Type,Montant,Nom_src,Ancien_solde_src,Nouveau_solde_src,Nom_dest,Ancien_solde_dest,Nouveau_solde_dest,Date
TRANSFER,847570,Laurence Dumont de Laroche,1574500,726930,Adrienne Arnaud,518400,1365970,2022-01-03
CASH_IN,275944,Agence_moov_Abomey,300000,24056,Adrienne Arnaud,1365970,1641914,2022-01-08
CASH_IN,177658,Agence_moov_Ouidah,300000,122342,Adrienne Arnaud,1641914,1819572,2022-01-14
CASH_OUT,22611,Auguste Bousquet,107500,84889,Agence_moov_Abomey,300000,277389,2022-01-03
CASH_OUT,83508,Auguste Bousquet,84889,1381,Agence_moov_Cotonou,300000,216492,2022-01-04
CASH_OUT,467,Auguste Bousquet,1381,914,Agence_moov_Cotonou,300000,299533,2022-01-07
CASH_IN,1717,Agence_moov_Abomey,300000,298283,Auguste Bousquet,914,2631,2022-01-08
CASH_IN,89842,Agence_moov_Ouidah,300000,210158,Auguste Bousquet,2631,92473,2022-01-17
TRANSFER,1464285,Amélie de la Picard,1510500,46215,Gilbert Bazin Le Guillet,1365900,2830185,2022-01-15
CASH_OUT,1876634,Gilbert Bazin Le Guillet,2830185,953551,Agence_moov_Ouidah,300000,-1576634,2022-01-20
CASH_OUT,125503,Xavier-Stéphane Ollivier,224100,98597,Agence_moov_Ouidah,300000,174497,2022-01-01
CASH_IN,145770,Agence_moov_Ouidah,300000,154230,Xavier-Stéphane Ollivier,98597,244367,2022-01-10
CASH_IN,238300,Agence_moov_Ouidah,300000,61700,Marie Da Silva,1552300,1790600,2022-01-03
CASH_OUT,1036208,Marie Da Silva,1790600,754392,Agence_moov_Cotonou,300000,-736208,2022-01-05
CASH_IN,60857,Agence_moov_Abomey,300000,239143,Marie Da Silva,754392,815249,2022-01-06
TRANSFER,11620,Marie Da Silva,815249,803629,Noémi de la Didier,1581100,1569480,2022-01-13
CASH_IN,40206,Agence_moov_Cotonou,300000,259794,Marie Da Silva,803629,843835,2022-01-14
CASH_IN,204973,Agence_moov_Ouidah,300000,95027,Alex Salmon,1151800,1356773,2022-01-18
TRANSFER,537220,Vincent-Philippe Rossi,1378000,840780,Augustin Benard,416500,-120720,2022-01-06
CASH_OUT,433225,Marine-Clémence Ferreira,1029500,596275,Agence_moov_Cotonou,300000,-133225,2022-01-12
TRANSFER,518090,Marine-Clémence Ferreira,596275,78185,Maurice Seguin,1141600,623510,2022-01-15
CASH_OUT,5525,Marine-Clémence Ferreira,78185,72660,Agence_moov_Abomey,300000,294475,2022-01-21
TRANSFER,444634,Diane-Françoise Raynaud,708000,263366,Emmanuelle Gilbert,446800,891434,2022-01-10
TRANSFER,1692977,Sébastien-Arthur Masse,1919600,226623,Emmanuelle Gilbert,891434,2584411,2022-01-14
CASH_OUT,2052923,Emmanuelle Gilbert,2584411,531488,Agence_moov_Cotonou,300000,-1752923,2022-01-18
CASH_OUT,208284,Emmanuelle Gilbert,531488,323204,Agence_moov_Abomey,300000,91716,2022-01-26
CASH_OUT,472768,Margot Renaud de Lacombe,511500,38732,Agence_moov_Abomey,300000,-172768,2022-01-11
CASH_OUT,28501,Margot Renaud de Lacombe,38732,10231,Agence_moov_Abomey,300000,271499,2022-01-18
CASH_IN,58516,Agence_moov_Ouidah,300000,241484,Margot Renaud de Lacombe,10231,68747,2022-01-23
CASH_OUT,68130,Sabine Imbert,187100,118970,Agence_moov_Cotonou,300000,231870,2022-01-03
CASH_IN,4574,Agence_moov_Ouidah,300000,295426,Sabine Imbert,118970,123544,2022-01-17
CASH_OUT,47388,Sabine Imbert,123544,76156,Agence_moov_Ouidah,300000,252612,2022-01-22
TRANSFER,249946,Antoine Leroux,296300,46354,Amélie Gros-Riou,1056300,806354,2022-01-04
CASH_IN,62314,Agence_moov_Abomey,300000,237686,Antoine Leroux,46354,108668,2022-01-24
CASH_OUT,714125,Marthe Pichon,1125100,410975,Agence_moov_Abomey,300000,-414125,2022-01-07
CASH_OUT,350686,Marthe Pichon,410975,60289,Agence_moov_Ouidah,300000,-50686,2022-01-09
CASH_OUT,254487,Maryse Reynaud-Michaud,793400,538913,Agence_moov_Cotonou,300000,45513,2022-01-10
CASH_IN,179426,Agence_moov_Cotonou,300000,120574,Maryse Reynaud-Michaud,538913,718339,2022-01-12
TRANSFER,381883,Maryse Reynaud-Michaud,718339,336456,Luc Camus,208400,-173483,2022-01-13
TRANSFER,425037,Laurence Carlier,1278800,853763,Frédéric Moreau,897000,471963,2022-01-12
TRANSFER,67340,Théophile Mendès,75000,7660,Emmanuel-René Coulon,1646900,1714240,2022-01-09
CASH_OUT,849733,Nathalie-Chantal Jacques,1840900,991167,Agence_moov_Ouidah,300000,-549733,2022-01-01
TRANSFER,839782,Constance Regnier,1271300,431518,Nathalie-Chantal Jacques,991167,1830949,2022-01-05
CASH_IN,224064,Agence_moov_Abomey,300000,75936,Nathalie-Chantal Jacques,1830949,2055013,2022-01-06
CASH_OUT,959204,Nathalie-Chantal Jacques,2055013,1095809,Agence_moov_Cotonou,300000,-659204,2022-01-21
TRANSFER,153944,Laurence Dumont de Laroche,726930,572986,Nathalie-Chantal Jacques,1095809,1249753,2022-01-24
TRANSFER,277029,Alfred Chrétien,413400,136371,Frédérique Robin,1630500,1353471,2022-01-14
CASH_OUT,12932,Alfred Chrétien,136371,123439,Agence_moov_Abomey,300000,287068,2022-01-24
TRANSFER,561706,Nath Léger,1713500,1151794,Arnaude Gaillard,201200,762906,2022-01-11
TRANSFER,28352,Anastasie Louis,156400,128048,Guy Guyon,1009300,980948,2022-01-01
TRANSFER,8496,Anastasie Louis,128048,119552,Noémi de la Didier,1569480,1560984,2022-01-07
CASH_OUT,87215,Anastasie Louis,119552,32337,Agence_moov_Abomey,300000,212785,2022-01-18
CASH_IN,250416,Agence_moov_Cotonou,300000,49584,Bernadette Fabre,1935600,2186016,2022-01-07
CASH_OUT,1886156,Bernadette Fabre,2186016,299860,Agence_moov_Cotonou,300000,-1586156,2022-01-15
CASH_OUT,50397,Bernadette Fabre,299860,249463,Agence_moov_Ouidah,300000,249603,2022-01-17
TRANSFER,142415,Christine-Constance Gauthier,1036600,894185,Bernadette Fabre,249463,391878,2022-01-17
CASH_IN,234930,Agence_moov_Ouidah,300000,65070,Bernadette Fabre,391878,626808,2022-01-26
CASH_IN,107767,Agence_moov_Abomey,300000,192233,Maurice Seguin,623510,731277,2022-01-01
CASH_OUT,346453,Maurice Seguin,731277,384824,Agence_moov_Cotonou,300000,-46453,2022-01-05
CASH_IN,221664,Agence_moov_Abomey,300000,78336,Maurice Seguin,384824,606488,2022-01-21
CASH_OUT,377919,Luc-Tristan Moreau,1596400,1218481,Agence_moov_Ouidah,300000,-77919,2022-01-05
TRANSFER,94650,Grégoire Delmas de Blanchard,431900,337250,Stéphanie Bonneau,1136200,1041550,2022-01-10
CASH_IN,4258,Agence_moov_Cotonou,300000,295742,Grégoire Delmas de Blanchard,337250,341508,2022-01-26
CASH_OUT,135769,Maurice Alves,153900,18131,Agence_moov_Cotonou,300000,164231,2022-01-01
TRANSFER,14347,Maurice Alves,18131,3784,Benoît Verdier,1056200,1041853,2022-01-01
TRANSFER,520,Maurice Alves,3784,3264,Stéphane-Timothée Pineau,1004900,1004380,2022-01-02
CASH_IN,37241,Agence_moov_Cotonou,300000,262759,Maurice Alves,3264,40505,2022-01-02
CASH_IN,84001,Agence_moov_Abomey,300000,215999,Maurice Alves,40505,124506,2022-01-03
TRANSFER,81475,Maurice Alves,124506,43031,Nath Léger,1151794,1070319,2022-01-04
CASH_IN,33119,Agence_moov_Abomey,300000,266881,Maurice Alves,43031,76150,2022-01-04
TRANSFER,101877,Frédéric Moreau,471963,370086,Maurice Alves,76150,178027,2022-01-05
CASH_OUT,29379,Maurice Alves,178027,148648,Agence_moov_Cotonou,300000,270621,2022-01-05
CASH_IN,148812,Agence_moov_Cotonou,300000,151188,Maurice Alves,148648,297460,2022-01-06
CASH_OUT,263410,Maurice Alves,297460,34050,Agence_moov_Cotonou,300000,36590,2022-01-07
CASH_OUT,7964,Maurice Alves,34050,26086,Agence_moov_Cotonou,300000,292036,2022-01-09
TRANSFER,201294,David Diallo,924500,723206,Maurice Alves,26086,227380,2022-01-09
CASH_OUT,71938,Maurice Alves,227380,155442,Agence_moov_Cotonou,300000,228062,2022-01-12
CASH_OUT,28097,Maurice Alves,155442,127345,Agence_moov_Cotonou,300000,271903,2022-01-15
CASH_OUT,42760,Maurice Alves,127345,84585,Agence_moov_Cotonou,300000,257240,2022-01-18
CASH_OUT,15651,Maurice Alves,84585,68934,Agence_moov_Cotonou,300000,284349,2022-01-18
TRANSFER,46798,Maurice Alves,68934,22136,Laurent Perrot,1723500,1676702,2022-01-19
TRANSFER,412,Maurice Alves,22136,21724,Christophe Guilbert,1503800,1503388,2022-01-19
TRANSFER,458028,Marianne Descamps,682400,224372,Maurice Alves,21724,479752,2022-01-19
TRANSFER,431619,Laurent Besson,525200,93581,Maurice Alves,479752,911371,2022-01-19
CASH_IN,187149,Agence_moov_Ouidah,300000,112851,Maurice Alves,911371,1098520,2022-01-20
TRANSFER,187571,Joséphine Weber du Bonnin,732500,544929,Maurice Alves,1098520,1286091,2022-01-23
CASH_IN,220246,Agence_moov_Ouidah,300000,79754,Maurice Alves,1286091,1506337,2022-01-24
CASH_OUT,996977,Maurice Alves,1506337,509360,Agence_moov_Ouidah,300000,-696977,2022-01-25
TRANSFER,1155822,Noémi de la Didier,1560984,405162,Maurice Alves,509360,1665182,2022-01-26
TRANSFER,349949,Frédéric Moreau,370086,20137,Maurice Alves,1665182,2015131,2022-01-26
CASH_OUT,1134753,Maurice Alves,2015131,880378,Agence_moov_Abomey,300000,-834753,2022-01-27
CASH_OUT,20201,Laurent Besson,93581,73380,Agence_moov_Cotonou,300000,279799,2022-01-01
CASH_IN,162633,Agence_moov_Ouidah,300000,137367,Laurent Besson,73380,236013,2022-01-01
CASH_OUT,219811,Laurent Besson,236013,16202,Agence_moov_Cotonou,300000,80189,2022-01-01
CASH_IN,212028,Agence_moov_Cotonou,300000,87972,Laurent Besson,16202,228230,2022-01-02
CASH_OUT,156486,Laurent Besson,228230,71744,Agence_moov_Cotonou,300000,143514,2022-01-03
TRANSFER,28938,Marianne Descamps,224372,195434,Laurent Besson,71744,100682,2022-01-04
CASH_OUT,18356,Laurent Besson,100682,82326,Agence_moov_Cotonou,300000,281644,2022-01-08
TRANSFER,79448,Stéphanie Bonneau,1041550,962102,Laurent Besson,82326,161774,2022-01-08
TRANSFER,361060,Benoît Verdier,1041853,680793,Laurent Besson,161774,522834,2022-01-08
CASH_IN,73178,Agence_moov_Ouidah,300000,226822,Laurent Besson,522834,596012,2022-01-10
CASH_OUT,276805,Laurent Besson,596012,319207,Agence_moov_Abomey,300000,23195,2022-01-13
TRANSFER,984948,Laurent Perrot,1676702,691754,Laurent Besson,319207,1304155,2022-01-13
CASH_IN,279251,Agence_moov_Ouidah,300000,20749,Laurent Besson,1304155,1583406,2022-01-13
CASH_IN,189557,Agence_moov_Abomey,300000,110443,Laurent Besson,1583406,1772963,2022-01-14
CASH_IN,92802,Agence_moov_Abomey,300000,207198,Laurent Besson,1772963,1865765,2022-01-15
CASH_IN,75458,Agence_moov_Cotonou,300000,224542,Laurent Besson,1865765,1941223,2022-01-16
TRANSFER,1908149,Laurent Besson,1941223,33074,Frédéric Moreau,20137,-1888012,2022-01-17
TRANSFER,21135,Marthe Guillet,935400,914265,Laurent Besson,33074,54209,2022-01-17
TRANSFER,49292,Laurent Besson,54209,4917,Paul De Sousa,93700,44408,2022-01-18
CASH_OUT,3397,Laurent Besson,4917,1520,Agence_moov_Ouidah,300000,296603,2022-01-20
TRANSFER,947,Laurent Besson,1520,573,Paul De Sousa,44408,43461,2022-01-22
CASH_OUT,548,Laurent Besson,573,25,Agence_moov_Abomey,300000,299452,2022-01-22
CASH_IN,252256,Agence_moov_Cotonou,300000,47744,Laurent Besson,25,252281,2022-01-22
CASH_OUT,48191,Laurent Besson,252281,204090,Agence_moov_Abomey,300000,251809,2022-01-23
CASH_IN,84466,Agence_moov_Ouidah,300000,215534,Laurent Besson,204090,288556,2022-01-23
TRANSFER,890733,Jacques-Antoine Gros,1020500,129767,Laurent Besson,288556,1179289,2022-01-24
TRANSFER,132139,Joseph de la Dubois,595200,463061,Laurent Besson,1179289,1311428,2022-01-24
CASH_OUT,1275381,Laurent Besson,1311428,36047,Agence_moov_Abomey,300000,-975381,2022-01-27
CASH_IN,151478,Agence_moov_Ouidah,300000,148522,David Diallo,723206,874684,2022-01-02
CASH_IN,21845,Agence_moov_Abomey,300000,278155,David Diallo,874684,896529,2022-01-02
CASH_OUT,534636,David Diallo,896529,361893,Agence_moov_Ouidah,300000,-234636,2022-01-03
CASH_IN,62755,Agence_moov_Ouidah,300000,237245,David Diallo,361893,424648,2022-01-06
TRANSFER,1308567,Michèle Vallée,1325300,16733,David Diallo,424648,1733215,2022-01-08
TRANSFER,1689702,David Diallo,1733215,43513,Joseph de la Dubois,463061,-1226641,2022-01-10
CASH_IN,144980,Agence_moov_Abomey,300000,155020,David Diallo,43513,188493,2022-01-10
CASH_IN,135395,Agence_moov_Ouidah,300000,164605,David Diallo,188493,323888,2022-01-11
TRANSFER,227503,David Diallo,323888,96385,Agnès Chrétien-Sanchez,1914500,1686997,2022-01-12
TRANSFER,18139,Amélie de la Picard,46215,28076,David Diallo,96385,114524,2022-01-12
CASH_OUT,46255,David Diallo,114524,68269,Agence_moov_Cotonou,300000,253745,2022-01-12
TRANSFER,14629,David Diallo,68269,53640,Nath Léger,1070319,1055690,2022-01-13
TRANSFER,49393,David Diallo,53640,4247,Guy Guyon,980948,931555,2022-01-14
TRANSFER,14475,Michèle Vallée,16733,2258,David Diallo,4247,18722,2022-01-15
CASH_OUT,8135,David Diallo,18722,10587,Agence_moov_Cotonou,300000,291865,2022-01-16
TRANSFER,51622,Joséphine Weber du Bonnin,544929,493307,David Diallo,10587,62209,2022-01-16
TRANSFER,33923,David Diallo,62209,28286,Stéphanie Bonneau,962102,928179,2022-01-17
CASH_OUT,27508,David Diallo,28286,778,Agence_moov_Cotonou,300000,272492,2022-01-17
TRANSFER,432,David Diallo,778,346,Amélie Gros-Riou,806354,805922,2022-01-18
CASH_OUT,151,David Diallo,346,195,Agence_moov_Ouidah,300000,299849,2022-01-19
CASH_IN,279444,Agence_moov_Cotonou,300000,20556,David Diallo,195,279639,2022-01-19
CASH_IN,276917,Agence_moov_Abomey,300000,23083,David Diallo,279639,556556,2022-01-20
TRANSFER,671613,Nicole Lacroix,686900,15287,David Diallo,556556,1228169,2022-01-20
CASH_IN,25244,Agence_moov_Cotonou,300000,274756,David Diallo,1228169,1253413,2022-01-20
TRANSFER,109411,David Diallo,1253413,1144002,Nath Léger,1055690,946279,2022-01-23
CASH_OUT,360674,David Diallo,1144002,783328,Agence_moov_Abomey,300000,-60674,2022-01-24
CASH_OUT,551225,David Diallo,783328,232103,Agence_moov_Abomey,300000,-251225,2022-01-26
CASH_IN,26866,Agence_moov_Abomey,300000,273134,David Diallo,232103,258969,2022-01-26
CASH_OUT,1585,Michèle Vallée,2258,673,Agence_moov_Cotonou,300000,298415,2022-01-01
CASH_IN,165432,Agence_moov_Cotonou,300000,134568,Michèle Vallée,673,166105,2022-01-03
CASH_OUT,157241,Michèle Vallée,166105,8864,Agence_moov_Abomey,300000,142759,2022-01-04
CASH_OUT,7864,Michèle Vallée,8864,1000,Agence_moov_Ouidah,300000,292136,2022-01-04
CASH_IN,35746,Agence_moov_Abomey,300000,264254,Michèle Vallée,1000,36746,2022-01-04
TRANSFER,23850,Michèle Vallée,36746,12896,Stéphanie Bonneau,928179,904329,2022-01-05
CASH_IN,194779,Agence_moov_Abomey,300000,105221,Michèle Vallée,12896,207675,2022-01-06
CASH_OUT,172931,Michèle Vallée,207675,34744,Agence_moov_Abomey,300000,127069,2022-01-06
CASH_OUT,31906,Michèle Vallée,34744,2838,Agence_moov_Ouidah,300000,268094,2022-01-07
TRANSFER,47044,Laurence Dumont de Laroche,572986,525942,Michèle Vallée,2838,49882,2022-01-08
CASH_IN,222270,Agence_moov_Ouidah,300000,77730,Michèle Vallée,49882,272152,2022-01-08
CASH_OUT,193322,Michèle Vallée,272152,78830,Agence_moov_Cotonou,300000,106678,2022-01-11
TRANSFER,41477,Michèle Vallée,78830,37353,Diane-Françoise Raynaud,263366,221889,2022-01-12
TRANSFER,28178,Michèle Vallée,37353,9175,Valentine Traore,1622000,1593822,2022-01-15
TRANSFER,645655,Benoît Verdier,680793,35138,Michèle Vallée,9175,654830,2022-01-15
CASH_OUT,205020,Michèle Vallée,654830,449810,Agence_moov_Ouidah,300000,94980,2022-01-15
TRANSFER,413820,Michèle Vallée,449810,35990,Emmanuel Bousquet,169800,-244020,2022-01-15
CASH_OUT,13988,Michèle Vallée,35990,22002,Agence_moov_Abomey,300000,286012,2022-01-16
TRANSFER,421938,Stéphanie Bonneau,904329,482391,Michèle Vallée,22002,443940,2022-01-23
CASH_OUT,269668,Michèle Vallée,443940,174272,Agence_moov_Cotonou,300000,30332,2022-01-23
CASH_IN,186708,Agence_moov_Abomey,300000,113292,Michèle Vallée,174272,360980,2022-01-24
CASH_IN,124822,Agence_moov_Abomey,300000,175178,Michèle Vallée,360980,485802,2022-01-24
TRANSFER,185312,Michèle Vallée,485802,300490,Matthieu Renard,981500,796188,2022-01-25
CASH_IN,36849,Agence_moov_Cotonou,300000,263151,Michèle Vallée,300490,337339,2022-01-25
TRANSFER,301565,Théodore Bertin,578900,277335,Michèle Vallée,337339,638904,2022-01-25
CASH_IN,276906,Agence_moov_Ouidah,300000,23094,Michèle Vallée,638904,915810,2022-01-25
CASH_OUT,50002,Laurent Perrot,691754,641752,Agence_moov_Cotonou,300000,249998,2022-01-01
CASH_OUT,89528,Laurent Perrot,641752,552224,Agence_moov_Ouidah,300000,210472,2022-01-02
CASH_IN,72908,Agence_moov_Cotonou,300000,227092,Laurent Perrot,552224,625132,2022-01-04
CASH_OUT,189108,Laurent Perrot,625132,436024,Agence_moov_Abomey,300000,110892,2022-01-05
TRANSFER,144699,Richard Guibert,1191000,1046301,Laurent Perrot,436024,580723,2022-01-05
CASH_OUT,366255,Laurent Perrot,580723,214468,Agence_moov_Ouidah,300000,-66255,2022-01-05
CASH_IN,12071,Agence_moov_Cotonou,300000,287929,Laurent Perrot,214468,226539,2022-01-05
CASH_OUT,9622,Laurent Perrot,226539,216917,Agence_moov_Ouidah,300000,290378,2022-01-06
CASH_IN,99056,Agence_moov_Ouidah,300000,200944,Laurent Perrot,216917,315973,2022-01-06
CASH_IN,258169,Agence_moov_Abomey,300000,41831,Laurent Perrot,315973,574142,2022-01-07
CASH_IN,151637,Agence_moov_Ouidah,300000,148363,Laurent Perrot,574142,725779,2022-01-08
CASH_IN,47816,Agence_moov_Ouidah,300000,252184,Laurent Perrot,725779,773595,2022-01-10
TRANSFER,10784,Benoît Verdier,35138,24354,Laurent Perrot,773595,784379,2022-01-11
TRANSFER,700978,Laurent Perrot,784379,83401,Josette Guillon-Leclercq,1277700,576722,2022-01-13
CASH_OUT,3610,Laurent Perrot,83401,79791,Agence_moov_Cotonou,300000,296390,2022-01-15
CASH_IN,161308,Agence_moov_Cotonou,300000,138692,Laurent Perrot,79791,241099,2022-01-15
CASH_OUT,60529,Laurent Perrot,241099,180570,Agence_moov_Cotonou,300000,239471,2022-01-16
CASH_IN,3127,Agence_moov_Ouidah,300000,296873,Laurent Perrot,180570,183697,2022-01-16
TRANSFER,128619,Sébastien-Arthur Masse,226623,98004,Laurent Perrot,183697,312316,2022-01-17
TRANSFER,218774,Amélie Gros-Riou,805922,587148,Laurent Perrot,312316,531090,2022-01-19
CASH_IN,68449,Agence_moov_Ouidah,300000,231551,Laurent Perrot,531090,599539,2022-01-20
TRANSFER,202641,Laurent Perrot,599539,396898,Isaac Le Pinto,1293800,1091159,2022-01-25
CASH_OUT,205205,Laurent Perrot,396898,191693,Agence_moov_Ouidah,300000,94795,2022-01-26
TRANSFER,35347,Laurent Perrot,191693,156346,Matthieu Renard,796188,760841,2022-01-27
CASH_IN,230533,Agence_moov_Cotonou,300000,69467,Sébastien Jourdan,854400,1084933,2022-01-01
CASH_IN,230660,Agence_moov_Cotonou,300000,69340,Sébastien Jourdan,1084933,1315593,2022-01-01
TRANSFER,121242,Sébastien Jourdan,1315593,1194351,Valentine Traore,1593822,1472580,2022-01-02
CASH_IN,44313,Agence_moov_Ouidah,300000,255687,Sébastien Jourdan,1194351,1238664,2022-01-03
CASH_OUT,1003276,Sébastien Jourdan,1238664,235388,Agence_moov_Cotonou,300000,-703276,2022-01-03
CASH_IN,242988,Agence_moov_Cotonou,300000,57012,Sébastien Jourdan,235388,478376,2022-01-05
CASH_OUT,65592,Sébastien Jourdan,478376,412784,Agence_moov_Cotonou,300000,234408,2022-01-05
CASH_OUT,82672,Sébastien Jourdan,412784,330112,Agence_moov_Cotonou,300000,217328,2022-01-06
CASH_OUT,314232,Sébastien Jourdan,330112,15880,Agence_moov_Abomey,300000,-14232,2022-01-08
TRANSFER,9322,Sébastien Jourdan,15880,6558,Caroline Peltier,1938900,1929578,2022-01-12
TRANSFER,2663,Sébastien Jourdan,6558,3895,Sébastien-Arthur Masse,98004,95341,2022-01-13
CASH_IN,71726,Agence_moov_Cotonou,300000,228274,Sébastien Jourdan,3895,75621,2022-01-14
CASH_OUT,32680,Sébastien Jourdan,75621,42941,Agence_moov_Ouidah,300000,267320,2022-01-14
TRANSFER,40459,Sébastien Jourdan,42941,2482,Christophe Alexandre,1635000,1594541,2022-01-14
CASH_IN,153540,Agence_moov_Abomey,300000,146460,Sébastien Jourdan,2482,156022,2022-01-14
TRANSFER,1637337,Océane Boutin,1912200,274863,Sébastien Jourdan,156022,1793359,2022-01-15
TRANSFER,1324272,Sébastien Jourdan,1793359,469087,Caroline Peltier,1929578,605306,2022-01-15
CASH_IN,91850,Agence_moov_Ouidah,300000,208150,Sébastien Jourdan,469087,560937,2022-01-15
CASH_IN,1207,Agence_moov_Cotonou,300000,298793,Sébastien Jourdan,560937,562144,2022-01-17
CASH_IN,132411,Agence_moov_Cotonou,300000,167589,Sébastien Jourdan,562144,694555,2022-01-18
TRANSFER,378125,Sébastien Jourdan,694555,316430,Gabriel de Pineau,443300,65175,2022-01-18
CASH_IN,80520,Agence_moov_Abomey,300000,219480,Sébastien Jourdan,316430,396950,2022-01-19
CASH_OUT,308528,Sébastien Jourdan,396950,88422,Agence_moov_Cotonou,300000,-8528,2022-01-19
CASH_IN,27449,Agence_moov_Cotonou,300000,272551,Sébastien Jourdan,88422,115871,2022-01-20
CASH_OUT,74677,Sébastien Jourdan,115871,41194,Agence_moov_Ouidah,300000,225323,2022-01-23
CASH_OUT,31181,Sébastien Jourdan,41194,10013,Agence_moov_Abomey,300000,268819,2022-01-25
CASH_IN,285696,Agence_moov_Abomey,300000,14304,Sébastien Jourdan,10013,295709,2022-01-25
TRANSFER,743755,Richard Guibert,1046301,302546,Sébastien Jourdan,295709,1039464,2022-01-26
CASH_IN,149081,Agence_moov_Ouidah,300000,150919,Sébastien Jourdan,1039464,1188545,2022-01-26
CASH_IN,248153,Agence_moov_Abomey,300000,51847,Sébastien Jourdan,1188545,1436698,2022-01-27
CASH_OUT,378283,Nath Léger,946279,567996,Agence_moov_Ouidah,300000,-78283,2022-01-01
TRANSFER,262271,Nath Léger,567996,305725,Valentine Traore,1472580,1210309,2022-01-01
CASH_OUT,201805,Nath Léger,305725,103920,Agence_moov_Cotonou,300000,98195,2022-01-01
CASH_IN,267528,Agence_moov_Ouidah,300000,32472,Nath Léger,103920,371448,2022-01-02
CASH_OUT,34430,Nath Léger,371448,337018,Agence_moov_Abomey,300000,265570,2022-01-03
CASH_IN,212465,Agence_moov_Ouidah,300000,87535,Nath Léger,337018,549483,2022-01-08
CASH_OUT,127326,Nath Léger,549483,422157,Agence_moov_Cotonou,300000,172674,2022-01-11
TRANSFER,119169,Nath Léger,422157,302988,Caroline Peltier,605306,486137,2022-01-13
TRANSFER,24577,Océane Boutin,274863,250286,Nath Léger,302988,327565,2022-01-13
CASH_IN,188533,Agence_moov_Ouidah,300000,111467,Nath Léger,327565,516098,2022-01-13
CASH_IN,23367,Agence_moov_Cotonou,300000,276633,Nath Léger,516098,539465,2022-01-14
CASH_IN,153426,Agence_moov_Abomey,300000,146574,Nath Léger,539465,692891,2022-01-14
CASH_OUT,291177,Nath Léger,692891,401714,Agence_moov_Abomey,300000,8823,2022-01-17
TRANSFER,241168,Élodie Gérard,1964200,1723032,Nath Léger,401714,642882,2022-01-17
CASH_IN,228191,Agence_moov_Cotonou,300000,71809,Nath Léger,642882,871073,2022-01-17
CASH_IN,179206,Agence_moov_Cotonou,300000,120794,Nath Léger,871073,1050279,2022-01-19
CASH_OUT,39733,Nath Léger,1050279,1010546,Agence_moov_Ouidah,300000,260267,2022-01-20
CASH_OUT,707808,Nath Léger,1010546,302738,Agence_moov_Abomey,300000,-407808,2022-01-21
CASH_IN,109306,Agence_moov_Ouidah,300000,190694,Nath Léger,302738,412044,2022-01-24
CASH_OUT,6798,Nath Léger,412044,405246,Agence_moov_Ouidah,300000,293202,2022-01-26
CASH_IN,201667,Agence_moov_Ouidah,300000,98333,Nath Léger,405246,606913,2022-01-26
CASH_OUT,73937,Jacques-Antoine Gros,129767,55830,Agence_moov_Abomey,300000,226063,2022-01-02
TRANSFER,306987,Isaac Le Pinto,1091159,784172,Jacques-Antoine Gros,55830,362817,2022-01-02
CASH_IN,246229,Agence_moov_Cotonou,300000,53771,Jacques-Antoine Gros,362817,609046,2022-01-06
TRANSFER,744028,Noël Hamel,807700,63672,Jacques-Antoine Gros,609046,1353074,2022-01-08
TRANSFER,711737,Guy Guyon,931555,219818,Jacques-Antoine Gros,1353074,2064811,2022-01-09
CASH_IN,70690,Agence_moov_Ouidah,300000,229310,Jacques-Antoine Gros,2064811,2135501,2022-01-10
CASH_OUT,493077,Jacques-Antoine Gros,2135501,1642424,Agence_moov_Abomey,300000,-193077,2022-01-10
CASH_OUT,75186,Jacques-Antoine Gros,1642424,1567238,Agence_moov_Cotonou,300000,224814,2022-01-11
CASH_OUT,1066074,Jacques-Antoine Gros,1567238,501164,Agence_moov_Ouidah,300000,-766074,2022-01-11
CASH_IN,57965,Agence_moov_Ouidah,300000,242035,Jacques-Antoine Gros,501164,559129,2022-01-12
CASH_OUT,98341,Jacques-Antoine Gros,559129,460788,Agence_moov_Ouidah,300000,201659,2022-01-13
CASH_IN,216284,Agence_moov_Cotonou,300000,83716,Jacques-Antoine Gros,460788,677072,2022-01-15
CASH_IN,133450,Agence_moov_Ouidah,300000,166550,Jacques-Antoine Gros,677072,810522,2022-01-17
CASH_OUT,358575,Jacques-Antoine Gros,810522,451947,Agence_moov_Ouidah,300000,-58575,2022-01-17
CASH_IN,233719,Agence_moov_Cotonou,300000,66281,Jacques-Antoine Gros,451947,685666,2022-01-18
CASH_IN,273506,Agence_moov_Cotonou,300000,26494,Jacques-Antoine Gros,685666,959172,2022-01-21
TRANSFER,874241,Jacques-Antoine Gros,959172,84931,Joséphine Weber du Bonnin,493307,-380934,2022-01-23
TRANSFER,78134,Jacques-Antoine Gros,84931,6797,Stéphanie Bonneau,482391,404257,2022-01-23
CASH_IN,167430,Agence_moov_Ouidah,300000,132570,Jacques-Antoine Gros,6797,174227,2022-01-24
TRANSFER,3873,Jacques-Antoine Gros,174227,170354,Susan de Fontaine,1370000,1366127,2022-01-25
CASH_OUT,141963,Jacques-Antoine Gros,170354,28391,Agence_moov_Cotonou,300000,158037,2022-01-25
CASH_IN,166242,Agence_moov_Cotonou,300000,133758,Noël Hamel,63672,229914,2022-01-01
CASH_IN,32909,Agence_moov_Abomey,300000,267091,Noël Hamel,229914,262823,2022-01-01
CASH_OUT,83736,Noël Hamel,262823,179087,Agence_moov_Abomey,300000,216264,2022-01-04
CASH_OUT,9214,Noël Hamel,179087,169873,Agence_moov_Abomey,300000,290786,2022-01-05
CASH_OUT,94819,Noël Hamel,169873,75054,Agence_moov_Ouidah,300000,205181,2022-01-07
TRANSFER,6211,Noël Hamel,75054,68843,Noël Hamel,75054,81265,2022-01-08
CASH_IN,226927,Agence_moov_Abomey,300000,73073,Noël Hamel,68843,295770,2022-01-08
TRANSFER,28428,Paul De Sousa,43461,15033,Noël Hamel,295770,324198,2022-01-14
TRANSFER,2215,Paul De Sousa,15033,12818,Noël Hamel,324198,326413,2022-01-15
CASH_OUT,49467,Noël Hamel,326413,276946,Agence_moov_Ouidah,300000,250533,2022-01-16
TRANSFER,98861,Noël Hamel,276946,178085,Susan de Fontaine,1366127,1267266,2022-01-18
TRANSFER,40452,Noël Hamel,178085,137633,Théodore Bertin,277335,236883,2022-01-19
TRANSFER,531062,Clémence Bertin,1358100,827038,Noël Hamel,137633,668695,2022-01-19
CASH_OUT,508613,Noël Hamel,668695,160082,Agence_moov_Ouidah,300000,-208613,2022-01-20
CASH_OUT,148338,Noël Hamel,160082,11744,Agence_moov_Cotonou,300000,151662,2022-01-21
CASH_IN,1828,Agence_moov_Ouidah,300000,298172,Noël Hamel,11744,13572,2022-01-21
TRANSFER,3348,Noël Hamel,13572,10224,Aimé Allain,230100,226752,2022-01-22
CASH_OUT,7031,Noël Hamel,10224,3193,Agence_moov_Ouidah,300000,292969,2022-01-22
CASH_OUT,2412,Noël Hamel,3193,781,Agence_moov_Ouidah,300000,297588,2022-01-23
TRANSFER,640737,Agnès Chrétien-Sanchez,1686997,1046260,Noël Hamel,781,641518,2022-01-23
TRANSFER,375606,Noël Hamel,641518,265912,Alphonse Dupont-Petit,286700,-88906,2022-01-24
CASH_OUT,39362,Noël Hamel,265912,226550,Agence_moov_Ouidah,300000,260638,2022-01-26
CASH_OUT,30684,Noël Hamel,226550,195866,Agence_moov_Ouidah,300000,269316,2022-01-26
CASH_IN,188354,Agence_moov_Abomey,300000,111646,Noël Hamel,195866,384220,2022-01-27
CASH_OUT,152766,Noël Hamel,384220,231454,Agence_moov_Ouidah,300000,147234,2022-01-27
CASH_IN,31083,Agence_moov_Cotonou,300000,268917,Laurence Dumont de Laroche,525942,557025,2022-01-01
CASH_OUT,177829,Laurence Dumont de Laroche,557025,379196,Agence_moov_Cotonou,300000,122171,2022-01-02
CASH_OUT,112945,Laurence Dumont de Laroche,379196,266251,Agence_moov_Cotonou,300000,187055,2022-01-02
CASH_OUT,42211,Laurence Dumont de Laroche,266251,224040,Agence_moov_Abomey,300000,257789,2022-01-02
CASH_IN,213027,Agence_moov_Ouidah,300000,86973,Laurence Dumont de Laroche,224040,437067,2022-01-02
TRANSFER,299741,Laurence Dumont de Laroche,437067,137326,Matthieu Renard,760841,461100,2022-01-02
TRANSFER,54426,Laurence Dumont de Laroche,137326,82900,Christophe Alexandre,1594541,1540115,2022-01-04
CASH_OUT,50936,Laurence Dumont de Laroche,82900,31964,Agence_moov_Abomey,300000,249064,2022-01-05
CASH_IN,24881,Agence_moov_Cotonou,300000,275119,Laurence Dumont de Laroche,31964,56845,2022-01-06
CASH_IN,293848,Agence_moov_Ouidah,300000,6152,Laurence Dumont de Laroche,56845,350693,2022-01-06
CASH_OUT,251305,Laurence Dumont de Laroche,350693,99388,Agence_moov_Cotonou,300000,48695,2022-01-06
TRANSFER,33702,Laurence Dumont de Laroche,99388,65686,Diane-Françoise Raynaud,221889,188187,2022-01-07
CASH_OUT,34648,Laurence Dumont de Laroche,65686,31038,Agence_moov_Abomey,300000,265352,2022-01-12
TRANSFER,1419687,Agnès Baron,1973900,554213,Laurence Dumont de Laroche,31038,1450725,2022-01-12
TRANSFER,1421890,Laurence Dumont de Laroche,1450725,28835,Julie Robin de Gros,1562200,140310,2022-01-14
CASH_OUT,24024,Laurence Dumont de Laroche,28835,4811,Agence_moov_Abomey,300000,275976,2022-01-14
CASH_OUT,4287,Laurence Dumont de Laroche,4811,524,Agence_moov_Cotonou,300000,295713,2022-01-15
CASH_IN,176139,Agence_moov_Abomey,300000,123861,Laurence Dumont de Laroche,524,176663,2022-01-16
CASH_OUT,14524,Laurence Dumont de Laroche,176663,162139,Agence_moov_Cotonou,300000,285476,2022-01-16
CASH_IN,269710,Agence_moov_Abomey,300000,30290,Laurence Dumont de Laroche,162139,431849,2022-01-18
CASH_OUT,49123,Laurence Dumont de Laroche,431849,382726,Agence_moov_Cotonou,300000,250877,2022-01-18
TRANSFER,119475,Laurence Dumont de Laroche,382726,263251,Benoît Verdier,24354,-95121,2022-01-18
CASH_OUT,137478,Laurence Dumont de Laroche,263251,125773,Agence_moov_Ouidah,300000,162522,2022-01-19
CASH_IN,250292,Agence_moov_Cotonou,300000,49708,Laurence Dumont de Laroche,125773,376065,2022-01-25
TRANSFER,57236,Richard Guibert,302546,245310,Laurence Dumont de Laroche,376065,433301,2022-01-25
TRANSFER,368026,Laurence Dumont de Laroche,433301,65275,Théodore Bertin,236883,-131143,2022-01-25
TRANSFER,36226,Laurence Dumont de Laroche,65275,29049,Guy Guyon,219818,183592,2022-01-26
CASH_OUT,4147,Laurence Dumont de Laroche,29049,24902,Agence_moov_Ouidah,300000,295853,2022-01-27
CASH_IN,64362,Agence_moov_Cotonou,300000,235638,Matthieu Renard,461100,525462,2022-01-02
CASH_IN,51794,Agence_moov_Ouidah,300000,248206,Matthieu Renard,525462,577256,2022-01-02
TRANSFER,251290,Matthieu Renard,577256,325966,Marc Gilbert,1171200,919910,2022-01-02
CASH_OUT,113593,Matthieu Renard,325966,212373,Agence_moov_Cotonou,300000,186407,2022-01-03
TRANSFER,149266,Richard Guibert,245310,96044,Matthieu Renard,212373,361639,2022-01-03
CASH_OUT,112647,Matthieu Renard,361639,248992,Agence_moov_Cotonou,300000,187353,2022-01-04
CASH_OUT,93621,Matthieu Renard,248992,155371,Agence_moov_Abomey,300000,206379,2022-01-04
CASH_IN,65178,Agence_moov_Ouidah,300000,234822,Matthieu Renard,155371,220549,2022-01-05
CASH_IN,231993,Agence_moov_Cotonou,300000,68007,Matthieu Renard,220549,452542,2022-01-05
CASH_IN,142333,Agence_moov_Ouidah,300000,157667,Matthieu Renard,452542,594875,2022-01-06
CASH_OUT,284719,Matthieu Renard,594875,310156,Agence_moov_Abomey,300000,15281,2022-01-07
CASH_OUT,34553,Matthieu Renard,310156,275603,Agence_moov_Abomey,300000,265447,2022-01-10
TRANSFER,81273,Matthieu Renard,275603,194330,Diane-Françoise Raynaud,188187,106914,2022-01-12
CASH_IN,25029,Agence_moov_Cotonou,300000,274971,Matthieu Renard,194330,219359,2022-01-13
TRANSFER,2150,Théophile Mendès,7660,5510,Matthieu Renard,219359,221509,2022-01-13
CASH_OUT,178660,Matthieu Renard,221509,42849,Agence_moov_Ouidah,300000,121340,2022-01-13
TRANSFER,173545,Agnès Baron,554213,380668,Matthieu Renard,42849,216394,2022-01-20
CASH_OUT,208922,Matthieu Renard,216394,7472,Agence_moov_Abomey,300000,91078,2022-01-20
CASH_OUT,2907,Matthieu Renard,7472,4565,Agence_moov_Ouidah,300000,297093,2022-01-21
TRANSFER,1068,Matthieu Renard,4565,3497,Amélie de la Picard,28076,27008,2022-01-22
CASH_OUT,2519,Matthieu Renard,3497,978,Agence_moov_Abomey,300000,297481,2022-01-23
CASH_IN,89726,Agence_moov_Cotonou,300000,210274,Matthieu Renard,978,90704,2022-01-23
CASH_OUT,89512,Matthieu Renard,90704,1192,Agence_moov_Ouidah,300000,210488,2022-01-24
CASH_OUT,1055,Matthieu Renard,1192,137,Agence_moov_Abomey,300000,298945,2022-01-24
TRANSFER,113,Matthieu Renard,137,24,David-Théodore Diaz,1679700,1679587,2022-01-27
CASH_IN,175456,Agence_moov_Ouidah,300000,124544,Léon Paris,1651600,1827056,2022-01-02
CASH_IN,186849,Agence_moov_Cotonou,300000,113151,Léon Paris,1827056,2013905,2022-01-04
CASH_IN,226303,Agence_moov_Cotonou,300000,73697,Léon Paris,2013905,2240208,2022-01-05
TRANSFER,108649,Léon Paris,2240208,2131559,Isaac Le Pinto,784172,675523,2022-01-06
CASH_IN,153545,Agence_moov_Cotonou,300000,146455,Léon Paris,2131559,2285104,2022-01-07
CASH_IN,213098,Agence_moov_Abomey,300000,86902,Léon Paris,2285104,2498202,2022-01-09
CASH_IN,20269,Agence_moov_Cotonou,300000,279731,Léon Paris,2498202,2518471,2022-01-11
CASH_IN,293906,Agence_moov_Cotonou,300000,6094,Léon Paris,2518471,2812377,2022-01-13
CASH_IN,116166,Agence_moov_Cotonou,300000,183834,Léon Paris,2812377,2928543,2022-01-13
TRANSFER,1829044,Léon Paris,2928543,1099499,Agnès Baron,380668,-1448376,2022-01-13
TRANSFER,1095521,Léon Paris,1099499,3978,Guy Guyon,183592,-911929,2022-01-14
CASH_IN,99495,Agence_moov_Abomey,300000,200505,Léon Paris,3978,103473,2022-01-16
CASH_IN,12416,Agence_moov_Cotonou,300000,287584,Léon Paris,103473,115889,2022-01-17
TRANSFER,84215,Léon Paris,115889,31674,Lucy Vaillant,1156600,1072385,2022-01-17
CASH_OUT,30563,Léon Paris,31674,1111,Agence_moov_Ouidah,300000,269437,2022-01-17
CASH_OUT,219,Léon Paris,1111,892,Agence_moov_Cotonou,300000,299781,2022-01-18
CASH_IN,183056,Agence_moov_Ouidah,300000,116944,Léon Paris,892,183948,2022-01-18
CASH_OUT,2737,Léon Paris,183948,181211,Agence_moov_Ouidah,300000,297263,2022-01-19
TRANSFER,533590,Isaac Le Pinto,675523,141933,Léon Paris,181211,714801,2022-01-22
CASH_IN,1200,Agence_moov_Abomey,300000,298800,Léon Paris,714801,716001,2022-01-22
CASH_OUT,99629,Léon Paris,716001,616372,Agence_moov_Cotonou,300000,200371,2022-01-23
CASH_IN,99591,Agence_moov_Ouidah,300000,200409,Léon Paris,616372,715963,2022-01-24
TRANSFER,8259,Léon Paris,715963,707704,Josette Guillon-Leclercq,576722,568463,2022-01-25
CASH_OUT,533486,Léon Paris,707704,174218,Agence_moov_Abomey,300000,-233486,2022-01-25
CASH_IN,67661,Agence_moov_Cotonou,300000,232339,Léon Paris,174218,241879,2022-01-26
TRANSFER,671,Paul De Sousa,12818,12147,Léon Paris,241879,242550,2022-01-26
TRANSFER,238677,Vincent-Grégoire Brunet,525100,286423,Léon Paris,242550,481227,2022-01-27
CASH_OUT,758167,David-Théodore Diaz,1679587,921420,Agence_moov_Cotonou,300000,-458167,2022-01-01
CASH_OUT,788399,David-Théodore Diaz,921420,133021,Agence_moov_Cotonou,300000,-488399,2022-01-01
TRANSFER,93193,David-Théodore Diaz,133021,39828,Frédérique Robin,1353471,1260278,2022-01-01
CASH_IN,38108,Agence_moov_Ouidah,300000,261892,David-Théodore Diaz,39828,77936,2022-01-03
TRANSFER,6701,David-Théodore Diaz,77936,71235,Nicole Lacroix,15287,8586,2022-01-03
CASH_IN,206838,Agence_moov_Ouidah,300000,93162,David-Théodore Diaz,71235,278073,2022-01-05
CASH_IN,226039,Agence_moov_Cotonou,300000,73961,David-Théodore Diaz,278073,504112,2022-01-06
CASH_OUT,429881,David-Théodore Diaz,504112,74231,Agence_moov_Abomey,300000,-129881,2022-01-08
CASH_IN,175533,Agence_moov_Ouidah,300000,124467,David-Théodore Diaz,74231,249764,2022-01-08
TRANSFER,149182,David-Théodore Diaz,249764,100582,Paul Pereira,491500,342318,2022-01-09
TRANSFER,330447,Stéphanie Bonneau,404257,73810,David-Théodore Diaz,100582,431029,2022-01-09
CASH_IN,111317,Agence_moov_Ouidah,300000,188683,David-Théodore Diaz,431029,542346,2022-01-11
TRANSFER,248678,David-Théodore Diaz,542346,293668,Christine-Constance Gauthier,894185,645507,2022-01-15
CASH_OUT,168463,David-Théodore Diaz,293668,125205,Agence_moov_Abomey,300000,131537,2022-01-15
CASH_OUT,54896,David-Théodore Diaz,125205,70309,Agence_moov_Ouidah,300000,245104,2022-01-17
CASH_IN,9685,Agence_moov_Abomey,300000,290315,David-Théodore Diaz,70309,79994,2022-01-17
CASH_OUT,40084,David-Théodore Diaz,79994,39910,Agence_moov_Cotonou,300000,259916,2022-01-17
CASH_OUT,7374,David-Théodore Diaz,39910,32536,Agence_moov_Cotonou,300000,292626,2022-01-21
TRANSFER,5011,David-Théodore Diaz,32536,27525,Christophe Alexandre,1540115,1535104,2022-01-24
CASH_OUT,6910,David-Théodore Diaz,27525,20615,Agence_moov_Ouidah,300000,293090,2022-01-24
CASH_IN,101710,Agence_moov_Ouidah,300000,198290,David-Théodore Diaz,20615,122325,2022-01-25
TRANSFER,951549,Élodie Gérard,1723032,771483,David-Théodore Diaz,122325,1073874,2022-01-26
TRANSFER,490989,David-Théodore Diaz,1073874,582885,Sébastien-Arthur Masse,95341,-395648,2022-01-27
CASH_OUT,166530,David-Théodore Diaz,582885,416355,Agence_moov_Ouidah,300000,133470,2022-01-27
CASH_OUT,41669,Julie Robin de Gros,140310,98641,Agence_moov_Ouidah,300000,258331,2022-01-02
CASH_OUT,5044,Julie Robin de Gros,98641,93597,Agence_moov_Cotonou,300000,294956,2022-01-02
TRANSFER,89575,Océane Boutin,250286,160711,Julie Robin de Gros,93597,183172,2022-01-05
CASH_OUT,172701,Julie Robin de Gros,183172,10471,Agence_moov_Abomey,300000,127299,2022-01-06
TRANSFER,404138,Stéphane-Timothée Pineau,1004380,600242,Julie Robin de Gros,10471,414609,2022-01-09
CASH_IN,252534,Agence_moov_Ouidah,300000,47466,Julie Robin de Gros,414609,667143,2022-01-10
CASH_IN,292437,Agence_moov_Cotonou,300000,7563,Julie Robin de Gros,667143,959580,2022-01-10
CASH_IN,39807,Agence_moov_Ouidah,300000,260193,Julie Robin de Gros,959580,999387,2022-01-11
TRANSFER,813822,Julie Robin de Gros,999387,185565,Caroline Peltier,486137,-327685,2022-01-13
CASH_IN,280595,Agence_moov_Ouidah,300000,19405,Julie Robin de Gros,185565,466160,2022-01-13
CASH_IN,145502,Agence_moov_Abomey,300000,154498,Julie Robin de Gros,466160,611662,2022-01-14
CASH_IN,253438,Agence_moov_Ouidah,300000,46562,Julie Robin de Gros,611662,865100,2022-01-15
CASH_IN,69617,Agence_moov_Cotonou,300000,230383,Julie Robin de Gros,865100,934717,2022-01-15
CASH_IN,268647,Agence_moov_Cotonou,300000,31353,Julie Robin de Gros,934717,1203364,2022-01-16
CASH_OUT,563090,Julie Robin de Gros,1203364,640274,Agence_moov_Cotonou,300000,-263090,2022-01-16
CASH_OUT,44792,Julie Robin de Gros,640274,595482,Agence_moov_Ouidah,300000,255208,2022-01-18
CASH_IN,210920,Agence_moov_Abomey,300000,89080,Julie Robin de Gros,595482,806402,2022-01-19
TRANSFER,309209,Julie Robin de Gros,806402,497193,Richard Guibert,96044,-213165,2022-01-20
CASH_OUT,188747,Julie Robin de Gros,497193,308446,Agence_moov_Cotonou,300000,111253,2022-01-21
CASH_OUT,244557,Julie Robin de Gros,308446,63889,Agence_moov_Abomey,300000,55443,2022-01-21
TRANSFER,1089406,Antoine Bourdon de Auger,1210200,120794,Julie Robin de Gros,63889,1153295,2022-01-22
CASH_OUT,231312,Julie Robin de Gros,1153295,921983,Agence_moov_Ouidah,300000,68688,2022-01-22
CASH_IN,98583,Agence_moov_Ouidah,300000,201417,Julie Robin de Gros,921983,1020566,2022-01-22
CASH_IN,277001,Agence_moov_Abomey,300000,22999,Julie Robin de Gros,1020566,1297567,2022-01-23
CASH_OUT,267224,Julie Robin de Gros,1297567,1030343,Agence_moov_Ouidah,300000,32776,2022-01-23
TRANSFER,208018,Stéphane-Timothée Pineau,600242,392224,Julie Robin de Gros,1030343,1238361,2022-01-25
CASH_OUT,696031,Julie Robin de Gros,1238361,542330,Agence_moov_Ouidah,300000,-396031,2022-01-25
CASH_OUT,165618,Julie Robin de Gros,542330,376712,Agence_moov_Abomey,300000,134382,2022-01-27
TRANSFER,240793,Nicolas Hervé,1454800,1214007,Julie Robin de Gros,376712,617505,2022-01-27
TRANSFER,234861,Paul Pereira,342318,107457,Claudine Vallet,957000,722139,2022-01-02
CASH_IN,158627,Agence_moov_Ouidah,300000,141373,Paul Pereira,107457,266084,2022-01-03
CASH_OUT,4959,Paul Pereira,266084,261125,Agence_moov_Cotonou,300000,295041,2022-01-03
CASH_OUT,42132,Paul Pereira,261125,218993,Agence_moov_Ouidah,300000,257868,2022-01-04
CASH_OUT,154456,Paul Pereira,218993,64537,Agence_moov_Abomey,300000,145544,2022-01-04
CASH_IN,142895,Agence_moov_Cotonou,300000,157105,Paul Pereira,64537,207432,2022-01-05
TRANSFER,117803,Paul Pereira,207432,89629,Paul De Sousa,12147,-105656,2022-01-05
TRANSFER,36925,Paul Pereira,89629,52704,Caroline Monnier,1860600,1823675,2022-01-08
CASH_OUT,26985,Paul Pereira,52704,25719,Agence_moov_Abomey,300000,273015,2022-01-08
CASH_OUT,24569,Paul Pereira,25719,1150,Agence_moov_Cotonou,300000,275431,2022-01-08
CASH_IN,61592,Agence_moov_Ouidah,300000,238408,Paul Pereira,1150,62742,2022-01-09
CASH_IN,22445,Agence_moov_Ouidah,300000,277555,Paul Pereira,62742,85187,2022-01-10
CASH_OUT,39311,Paul Pereira,85187,45876,Agence_moov_Cotonou,300000,260689,2022-01-10
TRANSFER,101770,Caroline Monnier,1823675,1721905,Paul Pereira,45876,147646,2022-01-11
CASH_OUT,105001,Paul Pereira,147646,42645,Agence_moov_Ouidah,300000,194999,2022-01-11
CASH_OUT,10437,Paul Pereira,42645,32208,Agence_moov_Abomey,300000,289563,2022-01-11
TRANSFER,17931,Nicolas Grondin de la Pinto,34200,16269,Paul Pereira,32208,50139,2022-01-12
TRANSFER,48203,Paul Pereira,50139,1936,Émilie Guillon de Duhamel,1952300,1904097,2022-01-12
CASH_OUT,1106,Paul Pereira,1936,830,Agence_moov_Abomey,300000,298894,2022-01-15
TRANSFER,684,Paul Pereira,830,146,Marianne Descamps,195434,194750,2022-01-22
TRANSFER,60273,Diane-Françoise Raynaud,106914,46641,Paul Pereira,146,60419,2022-01-24
CASH_IN,79784,Agence_moov_Ouidah,300000,220216,Paul Pereira,60419,140203,2022-01-25
TRANSFER,55340,Paul Pereira,140203,84863,Valentine Traore,1210309,1154969,2022-01-25
CASH_OUT,53075,Paul Pereira,84863,31788,Agence_moov_Ouidah,300000,246925,2022-01-25
CASH_IN,72392,Agence_moov_Cotonou,300000,227608,Paul Pereira,31788,104180,2022-01-25
CASH_OUT,75991,Paul Pereira,104180,28189,Agence_moov_Abomey,300000,224009,2022-01-27
TRANSFER,23687,Paul Pereira,28189,4502,Lucy Vaillant,1072385,1048698,2022-01-27
CASH_OUT,665529,Claudine Vallet,722139,56610,Agence_moov_Abomey,300000,-365529,2022-01-02
CASH_IN,61096,Agence_moov_Abomey,300000,238904,Claudine Vallet,56610,117706,2022-01-02
CASH_IN,99463,Agence_moov_Ouidah,300000,200537,Claudine Vallet,117706,217169,2022-01-02
CASH_IN,55099,Agence_moov_Ouidah,300000,244901,Claudine Vallet,217169,272268,2022-01-02
TRANSFER,366430,Susan de Fontaine,1267266,900836,Claudine Vallet,272268,638698,2022-01-04
CASH_IN,160498,Agence_moov_Cotonou,300000,139502,Claudine Vallet,638698,799196,2022-01-04
CASH_IN,202924,Agence_moov_Cotonou,300000,97076,Claudine Vallet,799196,1002120,2022-01-08
CASH_OUT,428700,Claudine Vallet,1002120,573420,Agence_moov_Ouidah,300000,-128700,2022-01-08
TRANSFER,30425,Claudine Vallet,573420,542995,Claudine Vallet,573420,542995,2022-01-09
CASH_OUT,384613,Claudine Vallet,542995,158382,Agence_moov_Cotonou,300000,-84613,2022-01-10
TRANSFER,1161265,Nicolas Hervé,1214007,52742,Claudine Vallet,158382,1319647,2022-01-11
CASH_IN,183692,Agence_moov_Ouidah,300000,116308,Claudine Vallet,1319647,1503339,2022-01-12
CASH_IN,40015,Agence_moov_Cotonou,300000,259985,Claudine Vallet,1503339,1543354,2022-01-12
CASH_OUT,711144,Claudine Vallet,1543354,832210,Agence_moov_Abomey,300000,-411144,2022-01-12
CASH_OUT,8169,Claudine Vallet,832210,824041,Agence_moov_Cotonou,300000,291831,2022-01-19
CASH_OUT,701100,Claudine Vallet,824041,122941,Agence_moov_Abomey,300000,-401100,2022-01-20
CASH_OUT,112239,Claudine Vallet,122941,10702,Agence_moov_Ouidah,300000,187761,2022-01-23
CASH_IN,173136,Agence_moov_Ouidah,300000,126864,Claudine Vallet,10702,183838,2022-01-23
CASH_OUT,7331,Claudine Vallet,183838,176507,Agence_moov_Ouidah,300000,292669,2022-01-24
CASH_OUT,152107,Claudine Vallet,176507,24400,Agence_moov_Abomey,300000,147893,2022-01-24
CASH_IN,290215,Agence_moov_Cotonou,300000,9785,Claudine Vallet,24400,314615,2022-01-24
CASH_OUT,281770,Claudine Vallet,314615,32845,Agence_moov_Ouidah,300000,18230,2022-01-25
CASH_IN,176067,Agence_moov_Cotonou,300000,123933,Claudine Vallet,32845,208912,2022-01-25
CASH_IN,227155,Agence_moov_Abomey,300000,72845,Claudine Vallet,208912,436067,2022-01-25
CASH_OUT,15863,Diane-Françoise Raynaud,46641,30778,Agence_moov_Cotonou,300000,284137,2022-01-01
CASH_OUT,5025,Diane-Françoise Raynaud,30778,25753,Agence_moov_Cotonou,300000,294975,2022-01-03
TRANSFER,7959,Diane-Françoise Raynaud,25753,17794,Marc Gilbert,919910,911951,2022-01-04
TRANSFER,1584,Diane-Françoise Raynaud,17794,16210,Stéphanie Bonneau,73810,72226,2022-01-06
CASH_IN,35564,Agence_moov_Abomey,300000,264436,Diane-Françoise Raynaud,16210,51774,2022-01-07
CASH_IN,93865,Agence_moov_Ouidah,300000,206135,Diane-Françoise Raynaud,51774,145639,2022-01-07
CASH_OUT,59046,Diane-Françoise Raynaud,145639,86593,Agence_moov_Ouidah,300000,240954,2022-01-09
CASH_IN,293529,Agence_moov_Cotonou,300000,6471,Diane-Françoise Raynaud,86593,380122,2022-01-09
CASH_IN,172516,Agence_moov_Abomey,300000,127484,Diane-Françoise Raynaud,380122,552638,2022-01-10
TRANSFER,310477,Diane-Françoise Raynaud,552638,242161,Josette Guillon-Leclercq,568463,257986,2022-01-10
CASH_IN,165097,Agence_moov_Cotonou,300000,134903,Diane-Françoise Raynaud,242161,407258,2022-01-10
TRANSFER,157132,Diane-Françoise Raynaud,407258,250126,Paulette Dias,1256700,1099568,2022-01-12
CASH_IN,130651,Agence_moov_Abomey,300000,169349,Diane-Françoise Raynaud,250126,380777,2022-01-13
CASH_OUT,20208,Diane-Françoise Raynaud,380777,360569,Agence_moov_Cotonou,300000,279792,2022-01-14
TRANSFER,109025,Diane-Françoise Raynaud,360569,251544,Émilie Guillon de Duhamel,1904097,1795072,2022-01-15
TRANSFER,186396,Diane-Françoise Raynaud,251544,65148,Christophe Alexandre,1535104,1348708,2022-01-16
TRANSFER,186415,Marianne Descamps,194750,8335,Diane-Françoise Raynaud,65148,251563,2022-01-16
TRANSFER,34586,Isaac Le Pinto,141933,107347,Diane-Françoise Raynaud,251563,286149,2022-01-19
CASH_OUT,190032,Diane-Françoise Raynaud,286149,96117,Agence_moov_Abomey,300000,109968,2022-01-20
CASH_OUT,90011,Diane-Françoise Raynaud,96117,6106,Agence_moov_Ouidah,300000,209989,2022-01-21
CASH_IN,263294,Agence_moov_Cotonou,300000,36706,Diane-Françoise Raynaud,6106,269400,2022-01-22
CASH_IN,206545,Agence_moov_Abomey,300000,93455,Diane-Françoise Raynaud,269400,475945,2022-01-22
TRANSFER,27624,Diane-Françoise Raynaud,475945,448321,Marthe Guillet,914265,886641,2022-01-22
TRANSFER,8789,Susan de Fontaine,900836,892047,Diane-Françoise Raynaud,448321,457110,2022-01-24
CASH_OUT,424435,Diane-Françoise Raynaud,457110,32675,Agence_moov_Cotonou,300000,-124435,2022-01-24
CASH_OUT,27925,Diane-Françoise Raynaud,32675,4750,Agence_moov_Ouidah,300000,272075,2022-01-25
TRANSFER,940,Diane-Françoise Raynaud,4750,3810,Valentine Traore,1154969,1154029,2022-01-25
CASH_OUT,2595,Diane-Françoise Raynaud,3810,1215,Agence_moov_Cotonou,300000,297405,2022-01-26
CASH_OUT,295,Diane-Françoise Raynaud,1215,920,Agence_moov_Abomey,300000,299705,2022-01-26
CASH_OUT,753,Diane-Françoise Raynaud,920,167,Agence_moov_Abomey,300000,299247,2022-01-27
CASH_OUT,4839,Théophile Mendès,5510,671,Agence_moov_Cotonou,300000,295161,2022-01-02
CASH_IN,127485,Agence_moov_Abomey,300000,172515,Théophile Mendès,671,128156,2022-01-02
TRANSFER,618473,Marthe Guillet,886641,268168,Théophile Mendès,128156,746629,2022-01-03
CASH_IN,252368,Agence_moov_Abomey,300000,47632,Théophile Mendès,746629,998997,2022-01-06
TRANSFER,846268,Susan de Fontaine,892047,45779,Théophile Mendès,998997,1845265,2022-01-06
CASH_OUT,1690477,Théophile Mendès,1845265,154788,Agence_moov_Cotonou,300000,-1390477,2022-01-07
CASH_OUT,26857,Théophile Mendès,154788,127931,Agence_moov_Cotonou,300000,273143,2022-01-09
TRANSFER,110565,Théophile Mendès,127931,17366,Noémi de la Didier,405162,294597,2022-01-09
CASH_IN,90991,Agence_moov_Abomey,300000,209009,Théophile Mendès,17366,108357,2022-01-10
CASH_OUT,81425,Théophile Mendès,108357,26932,Agence_moov_Cotonou,300000,218575,2022-01-10
CASH_OUT,23109,Théophile Mendès,26932,3823,Agence_moov_Ouidah,300000,276891,2022-01-13
CASH_OUT,2062,Théophile Mendès,3823,1761,Agence_moov_Cotonou,300000,297938,2022-01-14
TRANSFER,13576,Nicolas Hervé,52742,39166,Théophile Mendès,1761,15337,2022-01-16
CASH_OUT,6590,Théophile Mendès,15337,8747,Agence_moov_Ouidah,300000,293410,2022-01-17
CASH_OUT,520,Théophile Mendès,8747,8227,Agence_moov_Ouidah,300000,299480,2022-01-17
CASH_IN,196023,Agence_moov_Abomey,300000,103977,Théophile Mendès,8227,204250,2022-01-19
CASH_IN,212230,Agence_moov_Abomey,300000,87770,Théophile Mendès,204250,416480,2022-01-19
CASH_IN,212189,Agence_moov_Cotonou,300000,87811,Théophile Mendès,416480,628669,2022-01-19
TRANSFER,864635,Marc Gilbert,911951,47316,Théophile Mendès,628669,1493304,2022-01-23
CASH_IN,170450,Agence_moov_Abomey,300000,129550,Théophile Mendès,1493304,1663754,2022-01-23
CASH_IN,238164,Agence_moov_Ouidah,300000,61836,Théophile Mendès,1663754,1901918,2022-01-24
TRANSFER,1501533,Théophile Mendès,1901918,400385,Théophile Mendès,1901918,400385,2022-01-24
CASH_OUT,363504,Théophile Mendès,400385,36881,Agence_moov_Cotonou,300000,-63504,2022-01-24
CASH_IN,263148,Agence_moov_Ouidah,300000,36852,Théophile Mendès,36881,300029,2022-01-24
CASH_IN,242708,Agence_moov_Ouidah,300000,57292,Théophile Mendès,300029,542737,2022-01-26
CASH_IN,174003,Agence_moov_Cotonou,300000,125997,Théophile Mendès,542737,716740,2022-01-27
CASH_IN,15296,Agence_moov_Cotonou,300000,284704,Marthe Guillet,268168,283464,2022-01-03
CASH_IN,138113,Agence_moov_Ouidah,300000,161887,Marthe Guillet,283464,421577,2022-01-04
CASH_OUT,186441,Marthe Guillet,421577,235136,Agence_moov_Ouidah,300000,113559,2022-01-04
CASH_OUT,52994,Marthe Guillet,235136,182142,Agence_moov_Ouidah,300000,247006,2022-01-04
TRANSFER,87318,Antoine Bourdon de Auger,120794,33476,Marthe Guillet,182142,269460,2022-01-05
TRANSFER,26224,Antoine Bourdon de Auger,33476,7252,Marthe Guillet,269460,295684,2022-01-05
CASH_IN,292986,Agence_moov_Ouidah,300000,7014,Marthe Guillet,295684,588670,2022-01-06
TRANSFER,473488,Marthe Guillet,588670,115182,Stéphane-Timothée Pineau,392224,-81264,2022-01-08
TRANSFER,1596664,Émilie Guillon de Duhamel,1795072,198408,Marthe Guillet,115182,1711846,2022-01-09
CASH_IN,135827,Agence_moov_Cotonou,300000,164173,Marthe Guillet,1711846,1847673,2022-01-10
CASH_IN,46002,Agence_moov_Cotonou,300000,253998,Marthe Guillet,1847673,1893675,2022-01-10
CASH_OUT,750831,Marthe Guillet,1893675,1142844,Agence_moov_Cotonou,300000,-450831,2022-01-11
TRANSFER,1702305,Alexandre Poirier,1810200,107895,Marthe Guillet,1142844,2845149,2022-01-11
CASH_IN,56818,Agence_moov_Ouidah,300000,243182,Marthe Guillet,2845149,2901967,2022-01-20
CASH_OUT,2349874,Marthe Guillet,2901967,552093,Agence_moov_Ouidah,300000,-2049874,2022-01-21
TRANSFER,1307,Vincent-Grégoire Brunet,286423,285116,Marthe Guillet,552093,553400,2022-01-22
CASH_IN,247353,Agence_moov_Ouidah,300000,52647,Marthe Guillet,553400,800753,2022-01-23
CASH_IN,2988,Agence_moov_Abomey,300000,297012,Marthe Guillet,800753,803741,2022-01-23
CASH_OUT,2320,Marthe Guillet,803741,801421,Agence_moov_Ouidah,300000,297680,2022-01-24
CASH_IN,98998,Agence_moov_Ouidah,300000,201002,Marthe Guillet,801421,900419,2022-01-25
CASH_OUT,110642,Marthe Guillet,900419,789777,Agence_moov_Abomey,300000,189358,2022-01-26
TRANSFER,297194,Marthe Guillet,789777,492583,Émilie Guillon de Duhamel,198408,-98786,2022-01-27
TRANSFER,27746,Nicolas Hervé,39166,11420,Constance Regnier,431518,403772,2022-01-01
CASH_OUT,1250,Nicolas Hervé,11420,10170,Agence_moov_Ouidah,300000,298750,2022-01-02
CASH_IN,227413,Agence_moov_Ouidah,300000,72587,Nicolas Hervé,10170,237583,2022-01-05
CASH_OUT,137585,Nicolas Hervé,237583,99998,Agence_moov_Cotonou,300000,162415,2022-01-07
CASH_IN,115408,Agence_moov_Ouidah,300000,184592,Nicolas Hervé,99998,215406,2022-01-07
CASH_IN,39953,Agence_moov_Ouidah,300000,260047,Nicolas Hervé,215406,255359,2022-01-08
CASH_OUT,181113,Nicolas Hervé,255359,74246,Agence_moov_Cotonou,300000,118887,2022-01-09
TRANSFER,62686,Nicolas Hervé,74246,11560,Paulette Dias,1099568,1036882,2022-01-11
TRANSFER,5845,Nicolas Hervé,11560,5715,Christine-Constance Gauthier,645507,639662,2022-01-13
CASH_IN,183208,Agence_moov_Ouidah,300000,116792,Nicolas Hervé,5715,188923,2022-01-15
CASH_IN,22318,Agence_moov_Abomey,300000,277682,Nicolas Hervé,188923,211241,2022-01-15
CASH_IN,131165,Agence_moov_Ouidah,300000,168835,Nicolas Hervé,211241,342406,2022-01-21
TRANSFER,78010,Nicolas Hervé,342406,264396,Christophe Alexandre,1348708,1270698,2022-01-21
TRANSFER,1176,Nicole Lacroix,8586,7410,Nicolas Hervé,264396,265572,2022-01-21
CASH_IN,133434,Agence_moov_Ouidah,300000,166566,Nicolas Hervé,265572,399006,2022-01-22
CASH_IN,128845,Agence_moov_Abomey,300000,171155,Nicolas Hervé,399006,527851,2022-01-22
CASH_IN,63858,Agence_moov_Abomey,300000,236142,Nicolas Hervé,527851,591709,2022-01-22
TRANSFER,583885,Nicolas Hervé,591709,7824,Aimé Allain,226752,-357133,2022-01-25
CASH_IN,213540,Agence_moov_Cotonou,300000,86460,Nicolas Hervé,7824,221364,2022-01-25
CASH_OUT,217393,Nicolas Hervé,221364,3971,Agence_moov_Ouidah,300000,82607,2022-01-27
TRANSFER,2391,Nicolas Hervé,3971,1580,Valentine Traore,1154029,1151638,2022-01-27
CASH_IN,131696,Agence_moov_Ouidah,300000,168304,Nicolas Hervé,1580,133276,2022-01-27
CASH_IN,182097,Agence_moov_Cotonou,300000,117903,Paulette Dias,1036882,1218979,2022-01-02
CASH_IN,185524,Agence_moov_Ouidah,300000,114476,Paulette Dias,1218979,1404503,2022-01-04
CASH_IN,291643,Agence_moov_Abomey,300000,8357,Paulette Dias,1404503,1696146,2022-01-06
TRANSFER,124391,Caroline Monnier,1721905,1597514,Paulette Dias,1696146,1820537,2022-01-08
TRANSFER,731831,Roland Colin,897700,165869,Paulette Dias,1820537,2552368,2022-01-11
CASH_OUT,2415263,Paulette Dias,2552368,137105,Agence_moov_Abomey,300000,-2115263,2022-01-11
CASH_OUT,41692,Paulette Dias,137105,95413,Agence_moov_Abomey,300000,258308,2022-01-13
TRANSFER,44076,Paulette Dias,95413,51337,Caroline Monnier,1597514,1553438,2022-01-13
CASH_IN,164880,Agence_moov_Cotonou,300000,135120,Paulette Dias,51337,216217,2022-01-13
CASH_IN,40245,Agence_moov_Cotonou,300000,259755,Paulette Dias,216217,256462,2022-01-13
TRANSFER,246887,Paulette Dias,256462,9575,Constance Regnier,403772,156885,2022-01-14
TRANSFER,1827,Paulette Dias,9575,7748,Christophe Alexandre,1270698,1268871,2022-01-15
TRANSFER,486,Paulette Dias,7748,7262,Noémi de la Didier,294597,294111,2022-01-16
TRANSFER,6736,Paulette Dias,7262,526,Alexandre Poirier,107895,101159,2022-01-17
CASH_IN,89857,Agence_moov_Ouidah,300000,210143,Paulette Dias,526,90383,2022-01-19
CASH_IN,63138,Agence_moov_Cotonou,300000,236862,Paulette Dias,90383,153521,2022-01-24
CASH_IN,189848,Agence_moov_Ouidah,300000,110152,Aimé Allain,-357133,-167285,2022-01-02
CASH_IN,186348,Agence_moov_Cotonou,300000,113652,Aimé Allain,-167285,19063,2022-01-02
CASH_OUT,9852,Aimé Allain,19063,9211,Agence_moov_Ouidah,300000,290148,2022-01-07
CASH_OUT,3386,Aimé Allain,9211,5825,Agence_moov_Abomey,300000,296614,2022-01-09
CASH_IN,188505,Agence_moov_Ouidah,300000,111495,Aimé Allain,5825,194330,2022-01-10
CASH_IN,275917,Agence_moov_Abomey,300000,24083,Aimé Allain,194330,470247,2022-01-14
CASH_OUT,47312,Aimé Allain,470247,422935,Agence_moov_Ouidah,300000,252688,2022-01-14
CASH_OUT,141639,Aimé Allain,422935,281296,Agence_moov_Ouidah,300000,158361,2022-01-14
TRANSFER,400,Antoine Bourdon de Auger,7252,6852,Aimé Allain,281296,281696,2022-01-16
CASH_IN,279793,Agence_moov_Ouidah,300000,20207,Aimé Allain,281696,561489,2022-01-18
CASH_OUT,259314,Aimé Allain,561489,302175,Agence_moov_Cotonou,300000,40686,2022-01-18
CASH_IN,97274,Agence_moov_Abomey,300000,202726,Aimé Allain,302175,399449,2022-01-19
CASH_OUT,214169,Aimé Allain,399449,185280,Agence_moov_Cotonou,300000,85831,2022-01-19
CASH_OUT,98350,Aimé Allain,185280,86930,Agence_moov_Ouidah,300000,201650,2022-01-20
CASH_OUT,30341,Aimé Allain,86930,56589,Agence_moov_Ouidah,300000,269659,2022-01-23
CASH_IN,177832,Agence_moov_Ouidah,300000,122168,Émilie Guillon de Duhamel,-98786,79046,2022-01-07
CASH_OUT,50086,Émilie Guillon de Duhamel,79046,28960,Agence_moov_Cotonou,300000,249914,2022-01-07
CASH_IN,156796,Agence_moov_Abomey,300000,143204,Émilie Guillon de Duhamel,28960,185756,2022-01-10
TRANSFER,43891,Émilie Guillon de Duhamel,185756,141865,Clémence Bertin,827038,783147,2022-01-14
TRANSFER,89453,Alexandre Poirier,101159,11706,Émilie Guillon de Duhamel,141865,231318,2022-01-16
CASH_IN,293099,Agence_moov_Ouidah,300000,6901,Émilie Guillon de Duhamel,231318,524417,2022-01-23
TRANSFER,713410,Clémence Bertin,783147,69737,Frédérique Robin,1260278,1973688,2022-01-01
CASH_IN,108781,Agence_moov_Ouidah,300000,191219,Frédérique Robin,1973688,2082469,2022-01-03
CASH_OUT,1558117,Frédérique Robin,2082469,524352,Agence_moov_Abomey,300000,-1258117,2022-01-03
TRANSFER,228060,Lucy Vaillant,1048698,820638,Frédérique Robin,524352,752412,2022-01-05
CASH_OUT,341938,Frédérique Robin,752412,410474,Agence_moov_Abomey,300000,-41938,2022-01-07
CASH_OUT,323621,Frédérique Robin,410474,86853,Agence_moov_Ouidah,300000,-23621,2022-01-09
TRANSFER,181209,Noémi de la Didier,294111,112902,Frédérique Robin,86853,268062,2022-01-09
TRANSFER,1806641,Émile Hebert,1877400,70759,Frédérique Robin,268062,2074703,2022-01-11
CASH_IN,31267,Agence_moov_Ouidah,300000,268733,Frédérique Robin,2074703,2105970,2022-01-14
TRANSFER,637,Marianne Descamps,8335,7698,Frédérique Robin,2105970,2106607,2022-01-14
TRANSFER,4900,Marianne Descamps,7698,2798,Frédérique Robin,2106607,2111507,2022-01-16
CASH_IN,243556,Agence_moov_Ouidah,300000,56444,Frédérique Robin,2111507,2355063,2022-01-20
CASH_IN,227098,Agence_moov_Cotonou,300000,72902,Frédérique Robin,2355063,2582161,2022-01-22
CASH_IN,64864,Agence_moov_Cotonou,300000,235136,Paul De Sousa,-105656,-40792,2022-01-02
CASH_IN,49462,Agence_moov_Ouidah,300000,250538,Paul De Sousa,-40792,8670,2022-01-02
TRANSFER,88050,Océane Boutin,160711,72661,Paul De Sousa,8670,96720,2022-01-03
TRANSFER,94652,Paul De Sousa,96720,2068,Marianne Descamps,2798,-91854,2022-01-06
CASH_IN,93918,Agence_moov_Ouidah,300000,206082,Paul De Sousa,2068,95986,2022-01-06
TRANSFER,7368,Nicole Lacroix,7410,42,Paul De Sousa,95986,103354,2022-01-07
TRANSFER,80101,Paul De Sousa,103354,23253,Amélie de la Picard,27008,-53093,2022-01-07
CASH_IN,281017,Agence_moov_Ouidah,300000,18983,Paul De Sousa,23253,304270,2022-01-07
CASH_OUT,303368,Paul De Sousa,304270,902,Agence_moov_Cotonou,300000,-3368,2022-01-11
CASH_OUT,319,Paul De Sousa,902,583,Agence_moov_Ouidah,300000,299681,2022-01-12
CASH_OUT,277,Paul De Sousa,583,306,Agence_moov_Cotonou,300000,299723,2022-01-13
CASH_OUT,105,Paul De Sousa,306,201,Agence_moov_Ouidah,300000,299895,2022-01-14
CASH_IN,200207,Agence_moov_Cotonou,300000,99793,Paul De Sousa,201,200408,2022-01-14
CASH_IN,99509,Agence_moov_Ouidah,300000,200491,Paul De Sousa,200408,299917,2022-01-16
TRANSFER,70883,Paul De Sousa,299917,229034,Marc Gilbert,47316,-23567,2022-01-20
CASH_IN,231107,Agence_moov_Ouidah,300000,68893,Paul De Sousa,229034,460141,2022-01-22
TRANSFER,1096892,Christophe Guilbert,1503388,406496,Paul De Sousa,460141,1557033,2022-01-23
CASH_OUT,1555292,Paul De Sousa,1557033,1741,Agence_moov_Ouidah,300000,-1255292,2022-01-23
CASH_OUT,1536,Paul De Sousa,1741,205,Agence_moov_Ouidah,300000,298464,2022-01-25
TRANSFER,659252,Christophe Alexandre,1268871,609619,Paul De Sousa,205,659457,2022-01-27
TRANSFER,995927,Caroline Monnier,1553438,557511,Susan de Fontaine,45779,1041706,2022-01-03
CASH_OUT,68581,Susan de Fontaine,1041706,973125,Agence_moov_Ouidah,300000,231419,2022-01-07
TRANSFER,487672,Élodie Gérard,771483,283811,Susan de Fontaine,973125,1460797,2022-01-08
CASH_OUT,816902,Susan de Fontaine,1460797,643895,Agence_moov_Cotonou,300000,-516902,2022-01-09
TRANSFER,252633,Christophe Guilbert,406496,153863,Susan de Fontaine,643895,896528,2022-01-12
TRANSFER,7549,Nicolas Grondin de la Pinto,16269,8720,Susan de Fontaine,896528,904077,2022-01-27
CASH_IN,259626,Agence_moov_Abomey,300000,40374,Joseph de la Dubois,-1226641,-967015,2022-01-01
CASH_IN,86558,Agence_moov_Ouidah,300000,213442,Joseph de la Dubois,-967015,-880457,2022-01-01
CASH_IN,223188,Agence_moov_Ouidah,300000,76812,Joseph de la Dubois,-880457,-657269,2022-01-04
CASH_IN,96715,Agence_moov_Cotonou,300000,203285,Joseph de la Dubois,-657269,-560554,2022-01-08
CASH_IN,83918,Agence_moov_Abomey,300000,216082,Joseph de la Dubois,-560554,-476636,2022-01-14
CASH_IN,107081,Agence_moov_Cotonou,300000,192919,Joseph de la Dubois,-476636,-369555,2022-01-17
CASH_IN,46710,Agence_moov_Abomey,300000,253290,Joseph de la Dubois,-369555,-322845,2022-01-24
CASH_IN,237508,Agence_moov_Cotonou,300000,62492,Joseph de la Dubois,-322845,-85337,2022-01-24
CASH_IN,102009,Agence_moov_Cotonou,300000,197991,Joseph de la Dubois,-85337,16672,2022-01-25
TRANSFER,4043,Joseph de la Dubois,16672,12629,Théodore-Alfred Fournier,293300,289257,2022-01-26
TRANSFER,3955,Joseph de la Dubois,12629,8674,Antoine Bourdon de Auger,6852,2897,2022-01-27
TRANSFER,7396,Joseph de la Dubois,8674,1278,Constance Regnier,156885,149489,2022-01-27
CASH_IN,118174,Agence_moov_Ouidah,300000,181826,Joseph de la Dubois,1278,119452,2022-01-27
CASH_IN,62615,Agence_moov_Ouidah,300000,237385,Benoît Verdier,-95121,-32506,2022-01-03
CASH_IN,185191,Agence_moov_Cotonou,300000,114809,Benoît Verdier,-32506,152685,2022-01-05
CASH_IN,8199,Agence_moov_Cotonou,300000,291801,Benoît Verdier,152685,160884,2022-01-05
CASH_IN,94297,Agence_moov_Cotonou,300000,205703,Benoît Verdier,160884,255181,2022-01-06
CASH_OUT,87253,Benoît Verdier,255181,167928,Agence_moov_Cotonou,300000,212747,2022-01-10
CASH_OUT,46541,Benoît Verdier,167928,121387,Agence_moov_Ouidah,300000,253459,2022-01-15
CASH_OUT,58880,Benoît Verdier,121387,62507,Agence_moov_Cotonou,300000,241120,2022-01-15
CASH_IN,140564,Agence_moov_Cotonou,300000,159436,Benoît Verdier,62507,203071,2022-01-16
TRANSFER,54116,Benoît Verdier,203071,148955,Océane Boutin,72661,18545,2022-01-17
CASH_IN,165994,Agence_moov_Abomey,300000,134006,Benoît Verdier,148955,314949,2022-01-23
TRANSFER,22097,Constance Regnier,149489,127392,Benoît Verdier,314949,337046,2022-01-24
CASH_IN,294810,Agence_moov_Ouidah,300000,5190,Benoît Verdier,337046,631856,2022-01-25
CASH_IN,91909,Agence_moov_Abomey,300000,208091,Lucy Vaillant,820638,912547,2022-01-02
CASH_OUT,863597,Lucy Vaillant,912547,48950,Agence_moov_Abomey,300000,-563597,2022-01-06
CASH_IN,103463,Agence_moov_Cotonou,300000,196537,Lucy Vaillant,48950,152413,2022-01-07
TRANSFER,5461,Lucy Vaillant,152413,146952,Gabriel de Pineau,65175,59714,2022-01-07
CASH_OUT,69714,Lucy Vaillant,146952,77238,Agence_moov_Ouidah,300000,230286,2022-01-10
CASH_OUT,26931,Lucy Vaillant,77238,50307,Agence_moov_Ouidah,300000,273069,2022-01-12
TRANSFER,51529,Constance Regnier,127392,75863,Lucy Vaillant,50307,101836,2022-01-16
CASH_OUT,15146,Lucy Vaillant,101836,86690,Agence_moov_Cotonou,300000,284854,2022-01-17
CASH_OUT,60298,Lucy Vaillant,86690,26392,Agence_moov_Abomey,300000,239702,2022-01-19
TRANSFER,1012,Lucy Vaillant,26392,25380,Gabriel de Pineau,59714,58702,2022-01-25
TRANSFER,100141,Vincent-Grégoire Brunet,285116,184975,Lucy Vaillant,25380,125521,2022-01-27
CASH_IN,260996,Agence_moov_Cotonou,300000,39004,Valentine Traore,1151638,1412634,2022-01-03
CASH_IN,237530,Agence_moov_Ouidah,300000,62470,Valentine Traore,1412634,1650164,2022-01-11
TRANSFER,427521,Valentine Traore,1650164,1222643,Isaac Le Pinto,107347,-320174,2022-01-12
CASH_OUT,115665,Valentine Traore,1222643,1106978,Agence_moov_Cotonou,300000,184335,2022-01-14
CASH_OUT,276550,Valentine Traore,1106978,830428,Agence_moov_Ouidah,300000,23450,2022-01-17
CASH_OUT,199662,Valentine Traore,830428,630766,Agence_moov_Ouidah,300000,100338,2022-01-17
CASH_OUT,529548,Valentine Traore,630766,101218,Agence_moov_Ouidah,300000,-229548,2022-01-19
TRANSFER,28485,Valentine Traore,101218,72733,Christophe Alexandre,609619,581134,2022-01-21
CASH_IN,285498,Agence_moov_Cotonou,300000,14502,Valentine Traore,72733,358231,2022-01-23
CASH_IN,120109,Agence_moov_Ouidah,300000,179891,Valentine Traore,358231,478340,2022-01-23
CASH_OUT,120549,Valentine Traore,478340,357791,Agence_moov_Abomey,300000,179451,2022-01-23
CASH_OUT,34619,Valentine Traore,357791,323172,Agence_moov_Cotonou,300000,265381,2022-01-24
CASH_IN,15680,Agence_moov_Cotonou,300000,284320,Valentine Traore,323172,338852,2022-01-25
TRANSFER,26249,Gabriel de Pineau,58702,32453,Valentine Traore,338852,365101,2022-01-27
TRANSFER,159715,Valentine Traore,365101,205386,Émile Hebert,70759,-88956,2022-01-27
CASH_IN,122346,Agence_moov_Cotonou,300000,177654,Emmanuel Bousquet,-244020,-121674,2022-01-01
CASH_IN,178270,Agence_moov_Ouidah,300000,121730,Emmanuel Bousquet,-121674,56596,2022-01-01
TRANSFER,22018,Emmanuel Bousquet,56596,34578,Hugues Gay,1066900,1044882,2022-01-04
TRANSFER,33501,Emmanuel Bousquet,34578,1077,Josette Guillon-Leclercq,257986,224485,2022-01-05
CASH_OUT,171,Emmanuel Bousquet,1077,906,Agence_moov_Abomey,300000,299829,2022-01-05
CASH_IN,293130,Agence_moov_Abomey,300000,6870,Emmanuel Bousquet,906,294036,2022-01-06
CASH_OUT,111596,Emmanuel Bousquet,294036,182440,Agence_moov_Ouidah,300000,188404,2022-01-06
TRANSFER,450718,Caroline Monnier,557511,106793,Emmanuel Bousquet,182440,633158,2022-01-07
CASH_OUT,214274,Emmanuel Bousquet,633158,418884,Agence_moov_Cotonou,300000,85726,2022-01-10
CASH_OUT,25288,Emmanuel Bousquet,418884,393596,Agence_moov_Abomey,300000,274712,2022-01-10
CASH_IN,125942,Agence_moov_Cotonou,300000,174058,Emmanuel Bousquet,393596,519538,2022-01-13
CASH_IN,196931,Agence_moov_Abomey,300000,103069,Emmanuel Bousquet,519538,716469,2022-01-14
CASH_IN,195450,Agence_moov_Abomey,300000,104550,Emmanuel Bousquet,716469,911919,2022-01-17
TRANSFER,489663,Emmanuel Bousquet,911919,422256,Antoine Bourdon de Auger,2897,-486766,2022-01-18
TRANSFER,364192,Emmanuel Bousquet,422256,58064,Alexandre Poirier,11706,-352486,2022-01-18
TRANSFER,6302,Nicolas Grondin de la Pinto,8720,2418,Emmanuel Bousquet,58064,64366,2022-01-18
CASH_IN,36079,Agence_moov_Ouidah,300000,263921,Emmanuel Bousquet,64366,100445,2022-01-19
TRANSFER,75897,Emmanuel Bousquet,100445,24548,Amélie Gros-Riou,587148,511251,2022-01-21
CASH_IN,246038,Agence_moov_Abomey,300000,53962,Emmanuel Bousquet,24548,270586,2022-01-22
CASH_IN,102749,Agence_moov_Cotonou,300000,197251,Alphonse Dupont-Petit,-88906,13843,2022-01-01
CASH_IN,133109,Agence_moov_Cotonou,300000,166891,Alphonse Dupont-Petit,13843,146952,2022-01-02
CASH_OUT,144902,Alphonse Dupont-Petit,146952,2050,Agence_moov_Ouidah,300000,155098,2022-01-03
CASH_IN,5931,Agence_moov_Abomey,300000,294069,Alphonse Dupont-Petit,2050,7981,2022-01-03
TRANSFER,7712,Alphonse Dupont-Petit,7981,269,Christophe Guilbert,153863,146151,2022-01-04
CASH_IN,264656,Agence_moov_Cotonou,300000,35344,Alphonse Dupont-Petit,269,264925,2022-01-06
TRANSFER,164078,Alphonse Dupont-Petit,264925,100847,Stéphanie Bonneau,72226,-91852,2022-01-06
CASH_OUT,91140,Alphonse Dupont-Petit,100847,9707,Agence_moov_Abomey,300000,208860,2022-01-08
TRANSFER,19023,Gabriel de Pineau,32453,13430,Alphonse Dupont-Petit,9707,28730,2022-01-09
CASH_IN,126307,Agence_moov_Abomey,300000,173693,Alphonse Dupont-Petit,28730,155037,2022-01-10
TRANSFER,272639,Théodore-Alfred Fournier,289257,16618,Alphonse Dupont-Petit,155037,427676,2022-01-19
CASH_IN,168027,Agence_moov_Cotonou,300000,131973,Alphonse Dupont-Petit,427676,595703,2022-01-20
CASH_IN,160415,Agence_moov_Ouidah,300000,139585,Alphonse Dupont-Petit,595703,756118,2022-01-21
CASH_OUT,424537,Alphonse Dupont-Petit,756118,331581,Agence_moov_Abomey,300000,-124537,2022-01-21
TRANSFER,202672,Alphonse Dupont-Petit,331581,128909,Clémence Bertin,69737,-132935,2022-01-23
CASH_IN,272145,Agence_moov_Ouidah,300000,27855,Alphonse Dupont-Petit,128909,401054,2022-01-24
CASH_OUT,146809,Alphonse Dupont-Petit,401054,254245,Agence_moov_Cotonou,300000,153191,2022-01-26
CASH_OUT,210203,Alphonse Dupont-Petit,254245,44042,Agence_moov_Cotonou,300000,89797,2022-01-26
CASH_IN,116868,Agence_moov_Abomey,300000,183132,Alphonse Dupont-Petit,44042,160910,2022-01-27
CASH_IN,183775,Agence_moov_Abomey,300000,116225,Agnès Chrétien-Sanchez,1046260,1230035,2022-01-04
TRANSFER,189770,Agnès Chrétien-Sanchez,1230035,1040265,Constance Regnier,75863,-113907,2022-01-07
CASH_OUT,957973,Agnès Chrétien-Sanchez,1040265,82292,Agence_moov_Ouidah,300000,-657973,2022-01-07
CASH_OUT,45559,Agnès Chrétien-Sanchez,82292,36733,Agence_moov_Abomey,300000,254441,2022-01-07
TRANSFER,44933,Caroline Monnier,106793,61860,Agnès Chrétien-Sanchez,36733,81666,2022-01-09
CASH_IN,233392,Agence_moov_Ouidah,300000,66608,Agnès Chrétien-Sanchez,81666,315058,2022-01-10
CASH_IN,33608,Agence_moov_Cotonou,300000,266392,Agnès Chrétien-Sanchez,315058,348666,2022-01-10
TRANSFER,177195,Agnès Chrétien-Sanchez,348666,171471,Gabriel de Pineau,13430,-163765,2022-01-11
TRANSFER,2849,Caroline Monnier,61860,59011,Agnès Chrétien-Sanchez,171471,174320,2022-01-13
CASH_IN,55646,Agence_moov_Cotonou,300000,244354,Agnès Chrétien-Sanchez,174320,229966,2022-01-16
CASH_IN,253706,Agence_moov_Abomey,300000,46294,Agnès Chrétien-Sanchez,229966,483672,2022-01-20
CASH_OUT,325385,Agnès Chrétien-Sanchez,483672,158287,Agence_moov_Ouidah,300000,-25385,2022-01-21
CASH_IN,295728,Agence_moov_Ouidah,300000,4272,Agnès Chrétien-Sanchez,158287,454015,2022-01-22
CASH_IN,290175,Agence_moov_Ouidah,300000,9825,Agnès Chrétien-Sanchez,454015,744190,2022-01-22
CASH_IN,213282,Agence_moov_Abomey,300000,86718,Agnès Chrétien-Sanchez,744190,957472,2022-01-22
CASH_OUT,236057,Agnès Chrétien-Sanchez,957472,721415,Agence_moov_Abomey,300000,63943,2022-01-26
CASH_IN,154622,Agence_moov_Abomey,300000,145378,Océane Boutin,18545,173167,2022-01-01
TRANSFER,408456,Hugues Gay,1044882,636426,Océane Boutin,173167,581623,2022-01-02
TRANSFER,177892,Hugues Gay,636426,458534,Océane Boutin,581623,759515,2022-01-04
TRANSFER,3047,Théodore-Alfred Fournier,16618,13571,Océane Boutin,759515,762562,2022-01-04
CASH_OUT,694424,Océane Boutin,762562,68138,Agence_moov_Ouidah,300000,-394424,2022-01-08
CASH_IN,7233,Agence_moov_Abomey,300000,292767,Océane Boutin,68138,75371,2022-01-09
CASH_OUT,6246,Océane Boutin,75371,69125,Agence_moov_Abomey,300000,293754,2022-01-09
CASH_IN,111807,Agence_moov_Ouidah,300000,188193,Océane Boutin,69125,180932,2022-01-09
CASH_IN,260289,Agence_moov_Cotonou,300000,39711,Océane Boutin,180932,441221,2022-01-11
CASH_IN,109783,Agence_moov_Cotonou,300000,190217,Océane Boutin,441221,551004,2022-01-11
TRANSFER,207281,Élodie Gérard,283811,76530,Océane Boutin,551004,758285,2022-01-18
CASH_OUT,710061,Océane Boutin,758285,48224,Agence_moov_Ouidah,300000,-410061,2022-01-19
CASH_OUT,368,Océane Boutin,48224,47856,Agence_moov_Cotonou,300000,299632,2022-01-20
CASH_IN,96386,Agence_moov_Abomey,300000,203614,Océane Boutin,47856,144242,2022-01-21
TRANSFER,65597,Noémi de la Didier,112902,47305,Océane Boutin,144242,209839,2022-01-26
CASH_OUT,197347,Hugues Gay,458534,261187,Agence_moov_Abomey,300000,102653,2022-01-02
TRANSFER,135129,Hugues Gay,261187,126058,Hugues Gay,261187,396316,2022-01-03
CASH_IN,39973,Agence_moov_Cotonou,300000,260027,Hugues Gay,126058,166031,2022-01-05
CASH_OUT,153880,Hugues Gay,166031,12151,Agence_moov_Ouidah,300000,146120,2022-01-06
CASH_IN,48310,Agence_moov_Ouidah,300000,251690,Hugues Gay,12151,60461,2022-01-08
CASH_IN,287357,Agence_moov_Ouidah,300000,12643,Hugues Gay,60461,347818,2022-01-10
CASH_OUT,346796,Hugues Gay,347818,1022,Agence_moov_Cotonou,300000,-46796,2022-01-11
CASH_OUT,116,Hugues Gay,1022,906,Agence_moov_Abomey,300000,299884,2022-01-11
CASH_IN,70423,Agence_moov_Cotonou,300000,229577,Hugues Gay,906,71329,2022-01-13
CASH_OUT,68259,Hugues Gay,71329,3070,Agence_moov_Cotonou,300000,231741,2022-01-20
CASH_IN,200439,Agence_moov_Cotonou,300000,99561,Hugues Gay,3070,203509,2022-01-21
CASH_OUT,60826,Hugues Gay,203509,142683,Agence_moov_Cotonou,300000,239174,2022-01-23
CASH_OUT,128310,Hugues Gay,142683,14373,Agence_moov_Abomey,300000,171690,2022-01-24
CASH_IN,2596,Agence_moov_Ouidah,300000,297404,Hugues Gay,14373,16969,2022-01-25
TRANSFER,32197,Noémi de la Didier,47305,15108,Hugues Gay,16969,49166,2022-01-26
CASH_IN,208038,Agence_moov_Ouidah,300000,91962,Sébastien-Arthur Masse,-395648,-187610,2022-01-05
CASH_IN,126106,Agence_moov_Ouidah,300000,173894,Sébastien-Arthur Masse,-187610,-61504,2022-01-09
CASH_IN,16785,Agence_moov_Ouidah,300000,283215,Sébastien-Arthur Masse,-61504,-44719,2022-01-17
CASH_IN,161003,Agence_moov_Ouidah,300000,138997,Sébastien-Arthur Masse,-44719,116284,2022-01-19
CASH_IN,198084,Agence_moov_Cotonou,300000,101916,Sébastien-Arthur Masse,116284,314368,2022-01-23
TRANSFER,209846,Sébastien-Arthur Masse,314368,104522,Noémi de la Didier,15108,-194738,2022-01-27
CASH_IN,149014,Agence_moov_Cotonou,300000,150986,Stéphane-Timothée Pineau,-81264,67750,2022-01-01
CASH_OUT,1580,Stéphane-Timothée Pineau,67750,66170,Agence_moov_Ouidah,300000,298420,2022-01-05
CASH_OUT,54640,Stéphane-Timothée Pineau,66170,11530,Agence_moov_Cotonou,300000,245360,2022-01-05
CASH_IN,33975,Agence_moov_Ouidah,300000,266025,Stéphane-Timothée Pineau,11530,45505,2022-01-06
TRANSFER,5106,Stéphane-Timothée Pineau,45505,40399,Caroline Monnier,59011,53905,2022-01-07
TRANSFER,76186,Élodie Gérard,76530,344,Stéphane-Timothée Pineau,40399,116585,2022-01-09
CASH_OUT,23100,Stéphane-Timothée Pineau,116585,93485,Agence_moov_Ouidah,300000,276900,2022-01-10
CASH_IN,149563,Agence_moov_Abomey,300000,150437,Stéphane-Timothée Pineau,93485,243048,2022-01-10
CASH_IN,63071,Agence_moov_Ouidah,300000,236929,Stéphane-Timothée Pineau,243048,306119,2022-01-10
TRANSFER,102324,Christophe Alexandre,581134,478810,Stéphane-Timothée Pineau,306119,408443,2022-01-13
CASH_OUT,222061,Stéphane-Timothée Pineau,408443,186382,Agence_moov_Ouidah,300000,77939,2022-01-13
CASH_OUT,162278,Stéphane-Timothée Pineau,186382,24104,Agence_moov_Cotonou,300000,137722,2022-01-16
CASH_OUT,7770,Stéphane-Timothée Pineau,24104,16334,Agence_moov_Cotonou,300000,292230,2022-01-17
TRANSFER,4874,Stéphane-Timothée Pineau,16334,11460,Nicolas Grondin de la Pinto,2418,-2456,2022-01-18
CASH_OUT,1634,Stéphane-Timothée Pineau,11460,9826,Agence_moov_Abomey,300000,298366,2022-01-19
CASH_IN,152933,Agence_moov_Cotonou,300000,147067,Stéphane-Timothée Pineau,9826,162759,2022-01-21
CASH_OUT,90092,Stéphane-Timothée Pineau,162759,72667,Agence_moov_Cotonou,300000,209908,2022-01-24
CASH_IN,259392,Agence_moov_Abomey,300000,40608,Stéphane-Timothée Pineau,72667,332059,2022-01-24
CASH_OUT,321815,Stéphane-Timothée Pineau,332059,10244,Agence_moov_Cotonou,300000,-21815,2022-01-25
TRANSFER,201258,Josette Guillon-Leclercq,224485,23227,Élodie Gérard,344,-200914,2022-01-03
CASH_IN,56950,Agence_moov_Cotonou,300000,243050,Josette Guillon-Leclercq,23227,80177,2022-01-04
TRANSFER,43412,Josette Guillon-Leclercq,80177,36765,Christophe Guilbert,146151,102739,2022-01-09
CASH_IN,212369,Agence_moov_Ouidah,300000,87631,Josette Guillon-Leclercq,36765,249134,2022-01-10
TRANSFER,335063,Christophe Alexandre,478810,143747,Josette Guillon-Leclercq,249134,584197,2022-01-16
CASH_OUT,526274,Josette Guillon-Leclercq,584197,57923,Agence_moov_Ouidah,300000,-226274,2022-01-19
CASH_IN,279407,Agence_moov_Abomey,300000,20593,Josette Guillon-Leclercq,57923,337330,2022-01-23
TRANSFER,4932,Caroline Monnier,53905,48973,Christophe Guilbert,102739,107671,2022-01-03
CASH_OUT,30687,Christophe Guilbert,107671,76984,Agence_moov_Cotonou,300000,269313,2022-01-06
CASH_OUT,64311,Christophe Guilbert,76984,12673,Agence_moov_Abomey,300000,235689,2022-01-06
CASH_IN,163765,Agence_moov_Ouidah,300000,136235,Christophe Guilbert,12673,176438,2022-01-08
CASH_OUT,118894,Christophe Guilbert,176438,57544,Agence_moov_Ouidah,300000,181106,2022-01-10
TRANSFER,265258,Christine-Constance Gauthier,639662,374404,Christophe Guilbert,57544,322802,2022-01-10
CASH_IN,282405,Agence_moov_Cotonou,300000,17595,Christophe Guilbert,322802,605207,2022-01-11
CASH_OUT,476838,Christophe Guilbert,605207,128369,Agence_moov_Cotonou,300000,-176838,2022-01-12
CASH_IN,70807,Agence_moov_Cotonou,300000,229193,Christophe Guilbert,128369,199176,2022-01-14
CASH_OUT,55002,Christophe Guilbert,199176,144174,Agence_moov_Cotonou,300000,244998,2022-01-14
CASH_OUT,143923,Christophe Guilbert,144174,251,Agence_moov_Ouidah,300000,156077,2022-01-16
TRANSFER,193,Christophe Guilbert,251,58,Christine-Constance Gauthier,374404,374211,2022-01-20
CASH_IN,93620,Agence_moov_Ouidah,300000,206380,Christophe Guilbert,58,93678,2022-01-21
TRANSFER,61652,Christophe Guilbert,93678,32026,Roland Colin,165869,104217,2022-01-22
CASH_OUT,18823,Christophe Guilbert,32026,13203,Agence_moov_Cotonou,300000,281177,2022-01-24
TRANSFER,6494,Christophe Guilbert,13203,6709,Vincent-Grégoire Brunet,184975,178481,2022-01-24
CASH_OUT,1306,Christophe Guilbert,6709,5403,Agence_moov_Cotonou,300000,298694,2022-01-24
CASH_IN,90503,Agence_moov_Ouidah,300000,209497,Christophe Guilbert,5403,95906,2022-01-26
CASH_IN,230881,Agence_moov_Ouidah,300000,69119,Christine-Constance Gauthier,374211,605092,2022-01-05
TRANSFER,513466,Christine-Constance Gauthier,605092,91626,Christophe Alexandre,143747,-369719,2022-01-09
CASH_OUT,79283,Christine-Constance Gauthier,91626,12343,Agence_moov_Cotonou,300000,220717,2022-01-15
CASH_IN,141934,Agence_moov_Ouidah,300000,158066,Christine-Constance Gauthier,12343,154277,2022-01-16
CASH_IN,234825,Agence_moov_Abomey,300000,65175,Christine-Constance Gauthier,154277,389102,2022-01-17
TRANSFER,239518,Christine-Constance Gauthier,389102,149584,Amélie Gros-Riou,511251,271733,2022-01-17
TRANSFER,55811,Christine-Constance Gauthier,149584,93773,Amélie Gros-Riou,271733,215922,2022-01-17
CASH_IN,127693,Agence_moov_Cotonou,300000,172307,Christine-Constance Gauthier,93773,221466,2022-01-26
TRANSFER,147318,Christine-Constance Gauthier,221466,74148,Vincent-Grégoire Brunet,178481,31163,2022-01-27
CASH_IN,213813,Agence_moov_Abomey,300000,86187,Stéphanie Bonneau,-91852,121961,2022-01-01
CASH_OUT,56759,Stéphanie Bonneau,121961,65202,Agence_moov_Ouidah,300000,243241,2022-01-04
CASH_IN,62796,Agence_moov_Ouidah,300000,237204,Stéphanie Bonneau,65202,127998,2022-01-05
CASH_IN,45435,Agence_moov_Cotonou,300000,254565,Stéphanie Bonneau,127998,173433,2022-01-08
CASH_IN,112420,Agence_moov_Cotonou,300000,187580,Stéphanie Bonneau,173433,285853,2022-01-08
CASH_IN,249728,Agence_moov_Ouidah,300000,50272,Stéphanie Bonneau,285853,535581,2022-01-08
CASH_IN,46155,Agence_moov_Abomey,300000,253845,Stéphanie Bonneau,535581,581736,2022-01-10
CASH_OUT,580916,Stéphanie Bonneau,581736,820,Agence_moov_Cotonou,300000,-280916,2022-01-13
CASH_OUT,529,Stéphanie Bonneau,820,291,Agence_moov_Ouidah,300000,299471,2022-01-13
CASH_OUT,162,Stéphanie Bonneau,291,129,Agence_moov_Ouidah,300000,299838,2022-01-19
CASH_OUT,116,Stéphanie Bonneau,129,13,Agence_moov_Ouidah,300000,299884,2022-01-26
CASH_IN,212946,Agence_moov_Ouidah,300000,87054,Constance Regnier,-113907,99039,2022-01-02
CASH_IN,256537,Agence_moov_Ouidah,300000,43463,Constance Regnier,99039,355576,2022-01-03
TRANSFER,210073,Constance Regnier,355576,145503,Vincent-Grégoire Brunet,31163,-178910,2022-01-06
TRANSFER,60982,Roland Colin,104217,43235,Constance Regnier,145503,206485,2022-01-10
CASH_IN,271230,Agence_moov_Ouidah,300000,28770,Constance Regnier,206485,477715,2022-01-13
CASH_IN,293142,Agence_moov_Ouidah,300000,6858,Constance Regnier,477715,770857,2022-01-16
TRANSFER,43159,Caroline Monnier,48973,5814,Constance Regnier,770857,814016,2022-01-24
TRANSFER,365300,Constance Regnier,814016,448716,Caroline Monnier,5814,-359486,2022-01-26
CASH_OUT,61207,Constance Regnier,448716,387509,Agence_moov_Ouidah,300000,238793,2022-01-27
CASH_IN,166550,Agence_moov_Cotonou,300000,133450,Caroline Peltier,-327685,-161135,2022-01-03
CASH_IN,217709,Agence_moov_Abomey,300000,82291,Caroline Peltier,-161135,56574,2022-01-05
TRANSFER,161593,Amélie Gros-Riou,215922,54329,Caroline Peltier,56574,218167,2022-01-06
CASH_IN,119954,Agence_moov_Cotonou,300000,180046,Caroline Peltier,218167,338121,2022-01-11
CASH_IN,41472,Agence_moov_Cotonou,300000,258528,Caroline Peltier,338121,379593,2022-01-12
TRANSFER,3363,Théodore-Alfred Fournier,13571,10208,Caroline Peltier,379593,382956,2022-01-13
CASH_IN,240368,Agence_moov_Abomey,300000,59632,Caroline Peltier,382956,623324,2022-01-14
CASH_OUT,255299,Caroline Peltier,623324,368025,Agence_moov_Ouidah,300000,44701,2022-01-14
CASH_IN,83450,Agence_moov_Cotonou,300000,216550,Caroline Peltier,368025,451475,2022-01-16
CASH_OUT,151642,Caroline Peltier,451475,299833,Agence_moov_Abomey,300000,148358,2022-01-17
CASH_IN,259445,Agence_moov_Ouidah,300000,40555,Caroline Peltier,299833,559278,2022-01-18
CASH_IN,268943,Agence_moov_Ouidah,300000,31057,Caroline Peltier,559278,828221,2022-01-19
CASH_IN,158487,Agence_moov_Abomey,300000,141513,Caroline Peltier,828221,986708,2022-01-20
CASH_OUT,337029,Caroline Peltier,986708,649679,Agence_moov_Abomey,300000,-37029,2022-01-23
TRANSFER,490060,Caroline Peltier,649679,159619,Théodore-Alfred Fournier,10208,-479852,2022-01-23
CASH_OUT,31485,Caroline Peltier,159619,128134,Agence_moov_Cotonou,300000,268515,2022-01-23
TRANSFER,59224,Caroline Peltier,128134,68910,Roland Colin,43235,-15989,2022-01-24
CASH_IN,108299,Agence_moov_Ouidah,300000,191701,Caroline Peltier,68910,177209,2022-01-25
CASH_OUT,120886,Caroline Peltier,177209,56323,Agence_moov_Abomey,300000,179114,2022-01-27
CASH_IN,222203,Agence_moov_Cotonou,300000,77797,Clémence Bertin,-132935,89268,2022-01-03
CASH_OUT,18008,Clémence Bertin,89268,71260,Agence_moov_Cotonou,300000,281992,2022-01-04
CASH_IN,69854,Agence_moov_Ouidah,300000,230146,Clémence Bertin,71260,141114,2022-01-06
CASH_OUT,132135,Clémence Bertin,141114,8979,Agence_moov_Ouidah,300000,167865,2022-01-07
TRANSFER,5805,Clémence Bertin,8979,3174,Clémence Bertin,8979,14784,2022-01-07
TRANSFER,1231,Clémence Bertin,3174,1943,Clémence Bertin,3174,1943,2022-01-10
TRANSFER,1715,Clémence Bertin,1943,228,Clémence Bertin,1943,3658,2022-01-12
CASH_OUT,202,Clémence Bertin,228,26,Agence_moov_Abomey,300000,299798,2022-01-13
CASH_IN,231077,Agence_moov_Cotonou,300000,68923,Clémence Bertin,26,231103,2022-01-15
CASH_OUT,48952,Clémence Bertin,231103,182151,Agence_moov_Cotonou,300000,251048,2022-01-20
CASH_OUT,175043,Clémence Bertin,182151,7108,Agence_moov_Cotonou,300000,124957,2022-01-27
CASH_IN,122077,Agence_moov_Ouidah,300000,177923,Isaac Le Pinto,-320174,-198097,2022-01-01
CASH_IN,97549,Agence_moov_Cotonou,300000,202451,Isaac Le Pinto,-198097,-100548,2022-01-02
CASH_IN,247516,Agence_moov_Abomey,300000,52484,Isaac Le Pinto,-100548,146968,2022-01-03
CASH_IN,72378,Agence_moov_Ouidah,300000,227622,Isaac Le Pinto,146968,219346,2022-01-08
CASH_OUT,75875,Isaac Le Pinto,219346,143471,Agence_moov_Cotonou,300000,224125,2022-01-09
CASH_IN,22898,Agence_moov_Abomey,300000,277102,Isaac Le Pinto,143471,166369,2022-01-10
CASH_IN,210428,Agence_moov_Ouidah,300000,89572,Isaac Le Pinto,166369,376797,2022-01-10
CASH_IN,70432,Agence_moov_Cotonou,300000,229568,Isaac Le Pinto,376797,447229,2022-01-11
CASH_IN,191276,Agence_moov_Abomey,300000,108724,Isaac Le Pinto,447229,638505,2022-01-11
CASH_IN,114942,Agence_moov_Abomey,300000,185058,Isaac Le Pinto,638505,753447,2022-01-12
CASH_OUT,372509,Isaac Le Pinto,753447,380938,Agence_moov_Abomey,300000,-72509,2022-01-12
CASH_IN,280169,Agence_moov_Cotonou,300000,19831,Isaac Le Pinto,380938,661107,2022-01-13
TRANSFER,33649,Isaac Le Pinto,661107,627458,Isaac Le Pinto,661107,694756,2022-01-14
CASH_IN,246720,Agence_moov_Abomey,300000,53280,Isaac Le Pinto,627458,874178,2022-01-18
CASH_IN,102154,Agence_moov_Abomey,300000,197846,Isaac Le Pinto,874178,976332,2022-01-19
CASH_IN,104475,Agence_moov_Abomey,300000,195525,Isaac Le Pinto,976332,1080807,2022-01-19
CASH_OUT,961120,Isaac Le Pinto,1080807,119687,Agence_moov_Cotonou,300000,-661120,2022-01-25
CASH_IN,30362,Agence_moov_Abomey,300000,269638,Isaac Le Pinto,119687,150049,2022-01-26
CASH_IN,125983,Agence_moov_Abomey,300000,174017,Émile Hebert,-88956,37027,2022-01-10
CASH_IN,253356,Agence_moov_Ouidah,300000,46644,Émile Hebert,37027,290383,2022-01-14
TRANSFER,139770,Émile Hebert,290383,150613,Émile Hebert,290383,150613,2022-01-18
CASH_OUT,125741,Émile Hebert,150613,24872,Agence_moov_Ouidah,300000,174259,2022-01-20
CASH_OUT,2087,Émile Hebert,24872,22785,Agence_moov_Ouidah,300000,297913,2022-01-24
CASH_IN,169383,Agence_moov_Ouidah,300000,130617,Émile Hebert,22785,192168,2022-01-25
CASH_IN,99042,Agence_moov_Cotonou,300000,200958,Agnès Baron,-1448376,-1349334,2022-01-02
CASH_IN,135731,Agence_moov_Cotonou,300000,164269,Agnès Baron,-1349334,-1213603,2022-01-07
CASH_IN,233607,Agence_moov_Cotonou,300000,66393,Agnès Baron,-1213603,-979996,2022-01-07
CASH_IN,113786,Agence_moov_Abomey,300000,186214,Agnès Baron,-979996,-866210,2022-01-11
CASH_IN,51023,Agence_moov_Ouidah,300000,248977,Agnès Baron,-866210,-815187,2022-01-11
CASH_IN,275962,Agence_moov_Ouidah,300000,24038,Agnès Baron,-815187,-539225,2022-01-12
CASH_IN,238282,Agence_moov_Ouidah,300000,61718,Agnès Baron,-539225,-300943,2022-01-16
CASH_IN,240720,Agence_moov_Ouidah,300000,59280,Agnès Baron,-300943,-60223,2022-01-25
CASH_IN,143490,Agence_moov_Ouidah,300000,156510,Marc Gilbert,-23567,119923,2022-01-01
TRANSFER,95851,Marc Gilbert,119923,24072,Marc Gilbert,119923,24072,2022-01-03
CASH_OUT,6178,Marc Gilbert,24072,17894,Agence_moov_Ouidah,300000,293822,2022-01-03
CASH_OUT,8589,Marc Gilbert,17894,9305,Agence_moov_Abomey,300000,291411,2022-01-04
CASH_IN,154528,Agence_moov_Ouidah,300000,145472,Marc Gilbert,9305,163833,2022-01-04
TRANSFER,161865,Marc Gilbert,163833,1968,Marc Gilbert,163833,325698,2022-01-04
CASH_IN,132067,Agence_moov_Cotonou,300000,167933,Marc Gilbert,1968,134035,2022-01-05
CASH_IN,223032,Agence_moov_Abomey,300000,76968,Marc Gilbert,134035,357067,2022-01-09
CASH_OUT,188660,Marc Gilbert,357067,168407,Agence_moov_Cotonou,300000,111340,2022-01-16
CASH_IN,55636,Agence_moov_Abomey,300000,244364,Marc Gilbert,168407,224043,2022-01-19
CASH_IN,69637,Agence_moov_Abomey,300000,230363,Marc Gilbert,224043,293680,2022-01-23
CASH_IN,131919,Agence_moov_Ouidah,300000,168081,Marc Gilbert,293680,425599,2022-01-26
CASH_IN,63400,Agence_moov_Abomey,300000,236600,Frédéric Moreau,-1888012,-1824612,2022-01-02
CASH_IN,23264,Agence_moov_Ouidah,300000,276736,Frédéric Moreau,-1824612,-1801348,2022-01-17
CASH_IN,201580,Agence_moov_Ouidah,300000,98420,Frédéric Moreau,-1801348,-1599768,2022-01-18
CASH_IN,176512,Agence_moov_Cotonou,300000,123488,Frédéric Moreau,-1599768,-1423256,2022-01-19
CASH_IN,293236,Agence_moov_Cotonou,300000,6764,Frédéric Moreau,-1423256,-1130020,2022-01-20
CASH_IN,105079,Agence_moov_Ouidah,300000,194921,Frédéric Moreau,-1130020,-1024941,2022-01-23
CASH_IN,220739,Agence_moov_Cotonou,300000,79261,Frédéric Moreau,-1024941,-804202,2022-01-26
CASH_IN,30171,Agence_moov_Ouidah,300000,269829,Richard Guibert,-213165,-182994,2022-01-01
CASH_IN,89340,Agence_moov_Ouidah,300000,210660,Richard Guibert,-182994,-93654,2022-01-01
CASH_IN,137579,Agence_moov_Ouidah,300000,162421,Richard Guibert,-93654,43925,2022-01-02
CASH_IN,149832,Agence_moov_Cotonou,300000,150168,Richard Guibert,43925,193757,2022-01-03
CASH_IN,118550,Agence_moov_Ouidah,300000,181450,Richard Guibert,193757,312307,2022-01-03
TRANSFER,49736,Richard Guibert,312307,262571,Richard Guibert,312307,262571,2022-01-10
CASH_OUT,111889,Richard Guibert,262571,150682,Agence_moov_Ouidah,300000,188111,2022-01-10
CASH_OUT,55247,Richard Guibert,150682,95435,Agence_moov_Abomey,300000,244753,2022-01-11
CASH_OUT,15654,Richard Guibert,95435,79781,Agence_moov_Cotonou,300000,284346,2022-01-12
CASH_IN,269803,Agence_moov_Abomey,300000,30197,Théodore-Alfred Fournier,-479852,-210049,2022-01-04
CASH_IN,134060,Agence_moov_Abomey,300000,165940,Théodore-Alfred Fournier,-210049,-75989,2022-01-05
CASH_IN,224356,Agence_moov_Abomey,300000,75644,Théodore-Alfred Fournier,-75989,148367,2022-01-08
CASH_OUT,74438,Théodore-Alfred Fournier,148367,73929,Agence_moov_Cotonou,300000,225562,2022-01-22
CASH_OUT,64118,Théodore-Alfred Fournier,73929,9811,Agence_moov_Cotonou,300000,235882,2022-01-27
CASH_IN,139464,Agence_moov_Abomey,300000,160536,Vincent-Grégoire Brunet,-178910,-39446,2022-01-04
CASH_IN,179431,Agence_moov_Ouidah,300000,120569,Vincent-Grégoire Brunet,-39446,139985,2022-01-05
CASH_OUT,71020,Vincent-Grégoire Brunet,139985,68965,Agence_moov_Cotonou,300000,228980,2022-01-07
CASH_IN,196899,Agence_moov_Cotonou,300000,103101,Vincent-Grégoire Brunet,68965,265864,2022-01-11
CASH_OUT,66510,Vincent-Grégoire Brunet,265864,199354,Agence_moov_Ouidah,300000,233490,2022-01-19
CASH_IN,238195,Agence_moov_Cotonou,300000,61805,Caroline Monnier,-359486,-121291,2022-01-02
CASH_IN,255459,Agence_moov_Abomey,300000,44541,Caroline Monnier,-121291,134168,2022-01-02
CASH_OUT,64868,Caroline Monnier,134168,69300,Agence_moov_Cotonou,300000,235132,2022-01-05
CASH_IN,272970,Agence_moov_Abomey,300000,27030,Caroline Monnier,69300,342270,2022-01-05
CASH_OUT,306343,Caroline Monnier,342270,35927,Agence_moov_Ouidah,300000,-6343,2022-01-07
CASH_OUT,12107,Caroline Monnier,35927,23820,Agence_moov_Abomey,300000,287893,2022-01-13
CASH_IN,41174,Agence_moov_Cotonou,300000,258826,Caroline Monnier,23820,64994,2022-01-19
CASH_IN,22580,Agence_moov_Ouidah,300000,277420,Caroline Monnier,64994,87574,2022-01-21
CASH_OUT,15229,Caroline Monnier,87574,72345,Agence_moov_Ouidah,300000,284771,2022-01-24
CASH_OUT,17416,Caroline Monnier,72345,54929,Agence_moov_Ouidah,300000,282584,2022-01-26
CASH_IN,294361,Agence_moov_Ouidah,300000,5639,Noémi de la Didier,-194738,99623,2022-01-02
CASH_IN,174271,Agence_moov_Ouidah,300000,125729,Noémi de la Didier,99623,273894,2022-01-09
TRANSFER,145136,Noémi de la Didier,273894,128758,Noémi de la Didier,273894,419030,2022-01-09
TRANSFER,42764,Noémi de la Didier,128758,85994,Noémi de la Didier,128758,171522,2022-01-10
TRANSFER,54162,Noémi de la Didier,85994,31832,Noémi de la Didier,85994,140156,2022-01-16
CASH_IN,299283,Agence_moov_Abomey,300000,717,Noémi de la Didier,31832,331115,2022-01-17
CASH_OUT,226946,Noémi de la Didier,331115,104169,Agence_moov_Cotonou,300000,73054,2022-01-17
CASH_OUT,13989,Noémi de la Didier,104169,90180,Agence_moov_Cotonou,300000,286011,2022-01-20
CASH_OUT,54097,Noémi de la Didier,90180,36083,Agence_moov_Cotonou,300000,245903,2022-01-21
CASH_IN,188781,Agence_moov_Cotonou,300000,111219,Noémi de la Didier,36083,224864,2022-01-22
CASH_IN,206475,Agence_moov_Ouidah,300000,93525,Noémi de la Didier,224864,431339,2022-01-22
CASH_IN,218543,Agence_moov_Ouidah,300000,81457,Noémi de la Didier,431339,649882,2022-01-23
CASH_IN,131611,Agence_moov_Abomey,300000,168389,Roland Colin,-15989,115622,2022-01-08
TRANSFER,61886,Roland Colin,115622,53736,Roland Colin,115622,53736,2022-01-08
CASH_IN,245317,Agence_moov_Ouidah,300000,54683,Roland Colin,53736,299053,2022-01-12
TRANSFER,28495,Roland Colin,299053,270558,Roland Colin,299053,327548,2022-01-12
CASH_OUT,190154,Roland Colin,270558,80404,Agence_moov_Abomey,300000,109846,2022-01-13
CASH_OUT,44569,Roland Colin,80404,35835,Agence_moov_Cotonou,300000,255431,2022-01-14
CASH_IN,242932,Agence_moov_Ouidah,300000,57068,Roland Colin,35835,278767,2022-01-18
CASH_IN,79456,Agence_moov_Abomey,300000,220544,Roland Colin,278767,358223,2022-01-20
CASH_OUT,224616,Roland Colin,358223,133607,Agence_moov_Ouidah,300000,75384,2022-01-22
CASH_OUT,94858,Roland Colin,133607,38749,Agence_moov_Abomey,300000,205142,2022-01-22
CASH_IN,239880,Agence_moov_Abomey,300000,60120,Roland Colin,38749,278629,2022-01-24
CASH_IN,281071,Agence_moov_Abomey,300000,18929,Marianne Descamps,-91854,189217,2022-01-02
CASH_IN,50770,Agence_moov_Ouidah,300000,249230,Marianne Descamps,189217,239987,2022-01-03
CASH_IN,58994,Agence_moov_Ouidah,300000,241006,Marianne Descamps,239987,298981,2022-01-03
CASH_OUT,8047,Marianne Descamps,298981,290934,Agence_moov_Cotonou,300000,291953,2022-01-11
CASH_OUT,180412,Marianne Descamps,290934,110522,Agence_moov_Cotonou,300000,119588,2022-01-12
CASH_IN,182251,Agence_moov_Abomey,300000,117749,Marianne Descamps,110522,292773,2022-01-18
CASH_OUT,8063,Marianne Descamps,292773,284710,Agence_moov_Cotonou,300000,291937,2022-01-23
CASH_OUT,168846,Marianne Descamps,284710,115864,Agence_moov_Cotonou,300000,131154,2022-01-26
CASH_IN,249762,Agence_moov_Cotonou,300000,50238,Luc Camus,-173483,76279,2022-01-04
TRANSFER,4576,Luc Camus,76279,71703,Luc Camus,76279,71703,2022-01-07
TRANSFER,19278,Luc Camus,71703,52425,Luc Camus,71703,52425,2022-01-07
CASH_OUT,38692,Luc Camus,52425,13733,Agence_moov_Ouidah,300000,261308,2022-01-09
CASH_OUT,3222,Luc Camus,13733,10511,Agence_moov_Cotonou,300000,296778,2022-01-10
CASH_IN,290269,Agence_moov_Ouidah,300000,9731,Luc Camus,10511,300780,2022-01-11
TRANSFER,24457,Luc Camus,300780,276323,Luc Camus,300780,276323,2022-01-12
CASH_IN,119839,Agence_moov_Abomey,300000,180161,Luc Camus,276323,396162,2022-01-13
CASH_OUT,136353,Luc Camus,396162,259809,Agence_moov_Cotonou,300000,163647,2022-01-13
CASH_IN,108149,Agence_moov_Ouidah,300000,191851,Luc Camus,259809,367958,2022-01-13
TRANSFER,282597,Luc Camus,367958,85361,Luc Camus,367958,85361,2022-01-15
CASH_IN,79238,Agence_moov_Cotonou,300000,220762,Luc Camus,85361,164599,2022-01-17
CASH_OUT,82304,Luc Camus,164599,82295,Agence_moov_Ouidah,300000,217696,2022-01-18
CASH_OUT,54139,Luc Camus,82295,28156,Agence_moov_Ouidah,300000,245861,2022-01-19
CASH_OUT,6043,Luc Camus,28156,22113,Agence_moov_Cotonou,300000,293957,2022-01-22
CASH_OUT,2210,Luc Camus,22113,19903,Agence_moov_Abomey,300000,297790,2022-01-24
CASH_IN,192857,Agence_moov_Ouidah,300000,107143,Luc Camus,19903,212760,2022-01-24
CASH_IN,80001,Agence_moov_Cotonou,300000,219999,Joséphine Weber du Bonnin,-380934,-300933,2022-01-04
CASH_IN,86503,Agence_moov_Ouidah,300000,213497,Joséphine Weber du Bonnin,-300933,-214430,2022-01-04
CASH_IN,125646,Agence_moov_Abomey,300000,174354,Joséphine Weber du Bonnin,-214430,-88784,2022-01-05
CASH_IN,113576,Agence_moov_Ouidah,300000,186424,Joséphine Weber du Bonnin,-88784,24792,2022-01-10
CASH_IN,127120,Agence_moov_Abomey,300000,172880,Joséphine Weber du Bonnin,24792,151912,2022-01-12
CASH_IN,270831,Agence_moov_Ouidah,300000,29169,Joséphine Weber du Bonnin,151912,422743,2022-01-17
CASH_IN,161212,Agence_moov_Cotonou,300000,138788,Joséphine Weber du Bonnin,422743,583955,2022-01-20
TRANSFER,22536,Joséphine Weber du Bonnin,583955,561419,Joséphine Weber du Bonnin,583955,606491,2022-01-21
TRANSFER,382868,Joséphine Weber du Bonnin,561419,178551,Joséphine Weber du Bonnin,561419,178551,2022-01-21
CASH_IN,290976,Agence_moov_Cotonou,300000,9024,Joséphine Weber du Bonnin,178551,469527,2022-01-22
CASH_IN,633,Agence_moov_Cotonou,300000,299367,Joséphine Weber du Bonnin,469527,470160,2022-01-26
CASH_IN,266413,Agence_moov_Abomey,300000,33587,Christophe Alexandre,-369719,-103306,2022-01-04
CASH_IN,6474,Agence_moov_Cotonou,300000,293526,Christophe Alexandre,-103306,-96832,2022-01-05
CASH_IN,37737,Agence_moov_Abomey,300000,262263,Christophe Alexandre,-96832,-59095,2022-01-06
CASH_IN,74963,Agence_moov_Ouidah,300000,225037,Christophe Alexandre,-59095,15868,2022-01-07
CASH_IN,100242,Agence_moov_Cotonou,300000,199758,Christophe Alexandre,15868,116110,2022-01-07
TRANSFER,112849,Christophe Alexandre,116110,3261,Christophe Alexandre,116110,228959,2022-01-11
CASH_OUT,2903,Christophe Alexandre,3261,358,Agence_moov_Cotonou,300000,297097,2022-01-12
CASH_OUT,251,Christophe Alexandre,358,107,Agence_moov_Abomey,300000,299749,2022-01-17
CASH_OUT,100,Christophe Alexandre,107,7,Agence_moov_Cotonou,300000,299900,2022-01-17
CASH_IN,283394,Agence_moov_Abomey,300000,16606,Christophe Alexandre,7,283401,2022-01-18
CASH_IN,70369,Agence_moov_Abomey,300000,229631,Christophe Alexandre,283401,353770,2022-01-21
CASH_OUT,74974,Christophe Alexandre,353770,278796,Agence_moov_Ouidah,300000,225026,2022-01-21
CASH_OUT,44362,Christophe Alexandre,278796,234434,Agence_moov_Cotonou,300000,255638,2022-01-22
CASH_IN,238128,Agence_moov_Ouidah,300000,61872,Christophe Alexandre,234434,472562,2022-01-24
CASH_OUT,402378,Christophe Alexandre,472562,70184,Agence_moov_Cotonou,300000,-102378,2022-01-25
CASH_IN,22248,Agence_moov_Cotonou,300000,277752,Christophe Alexandre,70184,92432,2022-01-27
CASH_IN,59009,Agence_moov_Abomey,300000,240991,Christophe Alexandre,92432,151441,2022-01-27
CASH_IN,139986,Agence_moov_Ouidah,300000,160014,Augustin Benard,-120720,19266,2022-01-01
CASH_OUT,6005,Augustin Benard,19266,13261,Agence_moov_Cotonou,300000,293995,2022-01-04
TRANSFER,10902,Augustin Benard,13261,2359,Augustin Benard,13261,24163,2022-01-06
CASH_IN,218841,Agence_moov_Cotonou,300000,81159,Augustin Benard,2359,221200,2022-01-09
CASH_IN,266553,Agence_moov_Ouidah,300000,33447,Augustin Benard,221200,487753,2022-01-11
CASH_IN,278501,Agence_moov_Abomey,300000,21499,Augustin Benard,487753,766254,2022-01-12
TRANSFER,439410,Augustin Benard,766254,326844,Augustin Benard,766254,1205664,2022-01-18
CASH_OUT,195089,Augustin Benard,326844,131755,Agence_moov_Cotonou,300000,104911,2022-01-18
CASH_IN,60320,Agence_moov_Cotonou,300000,239680,Augustin Benard,131755,192075,2022-01-22
TRANSFER,58498,Augustin Benard,192075,133577,Augustin Benard,192075,133577,2022-01-24
CASH_IN,44534,Agence_moov_Abomey,300000,255466,Augustin Benard,133577,178111,2022-01-25
CASH_IN,44931,Agence_moov_Cotonou,300000,255069,Augustin Benard,178111,223042,2022-01-25
CASH_OUT,142084,Augustin Benard,223042,80958,Agence_moov_Cotonou,300000,157916,2022-01-26
CASH_OUT,12524,Augustin Benard,80958,68434,Agence_moov_Cotonou,300000,287476,2022-01-26
CASH_IN,281903,Agence_moov_Cotonou,300000,18097,Amélie de la Picard,-53093,228810,2022-01-01
TRANSFER,41739,Amélie de la Picard,228810,187071,Amélie de la Picard,228810,187071,2022-01-02
CASH_IN,220089,Agence_moov_Ouidah,300000,79911,Amélie de la Picard,187071,407160,2022-01-09
TRANSFER,76297,Amélie de la Picard,407160,330863,Amélie de la Picard,407160,483457,2022-01-10
CASH_OUT,80849,Amélie de la Picard,330863,250014,Agence_moov_Ouidah,300000,219151,2022-01-11
CASH_IN,40076,Agence_moov_Ouidah,300000,259924,Amélie de la Picard,250014,290090,2022-01-11
CASH_OUT,143785,Amélie de la Picard,290090,146305,Agence_moov_Ouidah,300000,156215,2022-01-21
CASH_OUT,75083,Amélie de la Picard,146305,71222,Agence_moov_Abomey,300000,224917,2022-01-22
CASH_OUT,64444,Amélie de la Picard,71222,6778,Agence_moov_Cotonou,300000,235556,2022-01-27
CASH_IN,130954,Agence_moov_Cotonou,300000,169046,Amélie de la Picard,6778,137732,2022-01-27
CASH_IN,65771,Agence_moov_Abomey,300000,234229,Gabriel de Pineau,-163765,-97994,2022-01-05
CASH_IN,78900,Agence_moov_Abomey,300000,221100,Gabriel de Pineau,-97994,-19094,2022-01-11
CASH_IN,208002,Agence_moov_Abomey,300000,91998,Gabriel de Pineau,-19094,188908,2022-01-14
CASH_OUT,178142,Gabriel de Pineau,188908,10766,Agence_moov_Abomey,300000,121858,2022-01-17
CASH_IN,186089,Agence_moov_Abomey,300000,113911,Gabriel de Pineau,10766,196855,2022-01-18
TRANSFER,120822,Gabriel de Pineau,196855,76033,Gabriel de Pineau,196855,76033,2022-01-20
CASH_IN,286231,Agence_moov_Abomey,300000,13769,Gabriel de Pineau,76033,362264,2022-01-21
CASH_IN,267190,Agence_moov_Cotonou,300000,32810,Gabriel de Pineau,362264,629454,2022-01-22
CASH_OUT,187239,Gabriel de Pineau,629454,442215,Agence_moov_Cotonou,300000,112761,2022-01-23
CASH_OUT,378062,Gabriel de Pineau,442215,64153,Agence_moov_Abomey,300000,-78062,2022-01-23
CASH_IN,79139,Agence_moov_Cotonou,300000,220861,Gabriel de Pineau,64153,143292,2022-01-23
CASH_OUT,18011,Gabriel de Pineau,143292,125281,Agence_moov_Abomey,300000,281989,2022-01-24
CASH_OUT,99686,Gabriel de Pineau,125281,25595,Agence_moov_Ouidah,300000,200314,2022-01-24
CASH_IN,15648,Agence_moov_Ouidah,300000,284352,Théodore Bertin,-131143,-115495,2022-01-01
CASH_IN,151610,Agence_moov_Abomey,300000,148390,Théodore Bertin,-115495,36115,2022-01-04
TRANSFER,14123,Théodore Bertin,36115,21992,Théodore Bertin,36115,21992,2022-01-04
CASH_OUT,4954,Théodore Bertin,21992,17038,Agence_moov_Abomey,300000,295046,2022-01-06
CASH_OUT,4498,Théodore Bertin,17038,12540,Agence_moov_Ouidah,300000,295502,2022-01-12
CASH_OUT,9807,Théodore Bertin,12540,2733,Agence_moov_Cotonou,300000,290193,2022-01-17
TRANSFER,215,Théodore Bertin,2733,2518,Théodore Bertin,2733,2518,2022-01-19
CASH_OUT,1531,Théodore Bertin,2518,987,Agence_moov_Cotonou,300000,298469,2022-01-20
CASH_IN,243649,Agence_moov_Abomey,300000,56351,Théodore Bertin,987,244636,2022-01-21
CASH_IN,163670,Agence_moov_Abomey,300000,136330,Théodore Bertin,244636,408306,2022-01-21
CASH_OUT,402987,Théodore Bertin,408306,5319,Agence_moov_Abomey,300000,-102987,2022-01-25
CASH_OUT,3551,Théodore Bertin,5319,1768,Agence_moov_Ouidah,300000,296449,2022-01-26
CASH_IN,295446,Agence_moov_Abomey,300000,4554,Antoine Bourdon de Auger,-486766,-191320,2022-01-02
CASH_IN,247985,Agence_moov_Cotonou,300000,52015,Antoine Bourdon de Auger,-191320,56665,2022-01-03
TRANSFER,49546,Antoine Bourdon de Auger,56665,7119,Antoine Bourdon de Auger,56665,106211,2022-01-04
TRANSFER,366,Antoine Bourdon de Auger,7119,6753,Antoine Bourdon de Auger,7119,7485,2022-01-04
CASH_OUT,5795,Antoine Bourdon de Auger,6753,958,Agence_moov_Ouidah,300000,294205,2022-01-05
CASH_OUT,610,Antoine Bourdon de Auger,958,348,Agence_moov_Cotonou,300000,299390,2022-01-06
CASH_OUT,310,Antoine Bourdon de Auger,348,38,Agence_moov_Abomey,300000,299690,2022-01-07
CASH_IN,32782,Agence_moov_Cotonou,300000,267218,Antoine Bourdon de Auger,38,32820,2022-01-11
CASH_OUT,11138,Antoine Bourdon de Auger,32820,21682,Agence_moov_Cotonou,300000,288862,2022-01-12
CASH_OUT,12636,Antoine Bourdon de Auger,21682,9046,Agence_moov_Cotonou,300000,287364,2022-01-17
CASH_IN,236262,Agence_moov_Cotonou,300000,63738,Antoine Bourdon de Auger,9046,245308,2022-01-18
CASH_IN,299197,Agence_moov_Cotonou,300000,803,Antoine Bourdon de Auger,245308,544505,2022-01-21
CASH_OUT,19731,Antoine Bourdon de Auger,544505,524774,Agence_moov_Ouidah,300000,280269,2022-01-26
CASH_IN,4759,Agence_moov_Abomey,300000,295241,Antoine Bourdon de Auger,524774,529533,2022-01-27
CASH_IN,228051,Agence_moov_Cotonou,300000,71949,Nicolas Grondin de la Pinto,-2456,225595,2022-01-02
CASH_IN,23605,Agence_moov_Ouidah,300000,276395,Nicolas Grondin de la Pinto,225595,249200,2022-01-03
TRANSFER,154956,Nicolas Grondin de la Pinto,249200,94244,Nicolas Grondin de la Pinto,249200,404156,2022-01-08
TRANSFER,56072,Nicolas Grondin de la Pinto,94244,38172,Nicolas Grondin de la Pinto,94244,150316,2022-01-09
CASH_IN,285730,Agence_moov_Abomey,300000,14270,Nicolas Grondin de la Pinto,38172,323902,2022-01-09
CASH_IN,177290,Agence_moov_Ouidah,300000,122710,Nicolas Grondin de la Pinto,323902,501192,2022-01-10
CASH_IN,288401,Agence_moov_Abomey,300000,11599,Nicolas Grondin de la Pinto,501192,789593,2022-01-15
CASH_OUT,265751,Nicolas Grondin de la Pinto,789593,523842,Agence_moov_Abomey,300000,34249,2022-01-15
CASH_OUT,175006,Nicolas Grondin de la Pinto,523842,348836,Agence_moov_Cotonou,300000,124994,2022-01-17
CASH_IN,210507,Agence_moov_Cotonou,300000,89493,Élodie Gérard,-200914,9593,2022-01-02
TRANSFER,3958,Élodie Gérard,9593,5635,Élodie Gérard,9593,5635,2022-01-04
TRANSFER,5161,Élodie Gérard,5635,474,Élodie Gérard,5635,10796,2022-01-04
CASH_IN,233384,Agence_moov_Cotonou,300000,66616,Élodie Gérard,474,233858,2022-01-10
CASH_IN,196277,Agence_moov_Cotonou,300000,103723,Élodie Gérard,233858,430135,2022-01-13
CASH_IN,221785,Agence_moov_Ouidah,300000,78215,Élodie Gérard,430135,651920,2022-01-14
CASH_IN,204063,Agence_moov_Ouidah,300000,95937,Élodie Gérard,651920,855983,2022-01-16
CASH_IN,101710,Agence_moov_Cotonou,300000,198290,Élodie Gérard,855983,957693,2022-01-18
CASH_OUT,25208,Élodie Gérard,957693,932485,Agence_moov_Cotonou,300000,274792,2022-01-19
CASH_OUT,446449,Élodie Gérard,932485,486036,Agence_moov_Ouidah,300000,-146449,2022-01-19
CASH_OUT,86642,Élodie Gérard,486036,399394,Agence_moov_Abomey,300000,213358,2022-01-21
CASH_OUT,289075,Élodie Gérard,399394,110319,Agence_moov_Abomey,300000,10925,2022-01-25
CASH_IN,143921,Agence_moov_Ouidah,300000,156079,Guy Guyon,-911929,-768008,2022-01-01
CASH_IN,238128,Agence_moov_Abomey,300000,61872,Guy Guyon,-768008,-529880,2022-01-03
CASH_IN,23101,Agence_moov_Cotonou,300000,276899,Guy Guyon,-529880,-506779,2022-01-03
CASH_IN,102657,Agence_moov_Abomey,300000,197343,Guy Guyon,-506779,-404122,2022-01-06
CASH_IN,133844,Agence_moov_Ouidah,300000,166156,Guy Guyon,-404122,-270278,2022-01-08
CASH_IN,239225,Agence_moov_Abomey,300000,60775,Guy Guyon,-270278,-31053,2022-01-10
CASH_IN,227494,Agence_moov_Cotonou,300000,72506,Guy Guyon,-31053,196441,2022-01-10
TRANSFER,34846,Guy Guyon,196441,161595,Guy Guyon,196441,231287,2022-01-12
CASH_OUT,142357,Guy Guyon,161595,19238,Agence_moov_Ouidah,300000,157643,2022-01-12
TRANSFER,2888,Guy Guyon,19238,16350,Guy Guyon,19238,16350,2022-01-12
CASH_OUT,12195,Guy Guyon,16350,4155,Agence_moov_Cotonou,300000,287805,2022-01-13
CASH_OUT,210,Guy Guyon,4155,3945,Agence_moov_Cotonou,300000,299790,2022-01-17
CASH_IN,184596,Agence_moov_Cotonou,300000,115404,Guy Guyon,3945,188541,2022-01-17
CASH_OUT,123516,Guy Guyon,188541,65025,Agence_moov_Cotonou,300000,176484,2022-01-20
CASH_OUT,60428,Guy Guyon,65025,4597,Agence_moov_Abomey,300000,239572,2022-01-20
CASH_IN,70791,Agence_moov_Abomey,300000,229209,Nicole Lacroix,42,70833,2022-01-01
CASH_IN,227681,Agence_moov_Abomey,300000,72319,Nicole Lacroix,70833,298514,2022-01-02
TRANSFER,150198,Nicole Lacroix,298514,148316,Nicole Lacroix,298514,148316,2022-01-03
CASH_OUT,109783,Nicole Lacroix,148316,38533,Agence_moov_Ouidah,300000,190217,2022-01-03
CASH_OUT,20024,Nicole Lacroix,38533,18509,Agence_moov_Ouidah,300000,279976,2022-01-05
CASH_IN,267763,Agence_moov_Abomey,300000,32237,Nicole Lacroix,18509,286272,2022-01-06
CASH_IN,279605,Agence_moov_Abomey,300000,20395,Nicole Lacroix,286272,565877,2022-01-07
TRANSFER,400584,Nicole Lacroix,565877,165293,Nicole Lacroix,565877,966461,2022-01-07
CASH_IN,211563,Agence_moov_Ouidah,300000,88437,Nicole Lacroix,165293,376856,2022-01-08
CASH_OUT,215176,Nicole Lacroix,376856,161680,Agence_moov_Cotonou,300000,84824,2022-01-10
CASH_IN,86210,Agence_moov_Abomey,300000,213790,Nicole Lacroix,161680,247890,2022-01-10
CASH_IN,96493,Agence_moov_Abomey,300000,203507,Nicole Lacroix,247890,344383,2022-01-10
CASH_OUT,135866,Nicole Lacroix,344383,208517,Agence_moov_Cotonou,300000,164134,2022-01-12
CASH_OUT,129348,Nicole Lacroix,208517,79169,Agence_moov_Ouidah,300000,170652,2022-01-13
CASH_IN,89483,Agence_moov_Cotonou,300000,210517,Nicole Lacroix,79169,168652,2022-01-18
CASH_IN,206880,Agence_moov_Ouidah,300000,93120,Nicole Lacroix,168652,375532,2022-01-26
CASH_IN,8094,Agence_moov_Cotonou,300000,291906,Alexandre Poirier,-352486,-344392,2022-01-01
CASH_IN,46580,Agence_moov_Abomey,300000,253420,Alexandre Poirier,-344392,-297812,2022-01-01
CASH_IN,279116,Agence_moov_Cotonou,300000,20884,Alexandre Poirier,-297812,-18696,2022-01-07
CASH_IN,56056,Agence_moov_Abomey,300000,243944,Alexandre Poirier,-18696,37360,2022-01-11
CASH_IN,43401,Agence_moov_Cotonou,300000,256599,Alexandre Poirier,37360,80761,2022-01-19
TRANSFER,62700,Alexandre Poirier,80761,18061,Alexandre Poirier,80761,143461,2022-01-21
CASH_IN,250721,Agence_moov_Cotonou,300000,49279,Alexandre Poirier,18061,268782,2022-01-23
CASH_OUT,106126,Alexandre Poirier,268782,162656,Agence_moov_Ouidah,300000,193874,2022-01-25
CASH_OUT,32312,Alexandre Poirier,162656,130344,Agence_moov_Cotonou,300000,267688,2022-01-26
TRANSFER,230452,Nathalie-Chantal Jacques,1772100,1541648,Alex Salmon,558600,328148,2022-02-01
CASH_IN,118568,Agence_moov_Abomey,300000,181432,Nathalie-Chantal Jacques,1541648,1660216,2022-02-04
CASH_IN,175865,Agence_moov_Abomey,300000,124135,Nathalie-Chantal Jacques,1660216,1836081,2022-02-19
CASH_OUT,496132,Nathalie-Chantal Jacques,1836081,1339949,Agence_moov_Cotonou,300000,-196132,2022-02-24
TRANSFER,254533,Nathalie-Chantal Jacques,1339949,1085416,Luc Camus,1253200,998667,2022-02-26
CASH_OUT,55158,Nicolas Grondin de la Pinto,1884700,1829542,Agence_moov_Cotonou,300000,244842,2022-02-03
TRANSFER,721347,Nicolas Grondin de la Pinto,1829542,1108195,Christine-Constance Gauthier,232500,-488847,2022-02-06
CASH_OUT,966368,Nicolas Grondin de la Pinto,1108195,141827,Agence_moov_Ouidah,300000,-666368,2022-02-16
CASH_IN,298379,Agence_moov_Cotonou,300000,1621,Nicolas Grondin de la Pinto,141827,440206,2022-02-24
CASH_IN,149254,Agence_moov_Ouidah,300000,150746,Clémence Bertin,1165200,1314454,2022-02-06
TRANSFER,245595,Léon Paris,252400,6805,Clémence Bertin,1314454,1560049,2022-02-11
TRANSFER,10743,Clémence Bertin,1560049,1549306,Clémence Bertin,1560049,1570792,2022-02-18
TRANSFER,401858,Maryse Reynaud-Michaud,466700,64842,Clémence Bertin,1549306,1951164,2022-02-21
CASH_IN,112638,Agence_moov_Abomey,300000,187362,Clémence Bertin,1951164,2063802,2022-02-27
CASH_OUT,455836,Stéphane-Timothée Pineau,545500,89664,Agence_moov_Cotonou,300000,-155836,2022-02-02
CASH_IN,132855,Agence_moov_Abomey,300000,167145,Stéphane-Timothée Pineau,89664,222519,2022-02-13
CASH_IN,245662,Agence_moov_Ouidah,300000,54338,Julie Robin de Gros,109300,354962,2022-02-09
TRANSFER,414583,Luc Camus,998667,584084,Julie Robin de Gros,354962,769545,2022-02-24
TRANSFER,777152,Caroline Peltier,1040600,263448,Paul De Sousa,1577500,800348,2022-02-08
CASH_IN,249710,Agence_moov_Cotonou,300000,50290,Caroline Peltier,263448,513158,2022-02-15
TRANSFER,183314,Caroline Peltier,513158,329844,Marthe Pichon,636200,452886,2022-02-20
CASH_IN,169852,Agence_moov_Cotonou,300000,130148,Laurence Carlier,223400,393252,2022-02-19
CASH_IN,107790,Agence_moov_Ouidah,300000,192210,Laurence Carlier,393252,501042,2022-02-21
CASH_OUT,141629,Laurence Carlier,501042,359413,Agence_moov_Ouidah,300000,158371,2022-02-24
TRANSFER,603181,Susan de Fontaine,1873900,1270719,Jacques-Antoine Gros,1696400,1093219,2022-02-09
TRANSFER,628073,Susan de Fontaine,1270719,642646,Gilbert Bazin Le Guillet,395000,-233073,2022-02-17
TRANSFER,612972,Susan de Fontaine,642646,29674,Agnès Chrétien-Sanchez,1476500,863528,2022-02-27
TRANSFER,1063664,Matthieu Carpentier,1862400,798736,Adélaïde-Sophie Leclercq,504000,-559664,2022-02-01
TRANSFER,511623,David Diallo,561400,49777,Matthieu Carpentier,798736,1310359,2022-02-03
CASH_OUT,242396,Matthieu Carpentier,1310359,1067963,Agence_moov_Cotonou,300000,57604,2022-02-10
CASH_IN,142761,Agence_moov_Ouidah,300000,157239,Matthieu Carpentier,1067963,1210724,2022-02-22
CASH_IN,296878,Agence_moov_Cotonou,300000,3122,Marc Gilbert,1336800,1633678,2022-02-03
TRANSFER,265400,Émilie Guillon de Duhamel,685100,419700,Marc Gilbert,1633678,1899078,2022-02-06
TRANSFER,1578451,Marc Gilbert,1899078,320627,Benoît Verdier,1694200,115749,2022-02-06
TRANSFER,146422,Marc Gilbert,320627,174205,Marthe Pichon,452886,306464,2022-02-22
CASH_OUT,105131,Marc Gilbert,174205,69074,Agence_moov_Cotonou,300000,194869,2022-02-27
CASH_IN,137834,Agence_moov_Abomey,300000,162166,Claudine Vallet,248900,386734,2022-02-08
CASH_IN,273947,Agence_moov_Ouidah,300000,26053,Claudine Vallet,386734,660681,2022-02-09
CASH_OUT,183084,Claudine Vallet,660681,477597,Agence_moov_Abomey,300000,116916,2022-02-13
TRANSFER,191494,Vincent-Philippe Rossi,912900,721406,Claudine Vallet,477597,669091,2022-02-26
CASH_IN,111770,Agence_moov_Ouidah,300000,188230,Amélie Gros-Riou,917200,1028970,2022-02-22
CASH_OUT,625953,Amélie Gros-Riou,1028970,403017,Agence_moov_Cotonou,300000,-325953,2022-02-24
CASH_OUT,99719,Vincent-Grégoire Brunet,355400,255681,Agence_moov_Cotonou,300000,200281,2022-02-02
TRANSFER,77182,Vincent-Grégoire Brunet,255681,178499,Maurice Seguin,1614100,1536918,2022-02-07
CASH_IN,79828,Agence_moov_Ouidah,300000,220172,Vincent-Grégoire Brunet,178499,258327,2022-02-10
TRANSFER,609522,Amélie de la Picard,1294800,685278,Frédéric Moreau,610100,1219622,2022-02-02
TRANSFER,1176903,Frédéric Moreau,1219622,42719,David Diallo,49777,-1127126,2022-02-12
CASH_IN,169373,Agence_moov_Abomey,300000,130627,Frédéric Moreau,42719,212092,2022-02-14
CASH_OUT,35543,Frédéric Moreau,212092,176549,Agence_moov_Abomey,300000,264457,2022-02-14
CASH_OUT,1582346,Thierry Dos Santos-Le Roux,1846200,263854,Agence_moov_Ouidah,300000,-1282346,2022-02-02
CASH_OUT,24861,Thierry Dos Santos-Le Roux,263854,238993,Agence_moov_Cotonou,300000,275139,2022-02-08
TRANSFER,135230,Thierry Dos Santos-Le Roux,238993,103763,Nicole Lacroix,720900,585670,2022-02-08
CASH_IN,142401,Agence_moov_Ouidah,300000,157599,Thierry Dos Santos-Le Roux,103763,246164,2022-02-12
CASH_OUT,215094,Thierry Dos Santos-Le Roux,246164,31070,Agence_moov_Ouidah,300000,84906,2022-02-27
CASH_OUT,11365,Laurent Perrot,177900,166535,Agence_moov_Abomey,300000,288635,2022-02-11
CASH_IN,247072,Agence_moov_Cotonou,300000,52928,Laurent Perrot,166535,413607,2022-02-17
CASH_OUT,85960,Laurent Perrot,413607,327647,Agence_moov_Cotonou,300000,214040,2022-02-22
TRANSFER,404051,Aimé Allain,1199000,794949,Laurent Perrot,327647,731698,2022-02-22
CASH_OUT,347214,Laurent Perrot,731698,384484,Agence_moov_Ouidah,300000,-47214,2022-02-25
CASH_OUT,241781,David-Théodore Diaz,1507600,1265819,Agence_moov_Cotonou,300000,58219,2022-02-10
CASH_IN,179380,Agence_moov_Cotonou,300000,120620,David-Théodore Diaz,1265819,1445199,2022-02-16
TRANSFER,716625,Constance Regnier,1885800,1169175,Léon Paris,6805,-709820,2022-02-09
TRANSFER,1056520,Constance Regnier,1169175,112655,Maurice Seguin,1536918,480398,2022-02-09
TRANSFER,58634,Anastasie Louis,593100,534466,Constance Regnier,112655,171289,2022-02-13
CASH_OUT,112494,Constance Regnier,171289,58795,Agence_moov_Abomey,300000,187506,2022-02-18
TRANSFER,53823,Constance Regnier,58795,4972,Marthe Guillet,1662100,1608277,2022-02-27
TRANSFER,39437,Juliette Evrard Le Giraud,201400,161963,Élodie Gérard,1154700,1115263,2022-02-15
CASH_OUT,13020,Alexandre Poirier,94000,80980,Agence_moov_Cotonou,300000,286980,2022-02-15
TRANSFER,447811,Richard Guibert,679000,231189,Christophe Alexandre,1169000,1616811,2022-02-01
CASH_OUT,1110209,Christophe Alexandre,1616811,506602,Agence_moov_Cotonou,300000,-810209,2022-02-14
CASH_IN,68172,Agence_moov_Cotonou,300000,231828,Christophe Alexandre,506602,574774,2022-02-18
CASH_OUT,154688,Christophe Alexandre,574774,420086,Agence_moov_Ouidah,300000,145312,2022-02-23
CASH_IN,88446,Agence_moov_Abomey,300000,211554,Christophe Alexandre,420086,508532,2022-02-27
CASH_IN,28153,Agence_moov_Abomey,300000,271847,Marthe Pichon,306464,334617,2022-02-01
CASH_OUT,110296,Marthe Pichon,334617,224321,Agence_moov_Cotonou,300000,189704,2022-02-01
TRANSFER,73016,Marthe Pichon,224321,151305,Emmanuel-René Coulon,369900,296884,2022-02-02
CASH_OUT,26626,Marthe Pichon,151305,124679,Agence_moov_Cotonou,300000,273374,2022-02-03
CASH_IN,16834,Agence_moov_Cotonou,300000,283166,Marthe Pichon,124679,141513,2022-02-03
CASH_IN,115256,Agence_moov_Ouidah,300000,184744,Marthe Pichon,141513,256769,2022-02-10
CASH_OUT,10814,Marthe Pichon,256769,245955,Agence_moov_Cotonou,300000,289186,2022-02-10
CASH_OUT,245052,Marthe Pichon,245955,903,Agence_moov_Ouidah,300000,54948,2022-02-12
TRANSFER,129802,Anastasie Louis,534466,404664,Marthe Pichon,903,130705,2022-02-14
TRANSFER,27596,Marthe Pichon,130705,103109,Nath Léger,167100,139504,2022-02-15
TRANSFER,645528,Auguste Bousquet,1084800,439272,Marthe Pichon,103109,748637,2022-02-15
CASH_IN,185393,Agence_moov_Abomey,300000,114607,Marthe Pichon,748637,934030,2022-02-16
CASH_OUT,618901,Marthe Pichon,934030,315129,Agence_moov_Ouidah,300000,-318901,2022-02-18
TRANSFER,325305,Anastasie Louis,404664,79359,Marthe Pichon,315129,640434,2022-02-20
CASH_IN,176919,Agence_moov_Abomey,300000,123081,Marthe Pichon,640434,817353,2022-02-21
CASH_OUT,199510,Marthe Pichon,817353,617843,Agence_moov_Cotonou,300000,100490,2022-02-23
CASH_OUT,78247,Marthe Pichon,617843,539596,Agence_moov_Cotonou,300000,221753,2022-02-24
CASH_IN,261842,Agence_moov_Cotonou,300000,38158,Marthe Pichon,539596,801438,2022-02-25
CASH_IN,2141,Agence_moov_Cotonou,300000,297859,Marthe Pichon,801438,803579,2022-02-25
CASH_IN,26693,Agence_moov_Cotonou,300000,273307,Marthe Pichon,803579,830272,2022-02-25
CASH_IN,128369,Agence_moov_Cotonou,300000,171631,Marthe Pichon,830272,958641,2022-02-27
TRANSFER,790545,Josette Guillon-Leclercq,1821200,1030655,Antoine Bourdon de Auger,1538100,2328645,2022-02-01
CASH_IN,278755,Agence_moov_Cotonou,300000,21245,Antoine Bourdon de Auger,2328645,2607400,2022-02-01
TRANSFER,720440,Antoine Bourdon de Auger,2607400,1886960,Alphonse Dupont-Petit,1452500,732060,2022-02-02
TRANSFER,1726173,Emmanuel Bousquet,1985500,259327,Antoine Bourdon de Auger,1886960,3613133,2022-02-02
CASH_IN,202755,Agence_moov_Cotonou,300000,97245,Antoine Bourdon de Auger,3613133,3815888,2022-02-03
TRANSFER,935250,Christophe Guilbert,1121400,186150,Antoine Bourdon de Auger,3815888,4751138,2022-02-03
CASH_IN,253113,Agence_moov_Abomey,300000,46887,Antoine Bourdon de Auger,4751138,5004251,2022-02-04
TRANSFER,1520385,Emmanuelle Gilbert,1804400,284015,Antoine Bourdon de Auger,5004251,6524636,2022-02-07
CASH_IN,198893,Agence_moov_Cotonou,300000,101107,Antoine Bourdon de Auger,6524636,6723529,2022-02-08
TRANSFER,183783,Antoine Bourdon de Auger,6723529,6539746,Émilie Guillon de Duhamel,419700,235917,2022-02-08
CASH_OUT,2969486,Antoine Bourdon de Auger,6539746,3570260,Agence_moov_Ouidah,300000,-2669486,2022-02-10
TRANSFER,3008350,Antoine Bourdon de Auger,3570260,561910,Antoine Bourdon de Auger,3570260,561910,2022-02-10
CASH_IN,28361,Agence_moov_Abomey,300000,271639,Antoine Bourdon de Auger,561910,590271,2022-02-11
CASH_OUT,523134,Antoine Bourdon de Auger,590271,67137,Agence_moov_Ouidah,300000,-223134,2022-02-12
TRANSFER,8631,Antoine Bourdon de Auger,67137,58506,Émilie Guillon de Duhamel,235917,227286,2022-02-13
CASH_IN,115084,Agence_moov_Abomey,300000,184916,Antoine Bourdon de Auger,58506,173590,2022-02-13
TRANSFER,147472,Antoine Bourdon de Auger,173590,26118,Agnès Baron,642600,495128,2022-02-13
CASH_OUT,4552,Antoine Bourdon de Auger,26118,21566,Agence_moov_Cotonou,300000,295448,2022-02-15
CASH_OUT,11944,Antoine Bourdon de Auger,21566,9622,Agence_moov_Ouidah,300000,288056,2022-02-16
CASH_OUT,591,Antoine Bourdon de Auger,9622,9031,Agence_moov_Abomey,300000,299409,2022-02-17
CASH_OUT,1932,Antoine Bourdon de Auger,9031,7099,Agence_moov_Cotonou,300000,298068,2022-02-17
CASH_IN,173208,Agence_moov_Ouidah,300000,126792,Antoine Bourdon de Auger,7099,180307,2022-02-20
CASH_IN,73503,Agence_moov_Cotonou,300000,226497,Antoine Bourdon de Auger,180307,253810,2022-02-21
TRANSFER,1620309,Noël Hamel,1761700,141391,Antoine Bourdon de Auger,253810,1874119,2022-02-22
CASH_IN,190699,Agence_moov_Ouidah,300000,109301,Antoine Bourdon de Auger,1874119,2064818,2022-02-23
TRANSFER,611920,Antoine Bourdon de Auger,2064818,1452898,Paul De Sousa,800348,188428,2022-02-24
TRANSFER,152448,Antoine Bourdon de Auger,1452898,1300450,Arnaude Gaillard,16400,-136048,2022-02-25
TRANSFER,1136690,Antoine Bourdon de Auger,1300450,163760,Émile Hebert,107900,-1028790,2022-02-27
CASH_IN,145126,Agence_moov_Abomey,300000,154874,Antoine Bourdon de Auger,163760,308886,2022-02-27
TRANSFER,248654,Vincent-Philippe Rossi,721406,472752,Théodore-Alfred Fournier,522400,273746,2022-02-01
CASH_OUT,437411,Vincent-Philippe Rossi,472752,35341,Agence_moov_Abomey,300000,-137411,2022-02-02
CASH_IN,150809,Agence_moov_Abomey,300000,149191,Vincent-Philippe Rossi,35341,186150,2022-02-02
TRANSFER,53802,Vincent-Philippe Rossi,186150,132348,Joséphine Weber du Bonnin,247700,193898,2022-02-02
CASH_OUT,60143,Vincent-Philippe Rossi,132348,72205,Agence_moov_Cotonou,300000,239857,2022-02-02
TRANSFER,61556,Vincent-Philippe Rossi,72205,10649,Théodore Bertin,908900,847344,2022-02-04
CASH_IN,134721,Agence_moov_Ouidah,300000,165279,Vincent-Philippe Rossi,10649,145370,2022-02-05
CASH_IN,214402,Agence_moov_Ouidah,300000,85598,Vincent-Philippe Rossi,145370,359772,2022-02-07
CASH_IN,240393,Agence_moov_Cotonou,300000,59607,Vincent-Philippe Rossi,359772,600165,2022-02-11
CASH_OUT,399822,Vincent-Philippe Rossi,600165,200343,Agence_moov_Cotonou,300000,-99822,2022-02-12
TRANSFER,187780,Joséphine Weber du Bonnin,193898,6118,Vincent-Philippe Rossi,200343,388123,2022-02-14
CASH_IN,235795,Agence_moov_Abomey,300000,64205,Vincent-Philippe Rossi,388123,623918,2022-02-14
CASH_OUT,127610,Vincent-Philippe Rossi,623918,496308,Agence_moov_Ouidah,300000,172390,2022-02-15
TRANSFER,19742,Vincent-Philippe Rossi,496308,476566,Marine-Clémence Ferreira,647700,627958,2022-02-18
CASH_OUT,458805,Vincent-Philippe Rossi,476566,17761,Agence_moov_Cotonou,300000,-158805,2022-02-19
TRANSFER,435723,Augustin Benard,1898600,1462877,Vincent-Philippe Rossi,17761,453484,2022-02-19
TRANSFER,144885,Vincent-Philippe Rossi,453484,308599,Alphonse Dupont-Petit,732060,587175,2022-02-19
CASH_IN,4171,Agence_moov_Abomey,300000,295829,Vincent-Philippe Rossi,308599,312770,2022-02-19
CASH_OUT,295629,Vincent-Philippe Rossi,312770,17141,Agence_moov_Ouidah,300000,4371,2022-02-20
CASH_OUT,13488,Vincent-Philippe Rossi,17141,3653,Agence_moov_Ouidah,300000,286512,2022-02-21
TRANSFER,993279,Margot Renaud de Lacombe,1082700,89421,Vincent-Philippe Rossi,3653,996932,2022-02-22
CASH_IN,144393,Agence_moov_Abomey,300000,155607,Vincent-Philippe Rossi,996932,1141325,2022-02-24
CASH_IN,147557,Agence_moov_Abomey,300000,152443,Vincent-Philippe Rossi,1141325,1288882,2022-02-25
CASH_OUT,777181,Vincent-Philippe Rossi,1288882,511701,Agence_moov_Abomey,300000,-477181,2022-02-25
CASH_OUT,207,Vincent-Philippe Rossi,511701,511494,Agence_moov_Abomey,300000,299793,2022-02-25
CASH_IN,81303,Agence_moov_Cotonou,300000,218697,Vincent-Philippe Rossi,511494,592797,2022-02-26
TRANSFER,486843,Vincent-Philippe Rossi,592797,105954,Auguste Bousquet,439272,-47571,2022-02-26
CASH_OUT,65836,Vincent-Philippe Rossi,105954,40118,Agence_moov_Abomey,300000,234164,2022-02-27
CASH_IN,48086,Agence_moov_Ouidah,300000,251914,Vincent-Philippe Rossi,40118,88204,2022-02-27
CASH_IN,186666,Agence_moov_Ouidah,300000,113334,Matthieu Renard,945200,1131866,2022-02-02
TRANSFER,1062521,Matthieu Renard,1131866,69345,Gabriel de Pineau,1106700,44179,2022-02-04
TRANSFER,159439,Christophe Guilbert,186150,26711,Matthieu Renard,69345,228784,2022-02-05
CASH_IN,203208,Agence_moov_Ouidah,300000,96792,Matthieu Renard,228784,431992,2022-02-07
CASH_IN,52006,Agence_moov_Cotonou,300000,247994,Matthieu Renard,431992,483998,2022-02-12
TRANSFER,153604,Matthieu Renard,483998,330394,Matthieu Renard,483998,637602,2022-02-15
TRANSFER,182765,Matthieu Renard,330394,147629,Nicole Lacroix,585670,402905,2022-02-16
CASH_OUT,72767,Matthieu Renard,147629,74862,Agence_moov_Ouidah,300000,227233,2022-02-16
CASH_OUT,51304,Matthieu Renard,74862,23558,Agence_moov_Cotonou,300000,248696,2022-02-17
CASH_IN,140428,Agence_moov_Cotonou,300000,159572,Matthieu Renard,23558,163986,2022-02-19
CASH_IN,113599,Agence_moov_Abomey,300000,186401,Matthieu Renard,163986,277585,2022-02-20
CASH_OUT,96036,Matthieu Renard,277585,181549,Agence_moov_Cotonou,300000,203964,2022-02-21
CASH_OUT,6659,Matthieu Renard,181549,174890,Agence_moov_Ouidah,300000,293341,2022-02-23
CASH_IN,16745,Agence_moov_Cotonou,300000,283255,Matthieu Renard,174890,191635,2022-02-23
CASH_OUT,103651,Matthieu Renard,191635,87984,Agence_moov_Cotonou,300000,196349,2022-02-24
CASH_IN,191028,Agence_moov_Cotonou,300000,108972,Matthieu Renard,87984,279012,2022-02-24
TRANSFER,98329,Emmanuel-René Coulon,296884,198555,Matthieu Renard,279012,377341,2022-02-24
TRANSFER,305167,Marthe Guillet,1608277,1303110,Matthieu Renard,377341,682508,2022-02-25
TRANSFER,206940,Maurice Alves,294600,87660,Matthieu Renard,682508,889448,2022-02-26
CASH_IN,55284,Agence_moov_Cotonou,300000,244716,Matthieu Renard,889448,944732,2022-02-26
TRANSFER,658538,Matthieu Renard,944732,286194,Anastasie Louis,79359,-579179,2022-02-27
CASH_IN,52722,Agence_moov_Ouidah,300000,247278,Marine-Clémence Ferreira,627958,680680,2022-02-01
CASH_IN,233032,Agence_moov_Cotonou,300000,66968,Marine-Clémence Ferreira,680680,913712,2022-02-01
CASH_OUT,394021,Marine-Clémence Ferreira,913712,519691,Agence_moov_Ouidah,300000,-94021,2022-02-03
CASH_OUT,125662,Marine-Clémence Ferreira,519691,394029,Agence_moov_Cotonou,300000,174338,2022-02-04
TRANSFER,27873,Marine-Clémence Ferreira,394029,366156,Caroline Monnier,1696300,1668427,2022-02-06
CASH_OUT,355857,Marine-Clémence Ferreira,366156,10299,Agence_moov_Abomey,300000,-55857,2022-02-06
CASH_IN,34607,Agence_moov_Cotonou,300000,265393,Marine-Clémence Ferreira,10299,44906,2022-02-07
TRANSFER,13034,Roland Colin,297100,284066,Marine-Clémence Ferreira,44906,57940,2022-02-08
CASH_IN,156338,Agence_moov_Cotonou,300000,143662,Marine-Clémence Ferreira,57940,214278,2022-02-08
CASH_OUT,18999,Marine-Clémence Ferreira,214278,195279,Agence_moov_Ouidah,300000,281001,2022-02-09
CASH_IN,274769,Agence_moov_Ouidah,300000,25231,Marine-Clémence Ferreira,195279,470048,2022-02-10
CASH_OUT,154128,Marine-Clémence Ferreira,470048,315920,Agence_moov_Ouidah,300000,145872,2022-02-12
TRANSFER,548088,Paul Pereira,1317200,769112,Marine-Clémence Ferreira,315920,864008,2022-02-13
CASH_IN,76512,Agence_moov_Abomey,300000,223488,Marine-Clémence Ferreira,864008,940520,2022-02-14
CASH_IN,161849,Agence_moov_Abomey,300000,138151,Marine-Clémence Ferreira,940520,1102369,2022-02-14
CASH_IN,239354,Agence_moov_Ouidah,300000,60646,Marine-Clémence Ferreira,1102369,1341723,2022-02-16
TRANSFER,650370,Marine-Clémence Ferreira,1341723,691353,Alfred Chrétien,1644100,993730,2022-02-19
CASH_IN,173892,Agence_moov_Ouidah,300000,126108,Marine-Clémence Ferreira,691353,865245,2022-02-19
CASH_OUT,479082,Marine-Clémence Ferreira,865245,386163,Agence_moov_Ouidah,300000,-179082,2022-02-19
CASH_OUT,194736,Marine-Clémence Ferreira,386163,191427,Agence_moov_Abomey,300000,105264,2022-02-19
TRANSFER,102498,Marine-Clémence Ferreira,191427,88929,Émilie Guillon de Duhamel,227286,124788,2022-02-19
CASH_OUT,27822,Marine-Clémence Ferreira,88929,61107,Agence_moov_Abomey,300000,272178,2022-02-21
CASH_OUT,13207,Marine-Clémence Ferreira,61107,47900,Agence_moov_Ouidah,300000,286793,2022-02-22
CASH_OUT,13094,Marine-Clémence Ferreira,47900,34806,Agence_moov_Ouidah,300000,286906,2022-02-22
TRANSFER,11040,Marine-Clémence Ferreira,34806,23766,Alphonse Dupont-Petit,587175,576135,2022-02-23
CASH_OUT,15307,Marine-Clémence Ferreira,23766,8459,Agence_moov_Ouidah,300000,284693,2022-02-25
CASH_OUT,1381,Marine-Clémence Ferreira,8459,7078,Agence_moov_Cotonou,300000,298619,2022-02-25
TRANSFER,1007598,Frédérique Robin,1014800,7202,Marine-Clémence Ferreira,7078,1014676,2022-02-26
CASH_OUT,674566,Marine-Clémence Ferreira,1014676,340110,Agence_moov_Ouidah,300000,-374566,2022-02-27
CASH_OUT,152648,Marine-Clémence Ferreira,340110,187462,Agence_moov_Cotonou,300000,147352,2022-02-27
CASH_IN,278362,Agence_moov_Ouidah,300000,21638,Émile Hebert,-1028790,-750428,2022-02-01
CASH_IN,215580,Agence_moov_Abomey,300000,84420,Émile Hebert,-750428,-534848,2022-02-01
CASH_IN,270361,Agence_moov_Ouidah,300000,29639,Émile Hebert,-534848,-264487,2022-02-02
CASH_IN,295763,Agence_moov_Cotonou,300000,4237,Émile Hebert,-264487,31276,2022-02-04
CASH_OUT,5592,Émile Hebert,31276,25684,Agence_moov_Ouidah,300000,294408,2022-02-04
TRANSFER,19698,Émile Hebert,25684,5986,Noël Hamel,141391,121693,2022-02-05
CASH_IN,164498,Agence_moov_Cotonou,300000,135502,Émile Hebert,5986,170484,2022-02-06
TRANSFER,18854,Nath Léger,139504,120650,Émile Hebert,170484,189338,2022-02-09
TRANSFER,19767,Élodie Gérard,1115263,1095496,Émile Hebert,189338,209105,2022-02-10
CASH_OUT,33477,Émile Hebert,209105,175628,Agence_moov_Abomey,300000,266523,2022-02-15
CASH_OUT,62908,Émile Hebert,175628,112720,Agence_moov_Abomey,300000,237092,2022-02-16
TRANSFER,46864,Théodore Bertin,847344,800480,Émile Hebert,112720,159584,2022-02-16
CASH_OUT,133862,Émile Hebert,159584,25722,Agence_moov_Ouidah,300000,166138,2022-02-17
TRANSFER,16390,Émile Hebert,25722,9332,Alphonse Dupont-Petit,576135,559745,2022-02-19
CASH_OUT,3080,Émile Hebert,9332,6252,Agence_moov_Abomey,300000,296920,2022-02-19
CASH_IN,161154,Agence_moov_Abomey,300000,138846,Émile Hebert,6252,167406,2022-02-20
CASH_IN,257899,Agence_moov_Ouidah,300000,42101,Émile Hebert,167406,425305,2022-02-20
CASH_OUT,207470,Émile Hebert,425305,217835,Agence_moov_Cotonou,300000,92530,2022-02-21
CASH_IN,88585,Agence_moov_Ouidah,300000,211415,Émile Hebert,217835,306420,2022-02-24
TRANSFER,295142,Émile Hebert,306420,11278,Richard Guibert,231189,-63953,2022-02-25
CASH_IN,118858,Agence_moov_Cotonou,300000,181142,Émile Hebert,11278,130136,2022-02-27
TRANSFER,2056,Sabine Imbert,53300,51244,Sébastien Jourdan,1923400,1921344,2022-02-04
CASH_OUT,36363,Sabine Imbert,51244,14881,Agence_moov_Ouidah,300000,263637,2022-02-04
TRANSFER,13190,Sabine Imbert,14881,1691,Théodore-Alfred Fournier,273746,260556,2022-02-05
TRANSFER,62602,Paul De Sousa,188428,125826,Sabine Imbert,1691,64293,2022-02-05
CASH_IN,138726,Agence_moov_Abomey,300000,161274,Sabine Imbert,64293,203019,2022-02-05
CASH_OUT,198206,Sabine Imbert,203019,4813,Agence_moov_Abomey,300000,101794,2022-02-05
CASH_OUT,385,Sabine Imbert,4813,4428,Agence_moov_Cotonou,300000,299615,2022-02-05
TRANSFER,660086,Marianne Descamps,742700,82614,Sabine Imbert,4428,664514,2022-02-08
CASH_IN,104466,Agence_moov_Abomey,300000,195534,Sabine Imbert,664514,768980,2022-02-10
TRANSFER,89930,Laurence Dumont de Laroche,133700,43770,Sabine Imbert,768980,858910,2022-02-10
CASH_OUT,386919,Sabine Imbert,858910,471991,Agence_moov_Ouidah,300000,-86919,2022-02-12
CASH_IN,238092,Agence_moov_Cotonou,300000,61908,Sabine Imbert,471991,710083,2022-02-12
CASH_OUT,217792,Sabine Imbert,710083,492291,Agence_moov_Cotonou,300000,82208,2022-02-12
CASH_IN,294849,Agence_moov_Ouidah,300000,5151,Sabine Imbert,492291,787140,2022-02-16
CASH_OUT,184784,Sabine Imbert,787140,602356,Agence_moov_Ouidah,300000,115216,2022-02-17
TRANSFER,434424,Sabine Imbert,602356,167932,Joséphine Weber du Bonnin,6118,-428306,2022-02-17
CASH_OUT,87243,Sabine Imbert,167932,80689,Agence_moov_Cotonou,300000,212757,2022-02-20
CASH_OUT,54328,Sabine Imbert,80689,26361,Agence_moov_Abomey,300000,245672,2022-02-20
CASH_OUT,19398,Sabine Imbert,26361,6963,Agence_moov_Cotonou,300000,280602,2022-02-21
TRANSFER,6227,Sabine Imbert,6963,736,Gabriel de Pineau,44179,37952,2022-02-21
CASH_OUT,486,Sabine Imbert,736,250,Agence_moov_Ouidah,300000,299514,2022-02-21
TRANSFER,138,Sabine Imbert,250,112,Nath Léger,120650,120512,2022-02-27
CASH_OUT,540815,Laurent Besson,1229100,688285,Agence_moov_Ouidah,300000,-240815,2022-02-02
CASH_IN,265552,Agence_moov_Cotonou,300000,34448,Laurent Besson,688285,953837,2022-02-04
CASH_OUT,513482,Laurent Besson,953837,440355,Agence_moov_Abomey,300000,-213482,2022-02-04
CASH_IN,89745,Agence_moov_Ouidah,300000,210255,Laurent Besson,440355,530100,2022-02-04
TRANSFER,279512,Laurent Besson,530100,250588,Josette Guillon-Leclercq,1030655,751143,2022-02-06
CASH_OUT,157429,Laurent Besson,250588,93159,Agence_moov_Ouidah,300000,142571,2022-02-07
CASH_IN,70593,Agence_moov_Ouidah,300000,229407,Laurent Besson,93159,163752,2022-02-07
CASH_OUT,62106,Laurent Besson,163752,101646,Agence_moov_Ouidah,300000,237894,2022-02-07
CASH_IN,292490,Agence_moov_Abomey,300000,7510,Laurent Besson,101646,394136,2022-02-09
TRANSFER,34815,Laurence Dumont de Laroche,43770,8955,Laurent Besson,394136,428951,2022-02-11
CASH_OUT,198122,Laurent Besson,428951,230829,Agence_moov_Cotonou,300000,101878,2022-02-12
CASH_OUT,44400,Laurent Besson,230829,186429,Agence_moov_Ouidah,300000,255600,2022-02-14
CASH_IN,296980,Agence_moov_Abomey,300000,3020,Laurent Besson,186429,483409,2022-02-14
TRANSFER,938073,Marie Da Silva,1340900,402827,Laurent Besson,483409,1421482,2022-02-16
CASH_IN,46600,Agence_moov_Ouidah,300000,253400,Laurent Besson,1421482,1468082,2022-02-18
CASH_OUT,872165,Laurent Besson,1468082,595917,Agence_moov_Ouidah,300000,-572165,2022-02-20
CASH_OUT,118589,Laurent Besson,595917,477328,Agence_moov_Ouidah,300000,181411,2022-02-20
TRANSFER,1554,Frédérique Robin,7202,5648,Laurent Besson,477328,478882,2022-02-21
CASH_OUT,52997,Laurent Besson,478882,425885,Agence_moov_Abomey,300000,247003,2022-02-21
CASH_IN,165169,Agence_moov_Abomey,300000,134831,Laurent Besson,425885,591054,2022-02-21
TRANSFER,197964,Nicole Lacroix,402905,204941,Laurent Besson,591054,789018,2022-02-23
TRANSFER,310533,Laurent Besson,789018,478485,Luc-Tristan Moreau,1809300,1498767,2022-02-23
CASH_IN,100201,Agence_moov_Ouidah,300000,199799,Laurent Besson,478485,578686,2022-02-25
TRANSFER,277105,Laurent Besson,578686,301581,Isaac Le Pinto,431400,154295,2022-02-26
CASH_IN,195992,Agence_moov_Cotonou,300000,104008,Laurent Besson,301581,497573,2022-02-26
TRANSFER,1070091,Hugues Gay,1941400,871309,Laurent Besson,497573,1567664,2022-02-27
CASH_OUT,756322,Laurent Besson,1567664,811342,Agence_moov_Abomey,300000,-456322,2022-02-27
CASH_IN,272033,Agence_moov_Abomey,300000,27967,Lucy Vaillant,47600,319633,2022-02-01
CASH_OUT,123135,Lucy Vaillant,319633,196498,Agence_moov_Cotonou,300000,176865,2022-02-03
CASH_IN,139343,Agence_moov_Abomey,300000,160657,Lucy Vaillant,196498,335841,2022-02-03
CASH_OUT,191382,Lucy Vaillant,335841,144459,Agence_moov_Abomey,300000,108618,2022-02-05
CASH_OUT,14340,Lucy Vaillant,144459,130119,Agence_moov_Abomey,300000,285660,2022-02-05
CASH_IN,166630,Agence_moov_Ouidah,300000,133370,Lucy Vaillant,130119,296749,2022-02-06
CASH_OUT,242421,Lucy Vaillant,296749,54328,Agence_moov_Ouidah,300000,57579,2022-02-09
TRANSFER,35506,Margot Renaud de Lacombe,89421,53915,Lucy Vaillant,54328,89834,2022-02-10
CASH_IN,19808,Agence_moov_Abomey,300000,280192,Lucy Vaillant,89834,109642,2022-02-11
TRANSFER,394532,Valentine Traore,1728000,1333468,Lucy Vaillant,109642,504174,2022-02-13
CASH_IN,40351,Agence_moov_Ouidah,300000,259649,Lucy Vaillant,504174,544525,2022-02-13
TRANSFER,237419,Lucy Vaillant,544525,307106,Bernadette Fabre,377000,139581,2022-02-17
TRANSFER,125392,Lucy Vaillant,307106,181714,Alphonse Dupont-Petit,559745,434353,2022-02-18
TRANSFER,223944,Marthe Guillet,1303110,1079166,Lucy Vaillant,181714,405658,2022-02-19
TRANSFER,49067,Marianne Descamps,82614,33547,Lucy Vaillant,405658,454725,2022-02-21
TRANSFER,324319,Lucy Vaillant,454725,130406,Nicolas Hervé,1186100,861781,2022-02-23
TRANSFER,100600,Lucy Vaillant,130406,29806,Luc-Tristan Moreau,1498767,1398167,2022-02-24
CASH_OUT,6612,Lucy Vaillant,29806,23194,Agence_moov_Ouidah,300000,293388,2022-02-25
TRANSFER,21861,Benoît Verdier,115749,93888,Lucy Vaillant,23194,45055,2022-02-27
CASH_IN,291917,Agence_moov_Cotonou,300000,8083,Lucy Vaillant,45055,336972,2022-02-27
CASH_OUT,4339,Lucy Vaillant,336972,332633,Agence_moov_Abomey,300000,295661,2022-02-27
CASH_OUT,239012,Roland Colin,284066,45054,Agence_moov_Abomey,300000,60988,2022-02-01
TRANSFER,8707,Roland Colin,45054,36347,Nath Léger,120512,111805,2022-02-02
CASH_IN,102478,Agence_moov_Cotonou,300000,197522,Roland Colin,36347,138825,2022-02-02
CASH_OUT,37102,Roland Colin,138825,101723,Agence_moov_Ouidah,300000,262898,2022-02-04
CASH_IN,10358,Agence_moov_Abomey,300000,289642,Roland Colin,101723,112081,2022-02-05
TRANSFER,88857,Roland Colin,112081,23224,Isaac Le Pinto,154295,65438,2022-02-07
CASH_OUT,10958,Roland Colin,23224,12266,Agence_moov_Ouidah,300000,289042,2022-02-08
CASH_OUT,5731,Roland Colin,12266,6535,Agence_moov_Cotonou,300000,294269,2022-02-08
TRANSFER,5097,Roland Colin,6535,1438,Guy Guyon,1148500,1143403,2022-02-09
CASH_OUT,794,Roland Colin,1438,644,Agence_moov_Cotonou,300000,299206,2022-02-11
CASH_IN,29725,Agence_moov_Cotonou,300000,270275,Roland Colin,644,30369,2022-02-11
CASH_IN,192310,Agence_moov_Abomey,300000,107690,Roland Colin,30369,222679,2022-02-12
CASH_IN,154213,Agence_moov_Abomey,300000,145787,Roland Colin,222679,376892,2022-02-12
TRANSFER,64241,Roland Colin,376892,312651,Alphonse Dupont-Petit,434353,370112,2022-02-13
TRANSFER,142357,Roland Colin,312651,170294,Emmanuelle Gilbert,284015,141658,2022-02-16
CASH_IN,144267,Agence_moov_Ouidah,300000,155733,Roland Colin,170294,314561,2022-02-16
CASH_OUT,73774,Roland Colin,314561,240787,Agence_moov_Abomey,300000,226226,2022-02-18
CASH_OUT,179356,Roland Colin,240787,61431,Agence_moov_Ouidah,300000,120644,2022-02-18
TRANSFER,22901,Roland Colin,61431,38530,Maurice Alves,87660,64759,2022-02-21
CASH_OUT,33069,Roland Colin,38530,5461,Agence_moov_Abomey,300000,266931,2022-02-21
TRANSFER,2258,Roland Colin,5461,3203,Théodore Bertin,800480,798222,2022-02-23
TRANSFER,2328,Roland Colin,3203,875,Élodie Gérard,1095496,1093168,2022-02-25
CASH_OUT,509,Roland Colin,875,366,Agence_moov_Cotonou,300000,299491,2022-02-25
CASH_IN,222267,Agence_moov_Cotonou,300000,77733,Roland Colin,366,222633,2022-02-25
CASH_IN,64137,Agence_moov_Abomey,300000,235863,Roland Colin,222633,286770,2022-02-26
TRANSFER,9694,Emmanuelle Gilbert,141658,131964,Marie Da Silva,402827,412521,2022-02-04
CASH_OUT,199072,Marie Da Silva,412521,213449,Agence_moov_Cotonou,300000,100928,2022-02-04
CASH_OUT,169554,Marie Da Silva,213449,43895,Agence_moov_Ouidah,300000,130446,2022-02-05
CASH_IN,204652,Agence_moov_Ouidah,300000,95348,Marie Da Silva,43895,248547,2022-02-05
CASH_IN,225805,Agence_moov_Ouidah,300000,74195,Marie Da Silva,248547,474352,2022-02-05
TRANSFER,267227,Marie Da Silva,474352,207125,Maurice Alves,64759,-202468,2022-02-05
CASH_OUT,78498,Marie Da Silva,207125,128627,Agence_moov_Ouidah,300000,221502,2022-02-06
CASH_IN,104742,Agence_moov_Ouidah,300000,195258,Marie Da Silva,128627,233369,2022-02-07
TRANSFER,152148,Paul Pereira,769112,616964,Marie Da Silva,233369,385517,2022-02-08
CASH_OUT,39615,Marie Da Silva,385517,345902,Agence_moov_Ouidah,300000,260385,2022-02-08
CASH_OUT,44263,Marie Da Silva,345902,301639,Agence_moov_Abomey,300000,255737,2022-02-08
CASH_IN,242944,Agence_moov_Cotonou,300000,57056,Marie Da Silva,301639,544583,2022-02-12
TRANSFER,98095,Marie Da Silva,544583,446488,Théodore-Alfred Fournier,260556,162461,2022-02-13
CASH_IN,45788,Agence_moov_Abomey,300000,254212,Marie Da Silva,446488,492276,2022-02-14
CASH_OUT,84976,Marie Da Silva,492276,407300,Agence_moov_Cotonou,300000,215024,2022-02-17
CASH_IN,236426,Agence_moov_Abomey,300000,63574,Marie Da Silva,407300,643726,2022-02-17
TRANSFER,139211,Marie Da Silva,643726,504515,Frédérique Robin,5648,-133563,2022-02-18
CASH_OUT,427992,Marie Da Silva,504515,76523,Agence_moov_Abomey,300000,-127992,2022-02-18
CASH_OUT,3363,Marie Da Silva,76523,73160,Agence_moov_Abomey,300000,296637,2022-02-23
CASH_IN,27409,Agence_moov_Cotonou,300000,272591,Marie Da Silva,73160,100569,2022-02-23
CASH_OUT,31088,Marie Da Silva,100569,69481,Agence_moov_Ouidah,300000,268912,2022-02-26
CASH_OUT,46622,Marie Da Silva,69481,22859,Agence_moov_Cotonou,300000,253378,2022-02-26
CASH_IN,180056,Agence_moov_Abomey,300000,119944,Émilie Guillon de Duhamel,124788,304844,2022-02-01
CASH_IN,62730,Agence_moov_Ouidah,300000,237270,Émilie Guillon de Duhamel,304844,367574,2022-02-01
CASH_IN,231769,Agence_moov_Cotonou,300000,68231,Émilie Guillon de Duhamel,367574,599343,2022-02-02
CASH_OUT,501144,Émilie Guillon de Duhamel,599343,98199,Agence_moov_Cotonou,300000,-201144,2022-02-03
CASH_OUT,28404,Émilie Guillon de Duhamel,98199,69795,Agence_moov_Ouidah,300000,271596,2022-02-03
CASH_IN,68938,Agence_moov_Abomey,300000,231062,Émilie Guillon de Duhamel,69795,138733,2022-02-04
TRANSFER,518221,Marthe Guillet,1079166,560945,Émilie Guillon de Duhamel,138733,656954,2022-02-04
CASH_IN,123094,Agence_moov_Ouidah,300000,176906,Émilie Guillon de Duhamel,656954,780048,2022-02-04
TRANSFER,666125,Émilie Guillon de Duhamel,780048,113923,Paul De Sousa,125826,-540299,2022-02-04
TRANSFER,85083,Émilie Guillon de Duhamel,113923,28840,Nicolas Hervé,861781,776698,2022-02-06
TRANSFER,23039,Émilie Guillon de Duhamel,28840,5801,Agnès Baron,495128,472089,2022-02-07
TRANSFER,4069,Émilie Guillon de Duhamel,5801,1732,Luc-Tristan Moreau,1398167,1394098,2022-02-10
TRANSFER,1243,Émilie Guillon de Duhamel,1732,489,Noël Hamel,121693,120450,2022-02-11
CASH_OUT,199,Émilie Guillon de Duhamel,489,290,Agence_moov_Ouidah,300000,299801,2022-02-12
TRANSFER,167,Émilie Guillon de Duhamel,290,123,Maryse Reynaud-Michaud,64842,64675,2022-02-13
TRANSFER,119,Émilie Guillon de Duhamel,123,4,Nicolas Hervé,776698,776579,2022-02-13
CASH_IN,285018,Agence_moov_Abomey,300000,14982,Émilie Guillon de Duhamel,4,285022,2022-02-14
CASH_OUT,18717,Émilie Guillon de Duhamel,285022,266305,Agence_moov_Cotonou,300000,281283,2022-02-16
CASH_IN,206655,Agence_moov_Cotonou,300000,93345,Émilie Guillon de Duhamel,266305,472960,2022-02-16
CASH_OUT,215804,Émilie Guillon de Duhamel,472960,257156,Agence_moov_Cotonou,300000,84196,2022-02-18
TRANSFER,974266,Caroline Monnier,1668427,694161,Émilie Guillon de Duhamel,257156,1231422,2022-02-19
CASH_IN,120221,Agence_moov_Abomey,300000,179779,Émilie Guillon de Duhamel,1231422,1351643,2022-02-20
CASH_IN,18234,Agence_moov_Cotonou,300000,281766,Émilie Guillon de Duhamel,1351643,1369877,2022-02-24
CASH_OUT,987805,Émilie Guillon de Duhamel,1369877,382072,Agence_moov_Abomey,300000,-687805,2022-02-24
CASH_IN,45741,Agence_moov_Abomey,300000,254259,Émilie Guillon de Duhamel,382072,427813,2022-02-25
CASH_OUT,421916,Émilie Guillon de Duhamel,427813,5897,Agence_moov_Abomey,300000,-121916,2022-02-25
CASH_IN,8191,Agence_moov_Ouidah,300000,291809,Léon Paris,-709820,-701629,2022-02-02
CASH_IN,119196,Agence_moov_Ouidah,300000,180804,Léon Paris,-701629,-582433,2022-02-05
CASH_IN,218956,Agence_moov_Abomey,300000,81044,Léon Paris,-582433,-363477,2022-02-10
CASH_IN,113948,Agence_moov_Cotonou,300000,186052,Léon Paris,-363477,-249529,2022-02-10
CASH_IN,26330,Agence_moov_Abomey,300000,273670,Léon Paris,-249529,-223199,2022-02-10
CASH_IN,273371,Agence_moov_Abomey,300000,26629,Léon Paris,-223199,50172,2022-02-12
CASH_OUT,32896,Léon Paris,50172,17276,Agence_moov_Abomey,300000,267104,2022-02-14
CASH_IN,232476,Agence_moov_Cotonou,300000,67524,Léon Paris,17276,249752,2022-02-14
CASH_IN,67028,Agence_moov_Ouidah,300000,232972,Léon Paris,249752,316780,2022-02-14
TRANSFER,177698,Léon Paris,316780,139082,Christophe Guilbert,26711,-150987,2022-02-14
CASH_OUT,30747,Léon Paris,139082,108335,Agence_moov_Ouidah,300000,269253,2022-02-14
CASH_OUT,101694,Léon Paris,108335,6641,Agence_moov_Abomey,300000,198306,2022-02-15
CASH_IN,39705,Agence_moov_Ouidah,300000,260295,Léon Paris,6641,46346,2022-02-16
TRANSFER,41523,Léon Paris,46346,4823,Théodore-Alfred Fournier,162461,120938,2022-02-17
TRANSFER,362180,Sébastien Jourdan,1921344,1559164,Léon Paris,4823,367003,2022-02-17
TRANSFER,354877,Léon Paris,367003,12126,Isaac Le Pinto,65438,-289439,2022-02-19
CASH_IN,195964,Agence_moov_Cotonou,300000,104036,Léon Paris,12126,208090,2022-02-20
CASH_OUT,154595,Léon Paris,208090,53495,Agence_moov_Cotonou,300000,145405,2022-02-21
CASH_IN,125434,Agence_moov_Cotonou,300000,174566,Léon Paris,53495,178929,2022-02-22
CASH_OUT,17711,Léon Paris,178929,161218,Agence_moov_Abomey,300000,282289,2022-02-25
CASH_IN,220631,Agence_moov_Ouidah,300000,79369,Léon Paris,161218,381849,2022-02-26
CASH_IN,147603,Agence_moov_Abomey,300000,152397,Richard Guibert,-63953,83650,2022-02-01
CASH_IN,254542,Agence_moov_Cotonou,300000,45458,Richard Guibert,83650,338192,2022-02-02
TRANSFER,17121,Richard Guibert,338192,321071,Luc Camus,584084,566963,2022-02-02
TRANSFER,160207,Richard Guibert,321071,160864,Richard Guibert,321071,160864,2022-02-03
TRANSFER,77406,Richard Guibert,160864,83458,Caroline Bonneau,798400,720994,2022-02-03
TRANSFER,45737,Richard Guibert,83458,37721,Théophile Mendès,1737000,1691263,2022-02-07
CASH_IN,213932,Agence_moov_Cotonou,300000,86068,Richard Guibert,37721,251653,2022-02-08
CASH_OUT,181278,Richard Guibert,251653,70375,Agence_moov_Ouidah,300000,118722,2022-02-08
CASH_IN,230185,Agence_moov_Cotonou,300000,69815,Richard Guibert,70375,300560,2022-02-08
CASH_OUT,219499,Richard Guibert,300560,81061,Agence_moov_Ouidah,300000,80501,2022-02-09
TRANSFER,13328,Richard Guibert,81061,67733,Hugues Gay,871309,857981,2022-02-09
CASH_IN,206212,Agence_moov_Cotonou,300000,93788,Richard Guibert,67733,273945,2022-02-10
CASH_OUT,173582,Richard Guibert,273945,100363,Agence_moov_Ouidah,300000,126418,2022-02-14
CASH_OUT,96826,Richard Guibert,100363,3537,Agence_moov_Cotonou,300000,203174,2022-02-15
TRANSFER,1168,Richard Guibert,3537,2369,Caroline Bonneau,720994,719826,2022-02-16
CASH_OUT,1724,Richard Guibert,2369,645,Agence_moov_Cotonou,300000,298276,2022-02-17
CASH_IN,225422,Agence_moov_Ouidah,300000,74578,Richard Guibert,645,226067,2022-02-17
TRANSFER,126564,Richard Guibert,226067,99503,Grégoire Delmas de Blanchard,494500,367936,2022-02-20
TRANSFER,18336,Alex Salmon,328148,309812,Richard Guibert,99503,117839,2022-02-20
CASH_IN,191333,Agence_moov_Ouidah,300000,108667,Richard Guibert,117839,309172,2022-02-22
TRANSFER,976371,Diane-Françoise Raynaud,1504600,528229,Richard Guibert,309172,1285543,2022-02-24
CASH_OUT,737705,Richard Guibert,1285543,547838,Agence_moov_Ouidah,300000,-437705,2022-02-25
CASH_IN,130095,Agence_moov_Cotonou,300000,169905,Richard Guibert,547838,677933,2022-02-25
CASH_IN,33932,Agence_moov_Abomey,300000,266068,Richard Guibert,677933,711865,2022-02-26
CASH_IN,233883,Agence_moov_Ouidah,300000,66117,Richard Guibert,711865,945748,2022-02-27
TRANSFER,37622,Sébastien-Arthur Masse,38400,778,Joseph de la Dubois,1445200,1482822,2022-02-02
TRANSFER,467350,Joseph de la Dubois,1482822,1015472,Nicole Lacroix,204941,-262409,2022-02-02
CASH_OUT,265330,Joseph de la Dubois,1015472,750142,Agence_moov_Abomey,300000,34670,2022-02-02
TRANSFER,506942,Joseph de la Dubois,750142,243200,Caroline Monnier,694161,187219,2022-02-03
CASH_IN,126332,Agence_moov_Cotonou,300000,173668,Joseph de la Dubois,243200,369532,2022-02-04
TRANSFER,255558,Joseph de la Dubois,369532,113974,Bernadette Fabre,139581,-115977,2022-02-05
CASH_OUT,51202,Joseph de la Dubois,113974,62772,Agence_moov_Cotonou,300000,248798,2022-02-05
TRANSFER,36214,Joseph de la Dubois,62772,26558,Maryse Reynaud-Michaud,64675,28461,2022-02-06
CASH_OUT,10103,Joseph de la Dubois,26558,16455,Agence_moov_Abomey,300000,289897,2022-02-07
CASH_OUT,3973,Joseph de la Dubois,16455,12482,Agence_moov_Abomey,300000,296027,2022-02-07
TRANSFER,2941,Joseph de la Dubois,12482,9541,Caroline Monnier,187219,184278,2022-02-09
CASH_IN,182299,Agence_moov_Abomey,300000,117701,Joseph de la Dubois,9541,191840,2022-02-09
TRANSFER,73760,Joseph de la Dubois,191840,118080,Marianne Descamps,33547,-40213,2022-02-13
CASH_OUT,12160,Joseph de la Dubois,118080,105920,Agence_moov_Cotonou,300000,287840,2022-02-13
TRANSFER,79007,Joseph de la Dubois,105920,26913,Caroline Monnier,184278,105271,2022-02-13
CASH_IN,7518,Agence_moov_Cotonou,300000,292482,Joseph de la Dubois,26913,34431,2022-02-14
CASH_OUT,29117,Joseph de la Dubois,34431,5314,Agence_moov_Cotonou,300000,270883,2022-02-16
CASH_IN,295385,Agence_moov_Cotonou,300000,4615,Joseph de la Dubois,5314,300699,2022-02-18
CASH_IN,258783,Agence_moov_Abomey,300000,41217,Joseph de la Dubois,300699,559482,2022-02-19
CASH_IN,273318,Agence_moov_Abomey,300000,26682,Joseph de la Dubois,559482,832800,2022-02-20
CASH_IN,16673,Agence_moov_Abomey,300000,283327,Joseph de la Dubois,832800,849473,2022-02-22
CASH_OUT,128115,Joseph de la Dubois,849473,721358,Agence_moov_Ouidah,300000,171885,2022-02-22
CASH_IN,92802,Agence_moov_Cotonou,300000,207198,Joseph de la Dubois,721358,814160,2022-02-24
CASH_OUT,613820,Joseph de la Dubois,814160,200340,Agence_moov_Ouidah,300000,-313820,2022-02-24
CASH_OUT,186774,Joseph de la Dubois,200340,13566,Agence_moov_Cotonou,300000,113226,2022-02-24
CASH_OUT,382165,Valentine Traore,1333468,951303,Agence_moov_Cotonou,300000,-82165,2022-02-02
CASH_IN,130167,Agence_moov_Cotonou,300000,169833,Valentine Traore,951303,1081470,2022-02-02
CASH_OUT,124168,Valentine Traore,1081470,957302,Agence_moov_Abomey,300000,175832,2022-02-02
TRANSFER,319897,Valentine Traore,957302,637405,Marthe Guillet,560945,241048,2022-02-04
TRANSFER,296783,Diane-Françoise Raynaud,528229,231446,Valentine Traore,637405,934188,2022-02-05
CASH_OUT,732048,Valentine Traore,934188,202140,Agence_moov_Ouidah,300000,-432048,2022-02-07
TRANSFER,11928,Valentine Traore,202140,190212,Sébastien-Arthur Masse,778,-11150,2022-02-07
CASH_IN,114166,Agence_moov_Cotonou,300000,185834,Valentine Traore,190212,304378,2022-02-10
TRANSFER,220381,Valentine Traore,304378,83997,Paul Pereira,616964,396583,2022-02-11
TRANSFER,15161,Valentine Traore,83997,68836,Emmanuelle Gilbert,131964,116803,2022-02-12
CASH_IN,253382,Agence_moov_Ouidah,300000,46618,Valentine Traore,68836,322218,2022-02-12
CASH_OUT,10375,Valentine Traore,322218,311843,Agence_moov_Ouidah,300000,289625,2022-02-12
CASH_IN,273333,Agence_moov_Abomey,300000,26667,Valentine Traore,311843,585176,2022-02-12
CASH_IN,137995,Agence_moov_Cotonou,300000,162005,Valentine Traore,585176,723171,2022-02-13
CASH_OUT,310292,Valentine Traore,723171,412879,Agence_moov_Cotonou,300000,-10292,2022-02-17
CASH_OUT,326597,Valentine Traore,412879,86282,Agence_moov_Ouidah,300000,-26597,2022-02-17
TRANSFER,12428,Valentine Traore,86282,73854,Valentine Traore,86282,98710,2022-02-18
CASH_IN,119048,Agence_moov_Cotonou,300000,180952,Valentine Traore,73854,192902,2022-02-19
CASH_OUT,148779,Valentine Traore,192902,44123,Agence_moov_Abomey,300000,151221,2022-02-19
CASH_OUT,19620,Valentine Traore,44123,24503,Agence_moov_Cotonou,300000,280380,2022-02-22
TRANSFER,400067,Agnès Baron,472089,72022,Valentine Traore,24503,424570,2022-02-23
CASH_OUT,62175,Valentine Traore,424570,362395,Agence_moov_Ouidah,300000,237825,2022-02-26
CASH_OUT,269725,Valentine Traore,362395,92670,Agence_moov_Ouidah,300000,30275,2022-02-27
CASH_OUT,179593,Maurice Seguin,480398,300805,Agence_moov_Ouidah,300000,120407,2022-02-02
CASH_OUT,130130,Maurice Seguin,300805,170675,Agence_moov_Ouidah,300000,169870,2022-02-02
CASH_OUT,143412,Maurice Seguin,170675,27263,Agence_moov_Ouidah,300000,156588,2022-02-04
CASH_OUT,3981,Maurice Seguin,27263,23282,Agence_moov_Ouidah,300000,296019,2022-02-04
CASH_IN,51034,Agence_moov_Cotonou,300000,248966,Maurice Seguin,23282,74316,2022-02-04
CASH_OUT,475,Maurice Seguin,74316,73841,Agence_moov_Abomey,300000,299525,2022-02-04
CASH_OUT,8588,Maurice Seguin,73841,65253,Agence_moov_Cotonou,300000,291412,2022-02-06
CASH_OUT,12656,Maurice Seguin,65253,52597,Agence_moov_Abomey,300000,287344,2022-02-08
CASH_IN,243363,Agence_moov_Ouidah,300000,56637,Maurice Seguin,52597,295960,2022-02-09
TRANSFER,205203,Diane-Françoise Raynaud,231446,26243,Maurice Seguin,295960,501163,2022-02-09
TRANSFER,375230,Hugues Gay,857981,482751,Maurice Seguin,501163,876393,2022-02-12
CASH_IN,158278,Agence_moov_Ouidah,300000,141722,Maurice Seguin,876393,1034671,2022-02-13
CASH_OUT,680658,Maurice Seguin,1034671,354013,Agence_moov_Abomey,300000,-380658,2022-02-13
TRANSFER,1244778,Luc-Tristan Moreau,1394098,149320,Maurice Seguin,354013,1598791,2022-02-15
CASH_IN,185678,Agence_moov_Abomey,300000,114322,Maurice Seguin,1598791,1784469,2022-02-15
CASH_OUT,727292,Maurice Seguin,1784469,1057177,Agence_moov_Cotonou,300000,-427292,2022-02-16
CASH_OUT,429988,Maurice Seguin,1057177,627189,Agence_moov_Cotonou,300000,-129988,2022-02-17
CASH_OUT,477468,Maurice Seguin,627189,149721,Agence_moov_Cotonou,300000,-177468,2022-02-19
CASH_IN,93924,Agence_moov_Cotonou,300000,206076,Maurice Seguin,149721,243645,2022-02-19
CASH_OUT,182033,Maurice Seguin,243645,61612,Agence_moov_Ouidah,300000,117967,2022-02-20
TRANSFER,18283,Maurice Seguin,61612,43329,Emmanuel-René Coulon,198555,180272,2022-02-20
CASH_OUT,5014,Maurice Seguin,43329,38315,Agence_moov_Abomey,300000,294986,2022-02-20
TRANSFER,35233,Maurice Seguin,38315,3082,Alphonse Dupont-Petit,370112,334879,2022-02-20
TRANSFER,334544,Paul Pereira,396583,62039,Maurice Seguin,3082,337626,2022-02-21
CASH_OUT,223982,Maurice Seguin,337626,113644,Agence_moov_Abomey,300000,76018,2022-02-21
CASH_IN,113342,Agence_moov_Abomey,300000,186658,Maurice Seguin,113644,226986,2022-02-21
CASH_OUT,112928,Maurice Seguin,226986,114058,Agence_moov_Ouidah,300000,187072,2022-02-22
CASH_OUT,79417,Maurice Seguin,114058,34641,Agence_moov_Abomey,300000,220583,2022-02-23
TRANSFER,12015,Maurice Seguin,34641,22626,Gabriel de Pineau,37952,25937,2022-02-24
TRANSFER,67764,Emmanuel Bousquet,259327,191563,Josette Guillon-Leclercq,751143,818907,2022-02-01
CASH_IN,177942,Agence_moov_Abomey,300000,122058,Josette Guillon-Leclercq,818907,996849,2022-02-01
TRANSFER,28121,Maryse Reynaud-Michaud,28461,340,Josette Guillon-Leclercq,996849,1024970,2022-02-01
TRANSFER,445809,Nicolas Hervé,776579,330770,Josette Guillon-Leclercq,1024970,1470779,2022-02-06
CASH_IN,91618,Agence_moov_Ouidah,300000,208382,Josette Guillon-Leclercq,1470779,1562397,2022-02-07
CASH_IN,75289,Agence_moov_Ouidah,300000,224711,Josette Guillon-Leclercq,1562397,1637686,2022-02-08
CASH_OUT,1520010,Josette Guillon-Leclercq,1637686,117676,Agence_moov_Ouidah,300000,-1220010,2022-02-08
CASH_IN,166090,Agence_moov_Cotonou,300000,133910,Josette Guillon-Leclercq,117676,283766,2022-02-10
CASH_IN,252082,Agence_moov_Cotonou,300000,47918,Josette Guillon-Leclercq,283766,535848,2022-02-11
TRANSFER,490427,Josette Guillon-Leclercq,535848,45421,Théophile Mendès,1691263,1200836,2022-02-12
TRANSFER,302941,Grégoire Delmas de Blanchard,367936,64995,Josette Guillon-Leclercq,45421,348362,2022-02-13
CASH_IN,122262,Agence_moov_Ouidah,300000,177738,Josette Guillon-Leclercq,348362,470624,2022-02-13
CASH_IN,263551,Agence_moov_Abomey,300000,36449,Josette Guillon-Leclercq,470624,734175,2022-02-13
CASH_OUT,91222,Josette Guillon-Leclercq,734175,642953,Agence_moov_Abomey,300000,208778,2022-02-15
CASH_OUT,317063,Josette Guillon-Leclercq,642953,325890,Agence_moov_Abomey,300000,-17063,2022-02-16
TRANSFER,59054,Adrienne Arnaud,401100,342046,Josette Guillon-Leclercq,325890,384944,2022-02-17
CASH_IN,223211,Agence_moov_Abomey,300000,76789,Josette Guillon-Leclercq,384944,608155,2022-02-17
CASH_IN,131716,Agence_moov_Abomey,300000,168284,Josette Guillon-Leclercq,608155,739871,2022-02-17
TRANSFER,397579,Josette Guillon-Leclercq,739871,342292,Nath Léger,111805,-285774,2022-02-18
TRANSFER,12934,Josette Guillon-Leclercq,342292,329358,Laurence Dumont de Laroche,8955,-3979,2022-02-18
CASH_OUT,251241,Josette Guillon-Leclercq,329358,78117,Agence_moov_Abomey,300000,48759,2022-02-20
TRANSFER,141855,Luc-Tristan Moreau,149320,7465,Josette Guillon-Leclercq,78117,219972,2022-02-21
CASH_OUT,192100,Josette Guillon-Leclercq,219972,27872,Agence_moov_Ouidah,300000,107900,2022-02-21
CASH_OUT,20757,Josette Guillon-Leclercq,27872,7115,Agence_moov_Cotonou,300000,279243,2022-02-21
CASH_OUT,3651,Josette Guillon-Leclercq,7115,3464,Agence_moov_Ouidah,300000,296349,2022-02-21
CASH_IN,208573,Agence_moov_Cotonou,300000,91427,Josette Guillon-Leclercq,3464,212037,2022-02-23
CASH_OUT,22402,Josette Guillon-Leclercq,212037,189635,Agence_moov_Cotonou,300000,277598,2022-02-25
CASH_OUT,436521,Luc Camus,566963,130442,Agence_moov_Ouidah,300000,-136521,2022-02-01
CASH_OUT,75259,Luc Camus,130442,55183,Agence_moov_Cotonou,300000,224741,2022-02-01
TRANSFER,33981,Luc Camus,55183,21202,Emmanuel-René Coulon,180272,146291,2022-02-03
TRANSFER,4852,Luc Camus,21202,16350,Luc-Tristan Moreau,7465,2613,2022-02-04
CASH_IN,192202,Agence_moov_Ouidah,300000,107798,Luc Camus,16350,208552,2022-02-05
TRANSFER,692673,Aimé Allain,794949,102276,Luc Camus,208552,901225,2022-02-06
CASH_OUT,809268,Luc Camus,901225,91957,Agence_moov_Abomey,300000,-509268,2022-02-07
TRANSFER,52626,Aimé Allain,102276,49650,Luc Camus,91957,144583,2022-02-09
CASH_OUT,37388,Luc Camus,144583,107195,Agence_moov_Cotonou,300000,262612,2022-02-10
CASH_IN,158441,Agence_moov_Ouidah,300000,141559,Luc Camus,107195,265636,2022-02-10
CASH_OUT,115666,Luc Camus,265636,149970,Agence_moov_Abomey,300000,184334,2022-02-12
CASH_IN,135788,Agence_moov_Cotonou,300000,164212,Luc Camus,149970,285758,2022-02-12
TRANSFER,6635,Agnès Baron,72022,65387,Luc Camus,285758,292393,2022-02-14
CASH_OUT,4308,Luc Camus,292393,288085,Agence_moov_Abomey,300000,295692,2022-02-15
CASH_IN,285670,Agence_moov_Abomey,300000,14330,Luc Camus,288085,573755,2022-02-15
CASH_OUT,519744,Luc Camus,573755,54011,Agence_moov_Cotonou,300000,-219744,2022-02-19
CASH_IN,288657,Agence_moov_Abomey,300000,11343,Luc Camus,54011,342668,2022-02-19
CASH_OUT,137992,Luc Camus,342668,204676,Agence_moov_Cotonou,300000,162008,2022-02-21
CASH_OUT,114697,Luc Camus,204676,89979,Agence_moov_Ouidah,300000,185303,2022-02-22
CASH_IN,47110,Agence_moov_Ouidah,300000,252890,Luc Camus,89979,137089,2022-02-22
CASH_IN,52566,Agence_moov_Ouidah,300000,247434,Luc Camus,137089,189655,2022-02-23
TRANSFER,87860,Caroline Monnier,105271,17411,Luc Camus,189655,277515,2022-02-23
CASH_IN,24278,Agence_moov_Abomey,300000,275722,Luc Camus,277515,301793,2022-02-24
CASH_IN,245448,Agence_moov_Ouidah,300000,54552,Luc Camus,301793,547241,2022-02-27
TRANSFER,270994,Alphonse Dupont-Petit,334879,63885,Noël Hamel,120450,391444,2022-02-01
CASH_OUT,131497,Noël Hamel,391444,259947,Agence_moov_Cotonou,300000,168503,2022-02-02
CASH_IN,33986,Agence_moov_Cotonou,300000,266014,Noël Hamel,259947,293933,2022-02-02
CASH_IN,224946,Agence_moov_Cotonou,300000,75054,Noël Hamel,293933,518879,2022-02-02
CASH_OUT,90618,Noël Hamel,518879,428261,Agence_moov_Ouidah,300000,209382,2022-02-03
CASH_OUT,78395,Noël Hamel,428261,349866,Agence_moov_Abomey,300000,221605,2022-02-04
TRANSFER,88549,Noël Hamel,349866,261317,Emmanuelle Gilbert,116803,28254,2022-02-04
CASH_IN,36785,Agence_moov_Abomey,300000,263215,Noël Hamel,261317,298102,2022-02-06
TRANSFER,4996,Emmanuelle Gilbert,28254,23258,Noël Hamel,298102,303098,2022-02-06
TRANSFER,236337,Noël Hamel,303098,66761,Margot Renaud de Lacombe,53915,-182422,2022-02-07
TRANSFER,37195,Noël Hamel,66761,29566,Augustin Benard,1462877,1425682,2022-02-08
CASH_IN,146814,Agence_moov_Abomey,300000,153186,Noël Hamel,29566,176380,2022-02-09
CASH_IN,177047,Agence_moov_Abomey,300000,122953,Noël Hamel,176380,353427,2022-02-10
TRANSFER,123580,Noël Hamel,353427,229847,Grégoire Delmas de Blanchard,64995,-58585,2022-02-10
CASH_OUT,165312,Noël Hamel,229847,64535,Agence_moov_Ouidah,300000,134688,2022-02-11
CASH_OUT,34477,Noël Hamel,64535,30058,Agence_moov_Ouidah,300000,265523,2022-02-11
CASH_IN,284127,Agence_moov_Cotonou,300000,15873,Noël Hamel,30058,314185,2022-02-13
TRANSFER,93012,Noël Hamel,314185,221173,Gabriel de Pineau,25937,-67075,2022-02-15
CASH_IN,236786,Agence_moov_Ouidah,300000,63214,Noël Hamel,221173,457959,2022-02-16
CASH_IN,48127,Agence_moov_Abomey,300000,251873,Noël Hamel,457959,506086,2022-02-16
CASH_IN,185947,Agence_moov_Cotonou,300000,114053,Noël Hamel,506086,692033,2022-02-18
TRANSFER,335259,Noël Hamel,692033,356774,Alex Salmon,309812,-25447,2022-02-18
CASH_OUT,35768,Noël Hamel,356774,321006,Agence_moov_Abomey,300000,264232,2022-02-19
CASH_OUT,320057,Noël Hamel,321006,949,Agence_moov_Ouidah,300000,-20057,2022-02-20
TRANSFER,631302,Augustin Benard,1425682,794380,Noël Hamel,949,632251,2022-02-21
CASH_IN,131321,Agence_moov_Ouidah,300000,168679,Noël Hamel,632251,763572,2022-02-27
CASH_IN,252420,Agence_moov_Abomey,300000,47580,Arnaude Gaillard,-136048,116372,2022-02-03
TRANSFER,314,Caroline Monnier,17411,17097,Arnaude Gaillard,116372,116686,2022-02-04
TRANSFER,35592,Arnaude Gaillard,116686,81094,Paul Pereira,62039,26447,2022-02-04
TRANSFER,36188,Alfred Chrétien,993730,957542,Arnaude Gaillard,81094,117282,2022-02-04
CASH_OUT,98480,Arnaude Gaillard,117282,18802,Agence_moov_Cotonou,300000,201520,2022-02-06
CASH_OUT,4117,Arnaude Gaillard,18802,14685,Agence_moov_Abomey,300000,295883,2022-02-07
TRANSFER,1397,Agnès Baron,65387,63990,Arnaude Gaillard,14685,16082,2022-02-08
TRANSFER,93274,Benoît Verdier,93888,614,Arnaude Gaillard,16082,109356,2022-02-08
CASH_OUT,102665,Arnaude Gaillard,109356,6691,Agence_moov_Cotonou,300000,197335,2022-02-10
CASH_IN,253906,Agence_moov_Cotonou,300000,46094,Arnaude Gaillard,6691,260597,2022-02-11
TRANSFER,166371,Arnaude Gaillard,260597,94226,Arnaude Gaillard,260597,426968,2022-02-15
CASH_OUT,89445,Arnaude Gaillard,94226,4781,Agence_moov_Ouidah,300000,210555,2022-02-19
CASH_OUT,1988,Arnaude Gaillard,4781,2793,Agence_moov_Cotonou,300000,298012,2022-02-20
CASH_OUT,2082,Arnaude Gaillard,2793,711,Agence_moov_Abomey,300000,297918,2022-02-20
TRANSFER,2230,Paul Pereira,26447,24217,Arnaude Gaillard,711,2941,2022-02-22
TRANSFER,1045,Arnaude Gaillard,2941,1896,Théodore-Alfred Fournier,120938,119893,2022-02-24
CASH_IN,89153,Agence_moov_Ouidah,300000,210847,Arnaude Gaillard,1896,91049,2022-02-25
CASH_IN,154994,Agence_moov_Cotonou,300000,145006,Bernadette Fabre,-115977,39017,2022-02-01
CASH_IN,105433,Agence_moov_Ouidah,300000,194567,Bernadette Fabre,39017,144450,2022-02-02
CASH_IN,124812,Agence_moov_Abomey,300000,175188,Bernadette Fabre,144450,269262,2022-02-04
CASH_IN,43411,Agence_moov_Cotonou,300000,256589,Bernadette Fabre,269262,312673,2022-02-04
CASH_IN,233626,Agence_moov_Abomey,300000,66374,Bernadette Fabre,312673,546299,2022-02-09
CASH_IN,11100,Agence_moov_Abomey,300000,288900,Bernadette Fabre,546299,557399,2022-02-10
TRANSFER,370476,Alfred Chrétien,957542,587066,Bernadette Fabre,557399,927875,2022-02-12
CASH_IN,65291,Agence_moov_Ouidah,300000,234709,Bernadette Fabre,927875,993166,2022-02-18
TRANSFER,446004,Bernadette Fabre,993166,547162,Hugues Gay,482751,36747,2022-02-18
TRANSFER,1538,Luc-Tristan Moreau,2613,1075,Bernadette Fabre,547162,548700,2022-02-19
TRANSFER,341612,Bernadette Fabre,548700,207088,Paul Pereira,24217,-317395,2022-02-19
CASH_OUT,161468,Bernadette Fabre,207088,45620,Agence_moov_Cotonou,300000,138532,2022-02-21
CASH_OUT,38519,Bernadette Fabre,45620,7101,Agence_moov_Cotonou,300000,261481,2022-02-23
CASH_IN,273594,Agence_moov_Cotonou,300000,26406,Bernadette Fabre,7101,280695,2022-02-27
CASH_OUT,667768,Élodie Gérard,1093168,425400,Agence_moov_Ouidah,300000,-367768,2022-02-05
CASH_OUT,225923,Élodie Gérard,425400,199477,Agence_moov_Cotonou,300000,74077,2022-02-08
CASH_OUT,144877,Élodie Gérard,199477,54600,Agence_moov_Abomey,300000,155123,2022-02-13
CASH_OUT,39412,Élodie Gérard,54600,15188,Agence_moov_Cotonou,300000,260588,2022-02-15
TRANSFER,658,Élodie Gérard,15188,14530,Nicolas Hervé,330770,330112,2022-02-15
CASH_IN,228516,Agence_moov_Abomey,300000,71484,Élodie Gérard,14530,243046,2022-02-18
CASH_IN,72272,Agence_moov_Cotonou,300000,227728,Élodie Gérard,243046,315318,2022-02-23
CASH_IN,160142,Agence_moov_Cotonou,300000,139858,Élodie Gérard,315318,475460,2022-02-23
TRANSFER,179653,Marthe Guillet,241048,61395,Élodie Gérard,475460,655113,2022-02-24
TRANSFER,48429,Élodie Gérard,655113,606684,Benoît Verdier,614,-47815,2022-02-25
CASH_IN,79489,Agence_moov_Ouidah,300000,220511,Élodie Gérard,606684,686173,2022-02-25
CASH_IN,7838,Agence_moov_Ouidah,300000,292162,Anastasie Louis,-579179,-571341,2022-02-03
CASH_IN,124922,Agence_moov_Ouidah,300000,175078,Anastasie Louis,-571341,-446419,2022-02-11
CASH_IN,225501,Agence_moov_Ouidah,300000,74499,Anastasie Louis,-446419,-220918,2022-02-15
CASH_IN,225181,Agence_moov_Ouidah,300000,74819,Anastasie Louis,-220918,4263,2022-02-19
CASH_OUT,3633,Anastasie Louis,4263,630,Agence_moov_Abomey,300000,296367,2022-02-21
TRANSFER,147,Anastasie Louis,630,483,Alfred Chrétien,587066,586919,2022-02-23
CASH_IN,146150,Agence_moov_Abomey,300000,153850,Caroline Bonneau,719826,865976,2022-02-03
TRANSFER,90563,Théodore-Alfred Fournier,119893,29330,Caroline Bonneau,865976,956539,2022-02-03
CASH_OUT,515916,Caroline Bonneau,956539,440623,Agence_moov_Cotonou,300000,-215916,2022-02-04
CASH_OUT,413084,Caroline Bonneau,440623,27539,Agence_moov_Ouidah,300000,-113084,2022-02-04
CASH_IN,62825,Agence_moov_Abomey,300000,237175,Caroline Bonneau,27539,90364,2022-02-06
TRANSFER,39900,Caroline Bonneau,90364,50464,Alfred Chrétien,586919,547019,2022-02-06
CASH_OUT,45663,Caroline Bonneau,50464,4801,Agence_moov_Abomey,300000,254337,2022-02-08
CASH_IN,264579,Agence_moov_Cotonou,300000,35421,Caroline Bonneau,4801,269380,2022-02-10
TRANSFER,227066,Stéphanie Bonneau,281800,54734,Caroline Bonneau,269380,496446,2022-02-12
CASH_IN,149907,Agence_moov_Cotonou,300000,150093,Caroline Bonneau,496446,646353,2022-02-12
TRANSFER,171393,Caroline Bonneau,646353,474960,Sébastien Jourdan,1559164,1387771,2022-02-13
TRANSFER,278,Maryse Reynaud-Michaud,340,62,Caroline Bonneau,474960,475238,2022-02-15
TRANSFER,15295,Hugues Gay,36747,21452,Caroline Bonneau,475238,490533,2022-02-16
TRANSFER,30955,Emmanuel Bousquet,191563,160608,Caroline Bonneau,490533,521488,2022-02-16
TRANSFER,24523,Théodore-Alfred Fournier,29330,4807,Caroline Bonneau,521488,546011,2022-02-18
CASH_IN,268891,Agence_moov_Ouidah,300000,31109,Caroline Bonneau,546011,814902,2022-02-19
CASH_IN,81153,Agence_moov_Cotonou,300000,218847,Caroline Bonneau,814902,896055,2022-02-20
CASH_IN,139446,Agence_moov_Abomey,300000,160554,Caroline Bonneau,896055,1035501,2022-02-20
CASH_OUT,580777,Caroline Bonneau,1035501,454724,Agence_moov_Ouidah,300000,-280777,2022-02-21
CASH_OUT,857874,Théophile Mendès,1200836,342962,Agence_moov_Abomey,300000,-557874,2022-02-01
CASH_OUT,197153,Théophile Mendès,342962,145809,Agence_moov_Abomey,300000,102847,2022-02-02
CASH_IN,57770,Agence_moov_Ouidah,300000,242230,Théophile Mendès,145809,203579,2022-02-04
CASH_OUT,46179,Théophile Mendès,203579,157400,Agence_moov_Abomey,300000,253821,2022-02-05
CASH_IN,187500,Agence_moov_Cotonou,300000,112500,Théophile Mendès,157400,344900,2022-02-06
TRANSFER,1500,Théodore-Alfred Fournier,4807,3307,Théophile Mendès,344900,346400,2022-02-08
TRANSFER,61352,Emmanuel Bousquet,160608,99256,Théophile Mendès,346400,407752,2022-02-08
CASH_IN,135464,Agence_moov_Abomey,300000,164536,Théophile Mendès,407752,543216,2022-02-12
CASH_OUT,229614,Théophile Mendès,543216,313602,Agence_moov_Abomey,300000,70386,2022-02-14
CASH_OUT,245354,Théophile Mendès,313602,68248,Agence_moov_Cotonou,300000,54646,2022-02-15
CASH_IN,90813,Agence_moov_Ouidah,300000,209187,Théophile Mendès,68248,159061,2022-02-20
TRANSFER,613,Luc-Tristan Moreau,1075,462,Théophile Mendès,159061,159674,2022-02-26
TRANSFER,15452,Diane-Françoise Raynaud,26243,10791,Théophile Mendès,159674,175126,2022-02-26
CASH_OUT,168982,Théophile Mendès,175126,6144,Agence_moov_Abomey,300000,131018,2022-02-26
CASH_OUT,22330,Emmanuelle Gilbert,23258,928,Agence_moov_Abomey,300000,277670,2022-02-11
CASH_OUT,424,Emmanuelle Gilbert,928,504,Agence_moov_Ouidah,300000,299576,2022-02-13
CASH_IN,215469,Agence_moov_Abomey,300000,84531,Emmanuelle Gilbert,504,215973,2022-02-15
TRANSFER,5014,Hugues Gay,21452,16438,Emmanuelle Gilbert,215973,220987,2022-02-17
CASH_IN,76457,Agence_moov_Ouidah,300000,223543,Emmanuelle Gilbert,220987,297444,2022-02-20
TRANSFER,49612,Aimé Allain,49650,38,Emmanuelle Gilbert,297444,347056,2022-02-21
CASH_OUT,221414,Emmanuelle Gilbert,347056,125642,Agence_moov_Abomey,300000,78586,2022-02-22
CASH_IN,200875,Agence_moov_Ouidah,300000,99125,Emmanuelle Gilbert,125642,326517,2022-02-27
CASH_OUT,27390,Guy Guyon,1143403,1116013,Agence_moov_Ouidah,300000,272610,2022-02-04
CASH_OUT,742745,Guy Guyon,1116013,373268,Agence_moov_Cotonou,300000,-442745,2022-02-04
CASH_IN,268745,Agence_moov_Abomey,300000,31255,Guy Guyon,373268,642013,2022-02-08
TRANSFER,454836,Guy Guyon,642013,187177,Diane-Françoise Raynaud,10791,-444045,2022-02-09
CASH_IN,155328,Agence_moov_Abomey,300000,144672,Guy Guyon,187177,342505,2022-02-10
CASH_IN,211675,Agence_moov_Abomey,300000,88325,Guy Guyon,342505,554180,2022-02-19
TRANSFER,452164,Guy Guyon,554180,102016,Hugues Gay,16438,-435726,2022-02-20
TRANSFER,77419,Guy Guyon,102016,24597,Guy Guyon,102016,179435,2022-02-20
CASH_OUT,10281,Guy Guyon,24597,14316,Agence_moov_Ouidah,300000,289719,2022-02-20
CASH_IN,152352,Agence_moov_Abomey,300000,147648,Guy Guyon,14316,166668,2022-02-21
CASH_IN,87493,Agence_moov_Ouidah,300000,212507,Guy Guyon,166668,254161,2022-02-22
CASH_OUT,137946,Guy Guyon,254161,116215,Agence_moov_Cotonou,300000,162054,2022-02-24
CASH_IN,149988,Agence_moov_Cotonou,300000,150012,Hugues Gay,-435726,-285738,2022-02-01
CASH_IN,110606,Agence_moov_Ouidah,300000,189394,Hugues Gay,-285738,-175132,2022-02-02
CASH_IN,81973,Agence_moov_Ouidah,300000,218027,Hugues Gay,-175132,-93159,2022-02-04
CASH_IN,2084,Agence_moov_Ouidah,300000,297916,Hugues Gay,-93159,-91075,2022-02-05
CASH_IN,258080,Agence_moov_Abomey,300000,41920,Hugues Gay,-91075,167005,2022-02-06
TRANSFER,3065,Théodore-Alfred Fournier,3307,242,Hugues Gay,167005,170070,2022-02-06
TRANSFER,1349590,Sébastien Jourdan,1387771,38181,Hugues Gay,170070,1519660,2022-02-08
CASH_IN,88093,Agence_moov_Abomey,300000,211907,Hugues Gay,1519660,1607753,2022-02-09
CASH_OUT,890640,Hugues Gay,1607753,717113,Agence_moov_Ouidah,300000,-590640,2022-02-14
CASH_OUT,589706,Hugues Gay,717113,127407,Agence_moov_Abomey,300000,-289706,2022-02-15
TRANSFER,57277,Hugues Gay,127407,70130,Hugues Gay,127407,184684,2022-02-16
CASH_OUT,51193,Hugues Gay,70130,18937,Agence_moov_Abomey,300000,248807,2022-02-16
TRANSFER,3377,Hugues Gay,18937,15560,Stéphanie Bonneau,54734,51357,2022-02-17
CASH_OUT,10274,Hugues Gay,15560,5286,Agence_moov_Cotonou,300000,289726,2022-02-17
CASH_OUT,2513,Hugues Gay,5286,2773,Agence_moov_Abomey,300000,297487,2022-02-18
TRANSFER,511,Hugues Gay,2773,2262,Alfred Chrétien,547019,546508,2022-02-21
TRANSFER,292699,Alfred Chrétien,546508,253809,Hugues Gay,2262,294961,2022-02-24
CASH_IN,147706,Agence_moov_Ouidah,300000,152294,Hugues Gay,294961,442667,2022-02-27
TRANSFER,2872,Agnès Baron,63990,61118,Théodore Bertin,798222,801094,2022-02-01
CASH_OUT,474377,Théodore Bertin,801094,326717,Agence_moov_Ouidah,300000,-174377,2022-02-02
CASH_OUT,85696,Théodore Bertin,326717,241021,Agence_moov_Abomey,300000,214304,2022-02-04
TRANSFER,109274,Théodore Bertin,241021,131747,Théodore Bertin,241021,131747,2022-02-04
TRANSFER,24711,Emmanuel-René Coulon,146291,121580,Théodore Bertin,131747,156458,2022-02-04
CASH_OUT,115853,Théodore Bertin,156458,40605,Agence_moov_Ouidah,300000,184147,2022-02-04
CASH_IN,193949,Agence_moov_Ouidah,300000,106051,Théodore Bertin,40605,234554,2022-02-11
CASH_OUT,17490,Théodore Bertin,234554,217064,Agence_moov_Cotonou,300000,282510,2022-02-12
CASH_OUT,193194,Théodore Bertin,217064,23870,Agence_moov_Cotonou,300000,106806,2022-02-13
TRANSFER,16161,Théodore Bertin,23870,7709,Adrienne Arnaud,342046,325885,2022-02-14
CASH_IN,261089,Agence_moov_Abomey,300000,38911,Théodore Bertin,7709,268798,2022-02-16
TRANSFER,113462,Emmanuel-René Coulon,121580,8118,Théodore Bertin,268798,382260,2022-02-21
CASH_OUT,242519,Théodore Bertin,382260,139741,Agence_moov_Abomey,300000,57481,2022-02-22
CASH_IN,182364,Agence_moov_Abomey,300000,117636,Théodore Bertin,139741,322105,2022-02-22
TRANSFER,275808,Théodore Bertin,322105,46297,Luc-Tristan Moreau,462,-275346,2022-02-22
CASH_IN,237839,Agence_moov_Ouidah,300000,62161,Joséphine Weber du Bonnin,-428306,-190467,2022-02-02
CASH_IN,69946,Agence_moov_Cotonou,300000,230054,Joséphine Weber du Bonnin,-190467,-120521,2022-02-03
CASH_IN,158144,Agence_moov_Abomey,300000,141856,Joséphine Weber du Bonnin,-120521,37623,2022-02-13
CASH_OUT,14338,Joséphine Weber du Bonnin,37623,23285,Agence_moov_Abomey,300000,285662,2022-02-14
CASH_OUT,10941,Joséphine Weber du Bonnin,23285,12344,Agence_moov_Abomey,300000,289059,2022-02-23
TRANSFER,4203,Joséphine Weber du Bonnin,12344,8141,Agnès Baron,61118,56915,2022-02-25
CASH_OUT,5408,Joséphine Weber du Bonnin,8141,2733,Agence_moov_Ouidah,300000,294592,2022-02-27
CASH_OUT,12245,Sébastien Jourdan,38181,25936,Agence_moov_Abomey,300000,287755,2022-02-02
TRANSFER,2549,Emmanuel-René Coulon,8118,5569,Sébastien Jourdan,25936,28485,2022-02-04
CASH_OUT,7564,Sébastien Jourdan,28485,20921,Agence_moov_Ouidah,300000,292436,2022-02-12
TRANSFER,16035,Alfred Chrétien,253809,237774,Sébastien Jourdan,20921,36956,2022-02-13
TRANSFER,20362,Emmanuel Bousquet,99256,78894,Sébastien Jourdan,36956,57318,2022-02-13
TRANSFER,4692,Emmanuel-René Coulon,5569,877,Sébastien Jourdan,57318,62010,2022-02-14
CASH_IN,1565,Agence_moov_Ouidah,300000,298435,Sébastien Jourdan,62010,63575,2022-02-14
CASH_OUT,13731,Sébastien Jourdan,63575,49844,Agence_moov_Ouidah,300000,286269,2022-02-17
CASH_IN,133548,Agence_moov_Ouidah,300000,166452,Sébastien Jourdan,49844,183392,2022-02-21
CASH_IN,176902,Agence_moov_Cotonou,300000,123098,Sébastien Jourdan,183392,360294,2022-02-22
CASH_OUT,57464,Sébastien Jourdan,360294,302830,Agence_moov_Cotonou,300000,242536,2022-02-26
CASH_OUT,275012,Sébastien Jourdan,302830,27818,Agence_moov_Abomey,300000,24988,2022-02-27
CASH_OUT,3000,Sébastien Jourdan,27818,24818,Agence_moov_Abomey,300000,297000,2022-02-27
CASH_OUT,5151,Sébastien Jourdan,24818,19667,Agence_moov_Abomey,300000,294849,2022-02-27
CASH_IN,155427,Agence_moov_Abomey,300000,144573,Gabriel de Pineau,-67075,88352,2022-02-02
CASH_IN,297181,Agence_moov_Abomey,300000,2819,Gabriel de Pineau,88352,385533,2022-02-04
TRANSFER,273659,Gabriel de Pineau,385533,111874,Gabriel de Pineau,385533,111874,2022-02-05
TRANSFER,59810,Emmanuel Bousquet,78894,19084,Gabriel de Pineau,111874,171684,2022-02-07
CASH_IN,270178,Agence_moov_Ouidah,300000,29822,Gabriel de Pineau,171684,441862,2022-02-10
CASH_OUT,168930,Gabriel de Pineau,441862,272932,Agence_moov_Cotonou,300000,131070,2022-02-18
CASH_OUT,13313,Gabriel de Pineau,272932,259619,Agence_moov_Ouidah,300000,286687,2022-02-21
CASH_IN,144823,Agence_moov_Abomey,300000,155177,Gabriel de Pineau,259619,404442,2022-02-22
TRANSFER,170885,Gabriel de Pineau,404442,233557,Adrienne Arnaud,325885,155000,2022-02-25
TRANSFER,486306,Augustin Benard,794380,308074,Augustin Benard,794380,1280686,2022-02-04
CASH_OUT,214013,Augustin Benard,308074,94061,Agence_moov_Ouidah,300000,85987,2022-02-05
TRANSFER,145,Emmanuel-René Coulon,877,732,Augustin Benard,94061,94206,2022-02-08
TRANSFER,77551,Augustin Benard,94206,16655,Nicolas Hervé,330112,252561,2022-02-10
CASH_OUT,5709,Augustin Benard,16655,10946,Agence_moov_Abomey,300000,294291,2022-02-12
CASH_OUT,6526,Augustin Benard,10946,4420,Agence_moov_Ouidah,300000,293474,2022-02-12
TRANSFER,147689,Adrienne Arnaud,155000,7311,Augustin Benard,4420,152109,2022-02-13
CASH_IN,293454,Agence_moov_Cotonou,300000,6546,Augustin Benard,152109,445563,2022-02-17
CASH_IN,59211,Agence_moov_Abomey,300000,240789,Augustin Benard,445563,504774,2022-02-20
CASH_IN,70252,Agence_moov_Ouidah,300000,229748,Augustin Benard,504774,575026,2022-02-22
CASH_OUT,329188,Augustin Benard,575026,245838,Agence_moov_Abomey,300000,-29188,2022-02-23
CASH_IN,185887,Agence_moov_Abomey,300000,114113,Augustin Benard,245838,431725,2022-02-24
CASH_OUT,45514,Augustin Benard,431725,386211,Agence_moov_Ouidah,300000,254486,2022-02-26
CASH_IN,88091,Agence_moov_Abomey,300000,211909,Augustin Benard,386211,474302,2022-02-27
TRANSFER,57150,Amélie de la Picard,685278,628128,Emmanuel Bousquet,19084,76234,2022-02-02
CASH_IN,6257,Agence_moov_Abomey,300000,293743,Emmanuel Bousquet,76234,82491,2022-02-02
CASH_IN,221752,Agence_moov_Abomey,300000,78248,Emmanuel Bousquet,82491,304243,2022-02-06
TRANSFER,6616,Stéphanie Bonneau,51357,44741,Emmanuel Bousquet,304243,310859,2022-02-07
TRANSFER,3169,Adrienne Arnaud,7311,4142,Emmanuel Bousquet,310859,314028,2022-02-10
CASH_IN,113199,Agence_moov_Abomey,300000,186801,Emmanuel Bousquet,314028,427227,2022-02-10
TRANSFER,218214,Emmanuel Bousquet,427227,209013,Amélie de la Picard,628128,409914,2022-02-11
CASH_OUT,49680,Emmanuel Bousquet,209013,159333,Agence_moov_Abomey,300000,250320,2022-02-13
CASH_IN,275616,Agence_moov_Ouidah,300000,24384,Emmanuel Bousquet,159333,434949,2022-02-18
CASH_OUT,203525,Emmanuel Bousquet,434949,231424,Agence_moov_Abomey,300000,96475,2022-02-21
TRANSFER,1746,Stéphanie Bonneau,44741,42995,Emmanuel Bousquet,231424,233170,2022-02-21
CASH_IN,114106,Agence_moov_Ouidah,300000,185894,Emmanuel Bousquet,233170,347276,2022-02-24
TRANSFER,152886,Emmanuel Bousquet,347276,194390,Adrienne Arnaud,4142,-148744,2022-02-24
CASH_OUT,122242,Emmanuel Bousquet,194390,72148,Agence_moov_Ouidah,300000,177758,2022-02-26
CASH_IN,189965,Agence_moov_Abomey,300000,110035,Margot Renaud de Lacombe,-182422,7543,2022-02-02
CASH_IN,154847,Agence_moov_Ouidah,300000,145153,Margot Renaud de Lacombe,7543,162390,2022-02-02
TRANSFER,53889,Margot Renaud de Lacombe,162390,108501,Emmanuel-René Coulon,732,-53157,2022-02-04
CASH_OUT,3482,Margot Renaud de Lacombe,108501,105019,Agence_moov_Ouidah,300000,296518,2022-02-10
TRANSFER,56656,Agnès Baron,56915,259,Margot Renaud de Lacombe,105019,161675,2022-02-12
CASH_OUT,121862,Margot Renaud de Lacombe,161675,39813,Agence_moov_Cotonou,300000,178138,2022-02-14
CASH_IN,26369,Agence_moov_Ouidah,300000,273631,Margot Renaud de Lacombe,39813,66182,2022-02-15
CASH_OUT,21493,Margot Renaud de Lacombe,66182,44689,Agence_moov_Cotonou,300000,278507,2022-02-16
CASH_OUT,28853,Margot Renaud de Lacombe,44689,15836,Agence_moov_Ouidah,300000,271147,2022-02-16
TRANSFER,4035,Margot Renaud de Lacombe,15836,11801,Amélie de la Picard,409914,405879,2022-02-17
TRANSFER,3251,Margot Renaud de Lacombe,11801,8550,Amélie de la Picard,405879,402628,2022-02-17
TRANSFER,2457,Margot Renaud de Lacombe,8550,6093,Nicolas Hervé,252561,250104,2022-02-19
TRANSFER,4851,Margot Renaud de Lacombe,6093,1242,Nicolas Hervé,250104,245253,2022-02-21
CASH_IN,210661,Agence_moov_Ouidah,300000,89339,Maurice Alves,-202468,8193,2022-02-03
CASH_IN,54651,Agence_moov_Abomey,300000,245349,Maurice Alves,8193,62844,2022-02-06
CASH_IN,177584,Agence_moov_Cotonou,300000,122416,Maurice Alves,62844,240428,2022-02-08
CASH_IN,44800,Agence_moov_Ouidah,300000,255200,Maurice Alves,240428,285228,2022-02-12
CASH_OUT,135165,Maurice Alves,285228,150063,Agence_moov_Cotonou,300000,164835,2022-02-13
TRANSFER,82319,Maurice Alves,150063,67744,Alfred Chrétien,237774,155455,2022-02-16
CASH_OUT,9346,Maurice Alves,67744,58398,Agence_moov_Ouidah,300000,290654,2022-02-19
CASH_OUT,2297,Maurice Alves,58398,56101,Agence_moov_Cotonou,300000,297703,2022-02-22
TRANSFER,46111,Maurice Alves,56101,9990,Stéphanie Bonneau,42995,-3116,2022-02-24
CASH_IN,175443,Agence_moov_Abomey,300000,124557,Amélie de la Picard,402628,578071,2022-02-02
TRANSFER,442740,Amélie de la Picard,578071,135331,Amélie de la Picard,578071,135331,2022-02-03
CASH_IN,200486,Agence_moov_Abomey,300000,99514,Amélie de la Picard,135331,335817,2022-02-05
CASH_OUT,291816,Amélie de la Picard,335817,44001,Agence_moov_Cotonou,300000,8184,2022-02-05
CASH_IN,291040,Agence_moov_Ouidah,300000,8960,Amélie de la Picard,44001,335041,2022-02-06
CASH_IN,244866,Agence_moov_Abomey,300000,55134,Amélie de la Picard,335041,579907,2022-02-06
TRANSFER,127095,Alfred Chrétien,155455,28360,Amélie de la Picard,579907,707002,2022-02-07
CASH_OUT,10387,Amélie de la Picard,707002,696615,Agence_moov_Cotonou,300000,289613,2022-02-13
CASH_OUT,594541,Amélie de la Picard,696615,102074,Agence_moov_Cotonou,300000,-294541,2022-02-13
CASH_OUT,201,Amélie de la Picard,102074,101873,Agence_moov_Ouidah,300000,299799,2022-02-15
CASH_OUT,62252,Amélie de la Picard,101873,39621,Agence_moov_Cotonou,300000,237748,2022-02-16
CASH_IN,286126,Agence_moov_Abomey,300000,13874,Amélie de la Picard,39621,325747,2022-02-19
CASH_IN,295225,Agence_moov_Abomey,300000,4775,Isaac Le Pinto,-289439,5786,2022-02-03
CASH_IN,71777,Agence_moov_Abomey,300000,228223,Isaac Le Pinto,5786,77563,2022-02-04
TRANSFER,22392,Alfred Chrétien,28360,5968,Isaac Le Pinto,77563,99955,2022-02-04
TRANSFER,42877,Isaac Le Pinto,99955,57078,Isaac Le Pinto,99955,57078,2022-02-04
CASH_OUT,32824,Isaac Le Pinto,57078,24254,Agence_moov_Ouidah,300000,267176,2022-02-05
CASH_OUT,8689,Isaac Le Pinto,24254,15565,Agence_moov_Cotonou,300000,291311,2022-02-06
CASH_IN,10111,Agence_moov_Ouidah,300000,289889,Isaac Le Pinto,15565,25676,2022-02-06
TRANSFER,3117,Isaac Le Pinto,25676,22559,Alfred Chrétien,5968,2851,2022-02-07
CASH_OUT,11818,Isaac Le Pinto,22559,10741,Agence_moov_Abomey,300000,288182,2022-02-09
CASH_OUT,7828,Isaac Le Pinto,10741,2913,Agence_moov_Ouidah,300000,292172,2022-02-10
CASH_OUT,1164,Isaac Le Pinto,2913,1749,Agence_moov_Ouidah,300000,298836,2022-02-12
CASH_OUT,1232,Isaac Le Pinto,1749,517,Agence_moov_Abomey,300000,298768,2022-02-15
CASH_OUT,319,Isaac Le Pinto,517,198,Agence_moov_Ouidah,300000,299681,2022-02-17
CASH_IN,56117,Agence_moov_Abomey,300000,243883,Isaac Le Pinto,198,56315,2022-02-18
TRANSFER,88062,Nicolas Hervé,245253,157191,Isaac Le Pinto,56315,144377,2022-02-18
CASH_OUT,23583,Isaac Le Pinto,144377,120794,Agence_moov_Ouidah,300000,276417,2022-02-23
CASH_IN,133852,Agence_moov_Ouidah,300000,166148,Isaac Le Pinto,120794,254646,2022-02-25
CASH_OUT,114167,Isaac Le Pinto,254646,140479,Agence_moov_Ouidah,300000,185833,2022-02-27
CASH_IN,285183,Agence_moov_Abomey,300000,14817,Christine-Constance Gauthier,-488847,-203664,2022-02-04
CASH_IN,22532,Agence_moov_Cotonou,300000,277468,Christine-Constance Gauthier,-203664,-181132,2022-02-09
CASH_IN,104686,Agence_moov_Abomey,300000,195314,Christine-Constance Gauthier,-181132,-76446,2022-02-10
CASH_IN,178099,Agence_moov_Cotonou,300000,121901,Christine-Constance Gauthier,-76446,101653,2022-02-12
CASH_OUT,29565,Christine-Constance Gauthier,101653,72088,Agence_moov_Abomey,300000,270435,2022-02-13
TRANSFER,183,Agnès Baron,259,76,Christine-Constance Gauthier,72088,72271,2022-02-25
CASH_IN,44378,Agence_moov_Ouidah,300000,255622,Aimé Allain,38,44416,2022-02-02
CASH_IN,244516,Agence_moov_Ouidah,300000,55484,Aimé Allain,44416,288932,2022-02-04
CASH_IN,128105,Agence_moov_Cotonou,300000,171895,Aimé Allain,288932,417037,2022-02-04
TRANSFER,60967,Nicolas Hervé,157191,96224,Aimé Allain,417037,478004,2022-02-07
CASH_IN,284323,Agence_moov_Ouidah,300000,15677,Aimé Allain,478004,762327,2022-02-07
TRANSFER,469789,Aimé Allain,762327,292538,Nicolas Hervé,96224,-373565,2022-02-13
CASH_OUT,114412,Aimé Allain,292538,178126,Agence_moov_Abomey,300000,185588,2022-02-14
CASH_OUT,130381,Aimé Allain,178126,47745,Agence_moov_Ouidah,300000,169619,2022-02-20
CASH_IN,16185,Agence_moov_Ouidah,300000,283815,Aimé Allain,47745,63930,2022-02-22
CASH_OUT,60738,Aimé Allain,63930,3192,Agence_moov_Ouidah,300000,239262,2022-02-23
CASH_IN,277224,Agence_moov_Ouidah,300000,22776,Paul De Sousa,-540299,-263075,2022-02-02
CASH_IN,271135,Agence_moov_Cotonou,300000,28865,Paul De Sousa,-263075,8060,2022-02-02
CASH_IN,62002,Agence_moov_Abomey,300000,237998,Paul De Sousa,8060,70062,2022-02-03
CASH_IN,141379,Agence_moov_Abomey,300000,158621,Paul De Sousa,70062,211441,2022-02-05
CASH_OUT,184916,Paul De Sousa,211441,26525,Agence_moov_Ouidah,300000,115084,2022-02-06
TRANSFER,22246,Paul De Sousa,26525,4279,Paul De Sousa,26525,48771,2022-02-07
CASH_IN,61712,Agence_moov_Abomey,300000,238288,Paul De Sousa,4279,65991,2022-02-10
TRANSFER,12698,Paul De Sousa,65991,53293,Paul De Sousa,65991,78689,2022-02-11
TRANSFER,7430,Paul De Sousa,53293,45863,Paul De Sousa,53293,60723,2022-02-14
CASH_OUT,38323,Paul De Sousa,45863,7540,Agence_moov_Abomey,300000,261677,2022-02-14
CASH_OUT,2472,Paul De Sousa,7540,5068,Agence_moov_Ouidah,300000,297528,2022-02-16
CASH_IN,32107,Agence_moov_Abomey,300000,267893,Paul De Sousa,5068,37175,2022-02-20
CASH_IN,157767,Agence_moov_Ouidah,300000,142233,Paul De Sousa,37175,194942,2022-02-22
CASH_IN,238578,Agence_moov_Ouidah,300000,61422,Frédérique Robin,-133563,105015,2022-02-02
CASH_OUT,31395,Frédérique Robin,105015,73620,Agence_moov_Ouidah,300000,268605,2022-02-02
CASH_OUT,3112,Frédérique Robin,73620,70508,Agence_moov_Ouidah,300000,296888,2022-02-02
CASH_OUT,69318,Frédérique Robin,70508,1190,Agence_moov_Ouidah,300000,230682,2022-02-09
TRANSFER,660,Frédérique Robin,1190,530,Frédérique Robin,1190,530,2022-02-09
TRANSFER,504,Frédérique Robin,530,26,Frédérique Robin,530,1034,2022-02-09
CASH_IN,224185,Agence_moov_Abomey,300000,75815,Frédérique Robin,26,224211,2022-02-11
TRANSFER,218841,Frédérique Robin,224211,5370,Frédérique Robin,224211,5370,2022-02-12
CASH_IN,250177,Agence_moov_Abomey,300000,49823,Frédérique Robin,5370,255547,2022-02-17
CASH_IN,30444,Agence_moov_Abomey,300000,269556,Frédérique Robin,255547,285991,2022-02-18
CASH_IN,135877,Agence_moov_Ouidah,300000,164123,Frédérique Robin,285991,421868,2022-02-19
CASH_OUT,221553,Frédérique Robin,421868,200315,Agence_moov_Cotonou,300000,78447,2022-02-23
CASH_OUT,161885,Frédérique Robin,200315,38430,Agence_moov_Abomey,300000,138115,2022-02-24
CASH_IN,17994,Agence_moov_Abomey,300000,282006,Laurence Dumont de Laroche,-3979,14015,2022-02-03
TRANSFER,5536,Laurence Dumont de Laroche,14015,8479,Laurence Dumont de Laroche,14015,19551,2022-02-03
TRANSFER,5182,Laurence Dumont de Laroche,8479,3297,Laurence Dumont de Laroche,8479,13661,2022-02-04
CASH_IN,15183,Agence_moov_Ouidah,300000,284817,Laurence Dumont de Laroche,3297,18480,2022-02-06
CASH_OUT,4699,Laurence Dumont de Laroche,18480,13781,Agence_moov_Abomey,300000,295301,2022-02-07
TRANSFER,1423,Laurence Dumont de Laroche,13781,12358,Laurence Dumont de Laroche,13781,15204,2022-02-12
TRANSFER,8040,Laurence Dumont de Laroche,12358,4318,Laurence Dumont de Laroche,12358,4318,2022-02-13
CASH_OUT,1184,Laurence Dumont de Laroche,4318,3134,Agence_moov_Cotonou,300000,298816,2022-02-14
TRANSFER,1032,Laurence Dumont de Laroche,3134,2102,Laurence Dumont de Laroche,3134,2102,2022-02-14
CASH_IN,283421,Agence_moov_Ouidah,300000,16579,Laurence Dumont de Laroche,2102,285523,2022-02-20
CASH_IN,207504,Agence_moov_Cotonou,300000,92496,Laurence Dumont de Laroche,285523,493027,2022-02-21
CASH_OUT,466832,Laurence Dumont de Laroche,493027,26195,Agence_moov_Abomey,300000,-166832,2022-02-22
CASH_IN,97347,Agence_moov_Cotonou,300000,202653,Laurence Dumont de Laroche,26195,123542,2022-02-23
CASH_OUT,121127,Laurence Dumont de Laroche,123542,2415,Agence_moov_Abomey,300000,178873,2022-02-23
CASH_IN,290007,Agence_moov_Ouidah,300000,9993,Laurence Dumont de Laroche,2415,292422,2022-02-25
CASH_OUT,21957,Laurence Dumont de Laroche,292422,270465,Agence_moov_Cotonou,300000,278043,2022-02-26
CASH_IN,20324,Agence_moov_Cotonou,300000,279676,Laurence Dumont de Laroche,270465,290789,2022-02-27
CASH_IN,240488,Agence_moov_Cotonou,300000,59512,David Diallo,-1127126,-886638,2022-02-01
CASH_IN,124597,Agence_moov_Cotonou,300000,175403,David Diallo,-886638,-762041,2022-02-03
CASH_IN,108045,Agence_moov_Abomey,300000,191955,David Diallo,-762041,-653996,2022-02-04
CASH_IN,50615,Agence_moov_Abomey,300000,249385,David Diallo,-653996,-603381,2022-02-05
CASH_IN,53525,Agence_moov_Cotonou,300000,246475,David Diallo,-603381,-549856,2022-02-06
CASH_IN,154028,Agence_moov_Ouidah,300000,145972,David Diallo,-549856,-395828,2022-02-07
CASH_IN,152319,Agence_moov_Cotonou,300000,147681,David Diallo,-395828,-243509,2022-02-10
CASH_IN,183691,Agence_moov_Cotonou,300000,116309,David Diallo,-243509,-59818,2022-02-10
CASH_IN,5047,Agence_moov_Cotonou,300000,294953,David Diallo,-59818,-54771,2022-02-11
CASH_IN,86752,Agence_moov_Ouidah,300000,213248,David Diallo,-54771,31981,2022-02-11
TRANSFER,29804,David Diallo,31981,2177,David Diallo,31981,61785,2022-02-13
TRANSFER,1901,David Diallo,2177,276,David Diallo,2177,276,2022-02-17
TRANSFER,174,David Diallo,276,102,David Diallo,276,102,2022-02-17
CASH_IN,267290,Agence_moov_Cotonou,300000,32710,David Diallo,102,267392,2022-02-18
CASH_IN,280050,Agence_moov_Abomey,300000,19950,David Diallo,267392,547442,2022-02-20
CASH_OUT,468130,David Diallo,547442,79312,Agence_moov_Cotonou,300000,-168130,2022-02-24
CASH_OUT,8950,David Diallo,79312,70362,Agence_moov_Cotonou,300000,291050,2022-02-25
CASH_IN,178196,Agence_moov_Cotonou,300000,121804,Sébastien-Arthur Masse,-11150,167046,2022-02-02
CASH_OUT,34827,Sébastien-Arthur Masse,167046,132219,Agence_moov_Abomey,300000,265173,2022-02-05
TRANSFER,89105,Sébastien-Arthur Masse,132219,43114,Sébastien-Arthur Masse,132219,43114,2022-02-07
TRANSFER,27444,Sébastien-Arthur Masse,43114,15670,Sébastien-Arthur Masse,43114,70558,2022-02-08
CASH_OUT,13027,Sébastien-Arthur Masse,15670,2643,Agence_moov_Cotonou,300000,286973,2022-02-08
CASH_OUT,2164,Sébastien-Arthur Masse,2643,479,Agence_moov_Cotonou,300000,297836,2022-02-09
TRANSFER,201,Sébastien-Arthur Masse,479,278,Sébastien-Arthur Masse,479,680,2022-02-09
TRANSFER,245,Sébastien-Arthur Masse,278,33,Sébastien-Arthur Masse,278,523,2022-02-10
CASH_IN,216547,Agence_moov_Abomey,300000,83453,Sébastien-Arthur Masse,33,216580,2022-02-13
CASH_IN,36530,Agence_moov_Cotonou,300000,263470,Sébastien-Arthur Masse,216580,253110,2022-02-14
TRANSFER,5373,Sébastien-Arthur Masse,253110,247737,Sébastien-Arthur Masse,253110,247737,2022-02-18
TRANSFER,183280,Sébastien-Arthur Masse,247737,64457,Sébastien-Arthur Masse,247737,64457,2022-02-18
CASH_OUT,20092,Sébastien-Arthur Masse,64457,44365,Agence_moov_Cotonou,300000,279908,2022-02-19
CASH_OUT,27334,Sébastien-Arthur Masse,44365,17031,Agence_moov_Cotonou,300000,272666,2022-02-21
CASH_OUT,2816,Sébastien-Arthur Masse,17031,14215,Agence_moov_Abomey,300000,297184,2022-02-21
CASH_IN,80443,Agence_moov_Cotonou,300000,219557,Agnès Baron,76,80519,2022-02-01
CASH_IN,270630,Agence_moov_Ouidah,300000,29370,Agnès Baron,80519,351149,2022-02-03
CASH_OUT,196606,Agnès Baron,351149,154543,Agence_moov_Ouidah,300000,103394,2022-02-04
CASH_OUT,154180,Agnès Baron,154543,363,Agence_moov_Ouidah,300000,145820,2022-02-07
CASH_OUT,211,Agnès Baron,363,152,Agence_moov_Abomey,300000,299789,2022-02-23
CASH_IN,278657,Agence_moov_Abomey,300000,21343,Agnès Baron,152,278809,2022-02-24
CASH_OUT,254868,Agnès Baron,278809,23941,Agence_moov_Ouidah,300000,45132,2022-02-25
CASH_IN,154397,Agence_moov_Ouidah,300000,145603,Agnès Baron,23941,178338,2022-02-26
CASH_IN,80336,Agence_moov_Abomey,300000,219664,Agnès Baron,178338,258674,2022-02-27
CASH_IN,226706,Agence_moov_Cotonou,300000,73294,Nicole Lacroix,-262409,-35703,2022-02-04
CASH_IN,50659,Agence_moov_Abomey,300000,249341,Nicole Lacroix,-35703,14956,2022-02-06
CASH_OUT,5321,Nicole Lacroix,14956,9635,Agence_moov_Cotonou,300000,294679,2022-02-08
TRANSFER,4102,Nicole Lacroix,9635,5533,Nicole Lacroix,9635,13737,2022-02-09
CASH_OUT,1824,Nicole Lacroix,5533,3709,Agence_moov_Ouidah,300000,298176,2022-02-11
TRANSFER,1571,Nicole Lacroix,3709,2138,Nicole Lacroix,3709,2138,2022-02-15
TRANSFER,1441,Nicole Lacroix,2138,697,Nicole Lacroix,2138,3579,2022-02-20
CASH_IN,265794,Agence_moov_Abomey,300000,34206,Nicole Lacroix,697,266491,2022-02-22
CASH_IN,9633,Agence_moov_Abomey,300000,290367,Nicole Lacroix,266491,276124,2022-02-23
CASH_IN,159985,Agence_moov_Cotonou,300000,140015,Nicole Lacroix,276124,436109,2022-02-24
CASH_IN,153079,Agence_moov_Abomey,300000,146921,Benoît Verdier,-47815,105264,2022-02-01
CASH_OUT,46999,Benoît Verdier,105264,58265,Agence_moov_Abomey,300000,253001,2022-02-01
CASH_OUT,15295,Benoît Verdier,58265,42970,Agence_moov_Cotonou,300000,284705,2022-02-02
CASH_IN,293674,Agence_moov_Ouidah,300000,6326,Benoît Verdier,42970,336644,2022-02-03
CASH_OUT,44064,Benoît Verdier,336644,292580,Agence_moov_Abomey,300000,255936,2022-02-04
CASH_IN,130779,Agence_moov_Abomey,300000,169221,Benoît Verdier,292580,423359,2022-02-05
CASH_OUT,191669,Benoît Verdier,423359,231690,Agence_moov_Ouidah,300000,108331,2022-02-06
CASH_OUT,86725,Benoît Verdier,231690,144965,Agence_moov_Cotonou,300000,213275,2022-02-07
TRANSFER,73643,Benoît Verdier,144965,71322,Benoît Verdier,144965,71322,2022-02-07
CASH_IN,26181,Agence_moov_Abomey,300000,273819,Benoît Verdier,71322,97503,2022-02-10
CASH_OUT,21279,Benoît Verdier,97503,76224,Agence_moov_Cotonou,300000,278721,2022-02-10
CASH_OUT,5204,Benoît Verdier,76224,71020,Agence_moov_Abomey,300000,294796,2022-02-12
CASH_IN,279315,Agence_moov_Cotonou,300000,20685,Benoît Verdier,71020,350335,2022-02-13
CASH_IN,218772,Agence_moov_Ouidah,300000,81228,Benoît Verdier,350335,569107,2022-02-16
CASH_OUT,229791,Benoît Verdier,569107,339316,Agence_moov_Abomey,300000,70209,2022-02-17
CASH_IN,242582,Agence_moov_Cotonou,300000,57418,Benoît Verdier,339316,581898,2022-02-21
CASH_OUT,103055,Benoît Verdier,581898,478843,Agence_moov_Abomey,300000,196945,2022-02-21
CASH_IN,61055,Agence_moov_Cotonou,300000,238945,Benoît Verdier,478843,539898,2022-02-23
CASH_IN,39998,Agence_moov_Cotonou,300000,260002,Benoît Verdier,539898,579896,2022-02-24
CASH_IN,45996,Agence_moov_Abomey,300000,254004,Alex Salmon,-25447,20549,2022-02-02
TRANSFER,8234,Alex Salmon,20549,12315,Alex Salmon,20549,28783,2022-02-03
TRANSFER,9671,Alex Salmon,12315,2644,Alex Salmon,12315,2644,2022-02-03
TRANSFER,2128,Alex Salmon,2644,516,Alex Salmon,2644,516,2022-02-04
CASH_IN,231488,Agence_moov_Ouidah,300000,68512,Alex Salmon,516,232004,2022-02-05
CASH_OUT,186347,Alex Salmon,232004,45657,Agence_moov_Abomey,300000,113653,2022-02-07
TRANSFER,40501,Alex Salmon,45657,5156,Alex Salmon,45657,5156,2022-02-08
CASH_IN,75605,Agence_moov_Cotonou,300000,224395,Alex Salmon,5156,80761,2022-02-12
CASH_OUT,74866,Alex Salmon,80761,5895,Agence_moov_Abomey,300000,225134,2022-02-13
CASH_IN,223350,Agence_moov_Cotonou,300000,76650,Alex Salmon,5895,229245,2022-02-13
CASH_OUT,119173,Alex Salmon,229245,110072,Agence_moov_Abomey,300000,180827,2022-02-13
CASH_IN,266902,Agence_moov_Abomey,300000,33098,Alex Salmon,110072,376974,2022-02-15
CASH_IN,280987,Agence_moov_Ouidah,300000,19013,Alex Salmon,376974,657961,2022-02-17
CASH_OUT,549196,Alex Salmon,657961,108765,Agence_moov_Cotonou,300000,-249196,2022-02-24
CASH_OUT,90550,Alex Salmon,108765,18215,Agence_moov_Abomey,300000,209450,2022-02-24
CASH_IN,112586,Agence_moov_Ouidah,300000,187414,Diane-Françoise Raynaud,-444045,-331459,2022-02-03
CASH_IN,212115,Agence_moov_Abomey,300000,87885,Diane-Françoise Raynaud,-331459,-119344,2022-02-13
CASH_IN,145601,Agence_moov_Abomey,300000,154399,Diane-Françoise Raynaud,-119344,26257,2022-02-13
TRANSFER,25375,Diane-Françoise Raynaud,26257,882,Diane-Françoise Raynaud,26257,51632,2022-02-14
CASH_IN,76842,Agence_moov_Abomey,300000,223158,Diane-Françoise Raynaud,882,77724,2022-02-20
CASH_IN,114977,Agence_moov_Abomey,300000,185023,Diane-Françoise Raynaud,77724,192701,2022-02-22
CASH_OUT,47103,Diane-Françoise Raynaud,192701,145598,Agence_moov_Cotonou,300000,252897,2022-02-25
CASH_IN,17656,Agence_moov_Abomey,300000,282344,Stéphanie Bonneau,-3116,14540,2022-02-01
CASH_IN,29288,Agence_moov_Cotonou,300000,270712,Stéphanie Bonneau,14540,43828,2022-02-03
CASH_IN,29596,Agence_moov_Ouidah,300000,270404,Stéphanie Bonneau,43828,73424,2022-02-07
CASH_IN,140950,Agence_moov_Cotonou,300000,159050,Stéphanie Bonneau,73424,214374,2022-02-12
CASH_IN,165285,Agence_moov_Ouidah,300000,134715,Stéphanie Bonneau,214374,379659,2022-02-12
CASH_OUT,260103,Stéphanie Bonneau,379659,119556,Agence_moov_Cotonou,300000,39897,2022-02-15
CASH_OUT,80761,Stéphanie Bonneau,119556,38795,Agence_moov_Cotonou,300000,219239,2022-02-16
TRANSFER,18249,Stéphanie Bonneau,38795,20546,Stéphanie Bonneau,38795,57044,2022-02-16
CASH_OUT,4431,Stéphanie Bonneau,20546,16115,Agence_moov_Abomey,300000,295569,2022-02-18
CASH_IN,288483,Agence_moov_Ouidah,300000,11517,Stéphanie Bonneau,16115,304598,2022-02-19
CASH_IN,52125,Agence_moov_Ouidah,300000,247875,Stéphanie Bonneau,304598,356723,2022-02-19
CASH_IN,206418,Agence_moov_Abomey,300000,93582,Stéphanie Bonneau,356723,563141,2022-02-20
CASH_OUT,249958,Stéphanie Bonneau,563141,313183,Agence_moov_Ouidah,300000,50042,2022-02-25
CASH_IN,257487,Agence_moov_Ouidah,300000,42513,Emmanuel-René Coulon,-53157,204330,2022-02-01
CASH_IN,190151,Agence_moov_Ouidah,300000,109849,Emmanuel-René Coulon,204330,394481,2022-02-03
CASH_IN,70686,Agence_moov_Ouidah,300000,229314,Emmanuel-René Coulon,394481,465167,2022-02-05
CASH_IN,297441,Agence_moov_Ouidah,300000,2559,Emmanuel-René Coulon,465167,762608,2022-02-06
CASH_IN,133974,Agence_moov_Abomey,300000,166026,Emmanuel-René Coulon,762608,896582,2022-02-07
CASH_OUT,53090,Emmanuel-René Coulon,896582,843492,Agence_moov_Ouidah,300000,246910,2022-02-12
CASH_OUT,657211,Emmanuel-René Coulon,843492,186281,Agence_moov_Abomey,300000,-357211,2022-02-12
CASH_OUT,117026,Emmanuel-René Coulon,186281,69255,Agence_moov_Ouidah,300000,182974,2022-02-22
CASH_OUT,40614,Emmanuel-René Coulon,69255,28641,Agence_moov_Ouidah,300000,259386,2022-02-23
CASH_OUT,18801,Emmanuel-René Coulon,28641,9840,Agence_moov_Cotonou,300000,281199,2022-02-23
CASH_OUT,1847,Emmanuel-René Coulon,9840,7993,Agence_moov_Ouidah,300000,298153,2022-02-24
CASH_IN,244541,Agence_moov_Ouidah,300000,55459,Emmanuel-René Coulon,7993,252534,2022-02-27
CASH_IN,85066,Agence_moov_Cotonou,300000,214934,Nicolas Hervé,-373565,-288499,2022-02-02
CASH_IN,5188,Agence_moov_Cotonou,300000,294812,Nicolas Hervé,-288499,-283311,2022-02-03
CASH_IN,120378,Agence_moov_Ouidah,300000,179622,Nicolas Hervé,-283311,-162933,2022-02-07
CASH_IN,208966,Agence_moov_Abomey,300000,91034,Nicolas Hervé,-162933,46033,2022-02-09
CASH_IN,196312,Agence_moov_Cotonou,300000,103688,Nicolas Hervé,46033,242345,2022-02-12
CASH_IN,296504,Agence_moov_Abomey,300000,3496,Nicolas Hervé,242345,538849,2022-02-12
CASH_IN,122444,Agence_moov_Ouidah,300000,177556,Nicolas Hervé,538849,661293,2022-02-12
CASH_IN,110401,Agence_moov_Cotonou,300000,189599,Nicolas Hervé,661293,771694,2022-02-12
CASH_OUT,375811,Nicolas Hervé,771694,395883,Agence_moov_Cotonou,300000,-75811,2022-02-15
CASH_OUT,36448,Nicolas Hervé,395883,359435,Agence_moov_Cotonou,300000,263552,2022-02-22
CASH_OUT,27076,Nicolas Hervé,359435,332359,Agence_moov_Abomey,300000,272924,2022-02-23
CASH_IN,222208,Agence_moov_Abomey,300000,77792,Nicolas Hervé,332359,554567,2022-02-25
CASH_OUT,69610,Nicolas Hervé,554567,484957,Agence_moov_Ouidah,300000,230390,2022-02-27
CASH_IN,262817,Agence_moov_Abomey,300000,37183,Adélaïde-Sophie Leclercq,-559664,-296847,2022-02-03
CASH_IN,36615,Agence_moov_Ouidah,300000,263385,Adélaïde-Sophie Leclercq,-296847,-260232,2022-02-07
CASH_IN,248285,Agence_moov_Ouidah,300000,51715,Adélaïde-Sophie Leclercq,-260232,-11947,2022-02-07
CASH_IN,263659,Agence_moov_Ouidah,300000,36341,Adélaïde-Sophie Leclercq,-11947,251712,2022-02-10
TRANSFER,175834,Adélaïde-Sophie Leclercq,251712,75878,Adélaïde-Sophie Leclercq,251712,427546,2022-02-22
CASH_OUT,38571,Adélaïde-Sophie Leclercq,75878,37307,Agence_moov_Cotonou,300000,261429,2022-02-27
CASH_IN,203207,Agence_moov_Abomey,300000,96793,Luc-Tristan Moreau,-275346,-72139,2022-02-01
CASH_IN,89836,Agence_moov_Cotonou,300000,210164,Luc-Tristan Moreau,-72139,17697,2022-02-05
CASH_IN,287109,Agence_moov_Cotonou,300000,12891,Luc-Tristan Moreau,17697,304806,2022-02-05
CASH_OUT,167875,Luc-Tristan Moreau,304806,136931,Agence_moov_Abomey,300000,132125,2022-02-07
TRANSFER,120053,Luc-Tristan Moreau,136931,16878,Luc-Tristan Moreau,136931,256984,2022-02-07
CASH_IN,266892,Agence_moov_Ouidah,300000,33108,Luc-Tristan Moreau,16878,283770,2022-02-09
CASH_OUT,124852,Luc-Tristan Moreau,283770,158918,Agence_moov_Abomey,300000,175148,2022-02-11
CASH_OUT,86614,Luc-Tristan Moreau,158918,72304,Agence_moov_Abomey,300000,213386,2022-02-13
CASH_IN,72627,Agence_moov_Abomey,300000,227373,Luc-Tristan Moreau,72304,144931,2022-02-16
CASH_OUT,113323,Luc-Tristan Moreau,144931,31608,Agence_moov_Cotonou,300000,186677,2022-02-19
CASH_OUT,3342,Luc-Tristan Moreau,31608,28266,Agence_moov_Cotonou,300000,296658,2022-02-22
CASH_OUT,27016,Luc-Tristan Moreau,28266,1250,Agence_moov_Cotonou,300000,272984,2022-02-22
CASH_IN,298245,Agence_moov_Ouidah,300000,1755,Grégoire Delmas de Blanchard,-58585,239660,2022-02-01
CASH_IN,15105,Agence_moov_Cotonou,300000,284895,Grégoire Delmas de Blanchard,239660,254765,2022-02-02
CASH_OUT,239342,Grégoire Delmas de Blanchard,254765,15423,Agence_moov_Ouidah,300000,60658,2022-02-03
CASH_OUT,9129,Grégoire Delmas de Blanchard,15423,6294,Agence_moov_Cotonou,300000,290871,2022-02-08
CASH_IN,179245,Agence_moov_Cotonou,300000,120755,Grégoire Delmas de Blanchard,6294,185539,2022-02-09
CASH_OUT,123848,Grégoire Delmas de Blanchard,185539,61691,Agence_moov_Ouidah,300000,176152,2022-02-10
CASH_OUT,39262,Grégoire Delmas de Blanchard,61691,22429,Agence_moov_Abomey,300000,260738,2022-02-10
CASH_OUT,8635,Grégoire Delmas de Blanchard,22429,13794,Agence_moov_Cotonou,300000,291365,2022-02-12
CASH_IN,284381,Agence_moov_Abomey,300000,15619,Grégoire Delmas de Blanchard,13794,298175,2022-02-13
CASH_OUT,215237,Grégoire Delmas de Blanchard,298175,82938,Agence_moov_Ouidah,300000,84763,2022-02-14
TRANSFER,15807,Grégoire Delmas de Blanchard,82938,67131,Grégoire Delmas de Blanchard,82938,67131,2022-02-17
TRANSFER,64165,Grégoire Delmas de Blanchard,67131,2966,Grégoire Delmas de Blanchard,67131,2966,2022-02-17
CASH_OUT,1175,Grégoire Delmas de Blanchard,2966,1791,Agence_moov_Ouidah,300000,298825,2022-02-18
CASH_OUT,1586,Grégoire Delmas de Blanchard,1791,205,Agence_moov_Abomey,300000,298414,2022-02-20
CASH_OUT,120,Grégoire Delmas de Blanchard,205,85,Agence_moov_Ouidah,300000,299880,2022-02-22
CASH_IN,139497,Agence_moov_Abomey,300000,160503,Grégoire Delmas de Blanchard,85,139582,2022-02-26
CASH_IN,87148,Agence_moov_Cotonou,300000,212852,Gilbert Bazin Le Guillet,-233073,-145925,2022-02-04
CASH_IN,272170,Agence_moov_Abomey,300000,27830,Gilbert Bazin Le Guillet,-145925,126245,2022-02-04
CASH_OUT,92383,Gilbert Bazin Le Guillet,126245,33862,Agence_moov_Abomey,300000,207617,2022-02-10
CASH_IN,222731,Agence_moov_Abomey,300000,77269,Gilbert Bazin Le Guillet,33862,256593,2022-02-10
CASH_IN,107978,Agence_moov_Ouidah,300000,192022,Gilbert Bazin Le Guillet,256593,364571,2022-02-13
CASH_IN,100214,Agence_moov_Cotonou,300000,199786,Gilbert Bazin Le Guillet,364571,464785,2022-02-13
TRANSFER,351509,Gilbert Bazin Le Guillet,464785,113276,Gilbert Bazin Le Guillet,464785,816294,2022-02-14
TRANSFER,12135,Gilbert Bazin Le Guillet,113276,101141,Gilbert Bazin Le Guillet,113276,101141,2022-02-16
CASH_IN,269073,Agence_moov_Cotonou,300000,30927,Gilbert Bazin Le Guillet,101141,370214,2022-02-17
CASH_OUT,308247,Gilbert Bazin Le Guillet,370214,61967,Agence_moov_Abomey,300000,-8247,2022-02-18
CASH_IN,44209,Agence_moov_Ouidah,300000,255791,Christophe Guilbert,-150987,-106778,2022-02-04
CASH_IN,71773,Agence_moov_Cotonou,300000,228227,Christophe Guilbert,-106778,-35005,2022-02-06
CASH_IN,273245,Agence_moov_Abomey,300000,26755,Christophe Guilbert,-35005,238240,2022-02-08
CASH_OUT,49516,Christophe Guilbert,238240,188724,Agence_moov_Cotonou,300000,250484,2022-02-09
CASH_IN,40393,Agence_moov_Abomey,300000,259607,Christophe Guilbert,188724,229117,2022-02-13
CASH_IN,13640,Agence_moov_Cotonou,300000,286360,Christophe Guilbert,229117,242757,2022-02-17
CASH_IN,242408,Agence_moov_Abomey,300000,57592,Christophe Guilbert,242757,485165,2022-02-19
CASH_OUT,150965,Christophe Guilbert,485165,334200,Agence_moov_Abomey,300000,149035,2022-02-23
CASH_IN,223001,Agence_moov_Cotonou,300000,76999,Christophe Guilbert,334200,557201,2022-02-24
CASH_IN,111450,Agence_moov_Cotonou,300000,188550,Nath Léger,-285774,-174324,2022-02-01
CASH_IN,202367,Agence_moov_Cotonou,300000,97633,Nath Léger,-174324,28043,2022-02-08
CASH_OUT,24800,Nath Léger,28043,3243,Agence_moov_Abomey,300000,275200,2022-02-10
CASH_IN,58686,Agence_moov_Cotonou,300000,241314,Nath Léger,3243,61929,2022-02-14
CASH_IN,66554,Agence_moov_Cotonou,300000,233446,Nath Léger,61929,128483,2022-02-18
CASH_OUT,126087,Nath Léger,128483,2396,Agence_moov_Ouidah,300000,173913,2022-02-18
CASH_IN,79250,Agence_moov_Abomey,300000,220750,Nath Léger,2396,81646,2022-02-21
CASH_OUT,24826,Nath Léger,81646,56820,Agence_moov_Ouidah,300000,275174,2022-02-22
CASH_IN,147196,Agence_moov_Ouidah,300000,152804,Nath Léger,56820,204016,2022-02-26
CASH_IN,220213,Agence_moov_Ouidah,300000,79787,Marianne Descamps,-40213,180000,2022-02-02
CASH_IN,268859,Agence_moov_Ouidah,300000,31141,Marianne Descamps,180000,448859,2022-02-02
CASH_OUT,305238,Marianne Descamps,448859,143621,Agence_moov_Ouidah,300000,-5238,2022-02-04
CASH_IN,200259,Agence_moov_Abomey,300000,99741,Marianne Descamps,143621,343880,2022-02-12
CASH_OUT,288825,Marianne Descamps,343880,55055,Agence_moov_Ouidah,300000,11175,2022-02-21
CASH_IN,8780,Agence_moov_Cotonou,300000,291220,Adrienne Arnaud,-148744,-139964,2022-02-01
CASH_IN,90983,Agence_moov_Cotonou,300000,209017,Adrienne Arnaud,-139964,-48981,2022-02-02
CASH_IN,66826,Agence_moov_Abomey,300000,233174,Adrienne Arnaud,-48981,17845,2022-02-03
CASH_OUT,15127,Adrienne Arnaud,17845,2718,Agence_moov_Abomey,300000,284873,2022-02-11
CASH_OUT,1964,Adrienne Arnaud,2718,754,Agence_moov_Ouidah,300000,298036,2022-02-14
CASH_OUT,179,Adrienne Arnaud,754,575,Agence_moov_Abomey,300000,299821,2022-02-20
CASH_IN,72344,Agence_moov_Ouidah,300000,227656,Adrienne Arnaud,575,72919,2022-02-23
CASH_IN,467,Agence_moov_Cotonou,300000,299533,Maryse Reynaud-Michaud,62,529,2022-02-07
CASH_IN,66008,Agence_moov_Abomey,300000,233992,Maryse Reynaud-Michaud,529,66537,2022-02-08
CASH_OUT,59708,Maryse Reynaud-Michaud,66537,6829,Agence_moov_Cotonou,300000,240292,2022-02-10
CASH_IN,110125,Agence_moov_Cotonou,300000,189875,Maryse Reynaud-Michaud,6829,116954,2022-02-11
CASH_OUT,46362,Maryse Reynaud-Michaud,116954,70592,Agence_moov_Cotonou,300000,253638,2022-02-12
TRANSFER,16212,Maryse Reynaud-Michaud,70592,54380,Maryse Reynaud-Michaud,70592,54380,2022-02-12
CASH_OUT,16839,Maryse Reynaud-Michaud,54380,37541,Agence_moov_Abomey,300000,283161,2022-02-13
TRANSFER,7299,Maryse Reynaud-Michaud,37541,30242,Maryse Reynaud-Michaud,37541,30242,2022-02-14
CASH_IN,12211,Agence_moov_Abomey,300000,287789,Maryse Reynaud-Michaud,30242,42453,2022-02-14
CASH_OUT,447,Maryse Reynaud-Michaud,42453,42006,Agence_moov_Abomey,300000,299553,2022-02-19
CASH_OUT,15362,Maryse Reynaud-Michaud,42006,26644,Agence_moov_Ouidah,300000,284638,2022-02-23
CASH_OUT,20842,Maryse Reynaud-Michaud,26644,5802,Agence_moov_Ouidah,300000,279158,2022-02-25
CASH_OUT,474,Maryse Reynaud-Michaud,5802,5328,Agence_moov_Ouidah,300000,299526,2022-02-25
CASH_IN,36988,Agence_moov_Cotonou,300000,263012,Auguste Bousquet,-47571,-10583,2022-02-01
CASH_IN,1887,Agence_moov_Cotonou,300000,298113,Auguste Bousquet,-10583,-8696,2022-02-08
CASH_IN,177848,Agence_moov_Abomey,300000,122152,Auguste Bousquet,-8696,169152,2022-02-08
CASH_OUT,99822,Auguste Bousquet,169152,69330,Agence_moov_Ouidah,300000,200178,2022-02-10
CASH_IN,212911,Agence_moov_Cotonou,300000,87089,Auguste Bousquet,69330,282241,2022-02-11
CASH_OUT,202607,Auguste Bousquet,282241,79634,Agence_moov_Cotonou,300000,97393,2022-02-11
TRANSFER,67138,Auguste Bousquet,79634,12496,Auguste Bousquet,79634,12496,2022-02-17
CASH_OUT,10504,Auguste Bousquet,12496,1992,Agence_moov_Abomey,300000,289496,2022-02-19
CASH_IN,28532,Agence_moov_Cotonou,300000,271468,Auguste Bousquet,1992,30524,2022-02-20
CASH_OUT,19612,Auguste Bousquet,30524,10912,Agence_moov_Abomey,300000,280388,2022-02-21
CASH_OUT,8588,Auguste Bousquet,10912,2324,Agence_moov_Cotonou,300000,291412,2022-02-22
CASH_IN,85620,Agence_moov_Abomey,300000,214380,Paul Pereira,-317395,-231775,2022-02-05
CASH_IN,195366,Agence_moov_Cotonou,300000,104634,Paul Pereira,-231775,-36409,2022-02-07
CASH_IN,69619,Agence_moov_Cotonou,300000,230381,Paul Pereira,-36409,33210,2022-02-08
CASH_IN,285515,Agence_moov_Ouidah,300000,14485,Paul Pereira,33210,318725,2022-02-09
CASH_IN,170529,Agence_moov_Cotonou,300000,129471,Paul Pereira,318725,489254,2022-02-11
CASH_OUT,347074,Paul Pereira,489254,142180,Agence_moov_Ouidah,300000,-47074,2022-02-13
CASH_OUT,128184,Paul Pereira,142180,13996,Agence_moov_Abomey,300000,171816,2022-02-15
CASH_OUT,924,Paul Pereira,13996,13072,Agence_moov_Abomey,300000,299076,2022-02-19
CASH_IN,93837,Agence_moov_Ouidah,300000,206163,Paul Pereira,13072,106909,2022-02-20
CASH_IN,164144,Agence_moov_Ouidah,300000,135856,Paul Pereira,106909,271053,2022-02-26
CASH_IN,225253,Agence_moov_Ouidah,300000,74747,Paul De Sousa,556900,782153,2022-03-16
CASH_IN,49329,Agence_moov_Ouidah,300000,250671,Amélie Gros-Riou,749200,798529,2022-03-03
CASH_IN,266945,Agence_moov_Cotonou,300000,33055,Amélie Gros-Riou,798529,1065474,2022-03-04
CASH_OUT,536741,Amélie Gros-Riou,1065474,528733,Agence_moov_Ouidah,300000,-236741,2022-03-11
CASH_OUT,169692,Amélie Gros-Riou,528733,359041,Agence_moov_Ouidah,300000,130308,2022-03-25
CASH_IN,249422,Agence_moov_Ouidah,300000,50578,Noémi de la Didier,1469500,1718922,2022-03-17
CASH_IN,48394,Agence_moov_Cotonou,300000,251606,Maurice Seguin,1439600,1487994,2022-03-08
TRANSFER,135419,Stéphane-Timothée Pineau,1453200,1317781,Maurice Seguin,1487994,1623413,2022-03-13
TRANSFER,1135395,Maurice Seguin,1623413,488018,Noël Hamel,138400,-996995,2022-03-15
CASH_OUT,251785,Sabine Imbert,907000,655215,Agence_moov_Ouidah,300000,48215,2022-03-14
CASH_IN,201278,Agence_moov_Ouidah,300000,98722,Sabine Imbert,655215,856493,2022-03-18
CASH_IN,137628,Agence_moov_Abomey,300000,162372,Sabine Imbert,856493,994121,2022-03-27
TRANSFER,372428,Luc-Tristan Moreau,593900,221472,Laurence Carlier,416900,44472,2022-03-08
CASH_IN,30793,Agence_moov_Ouidah,300000,269207,Luc-Tristan Moreau,221472,252265,2022-03-11
CASH_OUT,27644,Luc-Tristan Moreau,252265,224621,Agence_moov_Abomey,300000,272356,2022-03-17
CASH_OUT,55487,Luc-Tristan Moreau,224621,169134,Agence_moov_Ouidah,300000,244513,2022-03-21
TRANSFER,26677,Marianne Descamps,328500,301823,Luc-Tristan Moreau,169134,195811,2022-03-23
TRANSFER,1257916,Claudine Vallet,1897000,639084,Thierry Dos Santos-Le Roux,476000,-781916,2022-03-17
CASH_IN,207829,Agence_moov_Cotonou,300000,92171,Antoine Leroux,1078500,1286329,2022-03-05
CASH_IN,234891,Agence_moov_Cotonou,300000,65109,Antoine Leroux,1286329,1521220,2022-03-06
CASH_OUT,2640,Aimé Allain,14500,11860,Agence_moov_Cotonou,300000,297360,2022-03-02
TRANSFER,1189773,Alfred Chrétien,1246400,56627,Aimé Allain,11860,1201633,2022-03-19
CASH_OUT,1015831,Aimé Allain,1201633,185802,Agence_moov_Abomey,300000,-715831,2022-03-25
TRANSFER,102080,Julie Robin de Gros,110200,8120,Isaac Le Pinto,42000,144080,2022-03-08
CASH_IN,87044,Agence_moov_Ouidah,300000,212956,Isaac Le Pinto,144080,231124,2022-03-10
CASH_OUT,11523,Théodore-Alfred Fournier,124700,113177,Agence_moov_Cotonou,300000,288477,2022-03-01
CASH_OUT,521,Théodore-Alfred Fournier,113177,112656,Agence_moov_Ouidah,300000,299479,2022-03-01
CASH_OUT,78138,Théodore-Alfred Fournier,112656,34518,Agence_moov_Cotonou,300000,221862,2022-03-03
TRANSFER,1133081,Juliette Evrard Le Giraud,1569100,436019,Théodore-Alfred Fournier,34518,1167599,2022-03-13
TRANSFER,526043,Christophe Guilbert,815800,289757,Théodore-Alfred Fournier,1167599,1693642,2022-03-20
TRANSFER,308960,Joséphine Weber du Bonnin,483900,174940,Bernadette Fabre,1226100,1535060,2022-03-02
TRANSFER,93216,Bernadette Fabre,1535060,1441844,Matthieu Renard,5700,-87516,2022-03-10
TRANSFER,1419543,Bernadette Fabre,1441844,22301,Laurent Perrot,931500,-488043,2022-03-18
CASH_IN,10804,Agence_moov_Cotonou,300000,289196,Bernadette Fabre,22301,33105,2022-03-26
CASH_OUT,1316935,Antoine Bourdon de Auger,1657900,340965,Agence_moov_Ouidah,300000,-1016935,2022-03-20
CASH_OUT,274480,Susan de Fontaine,1220000,945520,Agence_moov_Cotonou,300000,25520,2022-03-04
TRANSFER,491341,Théophile Mendès,722900,231559,Susan de Fontaine,945520,1436861,2022-03-05
TRANSFER,1020656,Laurent Besson,1618700,598044,Susan de Fontaine,1436861,2457517,2022-03-11
TRANSFER,2375191,Susan de Fontaine,2457517,82326,Théodore Bertin,985700,-1389491,2022-03-11
CASH_OUT,16539,Susan de Fontaine,82326,65787,Agence_moov_Cotonou,300000,283461,2022-03-18
CASH_IN,186174,Agence_moov_Abomey,300000,113826,Luc Camus,299600,485774,2022-03-12
CASH_IN,27028,Agence_moov_Abomey,300000,272972,Luc Camus,485774,512802,2022-03-26
CASH_OUT,799370,Margot Renaud de Lacombe,957900,158530,Agence_moov_Cotonou,300000,-499370,2022-03-01
CASH_OUT,25311,Margot Renaud de Lacombe,158530,133219,Agence_moov_Abomey,300000,274689,2022-03-02
CASH_IN,61749,Agence_moov_Cotonou,300000,238251,Margot Renaud de Lacombe,133219,194968,2022-03-03
CASH_IN,118625,Agence_moov_Cotonou,300000,181375,Margot Renaud de Lacombe,194968,313593,2022-03-23
CASH_IN,184288,Agence_moov_Abomey,300000,115712,Margot Renaud de Lacombe,313593,497881,2022-03-26
CASH_OUT,1151474,Émilie Guillon de Duhamel,1749900,598426,Agence_moov_Ouidah,300000,-851474,2022-03-02
TRANSFER,115699,Émilie Guillon de Duhamel,598426,482727,Marie Da Silva,906100,790401,2022-03-03
CASH_IN,134678,Agence_moov_Cotonou,300000,165322,Émilie Guillon de Duhamel,482727,617405,2022-03-18
TRANSFER,504866,Émilie Guillon de Duhamel,617405,112539,Marc Gilbert,1966000,1461134,2022-03-19
CASH_OUT,28268,Christophe Alexandre,142000,113732,Agence_moov_Cotonou,300000,271732,2022-03-06
CASH_OUT,62896,Christophe Alexandre,113732,50836,Agence_moov_Ouidah,300000,237104,2022-03-16
TRANSFER,9478,Christophe Alexandre,50836,41358,Richard Guibert,335300,325822,2022-03-17
CASH_OUT,46066,Léon Paris,166100,120034,Agence_moov_Cotonou,300000,253934,2022-03-15
CASH_IN,204861,Agence_moov_Abomey,300000,95139,Léon Paris,120034,324895,2022-03-17
TRANSFER,103832,Léon Paris,324895,221063,Marine-Clémence Ferreira,1279400,1175568,2022-03-19
CASH_IN,70932,Agence_moov_Cotonou,300000,229068,Léon Paris,221063,291995,2022-03-23
CASH_IN,263183,Agence_moov_Ouidah,300000,36817,Xavier-Stéphane Ollivier,392300,655483,2022-03-04
CASH_IN,69672,Agence_moov_Ouidah,300000,230328,Xavier-Stéphane Ollivier,655483,725155,2022-03-14
TRANSFER,13526,Xavier-Stéphane Ollivier,725155,711629,Stéphane-Timothée Pineau,1317781,1304255,2022-03-24
TRANSFER,218410,Richard Guibert,325822,107412,Nicole Lacroix,1643400,1861810,2022-03-13
CASH_OUT,174734,Nicole Lacroix,1861810,1687076,Agence_moov_Ouidah,300000,125266,2022-03-18
TRANSFER,1118662,Maryse Lebreton,1742300,623638,Nicole Lacroix,1687076,2805738,2022-03-21
TRANSFER,397108,Constance Regnier,555700,158592,Agnès Baron,1903500,1506392,2022-03-01
TRANSFER,115137,Constance Regnier,158592,43455,Agnès Baron,1506392,1391255,2022-03-02
TRANSFER,1632,Constance Regnier,43455,41823,Nathalie-Chantal Jacques,1339000,1337368,2022-03-03
CASH_OUT,15396,Constance Regnier,41823,26427,Agence_moov_Abomey,300000,284604,2022-03-04
TRANSFER,1023526,Marc Gilbert,1461134,437608,Constance Regnier,26427,1049953,2022-03-04
TRANSFER,824758,Constance Regnier,1049953,225195,Océane Boutin,879600,54842,2022-03-06
TRANSFER,55910,Constance Regnier,225195,169285,Nathalie-Chantal Jacques,1337368,1281458,2022-03-06
CASH_OUT,72928,Constance Regnier,169285,96357,Agence_moov_Ouidah,300000,227072,2022-03-07
CASH_OUT,4467,Constance Regnier,96357,91890,Agence_moov_Cotonou,300000,295533,2022-03-08
TRANSFER,54118,Constance Regnier,91890,37772,Océane Boutin,54842,724,2022-03-12
CASH_IN,228213,Agence_moov_Abomey,300000,71787,Constance Regnier,37772,265985,2022-03-14
CASH_OUT,144156,Constance Regnier,265985,121829,Agence_moov_Abomey,300000,155844,2022-03-17
CASH_IN,30899,Agence_moov_Cotonou,300000,269101,Constance Regnier,121829,152728,2022-03-18
CASH_OUT,130664,Constance Regnier,152728,22064,Agence_moov_Abomey,300000,169336,2022-03-18
TRANSFER,2767,Constance Regnier,22064,19297,Paul Pereira,1146600,1143833,2022-03-19
CASH_IN,147705,Agence_moov_Ouidah,300000,152295,Constance Regnier,19297,167002,2022-03-19
CASH_IN,253413,Agence_moov_Cotonou,300000,46587,Constance Regnier,167002,420415,2022-03-21
TRANSFER,252770,Constance Regnier,420415,167645,Emmanuel-René Coulon,336800,84030,2022-03-22
CASH_OUT,109002,Constance Regnier,167645,58643,Agence_moov_Ouidah,300000,190998,2022-03-22
TRANSFER,597491,Alphonse Dupont-Petit,1818100,1220609,Constance Regnier,58643,656134,2022-03-23
CASH_IN,14853,Agence_moov_Ouidah,300000,285147,Constance Regnier,656134,670987,2022-03-23
CASH_OUT,421880,Constance Regnier,670987,249107,Agence_moov_Cotonou,300000,-121880,2022-03-24
CASH_IN,79848,Agence_moov_Cotonou,300000,220152,Constance Regnier,249107,328955,2022-03-25
CASH_OUT,196541,Constance Regnier,328955,132414,Agence_moov_Ouidah,300000,103459,2022-03-25
CASH_OUT,50447,Constance Regnier,132414,81967,Agence_moov_Abomey,300000,249553,2022-03-25
CASH_OUT,18631,Constance Regnier,81967,63336,Agence_moov_Ouidah,300000,281369,2022-03-25
CASH_OUT,51238,Constance Regnier,63336,12098,Agence_moov_Abomey,300000,248762,2022-03-27
CASH_IN,152310,Agence_moov_Ouidah,300000,147690,Constance Regnier,12098,164408,2022-03-27
TRANSFER,379275,Diane-Françoise Raynaud,552500,173225,Constance Regnier,164408,543683,2022-03-27
TRANSFER,128556,Anastasie Louis,1330200,1201644,Anastasie Louis,1330200,1201644,2022-03-03
TRANSFER,209592,Clémence Bertin,374700,165108,Anastasie Louis,1201644,1411236,2022-03-06
TRANSFER,621206,Anastasie Louis,1411236,790030,Nath Léger,1437900,816694,2022-03-06
CASH_IN,253253,Agence_moov_Abomey,300000,46747,Anastasie Louis,790030,1043283,2022-03-07
CASH_IN,59940,Agence_moov_Abomey,300000,240060,Anastasie Louis,1043283,1103223,2022-03-08
CASH_IN,94369,Agence_moov_Ouidah,300000,205631,Anastasie Louis,1103223,1197592,2022-03-09
CASH_OUT,290503,Anastasie Louis,1197592,907089,Agence_moov_Ouidah,300000,9497,2022-03-10
TRANSFER,63362,Alphonse Dupont-Petit,1220609,1157247,Anastasie Louis,907089,970451,2022-03-10
CASH_OUT,64874,Anastasie Louis,970451,905577,Agence_moov_Cotonou,300000,235126,2022-03-11
CASH_IN,114056,Agence_moov_Abomey,300000,185944,Anastasie Louis,905577,1019633,2022-03-12
CASH_OUT,823799,Anastasie Louis,1019633,195834,Agence_moov_Ouidah,300000,-523799,2022-03-12
TRANSFER,15629,Anastasie Louis,195834,180205,Adélaïde-Sophie Leclercq,990300,974671,2022-03-13
CASH_IN,223009,Agence_moov_Abomey,300000,76991,Anastasie Louis,180205,403214,2022-03-14
CASH_OUT,326643,Anastasie Louis,403214,76571,Agence_moov_Cotonou,300000,-26643,2022-03-15
CASH_IN,88968,Agence_moov_Ouidah,300000,211032,Anastasie Louis,76571,165539,2022-03-16
CASH_IN,197577,Agence_moov_Ouidah,300000,102423,Anastasie Louis,165539,363116,2022-03-17
CASH_OUT,39305,Anastasie Louis,363116,323811,Agence_moov_Ouidah,300000,260695,2022-03-18
CASH_OUT,171877,Anastasie Louis,323811,151934,Agence_moov_Abomey,300000,128123,2022-03-19
TRANSFER,17332,Anastasie Louis,151934,134602,Guy Guyon,578200,560868,2022-03-21
CASH_OUT,62394,Anastasie Louis,134602,72208,Agence_moov_Cotonou,300000,237606,2022-03-23
CASH_OUT,31276,Anastasie Louis,72208,40932,Agence_moov_Ouidah,300000,268724,2022-03-24
TRANSFER,28479,Anastasie Louis,40932,12453,Matthieu Carpentier,1507600,1479121,2022-03-24
CASH_OUT,2770,Anastasie Louis,12453,9683,Agence_moov_Cotonou,300000,297230,2022-03-24
CASH_OUT,1190,Anastasie Louis,9683,8493,Agence_moov_Ouidah,300000,298810,2022-03-26
CASH_IN,38817,Agence_moov_Cotonou,300000,261183,Anastasie Louis,8493,47310,2022-03-27
TRANSFER,31542,Anastasie Louis,47310,15768,Stéphane-Timothée Pineau,1304255,1272713,2022-03-27
CASH_OUT,88211,Nicolas Grondin de la Pinto,294400,206189,Agence_moov_Cotonou,300000,211789,2022-03-02
TRANSFER,52909,Nicolas Grondin de la Pinto,206189,153280,Marine-Clémence Ferreira,1175568,1122659,2022-03-04
TRANSFER,139849,David Diallo,646400,506551,Nicolas Grondin de la Pinto,153280,293129,2022-03-04
CASH_OUT,251501,Nicolas Grondin de la Pinto,293129,41628,Agence_moov_Cotonou,300000,48499,2022-03-04
TRANSFER,449616,Frédérique Robin,1736500,1286884,Nicolas Grondin de la Pinto,41628,491244,2022-03-05
TRANSFER,40297,Alfred Chrétien,56627,16330,Nicolas Grondin de la Pinto,491244,531541,2022-03-05
TRANSFER,417906,Nicolas Grondin de la Pinto,531541,113635,Richard Guibert,107412,-310494,2022-03-05
CASH_OUT,78022,Nicolas Grondin de la Pinto,113635,35613,Agence_moov_Ouidah,300000,221978,2022-03-06
TRANSFER,12074,Nicolas Grondin de la Pinto,35613,23539,Paulette Dias,540500,528426,2022-03-07
CASH_IN,267697,Agence_moov_Cotonou,300000,32303,Nicolas Grondin de la Pinto,23539,291236,2022-03-07
TRANSFER,16354,Joseph de la Dubois,208700,192346,Nicolas Grondin de la Pinto,291236,307590,2022-03-08
CASH_OUT,176298,Nicolas Grondin de la Pinto,307590,131292,Agence_moov_Ouidah,300000,123702,2022-03-09
CASH_OUT,116469,Nicolas Grondin de la Pinto,131292,14823,Agence_moov_Abomey,300000,183531,2022-03-09
TRANSFER,5366,Nicolas Grondin de la Pinto,14823,9457,Jacques-Antoine Gros,988000,982634,2022-03-10
CASH_IN,33046,Agence_moov_Ouidah,300000,266954,Nicolas Grondin de la Pinto,9457,42503,2022-03-13
CASH_IN,151207,Agence_moov_Cotonou,300000,148793,Nicolas Grondin de la Pinto,42503,193710,2022-03-13
CASH_IN,13445,Agence_moov_Ouidah,300000,286555,Nicolas Grondin de la Pinto,193710,207155,2022-03-13
TRANSFER,45477,Nicolas Grondin de la Pinto,207155,161678,Paulette Dias,528426,482949,2022-03-14
TRANSFER,1023762,Matthieu Carpentier,1479121,455359,Nicolas Grondin de la Pinto,161678,1185440,2022-03-15
TRANSFER,209893,Michèle Vallée,588300,378407,Nicolas Grondin de la Pinto,1185440,1395333,2022-03-17
CASH_IN,6866,Agence_moov_Ouidah,300000,293134,Nicolas Grondin de la Pinto,1395333,1402199,2022-03-18
CASH_OUT,617399,Nicolas Grondin de la Pinto,1402199,784800,Agence_moov_Abomey,300000,-317399,2022-03-19
CASH_OUT,177703,Nicolas Grondin de la Pinto,784800,607097,Agence_moov_Ouidah,300000,122297,2022-03-19
CASH_OUT,153485,Nicolas Grondin de la Pinto,607097,453612,Agence_moov_Abomey,300000,146515,2022-03-21
CASH_IN,154219,Agence_moov_Ouidah,300000,145781,Nicolas Grondin de la Pinto,453612,607831,2022-03-23
CASH_OUT,269719,Nicolas Grondin de la Pinto,607831,338112,Agence_moov_Ouidah,300000,30281,2022-03-23
TRANSFER,1639089,Marthe Pichon,1823000,183911,Nicolas Grondin de la Pinto,338112,1977201,2022-03-23
CASH_IN,258608,Agence_moov_Ouidah,300000,41392,Nicolas Grondin de la Pinto,1977201,2235809,2022-03-26
CASH_OUT,1827411,Nicolas Grondin de la Pinto,2235809,408398,Agence_moov_Ouidah,300000,-1527411,2022-03-26
CASH_IN,223881,Agence_moov_Ouidah,300000,76119,Nicolas Hervé,540000,763881,2022-03-01
TRANSFER,101288,Joséphine Weber du Bonnin,174940,73652,Nicolas Hervé,763881,865169,2022-03-01
CASH_IN,265142,Agence_moov_Ouidah,300000,34858,Nicolas Hervé,865169,1130311,2022-03-02
TRANSFER,259315,Nicolas Hervé,1130311,870996,Agnès Baron,1391255,1131940,2022-03-03
CASH_IN,86102,Agence_moov_Ouidah,300000,213898,Nicolas Hervé,870996,957098,2022-03-03
CASH_IN,156100,Agence_moov_Cotonou,300000,143900,Nicolas Hervé,957098,1113198,2022-03-03
CASH_IN,121942,Agence_moov_Ouidah,300000,178058,Nicolas Hervé,1113198,1235140,2022-03-04
TRANSFER,204032,Théophile Mendès,231559,27527,Nicolas Hervé,1235140,1439172,2022-03-05
CASH_IN,280536,Agence_moov_Abomey,300000,19464,Nicolas Hervé,1439172,1719708,2022-03-05
TRANSFER,862196,Frédérique Robin,1286884,424688,Nicolas Hervé,1719708,2581904,2022-03-06
CASH_IN,24686,Agence_moov_Ouidah,300000,275314,Nicolas Hervé,2581904,2606590,2022-03-07
CASH_IN,119285,Agence_moov_Ouidah,300000,180715,Nicolas Hervé,2606590,2725875,2022-03-10
CASH_OUT,862846,Nicolas Hervé,2725875,1863029,Agence_moov_Ouidah,300000,-562846,2022-03-11
CASH_IN,138691,Agence_moov_Abomey,300000,161309,Nicolas Hervé,1863029,2001720,2022-03-11
CASH_IN,162377,Agence_moov_Cotonou,300000,137623,Nicolas Hervé,2001720,2164097,2022-03-11
TRANSFER,115353,Arnaude Gaillard,595900,480547,Nicolas Hervé,2164097,2279450,2022-03-12
CASH_IN,117758,Agence_moov_Ouidah,300000,182242,Nicolas Hervé,2279450,2397208,2022-03-12
CASH_IN,5792,Agence_moov_Ouidah,300000,294208,Nicolas Hervé,2397208,2403000,2022-03-13
CASH_IN,217213,Agence_moov_Cotonou,300000,82787,Nicolas Hervé,2403000,2620213,2022-03-14
CASH_OUT,1279284,Nicolas Hervé,2620213,1340929,Agence_moov_Ouidah,300000,-979284,2022-03-15
CASH_IN,14853,Agence_moov_Cotonou,300000,285147,Nicolas Hervé,1340929,1355782,2022-03-19
CASH_IN,198809,Agence_moov_Cotonou,300000,101191,Nicolas Hervé,1355782,1554591,2022-03-19
TRANSFER,1346375,Nicolas Hervé,1554591,208216,Marthe Guillet,223500,-1122875,2022-03-20
CASH_OUT,38226,Nicolas Hervé,208216,169990,Agence_moov_Abomey,300000,261774,2022-03-21
CASH_IN,18653,Agence_moov_Cotonou,300000,281347,Nicolas Hervé,169990,188643,2022-03-22
TRANSFER,73812,Stéphane-Timothée Pineau,1272713,1198901,Nicolas Hervé,188643,262455,2022-03-22
CASH_OUT,40780,Nicolas Hervé,262455,221675,Agence_moov_Ouidah,300000,259220,2022-03-23
CASH_OUT,191846,Nicolas Hervé,221675,29829,Agence_moov_Cotonou,300000,108154,2022-03-26
CASH_IN,106299,Agence_moov_Abomey,300000,193701,Nicolas Hervé,29829,136128,2022-03-26
CASH_IN,164071,Agence_moov_Ouidah,300000,135929,Lucy Vaillant,884500,1048571,2022-03-01
CASH_IN,246526,Agence_moov_Cotonou,300000,53474,Lucy Vaillant,1048571,1295097,2022-03-02
CASH_IN,55910,Agence_moov_Ouidah,300000,244090,Lucy Vaillant,1295097,1351007,2022-03-03
CASH_IN,86327,Agence_moov_Cotonou,300000,213673,Lucy Vaillant,1351007,1437334,2022-03-03
CASH_OUT,13516,Lucy Vaillant,1437334,1423818,Agence_moov_Ouidah,300000,286484,2022-03-04
CASH_OUT,540423,Lucy Vaillant,1423818,883395,Agence_moov_Ouidah,300000,-240423,2022-03-05
TRANSFER,166497,Adélaïde-Sophie Leclercq,974671,808174,Lucy Vaillant,883395,1049892,2022-03-06
CASH_OUT,324008,Lucy Vaillant,1049892,725884,Agence_moov_Ouidah,300000,-24008,2022-03-09
TRANSFER,262798,Frédérique Robin,424688,161890,Lucy Vaillant,725884,988682,2022-03-13
CASH_OUT,654188,Lucy Vaillant,988682,334494,Agence_moov_Cotonou,300000,-354188,2022-03-14
TRANSFER,187480,Lucy Vaillant,334494,147014,Julie Robin de Gros,8120,-179360,2022-03-14
TRANSFER,352827,Paulette Dias,482949,130122,Lucy Vaillant,147014,499841,2022-03-16
CASH_IN,68749,Agence_moov_Abomey,300000,231251,Lucy Vaillant,499841,568590,2022-03-16
CASH_IN,3957,Agence_moov_Ouidah,300000,296043,Lucy Vaillant,568590,572547,2022-03-18
TRANSFER,99743,Lucy Vaillant,572547,472804,Caroline Bonneau,776900,677157,2022-03-20
CASH_IN,55423,Agence_moov_Abomey,300000,244577,Lucy Vaillant,472804,528227,2022-03-22
CASH_OUT,130873,Lucy Vaillant,528227,397354,Agence_moov_Abomey,300000,169127,2022-03-23
CASH_IN,138368,Agence_moov_Cotonou,300000,161632,Lucy Vaillant,397354,535722,2022-03-24
TRANSFER,6279,David-Théodore Diaz,21200,14921,Lucy Vaillant,535722,542001,2022-03-24
CASH_IN,195060,Agence_moov_Abomey,300000,104940,Lucy Vaillant,542001,737061,2022-03-25
CASH_OUT,276617,Lucy Vaillant,737061,460444,Agence_moov_Abomey,300000,23383,2022-03-26
CASH_OUT,5447,Lucy Vaillant,460444,454997,Agence_moov_Abomey,300000,294553,2022-03-27
CASH_IN,212480,Agence_moov_Abomey,300000,87520,Paulette Dias,130122,342602,2022-03-02
CASH_OUT,171533,Paulette Dias,342602,171069,Agence_moov_Cotonou,300000,128467,2022-03-03
CASH_OUT,132349,Paulette Dias,171069,38720,Agence_moov_Abomey,300000,167651,2022-03-03
CASH_IN,68382,Agence_moov_Cotonou,300000,231618,Paulette Dias,38720,107102,2022-03-04
TRANSFER,14845,Paulette Dias,107102,92257,Marie Da Silva,790401,775556,2022-03-04
CASH_OUT,92120,Paulette Dias,92257,137,Agence_moov_Ouidah,300000,207880,2022-03-08
CASH_IN,206831,Agence_moov_Abomey,300000,93169,Paulette Dias,137,206968,2022-03-09
CASH_OUT,123525,Paulette Dias,206968,83443,Agence_moov_Abomey,300000,176475,2022-03-10
CASH_IN,255839,Agence_moov_Abomey,300000,44161,Paulette Dias,83443,339282,2022-03-10
TRANSFER,69243,Paulette Dias,339282,270039,Frédéric Moreau,45100,-24143,2022-03-11
CASH_IN,79901,Agence_moov_Cotonou,300000,220099,Paulette Dias,270039,349940,2022-03-12
TRANSFER,29780,Paulette Dias,349940,320160,Roland Colin,614800,585020,2022-03-14
CASH_IN,26652,Agence_moov_Abomey,300000,273348,Paulette Dias,320160,346812,2022-03-14
CASH_OUT,11431,Paulette Dias,346812,335381,Agence_moov_Abomey,300000,288569,2022-03-15
CASH_IN,154762,Agence_moov_Abomey,300000,145238,Paulette Dias,335381,490143,2022-03-16
TRANSFER,56123,Grégoire Delmas de Blanchard,1373200,1317077,Paulette Dias,490143,546266,2022-03-17
CASH_IN,82551,Agence_moov_Cotonou,300000,217449,Paulette Dias,546266,628817,2022-03-17
CASH_OUT,75841,Paulette Dias,628817,552976,Agence_moov_Cotonou,300000,224159,2022-03-17
CASH_OUT,492400,Paulette Dias,552976,60576,Agence_moov_Ouidah,300000,-192400,2022-03-18
CASH_OUT,11375,Paulette Dias,60576,49201,Agence_moov_Cotonou,300000,288625,2022-03-18
CASH_OUT,40554,Paulette Dias,49201,8647,Agence_moov_Cotonou,300000,259446,2022-03-19
TRANSFER,266110,Nath Léger,816694,550584,Paulette Dias,8647,274757,2022-03-21
CASH_IN,168679,Agence_moov_Cotonou,300000,131321,Paulette Dias,274757,443436,2022-03-22
TRANSFER,157871,Paulette Dias,443436,285565,Juliette Evrard Le Giraud,436019,278148,2022-03-22
TRANSFER,402700,Emmanuelle Gilbert,844800,442100,Paulette Dias,285565,688265,2022-03-26
CASH_IN,116056,Agence_moov_Abomey,300000,183944,Paulette Dias,688265,804321,2022-03-26
CASH_OUT,253848,Paulette Dias,804321,550473,Agence_moov_Abomey,300000,46152,2022-03-26
CASH_IN,292318,Agence_moov_Cotonou,300000,7682,Richard Guibert,-310494,-18176,2022-03-01
CASH_IN,248097,Agence_moov_Cotonou,300000,51903,Richard Guibert,-18176,229921,2022-03-01
TRANSFER,278847,Adélaïde-Sophie Leclercq,808174,529327,Richard Guibert,229921,508768,2022-03-01
TRANSFER,275577,Richard Guibert,508768,233191,Laurence Dumont de Laroche,1892600,1617023,2022-03-04
CASH_IN,210577,Agence_moov_Abomey,300000,89423,Richard Guibert,233191,443768,2022-03-05
TRANSFER,1320259,Maryse Reynaud-Michaud,1913200,592941,Richard Guibert,443768,1764027,2022-03-06
CASH_IN,182290,Agence_moov_Abomey,300000,117710,Richard Guibert,1764027,1946317,2022-03-08
TRANSFER,1939892,Richard Guibert,1946317,6425,Clémence Bertin,165108,-1774784,2022-03-10
CASH_IN,202512,Agence_moov_Cotonou,300000,97488,Richard Guibert,6425,208937,2022-03-11
CASH_OUT,137559,Richard Guibert,208937,71378,Agence_moov_Abomey,300000,162441,2022-03-12
CASH_OUT,66303,Richard Guibert,71378,5075,Agence_moov_Ouidah,300000,233697,2022-03-12
CASH_IN,160440,Agence_moov_Ouidah,300000,139560,Richard Guibert,5075,165515,2022-03-12
CASH_OUT,18537,Richard Guibert,165515,146978,Agence_moov_Ouidah,300000,281463,2022-03-12
TRANSFER,31728,Marc Gilbert,437608,405880,Richard Guibert,146978,178706,2022-03-12
CASH_OUT,30390,Richard Guibert,178706,148316,Agence_moov_Cotonou,300000,269610,2022-03-12
TRANSFER,38625,Richard Guibert,148316,109691,Matthieu Carpentier,455359,416734,2022-03-14
CASH_OUT,40676,Richard Guibert,109691,69015,Agence_moov_Ouidah,300000,259324,2022-03-16
CASH_IN,141985,Agence_moov_Abomey,300000,158015,Richard Guibert,69015,211000,2022-03-20
CASH_IN,193490,Agence_moov_Ouidah,300000,106510,Richard Guibert,211000,404490,2022-03-24
TRANSFER,122217,Richard Guibert,404490,282273,Valentine Traore,1913200,1790983,2022-03-24
TRANSFER,140548,Richard Guibert,282273,141725,Adélaïde-Sophie Leclercq,529327,388779,2022-03-24
CASH_IN,214928,Agence_moov_Cotonou,300000,85072,Richard Guibert,141725,356653,2022-03-25
CASH_OUT,331395,Richard Guibert,356653,25258,Agence_moov_Ouidah,300000,-31395,2022-03-25
CASH_OUT,16945,Richard Guibert,25258,8313,Agence_moov_Ouidah,300000,283055,2022-03-25
CASH_IN,86035,Agence_moov_Abomey,300000,213965,Richard Guibert,8313,94348,2022-03-27
CASH_IN,223407,Agence_moov_Ouidah,300000,76593,Nath Léger,550584,773991,2022-03-01
CASH_IN,92816,Agence_moov_Cotonou,300000,207184,Nath Léger,773991,866807,2022-03-01
CASH_IN,182378,Agence_moov_Abomey,300000,117622,Nath Léger,866807,1049185,2022-03-01
TRANSFER,920624,Alphonse Dupont-Petit,1157247,236623,Nath Léger,1049185,1969809,2022-03-01
TRANSFER,135592,Adrienne Arnaud,709400,573808,Nath Léger,1969809,2105401,2022-03-02
TRANSFER,506024,Guy Guyon,560868,54844,Nath Léger,2105401,2611425,2022-03-04
TRANSFER,1216360,Nath Léger,2611425,1395065,Juliette Evrard Le Giraud,278148,-938212,2022-03-05
CASH_OUT,478573,Nath Léger,1395065,916492,Agence_moov_Abomey,300000,-178573,2022-03-10
CASH_OUT,241238,Nath Léger,916492,675254,Agence_moov_Ouidah,300000,58762,2022-03-11
CASH_OUT,188735,Nath Léger,675254,486519,Agence_moov_Abomey,300000,111265,2022-03-15
CASH_IN,228267,Agence_moov_Abomey,300000,71733,Nath Léger,486519,714786,2022-03-15
TRANSFER,265673,Christine-Constance Gauthier,409100,143427,Nath Léger,714786,980459,2022-03-16
CASH_IN,127564,Agence_moov_Abomey,300000,172436,Nath Léger,980459,1108023,2022-03-17
TRANSFER,72939,Marianne Descamps,301823,228884,Nath Léger,1108023,1180962,2022-03-20
TRANSFER,598229,Gilbert Bazin Le Guillet,970200,371971,Nath Léger,1180962,1779191,2022-03-21
CASH_OUT,1021460,Nath Léger,1779191,757731,Agence_moov_Ouidah,300000,-721460,2022-03-23
CASH_IN,51266,Agence_moov_Abomey,300000,248734,Nath Léger,757731,808997,2022-03-25
CASH_OUT,201512,Nath Léger,808997,607485,Agence_moov_Abomey,300000,98488,2022-03-25
CASH_OUT,294082,Nath Léger,607485,313403,Agence_moov_Cotonou,300000,5918,2022-03-25
CASH_IN,98560,Agence_moov_Abomey,300000,201440,Nath Léger,313403,411963,2022-03-27
TRANSFER,317857,Nath Léger,411963,94106,Frédérique Robin,161890,-155967,2022-03-27
CASH_IN,52783,Agence_moov_Cotonou,300000,247217,Caroline Peltier,351300,404083,2022-03-01
CASH_IN,239766,Agence_moov_Abomey,300000,60234,Caroline Peltier,404083,643849,2022-03-01
TRANSFER,49499,Jacques-Antoine Gros,982634,933135,Caroline Peltier,643849,693348,2022-03-03
CASH_IN,299093,Agence_moov_Cotonou,300000,907,Caroline Peltier,693348,992441,2022-03-08
TRANSFER,532051,Maryse Lebreton,623638,91587,Caroline Peltier,992441,1524492,2022-03-08
CASH_OUT,1321494,Caroline Peltier,1524492,202998,Agence_moov_Cotonou,300000,-1021494,2022-03-09
TRANSFER,195,Océane Boutin,724,529,Caroline Peltier,202998,203193,2022-03-10
TRANSFER,103578,Caroline Peltier,203193,99615,Emmanuel-René Coulon,84030,-19548,2022-03-10
TRANSFER,230955,Roland Colin,585020,354065,Caroline Peltier,99615,330570,2022-03-14
TRANSFER,313431,Caroline Peltier,330570,17139,Paul Pereira,1143833,830402,2022-03-16
TRANSFER,14934,Caroline Peltier,17139,2205,Caroline Peltier,17139,2205,2022-03-16
TRANSFER,50808,Joséphine Weber du Bonnin,73652,22844,Caroline Peltier,2205,53013,2022-03-16
CASH_IN,289019,Agence_moov_Cotonou,300000,10981,Caroline Peltier,53013,342032,2022-03-18
CASH_IN,62901,Agence_moov_Cotonou,300000,237099,Caroline Peltier,342032,404933,2022-03-18
CASH_OUT,41907,Caroline Peltier,404933,363026,Agence_moov_Abomey,300000,258093,2022-03-19
TRANSFER,320873,Caroline Peltier,363026,42153,Augustin Benard,6800,-314073,2022-03-19
CASH_IN,59129,Agence_moov_Ouidah,300000,240871,Caroline Peltier,42153,101282,2022-03-21
TRANSFER,10172,Caroline Peltier,101282,91110,Amélie de la Picard,77600,67428,2022-03-21
TRANSFER,9463,Théophile Mendès,27527,18064,Caroline Peltier,91110,100573,2022-03-21
TRANSFER,38133,Caroline Peltier,100573,62440,Marianne Descamps,228884,190751,2022-03-25
CASH_OUT,62169,Caroline Peltier,62440,271,Agence_moov_Ouidah,300000,237831,2022-03-26
TRANSFER,817101,Alexandre Poirier,1016100,198999,Marthe Pichon,183911,-633190,2022-03-03
TRANSFER,26033,Alexandre Poirier,198999,172966,Alexandre Poirier,198999,172966,2022-03-05
CASH_IN,169084,Agence_moov_Ouidah,300000,130916,Alexandre Poirier,172966,342050,2022-03-07
CASH_OUT,154825,Alexandre Poirier,342050,187225,Agence_moov_Abomey,300000,145175,2022-03-09
CASH_IN,138248,Agence_moov_Ouidah,300000,161752,Alexandre Poirier,187225,325473,2022-03-09
CASH_OUT,271608,Alexandre Poirier,325473,53865,Agence_moov_Abomey,300000,28392,2022-03-09
TRANSFER,112716,Nathalie-Chantal Jacques,1281458,1168742,Alexandre Poirier,53865,166581,2022-03-14
CASH_OUT,3113,Alexandre Poirier,166581,163468,Agence_moov_Abomey,300000,296887,2022-03-16
CASH_OUT,133607,Alexandre Poirier,163468,29861,Agence_moov_Cotonou,300000,166393,2022-03-16
CASH_IN,113283,Agence_moov_Ouidah,300000,186717,Alexandre Poirier,29861,143144,2022-03-18
CASH_IN,129210,Agence_moov_Abomey,300000,170790,Alexandre Poirier,143144,272354,2022-03-19
CASH_OUT,36544,Alexandre Poirier,272354,235810,Agence_moov_Ouidah,300000,263456,2022-03-19
TRANSFER,411992,Benoît Verdier,1647600,1235608,Alexandre Poirier,235810,647802,2022-03-19
CASH_IN,156552,Agence_moov_Cotonou,300000,143448,Alexandre Poirier,647802,804354,2022-03-19
CASH_OUT,303091,Alexandre Poirier,804354,501263,Agence_moov_Abomey,300000,-3091,2022-03-19
CASH_OUT,49342,Alexandre Poirier,501263,451921,Agence_moov_Abomey,300000,250658,2022-03-19
CASH_OUT,263266,Alexandre Poirier,451921,188655,Agence_moov_Cotonou,300000,36734,2022-03-21
TRANSFER,173042,Alexandre Poirier,188655,15613,Guy Guyon,54844,-118198,2022-03-22
CASH_OUT,14553,Alexandre Poirier,15613,1060,Agence_moov_Abomey,300000,285447,2022-03-23
TRANSFER,248785,Michèle Vallée,378407,129622,Alexandre Poirier,1060,249845,2022-03-23
CASH_IN,67014,Agence_moov_Ouidah,300000,232986,Alexandre Poirier,249845,316859,2022-03-24
CASH_IN,299358,Agence_moov_Ouidah,300000,642,Alexandre Poirier,316859,616217,2022-03-24
CASH_IN,180592,Agence_moov_Ouidah,300000,119408,Alexandre Poirier,616217,796809,2022-03-25
CASH_OUT,223055,Alexandre Poirier,796809,573754,Agence_moov_Cotonou,300000,76945,2022-03-25
CASH_IN,270314,Agence_moov_Abomey,300000,29686,Alexandre Poirier,573754,844068,2022-03-26
TRANSFER,348408,Alexandre Poirier,844068,495660,Benoît Verdier,1235608,887200,2022-03-27
CASH_OUT,33616,Gilbert Bazin Le Guillet,371971,338355,Agence_moov_Cotonou,300000,266384,2022-03-02
CASH_OUT,119209,Gilbert Bazin Le Guillet,338355,219146,Agence_moov_Ouidah,300000,180791,2022-03-04
CASH_IN,115038,Agence_moov_Cotonou,300000,184962,Gilbert Bazin Le Guillet,219146,334184,2022-03-04
TRANSFER,650224,Laurence Dumont de Laroche,1617023,966799,Gilbert Bazin Le Guillet,334184,984408,2022-03-06
TRANSFER,198427,Stéphanie Bonneau,1529800,1331373,Gilbert Bazin Le Guillet,984408,1182835,2022-03-07
CASH_OUT,484209,Gilbert Bazin Le Guillet,1182835,698626,Agence_moov_Abomey,300000,-184209,2022-03-09
CASH_IN,285148,Agence_moov_Ouidah,300000,14852,Gilbert Bazin Le Guillet,698626,983774,2022-03-11
TRANSFER,450978,Gilbert Bazin Le Guillet,983774,532796,Marc Gilbert,405880,-45098,2022-03-11
CASH_OUT,64101,Gilbert Bazin Le Guillet,532796,468695,Agence_moov_Abomey,300000,235899,2022-03-12
TRANSFER,25867,Gilbert Bazin Le Guillet,468695,442828,Emmanuel Bousquet,373600,347733,2022-03-14
TRANSFER,130351,Gilbert Bazin Le Guillet,442828,312477,Grégoire Delmas de Blanchard,1317077,1186726,2022-03-15
CASH_OUT,290133,Gilbert Bazin Le Guillet,312477,22344,Agence_moov_Cotonou,300000,9867,2022-03-19
CASH_IN,60909,Agence_moov_Cotonou,300000,239091,Gilbert Bazin Le Guillet,22344,83253,2022-03-19
CASH_IN,250201,Agence_moov_Abomey,300000,49799,Gilbert Bazin Le Guillet,83253,333454,2022-03-21
CASH_IN,61206,Agence_moov_Abomey,300000,238794,Gilbert Bazin Le Guillet,333454,394660,2022-03-23
TRANSFER,50746,Gilbert Bazin Le Guillet,394660,343914,Marianne Descamps,190751,140005,2022-03-23
CASH_IN,138743,Agence_moov_Ouidah,300000,161257,Gilbert Bazin Le Guillet,343914,482657,2022-03-24
CASH_IN,186635,Agence_moov_Ouidah,300000,113365,Gilbert Bazin Le Guillet,482657,669292,2022-03-24
TRANSFER,937,Alfred Chrétien,16330,15393,Gilbert Bazin Le Guillet,669292,670229,2022-03-25
CASH_OUT,68353,Gilbert Bazin Le Guillet,670229,601876,Agence_moov_Ouidah,300000,231647,2022-03-26
CASH_OUT,379573,Gilbert Bazin Le Guillet,601876,222303,Agence_moov_Abomey,300000,-79573,2022-03-27
CASH_OUT,669738,Jacques-Antoine Gros,933135,263397,Agence_moov_Abomey,300000,-369738,2022-03-01
CASH_IN,155061,Agence_moov_Abomey,300000,144939,Jacques-Antoine Gros,263397,418458,2022-03-01
CASH_OUT,15891,Jacques-Antoine Gros,418458,402567,Agence_moov_Abomey,300000,284109,2022-03-03
CASH_OUT,347548,Jacques-Antoine Gros,402567,55019,Agence_moov_Ouidah,300000,-47548,2022-03-03
CASH_OUT,30916,Jacques-Antoine Gros,55019,24103,Agence_moov_Cotonou,300000,269084,2022-03-05
CASH_OUT,22645,Jacques-Antoine Gros,24103,1458,Agence_moov_Ouidah,300000,277355,2022-03-05
CASH_OUT,791,Jacques-Antoine Gros,1458,667,Agence_moov_Ouidah,300000,299209,2022-03-07
TRANSFER,799077,Vincent-Philippe Rossi,1821100,1022023,Jacques-Antoine Gros,667,799744,2022-03-09
CASH_OUT,95394,Jacques-Antoine Gros,799744,704350,Agence_moov_Abomey,300000,204606,2022-03-10
CASH_IN,141680,Agence_moov_Abomey,300000,158320,Jacques-Antoine Gros,704350,846030,2022-03-10
CASH_IN,299978,Agence_moov_Abomey,300000,22,Jacques-Antoine Gros,846030,1146008,2022-03-11
CASH_IN,266578,Agence_moov_Abomey,300000,33422,Jacques-Antoine Gros,1146008,1412586,2022-03-12
CASH_OUT,1327209,Jacques-Antoine Gros,1412586,85377,Agence_moov_Abomey,300000,-1027209,2022-03-13
CASH_OUT,41053,Jacques-Antoine Gros,85377,44324,Agence_moov_Abomey,300000,258947,2022-03-14
CASH_IN,268768,Agence_moov_Cotonou,300000,31232,Jacques-Antoine Gros,44324,313092,2022-03-14
CASH_IN,118000,Agence_moov_Ouidah,300000,182000,Jacques-Antoine Gros,313092,431092,2022-03-14
CASH_IN,12773,Agence_moov_Cotonou,300000,287227,Jacques-Antoine Gros,431092,443865,2022-03-17
CASH_OUT,432133,Jacques-Antoine Gros,443865,11732,Agence_moov_Cotonou,300000,-132133,2022-03-18
CASH_OUT,4155,Jacques-Antoine Gros,11732,7577,Agence_moov_Ouidah,300000,295845,2022-03-18
CASH_OUT,1230,Jacques-Antoine Gros,7577,6347,Agence_moov_Ouidah,300000,298770,2022-03-19
CASH_IN,87364,Agence_moov_Cotonou,300000,212636,Jacques-Antoine Gros,6347,93711,2022-03-21
CASH_OUT,11812,Jacques-Antoine Gros,93711,81899,Agence_moov_Abomey,300000,288188,2022-03-21
TRANSFER,79213,Jacques-Antoine Gros,81899,2686,Théophile Mendès,18064,-61149,2022-03-23
CASH_OUT,192,Jacques-Antoine Gros,2686,2494,Agence_moov_Cotonou,300000,299808,2022-03-23
CASH_OUT,2385,Jacques-Antoine Gros,2494,109,Agence_moov_Abomey,300000,297615,2022-03-23
TRANSFER,103,Jacques-Antoine Gros,109,6,Matthieu Carpentier,416734,416631,2022-03-23
CASH_IN,286240,Agence_moov_Ouidah,300000,13760,Jacques-Antoine Gros,6,286246,2022-03-24
CASH_OUT,207473,Jacques-Antoine Gros,286246,78773,Agence_moov_Abomey,300000,92527,2022-03-26
CASH_IN,63631,Agence_moov_Ouidah,300000,236369,Vincent-Philippe Rossi,1022023,1085654,2022-03-05
CASH_OUT,1020159,Vincent-Philippe Rossi,1085654,65495,Agence_moov_Cotonou,300000,-720159,2022-03-08
CASH_IN,38464,Agence_moov_Cotonou,300000,261536,Vincent-Philippe Rossi,65495,103959,2022-03-09
CASH_IN,256731,Agence_moov_Abomey,300000,43269,Vincent-Philippe Rossi,103959,360690,2022-03-10
CASH_IN,95721,Agence_moov_Abomey,300000,204279,Vincent-Philippe Rossi,360690,456411,2022-03-10
CASH_IN,81651,Agence_moov_Abomey,300000,218349,Vincent-Philippe Rossi,456411,538062,2022-03-12
CASH_IN,201094,Agence_moov_Cotonou,300000,98906,Vincent-Philippe Rossi,538062,739156,2022-03-13
TRANSFER,13214,Amélie de la Picard,67428,54214,Vincent-Philippe Rossi,739156,752370,2022-03-13
TRANSFER,265181,Adrienne Arnaud,573808,308627,Vincent-Philippe Rossi,752370,1017551,2022-03-13
CASH_IN,237977,Agence_moov_Abomey,300000,62023,Vincent-Philippe Rossi,1017551,1255528,2022-03-13
CASH_OUT,210666,Vincent-Philippe Rossi,1255528,1044862,Agence_moov_Abomey,300000,89334,2022-03-14
CASH_OUT,763273,Vincent-Philippe Rossi,1044862,281589,Agence_moov_Abomey,300000,-463273,2022-03-15
TRANSFER,127254,Vincent-Philippe Rossi,281589,154335,Arnaude Gaillard,480547,353293,2022-03-16
CASH_IN,119993,Agence_moov_Cotonou,300000,180007,Vincent-Philippe Rossi,154335,274328,2022-03-16
TRANSFER,14167,Joséphine Weber du Bonnin,22844,8677,Vincent-Philippe Rossi,274328,288495,2022-03-19
CASH_IN,15256,Agence_moov_Abomey,300000,284744,Vincent-Philippe Rossi,288495,303751,2022-03-24
CASH_OUT,252250,Vincent-Philippe Rossi,303751,51501,Agence_moov_Ouidah,300000,47750,2022-03-24
TRANSFER,44305,Adélaïde-Sophie Leclercq,388779,344474,Vincent-Philippe Rossi,51501,95806,2022-03-26
CASH_IN,278960,Agence_moov_Ouidah,300000,21040,Vincent-Philippe Rossi,95806,374766,2022-03-26
TRANSFER,36459,Vincent-Philippe Rossi,374766,338307,Diane-Françoise Raynaud,173225,136766,2022-03-27
CASH_OUT,179125,Vincent-Philippe Rossi,338307,159182,Agence_moov_Abomey,300000,120875,2022-03-27
CASH_IN,79006,Agence_moov_Cotonou,300000,220994,Frédérique Robin,-155967,-76961,2022-03-01
CASH_IN,279294,Agence_moov_Abomey,300000,20706,Frédérique Robin,-76961,202333,2022-03-02
CASH_IN,184041,Agence_moov_Cotonou,300000,115959,Frédérique Robin,202333,386374,2022-03-03
TRANSFER,340717,Frédérique Robin,386374,45657,Arnaude Gaillard,353293,12576,2022-03-04
CASH_IN,172868,Agence_moov_Cotonou,300000,127132,Frédérique Robin,45657,218525,2022-03-05
CASH_OUT,144154,Frédérique Robin,218525,74371,Agence_moov_Ouidah,300000,155846,2022-03-05
TRANSFER,199105,Adélaïde-Sophie Leclercq,344474,145369,Frédérique Robin,74371,273476,2022-03-07
TRANSFER,148495,Frédérique Robin,273476,124981,Auguste Bousquet,779300,630805,2022-03-08
CASH_OUT,26606,Frédérique Robin,124981,98375,Agence_moov_Ouidah,300000,273394,2022-03-10
CASH_OUT,34491,Frédérique Robin,98375,63884,Agence_moov_Ouidah,300000,265509,2022-03-11
CASH_IN,57025,Agence_moov_Cotonou,300000,242975,Frédérique Robin,63884,120909,2022-03-11
CASH_OUT,119478,Frédérique Robin,120909,1431,Agence_moov_Abomey,300000,180522,2022-03-11
CASH_IN,90355,Agence_moov_Abomey,300000,209645,Frédérique Robin,1431,91786,2022-03-15
TRANSFER,280,Océane Boutin,529,249,Frédérique Robin,91786,92066,2022-03-15
CASH_IN,261929,Agence_moov_Ouidah,300000,38071,Frédérique Robin,92066,353995,2022-03-16
CASH_IN,55761,Agence_moov_Ouidah,300000,244239,Frédérique Robin,353995,409756,2022-03-17
TRANSFER,662666,Benoît Verdier,887200,224534,Frédérique Robin,409756,1072422,2022-03-19
TRANSFER,588305,Frédérique Robin,1072422,484117,Agnès Baron,1131940,543635,2022-03-20
CASH_OUT,93741,Frédérique Robin,484117,390376,Agence_moov_Ouidah,300000,206259,2022-03-22
CASH_IN,162402,Agence_moov_Cotonou,300000,137598,Frédérique Robin,390376,552778,2022-03-22
CASH_IN,190865,Agence_moov_Cotonou,300000,109135,Frédérique Robin,552778,743643,2022-03-24
CASH_OUT,196190,Frédérique Robin,743643,547453,Agence_moov_Abomey,300000,103810,2022-03-24
CASH_IN,162998,Agence_moov_Abomey,300000,137002,Frédérique Robin,547453,710451,2022-03-25
CASH_OUT,118657,Frédérique Robin,710451,591794,Agence_moov_Cotonou,300000,181343,2022-03-26
CASH_OUT,392376,Frédérique Robin,591794,199418,Agence_moov_Cotonou,300000,-92376,2022-03-27
CASH_IN,222117,Agence_moov_Abomey,300000,77883,Clémence Bertin,-1774784,-1552667,2022-03-01
CASH_IN,260592,Agence_moov_Ouidah,300000,39408,Clémence Bertin,-1552667,-1292075,2022-03-03
CASH_IN,262064,Agence_moov_Cotonou,300000,37936,Clémence Bertin,-1292075,-1030011,2022-03-03
CASH_IN,154084,Agence_moov_Cotonou,300000,145916,Clémence Bertin,-1030011,-875927,2022-03-04
CASH_IN,165651,Agence_moov_Abomey,300000,134349,Clémence Bertin,-875927,-710276,2022-03-06
CASH_IN,14541,Agence_moov_Abomey,300000,285459,Clémence Bertin,-710276,-695735,2022-03-07
CASH_IN,208253,Agence_moov_Abomey,300000,91747,Clémence Bertin,-695735,-487482,2022-03-07
CASH_IN,261618,Agence_moov_Cotonou,300000,38382,Clémence Bertin,-487482,-225864,2022-03-08
CASH_IN,159297,Agence_moov_Abomey,300000,140703,Clémence Bertin,-225864,-66567,2022-03-09
CASH_IN,289563,Agence_moov_Cotonou,300000,10437,Clémence Bertin,-66567,222996,2022-03-10
CASH_OUT,215608,Clémence Bertin,222996,7388,Agence_moov_Abomey,300000,84392,2022-03-13
CASH_OUT,3402,Clémence Bertin,7388,3986,Agence_moov_Abomey,300000,296598,2022-03-13
CASH_IN,259323,Agence_moov_Ouidah,300000,40677,Clémence Bertin,3986,263309,2022-03-13
CASH_OUT,208954,Clémence Bertin,263309,54355,Agence_moov_Abomey,300000,91046,2022-03-13
TRANSFER,2958,Clémence Bertin,54355,51397,Matthieu Carpentier,416631,413673,2022-03-14
CASH_OUT,35445,Clémence Bertin,51397,15952,Agence_moov_Abomey,300000,264555,2022-03-15
CASH_IN,157142,Agence_moov_Cotonou,300000,142858,Clémence Bertin,15952,173094,2022-03-16
CASH_OUT,65912,Clémence Bertin,173094,107182,Agence_moov_Cotonou,300000,234088,2022-03-17
CASH_OUT,85579,Clémence Bertin,107182,21603,Agence_moov_Abomey,300000,214421,2022-03-17
CASH_IN,90189,Agence_moov_Abomey,300000,209811,Clémence Bertin,21603,111792,2022-03-20
CASH_IN,299470,Agence_moov_Abomey,300000,530,Clémence Bertin,111792,411262,2022-03-20
CASH_OUT,378336,Clémence Bertin,411262,32926,Agence_moov_Cotonou,300000,-78336,2022-03-21
CASH_OUT,4559,Clémence Bertin,32926,28367,Agence_moov_Abomey,300000,295441,2022-03-22
CASH_IN,110208,Agence_moov_Cotonou,300000,189792,Clémence Bertin,28367,138575,2022-03-22
TRANSFER,20962,Clémence Bertin,138575,117613,Maryse Reynaud-Michaud,592941,571979,2022-03-23
CASH_OUT,79287,Clémence Bertin,117613,38326,Agence_moov_Cotonou,300000,220713,2022-03-25
CASH_IN,77234,Agence_moov_Ouidah,300000,222766,Clémence Bertin,38326,115560,2022-03-27
CASH_IN,151408,Agence_moov_Cotonou,300000,148592,Juliette Evrard Le Giraud,-938212,-786804,2022-03-02
CASH_IN,175585,Agence_moov_Ouidah,300000,124415,Juliette Evrard Le Giraud,-786804,-611219,2022-03-06
CASH_IN,263757,Agence_moov_Cotonou,300000,36243,Juliette Evrard Le Giraud,-611219,-347462,2022-03-10
CASH_IN,230185,Agence_moov_Cotonou,300000,69815,Juliette Evrard Le Giraud,-347462,-117277,2022-03-12
CASH_IN,208966,Agence_moov_Abomey,300000,91034,Juliette Evrard Le Giraud,-117277,91689,2022-03-12
TRANSFER,23395,Joseph de la Dubois,192346,168951,Juliette Evrard Le Giraud,91689,115084,2022-03-13
CASH_IN,289828,Agence_moov_Cotonou,300000,10172,Juliette Evrard Le Giraud,115084,404912,2022-03-14
CASH_OUT,76469,Juliette Evrard Le Giraud,404912,328443,Agence_moov_Cotonou,300000,223531,2022-03-15
CASH_OUT,108631,Juliette Evrard Le Giraud,328443,219812,Agence_moov_Cotonou,300000,191369,2022-03-16
CASH_IN,251069,Agence_moov_Abomey,300000,48931,Juliette Evrard Le Giraud,219812,470881,2022-03-16
CASH_IN,40069,Agence_moov_Ouidah,300000,259931,Juliette Evrard Le Giraud,470881,510950,2022-03-18
CASH_OUT,151726,Juliette Evrard Le Giraud,510950,359224,Agence_moov_Ouidah,300000,148274,2022-03-18
CASH_OUT,311107,Juliette Evrard Le Giraud,359224,48117,Agence_moov_Ouidah,300000,-11107,2022-03-18
CASH_IN,126731,Agence_moov_Cotonou,300000,173269,Juliette Evrard Le Giraud,48117,174848,2022-03-20
CASH_OUT,101142,Juliette Evrard Le Giraud,174848,73706,Agence_moov_Cotonou,300000,198858,2022-03-20
CASH_OUT,36219,Juliette Evrard Le Giraud,73706,37487,Agence_moov_Cotonou,300000,263781,2022-03-20
CASH_OUT,20349,Juliette Evrard Le Giraud,37487,17138,Agence_moov_Abomey,300000,279651,2022-03-21
CASH_IN,80226,Agence_moov_Ouidah,300000,219774,Juliette Evrard Le Giraud,17138,97364,2022-03-21
TRANSFER,16613,Juliette Evrard Le Giraud,97364,80751,Gabriel de Pineau,333000,316387,2022-03-22
CASH_IN,161608,Agence_moov_Cotonou,300000,138392,Juliette Evrard Le Giraud,80751,242359,2022-03-22
CASH_IN,172520,Agence_moov_Ouidah,300000,127480,Juliette Evrard Le Giraud,242359,414879,2022-03-23
CASH_OUT,32851,Juliette Evrard Le Giraud,414879,382028,Agence_moov_Ouidah,300000,267149,2022-03-24
CASH_IN,207273,Agence_moov_Abomey,300000,92727,Juliette Evrard Le Giraud,382028,589301,2022-03-25
CASH_IN,82403,Agence_moov_Abomey,300000,217597,Juliette Evrard Le Giraud,589301,671704,2022-03-25
TRANSFER,526549,Juliette Evrard Le Giraud,671704,145155,Diane-Françoise Raynaud,136766,-389783,2022-03-26
CASH_OUT,1264,Juliette Evrard Le Giraud,145155,143891,Agence_moov_Ouidah,300000,298736,2022-03-26
TRANSFER,68693,Christine-Constance Gauthier,143427,74734,Juliette Evrard Le Giraud,143891,212584,2022-03-27
TRANSFER,120579,Juliette Evrard Le Giraud,212584,92005,Benoît Verdier,224534,103955,2022-03-27
TRANSFER,176599,Gabriel de Pineau,316387,139788,Juliette Evrard Le Giraud,92005,268604,2022-03-27
CASH_IN,104331,Agence_moov_Abomey,300000,195669,Diane-Françoise Raynaud,-389783,-285452,2022-03-02
CASH_IN,140274,Agence_moov_Cotonou,300000,159726,Diane-Françoise Raynaud,-285452,-145178,2022-03-02
CASH_IN,192387,Agence_moov_Abomey,300000,107613,Diane-Françoise Raynaud,-145178,47209,2022-03-03
CASH_OUT,21612,Diane-Françoise Raynaud,47209,25597,Agence_moov_Abomey,300000,278388,2022-03-03
CASH_OUT,8499,Diane-Françoise Raynaud,25597,17098,Agence_moov_Abomey,300000,291501,2022-03-03
CASH_IN,202847,Agence_moov_Cotonou,300000,97153,Diane-Françoise Raynaud,17098,219945,2022-03-04
TRANSFER,189984,Diane-Françoise Raynaud,219945,29961,Joseph de la Dubois,168951,-21033,2022-03-04
CASH_IN,193422,Agence_moov_Abomey,300000,106578,Diane-Françoise Raynaud,29961,223383,2022-03-05
CASH_OUT,112661,Diane-Françoise Raynaud,223383,110722,Agence_moov_Cotonou,300000,187339,2022-03-05
CASH_OUT,48999,Diane-Françoise Raynaud,110722,61723,Agence_moov_Cotonou,300000,251001,2022-03-07
CASH_OUT,7658,Diane-Françoise Raynaud,61723,54065,Agence_moov_Cotonou,300000,292342,2022-03-08
TRANSFER,23421,Diane-Françoise Raynaud,54065,30644,Diane-Françoise Raynaud,54065,30644,2022-03-08
CASH_OUT,22113,Diane-Françoise Raynaud,30644,8531,Agence_moov_Cotonou,300000,277887,2022-03-09
CASH_OUT,4407,Diane-Françoise Raynaud,8531,4124,Agence_moov_Cotonou,300000,295593,2022-03-09
CASH_OUT,1365,Diane-Françoise Raynaud,4124,2759,Agence_moov_Cotonou,300000,298635,2022-03-14
CASH_OUT,2758,Diane-Françoise Raynaud,2759,1,Agence_moov_Cotonou,300000,297242,2022-03-15
CASH_IN,295214,Agence_moov_Cotonou,300000,4786,Diane-Françoise Raynaud,1,295215,2022-03-15
CASH_OUT,7299,Diane-Françoise Raynaud,295215,287916,Agence_moov_Ouidah,300000,292701,2022-03-16
CASH_IN,131274,Agence_moov_Cotonou,300000,168726,Diane-Françoise Raynaud,287916,419190,2022-03-16
CASH_OUT,293170,Diane-Françoise Raynaud,419190,126020,Agence_moov_Cotonou,300000,6830,2022-03-16
CASH_OUT,19391,Diane-Françoise Raynaud,126020,106629,Agence_moov_Ouidah,300000,280609,2022-03-17
CASH_IN,149144,Agence_moov_Cotonou,300000,150856,Diane-Françoise Raynaud,106629,255773,2022-03-20
TRANSFER,332769,Stéphanie Bonneau,1331373,998604,Diane-Françoise Raynaud,255773,588542,2022-03-22
CASH_IN,248908,Agence_moov_Cotonou,300000,51092,Diane-Françoise Raynaud,588542,837450,2022-03-24
TRANSFER,799599,Grégoire Delmas de Blanchard,1186726,387127,Diane-Françoise Raynaud,837450,1637049,2022-03-25
TRANSFER,330049,Matthieu Carpentier,413673,83624,Agnès Baron,543635,873684,2022-03-02
TRANSFER,488460,Caroline Bonneau,677157,188697,Agnès Baron,873684,1362144,2022-03-03
CASH_IN,99139,Agence_moov_Abomey,300000,200861,Agnès Baron,1362144,1461283,2022-03-03
CASH_IN,8531,Agence_moov_Ouidah,300000,291469,Agnès Baron,1461283,1469814,2022-03-03
CASH_IN,227752,Agence_moov_Ouidah,300000,72248,Agnès Baron,1469814,1697566,2022-03-03
CASH_IN,185829,Agence_moov_Ouidah,300000,114171,Agnès Baron,1697566,1883395,2022-03-04
TRANSFER,544440,Agnès Baron,1883395,1338955,Alphonse Dupont-Petit,236623,-307817,2022-03-05
CASH_OUT,317588,Agnès Baron,1338955,1021367,Agence_moov_Abomey,300000,-17588,2022-03-07
TRANSFER,1016825,Agnès Baron,1021367,4542,Caroline Monnier,416600,-600225,2022-03-08
TRANSFER,33400,Maryse Lebreton,91587,58187,Agnès Baron,4542,37942,2022-03-08
CASH_IN,229535,Agence_moov_Cotonou,300000,70465,Agnès Baron,37942,267477,2022-03-08
CASH_OUT,176838,Agnès Baron,267477,90639,Agence_moov_Cotonou,300000,123162,2022-03-11
TRANSFER,548557,Auguste Bousquet,630805,82248,Agnès Baron,90639,639196,2022-03-12
TRANSFER,43300,Agnès Baron,639196,595896,David-Théodore Diaz,14921,-28379,2022-03-13
TRANSFER,132070,Paul Pereira,830402,698332,Agnès Baron,595896,727966,2022-03-13
TRANSFER,100899,Caroline Bonneau,188697,87798,Agnès Baron,727966,828865,2022-03-13
TRANSFER,154928,Élodie Gérard,1447400,1292472,Agnès Baron,828865,983793,2022-03-13
CASH_OUT,775583,Agnès Baron,983793,208210,Agence_moov_Abomey,300000,-475583,2022-03-13
CASH_OUT,116300,Agnès Baron,208210,91910,Agence_moov_Cotonou,300000,183700,2022-03-15
TRANSFER,26495,Agnès Baron,91910,65415,Joséphine Weber du Bonnin,8677,-17818,2022-03-16
TRANSFER,437178,Josette Guillon-Leclercq,780700,343522,Agnès Baron,65415,502593,2022-03-18
CASH_OUT,419661,Agnès Baron,502593,82932,Agence_moov_Ouidah,300000,-119661,2022-03-20
CASH_OUT,15355,Agnès Baron,82932,67577,Agence_moov_Cotonou,300000,284645,2022-03-23
TRANSFER,464694,Agnès Chrétien-Sanchez,1326500,861806,Agnès Baron,67577,532271,2022-03-24
CASH_OUT,279379,Agnès Baron,532271,252892,Agence_moov_Ouidah,300000,20621,2022-03-26
TRANSFER,232,Océane Boutin,249,17,Agnès Baron,252892,253124,2022-03-26
CASH_IN,123337,Agence_moov_Abomey,300000,176663,Agnès Baron,253124,376461,2022-03-27
CASH_IN,175035,Agence_moov_Ouidah,300000,124965,Guy Guyon,-118198,56837,2022-03-02
CASH_IN,93209,Agence_moov_Abomey,300000,206791,Guy Guyon,56837,150046,2022-03-02
TRANSFER,1075621,Nathalie-Chantal Jacques,1168742,93121,Guy Guyon,150046,1225667,2022-03-04
CASH_OUT,46364,Guy Guyon,1225667,1179303,Agence_moov_Abomey,300000,253636,2022-03-04
CASH_OUT,169054,Guy Guyon,1179303,1010249,Agence_moov_Ouidah,300000,130946,2022-03-05
CASH_OUT,767284,Guy Guyon,1010249,242965,Agence_moov_Abomey,300000,-467284,2022-03-06
TRANSFER,100089,Gabriel de Pineau,139788,39699,Guy Guyon,242965,343054,2022-03-06
TRANSFER,17857,Nathalie-Chantal Jacques,93121,75264,Guy Guyon,343054,360911,2022-03-07
CASH_OUT,61652,Guy Guyon,360911,299259,Agence_moov_Cotonou,300000,238348,2022-03-07
TRANSFER,130982,Marianne Descamps,140005,9023,Guy Guyon,299259,430241,2022-03-07
CASH_IN,215702,Agence_moov_Abomey,300000,84298,Guy Guyon,430241,645943,2022-03-08
CASH_OUT,109519,Guy Guyon,645943,536424,Agence_moov_Abomey,300000,190481,2022-03-12
CASH_OUT,194094,Guy Guyon,536424,342330,Agence_moov_Cotonou,300000,105906,2022-03-13
CASH_IN,238081,Agence_moov_Cotonou,300000,61919,Guy Guyon,342330,580411,2022-03-14
CASH_OUT,52159,Guy Guyon,580411,528252,Agence_moov_Abomey,300000,247841,2022-03-16
CASH_IN,61241,Agence_moov_Ouidah,300000,238759,Guy Guyon,528252,589493,2022-03-17
CASH_IN,86683,Agence_moov_Ouidah,300000,213317,Guy Guyon,589493,676176,2022-03-17
CASH_IN,247777,Agence_moov_Cotonou,300000,52223,Guy Guyon,676176,923953,2022-03-19
CASH_IN,252193,Agence_moov_Cotonou,300000,47807,Guy Guyon,923953,1176146,2022-03-19
CASH_IN,258735,Agence_moov_Abomey,300000,41265,Guy Guyon,1176146,1434881,2022-03-23
CASH_IN,169220,Agence_moov_Ouidah,300000,130780,Guy Guyon,1434881,1604101,2022-03-23
CASH_IN,31297,Agence_moov_Ouidah,300000,268703,Guy Guyon,1604101,1635398,2022-03-23
CASH_OUT,94790,Guy Guyon,1635398,1540608,Agence_moov_Ouidah,300000,205210,2022-03-23
CASH_OUT,1452355,Guy Guyon,1540608,88253,Agence_moov_Cotonou,300000,-1152355,2022-03-24
CASH_IN,10350,Agence_moov_Ouidah,300000,289650,Guy Guyon,88253,98603,2022-03-25
CASH_IN,63874,Agence_moov_Ouidah,300000,236126,Guy Guyon,98603,162477,2022-03-25
TRANSFER,80559,Guy Guyon,162477,81918,Stéphane-Timothée Pineau,1198901,1118342,2022-03-25
CASH_OUT,79535,Guy Guyon,81918,2383,Agence_moov_Ouidah,300000,220465,2022-03-26
CASH_OUT,337,Guy Guyon,2383,2046,Agence_moov_Cotonou,300000,299663,2022-03-27
CASH_IN,253549,Agence_moov_Ouidah,300000,46451,Océane Boutin,17,253566,2022-03-01
CASH_IN,187897,Agence_moov_Ouidah,300000,112103,Océane Boutin,253566,441463,2022-03-06
TRANSFER,318025,Océane Boutin,441463,123438,Caroline Bonneau,87798,-230227,2022-03-06
TRANSFER,96159,Océane Boutin,123438,27279,Matthieu Carpentier,83624,-12535,2022-03-07
CASH_IN,192724,Agence_moov_Cotonou,300000,107276,Océane Boutin,27279,220003,2022-03-09
CASH_OUT,61188,Océane Boutin,220003,158815,Agence_moov_Cotonou,300000,238812,2022-03-10
CASH_IN,79068,Agence_moov_Ouidah,300000,220932,Océane Boutin,158815,237883,2022-03-10
CASH_OUT,197501,Océane Boutin,237883,40382,Agence_moov_Ouidah,300000,102499,2022-03-11
TRANSFER,64629,Auguste Bousquet,82248,17619,Océane Boutin,40382,105011,2022-03-13
TRANSFER,89365,Océane Boutin,105011,15646,Adrienne Arnaud,308627,219262,2022-03-13
TRANSFER,10503,Océane Boutin,15646,5143,Marine-Clémence Ferreira,1122659,1112156,2022-03-18
CASH_OUT,2467,Océane Boutin,5143,2676,Agence_moov_Ouidah,300000,297533,2022-03-18
CASH_OUT,1212,Océane Boutin,2676,1464,Agence_moov_Abomey,300000,298788,2022-03-19
CASH_IN,122050,Agence_moov_Cotonou,300000,177950,Océane Boutin,1464,123514,2022-03-20
CASH_OUT,75599,Océane Boutin,123514,47915,Agence_moov_Cotonou,300000,224401,2022-03-22
CASH_IN,131726,Agence_moov_Cotonou,300000,168274,Océane Boutin,47915,179641,2022-03-22
CASH_OUT,88387,Océane Boutin,179641,91254,Agence_moov_Ouidah,300000,211613,2022-03-23
CASH_IN,155446,Agence_moov_Cotonou,300000,144554,Océane Boutin,91254,246700,2022-03-24
CASH_OUT,25139,Océane Boutin,246700,221561,Agence_moov_Abomey,300000,274861,2022-03-24
CASH_OUT,118249,Océane Boutin,221561,103312,Agence_moov_Abomey,300000,181751,2022-03-24
CASH_IN,10580,Agence_moov_Ouidah,300000,289420,Océane Boutin,103312,113892,2022-03-25
CASH_OUT,46059,Océane Boutin,113892,67833,Agence_moov_Ouidah,300000,253941,2022-03-25
TRANSFER,1510579,Valentine Traore,1790983,280404,Océane Boutin,67833,1578412,2022-03-25
CASH_IN,81556,Agence_moov_Cotonou,300000,218444,Christophe Guilbert,289757,371313,2022-03-06
CASH_OUT,362310,Christophe Guilbert,371313,9003,Agence_moov_Ouidah,300000,-62310,2022-03-11
TRANSFER,135805,Josette Guillon-Leclercq,343522,207717,Christophe Guilbert,9003,144808,2022-03-14
TRANSFER,255041,Valentine Traore,280404,25363,Christophe Guilbert,144808,399849,2022-03-14
CASH_IN,274324,Agence_moov_Cotonou,300000,25676,Christophe Guilbert,399849,674173,2022-03-16
CASH_OUT,341553,Christophe Guilbert,674173,332620,Agence_moov_Abomey,300000,-41553,2022-03-17
CASH_OUT,258427,Christophe Guilbert,332620,74193,Agence_moov_Cotonou,300000,41573,2022-03-21
CASH_OUT,62019,Christophe Guilbert,74193,12174,Agence_moov_Cotonou,300000,237981,2022-03-26
CASH_IN,5917,Agence_moov_Cotonou,300000,294083,Christophe Guilbert,12174,18091,2022-03-27
CASH_IN,244995,Agence_moov_Cotonou,300000,55005,Frédéric Moreau,-24143,220852,2022-03-01
CASH_IN,63494,Agence_moov_Abomey,300000,236506,Frédéric Moreau,220852,284346,2022-03-06
CASH_OUT,30088,Frédéric Moreau,284346,254258,Agence_moov_Abomey,300000,269912,2022-03-07
CASH_IN,268887,Agence_moov_Ouidah,300000,31113,Frédéric Moreau,254258,523145,2022-03-11
CASH_OUT,213432,Frédéric Moreau,523145,309713,Agence_moov_Cotonou,300000,86568,2022-03-11
CASH_IN,283176,Agence_moov_Cotonou,300000,16824,Frédéric Moreau,309713,592889,2022-03-14
CASH_IN,161586,Agence_moov_Abomey,300000,138414,Frédéric Moreau,592889,754475,2022-03-15
CASH_IN,62892,Agence_moov_Abomey,300000,237108,Frédéric Moreau,754475,817367,2022-03-25
CASH_IN,291678,Agence_moov_Abomey,300000,8322,Élodie Gérard,1292472,1584150,2022-03-01
CASH_OUT,468669,Élodie Gérard,1584150,1115481,Agence_moov_Cotonou,300000,-168669,2022-03-01
CASH_OUT,559050,Élodie Gérard,1115481,556431,Agence_moov_Cotonou,300000,-259050,2022-03-02
CASH_OUT,1597,Élodie Gérard,556431,554834,Agence_moov_Ouidah,300000,298403,2022-03-03
CASH_IN,118376,Agence_moov_Ouidah,300000,181624,Élodie Gérard,554834,673210,2022-03-03
CASH_OUT,457435,Élodie Gérard,673210,215775,Agence_moov_Cotonou,300000,-157435,2022-03-05
CASH_OUT,43850,Élodie Gérard,215775,171925,Agence_moov_Cotonou,300000,256150,2022-03-05
CASH_IN,153118,Agence_moov_Ouidah,300000,146882,Élodie Gérard,171925,325043,2022-03-06
CASH_OUT,44913,Élodie Gérard,325043,280130,Agence_moov_Ouidah,300000,255087,2022-03-08
TRANSFER,212417,Élodie Gérard,280130,67713,Josette Guillon-Leclercq,207717,-4700,2022-03-09
CASH_IN,271026,Agence_moov_Cotonou,300000,28974,Élodie Gérard,67713,338739,2022-03-10
TRANSFER,235896,Élodie Gérard,338739,102843,Amélie de la Picard,54214,-181682,2022-03-10
CASH_IN,77065,Agence_moov_Abomey,300000,222935,Élodie Gérard,102843,179908,2022-03-12
CASH_OUT,7465,Élodie Gérard,179908,172443,Agence_moov_Abomey,300000,292535,2022-03-13
CASH_IN,174809,Agence_moov_Cotonou,300000,125191,Élodie Gérard,172443,347252,2022-03-15
CASH_IN,239415,Agence_moov_Cotonou,300000,60585,Élodie Gérard,347252,586667,2022-03-17
CASH_IN,241518,Agence_moov_Ouidah,300000,58482,Élodie Gérard,586667,828185,2022-03-20
CASH_OUT,789943,Élodie Gérard,828185,38242,Agence_moov_Cotonou,300000,-489943,2022-03-22
TRANSFER,2506,Marianne Descamps,9023,6517,Élodie Gérard,38242,40748,2022-03-25
CASH_OUT,3260,Élodie Gérard,40748,37488,Agence_moov_Ouidah,300000,296740,2022-03-27
CASH_IN,138678,Agence_moov_Abomey,300000,161322,Emmanuel-René Coulon,-19548,119130,2022-03-04
CASH_OUT,94004,Emmanuel-René Coulon,119130,25126,Agence_moov_Ouidah,300000,205996,2022-03-04
CASH_IN,295815,Agence_moov_Abomey,300000,4185,Emmanuel-René Coulon,25126,320941,2022-03-13
TRANSFER,249471,Marie Da Silva,775556,526085,Emmanuel-René Coulon,320941,570412,2022-03-13
CASH_OUT,212820,Emmanuel-René Coulon,570412,357592,Agence_moov_Cotonou,300000,87180,2022-03-18
CASH_OUT,271519,Emmanuel-René Coulon,357592,86073,Agence_moov_Abomey,300000,28481,2022-03-19
CASH_IN,197085,Agence_moov_Ouidah,300000,102915,Emmanuel-René Coulon,86073,283158,2022-03-21
CASH_IN,32502,Agence_moov_Ouidah,300000,267498,Emmanuel-René Coulon,283158,315660,2022-03-21
CASH_IN,55716,Agence_moov_Cotonou,300000,244284,Emmanuel-René Coulon,315660,371376,2022-03-27
CASH_IN,44718,Agence_moov_Ouidah,300000,255282,Caroline Monnier,-600225,-555507,2022-03-01
CASH_IN,77060,Agence_moov_Abomey,300000,222940,Caroline Monnier,-555507,-478447,2022-03-01
CASH_IN,205306,Agence_moov_Ouidah,300000,94694,Caroline Monnier,-478447,-273141,2022-03-01
CASH_IN,88949,Agence_moov_Ouidah,300000,211051,Caroline Monnier,-273141,-184192,2022-03-04
CASH_IN,188149,Agence_moov_Cotonou,300000,111851,Caroline Monnier,-184192,3957,2022-03-07
TRANSFER,3372,Caroline Monnier,3957,585,Agnès Chrétien-Sanchez,861806,858434,2022-03-09
TRANSFER,121405,Adélaïde-Sophie Leclercq,145369,23964,Caroline Monnier,585,121990,2022-03-10
TRANSFER,105506,Caroline Monnier,121990,16484,Michèle Vallée,129622,24116,2022-03-13
TRANSFER,47732,Christine-Constance Gauthier,74734,27002,Caroline Monnier,16484,64216,2022-03-13
TRANSFER,1079,Caroline Monnier,64216,63137,David Diallo,506551,505472,2022-03-13
CASH_OUT,10176,Caroline Monnier,63137,52961,Agence_moov_Abomey,300000,289824,2022-03-14
CASH_IN,147459,Agence_moov_Cotonou,300000,152541,Caroline Monnier,52961,200420,2022-03-19
CASH_OUT,552,Caroline Monnier,200420,199868,Agence_moov_Abomey,300000,299448,2022-03-19
CASH_OUT,79173,Caroline Monnier,199868,120695,Agence_moov_Ouidah,300000,220827,2022-03-20
CASH_OUT,83647,Caroline Monnier,120695,37048,Agence_moov_Abomey,300000,216353,2022-03-24
CASH_OUT,15133,Caroline Monnier,37048,21915,Agence_moov_Ouidah,300000,284867,2022-03-26
CASH_IN,258503,Agence_moov_Abomey,300000,41497,Stéphanie Bonneau,998604,1257107,2022-03-02
CASH_IN,255477,Agence_moov_Ouidah,300000,44523,Stéphanie Bonneau,1257107,1512584,2022-03-03
CASH_IN,181510,Agence_moov_Cotonou,300000,118490,Stéphanie Bonneau,1512584,1694094,2022-03-04
TRANSFER,426167,Stéphane-Timothée Pineau,1118342,692175,Stéphanie Bonneau,1694094,2120261,2022-03-06
CASH_OUT,1471706,Stéphanie Bonneau,2120261,648555,Agence_moov_Cotonou,300000,-1171706,2022-03-07
CASH_OUT,132328,Stéphanie Bonneau,648555,516227,Agence_moov_Ouidah,300000,167672,2022-03-08
TRANSFER,1093,Arnaude Gaillard,12576,11483,Stéphanie Bonneau,516227,517320,2022-03-10
CASH_IN,145986,Agence_moov_Ouidah,300000,154014,Stéphanie Bonneau,517320,663306,2022-03-10
CASH_OUT,121574,Stéphanie Bonneau,663306,541732,Agence_moov_Cotonou,300000,178426,2022-03-12
TRANSFER,1048531,Marine-Clémence Ferreira,1112156,63625,Stéphanie Bonneau,541732,1590263,2022-03-13
TRANSFER,237886,Stéphanie Bonneau,1590263,1352377,Gabriel de Pineau,39699,-198187,2022-03-14
TRANSFER,749086,Stéphanie Bonneau,1352377,603291,David Diallo,505472,-243614,2022-03-23
CASH_IN,252904,Agence_moov_Abomey,300000,47096,Stéphanie Bonneau,603291,856195,2022-03-23
CASH_OUT,309949,Stéphanie Bonneau,856195,546246,Agence_moov_Abomey,300000,-9949,2022-03-26
TRANSFER,60670,Stéphanie Bonneau,546246,485576,Adélaïde-Sophie Leclercq,23964,-36706,2022-03-27
CASH_IN,295671,Agence_moov_Ouidah,300000,4329,Stéphanie Bonneau,485576,781247,2022-03-27
CASH_IN,69158,Agence_moov_Abomey,300000,230842,Noël Hamel,-996995,-927837,2022-03-15
CASH_IN,165143,Agence_moov_Ouidah,300000,134857,Noël Hamel,-927837,-762694,2022-03-16
CASH_IN,84042,Agence_moov_Cotonou,300000,215958,Noël Hamel,-762694,-678652,2022-03-19
CASH_IN,22262,Agence_moov_Cotonou,300000,277738,Noël Hamel,-678652,-656390,2022-03-19
CASH_IN,233975,Agence_moov_Cotonou,300000,66025,Noël Hamel,-656390,-422415,2022-03-20
CASH_IN,248121,Agence_moov_Cotonou,300000,51879,Noël Hamel,-422415,-174294,2022-03-21
CASH_IN,202046,Agence_moov_Abomey,300000,97954,Noël Hamel,-174294,27752,2022-03-23
CASH_OUT,27495,Noël Hamel,27752,257,Agence_moov_Cotonou,300000,272505,2022-03-24
TRANSFER,49721,Maryse Lebreton,58187,8466,Benoît Verdier,103955,153676,2022-03-02
TRANSFER,7524,Arnaude Gaillard,11483,3959,Benoît Verdier,153676,161200,2022-03-05
CASH_IN,294370,Agence_moov_Abomey,300000,5630,Benoît Verdier,161200,455570,2022-03-07
CASH_OUT,27053,Benoît Verdier,455570,428517,Agence_moov_Ouidah,300000,272947,2022-03-07
TRANSFER,19721,Adrienne Arnaud,219262,199541,Benoît Verdier,428517,448238,2022-03-07
TRANSFER,345531,Benoît Verdier,448238,102707,Grégoire Delmas de Blanchard,387127,41596,2022-03-10
CASH_IN,158994,Agence_moov_Ouidah,300000,141006,Benoît Verdier,102707,261701,2022-03-10
CASH_OUT,231773,Benoît Verdier,261701,29928,Agence_moov_Ouidah,300000,68227,2022-03-11
CASH_IN,80571,Agence_moov_Cotonou,300000,219429,Benoît Verdier,29928,110499,2022-03-12
CASH_IN,17159,Agence_moov_Cotonou,300000,282841,Benoît Verdier,110499,127658,2022-03-14
CASH_IN,298351,Agence_moov_Abomey,300000,1649,Benoît Verdier,127658,426009,2022-03-14
TRANSFER,1307,Marianne Descamps,6517,5210,Benoît Verdier,426009,427316,2022-03-16
TRANSFER,398911,Benoît Verdier,427316,28405,Marie Da Silva,526085,127174,2022-03-17
CASH_IN,210208,Agence_moov_Cotonou,300000,89792,Benoît Verdier,28405,238613,2022-03-18
CASH_IN,109453,Agence_moov_Cotonou,300000,190547,Benoît Verdier,238613,348066,2022-03-25
TRANSFER,256429,Benoît Verdier,348066,91637,Grégoire Delmas de Blanchard,41596,-214833,2022-03-26
CASH_IN,244310,Agence_moov_Cotonou,300000,55690,Benoît Verdier,91637,335947,2022-03-27
CASH_IN,161542,Agence_moov_Abomey,300000,138458,Grégoire Delmas de Blanchard,-214833,-53291,2022-03-01
CASH_IN,9277,Agence_moov_Abomey,300000,290723,Grégoire Delmas de Blanchard,-53291,-44014,2022-03-08
CASH_IN,209856,Agence_moov_Ouidah,300000,90144,Grégoire Delmas de Blanchard,-44014,165842,2022-03-11
CASH_IN,116576,Agence_moov_Ouidah,300000,183424,Grégoire Delmas de Blanchard,165842,282418,2022-03-11
CASH_IN,65230,Agence_moov_Abomey,300000,234770,Grégoire Delmas de Blanchard,282418,347648,2022-03-12
CASH_IN,134662,Agence_moov_Cotonou,300000,165338,Grégoire Delmas de Blanchard,347648,482310,2022-03-15
CASH_OUT,475183,Grégoire Delmas de Blanchard,482310,7127,Agence_moov_Ouidah,300000,-175183,2022-03-15
CASH_OUT,842,Grégoire Delmas de Blanchard,7127,6285,Agence_moov_Ouidah,300000,299158,2022-03-15
TRANSFER,384217,Emmanuelle Gilbert,442100,57883,Grégoire Delmas de Blanchard,6285,390502,2022-03-17
CASH_IN,243930,Agence_moov_Ouidah,300000,56070,Grégoire Delmas de Blanchard,390502,634432,2022-03-20
CASH_IN,57061,Agence_moov_Abomey,300000,242939,Grégoire Delmas de Blanchard,634432,691493,2022-03-24
CASH_OUT,432617,Grégoire Delmas de Blanchard,691493,258876,Agence_moov_Abomey,300000,-132617,2022-03-25
CASH_IN,291728,Agence_moov_Abomey,300000,8272,Josette Guillon-Leclercq,-4700,287028,2022-03-03
TRANSFER,101211,Josette Guillon-Leclercq,287028,185817,Josette Guillon-Leclercq,287028,185817,2022-03-12
CASH_IN,210433,Agence_moov_Cotonou,300000,89567,Josette Guillon-Leclercq,185817,396250,2022-03-13
CASH_OUT,20582,Josette Guillon-Leclercq,396250,375668,Agence_moov_Abomey,300000,279418,2022-03-15
CASH_OUT,109809,Josette Guillon-Leclercq,375668,265859,Agence_moov_Abomey,300000,190191,2022-03-15
CASH_OUT,235295,Josette Guillon-Leclercq,265859,30564,Agence_moov_Abomey,300000,64705,2022-03-18
TRANSFER,30550,Josette Guillon-Leclercq,30564,14,Marie Da Silva,127174,96624,2022-03-20
CASH_IN,274912,Agence_moov_Abomey,300000,25088,Augustin Benard,-314073,-39161,2022-03-02
CASH_IN,51595,Agence_moov_Abomey,300000,248405,Augustin Benard,-39161,12434,2022-03-06
CASH_IN,144870,Agence_moov_Ouidah,300000,155130,Augustin Benard,12434,157304,2022-03-08
CASH_OUT,127032,Augustin Benard,157304,30272,Agence_moov_Cotonou,300000,172968,2022-03-09
TRANSFER,27583,Augustin Benard,30272,2689,Marianne Descamps,5210,-22373,2022-03-15
CASH_OUT,836,Augustin Benard,2689,1853,Agence_moov_Abomey,300000,299164,2022-03-16
TRANSFER,1615,Augustin Benard,1853,238,Augustin Benard,1853,238,2022-03-18
CASH_OUT,220,Augustin Benard,238,18,Agence_moov_Ouidah,300000,299780,2022-03-27
CASH_IN,243607,Agence_moov_Ouidah,300000,56393,Roland Colin,354065,597672,2022-03-01
CASH_IN,112475,Agence_moov_Ouidah,300000,187525,Roland Colin,597672,710147,2022-03-12
CASH_OUT,446714,Roland Colin,710147,263433,Agence_moov_Abomey,300000,-146714,2022-03-12
CASH_IN,121375,Agence_moov_Cotonou,300000,178625,Roland Colin,263433,384808,2022-03-13
TRANSFER,347580,Roland Colin,384808,37228,Stéphane-Timothée Pineau,692175,344595,2022-03-16
CASH_OUT,32952,Roland Colin,37228,4276,Agence_moov_Abomey,300000,267048,2022-03-16
CASH_IN,20601,Agence_moov_Ouidah,300000,279399,Roland Colin,4276,24877,2022-03-17
CASH_OUT,11349,Roland Colin,24877,13528,Agence_moov_Cotonou,300000,288651,2022-03-19
CASH_OUT,7933,Roland Colin,13528,5595,Agence_moov_Cotonou,300000,292067,2022-03-20
CASH_IN,40241,Agence_moov_Ouidah,300000,259759,Roland Colin,5595,45836,2022-03-21
CASH_IN,148513,Agence_moov_Ouidah,300000,151487,Roland Colin,45836,194349,2022-03-21
CASH_OUT,55637,Roland Colin,194349,138712,Agence_moov_Abomey,300000,244363,2022-03-22
TRANSFER,4190,Roland Colin,138712,134522,Valentine Traore,25363,21173,2022-03-24
TRANSFER,103696,Roland Colin,134522,30826,Emmanuelle Gilbert,57883,-45813,2022-03-25
TRANSFER,5437,Christine-Constance Gauthier,27002,21565,Roland Colin,30826,36263,2022-03-25
TRANSFER,5550,Maryse Lebreton,8466,2916,Roland Colin,36263,41813,2022-03-26
CASH_IN,54963,Agence_moov_Cotonou,300000,245037,Thierry Dos Santos-Le Roux,-781916,-726953,2022-03-01
CASH_IN,222247,Agence_moov_Ouidah,300000,77753,Thierry Dos Santos-Le Roux,-726953,-504706,2022-03-01
CASH_IN,229647,Agence_moov_Ouidah,300000,70353,Thierry Dos Santos-Le Roux,-504706,-275059,2022-03-01
CASH_IN,95341,Agence_moov_Ouidah,300000,204659,Thierry Dos Santos-Le Roux,-275059,-179718,2022-03-02
CASH_IN,24089,Agence_moov_Abomey,300000,275911,Thierry Dos Santos-Le Roux,-179718,-155629,2022-03-04
CASH_IN,262537,Agence_moov_Cotonou,300000,37463,Thierry Dos Santos-Le Roux,-155629,106908,2022-03-05
CASH_IN,38306,Agence_moov_Abomey,300000,261694,Thierry Dos Santos-Le Roux,106908,145214,2022-03-05
CASH_IN,182540,Agence_moov_Cotonou,300000,117460,Thierry Dos Santos-Le Roux,145214,327754,2022-03-06
CASH_IN,109432,Agence_moov_Cotonou,300000,190568,Thierry Dos Santos-Le Roux,327754,437186,2022-03-07
CASH_OUT,197063,Thierry Dos Santos-Le Roux,437186,240123,Agence_moov_Cotonou,300000,102937,2022-03-08
CASH_IN,262290,Agence_moov_Cotonou,300000,37710,Thierry Dos Santos-Le Roux,240123,502413,2022-03-10
CASH_OUT,326819,Thierry Dos Santos-Le Roux,502413,175594,Agence_moov_Cotonou,300000,-26819,2022-03-13
TRANSFER,497826,Laurence Dumont de Laroche,966799,468973,Thierry Dos Santos-Le Roux,175594,673420,2022-03-13
CASH_OUT,551752,Thierry Dos Santos-Le Roux,673420,121668,Agence_moov_Cotonou,300000,-251752,2022-03-13
CASH_OUT,48878,Thierry Dos Santos-Le Roux,121668,72790,Agence_moov_Cotonou,300000,251122,2022-03-17
CASH_IN,114238,Agence_moov_Ouidah,300000,185762,Thierry Dos Santos-Le Roux,72790,187028,2022-03-19
CASH_IN,30504,Agence_moov_Ouidah,300000,269496,Thierry Dos Santos-Le Roux,187028,217532,2022-03-25
CASH_OUT,183074,Thierry Dos Santos-Le Roux,217532,34458,Agence_moov_Abomey,300000,116926,2022-03-27
CASH_IN,110072,Agence_moov_Ouidah,300000,189928,Théodore Bertin,-1389491,-1279419,2022-03-04
CASH_IN,243122,Agence_moov_Ouidah,300000,56878,Théodore Bertin,-1279419,-1036297,2022-03-04
CASH_IN,162414,Agence_moov_Abomey,300000,137586,Théodore Bertin,-1036297,-873883,2022-03-04
CASH_IN,62756,Agence_moov_Cotonou,300000,237244,Théodore Bertin,-873883,-811127,2022-03-04
CASH_IN,168964,Agence_moov_Ouidah,300000,131036,Théodore Bertin,-811127,-642163,2022-03-05
CASH_IN,23008,Agence_moov_Ouidah,300000,276992,Théodore Bertin,-642163,-619155,2022-03-06
CASH_IN,264648,Agence_moov_Cotonou,300000,35352,Théodore Bertin,-619155,-354507,2022-03-06
CASH_IN,119147,Agence_moov_Cotonou,300000,180853,Théodore Bertin,-354507,-235360,2022-03-09
CASH_IN,118088,Agence_moov_Abomey,300000,181912,Théodore Bertin,-235360,-117272,2022-03-10
CASH_IN,61560,Agence_moov_Abomey,300000,238440,Théodore Bertin,-117272,-55712,2022-03-14
CASH_IN,230318,Agence_moov_Ouidah,300000,69682,Théodore Bertin,-55712,174606,2022-03-14
TRANSFER,12394,Alfred Chrétien,15393,2999,Théodore Bertin,174606,187000,2022-03-15
TRANSFER,126056,Théodore Bertin,187000,60944,Nathalie-Chantal Jacques,75264,-50792,2022-03-20
CASH_OUT,52754,Théodore Bertin,60944,8190,Agence_moov_Cotonou,300000,247246,2022-03-21
TRANSFER,16647,Christine-Constance Gauthier,21565,4918,Théodore Bertin,8190,24837,2022-03-21
CASH_OUT,10093,Théodore Bertin,24837,14744,Agence_moov_Cotonou,300000,289907,2022-03-21
CASH_IN,210392,Agence_moov_Abomey,300000,89608,Théodore Bertin,14744,225136,2022-03-25
CASH_OUT,63486,Théodore Bertin,225136,161650,Agence_moov_Cotonou,300000,236514,2022-03-27
CASH_OUT,208624,Stéphane-Timothée Pineau,344595,135971,Agence_moov_Cotonou,300000,91376,2022-03-03
CASH_IN,203333,Agence_moov_Cotonou,300000,96667,Stéphane-Timothée Pineau,135971,339304,2022-03-06
CASH_OUT,183517,Stéphane-Timothée Pineau,339304,155787,Agence_moov_Abomey,300000,116483,2022-03-07
TRANSFER,147091,Stéphane-Timothée Pineau,155787,8696,Michèle Vallée,24116,-122975,2022-03-13
TRANSFER,2769,Stéphane-Timothée Pineau,8696,5927,Maryse Reynaud-Michaud,571979,569210,2022-03-14
CASH_OUT,1774,Stéphane-Timothée Pineau,5927,4153,Agence_moov_Cotonou,300000,298226,2022-03-16
TRANSFER,2815,Maryse Lebreton,2916,101,Stéphane-Timothée Pineau,4153,6968,2022-03-26
TRANSFER,6135,Auguste Bousquet,17619,11484,Stéphane-Timothée Pineau,6968,13103,2022-03-26
CASH_OUT,100,Stéphane-Timothée Pineau,13103,13003,Agence_moov_Ouidah,300000,299900,2022-03-27
TRANSFER,5877,Valentine Traore,21173,15296,Stéphane-Timothée Pineau,13003,18880,2022-03-27
CASH_IN,59692,Agence_moov_Ouidah,300000,240308,Caroline Bonneau,-230227,-170535,2022-03-01
CASH_IN,35953,Agence_moov_Ouidah,300000,264047,Caroline Bonneau,-170535,-134582,2022-03-03
CASH_IN,71713,Agence_moov_Cotonou,300000,228287,Caroline Bonneau,-134582,-62869,2022-03-04
CASH_IN,238703,Agence_moov_Ouidah,300000,61297,Caroline Bonneau,-62869,175834,2022-03-06
CASH_OUT,14225,Caroline Bonneau,175834,161609,Agence_moov_Cotonou,300000,285775,2022-03-06
CASH_OUT,1972,Caroline Bonneau,161609,159637,Agence_moov_Abomey,300000,298028,2022-03-07
CASH_OUT,106514,Caroline Bonneau,159637,53123,Agence_moov_Abomey,300000,193486,2022-03-09
CASH_OUT,1116,Caroline Bonneau,53123,52007,Agence_moov_Ouidah,300000,298884,2022-03-12
CASH_IN,117016,Agence_moov_Abomey,300000,182984,Caroline Bonneau,52007,169023,2022-03-13
TRANSFER,555,Alfred Chrétien,2999,2444,Caroline Bonneau,169023,169578,2022-03-13
CASH_IN,130376,Agence_moov_Abomey,300000,169624,Caroline Bonneau,169578,299954,2022-03-18
TRANSFER,110572,Caroline Bonneau,299954,189382,Agnès Chrétien-Sanchez,858434,747862,2022-03-21
CASH_OUT,102004,Caroline Bonneau,189382,87378,Agence_moov_Ouidah,300000,197996,2022-03-26
CASH_IN,10241,Agence_moov_Ouidah,300000,289759,David Diallo,-243614,-233373,2022-03-01
CASH_IN,29180,Agence_moov_Cotonou,300000,270820,David Diallo,-233373,-204193,2022-03-05
CASH_IN,252906,Agence_moov_Cotonou,300000,47094,David Diallo,-204193,48713,2022-03-09
CASH_IN,177986,Agence_moov_Ouidah,300000,122014,David Diallo,48713,226699,2022-03-12
TRANSFER,84190,David Diallo,226699,142509,David Diallo,226699,142509,2022-03-18
CASH_OUT,89386,David Diallo,142509,53123,Agence_moov_Abomey,300000,210614,2022-03-19
TRANSFER,642515,Paul Pereira,698332,55817,David Diallo,53123,695638,2022-03-19
TRANSFER,454147,Agnès Chrétien-Sanchez,747862,293715,David Diallo,695638,1149785,2022-03-20
CASH_IN,286195,Agence_moov_Cotonou,300000,13805,David Diallo,1149785,1435980,2022-03-21
CASH_OUT,1296562,David Diallo,1435980,139418,Agence_moov_Abomey,300000,-996562,2022-03-21
CASH_IN,187245,Agence_moov_Cotonou,300000,112755,David Diallo,139418,326663,2022-03-22
CASH_IN,209999,Agence_moov_Abomey,300000,90001,David Diallo,326663,536662,2022-03-25
CASH_OUT,358136,David Diallo,536662,178526,Agence_moov_Ouidah,300000,-58136,2022-03-26
TRANSFER,99578,Maryse Reynaud-Michaud,569210,469632,David Diallo,178526,278104,2022-03-26
TRANSFER,125136,David Diallo,278104,152968,Auguste Bousquet,11484,-113652,2022-03-26
CASH_OUT,20145,David Diallo,152968,132823,Agence_moov_Abomey,300000,279855,2022-03-26
TRANSFER,89800,David Diallo,132823,43023,Paul Pereira,55817,-33983,2022-03-26
CASH_IN,275305,Agence_moov_Cotonou,300000,24695,Marthe Pichon,-633190,-357885,2022-03-01
CASH_IN,61230,Agence_moov_Ouidah,300000,238770,Marthe Pichon,-357885,-296655,2022-03-06
CASH_IN,246871,Agence_moov_Abomey,300000,53129,Marthe Pichon,-296655,-49784,2022-03-09
CASH_IN,235583,Agence_moov_Abomey,300000,64417,Marthe Pichon,-49784,185799,2022-03-09
TRANSFER,96760,Marthe Pichon,185799,89039,Emmanuel Bousquet,347733,250973,2022-03-11
TRANSFER,84942,Marthe Pichon,89039,4097,Christine-Constance Gauthier,4918,-80024,2022-03-12
CASH_OUT,3263,Marthe Pichon,4097,834,Agence_moov_Abomey,300000,296737,2022-03-16
CASH_OUT,553,Marthe Pichon,834,281,Agence_moov_Ouidah,300000,299447,2022-03-16
CASH_OUT,232,Marthe Pichon,281,49,Agence_moov_Cotonou,300000,299768,2022-03-21
CASH_IN,257244,Agence_moov_Cotonou,300000,42756,Marthe Pichon,49,257293,2022-03-23
CASH_IN,28588,Agence_moov_Ouidah,300000,271412,Auguste Bousquet,-113652,-85064,2022-03-05
CASH_IN,165476,Agence_moov_Abomey,300000,134524,Auguste Bousquet,-85064,80412,2022-03-05
CASH_OUT,78361,Auguste Bousquet,80412,2051,Agence_moov_Ouidah,300000,221639,2022-03-07
CASH_IN,134454,Agence_moov_Abomey,300000,165546,Auguste Bousquet,2051,136505,2022-03-07
CASH_IN,32243,Agence_moov_Ouidah,300000,267757,Auguste Bousquet,136505,168748,2022-03-10
TRANSFER,101,Maryse Lebreton,101,0,Auguste Bousquet,168748,168849,2022-03-20
CASH_OUT,110057,Auguste Bousquet,168849,58792,Agence_moov_Ouidah,300000,189943,2022-03-21
CASH_OUT,17031,Auguste Bousquet,58792,41761,Agence_moov_Cotonou,300000,282969,2022-03-24
CASH_IN,163431,Agence_moov_Ouidah,300000,136569,Adrienne Arnaud,199541,362972,2022-03-01
CASH_IN,144370,Agence_moov_Cotonou,300000,155630,Adrienne Arnaud,362972,507342,2022-03-09
CASH_OUT,131233,Adrienne Arnaud,507342,376109,Agence_moov_Abomey,300000,168767,2022-03-11
CASH_OUT,262790,Adrienne Arnaud,376109,113319,Agence_moov_Cotonou,300000,37210,2022-03-15
CASH_OUT,81768,Adrienne Arnaud,113319,31551,Agence_moov_Cotonou,300000,218232,2022-03-22
CASH_IN,188550,Agence_moov_Ouidah,300000,111450,Adrienne Arnaud,31551,220101,2022-03-24
TRANSFER,12613,Adrienne Arnaud,220101,207488,Laurence Dumont de Laroche,468973,456360,2022-03-27
CASH_IN,179185,Agence_moov_Ouidah,300000,120815,Matthieu Carpentier,-12535,166650,2022-03-01
CASH_IN,202151,Agence_moov_Ouidah,300000,97849,Matthieu Carpentier,166650,368801,2022-03-01
CASH_IN,108174,Agence_moov_Ouidah,300000,191826,Matthieu Carpentier,368801,476975,2022-03-04
CASH_OUT,459843,Matthieu Carpentier,476975,17132,Agence_moov_Ouidah,300000,-159843,2022-03-10
CASH_IN,140730,Agence_moov_Ouidah,300000,159270,Matthieu Carpentier,17132,157862,2022-03-11
CASH_IN,237116,Agence_moov_Cotonou,300000,62884,Matthieu Carpentier,157862,394978,2022-03-12
CASH_OUT,158859,Matthieu Carpentier,394978,236119,Agence_moov_Cotonou,300000,141141,2022-03-12
CASH_OUT,192,Matthieu Carpentier,236119,235927,Agence_moov_Ouidah,300000,299808,2022-03-14
CASH_IN,252775,Agence_moov_Cotonou,300000,47225,Matthieu Carpentier,235927,488702,2022-03-19
TRANSFER,31068,Marine-Clémence Ferreira,63625,32557,Matthieu Carpentier,488702,519770,2022-03-20
CASH_OUT,331150,Matthieu Carpentier,519770,188620,Agence_moov_Abomey,300000,-31150,2022-03-21
CASH_OUT,22774,Matthieu Carpentier,188620,165846,Agence_moov_Abomey,300000,277226,2022-03-25
TRANSFER,115820,Matthieu Carpentier,165846,50026,Arnaude Gaillard,3959,-111861,2022-03-26
CASH_OUT,797,Matthieu Carpentier,50026,49229,Agence_moov_Cotonou,300000,299203,2022-03-26
CASH_IN,44630,Agence_moov_Ouidah,300000,255370,Adélaïde-Sophie Leclercq,-36706,7924,2022-03-03
CASH_IN,153076,Agence_moov_Cotonou,300000,146924,Adélaïde-Sophie Leclercq,7924,161000,2022-03-03
CASH_IN,62932,Agence_moov_Ouidah,300000,237068,Adélaïde-Sophie Leclercq,161000,223932,2022-03-09
TRANSFER,118756,Adélaïde-Sophie Leclercq,223932,105176,Laurence Dumont de Laroche,456360,337604,2022-03-09
CASH_IN,201607,Agence_moov_Abomey,300000,98393,Adélaïde-Sophie Leclercq,105176,306783,2022-03-12
TRANSFER,152078,Maryse Reynaud-Michaud,469632,317554,Adélaïde-Sophie Leclercq,306783,458861,2022-03-13
CASH_IN,104597,Agence_moov_Ouidah,300000,195403,Adélaïde-Sophie Leclercq,458861,563458,2022-03-15
CASH_IN,254375,Agence_moov_Cotonou,300000,45625,Adélaïde-Sophie Leclercq,563458,817833,2022-03-16
CASH_OUT,458225,Adélaïde-Sophie Leclercq,817833,359608,Agence_moov_Cotonou,300000,-158225,2022-03-16
CASH_IN,202814,Agence_moov_Abomey,300000,97186,Adélaïde-Sophie Leclercq,359608,562422,2022-03-19
TRANSFER,190104,Adélaïde-Sophie Leclercq,562422,372318,Valentine Traore,15296,-174808,2022-03-21
TRANSFER,43840,Adélaïde-Sophie Leclercq,372318,328478,Agnès Chrétien-Sanchez,293715,249875,2022-03-21
CASH_OUT,96887,Adélaïde-Sophie Leclercq,328478,231591,Agence_moov_Abomey,300000,203113,2022-03-23
CASH_OUT,116958,Adélaïde-Sophie Leclercq,231591,114633,Agence_moov_Ouidah,300000,183042,2022-03-25
CASH_OUT,73142,Adélaïde-Sophie Leclercq,114633,41491,Agence_moov_Ouidah,300000,226858,2022-03-25
CASH_IN,152257,Agence_moov_Cotonou,300000,147743,Adélaïde-Sophie Leclercq,41491,193748,2022-03-25
CASH_OUT,71623,Adélaïde-Sophie Leclercq,193748,122125,Agence_moov_Cotonou,300000,228377,2022-03-25
CASH_IN,56195,Agence_moov_Cotonou,300000,243805,Joséphine Weber du Bonnin,-17818,38377,2022-03-01
TRANSFER,3072,Joséphine Weber du Bonnin,38377,35305,Laurence Dumont de Laroche,337604,334532,2022-03-02
TRANSFER,15960,Joséphine Weber du Bonnin,35305,19345,Emmanuel Bousquet,250973,235013,2022-03-03
CASH_IN,44998,Agence_moov_Abomey,300000,255002,Joséphine Weber du Bonnin,19345,64343,2022-03-06
CASH_IN,264973,Agence_moov_Ouidah,300000,35027,Joséphine Weber du Bonnin,64343,329316,2022-03-06
CASH_IN,180816,Agence_moov_Cotonou,300000,119184,Joséphine Weber du Bonnin,329316,510132,2022-03-07
TRANSFER,146034,Joséphine Weber du Bonnin,510132,364098,Marine-Clémence Ferreira,32557,-113477,2022-03-08
TRANSFER,326627,Joséphine Weber du Bonnin,364098,37471,Agnès Chrétien-Sanchez,249875,-76752,2022-03-08
CASH_IN,67542,Agence_moov_Abomey,300000,232458,Joséphine Weber du Bonnin,37471,105013,2022-03-09
CASH_IN,186488,Agence_moov_Cotonou,300000,113512,Joséphine Weber du Bonnin,105013,291501,2022-03-10
CASH_OUT,285941,Joséphine Weber du Bonnin,291501,5560,Agence_moov_Cotonou,300000,14059,2022-03-14
CASH_OUT,1901,Joséphine Weber du Bonnin,5560,3659,Agence_moov_Ouidah,300000,298099,2022-03-14
CASH_IN,66723,Agence_moov_Abomey,300000,233277,Joséphine Weber du Bonnin,3659,70382,2022-03-19
TRANSFER,32952,Marie Da Silva,96624,63672,Joséphine Weber du Bonnin,70382,103334,2022-03-20
CASH_OUT,52891,Joséphine Weber du Bonnin,103334,50443,Agence_moov_Cotonou,300000,247109,2022-03-20
CASH_OUT,43096,Joséphine Weber du Bonnin,50443,7347,Agence_moov_Ouidah,300000,256904,2022-03-22
CASH_OUT,512,Joséphine Weber du Bonnin,7347,6835,Agence_moov_Ouidah,300000,299488,2022-03-24
CASH_OUT,144281,Emmanuel Bousquet,235013,90732,Agence_moov_Abomey,300000,155719,2022-03-01
CASH_IN,150941,Agence_moov_Cotonou,300000,149059,Emmanuel Bousquet,90732,241673,2022-03-01
CASH_IN,252230,Agence_moov_Cotonou,300000,47770,Emmanuel Bousquet,241673,493903,2022-03-04
TRANSFER,19693,Emmanuel Bousquet,493903,474210,Alfred Chrétien,2444,-17249,2022-03-04
CASH_IN,107146,Agence_moov_Abomey,300000,192854,Emmanuel Bousquet,474210,581356,2022-03-05
TRANSFER,409377,Emmanuel Bousquet,581356,171979,Maryse Reynaud-Michaud,317554,-91823,2022-03-05
CASH_IN,242285,Agence_moov_Cotonou,300000,57715,Emmanuel Bousquet,171979,414264,2022-03-06
CASH_IN,200096,Agence_moov_Ouidah,300000,99904,Emmanuel Bousquet,414264,614360,2022-03-09
CASH_OUT,538546,Emmanuel Bousquet,614360,75814,Agence_moov_Cotonou,300000,-238546,2022-03-11
TRANSFER,30602,Emmanuel Bousquet,75814,45212,Emmanuel Bousquet,75814,45212,2022-03-11
CASH_OUT,29470,Emmanuel Bousquet,45212,15742,Agence_moov_Abomey,300000,270530,2022-03-12
CASH_OUT,8432,Emmanuel Bousquet,15742,7310,Agence_moov_Cotonou,300000,291568,2022-03-13
CASH_IN,13902,Agence_moov_Cotonou,300000,286098,Emmanuel Bousquet,7310,21212,2022-03-13
TRANSFER,8281,Emmanuel Bousquet,21212,12931,Laurence Dumont de Laroche,334532,326251,2022-03-18
CASH_IN,28656,Agence_moov_Cotonou,300000,271344,Emmanuel Bousquet,12931,41587,2022-03-21
CASH_OUT,39192,Emmanuel Bousquet,41587,2395,Agence_moov_Ouidah,300000,260808,2022-03-25
CASH_OUT,1832,Emmanuel Bousquet,2395,563,Agence_moov_Abomey,300000,298168,2022-03-26
CASH_IN,188236,Agence_moov_Ouidah,300000,111764,Arnaude Gaillard,-111861,76375,2022-03-04
TRANSFER,40767,Arnaude Gaillard,76375,35608,Marie Da Silva,63672,22905,2022-03-08
TRANSFER,10662,Marie Da Silva,22905,12243,Arnaude Gaillard,35608,46270,2022-03-08
TRANSFER,16871,Arnaude Gaillard,46270,29399,Marie Da Silva,12243,-4628,2022-03-11
CASH_OUT,25149,Arnaude Gaillard,29399,4250,Agence_moov_Cotonou,300000,274851,2022-03-11
CASH_IN,173906,Agence_moov_Cotonou,300000,126094,Arnaude Gaillard,4250,178156,2022-03-11
TRANSFER,57185,Arnaude Gaillard,178156,120971,Arnaude Gaillard,178156,120971,2022-03-12
CASH_IN,47870,Agence_moov_Cotonou,300000,252130,Arnaude Gaillard,120971,168841,2022-03-13
CASH_OUT,36446,Arnaude Gaillard,168841,132395,Agence_moov_Ouidah,300000,263554,2022-03-15
CASH_OUT,117199,Arnaude Gaillard,132395,15196,Agence_moov_Ouidah,300000,182801,2022-03-16
TRANSFER,11273,Arnaude Gaillard,15196,3923,Laurence Dumont de Laroche,326251,314978,2022-03-17
TRANSFER,1145,Arnaude Gaillard,3923,2778,Laurence Dumont de Laroche,314978,313833,2022-03-18
CASH_OUT,1601,Arnaude Gaillard,2778,1177,Agence_moov_Cotonou,300000,298399,2022-03-20
CASH_IN,71659,Agence_moov_Abomey,300000,228341,Arnaude Gaillard,1177,72836,2022-03-21
TRANSFER,91714,Laurence Dumont de Laroche,313833,222119,Arnaude Gaillard,72836,164550,2022-03-27
CASH_IN,258680,Agence_moov_Ouidah,300000,41320,Théophile Mendès,-61149,197531,2022-03-01
CASH_OUT,30550,Théophile Mendès,197531,166981,Agence_moov_Cotonou,300000,269450,2022-03-01
TRANSFER,139135,Théophile Mendès,166981,27846,Laurence Dumont de Laroche,222119,82984,2022-03-03
CASH_OUT,11054,Théophile Mendès,27846,16792,Agence_moov_Cotonou,300000,288946,2022-03-05
CASH_OUT,3991,Théophile Mendès,16792,12801,Agence_moov_Cotonou,300000,296009,2022-03-06
TRANSFER,3723,Théophile Mendès,12801,9078,Laurence Dumont de Laroche,82984,79261,2022-03-07
CASH_OUT,174,Théophile Mendès,9078,8904,Agence_moov_Abomey,300000,299826,2022-03-10
CASH_IN,66819,Agence_moov_Abomey,300000,233181,Théophile Mendès,8904,75723,2022-03-11
CASH_OUT,28553,Théophile Mendès,75723,47170,Agence_moov_Ouidah,300000,271447,2022-03-14
TRANSFER,6712,Laurence Dumont de Laroche,79261,72549,Théophile Mendès,47170,53882,2022-03-20
CASH_IN,267740,Agence_moov_Cotonou,300000,32260,Théophile Mendès,53882,321622,2022-03-21
CASH_IN,136087,Agence_moov_Abomey,300000,163913,Théophile Mendès,321622,457709,2022-03-26
CASH_IN,88098,Agence_moov_Abomey,300000,211902,Marie Da Silva,-4628,83470,2022-03-01
CASH_OUT,25844,Marie Da Silva,83470,57626,Agence_moov_Ouidah,300000,274156,2022-03-02
TRANSFER,51537,Marie Da Silva,57626,6089,Marie Da Silva,57626,6089,2022-03-04
CASH_IN,239330,Agence_moov_Ouidah,300000,60670,Marie Da Silva,6089,245419,2022-03-14
CASH_IN,112915,Agence_moov_Abomey,300000,187085,Marie Da Silva,245419,358334,2022-03-15
CASH_OUT,158952,Marie Da Silva,358334,199382,Agence_moov_Abomey,300000,141048,2022-03-15
CASH_OUT,24944,Marie Da Silva,199382,174438,Agence_moov_Ouidah,300000,275056,2022-03-20
CASH_IN,166065,Agence_moov_Abomey,300000,133935,Marie Da Silva,174438,340503,2022-03-25
CASH_OUT,266960,Marie Da Silva,340503,73543,Agence_moov_Abomey,300000,33040,2022-03-25
CASH_OUT,33943,Marie Da Silva,73543,39600,Agence_moov_Abomey,300000,266057,2022-03-25
CASH_OUT,18383,Marie Da Silva,39600,21217,Agence_moov_Ouidah,300000,281617,2022-03-26
CASH_OUT,13805,Marie Da Silva,21217,7412,Agence_moov_Ouidah,300000,286195,2022-03-27
CASH_IN,113362,Agence_moov_Ouidah,300000,186638,Matthieu Renard,-87516,25846,2022-03-04
CASH_IN,200949,Agence_moov_Abomey,300000,99051,Matthieu Renard,25846,226795,2022-03-04
CASH_OUT,108860,Matthieu Renard,226795,117935,Agence_moov_Ouidah,300000,191140,2022-03-05
CASH_OUT,31778,Matthieu Renard,117935,86157,Agence_moov_Ouidah,300000,268222,2022-03-08
CASH_IN,67215,Agence_moov_Ouidah,300000,232785,Matthieu Renard,86157,153372,2022-03-10
CASH_OUT,7295,Matthieu Renard,153372,146077,Agence_moov_Ouidah,300000,292705,2022-03-11
TRANSFER,97028,Matthieu Renard,146077,49049,Matthieu Renard,146077,49049,2022-03-12
TRANSFER,36059,Matthieu Renard,49049,12990,Matthieu Renard,49049,85108,2022-03-12
TRANSFER,7445,Matthieu Renard,12990,5545,Matthieu Renard,12990,5545,2022-03-12
TRANSFER,4317,Matthieu Renard,5545,1228,Matthieu Renard,5545,1228,2022-03-12
CASH_IN,84936,Agence_moov_Abomey,300000,215064,Matthieu Renard,1228,86164,2022-03-14
CASH_OUT,71537,Matthieu Renard,86164,14627,Agence_moov_Abomey,300000,228463,2022-03-15
CASH_IN,73265,Agence_moov_Abomey,300000,226735,Matthieu Renard,14627,87892,2022-03-22
CASH_OUT,17019,Matthieu Renard,87892,70873,Agence_moov_Cotonou,300000,282981,2022-03-24
CASH_IN,284992,Agence_moov_Ouidah,300000,15008,Matthieu Renard,70873,355865,2022-03-24
CASH_IN,81652,Agence_moov_Ouidah,300000,218348,Gabriel de Pineau,-198187,-116535,2022-03-01
CASH_IN,81528,Agence_moov_Ouidah,300000,218472,Gabriel de Pineau,-116535,-35007,2022-03-02
CASH_IN,136676,Agence_moov_Abomey,300000,163324,Gabriel de Pineau,-35007,101669,2022-03-04
CASH_IN,71755,Agence_moov_Ouidah,300000,228245,Gabriel de Pineau,101669,173424,2022-03-05
CASH_IN,154819,Agence_moov_Cotonou,300000,145181,Gabriel de Pineau,173424,328243,2022-03-07
TRANSFER,208837,Gabriel de Pineau,328243,119406,Gabriel de Pineau,328243,537080,2022-03-09
CASH_IN,146596,Agence_moov_Abomey,300000,153404,Gabriel de Pineau,119406,266002,2022-03-09
CASH_OUT,55736,Gabriel de Pineau,266002,210266,Agence_moov_Abomey,300000,244264,2022-03-09
CASH_IN,253476,Agence_moov_Ouidah,300000,46524,Gabriel de Pineau,210266,463742,2022-03-11
TRANSFER,276713,Gabriel de Pineau,463742,187029,Gabriel de Pineau,463742,740455,2022-03-12
CASH_OUT,160958,Gabriel de Pineau,187029,26071,Agence_moov_Abomey,300000,139042,2022-03-13
CASH_OUT,3163,Gabriel de Pineau,26071,22908,Agence_moov_Ouidah,300000,296837,2022-03-13
CASH_OUT,21528,Gabriel de Pineau,22908,1380,Agence_moov_Ouidah,300000,278472,2022-03-15
CASH_OUT,705,Gabriel de Pineau,1380,675,Agence_moov_Cotonou,300000,299295,2022-03-16
CASH_IN,19859,Agence_moov_Abomey,300000,280141,Gabriel de Pineau,675,20534,2022-03-22
CASH_IN,205664,Agence_moov_Cotonou,300000,94336,Marthe Guillet,-1122875,-917211,2022-03-03
CASH_IN,273004,Agence_moov_Ouidah,300000,26996,Marthe Guillet,-917211,-644207,2022-03-04
CASH_IN,285396,Agence_moov_Abomey,300000,14604,Marthe Guillet,-644207,-358811,2022-03-06
CASH_IN,8424,Agence_moov_Abomey,300000,291576,Marthe Guillet,-358811,-350387,2022-03-14
CASH_IN,125782,Agence_moov_Cotonou,300000,174218,Marthe Guillet,-350387,-224605,2022-03-14
CASH_IN,45215,Agence_moov_Ouidah,300000,254785,Marthe Guillet,-224605,-179390,2022-03-18
CASH_IN,210093,Agence_moov_Cotonou,300000,89907,Marthe Guillet,-179390,30703,2022-03-19
CASH_IN,97227,Agence_moov_Ouidah,300000,202773,Marthe Guillet,30703,127930,2022-03-21
CASH_IN,284684,Agence_moov_Ouidah,300000,15316,Marthe Guillet,127930,412614,2022-03-25
CASH_IN,288208,Agence_moov_Abomey,300000,11792,Marthe Guillet,412614,700822,2022-03-26
CASH_IN,198604,Agence_moov_Abomey,300000,101396,Marthe Guillet,700822,899426,2022-03-27
CASH_IN,73415,Agence_moov_Ouidah,300000,226585,Christine-Constance Gauthier,-80024,-6609,2022-03-08
CASH_IN,213919,Agence_moov_Cotonou,300000,86081,Christine-Constance Gauthier,-6609,207310,2022-03-09
CASH_OUT,200276,Christine-Constance Gauthier,207310,7034,Agence_moov_Abomey,300000,99724,2022-03-13
CASH_OUT,3860,Christine-Constance Gauthier,7034,3174,Agence_moov_Ouidah,300000,296140,2022-03-21
CASH_IN,249896,Agence_moov_Abomey,300000,50104,Christine-Constance Gauthier,3174,253070,2022-03-22
CASH_OUT,72900,Christine-Constance Gauthier,253070,180170,Agence_moov_Cotonou,300000,227100,2022-03-24
CASH_IN,292087,Agence_moov_Abomey,300000,7913,Julie Robin de Gros,-179360,112727,2022-03-01
CASH_IN,39841,Agence_moov_Ouidah,300000,260159,Julie Robin de Gros,112727,152568,2022-03-02
CASH_IN,64628,Agence_moov_Cotonou,300000,235372,Julie Robin de Gros,152568,217196,2022-03-03
CASH_OUT,121833,Julie Robin de Gros,217196,95363,Agence_moov_Cotonou,300000,178167,2022-03-06
TRANSFER,6367,Julie Robin de Gros,95363,88996,Julie Robin de Gros,95363,101730,2022-03-07
CASH_IN,188444,Agence_moov_Abomey,300000,111556,Julie Robin de Gros,88996,277440,2022-03-10
CASH_OUT,82944,Julie Robin de Gros,277440,194496,Agence_moov_Ouidah,300000,217056,2022-03-14
CASH_IN,87660,Agence_moov_Abomey,300000,212340,Julie Robin de Gros,194496,282156,2022-03-15
TRANSFER,42015,Julie Robin de Gros,282156,240141,Julie Robin de Gros,282156,324171,2022-03-15
TRANSFER,36199,Julie Robin de Gros,240141,203942,Julie Robin de Gros,240141,203942,2022-03-16
CASH_OUT,142889,Julie Robin de Gros,203942,61053,Agence_moov_Cotonou,300000,157111,2022-03-16
TRANSFER,53433,Julie Robin de Gros,61053,7620,Julie Robin de Gros,61053,7620,2022-03-19
CASH_IN,43094,Agence_moov_Abomey,300000,256906,Julie Robin de Gros,7620,50714,2022-03-20
CASH_IN,197303,Agence_moov_Ouidah,300000,102697,Julie Robin de Gros,50714,248017,2022-03-21
CASH_OUT,44012,Julie Robin de Gros,248017,204005,Agence_moov_Abomey,300000,255988,2022-03-21
CASH_IN,35306,Agence_moov_Abomey,300000,264694,Julie Robin de Gros,204005,239311,2022-03-25
CASH_IN,82604,Agence_moov_Cotonou,300000,217396,Julie Robin de Gros,239311,321915,2022-03-27
CASH_IN,11599,Agence_moov_Cotonou,300000,288401,Marine-Clémence Ferreira,-113477,-101878,2022-03-01
CASH_IN,101464,Agence_moov_Abomey,300000,198536,Marine-Clémence Ferreira,-101878,-414,2022-03-01
CASH_IN,66641,Agence_moov_Ouidah,300000,233359,Marine-Clémence Ferreira,-414,66227,2022-03-02
TRANSFER,63092,Marine-Clémence Ferreira,66227,3135,Marine-Clémence Ferreira,66227,129319,2022-03-02
TRANSFER,2142,Marine-Clémence Ferreira,3135,993,Marine-Clémence Ferreira,3135,993,2022-03-03
TRANSFER,523,Marine-Clémence Ferreira,993,470,Marine-Clémence Ferreira,993,470,2022-03-04
TRANSFER,300,Marine-Clémence Ferreira,470,170,Marine-Clémence Ferreira,470,770,2022-03-05
CASH_OUT,137,Marine-Clémence Ferreira,170,33,Agence_moov_Cotonou,300000,299863,2022-03-07
CASH_IN,200854,Agence_moov_Abomey,300000,99146,Marine-Clémence Ferreira,33,200887,2022-03-07
CASH_OUT,183259,Marine-Clémence Ferreira,200887,17628,Agence_moov_Cotonou,300000,116741,2022-03-08
CASH_IN,158747,Agence_moov_Cotonou,300000,141253,Marine-Clémence Ferreira,17628,176375,2022-03-18
CASH_OUT,90630,Marine-Clémence Ferreira,176375,85745,Agence_moov_Ouidah,300000,209370,2022-03-22
CASH_IN,90197,Agence_moov_Abomey,300000,209803,Marine-Clémence Ferreira,85745,175942,2022-03-24
CASH_IN,41270,Agence_moov_Cotonou,300000,258730,Marine-Clémence Ferreira,175942,217212,2022-03-25
CASH_IN,170349,Agence_moov_Abomey,300000,129651,Alfred Chrétien,-17249,153100,2022-03-01
CASH_OUT,61713,Alfred Chrétien,153100,91387,Agence_moov_Abomey,300000,238287,2022-03-07
TRANSFER,41755,Alfred Chrétien,91387,49632,Alfred Chrétien,91387,133142,2022-03-09
CASH_OUT,32528,Alfred Chrétien,49632,17104,Agence_moov_Abomey,300000,267472,2022-03-09
TRANSFER,11435,Alfred Chrétien,17104,5669,Alfred Chrétien,17104,5669,2022-03-10
CASH_IN,185655,Agence_moov_Cotonou,300000,114345,Alfred Chrétien,5669,191324,2022-03-11
CASH_OUT,94214,Alfred Chrétien,191324,97110,Agence_moov_Abomey,300000,205786,2022-03-12
CASH_IN,102325,Agence_moov_Ouidah,300000,197675,Alfred Chrétien,97110,199435,2022-03-14
CASH_IN,6415,Agence_moov_Ouidah,300000,293585,Alfred Chrétien,199435,205850,2022-03-16
CASH_IN,154986,Agence_moov_Ouidah,300000,145014,Alfred Chrétien,205850,360836,2022-03-19
CASH_OUT,172823,Alfred Chrétien,360836,188013,Agence_moov_Ouidah,300000,127177,2022-03-20
CASH_IN,159058,Agence_moov_Abomey,300000,140942,Alfred Chrétien,188013,347071,2022-03-21
CASH_IN,283845,Agence_moov_Ouidah,300000,16155,Agnès Chrétien-Sanchez,-76752,207093,2022-03-02
CASH_IN,104523,Agence_moov_Cotonou,300000,195477,Agnès Chrétien-Sanchez,207093,311616,2022-03-10
CASH_OUT,28665,Agnès Chrétien-Sanchez,311616,282951,Agence_moov_Cotonou,300000,271335,2022-03-13
CASH_IN,74235,Agence_moov_Abomey,300000,225765,Agnès Chrétien-Sanchez,282951,357186,2022-03-20
CASH_OUT,234035,Agnès Chrétien-Sanchez,357186,123151,Agence_moov_Cotonou,300000,65965,2022-03-22
CASH_IN,210507,Agence_moov_Cotonou,300000,89493,Valentine Traore,-174808,35699,2022-03-03
CASH_IN,266085,Agence_moov_Abomey,300000,33915,Valentine Traore,35699,301784,2022-03-03
CASH_OUT,60904,Valentine Traore,301784,240880,Agence_moov_Ouidah,300000,239096,2022-03-03
CASH_OUT,137861,Valentine Traore,240880,103019,Agence_moov_Ouidah,300000,162139,2022-03-04
TRANSFER,95027,Valentine Traore,103019,7992,Valentine Traore,103019,198046,2022-03-05
TRANSFER,1623,Valentine Traore,7992,6369,Valentine Traore,7992,6369,2022-03-07
CASH_OUT,1860,Valentine Traore,6369,4509,Agence_moov_Ouidah,300000,298140,2022-03-08
CASH_OUT,4226,Valentine Traore,4509,283,Agence_moov_Abomey,300000,295774,2022-03-08
CASH_OUT,117,Valentine Traore,283,166,Agence_moov_Abomey,300000,299883,2022-03-09
TRANSFER,166,Valentine Traore,166,0,Valentine Traore,166,332,2022-03-12
CASH_IN,283535,Agence_moov_Ouidah,300000,16465,Valentine Traore,0,283535,2022-03-13
CASH_OUT,105845,Valentine Traore,283535,177690,Agence_moov_Cotonou,300000,194155,2022-03-23
CASH_IN,83846,Agence_moov_Cotonou,300000,216154,Nathalie-Chantal Jacques,-50792,33054,2022-03-01
TRANSFER,20543,Nathalie-Chantal Jacques,33054,12511,Nathalie-Chantal Jacques,33054,12511,2022-03-03
TRANSFER,9233,Nathalie-Chantal Jacques,12511,3278,Nathalie-Chantal Jacques,12511,3278,2022-03-05
TRANSFER,2686,Nathalie-Chantal Jacques,3278,592,Nathalie-Chantal Jacques,3278,592,2022-03-07
CASH_IN,221276,Agence_moov_Abomey,300000,78724,Nathalie-Chantal Jacques,592,221868,2022-03-08
CASH_IN,136802,Agence_moov_Cotonou,300000,163198,Nathalie-Chantal Jacques,221868,358670,2022-03-09
CASH_IN,101507,Agence_moov_Abomey,300000,198493,Nathalie-Chantal Jacques,358670,460177,2022-03-10
CASH_OUT,359014,Nathalie-Chantal Jacques,460177,101163,Agence_moov_Ouidah,300000,-59014,2022-03-12
CASH_IN,100420,Agence_moov_Cotonou,300000,199580,Nathalie-Chantal Jacques,101163,201583,2022-03-13
CASH_OUT,133539,Nathalie-Chantal Jacques,201583,68044,Agence_moov_Cotonou,300000,166461,2022-03-14
CASH_OUT,2823,Nathalie-Chantal Jacques,68044,65221,Agence_moov_Ouidah,300000,297177,2022-03-17
CASH_IN,145443,Agence_moov_Cotonou,300000,154557,Nathalie-Chantal Jacques,65221,210664,2022-03-20
CASH_IN,34721,Agence_moov_Ouidah,300000,265279,Nathalie-Chantal Jacques,210664,245385,2022-03-24
CASH_IN,93765,Agence_moov_Abomey,300000,206235,Marianne Descamps,-22373,71392,2022-03-03
CASH_OUT,34387,Marianne Descamps,71392,37005,Agence_moov_Ouidah,300000,265613,2022-03-03
CASH_OUT,9995,Marianne Descamps,37005,27010,Agence_moov_Cotonou,300000,290005,2022-03-05
TRANSFER,18882,Marianne Descamps,27010,8128,Marianne Descamps,27010,8128,2022-03-06
CASH_OUT,2195,Marianne Descamps,8128,5933,Agence_moov_Cotonou,300000,297805,2022-03-08
CASH_OUT,4334,Marianne Descamps,5933,1599,Agence_moov_Ouidah,300000,295666,2022-03-08
CASH_IN,121729,Agence_moov_Cotonou,300000,178271,Marianne Descamps,1599,123328,2022-03-09
TRANSFER,57744,Marianne Descamps,123328,65584,Marianne Descamps,123328,181072,2022-03-10
TRANSFER,7508,Marianne Descamps,65584,58076,Marianne Descamps,65584,73092,2022-03-13
CASH_IN,101926,Agence_moov_Ouidah,300000,198074,Marianne Descamps,58076,160002,2022-03-16
CASH_IN,111896,Agence_moov_Ouidah,300000,188104,Marianne Descamps,160002,271898,2022-03-16
CASH_IN,52908,Agence_moov_Ouidah,300000,247092,Marianne Descamps,271898,324806,2022-03-18
CASH_OUT,51079,Marianne Descamps,324806,273727,Agence_moov_Ouidah,300000,248921,2022-03-18
CASH_IN,52550,Agence_moov_Ouidah,300000,247450,Marianne Descamps,273727,326277,2022-03-18
CASH_IN,186627,Agence_moov_Cotonou,300000,113373,Marianne Descamps,326277,512904,2022-03-20
CASH_IN,222000,Agence_moov_Abomey,300000,78000,Marianne Descamps,512904,734904,2022-03-23
CASH_IN,148413,Agence_moov_Cotonou,300000,151587,Marianne Descamps,734904,883317,2022-03-24
CASH_IN,192891,Agence_moov_Abomey,300000,107109,Marianne Descamps,883317,1076208,2022-03-27
CASH_IN,126973,Agence_moov_Cotonou,300000,173027,Michèle Vallée,-122975,3998,2022-03-01
TRANSFER,3167,Michèle Vallée,3998,831,Michèle Vallée,3998,831,2022-03-05
CASH_OUT,458,Michèle Vallée,831,373,Agence_moov_Cotonou,300000,299542,2022-03-06
TRANSFER,142,Michèle Vallée,373,231,Michèle Vallée,373,231,2022-03-09
CASH_OUT,161,Michèle Vallée,231,70,Agence_moov_Abomey,300000,299839,2022-03-12
CASH_IN,195809,Agence_moov_Cotonou,300000,104191,Michèle Vallée,70,195879,2022-03-13
CASH_OUT,76846,Michèle Vallée,195879,119033,Agence_moov_Ouidah,300000,223154,2022-03-19
CASH_IN,117852,Agence_moov_Cotonou,300000,182148,Michèle Vallée,119033,236885,2022-03-20
CASH_IN,139277,Agence_moov_Ouidah,300000,160723,Michèle Vallée,236885,376162,2022-03-23
CASH_IN,170295,Agence_moov_Abomey,300000,129705,Michèle Vallée,376162,546457,2022-03-27
CASH_IN,40501,Agence_moov_Abomey,300000,259499,Maryse Reynaud-Michaud,-91823,-51322,2022-03-04
CASH_IN,76341,Agence_moov_Abomey,300000,223659,Maryse Reynaud-Michaud,-51322,25019,2022-03-15
CASH_IN,4882,Agence_moov_Ouidah,300000,295118,Maryse Reynaud-Michaud,25019,29901,2022-03-20
CASH_IN,141739,Agence_moov_Abomey,300000,158261,Maryse Reynaud-Michaud,29901,171640,2022-03-20
CASH_IN,222027,Agence_moov_Abomey,300000,77973,Maryse Reynaud-Michaud,171640,393667,2022-03-20
CASH_IN,112647,Agence_moov_Cotonou,300000,187353,Alphonse Dupont-Petit,-307817,-195170,2022-03-02
CASH_IN,119624,Agence_moov_Ouidah,300000,180376,Alphonse Dupont-Petit,-195170,-75546,2022-03-09
CASH_IN,9563,Agence_moov_Ouidah,300000,290437,Alphonse Dupont-Petit,-75546,-65983,2022-03-10
CASH_IN,12528,Agence_moov_Abomey,300000,287472,Alphonse Dupont-Petit,-65983,-53455,2022-03-11
CASH_IN,167556,Agence_moov_Ouidah,300000,132444,Alphonse Dupont-Petit,-53455,114101,2022-03-15
CASH_IN,170240,Agence_moov_Ouidah,300000,129760,Alphonse Dupont-Petit,114101,284341,2022-03-16
CASH_IN,165163,Agence_moov_Abomey,300000,134837,Alphonse Dupont-Petit,284341,449504,2022-03-22
CASH_IN,24710,Agence_moov_Abomey,300000,275290,Amélie de la Picard,-181682,-156972,2022-03-01
CASH_IN,259835,Agence_moov_Cotonou,300000,40165,Amélie de la Picard,-156972,102863,2022-03-02
TRANSFER,89241,Amélie de la Picard,102863,13622,Amélie de la Picard,102863,13622,2022-03-04
TRANSFER,12255,Amélie de la Picard,13622,1367,Amélie de la Picard,13622,25877,2022-03-09
CASH_IN,36747,Agence_moov_Cotonou,300000,263253,Amélie de la Picard,1367,38114,2022-03-10
CASH_IN,192760,Agence_moov_Ouidah,300000,107240,Amélie de la Picard,38114,230874,2022-03-13
TRANSFER,43927,Amélie de la Picard,230874,186947,Amélie de la Picard,230874,274801,2022-03-13
CASH_OUT,113343,Amélie de la Picard,186947,73604,Agence_moov_Abomey,300000,186657,2022-03-22
CASH_OUT,71423,Amélie de la Picard,73604,2181,Agence_moov_Cotonou,300000,228577,2022-03-25
CASH_IN,123780,Agence_moov_Ouidah,300000,176220,Amélie de la Picard,2181,125961,2022-03-25
CASH_IN,239114,Agence_moov_Ouidah,300000,60886,Emmanuelle Gilbert,-45813,193301,2022-03-01
CASH_OUT,11369,Emmanuelle Gilbert,193301,181932,Agence_moov_Abomey,300000,288631,2022-03-01
CASH_OUT,5711,Emmanuelle Gilbert,181932,176221,Agence_moov_Abomey,300000,294289,2022-03-02
CASH_IN,124966,Agence_moov_Cotonou,300000,175034,Emmanuelle Gilbert,176221,301187,2022-03-04
CASH_OUT,203700,Emmanuelle Gilbert,301187,97487,Agence_moov_Ouidah,300000,96300,2022-03-07
TRANSFER,13267,Emmanuelle Gilbert,97487,84220,Emmanuelle Gilbert,97487,84220,2022-03-07
TRANSFER,3243,Emmanuelle Gilbert,84220,80977,Emmanuelle Gilbert,84220,87463,2022-03-10
TRANSFER,63948,Emmanuelle Gilbert,80977,17029,Emmanuelle Gilbert,80977,144925,2022-03-10
CASH_IN,99713,Agence_moov_Cotonou,300000,200287,Emmanuelle Gilbert,17029,116742,2022-03-14
TRANSFER,23328,Emmanuelle Gilbert,116742,93414,Emmanuelle Gilbert,116742,140070,2022-03-15
CASH_IN,147502,Agence_moov_Abomey,300000,152498,Emmanuelle Gilbert,93414,240916,2022-03-18
CASH_OUT,43248,Emmanuelle Gilbert,240916,197668,Agence_moov_Ouidah,300000,256752,2022-03-18
CASH_IN,132320,Agence_moov_Cotonou,300000,167680,Emmanuelle Gilbert,197668,329988,2022-03-19
CASH_OUT,267492,Emmanuelle Gilbert,329988,62496,Agence_moov_Cotonou,300000,32508,2022-03-23
CASH_IN,185577,Agence_moov_Cotonou,300000,114423,Emmanuelle Gilbert,62496,248073,2022-03-26
CASH_IN,7738,Agence_moov_Cotonou,300000,292262,Laurent Perrot,-488043,-480305,2022-03-02
CASH_IN,110071,Agence_moov_Abomey,300000,189929,Laurent Perrot,-480305,-370234,2022-03-02
CASH_IN,146522,Agence_moov_Ouidah,300000,153478,Laurent Perrot,-370234,-223712,2022-03-05
CASH_IN,99299,Agence_moov_Cotonou,300000,200701,Laurent Perrot,-223712,-124413,2022-03-05
CASH_IN,196583,Agence_moov_Abomey,300000,103417,Laurent Perrot,-124413,72170,2022-03-06
CASH_OUT,58569,Laurent Perrot,72170,13601,Agence_moov_Ouidah,300000,241431,2022-03-07
CASH_IN,242394,Agence_moov_Abomey,300000,57606,Laurent Perrot,13601,255995,2022-03-10
CASH_OUT,208774,Laurent Perrot,255995,47221,Agence_moov_Abomey,300000,91226,2022-03-10
CASH_OUT,41363,Laurent Perrot,47221,5858,Agence_moov_Ouidah,300000,258637,2022-03-11
CASH_OUT,4521,Laurent Perrot,5858,1337,Agence_moov_Abomey,300000,295479,2022-03-16
CASH_IN,58791,Agence_moov_Abomey,300000,241209,Laurent Perrot,1337,60128,2022-03-16
CASH_IN,2024,Agence_moov_Cotonou,300000,297976,Laurent Perrot,60128,62152,2022-03-17
CASH_IN,285428,Agence_moov_Ouidah,300000,14572,David-Théodore Diaz,-28379,257049,2022-03-04
TRANSFER,204951,David-Théodore Diaz,257049,52098,David-Théodore Diaz,257049,462000,2022-03-05
TRANSFER,19531,David-Théodore Diaz,52098,32567,David-Théodore Diaz,52098,32567,2022-03-05
CASH_OUT,26270,David-Théodore Diaz,32567,6297,Agence_moov_Ouidah,300000,273730,2022-03-08
CASH_OUT,3271,David-Théodore Diaz,6297,3026,Agence_moov_Cotonou,300000,296729,2022-03-09
CASH_IN,117954,Agence_moov_Cotonou,300000,182046,David-Théodore Diaz,3026,120980,2022-03-09
CASH_OUT,58860,David-Théodore Diaz,120980,62120,Agence_moov_Ouidah,300000,241140,2022-03-10
CASH_OUT,59351,David-Théodore Diaz,62120,2769,Agence_moov_Cotonou,300000,240649,2022-03-13
CASH_OUT,1016,David-Théodore Diaz,2769,1753,Agence_moov_Ouidah,300000,298984,2022-03-16
CASH_IN,70935,Agence_moov_Abomey,300000,229065,David-Théodore Diaz,1753,72688,2022-03-16
TRANSFER,18024,David-Théodore Diaz,72688,54664,David-Théodore Diaz,72688,54664,2022-03-16
CASH_OUT,10277,David-Théodore Diaz,54664,44387,Agence_moov_Abomey,300000,289723,2022-03-17
CASH_OUT,9002,David-Théodore Diaz,44387,35385,Agence_moov_Ouidah,300000,290998,2022-03-19
CASH_IN,45846,Agence_moov_Ouidah,300000,254154,David-Théodore Diaz,35385,81231,2022-03-23
CASH_OUT,53689,David-Théodore Diaz,81231,27542,Agence_moov_Abomey,300000,246311,2022-03-27
CASH_IN,234116,Agence_moov_Cotonou,300000,65884,Paul Pereira,-33983,200133,2022-03-02
CASH_IN,57962,Agence_moov_Abomey,300000,242038,Paul Pereira,200133,258095,2022-03-07
CASH_IN,282997,Agence_moov_Cotonou,300000,17003,Paul Pereira,258095,541092,2022-03-14
CASH_OUT,338709,Paul Pereira,541092,202383,Agence_moov_Cotonou,300000,-38709,2022-03-15
CASH_IN,216225,Agence_moov_Cotonou,300000,83775,Paul Pereira,202383,418608,2022-03-20
CASH_IN,89184,Agence_moov_Abomey,300000,210816,Marc Gilbert,-45098,44086,2022-03-01
TRANSFER,10486,Marc Gilbert,44086,33600,Marc Gilbert,44086,54572,2022-03-04
CASH_IN,277934,Agence_moov_Abomey,300000,22066,Marc Gilbert,33600,311534,2022-03-04
CASH_IN,209675,Agence_moov_Abomey,300000,90325,Marc Gilbert,311534,521209,2022-03-05
TRANSFER,393037,Marc Gilbert,521209,128172,Marc Gilbert,521209,914246,2022-03-07
TRANSFER,110488,Marc Gilbert,128172,17684,Marc Gilbert,128172,17684,2022-03-07
CASH_OUT,14911,Marc Gilbert,17684,2773,Agence_moov_Abomey,300000,285089,2022-03-09
CASH_OUT,1413,Marc Gilbert,2773,1360,Agence_moov_Abomey,300000,298587,2022-03-10
CASH_OUT,137,Marc Gilbert,1360,1223,Agence_moov_Cotonou,300000,299863,2022-03-10
CASH_OUT,983,Marc Gilbert,1223,240,Agence_moov_Ouidah,300000,299017,2022-03-11
CASH_OUT,154,Marc Gilbert,240,86,Agence_moov_Ouidah,300000,299846,2022-03-22
CASH_IN,159808,Agence_moov_Cotonou,300000,140192,Joseph de la Dubois,-21033,138775,2022-03-02
CASH_IN,98604,Agence_moov_Ouidah,300000,201396,Joseph de la Dubois,138775,237379,2022-03-03
CASH_OUT,176108,Joseph de la Dubois,237379,61271,Agence_moov_Abomey,300000,123892,2022-03-07
CASH_OUT,29084,Joseph de la Dubois,61271,32187,Agence_moov_Abomey,300000,270916,2022-03-08
CASH_OUT,6722,Joseph de la Dubois,32187,25465,Agence_moov_Abomey,300000,293278,2022-03-08
CASH_OUT,15075,Joseph de la Dubois,25465,10390,Agence_moov_Cotonou,300000,284925,2022-03-14
CASH_IN,279577,Agence_moov_Abomey,300000,20423,Joseph de la Dubois,10390,289967,2022-03-17
CASH_IN,227164,Agence_moov_Ouidah,300000,72836,Maurice Seguin,1244600,1471764,2022-04-07
CASH_OUT,842979,Maurice Seguin,1471764,628785,Agence_moov_Abomey,300000,-542979,2022-04-22
CASH_OUT,1014620,Augustin Benard,1875200,860580,Agence_moov_Abomey,300000,-714620,2022-04-14
TRANSFER,341333,Augustin Benard,860580,519247,Antoine Leroux,248300,-93033,2022-04-17
CASH_IN,131047,Agence_moov_Abomey,300000,168953,Augustin Benard,519247,650294,2022-04-20
CASH_OUT,7412,Caroline Peltier,1637300,1629888,Agence_moov_Ouidah,300000,292588,2022-04-02
CASH_IN,178500,Agence_moov_Abomey,300000,121500,Caroline Peltier,1629888,1808388,2022-04-05
CASH_OUT,1330069,Caroline Peltier,1808388,478319,Agence_moov_Abomey,300000,-1030069,2022-04-15
CASH_OUT,15019,Caroline Peltier,478319,463300,Agence_moov_Abomey,300000,284981,2022-04-19
CASH_IN,294387,Agence_moov_Ouidah,300000,5613,Caroline Peltier,463300,757687,2022-04-26
TRANSFER,1081277,Laurence Carlier,1218600,137323,Guy Guyon,1253500,2334777,2022-04-14
CASH_OUT,2250743,Guy Guyon,2334777,84034,Agence_moov_Ouidah,300000,-1950743,2022-04-18
CASH_OUT,20777,Guy Guyon,84034,63257,Agence_moov_Cotonou,300000,279223,2022-04-20
TRANSFER,43216,Michèle Vallée,344600,301384,Nicole Lacroix,1156300,1113084,2022-04-01
TRANSFER,275630,Michèle Vallée,301384,25754,Élodie Gérard,176300,-99330,2022-04-02
CASH_OUT,5946,Michèle Vallée,25754,19808,Agence_moov_Abomey,300000,294054,2022-04-03
CASH_OUT,71059,Laurence Dumont de Laroche,462700,391641,Agence_moov_Cotonou,300000,228941,2022-04-10
TRANSFER,67870,Anastasie Louis,904800,836930,Laurence Dumont de Laroche,391641,459511,2022-04-16
CASH_OUT,96518,Laurence Dumont de Laroche,459511,362993,Agence_moov_Ouidah,300000,203482,2022-04-21
TRANSFER,9019,Laurence Dumont de Laroche,362993,353974,Paul Pereira,1745000,1735981,2022-04-25
TRANSFER,934996,Emmanuel-René Coulon,1380200,445204,Gilbert Bazin Le Guillet,1780600,2715596,2022-04-09
CASH_IN,143044,Agence_moov_Ouidah,300000,156956,Marc Gilbert,324700,467744,2022-04-04
CASH_IN,146261,Agence_moov_Abomey,300000,153739,Marc Gilbert,467744,614005,2022-04-15
CASH_IN,166629,Agence_moov_Ouidah,300000,133371,Marc Gilbert,614005,780634,2022-04-16
TRANSFER,982274,Christophe Alexandre,1659500,677226,Marc Gilbert,780634,1762908,2022-04-24
TRANSFER,8425,Xavier-Stéphane Ollivier,14700,6275,Marc Gilbert,1762908,1771333,2022-04-25
TRANSFER,1016132,Théodore-Alfred Fournier,1084300,68168,Susan de Fontaine,605200,1621332,2022-04-05
CASH_IN,36853,Agence_moov_Ouidah,300000,263147,Susan de Fontaine,1621332,1658185,2022-04-12
CASH_OUT,940234,Susan de Fontaine,1658185,717951,Agence_moov_Cotonou,300000,-640234,2022-04-17
TRANSFER,393943,Susan de Fontaine,717951,324008,Noémi de la Didier,1176300,782357,2022-04-23
TRANSFER,763126,David Diallo,839900,76774,Paul Pereira,1735981,2499107,2022-04-09
CASH_OUT,96531,Paul Pereira,2499107,2402576,Agence_moov_Abomey,300000,203469,2022-04-12
CASH_IN,150948,Agence_moov_Cotonou,300000,149052,Paul Pereira,2402576,2553524,2022-04-14
CASH_OUT,702820,Juliette Evrard Le Giraud,1048400,345580,Agence_moov_Ouidah,300000,-402820,2022-04-08
TRANSFER,613610,Stéphane-Timothée Pineau,908100,294490,Juliette Evrard Le Giraud,345580,959190,2022-04-20
TRANSFER,250242,Juliette Evrard Le Giraud,959190,708948,Caroline Bonneau,642200,391958,2022-04-23
CASH_OUT,51466,Lucy Vaillant,270200,218734,Agence_moov_Cotonou,300000,248534,2022-04-09
TRANSFER,210869,Stéphane-Timothée Pineau,294490,83621,Lucy Vaillant,218734,429603,2022-04-11
TRANSFER,75270,Lucy Vaillant,429603,354333,Laurent Perrot,1037300,962030,2022-04-21
TRANSFER,148036,Lucy Vaillant,354333,206297,Diane-Françoise Raynaud,1406800,1258764,2022-04-22
CASH_IN,116598,Agence_moov_Ouidah,300000,183402,Lucy Vaillant,206297,322895,2022-04-26
TRANSFER,145511,Emmanuel-René Coulon,445204,299693,Gabriel de Pineau,554600,700111,2022-04-07
CASH_OUT,159084,Christophe Guilbert,1288500,1129416,Agence_moov_Cotonou,300000,140916,2022-04-16
CASH_OUT,160781,Christophe Guilbert,1129416,968635,Agence_moov_Ouidah,300000,139219,2022-04-20
CASH_IN,209349,Agence_moov_Abomey,300000,90651,Christophe Guilbert,968635,1177984,2022-04-22
TRANSFER,39377,Christophe Guilbert,1177984,1138607,Vincent-Grégoire Brunet,1429800,1390423,2022-04-22
TRANSFER,892550,Vincent-Grégoire Brunet,1390423,497873,Marie Da Silva,915300,1807850,2022-04-09
TRANSFER,360989,Anastasie Louis,836930,475941,Nicolas Grondin de la Pinto,1659100,1298111,2022-04-11
TRANSFER,3120,Anastasie Louis,475941,472821,Isaac Le Pinto,1989300,1986180,2022-04-17
CASH_OUT,185695,Anastasie Louis,472821,287126,Agence_moov_Cotonou,300000,114305,2022-04-22
CASH_OUT,87950,Alphonse Dupont-Petit,1655100,1567150,Agence_moov_Abomey,300000,212050,2022-04-01
CASH_IN,187695,Agence_moov_Ouidah,300000,112305,Alphonse Dupont-Petit,1567150,1754845,2022-04-08
CASH_OUT,1613741,Alphonse Dupont-Petit,1754845,141104,Agence_moov_Abomey,300000,-1313741,2022-04-26
TRANSFER,36819,Alphonse Dupont-Petit,141104,104285,Julie Robin de Gros,1444000,1407181,2022-04-27
CASH_IN,192414,Agence_moov_Cotonou,300000,107586,Hugues Gay,82200,274614,2022-04-12
TRANSFER,703499,Noémi de la Didier,782357,78858,Paulette Dias,1726500,2429999,2022-04-02
CASH_OUT,819718,Frédérique Robin,957200,137482,Agence_moov_Abomey,300000,-519718,2022-04-08
CASH_IN,39873,Agence_moov_Cotonou,300000,260127,Frédérique Robin,137482,177355,2022-04-19
CASH_IN,138520,Agence_moov_Abomey,300000,161480,Paul De Sousa,928200,1066720,2022-04-01
CASH_IN,118522,Agence_moov_Abomey,300000,181478,Paul De Sousa,1066720,1185242,2022-04-03
CASH_IN,174223,Agence_moov_Cotonou,300000,125777,Paul De Sousa,1185242,1359465,2022-04-21
CASH_OUT,774549,Amélie Gros-Riou,1199100,424551,Agence_moov_Ouidah,300000,-474549,2022-04-10
CASH_IN,153673,Agence_moov_Cotonou,300000,146327,Amélie Gros-Riou,424551,578224,2022-04-14
CASH_OUT,111938,Amélie Gros-Riou,578224,466286,Agence_moov_Abomey,300000,188062,2022-04-19
TRANSFER,77454,Amélie Gros-Riou,466286,388832,Valentine Traore,1681500,1604046,2022-04-22
CASH_OUT,363352,Sébastien Jourdan,487400,124048,Agence_moov_Abomey,300000,-63352,2022-04-17
CASH_IN,229282,Agence_moov_Cotonou,300000,70718,Nathalie-Chantal Jacques,1732000,1961282,2022-04-03
CASH_IN,61345,Agence_moov_Cotonou,300000,238655,Nathalie-Chantal Jacques,1961282,2022627,2022-04-23
CASH_IN,261242,Agence_moov_Abomey,300000,38758,Antoine Leroux,-93033,168209,2022-04-06
CASH_IN,234029,Agence_moov_Ouidah,300000,65971,Antoine Leroux,168209,402238,2022-04-17
CASH_OUT,264733,Antoine Leroux,402238,137505,Agence_moov_Abomey,300000,35267,2022-04-27
TRANSFER,82234,Alex Salmon,797600,715366,Margot Renaud de Lacombe,121400,39166,2022-04-03
CASH_OUT,51585,Alex Salmon,715366,663781,Agence_moov_Cotonou,300000,248415,2022-04-16
TRANSFER,334574,Richard Guibert,1701000,1366426,Agnès Baron,922800,588226,2022-04-10
TRANSFER,31596,Laurence Carlier,137323,105727,Nicolas Hervé,1267100,1298696,2022-04-01
CASH_OUT,613460,Nicolas Hervé,1298696,685236,Agence_moov_Ouidah,300000,-313460,2022-04-02
CASH_IN,136242,Agence_moov_Cotonou,300000,163758,Nicolas Hervé,685236,821478,2022-04-03
CASH_IN,121678,Agence_moov_Cotonou,300000,178322,Nicolas Hervé,821478,943156,2022-04-05
CASH_IN,107960,Agence_moov_Ouidah,300000,192040,Nicolas Hervé,943156,1051116,2022-04-07
TRANSFER,652503,Nicolas Hervé,1051116,398613,Thierry Dos Santos-Le Roux,308500,-344003,2022-04-08
CASH_OUT,243712,Nicolas Hervé,398613,154901,Agence_moov_Abomey,300000,56288,2022-04-08
CASH_OUT,101329,Nicolas Hervé,154901,53572,Agence_moov_Ouidah,300000,198671,2022-04-11
CASH_IN,123624,Agence_moov_Abomey,300000,176376,Nicolas Hervé,53572,177196,2022-04-11
CASH_IN,256663,Agence_moov_Abomey,300000,43337,Nicolas Hervé,177196,433859,2022-04-11
CASH_IN,184764,Agence_moov_Abomey,300000,115236,Nicolas Hervé,433859,618623,2022-04-12
TRANSFER,103487,Nicolas Hervé,618623,515136,Marianne Descamps,698800,595313,2022-04-14
CASH_IN,147748,Agence_moov_Abomey,300000,152252,Nicolas Hervé,515136,662884,2022-04-15
CASH_OUT,178619,Nicolas Hervé,662884,484265,Agence_moov_Cotonou,300000,121381,2022-04-15
TRANSFER,394161,Nicolas Hervé,484265,90104,Caroline Bonneau,391958,-2203,2022-04-16
CASH_IN,41362,Agence_moov_Abomey,300000,258638,Nicolas Hervé,90104,131466,2022-04-16
CASH_OUT,101734,Nicolas Hervé,131466,29732,Agence_moov_Ouidah,300000,198266,2022-04-17
CASH_OUT,26006,Nicolas Hervé,29732,3726,Agence_moov_Cotonou,300000,273994,2022-04-17
CASH_IN,247441,Agence_moov_Abomey,300000,52559,Nicolas Hervé,3726,251167,2022-04-17
TRANSFER,113066,Nicolas Hervé,251167,138101,Sabine Imbert,655000,541934,2022-04-22
CASH_OUT,56270,Nicolas Hervé,138101,81831,Agence_moov_Ouidah,300000,243730,2022-04-22
TRANSFER,425258,Jacques-Antoine Gros,854500,429242,Nicolas Hervé,81831,507089,2022-04-22
TRANSFER,12955,Antoine Bourdon de Auger,114300,101345,Nicolas Hervé,507089,520044,2022-04-23
TRANSFER,169357,Émilie Guillon de Duhamel,639000,469643,Nicolas Hervé,520044,689401,2022-04-27
TRANSFER,196259,Jacques-Antoine Gros,429242,232983,Constance Regnier,406500,602759,2022-04-01
CASH_IN,114081,Agence_moov_Cotonou,300000,185919,Constance Regnier,602759,716840,2022-04-01
CASH_IN,283998,Agence_moov_Cotonou,300000,16002,Constance Regnier,716840,1000838,2022-04-02
TRANSFER,929187,Constance Regnier,1000838,71651,Stéphanie Bonneau,1074300,145113,2022-04-02
CASH_OUT,47708,Constance Regnier,71651,23943,Agence_moov_Ouidah,300000,252292,2022-04-02
CASH_IN,74862,Agence_moov_Abomey,300000,225138,Constance Regnier,23943,98805,2022-04-04
CASH_IN,98578,Agence_moov_Abomey,300000,201422,Constance Regnier,98805,197383,2022-04-04
CASH_OUT,67064,Constance Regnier,197383,130319,Agence_moov_Cotonou,300000,232936,2022-04-05
CASH_IN,64334,Agence_moov_Ouidah,300000,235666,Constance Regnier,130319,194653,2022-04-05
CASH_IN,93661,Agence_moov_Abomey,300000,206339,Constance Regnier,194653,288314,2022-04-06
CASH_OUT,202038,Constance Regnier,288314,86276,Agence_moov_Ouidah,300000,97962,2022-04-07
CASH_IN,205307,Agence_moov_Cotonou,300000,94693,Constance Regnier,86276,291583,2022-04-08
CASH_OUT,265826,Constance Regnier,291583,25757,Agence_moov_Cotonou,300000,34174,2022-04-08
TRANSFER,18844,Laurence Carlier,105727,86883,Constance Regnier,25757,44601,2022-04-09
TRANSFER,19682,Sébastien-Arthur Masse,75800,56118,Constance Regnier,44601,64283,2022-04-10
CASH_IN,298380,Agence_moov_Ouidah,300000,1620,Constance Regnier,64283,362663,2022-04-11
CASH_OUT,134088,Constance Regnier,362663,228575,Agence_moov_Cotonou,300000,165912,2022-04-13
CASH_IN,234253,Agence_moov_Cotonou,300000,65747,Constance Regnier,228575,462828,2022-04-14
TRANSFER,160146,Maurice Alves,916900,756754,Constance Regnier,462828,622974,2022-04-15
CASH_OUT,142079,Constance Regnier,622974,480895,Agence_moov_Ouidah,300000,157921,2022-04-17
CASH_IN,216989,Agence_moov_Abomey,300000,83011,Constance Regnier,480895,697884,2022-04-17
TRANSFER,410282,Claudine Vallet,794100,383818,Constance Regnier,697884,1108166,2022-04-18
TRANSFER,105577,Aimé Allain,203200,97623,Constance Regnier,1108166,1213743,2022-04-20
TRANSFER,5704,Constance Regnier,1213743,1208039,David-Théodore Diaz,348300,342596,2022-04-21
TRANSFER,590235,Constance Regnier,1208039,617804,Julie Robin de Gros,1407181,816946,2022-04-21
TRANSFER,184950,Constance Regnier,617804,432854,Vincent-Grégoire Brunet,497873,312923,2022-04-21
CASH_IN,141028,Agence_moov_Cotonou,300000,158972,Constance Regnier,432854,573882,2022-04-22
TRANSFER,16359,Constance Regnier,573882,557523,Benoît Verdier,497700,481341,2022-04-23
CASH_IN,244300,Agence_moov_Cotonou,300000,55700,Constance Regnier,557523,801823,2022-04-23
CASH_IN,132068,Agence_moov_Ouidah,300000,167932,Constance Regnier,801823,933891,2022-04-24
CASH_IN,228551,Agence_moov_Ouidah,300000,71449,David Diallo,76774,305325,2022-04-02
CASH_IN,65686,Agence_moov_Cotonou,300000,234314,David Diallo,305325,371011,2022-04-02
CASH_IN,292845,Agence_moov_Cotonou,300000,7155,David Diallo,371011,663856,2022-04-03
CASH_IN,55615,Agence_moov_Cotonou,300000,244385,David Diallo,663856,719471,2022-04-08
CASH_OUT,23144,David Diallo,719471,696327,Agence_moov_Abomey,300000,276856,2022-04-08
CASH_IN,200090,Agence_moov_Cotonou,300000,99910,David Diallo,696327,896417,2022-04-11
TRANSFER,911374,Luc Camus,1622300,710926,David Diallo,896417,1807791,2022-04-13
CASH_IN,141865,Agence_moov_Abomey,300000,158135,David Diallo,1807791,1949656,2022-04-13
TRANSFER,106980,David Diallo,1949656,1842676,Jacques-Antoine Gros,232983,126003,2022-04-18
CASH_OUT,1148872,David Diallo,1842676,693804,Agence_moov_Abomey,300000,-848872,2022-04-18
CASH_OUT,469956,David Diallo,693804,223848,Agence_moov_Ouidah,300000,-169956,2022-04-19
CASH_IN,190261,Agence_moov_Ouidah,300000,109739,David Diallo,223848,414109,2022-04-19
CASH_OUT,357153,David Diallo,414109,56956,Agence_moov_Cotonou,300000,-57153,2022-04-19
CASH_IN,39102,Agence_moov_Ouidah,300000,260898,David Diallo,56956,96058,2022-04-21
TRANSFER,78264,David Diallo,96058,17794,Emmanuelle Gilbert,865900,787636,2022-04-21
CASH_IN,201531,Agence_moov_Ouidah,300000,98469,David Diallo,17794,219325,2022-04-21
CASH_IN,197632,Agence_moov_Ouidah,300000,102368,David Diallo,219325,416957,2022-04-22
CASH_OUT,68748,David Diallo,416957,348209,Agence_moov_Cotonou,300000,231252,2022-04-25
CASH_IN,156515,Agence_moov_Cotonou,300000,143485,David Diallo,348209,504724,2022-04-25
CASH_OUT,493420,David Diallo,504724,11304,Agence_moov_Ouidah,300000,-193420,2022-04-25
CASH_IN,138958,Agence_moov_Abomey,300000,161042,David Diallo,11304,150262,2022-04-26
CASH_OUT,107112,David Diallo,150262,43150,Agence_moov_Abomey,300000,192888,2022-04-26
CASH_IN,213018,Agence_moov_Abomey,300000,86982,Josette Guillon-Leclercq,1203700,1416718,2022-04-01
CASH_IN,149738,Agence_moov_Abomey,300000,150262,Josette Guillon-Leclercq,1416718,1566456,2022-04-02
TRANSFER,1553808,Alexandre Poirier,1889600,335792,Josette Guillon-Leclercq,1566456,3120264,2022-04-02
CASH_IN,149904,Agence_moov_Abomey,300000,150096,Josette Guillon-Leclercq,3120264,3270168,2022-04-02
CASH_IN,267099,Agence_moov_Abomey,300000,32901,Josette Guillon-Leclercq,3270168,3537267,2022-04-04
TRANSFER,726445,Josette Guillon-Leclercq,3537267,2810822,Maurice Alves,756754,30309,2022-04-05
CASH_IN,138657,Agence_moov_Ouidah,300000,161343,Josette Guillon-Leclercq,2810822,2949479,2022-04-06
CASH_IN,91299,Agence_moov_Ouidah,300000,208701,Josette Guillon-Leclercq,2949479,3040778,2022-04-06
TRANSFER,87083,Auguste Bousquet,517600,430517,Josette Guillon-Leclercq,3040778,3127861,2022-04-08
CASH_OUT,2432280,Josette Guillon-Leclercq,3127861,695581,Agence_moov_Ouidah,300000,-2132280,2022-04-08
CASH_OUT,12487,Josette Guillon-Leclercq,695581,683094,Agence_moov_Cotonou,300000,287513,2022-04-09
TRANSFER,127520,Josette Guillon-Leclercq,683094,555574,Julie Robin de Gros,816946,689426,2022-04-11
TRANSFER,1458070,Caroline Monnier,1882400,424330,Josette Guillon-Leclercq,555574,2013644,2022-04-12
TRANSFER,1552200,Josette Guillon-Leclercq,2013644,461444,Noémi de la Didier,78858,-1473342,2022-04-16
TRANSFER,381304,Josette Guillon-Leclercq,461444,80140,Valentine Traore,1604046,1222742,2022-04-16
TRANSFER,49916,Laurence Carlier,86883,36967,Josette Guillon-Leclercq,80140,130056,2022-04-17
CASH_IN,224608,Agence_moov_Cotonou,300000,75392,Josette Guillon-Leclercq,130056,354664,2022-04-17
TRANSFER,696178,Bernadette Fabre,1710900,1014722,Josette Guillon-Leclercq,354664,1050842,2022-04-22
CASH_OUT,622925,Josette Guillon-Leclercq,1050842,427917,Agence_moov_Ouidah,300000,-322925,2022-04-22
TRANSFER,22736,Josette Guillon-Leclercq,427917,405181,Agnès Baron,588226,565490,2022-04-22
TRANSFER,215100,Josette Guillon-Leclercq,405181,190081,Joséphine Weber du Bonnin,1153600,938500,2022-04-23
CASH_OUT,140553,Josette Guillon-Leclercq,190081,49528,Agence_moov_Ouidah,300000,159447,2022-04-23
CASH_OUT,28405,Josette Guillon-Leclercq,49528,21123,Agence_moov_Abomey,300000,271595,2022-04-25
CASH_OUT,2969,Josette Guillon-Leclercq,21123,18154,Agence_moov_Abomey,300000,297031,2022-04-25
CASH_IN,169256,Agence_moov_Ouidah,300000,130744,Josette Guillon-Leclercq,18154,187410,2022-04-27
CASH_OUT,662,Josette Guillon-Leclercq,187410,186748,Agence_moov_Cotonou,300000,299338,2022-04-27
CASH_OUT,28196,Maurice Alves,30309,2113,Agence_moov_Cotonou,300000,271804,2022-04-01
CASH_OUT,2004,Maurice Alves,2113,109,Agence_moov_Ouidah,300000,297996,2022-04-02
TRANSFER,398076,Caroline Monnier,424330,26254,Maurice Alves,109,398185,2022-04-04
CASH_OUT,163954,Maurice Alves,398185,234231,Agence_moov_Cotonou,300000,136046,2022-04-04
TRANSFER,26234,Frédéric Moreau,186900,160666,Maurice Alves,234231,260465,2022-04-05
CASH_OUT,240205,Maurice Alves,260465,20260,Agence_moov_Abomey,300000,59795,2022-04-06
TRANSFER,8167,Maurice Alves,20260,12093,Nath Léger,515500,507333,2022-04-07
CASH_OUT,7564,Maurice Alves,12093,4529,Agence_moov_Abomey,300000,292436,2022-04-10
CASH_OUT,3748,Maurice Alves,4529,781,Agence_moov_Cotonou,300000,296252,2022-04-11
TRANSFER,401,Maurice Alves,781,380,Emmanuel Bousquet,848400,847999,2022-04-11
CASH_IN,114694,Agence_moov_Abomey,300000,185306,Maurice Alves,380,115074,2022-04-12
CASH_OUT,108410,Maurice Alves,115074,6664,Agence_moov_Cotonou,300000,191590,2022-04-13
TRANSFER,767870,Agnès Chrétien-Sanchez,1593200,825330,Maurice Alves,6664,774534,2022-04-14
TRANSFER,166709,Maurice Alves,774534,607825,Océane Boutin,1537300,1370591,2022-04-14
CASH_IN,191383,Agence_moov_Abomey,300000,108617,Maurice Alves,607825,799208,2022-04-18
TRANSFER,19420,Caroline Monnier,26254,6834,Maurice Alves,799208,818628,2022-04-19
CASH_OUT,454230,Maurice Alves,818628,364398,Agence_moov_Abomey,300000,-154230,2022-04-20
TRANSFER,13099,Maurice Alves,364398,351299,Agnès Chrétien-Sanchez,825330,812231,2022-04-20
TRANSFER,6456,Valentine Traore,1222742,1216286,Maurice Alves,351299,357755,2022-04-21
CASH_OUT,85141,Maurice Alves,357755,272614,Agence_moov_Cotonou,300000,214859,2022-04-21
CASH_OUT,54830,Maurice Alves,272614,217784,Agence_moov_Abomey,300000,245170,2022-04-22
CASH_IN,240696,Agence_moov_Cotonou,300000,59304,Maurice Alves,217784,458480,2022-04-22
TRANSFER,383488,Maurice Alves,458480,74992,David-Théodore Diaz,342596,-40892,2022-04-24
CASH_IN,192193,Agence_moov_Abomey,300000,107807,Maurice Alves,74992,267185,2022-04-26
CASH_IN,287820,Agence_moov_Abomey,300000,12180,Caroline Bonneau,-2203,285617,2022-04-01
CASH_OUT,4417,Caroline Bonneau,285617,281200,Agence_moov_Cotonou,300000,295583,2022-04-03
TRANSFER,108965,Vincent-Grégoire Brunet,312923,203958,Caroline Bonneau,281200,390165,2022-04-04
TRANSFER,42037,Stéphane-Timothée Pineau,83621,41584,Caroline Bonneau,390165,432202,2022-04-05
CASH_OUT,280817,Caroline Bonneau,432202,151385,Agence_moov_Abomey,300000,19183,2022-04-06
CASH_IN,87013,Agence_moov_Cotonou,300000,212987,Caroline Bonneau,151385,238398,2022-04-06
TRANSFER,552299,Emmanuel Bousquet,847999,295700,Caroline Bonneau,238398,790697,2022-04-06
CASH_IN,32204,Agence_moov_Abomey,300000,267796,Caroline Bonneau,790697,822901,2022-04-07
TRANSFER,489923,Marthe Guillet,723100,233177,Caroline Bonneau,822901,1312824,2022-04-09
TRANSFER,24152,Aimé Allain,97623,73471,Caroline Bonneau,1312824,1336976,2022-04-09
TRANSFER,41531,Caroline Bonneau,1336976,1295445,Frédéric Moreau,160666,119135,2022-04-10
TRANSFER,52380,Nicolas Grondin de la Pinto,1298111,1245731,Caroline Bonneau,1295445,1347825,2022-04-12
TRANSFER,1079423,Caroline Bonneau,1347825,268402,Alfred Chrétien,1710300,630877,2022-04-12
CASH_IN,218887,Agence_moov_Abomey,300000,81113,Caroline Bonneau,268402,487289,2022-04-13
TRANSFER,405189,Isaac Le Pinto,1986180,1580991,Caroline Bonneau,487289,892478,2022-04-15
CASH_OUT,424388,Caroline Bonneau,892478,468090,Agence_moov_Ouidah,300000,-124388,2022-04-16
CASH_OUT,128301,Caroline Bonneau,468090,339789,Agence_moov_Cotonou,300000,171699,2022-04-20
CASH_OUT,134633,Caroline Bonneau,339789,205156,Agence_moov_Abomey,300000,165367,2022-04-22
TRANSFER,123346,Caroline Bonneau,205156,81810,Bernadette Fabre,1014722,891376,2022-04-23
TRANSFER,29295,Caroline Bonneau,81810,52515,Marthe Pichon,1278500,1249205,2022-04-24
CASH_OUT,29118,Caroline Bonneau,52515,23397,Agence_moov_Abomey,300000,270882,2022-04-24
TRANSFER,1018462,Valentine Traore,1216286,197824,Caroline Bonneau,23397,1041859,2022-04-25
CASH_OUT,281870,Caroline Bonneau,1041859,759989,Agence_moov_Ouidah,300000,18130,2022-04-25
CASH_IN,92009,Agence_moov_Cotonou,300000,207991,Noémi de la Didier,-1473342,-1381333,2022-04-04
CASH_IN,168203,Agence_moov_Cotonou,300000,131797,Noémi de la Didier,-1381333,-1213130,2022-04-04
CASH_IN,278414,Agence_moov_Ouidah,300000,21586,Noémi de la Didier,-1213130,-934716,2022-04-04
CASH_IN,117859,Agence_moov_Ouidah,300000,182141,Noémi de la Didier,-934716,-816857,2022-04-04
CASH_IN,244930,Agence_moov_Cotonou,300000,55070,Noémi de la Didier,-816857,-571927,2022-04-05
CASH_IN,21451,Agence_moov_Cotonou,300000,278549,Noémi de la Didier,-571927,-550476,2022-04-06
CASH_IN,77763,Agence_moov_Abomey,300000,222237,Noémi de la Didier,-550476,-472713,2022-04-06
CASH_IN,4822,Agence_moov_Abomey,300000,295178,Noémi de la Didier,-472713,-467891,2022-04-09
CASH_IN,198558,Agence_moov_Abomey,300000,101442,Noémi de la Didier,-467891,-269333,2022-04-10
CASH_IN,194156,Agence_moov_Cotonou,300000,105844,Noémi de la Didier,-269333,-75177,2022-04-11
CASH_IN,109830,Agence_moov_Ouidah,300000,190170,Noémi de la Didier,-75177,34653,2022-04-11
CASH_IN,97892,Agence_moov_Ouidah,300000,202108,Noémi de la Didier,34653,132545,2022-04-12
TRANSFER,203389,Maryse Reynaud-Michaud,618000,414611,Noémi de la Didier,132545,335934,2022-04-13
CASH_OUT,22293,Noémi de la Didier,335934,313641,Agence_moov_Abomey,300000,277707,2022-04-13
CASH_IN,154654,Agence_moov_Abomey,300000,145346,Noémi de la Didier,313641,468295,2022-04-14
CASH_IN,229269,Agence_moov_Ouidah,300000,70731,Noémi de la Didier,468295,697564,2022-04-15
CASH_OUT,541907,Noémi de la Didier,697564,155657,Agence_moov_Ouidah,300000,-241907,2022-04-16
TRANSFER,86391,Noémi de la Didier,155657,69266,Léon Paris,1661100,1574709,2022-04-16
CASH_OUT,5791,Noémi de la Didier,69266,63475,Agence_moov_Abomey,300000,294209,2022-04-18
CASH_OUT,45790,Noémi de la Didier,63475,17685,Agence_moov_Abomey,300000,254210,2022-04-19
TRANSFER,672228,Arnaude Gaillard,822600,150372,Noémi de la Didier,17685,689913,2022-04-19
CASH_IN,248740,Agence_moov_Cotonou,300000,51260,Noémi de la Didier,689913,938653,2022-04-20
TRANSFER,3565,Caroline Monnier,6834,3269,Noémi de la Didier,938653,942218,2022-04-20
CASH_OUT,834661,Noémi de la Didier,942218,107557,Agence_moov_Abomey,300000,-534661,2022-04-23
TRANSFER,161616,Marthe Guillet,233177,71561,Noémi de la Didier,107557,269173,2022-04-23
TRANSFER,44208,Noémi de la Didier,269173,224965,Océane Boutin,1370591,1326383,2022-04-23
TRANSFER,32573,Stéphanie Bonneau,145113,112540,Noémi de la Didier,224965,257538,2022-04-25
CASH_IN,84385,Agence_moov_Ouidah,300000,215615,Noémi de la Didier,257538,341923,2022-04-26
TRANSFER,154481,Amélie de la Picard,430800,276319,Noémi de la Didier,341923,496404,2022-04-27
TRANSFER,1050592,Théophile Mendès,1770800,720208,Noémi de la Didier,496404,1546996,2022-04-27
CASH_IN,25168,Agence_moov_Abomey,300000,274832,Théodore-Alfred Fournier,68168,93336,2022-04-03
CASH_OUT,71074,Théodore-Alfred Fournier,93336,22262,Agence_moov_Cotonou,300000,228926,2022-04-03
CASH_OUT,2992,Théodore-Alfred Fournier,22262,19270,Agence_moov_Abomey,300000,297008,2022-04-04
CASH_OUT,16209,Théodore-Alfred Fournier,19270,3061,Agence_moov_Cotonou,300000,283791,2022-04-05
TRANSFER,74344,Valentine Traore,197824,123480,Théodore-Alfred Fournier,3061,77405,2022-04-06
CASH_OUT,31112,Théodore-Alfred Fournier,77405,46293,Agence_moov_Cotonou,300000,268888,2022-04-08
TRANSFER,22973,Théodore-Alfred Fournier,46293,23320,Grégoire Delmas de Blanchard,692100,669127,2022-04-08
TRANSFER,21685,Théodore-Alfred Fournier,23320,1635,Emmanuelle Gilbert,787636,765951,2022-04-09
CASH_OUT,950,Théodore-Alfred Fournier,1635,685,Agence_moov_Cotonou,300000,299050,2022-04-09
CASH_OUT,435,Théodore-Alfred Fournier,685,250,Agence_moov_Cotonou,300000,299565,2022-04-10
TRANSFER,16347,Stéphane-Timothée Pineau,41584,25237,Théodore-Alfred Fournier,250,16597,2022-04-11
CASH_OUT,9569,Théodore-Alfred Fournier,16597,7028,Agence_moov_Abomey,300000,290431,2022-04-13
CASH_IN,111223,Agence_moov_Cotonou,300000,188777,Théodore-Alfred Fournier,7028,118251,2022-04-13
CASH_OUT,71937,Théodore-Alfred Fournier,118251,46314,Agence_moov_Abomey,300000,228063,2022-04-13
CASH_OUT,43120,Théodore-Alfred Fournier,46314,3194,Agence_moov_Abomey,300000,256880,2022-04-14
TRANSFER,93554,Valentine Traore,123480,29926,Théodore-Alfred Fournier,3194,96748,2022-04-15
CASH_OUT,45814,Théodore-Alfred Fournier,96748,50934,Agence_moov_Cotonou,300000,254186,2022-04-16
CASH_IN,135315,Agence_moov_Cotonou,300000,164685,Théodore-Alfred Fournier,50934,186249,2022-04-17
TRANSFER,86799,Théodore-Alfred Fournier,186249,99450,Maryse Lebreton,1213700,1126901,2022-04-19
TRANSFER,298434,Vincent-Philippe Rossi,608900,310466,Théodore-Alfred Fournier,99450,397884,2022-04-21
CASH_IN,150564,Agence_moov_Ouidah,300000,149436,Théodore-Alfred Fournier,397884,548448,2022-04-22
TRANSFER,327,Valentine Traore,29926,29599,Théodore-Alfred Fournier,548448,548775,2022-04-23
TRANSFER,416874,Théodore-Alfred Fournier,548775,131901,Antoine Bourdon de Auger,101345,-315529,2022-04-24
TRANSFER,58400,Théodore-Alfred Fournier,131901,73501,Christine-Constance Gauthier,1101200,1042800,2022-04-24
CASH_OUT,32266,Théodore-Alfred Fournier,73501,41235,Agence_moov_Ouidah,300000,267734,2022-04-24
CASH_IN,29930,Agence_moov_Ouidah,300000,270070,Théodore-Alfred Fournier,41235,71165,2022-04-26
TRANSFER,63453,Théodore-Alfred Fournier,71165,7712,Alfred Chrétien,630877,567424,2022-04-26
CASH_OUT,3125,Théodore-Alfred Fournier,7712,4587,Agence_moov_Cotonou,300000,296875,2022-04-26
CASH_OUT,43287,Émilie Guillon de Duhamel,469643,426356,Agence_moov_Abomey,300000,256713,2022-04-01
TRANSFER,13938,Émilie Guillon de Duhamel,426356,412418,Maryse Reynaud-Michaud,414611,400673,2022-04-01
CASH_IN,204101,Agence_moov_Ouidah,300000,95899,Émilie Guillon de Duhamel,412418,616519,2022-04-02
CASH_OUT,68989,Émilie Guillon de Duhamel,616519,547530,Agence_moov_Abomey,300000,231011,2022-04-05
CASH_OUT,297322,Émilie Guillon de Duhamel,547530,250208,Agence_moov_Ouidah,300000,2678,2022-04-05
CASH_IN,109841,Agence_moov_Abomey,300000,190159,Émilie Guillon de Duhamel,250208,360049,2022-04-06
CASH_IN,74772,Agence_moov_Cotonou,300000,225228,Émilie Guillon de Duhamel,360049,434821,2022-04-07
CASH_IN,283240,Agence_moov_Ouidah,300000,16760,Émilie Guillon de Duhamel,434821,718061,2022-04-08
CASH_IN,130406,Agence_moov_Ouidah,300000,169594,Émilie Guillon de Duhamel,718061,848467,2022-04-08
CASH_OUT,692794,Émilie Guillon de Duhamel,848467,155673,Agence_moov_Ouidah,300000,-392794,2022-04-11
CASH_IN,105977,Agence_moov_Ouidah,300000,194023,Émilie Guillon de Duhamel,155673,261650,2022-04-12
TRANSFER,32552,Émilie Guillon de Duhamel,261650,229098,Émile Hebert,179600,147048,2022-04-12
CASH_IN,280345,Agence_moov_Cotonou,300000,19655,Émilie Guillon de Duhamel,229098,509443,2022-04-14
CASH_IN,22906,Agence_moov_Abomey,300000,277094,Émilie Guillon de Duhamel,509443,532349,2022-04-15
CASH_IN,278516,Agence_moov_Cotonou,300000,21484,Émilie Guillon de Duhamel,532349,810865,2022-04-15
CASH_IN,188152,Agence_moov_Abomey,300000,111848,Émilie Guillon de Duhamel,810865,999017,2022-04-19
TRANSFER,190618,Diane-Françoise Raynaud,1258764,1068146,Émilie Guillon de Duhamel,999017,1189635,2022-04-19
TRANSFER,3632,Émilie Guillon de Duhamel,1189635,1186003,Luc Camus,710926,707294,2022-04-19
CASH_IN,41131,Agence_moov_Cotonou,300000,258869,Émilie Guillon de Duhamel,1186003,1227134,2022-04-20
CASH_IN,193849,Agence_moov_Cotonou,300000,106151,Émilie Guillon de Duhamel,1227134,1420983,2022-04-21
TRANSFER,6581,Émilie Guillon de Duhamel,1420983,1414402,Nath Léger,507333,500752,2022-04-21
TRANSFER,196923,Émilie Guillon de Duhamel,1414402,1217479,Amélie de la Picard,276319,79396,2022-04-23
TRANSFER,20391,Matthieu Renard,587800,567409,Émilie Guillon de Duhamel,1217479,1237870,2022-04-25
TRANSFER,231692,Alexandre Poirier,335792,104100,Julie Robin de Gros,689426,457734,2022-04-01
TRANSFER,44841,Alexandre Poirier,104100,59259,Adélaïde-Sophie Leclercq,21700,-23141,2022-04-02
TRANSFER,19417,Alexandre Poirier,59259,39842,Emmanuel Bousquet,295700,276283,2022-04-03
CASH_IN,280997,Agence_moov_Abomey,300000,19003,Alexandre Poirier,39842,320839,2022-04-04
CASH_OUT,172362,Alexandre Poirier,320839,148477,Agence_moov_Cotonou,300000,127638,2022-04-05
CASH_OUT,138846,Alexandre Poirier,148477,9631,Agence_moov_Cotonou,300000,161154,2022-04-09
TRANSFER,1317379,Adrienne Arnaud,1523600,206221,Alexandre Poirier,9631,1327010,2022-04-10
CASH_IN,11181,Agence_moov_Abomey,300000,288819,Alexandre Poirier,1327010,1338191,2022-04-12
CASH_OUT,1210194,Alexandre Poirier,1338191,127997,Agence_moov_Abomey,300000,-910194,2022-04-13
CASH_OUT,13507,Alexandre Poirier,127997,114490,Agence_moov_Cotonou,300000,286493,2022-04-13
TRANSFER,155113,Marianne Descamps,595313,440200,Alexandre Poirier,114490,269603,2022-04-14
TRANSFER,4348,Xavier-Stéphane Ollivier,6275,1927,Alexandre Poirier,269603,273951,2022-04-15
TRANSFER,129721,Alexandre Poirier,273951,144230,Matthieu Carpentier,847600,717879,2022-04-15
TRANSFER,128506,Alexandre Poirier,144230,15724,Aimé Allain,73471,-55035,2022-04-15
CASH_IN,78625,Agence_moov_Abomey,300000,221375,Alexandre Poirier,15724,94349,2022-04-17
CASH_IN,95373,Agence_moov_Abomey,300000,204627,Alexandre Poirier,94349,189722,2022-04-17
CASH_OUT,28872,Alexandre Poirier,189722,160850,Agence_moov_Ouidah,300000,271128,2022-04-19
CASH_IN,78124,Agence_moov_Ouidah,300000,221876,Alexandre Poirier,160850,238974,2022-04-19
TRANSFER,150131,Alexandre Poirier,238974,88843,Marthe Pichon,1249205,1099074,2022-04-20
CASH_IN,227186,Agence_moov_Abomey,300000,72814,Alexandre Poirier,88843,316029,2022-04-20
TRANSFER,4360,Alexandre Poirier,316029,311669,Marthe Pichon,1099074,1094714,2022-04-22
TRANSFER,6806,Valentine Traore,29599,22793,Alexandre Poirier,311669,318475,2022-04-22
CASH_IN,157249,Agence_moov_Abomey,300000,142751,Alexandre Poirier,318475,475724,2022-04-22
CASH_OUT,408526,Alexandre Poirier,475724,67198,Agence_moov_Ouidah,300000,-108526,2022-04-23
TRANSFER,55823,Benoît Verdier,481341,425518,Alexandre Poirier,67198,123021,2022-04-25
TRANSFER,55360,Marthe Guillet,71561,16201,Alexandre Poirier,123021,178381,2022-04-25
TRANSFER,49779,Sabine Imbert,541934,492155,Alexandre Poirier,178381,228160,2022-04-26
CASH_OUT,161343,Alexandre Poirier,228160,66817,Agence_moov_Ouidah,300000,138657,2022-04-27
TRANSFER,302844,Vincent-Philippe Rossi,310466,7622,Nath Léger,500752,803596,2022-04-01
CASH_IN,287598,Agence_moov_Cotonou,300000,12402,Nath Léger,803596,1091194,2022-04-01
CASH_IN,262875,Agence_moov_Ouidah,300000,37125,Nath Léger,1091194,1354069,2022-04-02
TRANSFER,542285,Nath Léger,1354069,811784,Nath Léger,1354069,1896354,2022-04-03
TRANSFER,585346,Nath Léger,811784,226438,Luc Camus,707294,121948,2022-04-04
CASH_OUT,28338,Nath Léger,226438,198100,Agence_moov_Cotonou,300000,271662,2022-04-05
CASH_OUT,123903,Nath Léger,198100,74197,Agence_moov_Ouidah,300000,176097,2022-04-07
CASH_IN,70092,Agence_moov_Cotonou,300000,229908,Nath Léger,74197,144289,2022-04-08
CASH_OUT,24085,Nath Léger,144289,120204,Agence_moov_Cotonou,300000,275915,2022-04-11
CASH_IN,102348,Agence_moov_Ouidah,300000,197652,Nath Léger,120204,222552,2022-04-14
CASH_IN,225729,Agence_moov_Abomey,300000,74271,Nath Léger,222552,448281,2022-04-14
CASH_OUT,151169,Nath Léger,448281,297112,Agence_moov_Abomey,300000,148831,2022-04-15
TRANSFER,47155,Nath Léger,297112,249957,Maryse Lebreton,1126901,1079746,2022-04-15
CASH_IN,277307,Agence_moov_Abomey,300000,22693,Nath Léger,249957,527264,2022-04-16
CASH_IN,49479,Agence_moov_Ouidah,300000,250521,Nath Léger,527264,576743,2022-04-16
TRANSFER,262442,Marthe Pichon,1094714,832272,Nath Léger,576743,839185,2022-04-17
TRANSFER,627477,Nath Léger,839185,211708,Frédéric Moreau,119135,-508342,2022-04-18
TRANSFER,4210,Laurence Carlier,36967,32757,Nath Léger,211708,215918,2022-04-20
TRANSFER,6829,Nath Léger,215918,209089,Théophile Mendès,720208,713379,2022-04-22
TRANSFER,321766,Auguste Bousquet,430517,108751,Nath Léger,209089,530855,2022-04-22
TRANSFER,186934,Nath Léger,530855,343921,Théophile Mendès,713379,526445,2022-04-23
CASH_OUT,205579,Nath Léger,343921,138342,Agence_moov_Ouidah,300000,94421,2022-04-23
TRANSFER,70272,Clémence Bertin,1303600,1233328,Nath Léger,138342,208614,2022-04-24
CASH_OUT,120519,Nath Léger,208614,88095,Agence_moov_Cotonou,300000,179481,2022-04-26
TRANSFER,57317,Nath Léger,88095,30778,Xavier-Stéphane Ollivier,1927,-55390,2022-04-26
CASH_OUT,28638,Nath Léger,30778,2140,Agence_moov_Ouidah,300000,271362,2022-04-27
CASH_IN,236300,Agence_moov_Ouidah,300000,63700,Diane-Françoise Raynaud,1068146,1304446,2022-04-03
CASH_IN,226366,Agence_moov_Abomey,300000,73634,Diane-Françoise Raynaud,1304446,1530812,2022-04-03
CASH_OUT,564390,Diane-Françoise Raynaud,1530812,966422,Agence_moov_Abomey,300000,-264390,2022-04-03
CASH_OUT,137080,Diane-Françoise Raynaud,966422,829342,Agence_moov_Abomey,300000,162920,2022-04-04
CASH_IN,17371,Agence_moov_Cotonou,300000,282629,Diane-Françoise Raynaud,829342,846713,2022-04-04
TRANSFER,574233,Diane-Françoise Raynaud,846713,272480,Agnès Chrétien-Sanchez,812231,237998,2022-04-05
CASH_OUT,265877,Diane-Françoise Raynaud,272480,6603,Agence_moov_Ouidah,300000,34123,2022-04-05
CASH_IN,177787,Agence_moov_Cotonou,300000,122213,Diane-Françoise Raynaud,6603,184390,2022-04-05
TRANSFER,84525,Diane-Françoise Raynaud,184390,99865,Marthe Pichon,832272,747747,2022-04-06
CASH_IN,71055,Agence_moov_Abomey,300000,228945,Diane-Françoise Raynaud,99865,170920,2022-04-08
CASH_OUT,156349,Diane-Françoise Raynaud,170920,14571,Agence_moov_Ouidah,300000,143651,2022-04-08
TRANSFER,472,Diane-Françoise Raynaud,14571,14099,Océane Boutin,1326383,1325911,2022-04-08
CASH_OUT,2887,Diane-Françoise Raynaud,14099,11212,Agence_moov_Ouidah,300000,297113,2022-04-08
CASH_IN,193846,Agence_moov_Abomey,300000,106154,Diane-Françoise Raynaud,11212,205058,2022-04-08
CASH_IN,253873,Agence_moov_Cotonou,300000,46127,Diane-Françoise Raynaud,205058,458931,2022-04-08
CASH_OUT,84656,Diane-Françoise Raynaud,458931,374275,Agence_moov_Abomey,300000,215344,2022-04-11
TRANSFER,49258,Diane-Françoise Raynaud,374275,325017,Julie Robin de Gros,457734,408476,2022-04-11
CASH_IN,196603,Agence_moov_Cotonou,300000,103397,Diane-Françoise Raynaud,325017,521620,2022-04-14
TRANSFER,345200,Diane-Françoise Raynaud,521620,176420,Laurence Carlier,32757,-312443,2022-04-15
CASH_OUT,39191,Diane-Françoise Raynaud,176420,137229,Agence_moov_Ouidah,300000,260809,2022-04-19
TRANSFER,1524793,Léon Paris,1574709,49916,Diane-Françoise Raynaud,137229,1662022,2022-04-22
CASH_IN,120151,Agence_moov_Ouidah,300000,179849,Diane-Françoise Raynaud,1662022,1782173,2022-04-22
CASH_OUT,1028368,Diane-Françoise Raynaud,1782173,753805,Agence_moov_Abomey,300000,-728368,2022-04-24
CASH_OUT,747560,Diane-Françoise Raynaud,753805,6245,Agence_moov_Ouidah,300000,-447560,2022-04-24
CASH_OUT,775,Diane-Françoise Raynaud,6245,5470,Agence_moov_Ouidah,300000,299225,2022-04-26
TRANSFER,197,Diane-Françoise Raynaud,5470,5273,Julie Robin de Gros,408476,408279,2022-04-27
CASH_OUT,262953,Matthieu Carpentier,717879,454926,Agence_moov_Abomey,300000,37047,2022-04-01
CASH_OUT,447497,Matthieu Carpentier,454926,7429,Agence_moov_Abomey,300000,-147497,2022-04-03
CASH_OUT,4806,Matthieu Carpentier,7429,2623,Agence_moov_Abomey,300000,295194,2022-04-03
CASH_OUT,346,Matthieu Carpentier,2623,2277,Agence_moov_Abomey,300000,299654,2022-04-03
CASH_IN,145092,Agence_moov_Cotonou,300000,154908,Matthieu Carpentier,2277,147369,2022-04-05
TRANSFER,74224,Matthieu Carpentier,147369,73145,Sébastien-Arthur Masse,56118,-18106,2022-04-08
TRANSFER,37802,Matthieu Carpentier,73145,35343,Stéphane-Timothée Pineau,25237,-12565,2022-04-08
CASH_IN,71356,Agence_moov_Cotonou,300000,228644,Matthieu Carpentier,35343,106699,2022-04-08
TRANSFER,895224,Joseph de la Dubois,919000,23776,Matthieu Carpentier,106699,1001923,2022-04-09
CASH_OUT,73933,Matthieu Carpentier,1001923,927990,Agence_moov_Cotonou,300000,226067,2022-04-10
TRANSFER,898644,Matthieu Carpentier,927990,29346,Emmanuelle Gilbert,765951,-132693,2022-04-11
CASH_OUT,7005,Matthieu Carpentier,29346,22341,Agence_moov_Ouidah,300000,292995,2022-04-14
CASH_OUT,6293,Matthieu Carpentier,22341,16048,Agence_moov_Ouidah,300000,293707,2022-04-19
CASH_OUT,182,Matthieu Carpentier,16048,15866,Agence_moov_Abomey,300000,299818,2022-04-19
TRANSFER,11549,Matthieu Carpentier,15866,4317,Bernadette Fabre,891376,879827,2022-04-19
CASH_IN,96339,Agence_moov_Abomey,300000,203661,Matthieu Carpentier,4317,100656,2022-04-21
CASH_IN,87337,Agence_moov_Abomey,300000,212663,Matthieu Carpentier,100656,187993,2022-04-24
TRANSFER,107539,Matthieu Carpentier,187993,80454,Emmanuel-René Coulon,299693,192154,2022-04-25
TRANSFER,56931,Matthieu Carpentier,80454,23523,Arnaude Gaillard,150372,93441,2022-04-26
CASH_OUT,13221,Matthieu Carpentier,23523,10302,Agence_moov_Ouidah,300000,286779,2022-04-26
CASH_IN,20046,Agence_moov_Abomey,300000,279954,Matthieu Carpentier,10302,30348,2022-04-26
CASH_IN,290414,Agence_moov_Abomey,300000,9586,Matthieu Carpentier,30348,320762,2022-04-27
CASH_IN,120691,Agence_moov_Ouidah,300000,179309,Antoine Bourdon de Auger,-315529,-194838,2022-04-02
CASH_IN,135315,Agence_moov_Cotonou,300000,164685,Antoine Bourdon de Auger,-194838,-59523,2022-04-03
CASH_IN,148260,Agence_moov_Ouidah,300000,151740,Antoine Bourdon de Auger,-59523,88737,2022-04-03
CASH_IN,151746,Agence_moov_Abomey,300000,148254,Antoine Bourdon de Auger,88737,240483,2022-04-06
CASH_OUT,82056,Antoine Bourdon de Auger,240483,158427,Agence_moov_Abomey,300000,217944,2022-04-06
CASH_OUT,83890,Antoine Bourdon de Auger,158427,74537,Agence_moov_Ouidah,300000,216110,2022-04-07
CASH_OUT,45852,Antoine Bourdon de Auger,74537,28685,Agence_moov_Ouidah,300000,254148,2022-04-07
TRANSFER,22532,Antoine Bourdon de Auger,28685,6153,Christine-Constance Gauthier,1042800,1020268,2022-04-08
CASH_OUT,1001,Antoine Bourdon de Auger,6153,5152,Agence_moov_Abomey,300000,298999,2022-04-08
TRANSFER,333494,Matthieu Renard,567409,233915,Antoine Bourdon de Auger,5152,338646,2022-04-09
TRANSFER,129708,Antoine Bourdon de Auger,338646,208938,Julie Robin de Gros,408279,278571,2022-04-10
CASH_IN,270798,Agence_moov_Ouidah,300000,29202,Antoine Bourdon de Auger,208938,479736,2022-04-10
CASH_OUT,254796,Antoine Bourdon de Auger,479736,224940,Agence_moov_Abomey,300000,45204,2022-04-10
TRANSFER,1416154,Théodore Bertin,1572700,156546,Antoine Bourdon de Auger,224940,1641094,2022-04-11
CASH_IN,39842,Agence_moov_Cotonou,300000,260158,Antoine Bourdon de Auger,1641094,1680936,2022-04-12
CASH_IN,235907,Agence_moov_Cotonou,300000,64093,Antoine Bourdon de Auger,1680936,1916843,2022-04-13
CASH_IN,132829,Agence_moov_Ouidah,300000,167171,Antoine Bourdon de Auger,1916843,2049672,2022-04-14
CASH_IN,48005,Agence_moov_Cotonou,300000,251995,Antoine Bourdon de Auger,2049672,2097677,2022-04-14
CASH_IN,91077,Agence_moov_Cotonou,300000,208923,Antoine Bourdon de Auger,2097677,2188754,2022-04-16
TRANSFER,47137,Agnès Chrétien-Sanchez,237998,190861,Antoine Bourdon de Auger,2188754,2235891,2022-04-18
CASH_IN,120639,Agence_moov_Cotonou,300000,179361,Antoine Bourdon de Auger,2235891,2356530,2022-04-22
CASH_OUT,1740196,Antoine Bourdon de Auger,2356530,616334,Agence_moov_Abomey,300000,-1440196,2022-04-22
TRANSFER,610616,Antoine Bourdon de Auger,616334,5718,Julie Robin de Gros,278571,-332045,2022-04-22
CASH_IN,173516,Agence_moov_Abomey,300000,126484,Antoine Bourdon de Auger,5718,179234,2022-04-23
CASH_OUT,8986,Antoine Bourdon de Auger,179234,170248,Agence_moov_Abomey,300000,291014,2022-04-25
TRANSFER,62763,Stéphanie Bonneau,112540,49777,Antoine Bourdon de Auger,170248,233011,2022-04-26
CASH_OUT,178828,Antoine Bourdon de Auger,233011,54183,Agence_moov_Abomey,300000,121172,2022-04-26
CASH_IN,135955,Agence_moov_Cotonou,300000,164045,Grégoire Delmas de Blanchard,669127,805082,2022-04-01
TRANSFER,18506,Vincent-Grégoire Brunet,203958,185452,Grégoire Delmas de Blanchard,805082,823588,2022-04-04
CASH_OUT,787684,Grégoire Delmas de Blanchard,823588,35904,Agence_moov_Abomey,300000,-487684,2022-04-04
TRANSFER,3683,Grégoire Delmas de Blanchard,35904,32221,Laurent Besson,997500,993817,2022-04-04
CASH_IN,13335,Agence_moov_Cotonou,300000,286665,Grégoire Delmas de Blanchard,32221,45556,2022-04-05
TRANSFER,681899,Maryse Lebreton,1079746,397847,Grégoire Delmas de Blanchard,45556,727455,2022-04-06
CASH_IN,227355,Agence_moov_Abomey,300000,72645,Grégoire Delmas de Blanchard,727455,954810,2022-04-06
CASH_IN,159297,Agence_moov_Ouidah,300000,140703,Grégoire Delmas de Blanchard,954810,1114107,2022-04-07
TRANSFER,270554,Christine-Constance Gauthier,1020268,749714,Grégoire Delmas de Blanchard,1114107,1384661,2022-04-08
CASH_OUT,430212,Grégoire Delmas de Blanchard,1384661,954449,Agence_moov_Cotonou,300000,-130212,2022-04-10
CASH_IN,72937,Agence_moov_Abomey,300000,227063,Grégoire Delmas de Blanchard,954449,1027386,2022-04-13
CASH_OUT,194399,Grégoire Delmas de Blanchard,1027386,832987,Agence_moov_Ouidah,300000,105601,2022-04-14
TRANSFER,348056,Grégoire Delmas de Blanchard,832987,484931,Claudine Vallet,383818,35762,2022-04-15
TRANSFER,12319,Marthe Guillet,16201,3882,Grégoire Delmas de Blanchard,484931,497250,2022-04-16
CASH_IN,105173,Agence_moov_Ouidah,300000,194827,Grégoire Delmas de Blanchard,497250,602423,2022-04-17
CASH_IN,92767,Agence_moov_Abomey,300000,207233,Grégoire Delmas de Blanchard,602423,695190,2022-04-17
TRANSFER,125590,Théodore Bertin,156546,30956,Grégoire Delmas de Blanchard,695190,820780,2022-04-17
CASH_IN,253260,Agence_moov_Cotonou,300000,46740,Grégoire Delmas de Blanchard,820780,1074040,2022-04-18
CASH_IN,75312,Agence_moov_Cotonou,300000,224688,Grégoire Delmas de Blanchard,1074040,1149352,2022-04-18
TRANSFER,157847,Grégoire Delmas de Blanchard,1149352,991505,Joséphine Weber du Bonnin,938500,780653,2022-04-18
CASH_IN,286986,Agence_moov_Cotonou,300000,13014,Grégoire Delmas de Blanchard,991505,1278491,2022-04-18
TRANSFER,1230464,Grégoire Delmas de Blanchard,1278491,48027,Théophile Mendès,526445,-704019,2022-04-20
CASH_IN,260774,Agence_moov_Ouidah,300000,39226,Grégoire Delmas de Blanchard,48027,308801,2022-04-23
CASH_IN,57075,Agence_moov_Ouidah,300000,242925,Grégoire Delmas de Blanchard,308801,365876,2022-04-23
TRANSFER,223554,Luc-Tristan Moreau,1715800,1492246,Grégoire Delmas de Blanchard,365876,589430,2022-04-24
CASH_IN,77961,Agence_moov_Abomey,300000,222039,Grégoire Delmas de Blanchard,589430,667391,2022-04-24
CASH_OUT,472913,Grégoire Delmas de Blanchard,667391,194478,Agence_moov_Ouidah,300000,-172913,2022-04-24
CASH_IN,12475,Agence_moov_Abomey,300000,287525,Grégoire Delmas de Blanchard,194478,206953,2022-04-26
TRANSFER,909991,Laurent Besson,993817,83826,Grégoire Delmas de Blanchard,206953,1116944,2022-04-27
CASH_IN,230298,Agence_moov_Cotonou,300000,69702,Élodie Gérard,-99330,130968,2022-04-02
CASH_IN,262031,Agence_moov_Abomey,300000,37969,Élodie Gérard,130968,392999,2022-04-03
TRANSFER,86466,Jacques-Antoine Gros,126003,39537,Élodie Gérard,392999,479465,2022-04-03
CASH_OUT,153012,Élodie Gérard,479465,326453,Agence_moov_Ouidah,300000,146988,2022-04-04
CASH_IN,47230,Agence_moov_Abomey,300000,252770,Élodie Gérard,326453,373683,2022-04-05
TRANSFER,135811,Élodie Gérard,373683,237872,Maryse Reynaud-Michaud,400673,264862,2022-04-07
TRANSFER,143871,Élodie Gérard,237872,94001,Matthieu Renard,233915,90044,2022-04-08
CASH_IN,67706,Agence_moov_Abomey,300000,232294,Élodie Gérard,94001,161707,2022-04-08
TRANSFER,99718,Élodie Gérard,161707,61989,Claudine Vallet,35762,-63956,2022-04-12
TRANSFER,11383,Stéphanie Bonneau,49777,38394,Élodie Gérard,61989,73372,2022-04-13
TRANSFER,27008,Élodie Gérard,73372,46364,Emmanuel-René Coulon,192154,165146,2022-04-14
TRANSFER,297351,Christine-Constance Gauthier,749714,452363,Élodie Gérard,46364,343715,2022-04-15
CASH_OUT,234293,Élodie Gérard,343715,109422,Agence_moov_Ouidah,300000,65707,2022-04-17
TRANSFER,711396,Marthe Pichon,747747,36351,Élodie Gérard,109422,820818,2022-04-19
CASH_IN,133266,Agence_moov_Abomey,300000,166734,Élodie Gérard,820818,954084,2022-04-19
TRANSFER,261546,Christine-Constance Gauthier,452363,190817,Élodie Gérard,954084,1215630,2022-04-20
CASH_IN,3867,Agence_moov_Ouidah,300000,296133,Élodie Gérard,1215630,1219497,2022-04-20
CASH_OUT,190083,Élodie Gérard,1219497,1029414,Agence_moov_Ouidah,300000,109917,2022-04-22
CASH_IN,272190,Agence_moov_Ouidah,300000,27810,Élodie Gérard,1029414,1301604,2022-04-25
CASH_OUT,356986,Élodie Gérard,1301604,944618,Agence_moov_Cotonou,300000,-56986,2022-04-25
CASH_IN,273991,Agence_moov_Cotonou,300000,26009,Élodie Gérard,944618,1218609,2022-04-26
CASH_IN,148796,Agence_moov_Cotonou,300000,151204,Caroline Monnier,3269,152065,2022-04-01
TRANSFER,349968,Isaac Le Pinto,1580991,1231023,Caroline Monnier,152065,502033,2022-04-02
CASH_OUT,297733,Caroline Monnier,502033,204300,Agence_moov_Abomey,300000,2267,2022-04-04
TRANSFER,58545,Caroline Monnier,204300,145755,Emmanuel-René Coulon,165146,106601,2022-04-06
CASH_OUT,55093,Caroline Monnier,145755,90662,Agence_moov_Abomey,300000,244907,2022-04-06
TRANSFER,31805,Caroline Monnier,90662,58857,Marianne Descamps,440200,408395,2022-04-06
CASH_IN,38963,Agence_moov_Cotonou,300000,261037,Caroline Monnier,58857,97820,2022-04-07
CASH_OUT,11867,Caroline Monnier,97820,85953,Agence_moov_Abomey,300000,288133,2022-04-08
CASH_OUT,78026,Caroline Monnier,85953,7927,Agence_moov_Ouidah,300000,221974,2022-04-08
CASH_OUT,496,Caroline Monnier,7927,7431,Agence_moov_Ouidah,300000,299504,2022-04-09
CASH_IN,93400,Agence_moov_Ouidah,300000,206600,Caroline Monnier,7431,100831,2022-04-09
CASH_IN,132887,Agence_moov_Ouidah,300000,167113,Caroline Monnier,100831,233718,2022-04-09
TRANSFER,71729,Caroline Monnier,233718,161989,Clémence Bertin,1233328,1161599,2022-04-11
TRANSFER,18667,Théodore Bertin,30956,12289,Caroline Monnier,161989,180656,2022-04-12
CASH_OUT,13924,Caroline Monnier,180656,166732,Agence_moov_Ouidah,300000,286076,2022-04-13
CASH_IN,185894,Agence_moov_Cotonou,300000,114106,Caroline Monnier,166732,352626,2022-04-14
CASH_OUT,306420,Caroline Monnier,352626,46206,Agence_moov_Cotonou,300000,-6420,2022-04-16
CASH_OUT,2645,Caroline Monnier,46206,43561,Agence_moov_Abomey,300000,297355,2022-04-17
CASH_IN,112486,Agence_moov_Cotonou,300000,187514,Caroline Monnier,43561,156047,2022-04-17
CASH_IN,52870,Agence_moov_Ouidah,300000,247130,Caroline Monnier,156047,208917,2022-04-18
CASH_OUT,14201,Caroline Monnier,208917,194716,Agence_moov_Cotonou,300000,285799,2022-04-20
TRANSFER,25782,Léon Paris,49916,24134,Caroline Monnier,194716,220498,2022-04-25
CASH_IN,182084,Agence_moov_Cotonou,300000,117916,Caroline Monnier,220498,402582,2022-04-25
CASH_IN,236577,Agence_moov_Ouidah,300000,63423,Caroline Monnier,402582,639159,2022-04-27
CASH_IN,1510,Agence_moov_Cotonou,300000,298490,Théophile Mendès,-704019,-702509,2022-04-01
CASH_IN,93262,Agence_moov_Ouidah,300000,206738,Théophile Mendès,-702509,-609247,2022-04-02
CASH_IN,203870,Agence_moov_Abomey,300000,96130,Théophile Mendès,-609247,-405377,2022-04-03
CASH_IN,176698,Agence_moov_Abomey,300000,123302,Théophile Mendès,-405377,-228679,2022-04-06
CASH_IN,54185,Agence_moov_Ouidah,300000,245815,Théophile Mendès,-228679,-174494,2022-04-06
CASH_IN,274041,Agence_moov_Ouidah,300000,25959,Théophile Mendès,-174494,99547,2022-04-07
CASH_OUT,69931,Théophile Mendès,99547,29616,Agence_moov_Cotonou,300000,230069,2022-04-08
TRANSFER,88499,Benoît Verdier,425518,337019,Théophile Mendès,29616,118115,2022-04-10
CASH_OUT,60072,Théophile Mendès,118115,58043,Agence_moov_Abomey,300000,239928,2022-04-10
CASH_IN,201051,Agence_moov_Abomey,300000,98949,Théophile Mendès,58043,259094,2022-04-11
TRANSFER,62759,Théophile Mendès,259094,196335,Emmanuel-René Coulon,106601,43842,2022-04-11
CASH_OUT,6602,Théophile Mendès,196335,189733,Agence_moov_Cotonou,300000,293398,2022-04-13
CASH_IN,186157,Agence_moov_Abomey,300000,113843,Théophile Mendès,189733,375890,2022-04-13
CASH_IN,64152,Agence_moov_Ouidah,300000,235848,Théophile Mendès,375890,440042,2022-04-15
CASH_IN,22350,Agence_moov_Cotonou,300000,277650,Théophile Mendès,440042,462392,2022-04-17
CASH_IN,77177,Agence_moov_Cotonou,300000,222823,Théophile Mendès,462392,539569,2022-04-18
CASH_OUT,501757,Théophile Mendès,539569,37812,Agence_moov_Abomey,300000,-201757,2022-04-18
CASH_OUT,25403,Théophile Mendès,37812,12409,Agence_moov_Cotonou,300000,274597,2022-04-20
CASH_OUT,889,Théophile Mendès,12409,11520,Agence_moov_Cotonou,300000,299111,2022-04-20
CASH_IN,47034,Agence_moov_Cotonou,300000,252966,Théophile Mendès,11520,58554,2022-04-21
CASH_OUT,29898,Théophile Mendès,58554,28656,Agence_moov_Cotonou,300000,270102,2022-04-23
CASH_IN,52326,Agence_moov_Cotonou,300000,247674,Théophile Mendès,28656,80982,2022-04-23
CASH_IN,167979,Agence_moov_Abomey,300000,132021,David-Théodore Diaz,-40892,127087,2022-04-02
CASH_OUT,24795,David-Théodore Diaz,127087,102292,Agence_moov_Abomey,300000,275205,2022-04-02
CASH_IN,286222,Agence_moov_Ouidah,300000,13778,David-Théodore Diaz,102292,388514,2022-04-02
TRANSFER,161433,David-Théodore Diaz,388514,227081,Emmanuel-René Coulon,43842,-117591,2022-04-02
CASH_IN,76730,Agence_moov_Cotonou,300000,223270,David-Théodore Diaz,227081,303811,2022-04-03
CASH_OUT,40187,David-Théodore Diaz,303811,263624,Agence_moov_Abomey,300000,259813,2022-04-03
CASH_IN,110848,Agence_moov_Cotonou,300000,189152,David-Théodore Diaz,263624,374472,2022-04-04
TRANSFER,184523,David-Théodore Diaz,374472,189949,Clémence Bertin,1161599,977076,2022-04-04
CASH_OUT,178536,David-Théodore Diaz,189949,11413,Agence_moov_Cotonou,300000,121464,2022-04-06
CASH_IN,49129,Agence_moov_Ouidah,300000,250871,David-Théodore Diaz,11413,60542,2022-04-06
CASH_OUT,44674,David-Théodore Diaz,60542,15868,Agence_moov_Cotonou,300000,255326,2022-04-07
CASH_IN,288223,Agence_moov_Abomey,300000,11777,David-Théodore Diaz,15868,304091,2022-04-08
CASH_OUT,121719,David-Théodore Diaz,304091,182372,Agence_moov_Cotonou,300000,178281,2022-04-09
CASH_IN,152618,Agence_moov_Ouidah,300000,147382,David-Théodore Diaz,182372,334990,2022-04-10
CASH_IN,26672,Agence_moov_Cotonou,300000,273328,David-Théodore Diaz,334990,361662,2022-04-11
TRANSFER,504012,Isaac Le Pinto,1231023,727011,David-Théodore Diaz,361662,865674,2022-04-12
CASH_IN,3493,Agence_moov_Abomey,300000,296507,David-Théodore Diaz,865674,869167,2022-04-12
CASH_IN,160463,Agence_moov_Cotonou,300000,139537,David-Théodore Diaz,869167,1029630,2022-04-12
CASH_OUT,45170,David-Théodore Diaz,1029630,984460,Agence_moov_Abomey,300000,254830,2022-04-13
CASH_OUT,625709,David-Théodore Diaz,984460,358751,Agence_moov_Cotonou,300000,-325709,2022-04-14
CASH_OUT,179421,David-Théodore Diaz,358751,179330,Agence_moov_Cotonou,300000,120579,2022-04-17
CASH_OUT,56842,David-Théodore Diaz,179330,122488,Agence_moov_Cotonou,300000,243158,2022-04-19
CASH_OUT,89655,David-Théodore Diaz,122488,32833,Agence_moov_Abomey,300000,210345,2022-04-20
TRANSFER,3184,David-Théodore Diaz,32833,29649,Léon Paris,24134,20950,2022-04-20
CASH_IN,270502,Agence_moov_Abomey,300000,29498,David-Théodore Diaz,29649,300151,2022-04-20
TRANSFER,270484,David-Théodore Diaz,300151,29667,Océane Boutin,1325911,1055427,2022-04-21
TRANSFER,28400,David-Théodore Diaz,29667,1267,Margot Renaud de Lacombe,39166,10766,2022-04-21
TRANSFER,242083,Sabine Imbert,492155,250072,David-Théodore Diaz,1267,243350,2022-04-26
TRANSFER,3735,Joseph de la Dubois,23776,20041,Marthe Pichon,36351,32616,2022-04-01
CASH_IN,289933,Agence_moov_Cotonou,300000,10067,Joseph de la Dubois,20041,309974,2022-04-01
CASH_OUT,81055,Joseph de la Dubois,309974,228919,Agence_moov_Ouidah,300000,218945,2022-04-02
TRANSFER,25620,Laurent Besson,83826,58206,Joseph de la Dubois,228919,254539,2022-04-02
CASH_OUT,16412,Joseph de la Dubois,254539,238127,Agence_moov_Abomey,300000,283588,2022-04-03
TRANSFER,51199,Joseph de la Dubois,238127,186928,Auguste Bousquet,108751,57552,2022-04-03
CASH_OUT,117112,Joseph de la Dubois,186928,69816,Agence_moov_Ouidah,300000,182888,2022-04-07
TRANSFER,1128919,Luc-Tristan Moreau,1492246,363327,Joseph de la Dubois,69816,1198735,2022-04-07
CASH_IN,5627,Agence_moov_Cotonou,300000,294373,Joseph de la Dubois,1198735,1204362,2022-04-10
CASH_OUT,926142,Joseph de la Dubois,1204362,278220,Agence_moov_Ouidah,300000,-626142,2022-04-10
TRANSFER,69419,Matthieu Renard,90044,20625,Joseph de la Dubois,278220,347639,2022-04-11
CASH_IN,16193,Agence_moov_Cotonou,300000,283807,Joseph de la Dubois,347639,363832,2022-04-12
CASH_IN,251063,Agence_moov_Abomey,300000,48937,Joseph de la Dubois,363832,614895,2022-04-12
CASH_IN,270375,Agence_moov_Abomey,300000,29625,Joseph de la Dubois,614895,885270,2022-04-12
CASH_OUT,437413,Joseph de la Dubois,885270,447857,Agence_moov_Abomey,300000,-137413,2022-04-13
CASH_IN,118591,Agence_moov_Cotonou,300000,181409,Joseph de la Dubois,447857,566448,2022-04-17
CASH_IN,220877,Agence_moov_Abomey,300000,79123,Joseph de la Dubois,566448,787325,2022-04-18
CASH_OUT,548948,Joseph de la Dubois,787325,238377,Agence_moov_Cotonou,300000,-248948,2022-04-19
CASH_OUT,37377,Joseph de la Dubois,238377,201000,Agence_moov_Abomey,300000,262623,2022-04-20
TRANSFER,27464,Joseph de la Dubois,201000,173536,Joseph de la Dubois,201000,173536,2022-04-20
CASH_OUT,127055,Joseph de la Dubois,173536,46481,Agence_moov_Abomey,300000,172945,2022-04-21
TRANSFER,533368,Joséphine Weber du Bonnin,780653,247285,Joseph de la Dubois,46481,579849,2022-04-22
TRANSFER,33173,Joseph de la Dubois,579849,546676,Jacques-Antoine Gros,39537,6364,2022-04-23
CASH_OUT,253582,Joseph de la Dubois,546676,293094,Agence_moov_Abomey,300000,46418,2022-04-23
CASH_OUT,236085,Joseph de la Dubois,293094,57009,Agence_moov_Cotonou,300000,63915,2022-04-24
TRANSFER,961,Joseph de la Dubois,57009,56048,Léon Paris,20950,19989,2022-04-25
CASH_OUT,10408,Joseph de la Dubois,56048,45640,Agence_moov_Cotonou,300000,289592,2022-04-26
TRANSFER,86315,Arnaude Gaillard,93441,7126,Amélie de la Picard,79396,165711,2022-04-01
CASH_IN,40884,Agence_moov_Cotonou,300000,259116,Amélie de la Picard,165711,206595,2022-04-03
CASH_IN,223215,Agence_moov_Ouidah,300000,76785,Amélie de la Picard,206595,429810,2022-04-12
CASH_OUT,128424,Amélie de la Picard,429810,301386,Agence_moov_Abomey,300000,171576,2022-04-14
TRANSFER,37879,Nicolas Grondin de la Pinto,1245731,1207852,Amélie de la Picard,301386,339265,2022-04-14
TRANSFER,570174,Laurent Perrot,962030,391856,Amélie de la Picard,339265,909439,2022-04-17
TRANSFER,398542,Isaac Le Pinto,727011,328469,Amélie de la Picard,909439,1307981,2022-04-21
TRANSFER,376164,Amélie de la Picard,1307981,931817,Nicolas Grondin de la Pinto,1207852,831688,2022-04-23
TRANSFER,2145,Margot Renaud de Lacombe,10766,8621,Amélie de la Picard,931817,933962,2022-04-26
CASH_IN,32521,Agence_moov_Abomey,300000,267479,Théodore Bertin,12289,44810,2022-04-01
CASH_OUT,39242,Théodore Bertin,44810,5568,Agence_moov_Abomey,300000,260758,2022-04-02
TRANSFER,1511,Théodore Bertin,5568,4057,Agnès Baron,565490,563979,2022-04-02
TRANSFER,13911,Léon Paris,19989,6078,Théodore Bertin,4057,17968,2022-04-02
CASH_IN,266039,Agence_moov_Abomey,300000,33961,Théodore Bertin,17968,284007,2022-04-04
CASH_OUT,96715,Théodore Bertin,284007,187292,Agence_moov_Cotonou,300000,203285,2022-04-06
CASH_OUT,83545,Théodore Bertin,187292,103747,Agence_moov_Abomey,300000,216455,2022-04-07
TRANSFER,312606,Maryse Lebreton,397847,85241,Théodore Bertin,103747,416353,2022-04-08
CASH_OUT,118616,Théodore Bertin,416353,297737,Agence_moov_Cotonou,300000,181384,2022-04-08
TRANSFER,94305,Théodore Bertin,297737,203432,Marthe Pichon,32616,-61689,2022-04-08
TRANSFER,40568,Théodore Bertin,203432,162864,Luc-Tristan Moreau,363327,322759,2022-04-10
CASH_OUT,58634,Théodore Bertin,162864,104230,Agence_moov_Cotonou,300000,241366,2022-04-13
CASH_OUT,34273,Théodore Bertin,104230,69957,Agence_moov_Abomey,300000,265727,2022-04-20
CASH_IN,165012,Agence_moov_Ouidah,300000,134988,Théodore Bertin,69957,234969,2022-04-22
TRANSFER,200322,Théodore Bertin,234969,34647,Margot Renaud de Lacombe,8621,-191701,2022-04-24
CASH_OUT,8908,Théodore Bertin,34647,25739,Agence_moov_Abomey,300000,291092,2022-04-26
TRANSFER,48399,Sabine Imbert,250072,201673,Théodore Bertin,25739,74138,2022-04-27
TRANSFER,1483,Léon Paris,6078,4595,Maryse Reynaud-Michaud,264862,263379,2022-04-05
TRANSFER,4772,Jacques-Antoine Gros,6364,1592,Léon Paris,4595,9367,2022-04-09
CASH_OUT,3106,Léon Paris,9367,6261,Agence_moov_Abomey,300000,296894,2022-04-12
CASH_IN,76436,Agence_moov_Cotonou,300000,223564,Léon Paris,6261,82697,2022-04-13
CASH_IN,180062,Agence_moov_Cotonou,300000,119938,Léon Paris,82697,262759,2022-04-15
CASH_IN,176008,Agence_moov_Ouidah,300000,123992,Léon Paris,262759,438767,2022-04-17
CASH_OUT,115802,Léon Paris,438767,322965,Agence_moov_Cotonou,300000,184198,2022-04-25
CASH_IN,118128,Agence_moov_Cotonou,300000,181872,Agnès Chrétien-Sanchez,190861,308989,2022-04-01
CASH_IN,251259,Agence_moov_Ouidah,300000,48741,Agnès Chrétien-Sanchez,308989,560248,2022-04-03
CASH_OUT,231018,Agnès Chrétien-Sanchez,560248,329230,Agence_moov_Abomey,300000,68982,2022-04-03
TRANSFER,46666,Agnès Chrétien-Sanchez,329230,282564,Luc-Tristan Moreau,322759,276093,2022-04-09
CASH_OUT,186430,Agnès Chrétien-Sanchez,282564,96134,Agence_moov_Abomey,300000,113570,2022-04-11
TRANSFER,24587,Agnès Chrétien-Sanchez,96134,71547,Arnaude Gaillard,7126,-17461,2022-04-19
CASH_IN,10008,Agence_moov_Ouidah,300000,289992,Agnès Chrétien-Sanchez,71547,81555,2022-04-24
CASH_OUT,478894,Marine-Clémence Ferreira,965700,486806,Agence_moov_Abomey,300000,-178894,2022-04-01
TRANSFER,442007,Marine-Clémence Ferreira,486806,44799,Luc-Tristan Moreau,276093,-165914,2022-04-01
CASH_OUT,29705,Marine-Clémence Ferreira,44799,15094,Agence_moov_Cotonou,300000,270295,2022-04-06
CASH_IN,261978,Agence_moov_Ouidah,300000,38022,Marine-Clémence Ferreira,15094,277072,2022-04-06
CASH_OUT,196775,Marine-Clémence Ferreira,277072,80297,Agence_moov_Ouidah,300000,103225,2022-04-07
CASH_IN,219304,Agence_moov_Ouidah,300000,80696,Marine-Clémence Ferreira,80297,299601,2022-04-08
CASH_IN,122273,Agence_moov_Abomey,300000,177727,Marine-Clémence Ferreira,299601,421874,2022-04-08
CASH_OUT,194278,Marine-Clémence Ferreira,421874,227596,Agence_moov_Cotonou,300000,105722,2022-04-19
CASH_IN,227582,Agence_moov_Cotonou,300000,72418,Marine-Clémence Ferreira,227596,455178,2022-04-20
CASH_OUT,277598,Marine-Clémence Ferreira,455178,177580,Agence_moov_Ouidah,300000,22402,2022-04-21
CASH_IN,233353,Agence_moov_Ouidah,300000,66647,Marine-Clémence Ferreira,177580,410933,2022-04-22
TRANSFER,83238,Christine-Constance Gauthier,190817,107579,Marine-Clémence Ferreira,410933,494171,2022-04-22
CASH_IN,227770,Agence_moov_Cotonou,300000,72230,Marine-Clémence Ferreira,494171,721941,2022-04-22
TRANSFER,674727,Marine-Clémence Ferreira,721941,47214,Alfred Chrétien,567424,-107303,2022-04-23
CASH_OUT,36593,Marine-Clémence Ferreira,47214,10621,Agence_moov_Ouidah,300000,263407,2022-04-24
TRANSFER,778135,Nicolas Grondin de la Pinto,831688,53553,Marine-Clémence Ferreira,10621,788756,2022-04-24
CASH_IN,21404,Agence_moov_Abomey,300000,278596,Julie Robin de Gros,-332045,-310641,2022-04-04
CASH_IN,24310,Agence_moov_Ouidah,300000,275690,Julie Robin de Gros,-310641,-286331,2022-04-04
CASH_IN,231329,Agence_moov_Cotonou,300000,68671,Julie Robin de Gros,-286331,-55002,2022-04-04
CASH_IN,104316,Agence_moov_Cotonou,300000,195684,Julie Robin de Gros,-55002,49314,2022-04-06
CASH_IN,203980,Agence_moov_Ouidah,300000,96020,Julie Robin de Gros,49314,253294,2022-04-11
CASH_OUT,41141,Julie Robin de Gros,253294,212153,Agence_moov_Ouidah,300000,258859,2022-04-19
CASH_IN,242499,Agence_moov_Ouidah,300000,57501,Julie Robin de Gros,212153,454652,2022-04-19
TRANSFER,3434,Marthe Guillet,3882,448,Julie Robin de Gros,454652,458086,2022-04-20
CASH_OUT,318047,Julie Robin de Gros,458086,140039,Agence_moov_Abomey,300000,-18047,2022-04-24
CASH_OUT,137125,Julie Robin de Gros,140039,2914,Agence_moov_Ouidah,300000,162875,2022-04-24
CASH_OUT,2023,Julie Robin de Gros,2914,891,Agence_moov_Ouidah,300000,297977,2022-04-25
TRANSFER,554,Julie Robin de Gros,891,337,Agnès Baron,563979,563425,2022-04-25
CASH_OUT,336,Julie Robin de Gros,337,1,Agence_moov_Abomey,300000,299664,2022-04-25
CASH_IN,8012,Agence_moov_Abomey,300000,291988,Julie Robin de Gros,1,8013,2022-04-25
CASH_IN,291094,Agence_moov_Ouidah,300000,8906,Luc-Tristan Moreau,-165914,125180,2022-04-06
TRANSFER,51816,Luc-Tristan Moreau,125180,73364,Émile Hebert,147048,95232,2022-04-06
CASH_OUT,1386,Luc-Tristan Moreau,73364,71978,Agence_moov_Abomey,300000,298614,2022-04-07
CASH_OUT,33169,Luc-Tristan Moreau,71978,38809,Agence_moov_Abomey,300000,266831,2022-04-10
CASH_IN,191254,Agence_moov_Ouidah,300000,108746,Luc-Tristan Moreau,38809,230063,2022-04-12
CASH_OUT,155834,Luc-Tristan Moreau,230063,74229,Agence_moov_Cotonou,300000,144166,2022-04-18
TRANSFER,88611,Adrienne Arnaud,206221,117610,Luc-Tristan Moreau,74229,162840,2022-04-20
CASH_IN,230959,Agence_moov_Cotonou,300000,69041,Luc-Tristan Moreau,162840,393799,2022-04-22
CASH_IN,164236,Agence_moov_Abomey,300000,135764,Thierry Dos Santos-Le Roux,-344003,-179767,2022-04-01
CASH_IN,231595,Agence_moov_Abomey,300000,68405,Thierry Dos Santos-Le Roux,-179767,51828,2022-04-01
CASH_OUT,49382,Thierry Dos Santos-Le Roux,51828,2446,Agence_moov_Ouidah,300000,250618,2022-04-03
TRANSFER,136449,Laurent Perrot,391856,255407,Thierry Dos Santos-Le Roux,2446,138895,2022-04-04
CASH_OUT,120669,Thierry Dos Santos-Le Roux,138895,18226,Agence_moov_Abomey,300000,179331,2022-04-05
CASH_IN,17666,Agence_moov_Abomey,300000,282334,Thierry Dos Santos-Le Roux,18226,35892,2022-04-08
CASH_IN,54633,Agence_moov_Cotonou,300000,245367,Thierry Dos Santos-Le Roux,35892,90525,2022-04-10
CASH_OUT,47718,Thierry Dos Santos-Le Roux,90525,42807,Agence_moov_Ouidah,300000,252282,2022-04-10
CASH_OUT,42485,Thierry Dos Santos-Le Roux,42807,322,Agence_moov_Cotonou,300000,257515,2022-04-12
TRANSFER,202,Thierry Dos Santos-Le Roux,322,120,Marianne Descamps,408395,408193,2022-04-16
CASH_OUT,101,Thierry Dos Santos-Le Roux,120,19,Agence_moov_Cotonou,300000,299899,2022-04-16
CASH_IN,279202,Agence_moov_Abomey,300000,20798,Thierry Dos Santos-Le Roux,19,279221,2022-04-18
CASH_IN,213598,Agence_moov_Abomey,300000,86402,Thierry Dos Santos-Le Roux,279221,492819,2022-04-20
CASH_IN,10604,Agence_moov_Cotonou,300000,289396,Thierry Dos Santos-Le Roux,492819,503423,2022-04-21
CASH_OUT,132791,Thierry Dos Santos-Le Roux,503423,370632,Agence_moov_Ouidah,300000,167209,2022-04-24
TRANSFER,312679,Isaac Le Pinto,328469,15790,Thierry Dos Santos-Le Roux,370632,683311,2022-04-25
TRANSFER,418378,Océane Boutin,1055427,637049,Laurent Besson,58206,-360172,2022-04-01
TRANSFER,330372,Océane Boutin,637049,306677,Auguste Bousquet,57552,-272820,2022-04-09
CASH_OUT,71168,Océane Boutin,306677,235509,Agence_moov_Ouidah,300000,228832,2022-04-09
CASH_OUT,102541,Océane Boutin,235509,132968,Agence_moov_Abomey,300000,197459,2022-04-10
CASH_OUT,8653,Océane Boutin,132968,124315,Agence_moov_Ouidah,300000,291347,2022-04-10
TRANSFER,2763,Océane Boutin,124315,121552,Vincent-Grégoire Brunet,185452,182689,2022-04-11
TRANSFER,190,Marthe Guillet,448,258,Océane Boutin,121552,121742,2022-04-11
TRANSFER,118336,Océane Boutin,121742,3406,Noël Hamel,1718100,1599764,2022-04-12
TRANSFER,42744,Nicolas Grondin de la Pinto,53553,10809,Océane Boutin,3406,46150,2022-04-13
TRANSFER,38152,Stéphanie Bonneau,38394,242,Océane Boutin,46150,84302,2022-04-14
TRANSFER,97325,Marianne Descamps,408193,310868,Océane Boutin,84302,181627,2022-04-15
CASH_OUT,129713,Océane Boutin,181627,51914,Agence_moov_Cotonou,300000,170287,2022-04-16
CASH_OUT,30895,Océane Boutin,51914,21019,Agence_moov_Cotonou,300000,269105,2022-04-19
CASH_IN,117124,Agence_moov_Ouidah,300000,182876,Océane Boutin,21019,138143,2022-04-20
TRANSFER,11860,Océane Boutin,138143,126283,Bernadette Fabre,879827,867967,2022-04-20
CASH_IN,134501,Agence_moov_Cotonou,300000,165499,Océane Boutin,126283,260784,2022-04-20
CASH_IN,298776,Agence_moov_Cotonou,300000,1224,Océane Boutin,260784,559560,2022-04-23
CASH_OUT,506811,Océane Boutin,559560,52749,Agence_moov_Ouidah,300000,-206811,2022-04-24
TRANSFER,38747,Océane Boutin,52749,14002,Emmanuel Bousquet,276283,237536,2022-04-25
CASH_IN,44036,Agence_moov_Abomey,300000,255964,Océane Boutin,14002,58038,2022-04-26
CASH_IN,189878,Agence_moov_Abomey,300000,110122,Auguste Bousquet,-272820,-82942,2022-04-01
CASH_IN,245089,Agence_moov_Cotonou,300000,54911,Auguste Bousquet,-82942,162147,2022-04-02
TRANSFER,5563,Nicolas Grondin de la Pinto,10809,5246,Auguste Bousquet,162147,167710,2022-04-02
CASH_OUT,37517,Auguste Bousquet,167710,130193,Agence_moov_Cotonou,300000,262483,2022-04-03
TRANSFER,14315,Auguste Bousquet,130193,115878,Emmanuel Bousquet,237536,223221,2022-04-03
TRANSFER,103119,Auguste Bousquet,115878,12759,Sabine Imbert,201673,98554,2022-04-04
CASH_IN,120764,Agence_moov_Abomey,300000,179236,Auguste Bousquet,12759,133523,2022-04-04
TRANSFER,33602,Auguste Bousquet,133523,99921,Agnès Baron,563425,529823,2022-04-05
CASH_IN,77067,Agence_moov_Ouidah,300000,222933,Auguste Bousquet,99921,176988,2022-04-05
CASH_OUT,25703,Auguste Bousquet,176988,151285,Agence_moov_Abomey,300000,274297,2022-04-10
CASH_OUT,114878,Auguste Bousquet,151285,36407,Agence_moov_Ouidah,300000,185122,2022-04-12
CASH_IN,182440,Agence_moov_Cotonou,300000,117560,Auguste Bousquet,36407,218847,2022-04-15
CASH_IN,272197,Agence_moov_Cotonou,300000,27803,Auguste Bousquet,218847,491044,2022-04-17
CASH_IN,145043,Agence_moov_Ouidah,300000,154957,Auguste Bousquet,491044,636087,2022-04-18
CASH_OUT,153654,Auguste Bousquet,636087,482433,Agence_moov_Abomey,300000,146346,2022-04-18
CASH_IN,140590,Agence_moov_Abomey,300000,159410,Auguste Bousquet,482433,623023,2022-04-21
TRANSFER,2079,Vincent-Philippe Rossi,7622,5543,Auguste Bousquet,623023,625102,2022-04-22
TRANSFER,455924,Auguste Bousquet,625102,169178,Émile Hebert,95232,-360692,2022-04-24
CASH_IN,25778,Agence_moov_Abomey,300000,274222,Auguste Bousquet,169178,194956,2022-04-24
CASH_OUT,91540,Auguste Bousquet,194956,103416,Agence_moov_Cotonou,300000,208460,2022-04-26
CASH_OUT,2939,Vincent-Philippe Rossi,5543,2604,Agence_moov_Abomey,300000,297061,2022-04-04
TRANSFER,587346,Clémence Bertin,977076,389730,Vincent-Philippe Rossi,2604,589950,2022-04-06
TRANSFER,1323856,Noël Hamel,1599764,275908,Vincent-Philippe Rossi,589950,1913806,2022-04-08
TRANSFER,7116,Vincent-Philippe Rossi,1913806,1906690,Agnès Baron,529823,522707,2022-04-11
CASH_IN,271382,Agence_moov_Cotonou,300000,28618,Vincent-Philippe Rossi,1906690,2178072,2022-04-13
CASH_IN,213224,Agence_moov_Cotonou,300000,86776,Vincent-Philippe Rossi,2178072,2391296,2022-04-13
CASH_IN,89497,Agence_moov_Cotonou,300000,210503,Vincent-Philippe Rossi,2391296,2480793,2022-04-16
CASH_IN,121929,Agence_moov_Ouidah,300000,178071,Vincent-Philippe Rossi,2480793,2602722,2022-04-17
TRANSFER,234361,Marianne Descamps,310868,76507,Vincent-Philippe Rossi,2602722,2837083,2022-04-17
CASH_IN,31919,Agence_moov_Ouidah,300000,268081,Vincent-Philippe Rossi,2837083,2869002,2022-04-18
TRANSFER,111593,Maryse Reynaud-Michaud,263379,151786,Vincent-Philippe Rossi,2869002,2980595,2022-04-20
CASH_OUT,274943,Vincent-Philippe Rossi,2980595,2705652,Agence_moov_Ouidah,300000,25057,2022-04-22
TRANSFER,45191,Luc Camus,121948,76757,Vincent-Philippe Rossi,2705652,2750843,2022-04-23
CASH_OUT,2378941,Vincent-Philippe Rossi,2750843,371902,Agence_moov_Abomey,300000,-2078941,2022-04-24
TRANSFER,191037,Vincent-Philippe Rossi,371902,180865,Clémence Bertin,389730,198693,2022-04-25
CASH_OUT,175060,Vincent-Philippe Rossi,180865,5805,Agence_moov_Cotonou,300000,124940,2022-04-26
TRANSFER,9600,Adrienne Arnaud,117610,108010,Emmanuel Bousquet,223221,213621,2022-04-12
CASH_IN,109913,Agence_moov_Ouidah,300000,190087,Adrienne Arnaud,108010,217923,2022-04-12
CASH_OUT,135457,Adrienne Arnaud,217923,82466,Agence_moov_Abomey,300000,164543,2022-04-13
CASH_OUT,34780,Adrienne Arnaud,82466,47686,Agence_moov_Abomey,300000,265220,2022-04-18
TRANSFER,11206,Adrienne Arnaud,47686,36480,Agnès Baron,522707,511501,2022-04-21
CASH_IN,127244,Agence_moov_Abomey,300000,172756,Adrienne Arnaud,36480,163724,2022-04-23
CASH_IN,278607,Agence_moov_Ouidah,300000,21393,Marthe Pichon,-61689,216918,2022-04-01
TRANSFER,118494,Marthe Pichon,216918,98424,Joséphine Weber du Bonnin,247285,128791,2022-04-02
TRANSFER,65464,Marthe Pichon,98424,32960,Matthieu Renard,20625,-44839,2022-04-07
TRANSFER,49468,Sabine Imbert,98554,49086,Marthe Pichon,32960,82428,2022-04-09
CASH_OUT,67611,Marthe Pichon,82428,14817,Agence_moov_Ouidah,300000,232389,2022-04-12
CASH_OUT,2265,Marthe Pichon,14817,12552,Agence_moov_Abomey,300000,297735,2022-04-15
CASH_IN,85019,Agence_moov_Abomey,300000,214981,Marthe Pichon,12552,97571,2022-04-16
TRANSFER,132,Stéphanie Bonneau,242,110,Marthe Pichon,97571,97703,2022-04-20
CASH_IN,171034,Agence_moov_Ouidah,300000,128966,Marthe Pichon,97703,268737,2022-04-22
TRANSFER,145898,Marthe Pichon,268737,122839,Sabine Imbert,49086,-96812,2022-04-24
CASH_OUT,30153,Marthe Pichon,122839,92686,Agence_moov_Abomey,300000,269847,2022-04-26
CASH_IN,123850,Agence_moov_Cotonou,300000,176150,Marthe Pichon,92686,216536,2022-04-27
TRANSFER,38325,Marthe Pichon,216536,178211,Joséphine Weber du Bonnin,128791,90466,2022-04-27
TRANSFER,136774,Marthe Pichon,178211,41437,Maryse Reynaud-Michaud,151786,15012,2022-04-27
TRANSFER,99443,Christine-Constance Gauthier,107579,8136,Joséphine Weber du Bonnin,90466,189909,2022-04-05
TRANSFER,4934,Isaac Le Pinto,15790,10856,Joséphine Weber du Bonnin,189909,194843,2022-04-06
CASH_IN,231686,Agence_moov_Cotonou,300000,68314,Joséphine Weber du Bonnin,194843,426529,2022-04-08
CASH_IN,119880,Agence_moov_Abomey,300000,180120,Joséphine Weber du Bonnin,426529,546409,2022-04-13
TRANSFER,61424,Benoît Verdier,337019,275595,Joséphine Weber du Bonnin,546409,607833,2022-04-18
CASH_IN,290347,Agence_moov_Ouidah,300000,9653,Joséphine Weber du Bonnin,607833,898180,2022-04-19
CASH_IN,231169,Agence_moov_Cotonou,300000,68831,Joséphine Weber du Bonnin,898180,1129349,2022-04-27
CASH_IN,44348,Agence_moov_Ouidah,300000,255652,Joséphine Weber du Bonnin,1129349,1173697,2022-04-27
TRANSFER,1281,Nicolas Grondin de la Pinto,5246,3965,Jacques-Antoine Gros,1592,2873,2022-04-01
TRANSFER,2817,Jacques-Antoine Gros,2873,56,Marthe Guillet,258,-2559,2022-04-02
CASH_IN,222986,Agence_moov_Cotonou,300000,77014,Jacques-Antoine Gros,56,223042,2022-04-03
CASH_OUT,174383,Jacques-Antoine Gros,223042,48659,Agence_moov_Abomey,300000,125617,2022-04-03
CASH_OUT,30958,Jacques-Antoine Gros,48659,17701,Agence_moov_Abomey,300000,269042,2022-04-04
CASH_OUT,5366,Jacques-Antoine Gros,17701,12335,Agence_moov_Abomey,300000,294634,2022-04-04
CASH_OUT,6363,Jacques-Antoine Gros,12335,5972,Agence_moov_Abomey,300000,293637,2022-04-07
CASH_OUT,648,Jacques-Antoine Gros,5972,5324,Agence_moov_Abomey,300000,299352,2022-04-08
TRANSFER,7606,Christine-Constance Gauthier,8136,530,Jacques-Antoine Gros,5324,12930,2022-04-09
CASH_OUT,7046,Jacques-Antoine Gros,12930,5884,Agence_moov_Ouidah,300000,292954,2022-04-13
CASH_OUT,5379,Jacques-Antoine Gros,5884,505,Agence_moov_Cotonou,300000,294621,2022-04-18
CASH_IN,29842,Agence_moov_Ouidah,300000,270158,Jacques-Antoine Gros,505,30347,2022-04-18
CASH_OUT,27518,Jacques-Antoine Gros,30347,2829,Agence_moov_Cotonou,300000,272482,2022-04-19
CASH_IN,204245,Agence_moov_Abomey,300000,95755,Jacques-Antoine Gros,2829,207074,2022-04-19
CASH_OUT,175251,Jacques-Antoine Gros,207074,31823,Agence_moov_Abomey,300000,124749,2022-04-20
TRANSFER,13549,Jacques-Antoine Gros,31823,18274,Christine-Constance Gauthier,530,-13019,2022-04-22
CASH_IN,90026,Agence_moov_Ouidah,300000,209974,Jacques-Antoine Gros,18274,108300,2022-04-23
CASH_IN,130581,Agence_moov_Ouidah,300000,169419,Jacques-Antoine Gros,108300,238881,2022-04-24
CASH_OUT,71749,Jacques-Antoine Gros,238881,167132,Agence_moov_Cotonou,300000,228251,2022-04-24
CASH_OUT,59538,Jacques-Antoine Gros,167132,107594,Agence_moov_Abomey,300000,240462,2022-04-25
CASH_OUT,76475,Benoît Verdier,275595,199120,Agence_moov_Abomey,300000,223525,2022-04-03
TRANSFER,163562,Clémence Bertin,198693,35131,Benoît Verdier,199120,362682,2022-04-03
CASH_OUT,31161,Benoît Verdier,362682,331521,Agence_moov_Cotonou,300000,268839,2022-04-11
CASH_OUT,211824,Benoît Verdier,331521,119697,Agence_moov_Abomey,300000,88176,2022-04-22
CASH_IN,168429,Agence_moov_Ouidah,300000,131571,Benoît Verdier,119697,288126,2022-04-25
CASH_OUT,150593,Benoît Verdier,288126,137533,Agence_moov_Cotonou,300000,149407,2022-04-27
TRANSFER,20851,Luc Camus,76757,55906,Bernadette Fabre,867967,888818,2022-04-01
TRANSFER,10608,Clémence Bertin,35131,24523,Bernadette Fabre,888818,899426,2022-04-05
CASH_IN,39270,Agence_moov_Ouidah,300000,260730,Bernadette Fabre,899426,938696,2022-04-06
CASH_OUT,740450,Bernadette Fabre,938696,198246,Agence_moov_Abomey,300000,-440450,2022-04-07
CASH_OUT,155261,Bernadette Fabre,198246,42985,Agence_moov_Abomey,300000,144739,2022-04-10
CASH_OUT,34101,Bernadette Fabre,42985,8884,Agence_moov_Cotonou,300000,265899,2022-04-11
CASH_IN,13217,Agence_moov_Abomey,300000,286783,Bernadette Fabre,8884,22101,2022-04-14
CASH_IN,14781,Agence_moov_Cotonou,300000,285219,Bernadette Fabre,22101,36882,2022-04-16
CASH_OUT,18981,Bernadette Fabre,36882,17901,Agence_moov_Cotonou,300000,281019,2022-04-17
CASH_OUT,15037,Bernadette Fabre,17901,2864,Agence_moov_Cotonou,300000,284963,2022-04-22
TRANSFER,109,Stéphanie Bonneau,110,1,Bernadette Fabre,2864,2973,2022-04-23
CASH_OUT,2052,Bernadette Fabre,2973,921,Agence_moov_Cotonou,300000,297948,2022-04-25
TRANSFER,487,Bernadette Fabre,921,434,Vincent-Grégoire Brunet,182689,182202,2022-04-25
CASH_OUT,302,Bernadette Fabre,434,132,Agence_moov_Cotonou,300000,299698,2022-04-26
CASH_IN,236511,Agence_moov_Abomey,300000,63489,Bernadette Fabre,132,236643,2022-04-26
CASH_IN,238137,Agence_moov_Cotonou,300000,61863,Margot Renaud de Lacombe,-191701,46436,2022-04-01
TRANSFER,22986,Margot Renaud de Lacombe,46436,23450,Marianne Descamps,76507,53521,2022-04-01
CASH_OUT,17702,Margot Renaud de Lacombe,23450,5748,Agence_moov_Abomey,300000,282298,2022-04-05
CASH_OUT,3290,Margot Renaud de Lacombe,5748,2458,Agence_moov_Ouidah,300000,296710,2022-04-10
CASH_IN,59736,Agence_moov_Abomey,300000,240264,Margot Renaud de Lacombe,2458,62194,2022-04-15
CASH_OUT,45764,Margot Renaud de Lacombe,62194,16430,Agence_moov_Cotonou,300000,254236,2022-04-19
CASH_IN,287158,Agence_moov_Cotonou,300000,12842,Margot Renaud de Lacombe,16430,303588,2022-04-21
CASH_IN,43832,Agence_moov_Ouidah,300000,256168,Margot Renaud de Lacombe,303588,347420,2022-04-27
CASH_IN,139488,Agence_moov_Ouidah,300000,160512,Stéphane-Timothée Pineau,-12565,126923,2022-04-06
TRANSFER,24772,Maryse Lebreton,85241,60469,Stéphane-Timothée Pineau,126923,151695,2022-04-06
TRANSFER,60423,Stéphane-Timothée Pineau,151695,91272,Isaac Le Pinto,10856,-49567,2022-04-08
CASH_IN,96411,Agence_moov_Cotonou,300000,203589,Stéphane-Timothée Pineau,91272,187683,2022-04-10
CASH_IN,200441,Agence_moov_Cotonou,300000,99559,Stéphane-Timothée Pineau,187683,388124,2022-04-11
CASH_OUT,64834,Stéphane-Timothée Pineau,388124,323290,Agence_moov_Cotonou,300000,235166,2022-04-12
CASH_IN,270062,Agence_moov_Abomey,300000,29938,Stéphane-Timothée Pineau,323290,593352,2022-04-12
CASH_OUT,533043,Stéphane-Timothée Pineau,593352,60309,Agence_moov_Cotonou,300000,-233043,2022-04-14
CASH_IN,108977,Agence_moov_Cotonou,300000,191023,Stéphane-Timothée Pineau,60309,169286,2022-04-15
CASH_OUT,30189,Stéphane-Timothée Pineau,169286,139097,Agence_moov_Cotonou,300000,269811,2022-04-17
CASH_IN,126493,Agence_moov_Cotonou,300000,173507,Stéphane-Timothée Pineau,139097,265590,2022-04-19
TRANSFER,2142,Maryse Reynaud-Michaud,15012,12870,Stéphane-Timothée Pineau,265590,267732,2022-04-19
CASH_IN,241074,Agence_moov_Cotonou,300000,58926,Stéphane-Timothée Pineau,267732,508806,2022-04-19
TRANSFER,218700,Laurent Perrot,255407,36707,Stéphane-Timothée Pineau,508806,727506,2022-04-20
TRANSFER,257441,Stéphane-Timothée Pineau,727506,470065,Stéphane-Timothée Pineau,727506,984947,2022-04-22
CASH_IN,282882,Agence_moov_Abomey,300000,17118,Stéphane-Timothée Pineau,470065,752947,2022-04-22
TRANSFER,113406,Emmanuel Bousquet,213621,100215,Stéphane-Timothée Pineau,752947,866353,2022-04-22
CASH_OUT,282183,Stéphane-Timothée Pineau,866353,584170,Agence_moov_Abomey,300000,17817,2022-04-27
TRANSFER,7789,Marianne Descamps,53521,45732,Stéphane-Timothée Pineau,584170,591959,2022-04-27
CASH_OUT,502948,Stéphane-Timothée Pineau,591959,89011,Agence_moov_Abomey,300000,-202948,2022-04-27
CASH_IN,31142,Agence_moov_Ouidah,300000,268858,Frédéric Moreau,-508342,-477200,2022-04-02
CASH_IN,165032,Agence_moov_Cotonou,300000,134968,Frédéric Moreau,-477200,-312168,2022-04-06
CASH_IN,225032,Agence_moov_Ouidah,300000,74968,Frédéric Moreau,-312168,-87136,2022-04-08
CASH_IN,198925,Agence_moov_Abomey,300000,101075,Frédéric Moreau,-87136,111789,2022-04-08
TRANSFER,56480,Maryse Lebreton,60469,3989,Frédéric Moreau,111789,168269,2022-04-09
TRANSFER,38509,Frédéric Moreau,168269,129760,Luc Camus,55906,17397,2022-04-10
TRANSFER,27546,Frédéric Moreau,129760,102214,Vincent-Grégoire Brunet,182202,154656,2022-04-11
CASH_IN,160639,Agence_moov_Cotonou,300000,139361,Frédéric Moreau,102214,262853,2022-04-12
CASH_IN,223404,Agence_moov_Ouidah,300000,76596,Frédéric Moreau,262853,486257,2022-04-16
TRANSFER,408104,Frédéric Moreau,486257,78153,Frédéric Moreau,486257,78153,2022-04-22
TRANSFER,14619,Luc Camus,17397,2778,Frédéric Moreau,78153,92772,2022-04-24
CASH_IN,139283,Agence_moov_Cotonou,300000,160717,Frédéric Moreau,92772,232055,2022-04-27
CASH_OUT,175107,Frédéric Moreau,232055,56948,Agence_moov_Ouidah,300000,124893,2022-04-27
CASH_OUT,25129,Marianne Descamps,45732,20603,Agence_moov_Cotonou,300000,274871,2022-04-01
CASH_OUT,15299,Marianne Descamps,20603,5304,Agence_moov_Cotonou,300000,284701,2022-04-03
CASH_IN,164402,Agence_moov_Cotonou,300000,135598,Marianne Descamps,5304,169706,2022-04-07
CASH_IN,222460,Agence_moov_Ouidah,300000,77540,Marianne Descamps,169706,392166,2022-04-08
TRANSFER,297493,Marianne Descamps,392166,94673,Maryse Lebreton,3989,-293504,2022-04-08
CASH_IN,268281,Agence_moov_Abomey,300000,31719,Marianne Descamps,94673,362954,2022-04-08
TRANSFER,1368,Luc Camus,2778,1410,Marianne Descamps,362954,364322,2022-04-11
TRANSFER,15988,Laurent Perrot,36707,20719,Marianne Descamps,364322,380310,2022-04-11
CASH_OUT,94203,Marianne Descamps,380310,286107,Agence_moov_Abomey,300000,205797,2022-04-15
TRANSFER,29687,Marianne Descamps,286107,256420,Vincent-Grégoire Brunet,154656,124969,2022-04-16
CASH_IN,18943,Agence_moov_Ouidah,300000,281057,Marianne Descamps,256420,275363,2022-04-18
CASH_IN,153404,Agence_moov_Ouidah,300000,146596,Marianne Descamps,275363,428767,2022-04-20
TRANSFER,237148,Marianne Descamps,428767,191619,Laurent Perrot,20719,-216429,2022-04-20
CASH_IN,80133,Agence_moov_Cotonou,300000,219867,Marianne Descamps,191619,271752,2022-04-21
TRANSFER,12218,Maryse Reynaud-Michaud,12870,652,Marianne Descamps,271752,283970,2022-04-22
TRANSFER,204776,Marianne Descamps,283970,79194,Vincent-Grégoire Brunet,124969,-79807,2022-04-22
CASH_IN,111533,Agence_moov_Ouidah,300000,188467,Marianne Descamps,79194,190727,2022-04-23
CASH_OUT,107211,Marianne Descamps,190727,83516,Agence_moov_Ouidah,300000,192789,2022-04-23
TRANSFER,51808,Marianne Descamps,83516,31708,Agnès Baron,511501,459693,2022-04-24
CASH_IN,254834,Agence_moov_Abomey,300000,45166,Claudine Vallet,-63956,190878,2022-04-04
TRANSFER,189692,Claudine Vallet,190878,1186,Maryse Reynaud-Michaud,652,-189040,2022-04-05
CASH_IN,45589,Agence_moov_Abomey,300000,254411,Claudine Vallet,1186,46775,2022-04-08
TRANSFER,32649,Claudine Vallet,46775,14126,Luc Camus,1410,-31239,2022-04-11
CASH_IN,182611,Agence_moov_Abomey,300000,117389,Claudine Vallet,14126,196737,2022-04-12
TRANSFER,133557,Claudine Vallet,196737,63180,Noël Hamel,275908,142351,2022-04-15
TRANSFER,14729,Clémence Bertin,24523,9794,Claudine Vallet,63180,77909,2022-04-18
CASH_IN,184437,Agence_moov_Abomey,300000,115563,Claudine Vallet,77909,262346,2022-04-19
CASH_IN,249075,Agence_moov_Abomey,300000,50925,Claudine Vallet,262346,511421,2022-04-20
CASH_OUT,223605,Claudine Vallet,511421,287816,Agence_moov_Ouidah,300000,76395,2022-04-22
CASH_OUT,71329,Claudine Vallet,287816,216487,Agence_moov_Abomey,300000,228671,2022-04-22
TRANSFER,88595,Noël Hamel,142351,53756,Claudine Vallet,216487,305082,2022-04-25
TRANSFER,1607,Clémence Bertin,9794,8187,Claudine Vallet,305082,306689,2022-04-26
CASH_OUT,271755,Claudine Vallet,306689,34934,Agence_moov_Abomey,300000,28245,2022-04-26
TRANSFER,22778,Claudine Vallet,34934,12156,Agnès Baron,459693,436915,2022-04-26
CASH_IN,211160,Agence_moov_Cotonou,300000,88840,Sabine Imbert,-96812,114348,2022-04-01
CASH_OUT,25131,Sabine Imbert,114348,89217,Agence_moov_Cotonou,300000,274869,2022-04-02
CASH_OUT,79873,Sabine Imbert,89217,9344,Agence_moov_Cotonou,300000,220127,2022-04-04
TRANSFER,1156,Agnès Baron,436915,435759,Sabine Imbert,9344,10500,2022-04-10
CASH_IN,176212,Agence_moov_Abomey,300000,123788,Sabine Imbert,10500,186712,2022-04-17
CASH_OUT,97705,Sabine Imbert,186712,89007,Agence_moov_Cotonou,300000,202295,2022-04-18
CASH_IN,78537,Agence_moov_Abomey,300000,221463,Sabine Imbert,89007,167544,2022-04-24
CASH_IN,263408,Agence_moov_Ouidah,300000,36592,Sabine Imbert,167544,430952,2022-04-26
CASH_IN,49227,Agence_moov_Ouidah,300000,250773,Marthe Guillet,-2559,46668,2022-04-01
TRANSFER,89820,Agnès Baron,435759,345939,Marthe Guillet,46668,136488,2022-04-03
TRANSFER,27014,Marthe Guillet,136488,109474,Clémence Bertin,8187,-18827,2022-04-03
TRANSFER,14889,Emmanuel Bousquet,100215,85326,Marthe Guillet,109474,124363,2022-04-03
CASH_IN,230970,Agence_moov_Abomey,300000,69030,Marthe Guillet,124363,355333,2022-04-07
CASH_IN,42504,Agence_moov_Ouidah,300000,257496,Marthe Guillet,355333,397837,2022-04-09
CASH_OUT,292988,Marthe Guillet,397837,104849,Agence_moov_Cotonou,300000,7012,2022-04-12
TRANSFER,77824,Marthe Guillet,104849,27025,Emmanuel Bousquet,85326,7502,2022-04-12
CASH_IN,45146,Agence_moov_Cotonou,300000,254854,Marthe Guillet,27025,72171,2022-04-17
CASH_IN,241859,Agence_moov_Abomey,300000,58141,Marthe Guillet,72171,314030,2022-04-17
CASH_OUT,78099,Marthe Guillet,314030,235931,Agence_moov_Ouidah,300000,221901,2022-04-20
CASH_IN,231560,Agence_moov_Ouidah,300000,68440,Marthe Guillet,235931,467491,2022-04-22
CASH_OUT,32236,Marthe Guillet,467491,435255,Agence_moov_Cotonou,300000,267764,2022-04-24
TRANSFER,290701,Marthe Guillet,435255,144554,Agnès Baron,345939,55238,2022-04-25
CASH_IN,238201,Agence_moov_Abomey,300000,61799,Marthe Guillet,144554,382755,2022-04-26
CASH_IN,71405,Agence_moov_Cotonou,300000,228595,Marthe Guillet,382755,454160,2022-04-26
TRANSFER,36257,Agnès Baron,55238,18981,Marthe Guillet,454160,490417,2022-04-26
CASH_OUT,327862,Marthe Guillet,490417,162555,Agence_moov_Ouidah,300000,-27862,2022-04-27
CASH_IN,38782,Agence_moov_Cotonou,300000,261218,Émile Hebert,-360692,-321910,2022-04-01
CASH_IN,218277,Agence_moov_Cotonou,300000,81723,Émile Hebert,-321910,-103633,2022-04-01
CASH_IN,178445,Agence_moov_Ouidah,300000,121555,Émile Hebert,-103633,74812,2022-04-02
TRANSFER,21892,Noël Hamel,53756,31864,Émile Hebert,74812,96704,2022-04-03
TRANSFER,83696,Émile Hebert,96704,13008,Noël Hamel,31864,-51832,2022-04-03
CASH_IN,109767,Agence_moov_Ouidah,300000,190233,Émile Hebert,13008,122775,2022-04-03
TRANSFER,1237,Émile Hebert,122775,121538,Émile Hebert,122775,121538,2022-04-04
CASH_IN,194254,Agence_moov_Abomey,300000,105746,Émile Hebert,121538,315792,2022-04-09
CASH_OUT,39662,Émile Hebert,315792,276130,Agence_moov_Ouidah,300000,260338,2022-04-09
TRANSFER,12132,Agnès Baron,18981,6849,Émile Hebert,276130,288262,2022-04-11
CASH_IN,58055,Agence_moov_Cotonou,300000,241945,Émile Hebert,288262,346317,2022-04-12
CASH_IN,149858,Agence_moov_Ouidah,300000,150142,Émile Hebert,346317,496175,2022-04-17
CASH_IN,78122,Agence_moov_Cotonou,300000,221878,Émile Hebert,496175,574297,2022-04-19
TRANSFER,482208,Émile Hebert,574297,92089,Émile Hebert,574297,1056505,2022-04-20
CASH_IN,13244,Agence_moov_Ouidah,300000,286756,Émile Hebert,92089,105333,2022-04-20
CASH_OUT,80317,Émile Hebert,105333,25016,Agence_moov_Ouidah,300000,219683,2022-04-24
CASH_IN,280168,Agence_moov_Abomey,300000,19832,Laurence Carlier,-312443,-32275,2022-04-05
CASH_IN,183913,Agence_moov_Ouidah,300000,116087,Laurence Carlier,-32275,151638,2022-04-06
CASH_OUT,135015,Laurence Carlier,151638,16623,Agence_moov_Abomey,300000,164985,2022-04-09
CASH_OUT,14912,Laurence Carlier,16623,1711,Agence_moov_Abomey,300000,285088,2022-04-10
CASH_OUT,821,Laurence Carlier,1711,890,Agence_moov_Cotonou,300000,299179,2022-04-15
CASH_OUT,252,Laurence Carlier,890,638,Agence_moov_Ouidah,300000,299748,2022-04-15
CASH_OUT,551,Laurence Carlier,638,87,Agence_moov_Abomey,300000,299449,2022-04-16
CASH_IN,233650,Agence_moov_Ouidah,300000,66350,Laurence Carlier,87,233737,2022-04-17
CASH_OUT,185739,Laurence Carlier,233737,47998,Agence_moov_Abomey,300000,114261,2022-04-18
CASH_OUT,20191,Laurence Carlier,47998,27807,Agence_moov_Ouidah,300000,279809,2022-04-23
CASH_OUT,17504,Laurence Carlier,27807,10303,Agence_moov_Abomey,300000,282496,2022-04-24
CASH_OUT,652,Laurence Carlier,10303,9651,Agence_moov_Ouidah,300000,299348,2022-04-25
CASH_OUT,5222,Laurence Carlier,9651,4429,Agence_moov_Cotonou,300000,294778,2022-04-26
CASH_OUT,2498,Laurence Carlier,4429,1931,Agence_moov_Cotonou,300000,297502,2022-04-27
CASH_IN,195153,Agence_moov_Cotonou,300000,104847,Laurent Besson,-360172,-165019,2022-04-01
CASH_IN,282952,Agence_moov_Cotonou,300000,17048,Laurent Besson,-165019,117933,2022-04-02
TRANSFER,98565,Laurent Besson,117933,19368,Laurent Besson,117933,216498,2022-04-04
TRANSFER,17787,Laurent Besson,19368,1581,Laurent Besson,19368,1581,2022-04-07
TRANSFER,132,Laurent Besson,1581,1449,Laurent Besson,1581,1713,2022-04-07
TRANSFER,820,Laurent Besson,1449,629,Laurent Besson,1449,629,2022-04-07
TRANSFER,423,Laurent Besson,629,206,Laurent Besson,629,1052,2022-04-07
CASH_OUT,201,Laurent Besson,206,5,Agence_moov_Abomey,300000,299799,2022-04-08
CASH_IN,31150,Agence_moov_Cotonou,300000,268850,Laurent Besson,5,31155,2022-04-09
TRANSFER,30749,Laurent Besson,31155,406,Laurent Besson,31155,406,2022-04-10
CASH_OUT,294,Laurent Besson,406,112,Agence_moov_Cotonou,300000,299706,2022-04-17
CASH_IN,296983,Agence_moov_Cotonou,300000,3017,Laurent Besson,112,297095,2022-04-21
CASH_IN,118154,Agence_moov_Cotonou,300000,181846,Laurent Besson,297095,415249,2022-04-22
CASH_OUT,385678,Laurent Besson,415249,29571,Agence_moov_Ouidah,300000,-85678,2022-04-24
CASH_OUT,18601,Laurent Besson,29571,10970,Agence_moov_Cotonou,300000,281399,2022-04-25
CASH_OUT,7990,Laurent Besson,10970,2980,Agence_moov_Cotonou,300000,292010,2022-04-26
CASH_IN,276803,Agence_moov_Cotonou,300000,23197,Aimé Allain,-55035,221768,2022-04-04
TRANSFER,133912,Aimé Allain,221768,87856,Aimé Allain,221768,87856,2022-04-04
CASH_IN,9225,Agence_moov_Cotonou,300000,290775,Aimé Allain,87856,97081,2022-04-13
TRANSFER,26887,Aimé Allain,97081,70194,Aimé Allain,97081,123968,2022-04-17
CASH_IN,147597,Agence_moov_Cotonou,300000,152403,Aimé Allain,70194,217791,2022-04-20
CASH_OUT,86118,Aimé Allain,217791,131673,Agence_moov_Abomey,300000,213882,2022-04-22
CASH_OUT,118160,Aimé Allain,131673,13513,Agence_moov_Abomey,300000,181840,2022-04-26
CASH_OUT,918,Aimé Allain,13513,12595,Agence_moov_Ouidah,300000,299082,2022-04-27
CASH_IN,22267,Agence_moov_Abomey,300000,277733,Xavier-Stéphane Ollivier,-55390,-33123,2022-04-03
CASH_IN,273642,Agence_moov_Abomey,300000,26358,Xavier-Stéphane Ollivier,-33123,240519,2022-04-04
TRANSFER,51621,Xavier-Stéphane Ollivier,240519,188898,Xavier-Stéphane Ollivier,240519,292140,2022-04-08
CASH_OUT,64335,Xavier-Stéphane Ollivier,188898,124563,Agence_moov_Abomey,300000,235665,2022-04-13
CASH_OUT,112387,Xavier-Stéphane Ollivier,124563,12176,Agence_moov_Cotonou,300000,187613,2022-04-23
CASH_IN,243917,Agence_moov_Abomey,300000,56083,Xavier-Stéphane Ollivier,12176,256093,2022-04-23
CASH_IN,272240,Agence_moov_Ouidah,300000,27760,Xavier-Stéphane Ollivier,256093,528333,2022-04-24
CASH_IN,86070,Agence_moov_Ouidah,300000,213930,Laurent Perrot,-216429,-130359,2022-04-03
CASH_IN,13607,Agence_moov_Ouidah,300000,286393,Laurent Perrot,-130359,-116752,2022-04-05
CASH_IN,24622,Agence_moov_Abomey,300000,275378,Laurent Perrot,-116752,-92130,2022-04-07
CASH_IN,197516,Agence_moov_Cotonou,300000,102484,Laurent Perrot,-92130,105386,2022-04-08
CASH_IN,166537,Agence_moov_Abomey,300000,133463,Laurent Perrot,105386,271923,2022-04-09
CASH_IN,200130,Agence_moov_Abomey,300000,99870,Laurent Perrot,271923,472053,2022-04-12
CASH_IN,216317,Agence_moov_Abomey,300000,83683,Laurent Perrot,472053,688370,2022-04-14
TRANSFER,65274,Laurent Perrot,688370,623096,Laurent Perrot,688370,623096,2022-04-15
CASH_OUT,109833,Laurent Perrot,623096,513263,Agence_moov_Ouidah,300000,190167,2022-04-17
TRANSFER,443619,Laurent Perrot,513263,69644,Laurent Perrot,513263,956882,2022-04-17
CASH_OUT,55268,Laurent Perrot,69644,14376,Agence_moov_Ouidah,300000,244732,2022-04-23
CASH_IN,216527,Agence_moov_Abomey,300000,83473,Laurent Perrot,14376,230903,2022-04-23
CASH_IN,27085,Agence_moov_Abomey,300000,272915,Laurent Perrot,230903,257988,2022-04-23
CASH_OUT,141658,Laurent Perrot,257988,116330,Agence_moov_Ouidah,300000,158342,2022-04-24
CASH_OUT,34441,Laurent Perrot,116330,81889,Agence_moov_Cotonou,300000,265559,2022-04-25
CASH_IN,62837,Agence_moov_Abomey,300000,237163,Christine-Constance Gauthier,-13019,49818,2022-04-02
CASH_IN,92756,Agence_moov_Ouidah,300000,207244,Christine-Constance Gauthier,49818,142574,2022-04-03
TRANSFER,120041,Christine-Constance Gauthier,142574,22533,Christine-Constance Gauthier,142574,262615,2022-04-03
TRANSFER,629,Christine-Constance Gauthier,22533,21904,Christine-Constance Gauthier,22533,21904,2022-04-04
TRANSFER,3778,Christine-Constance Gauthier,21904,18126,Christine-Constance Gauthier,21904,18126,2022-04-07
CASH_OUT,6980,Christine-Constance Gauthier,18126,11146,Agence_moov_Cotonou,300000,293020,2022-04-08
CASH_IN,250012,Agence_moov_Cotonou,300000,49988,Christine-Constance Gauthier,11146,261158,2022-04-08
CASH_IN,170623,Agence_moov_Abomey,300000,129377,Christine-Constance Gauthier,261158,431781,2022-04-11
CASH_OUT,174935,Christine-Constance Gauthier,431781,256846,Agence_moov_Ouidah,300000,125065,2022-04-11
CASH_OUT,256415,Christine-Constance Gauthier,256846,431,Agence_moov_Ouidah,300000,43585,2022-04-11
CASH_IN,269698,Agence_moov_Ouidah,300000,30302,Christine-Constance Gauthier,431,270129,2022-04-13
CASH_OUT,240029,Christine-Constance Gauthier,270129,30100,Agence_moov_Cotonou,300000,59971,2022-04-14
CASH_IN,192318,Agence_moov_Cotonou,300000,107682,Christine-Constance Gauthier,30100,222418,2022-04-17
CASH_IN,53369,Agence_moov_Abomey,300000,246631,Christine-Constance Gauthier,222418,275787,2022-04-17
CASH_OUT,37957,Christine-Constance Gauthier,275787,237830,Agence_moov_Ouidah,300000,262043,2022-04-24
CASH_IN,18831,Agence_moov_Abomey,300000,281169,Christine-Constance Gauthier,237830,256661,2022-04-26
CASH_IN,108947,Agence_moov_Ouidah,300000,191053,Arnaude Gaillard,-17461,91486,2022-04-01
CASH_OUT,65293,Arnaude Gaillard,91486,26193,Agence_moov_Abomey,300000,234707,2022-04-04
CASH_OUT,5941,Arnaude Gaillard,26193,20252,Agence_moov_Ouidah,300000,294059,2022-04-05
CASH_OUT,4277,Arnaude Gaillard,20252,15975,Agence_moov_Cotonou,300000,295723,2022-04-10
CASH_OUT,14559,Arnaude Gaillard,15975,1416,Agence_moov_Ouidah,300000,285441,2022-04-11
TRANSFER,727,Arnaude Gaillard,1416,689,Arnaude Gaillard,1416,2143,2022-04-11
CASH_IN,279686,Agence_moov_Ouidah,300000,20314,Arnaude Gaillard,689,280375,2022-04-14
TRANSFER,63824,Arnaude Gaillard,280375,216551,Arnaude Gaillard,280375,216551,2022-04-14
CASH_OUT,143978,Arnaude Gaillard,216551,72573,Agence_moov_Cotonou,300000,156022,2022-04-14
TRANSFER,41884,Arnaude Gaillard,72573,30689,Arnaude Gaillard,72573,30689,2022-04-15
TRANSFER,13790,Arnaude Gaillard,30689,16899,Arnaude Gaillard,30689,16899,2022-04-17
CASH_OUT,8760,Arnaude Gaillard,16899,8139,Agence_moov_Abomey,300000,291240,2022-04-18
CASH_OUT,3263,Arnaude Gaillard,8139,4876,Agence_moov_Abomey,300000,296737,2022-04-19
CASH_OUT,404,Arnaude Gaillard,4876,4472,Agence_moov_Abomey,300000,299596,2022-04-21
CASH_OUT,110,Arnaude Gaillard,4472,4362,Agence_moov_Ouidah,300000,299890,2022-04-23
CASH_OUT,987,Arnaude Gaillard,4362,3375,Agence_moov_Cotonou,300000,299013,2022-04-23
CASH_OUT,3251,Arnaude Gaillard,3375,124,Agence_moov_Ouidah,300000,296749,2022-04-26
CASH_IN,282145,Agence_moov_Cotonou,300000,17855,Arnaude Gaillard,124,282269,2022-04-27
CASH_IN,34317,Agence_moov_Ouidah,300000,265683,Adélaïde-Sophie Leclercq,-23141,11176,2022-04-02
TRANSFER,1677,Adélaïde-Sophie Leclercq,11176,9499,Adélaïde-Sophie Leclercq,11176,9499,2022-04-02
CASH_IN,230642,Agence_moov_Abomey,300000,69358,Adélaïde-Sophie Leclercq,9499,240141,2022-04-02
CASH_OUT,229599,Adélaïde-Sophie Leclercq,240141,10542,Agence_moov_Abomey,300000,70401,2022-04-11
CASH_IN,256314,Agence_moov_Abomey,300000,43686,Adélaïde-Sophie Leclercq,10542,266856,2022-04-13
CASH_OUT,196059,Adélaïde-Sophie Leclercq,266856,70797,Agence_moov_Abomey,300000,103941,2022-04-14
CASH_IN,42559,Agence_moov_Abomey,300000,257441,Adélaïde-Sophie Leclercq,70797,113356,2022-04-15
TRANSFER,12505,Adélaïde-Sophie Leclercq,113356,100851,Adélaïde-Sophie Leclercq,113356,100851,2022-04-17
CASH_IN,128353,Agence_moov_Ouidah,300000,171647,Adélaïde-Sophie Leclercq,100851,229204,2022-04-20
CASH_OUT,71278,Adélaïde-Sophie Leclercq,229204,157926,Agence_moov_Ouidah,300000,228722,2022-04-22
TRANSFER,139155,Adélaïde-Sophie Leclercq,157926,18771,Adélaïde-Sophie Leclercq,157926,18771,2022-04-23
CASH_OUT,1702,Adélaïde-Sophie Leclercq,18771,17069,Agence_moov_Abomey,300000,298298,2022-04-24
CASH_IN,99456,Agence_moov_Abomey,300000,200544,Adélaïde-Sophie Leclercq,17069,116525,2022-04-25
CASH_IN,62672,Agence_moov_Cotonou,300000,237328,Matthieu Renard,-44839,17833,2022-04-07
TRANSFER,14753,Matthieu Renard,17833,3080,Matthieu Renard,17833,3080,2022-04-08
CASH_IN,7286,Agence_moov_Ouidah,300000,292714,Matthieu Renard,3080,10366,2022-04-11
CASH_IN,238667,Agence_moov_Abomey,300000,61333,Matthieu Renard,10366,249033,2022-04-19
CASH_IN,291728,Agence_moov_Ouidah,300000,8272,Stéphanie Bonneau,1,291729,2022-04-01
CASH_IN,283469,Agence_moov_Ouidah,300000,16531,Stéphanie Bonneau,291729,575198,2022-04-02
TRANSFER,118075,Stéphanie Bonneau,575198,457123,Stéphanie Bonneau,575198,457123,2022-04-02
CASH_OUT,154336,Stéphanie Bonneau,457123,302787,Agence_moov_Abomey,300000,145664,2022-04-02
CASH_OUT,256593,Stéphanie Bonneau,302787,46194,Agence_moov_Abomey,300000,43407,2022-04-05
CASH_OUT,5237,Stéphanie Bonneau,46194,40957,Agence_moov_Cotonou,300000,294763,2022-04-05
CASH_IN,194960,Agence_moov_Cotonou,300000,105040,Stéphanie Bonneau,40957,235917,2022-04-07
CASH_OUT,103860,Stéphanie Bonneau,235917,132057,Agence_moov_Abomey,300000,196140,2022-04-11
CASH_OUT,84362,Stéphanie Bonneau,132057,47695,Agence_moov_Cotonou,300000,215638,2022-04-14
CASH_OUT,21678,Stéphanie Bonneau,47695,26017,Agence_moov_Ouidah,300000,278322,2022-04-17
CASH_IN,128653,Agence_moov_Ouidah,300000,171347,Maryse Lebreton,-293504,-164851,2022-04-04
CASH_IN,150465,Agence_moov_Ouidah,300000,149535,Maryse Lebreton,-164851,-14386,2022-04-05
CASH_IN,173953,Agence_moov_Abomey,300000,126047,Maryse Lebreton,-14386,159567,2022-04-10
TRANSFER,41072,Maryse Lebreton,159567,118495,Maryse Lebreton,159567,200639,2022-04-11
CASH_IN,223474,Agence_moov_Abomey,300000,76526,Maryse Lebreton,118495,341969,2022-04-13
TRANSFER,137869,Maryse Lebreton,341969,204100,Maryse Lebreton,341969,479838,2022-04-13
CASH_IN,245213,Agence_moov_Cotonou,300000,54787,Maryse Lebreton,204100,449313,2022-04-14
CASH_OUT,96051,Maryse Lebreton,449313,353262,Agence_moov_Cotonou,300000,203949,2022-04-15
CASH_OUT,89023,Maryse Lebreton,353262,264239,Agence_moov_Abomey,300000,210977,2022-04-16
CASH_OUT,77331,Maryse Lebreton,264239,186908,Agence_moov_Ouidah,300000,222669,2022-04-21
CASH_OUT,64861,Maryse Lebreton,186908,122047,Agence_moov_Ouidah,300000,235139,2022-04-24
CASH_IN,219770,Agence_moov_Cotonou,300000,80230,Maryse Lebreton,122047,341817,2022-04-25
CASH_IN,183499,Agence_moov_Ouidah,300000,116501,Vincent-Grégoire Brunet,-79807,103692,2022-04-01
TRANSFER,3948,Vincent-Grégoire Brunet,103692,99744,Vincent-Grégoire Brunet,103692,107640,2022-04-02
CASH_OUT,1265,Vincent-Grégoire Brunet,99744,98479,Agence_moov_Ouidah,300000,298735,2022-04-02
CASH_IN,95195,Agence_moov_Cotonou,300000,204805,Vincent-Grégoire Brunet,98479,193674,2022-04-04
CASH_OUT,34851,Vincent-Grégoire Brunet,193674,158823,Agence_moov_Ouidah,300000,265149,2022-04-06
CASH_OUT,85749,Vincent-Grégoire Brunet,158823,73074,Agence_moov_Ouidah,300000,214251,2022-04-06
CASH_OUT,16534,Vincent-Grégoire Brunet,73074,56540,Agence_moov_Ouidah,300000,283466,2022-04-06
CASH_OUT,34384,Vincent-Grégoire Brunet,56540,22156,Agence_moov_Cotonou,300000,265616,2022-04-07
CASH_OUT,10445,Vincent-Grégoire Brunet,22156,11711,Agence_moov_Abomey,300000,289555,2022-04-10
CASH_IN,223921,Agence_moov_Ouidah,300000,76079,Vincent-Grégoire Brunet,11711,235632,2022-04-14
CASH_IN,8006,Agence_moov_Cotonou,300000,291994,Vincent-Grégoire Brunet,235632,243638,2022-04-18
CASH_IN,179164,Agence_moov_Abomey,300000,120836,Vincent-Grégoire Brunet,243638,422802,2022-04-18
CASH_IN,48733,Agence_moov_Ouidah,300000,251267,Vincent-Grégoire Brunet,422802,471535,2022-04-23
CASH_OUT,432536,Vincent-Grégoire Brunet,471535,38999,Agence_moov_Abomey,300000,-132536,2022-04-23
CASH_OUT,20004,Vincent-Grégoire Brunet,38999,18995,Agence_moov_Ouidah,300000,279996,2022-04-24
CASH_OUT,12915,Vincent-Grégoire Brunet,18995,6080,Agence_moov_Cotonou,300000,287085,2022-04-26
CASH_IN,170258,Agence_moov_Ouidah,300000,129742,Vincent-Grégoire Brunet,6080,176338,2022-04-26
CASH_IN,57620,Agence_moov_Ouidah,300000,242380,Emmanuel-René Coulon,-117591,-59971,2022-04-03
CASH_IN,176850,Agence_moov_Abomey,300000,123150,Emmanuel-René Coulon,-59971,116879,2022-04-04
CASH_IN,292470,Agence_moov_Abomey,300000,7530,Emmanuel-René Coulon,116879,409349,2022-04-05
CASH_IN,92916,Agence_moov_Ouidah,300000,207084,Emmanuel-René Coulon,409349,502265,2022-04-05
CASH_IN,143892,Agence_moov_Ouidah,300000,156108,Emmanuel-René Coulon,502265,646157,2022-04-05
CASH_IN,270603,Agence_moov_Cotonou,300000,29397,Emmanuel-René Coulon,646157,916760,2022-04-07
TRANSFER,73126,Emmanuel-René Coulon,916760,843634,Emmanuel-René Coulon,916760,989886,2022-04-08
TRANSFER,756912,Emmanuel-René Coulon,843634,86722,Emmanuel-René Coulon,843634,1600546,2022-04-08
CASH_OUT,71707,Emmanuel-René Coulon,86722,15015,Agence_moov_Cotonou,300000,228293,2022-04-09
CASH_OUT,11822,Emmanuel-René Coulon,15015,3193,Agence_moov_Cotonou,300000,288178,2022-04-10
CASH_OUT,997,Emmanuel-René Coulon,3193,2196,Agence_moov_Cotonou,300000,299003,2022-04-12
CASH_IN,206563,Agence_moov_Ouidah,300000,93437,Emmanuel-René Coulon,2196,208759,2022-04-15
CASH_OUT,53582,Emmanuel-René Coulon,208759,155177,Agence_moov_Abomey,300000,246418,2022-04-16
CASH_IN,265970,Agence_moov_Cotonou,300000,34030,Emmanuel-René Coulon,155177,421147,2022-04-17
CASH_OUT,200677,Emmanuel-René Coulon,421147,220470,Agence_moov_Cotonou,300000,99323,2022-04-18
CASH_OUT,119036,Emmanuel-René Coulon,220470,101434,Agence_moov_Ouidah,300000,180964,2022-04-20
CASH_OUT,51801,Emmanuel-René Coulon,101434,49633,Agence_moov_Ouidah,300000,248199,2022-04-27
CASH_IN,134662,Agence_moov_Ouidah,300000,165338,Alfred Chrétien,-107303,27359,2022-04-07
TRANSFER,11261,Alfred Chrétien,27359,16098,Alfred Chrétien,27359,16098,2022-04-10
CASH_IN,49964,Agence_moov_Cotonou,300000,250036,Alfred Chrétien,16098,66062,2022-04-11
CASH_IN,265584,Agence_moov_Cotonou,300000,34416,Alfred Chrétien,66062,331646,2022-04-11
CASH_IN,160777,Agence_moov_Ouidah,300000,139223,Alfred Chrétien,331646,492423,2022-04-12
CASH_OUT,166049,Alfred Chrétien,492423,326374,Agence_moov_Cotonou,300000,133951,2022-04-14
CASH_OUT,124959,Alfred Chrétien,326374,201415,Agence_moov_Abomey,300000,175041,2022-04-27
CASH_IN,249902,Agence_moov_Ouidah,300000,50098,Emmanuelle Gilbert,-132693,117209,2022-04-01
CASH_OUT,94415,Emmanuelle Gilbert,117209,22794,Agence_moov_Cotonou,300000,205585,2022-04-02
TRANSFER,287,Emmanuelle Gilbert,22794,22507,Emmanuelle Gilbert,22794,23081,2022-04-02
CASH_IN,266447,Agence_moov_Ouidah,300000,33553,Emmanuelle Gilbert,22507,288954,2022-04-07
CASH_OUT,230688,Emmanuelle Gilbert,288954,58266,Agence_moov_Abomey,300000,69312,2022-04-07
CASH_OUT,6084,Emmanuelle Gilbert,58266,52182,Agence_moov_Cotonou,300000,293916,2022-04-10
CASH_IN,152592,Agence_moov_Ouidah,300000,147408,Emmanuelle Gilbert,52182,204774,2022-04-11
CASH_IN,216849,Agence_moov_Cotonou,300000,83151,Emmanuelle Gilbert,204774,421623,2022-04-12
TRANSFER,324805,Emmanuelle Gilbert,421623,96818,Emmanuelle Gilbert,421623,96818,2022-04-13
CASH_IN,286347,Agence_moov_Cotonou,300000,13653,Emmanuelle Gilbert,96818,383165,2022-04-18
CASH_IN,14776,Agence_moov_Cotonou,300000,285224,Emmanuelle Gilbert,383165,397941,2022-04-19
CASH_OUT,267777,Emmanuelle Gilbert,397941,130164,Agence_moov_Abomey,300000,32223,2022-04-19
CASH_IN,16355,Agence_moov_Cotonou,300000,283645,Emmanuelle Gilbert,130164,146519,2022-04-22
CASH_IN,151390,Agence_moov_Cotonou,300000,148610,Sébastien-Arthur Masse,-18106,133284,2022-04-01
CASH_OUT,131806,Sébastien-Arthur Masse,133284,1478,Agence_moov_Cotonou,300000,168194,2022-04-07
CASH_IN,24628,Agence_moov_Abomey,300000,275372,Sébastien-Arthur Masse,1478,26106,2022-04-09
CASH_IN,91449,Agence_moov_Ouidah,300000,208551,Sébastien-Arthur Masse,26106,117555,2022-04-18
CASH_OUT,77206,Sébastien-Arthur Masse,117555,40349,Agence_moov_Cotonou,300000,222794,2022-04-19
CASH_IN,288305,Agence_moov_Abomey,300000,11695,Sébastien-Arthur Masse,40349,328654,2022-04-26
CASH_IN,143327,Agence_moov_Ouidah,300000,156673,Clémence Bertin,-18827,124500,2022-04-03
CASH_IN,224674,Agence_moov_Cotonou,300000,75326,Clémence Bertin,124500,349174,2022-04-06
CASH_IN,102004,Agence_moov_Ouidah,300000,197996,Clémence Bertin,349174,451178,2022-04-11
CASH_IN,108127,Agence_moov_Abomey,300000,191873,Clémence Bertin,451178,559305,2022-04-14
CASH_IN,74469,Agence_moov_Ouidah,300000,225531,Clémence Bertin,559305,633774,2022-04-19
CASH_OUT,206101,Clémence Bertin,633774,427673,Agence_moov_Ouidah,300000,93899,2022-04-20
CASH_OUT,183757,Clémence Bertin,427673,243916,Agence_moov_Cotonou,300000,116243,2022-04-24
CASH_IN,262088,Agence_moov_Cotonou,300000,37912,Clémence Bertin,243916,506004,2022-04-25
CASH_IN,23938,Agence_moov_Cotonou,300000,276062,Isaac Le Pinto,-49567,-25629,2022-04-02
CASH_IN,208938,Agence_moov_Cotonou,300000,91062,Isaac Le Pinto,-25629,183309,2022-04-05
CASH_IN,49705,Agence_moov_Cotonou,300000,250295,Isaac Le Pinto,183309,233014,2022-04-06
TRANSFER,215185,Isaac Le Pinto,233014,17829,Isaac Le Pinto,233014,448199,2022-04-07
CASH_IN,244025,Agence_moov_Abomey,300000,55975,Isaac Le Pinto,17829,261854,2022-04-07
CASH_IN,207693,Agence_moov_Abomey,300000,92307,Isaac Le Pinto,261854,469547,2022-04-09
CASH_OUT,410829,Isaac Le Pinto,469547,58718,Agence_moov_Ouidah,300000,-110829,2022-04-14
CASH_IN,24323,Agence_moov_Cotonou,300000,275677,Isaac Le Pinto,58718,83041,2022-04-16
CASH_OUT,4163,Isaac Le Pinto,83041,78878,Agence_moov_Cotonou,300000,295837,2022-04-18
CASH_IN,1234,Agence_moov_Abomey,300000,298766,Isaac Le Pinto,78878,80112,2022-04-25
CASH_IN,240917,Agence_moov_Cotonou,300000,59083,Noël Hamel,-51832,189085,2022-04-05
CASH_IN,179742,Agence_moov_Cotonou,300000,120258,Noël Hamel,189085,368827,2022-04-09
CASH_OUT,91638,Noël Hamel,368827,277189,Agence_moov_Abomey,300000,208362,2022-04-10
CASH_OUT,102372,Noël Hamel,277189,174817,Agence_moov_Abomey,300000,197628,2022-04-12
CASH_IN,240241,Agence_moov_Cotonou,300000,59759,Noël Hamel,174817,415058,2022-04-16
CASH_OUT,21018,Noël Hamel,415058,394040,Agence_moov_Abomey,300000,278982,2022-04-23
CASH_IN,146819,Agence_moov_Ouidah,300000,153181,Maryse Reynaud-Michaud,-189040,-42221,2022-04-04
CASH_IN,198753,Agence_moov_Cotonou,300000,101247,Maryse Reynaud-Michaud,-42221,156532,2022-04-04
TRANSFER,78894,Maryse Reynaud-Michaud,156532,77638,Maryse Reynaud-Michaud,156532,77638,2022-04-06
TRANSFER,53975,Maryse Reynaud-Michaud,77638,23663,Maryse Reynaud-Michaud,77638,131613,2022-04-07
CASH_IN,5403,Agence_moov_Cotonou,300000,294597,Maryse Reynaud-Michaud,23663,29066,2022-04-11
CASH_OUT,21477,Maryse Reynaud-Michaud,29066,7589,Agence_moov_Abomey,300000,278523,2022-04-11
CASH_OUT,421,Maryse Reynaud-Michaud,7589,7168,Agence_moov_Ouidah,300000,299579,2022-04-14
CASH_OUT,4030,Maryse Reynaud-Michaud,7168,3138,Agence_moov_Ouidah,300000,295970,2022-04-15
CASH_IN,52043,Agence_moov_Ouidah,300000,247957,Maryse Reynaud-Michaud,3138,55181,2022-04-15
CASH_IN,8194,Agence_moov_Ouidah,300000,291806,Maryse Reynaud-Michaud,55181,63375,2022-04-20
CASH_OUT,61619,Maryse Reynaud-Michaud,63375,1756,Agence_moov_Cotonou,300000,238381,2022-04-23
CASH_IN,142699,Agence_moov_Ouidah,300000,157301,Maryse Reynaud-Michaud,1756,144455,2022-04-27
CASH_IN,82121,Agence_moov_Cotonou,300000,217879,Clémence Bertin,1232600,1314721,2022-05-01
CASH_IN,24648,Agence_moov_Abomey,300000,275352,Clémence Bertin,1314721,1339369,2022-05-14
CASH_IN,283844,Agence_moov_Cotonou,300000,16156,Clémence Bertin,1339369,1623213,2022-05-15
TRANSFER,37517,Émilie Guillon de Duhamel,62400,24883,Clémence Bertin,1623213,1660730,2022-05-20
CASH_IN,64876,Agence_moov_Abomey,300000,235124,Clémence Bertin,1660730,1725606,2022-05-25
TRANSFER,1361392,Paul Pereira,1427600,66208,Juliette Evrard Le Giraud,1398200,36808,2022-05-02
CASH_OUT,46855,Paul Pereira,66208,19353,Agence_moov_Ouidah,300000,253145,2022-05-06
CASH_OUT,6693,Paul Pereira,19353,12660,Agence_moov_Ouidah,300000,293307,2022-05-24
TRANSFER,10476,Paul Pereira,12660,2184,Luc Camus,859800,849324,2022-05-25
TRANSFER,529926,David-Théodore Diaz,1365400,835474,Antoine Leroux,267300,797226,2022-05-16
TRANSFER,467284,Grégoire Delmas de Blanchard,1413800,946516,Noël Hamel,466100,-1184,2022-05-02
CASH_IN,61381,Agence_moov_Ouidah,300000,238619,Grégoire Delmas de Blanchard,946516,1007897,2022-05-09
CASH_OUT,972749,Grégoire Delmas de Blanchard,1007897,35148,Agence_moov_Abomey,300000,-672749,2022-05-17
CASH_IN,223214,Agence_moov_Abomey,300000,76786,Grégoire Delmas de Blanchard,35148,258362,2022-05-20
CASH_OUT,195739,Grégoire Delmas de Blanchard,258362,62623,Agence_moov_Cotonou,300000,104261,2022-05-22
CASH_OUT,558821,Adélaïde-Sophie Leclercq,1856400,1297579,Agence_moov_Abomey,300000,-258821,2022-05-19
TRANSFER,71372,Vincent-Philippe Rossi,107600,36228,Marine-Clémence Ferreira,429700,358328,2022-05-03
CASH_IN,54291,Agence_moov_Cotonou,300000,245709,Vincent-Philippe Rossi,36228,90519,2022-05-20
CASH_IN,72124,Agence_moov_Cotonou,300000,227876,Vincent-Philippe Rossi,90519,162643,2022-05-23
CASH_OUT,144758,Luc-Tristan Moreau,230400,85642,Agence_moov_Ouidah,300000,155242,2022-05-02
CASH_OUT,70795,Luc-Tristan Moreau,85642,14847,Agence_moov_Ouidah,300000,229205,2022-05-18
CASH_OUT,139602,Emmanuelle Gilbert,227200,87598,Agence_moov_Abomey,300000,160398,2022-05-14
TRANSFER,14920,Margot Renaud de Lacombe,832200,817280,Emmanuelle Gilbert,87598,102518,2022-05-26
CASH_IN,143302,Agence_moov_Cotonou,300000,156698,Anastasie Louis,982200,1125502,2022-05-05
TRANSFER,75667,Anastasie Louis,1125502,1049835,Nicole Lacroix,932800,857133,2022-05-07
TRANSFER,147855,Christophe Guilbert,227900,80045,Anastasie Louis,1049835,1197690,2022-05-10
TRANSFER,1238870,Christophe Alexandre,1933000,694130,Susan de Fontaine,1466900,228030,2022-05-06
CASH_OUT,166649,Christophe Alexandre,694130,527481,Agence_moov_Cotonou,300000,133351,2022-05-06
CASH_OUT,372705,Christophe Alexandre,527481,154776,Agence_moov_Abomey,300000,-72705,2022-05-18
CASH_OUT,137854,Christophe Alexandre,154776,16922,Agence_moov_Ouidah,300000,162146,2022-05-20
CASH_OUT,162674,Alex Salmon,402400,239726,Agence_moov_Ouidah,300000,137326,2022-05-02
CASH_OUT,189231,Alex Salmon,239726,50495,Agence_moov_Abomey,300000,110769,2022-05-13
CASH_IN,142526,Agence_moov_Abomey,300000,157474,Alex Salmon,50495,193021,2022-05-22
CASH_IN,150156,Agence_moov_Abomey,300000,149844,Benoît Verdier,649000,799156,2022-05-07
CASH_IN,136773,Agence_moov_Cotonou,300000,163227,Benoît Verdier,799156,935929,2022-05-12
CASH_OUT,768863,Benoît Verdier,935929,167066,Agence_moov_Ouidah,300000,-468863,2022-05-24
TRANSFER,101672,Maryse Reynaud-Michaud,384300,282628,Benoît Verdier,167066,268738,2022-05-24
TRANSFER,797080,Caroline Bonneau,835500,38420,Stéphane-Timothée Pineau,671800,-125280,2022-05-08
TRANSFER,664766,Frédéric Moreau,1364800,700034,Caroline Bonneau,38420,703186,2022-05-09
TRANSFER,419259,Joséphine Weber du Bonnin,853400,434141,Caroline Bonneau,703186,1122445,2022-05-11
CASH_OUT,54230,Marthe Guillet,1959100,1904870,Agence_moov_Ouidah,300000,245770,2022-05-01
TRANSFER,600767,Marthe Guillet,1904870,1304103,Roland Colin,151800,-448967,2022-05-08
CASH_OUT,1041717,Marthe Guillet,1304103,262386,Agence_moov_Abomey,300000,-741717,2022-05-23
CASH_OUT,61438,Marthe Guillet,262386,200948,Agence_moov_Ouidah,300000,238562,2022-05-23
TRANSFER,671105,Margot Renaud de Lacombe,817280,146175,Marc Gilbert,677500,1348605,2022-05-05
CASH_OUT,892910,Marc Gilbert,1348605,455695,Agence_moov_Cotonou,300000,-592910,2022-05-06
CASH_OUT,211807,Marc Gilbert,455695,243888,Agence_moov_Cotonou,300000,88193,2022-05-09
TRANSFER,49593,Marc Gilbert,243888,194295,Laurent Perrot,1967800,1918207,2022-05-11
CASH_OUT,137857,Marc Gilbert,194295,56438,Agence_moov_Cotonou,300000,162143,2022-05-24
CASH_IN,78516,Agence_moov_Ouidah,300000,221484,Nicole Lacroix,857133,935649,2022-05-05
CASH_IN,48040,Agence_moov_Ouidah,300000,251960,Nicole Lacroix,935649,983689,2022-05-12
CASH_IN,159908,Agence_moov_Cotonou,300000,140092,Nicole Lacroix,983689,1143597,2022-05-26
TRANSFER,103858,Xavier-Stéphane Ollivier,319400,215542,Alexandre Poirier,23900,-79958,2022-05-08
CASH_OUT,177074,Xavier-Stéphane Ollivier,215542,38468,Agence_moov_Ouidah,300000,122926,2022-05-15
CASH_IN,244428,Agence_moov_Cotonou,300000,55572,Caroline Monnier,1741000,1985428,2022-05-03
CASH_IN,194628,Agence_moov_Abomey,300000,105372,Caroline Monnier,1985428,2180056,2022-05-20
CASH_IN,230354,Agence_moov_Ouidah,300000,69646,Caroline Monnier,2180056,2410410,2022-05-22
TRANSFER,119687,Caroline Monnier,2410410,2290723,Hugues Gay,1127100,1007413,2022-05-27
CASH_IN,114748,Agence_moov_Ouidah,300000,185252,Alexandre Poirier,-79958,34790,2022-05-17
CASH_IN,73216,Agence_moov_Cotonou,300000,226784,Alexandre Poirier,34790,108006,2022-05-25
CASH_OUT,57748,Alexandre Poirier,108006,50258,Agence_moov_Abomey,300000,242252,2022-05-25
CASH_OUT,360398,Vincent-Grégoire Brunet,915700,555302,Agence_moov_Abomey,300000,-60398,2022-05-20
CASH_OUT,40470,Gabriel de Pineau,166900,126430,Agence_moov_Abomey,300000,259530,2022-05-04
TRANSFER,805808,Sébastien-Arthur Masse,1417100,611292,Gabriel de Pineau,126430,932238,2022-05-09
TRANSFER,339391,Gabriel de Pineau,932238,592847,Nicolas Hervé,1779400,1440009,2022-05-24
CASH_IN,192885,Agence_moov_Abomey,300000,107115,Gilbert Bazin Le Guillet,1087500,1280385,2022-05-09
TRANSFER,1154110,Gilbert Bazin Le Guillet,1280385,126275,Claudine Vallet,622600,-531510,2022-05-13
TRANSFER,3940,Caroline Peltier,156900,152960,Gilbert Bazin Le Guillet,126275,130215,2022-05-15
CASH_IN,44919,Agence_moov_Abomey,300000,255081,Gilbert Bazin Le Guillet,130215,175134,2022-05-20
CASH_IN,57812,Agence_moov_Ouidah,300000,242188,Gilbert Bazin Le Guillet,175134,232946,2022-05-23
CASH_IN,287273,Agence_moov_Cotonou,300000,12727,Nicolas Grondin de la Pinto,981900,1269173,2022-05-04
CASH_OUT,796587,Nicolas Grondin de la Pinto,1269173,472586,Agence_moov_Abomey,300000,-496587,2022-05-08
TRANSFER,227380,Frédéric Moreau,700034,472654,Nicolas Grondin de la Pinto,472586,699966,2022-05-11
CASH_IN,219487,Agence_moov_Abomey,300000,80513,Nicolas Grondin de la Pinto,699966,919453,2022-05-16
CASH_IN,229535,Agence_moov_Cotonou,300000,70465,Nicolas Grondin de la Pinto,919453,1148988,2022-05-26
CASH_IN,152947,Agence_moov_Ouidah,300000,147053,Thierry Dos Santos-Le Roux,285400,438347,2022-05-01
CASH_OUT,243869,Thierry Dos Santos-Le Roux,438347,194478,Agence_moov_Cotonou,300000,56131,2022-05-01
CASH_OUT,92624,Thierry Dos Santos-Le Roux,194478,101854,Agence_moov_Ouidah,300000,207376,2022-05-02
TRANSFER,1103274,Théophile Mendès,1881800,778526,Thierry Dos Santos-Le Roux,101854,1205128,2022-05-03
CASH_OUT,328994,Thierry Dos Santos-Le Roux,1205128,876134,Agence_moov_Ouidah,300000,-28994,2022-05-04
TRANSFER,151671,Agnès Chrétien-Sanchez,817900,666229,Thierry Dos Santos-Le Roux,876134,1027805,2022-05-06
TRANSFER,898499,Amélie Gros-Riou,1638200,739701,Thierry Dos Santos-Le Roux,1027805,1926304,2022-05-06
CASH_IN,180900,Agence_moov_Abomey,300000,119100,Thierry Dos Santos-Le Roux,1926304,2107204,2022-05-07
CASH_IN,238934,Agence_moov_Abomey,300000,61066,Thierry Dos Santos-Le Roux,2107204,2346138,2022-05-08
TRANSFER,149624,Adrienne Arnaud,1018700,869076,Thierry Dos Santos-Le Roux,2346138,2495762,2022-05-08
TRANSFER,563271,Laurent Perrot,1918207,1354936,Thierry Dos Santos-Le Roux,2495762,3059033,2022-05-08
CASH_OUT,1697105,Thierry Dos Santos-Le Roux,3059033,1361928,Agence_moov_Ouidah,300000,-1397105,2022-05-09
TRANSFER,1259479,Thierry Dos Santos-Le Roux,1361928,102449,Noémi de la Didier,1531200,271721,2022-05-11
CASH_OUT,13097,Thierry Dos Santos-Le Roux,102449,89352,Agence_moov_Ouidah,300000,286903,2022-05-13
CASH_IN,98964,Agence_moov_Cotonou,300000,201036,Thierry Dos Santos-Le Roux,89352,188316,2022-05-13
CASH_OUT,112797,Thierry Dos Santos-Le Roux,188316,75519,Agence_moov_Abomey,300000,187203,2022-05-13
CASH_OUT,8495,Thierry Dos Santos-Le Roux,75519,67024,Agence_moov_Ouidah,300000,291505,2022-05-14
CASH_OUT,1748,Thierry Dos Santos-Le Roux,67024,65276,Agence_moov_Abomey,300000,298252,2022-05-14
CASH_OUT,48343,Thierry Dos Santos-Le Roux,65276,16933,Agence_moov_Ouidah,300000,251657,2022-05-14
TRANSFER,195013,Maurice Alves,510900,315887,Thierry Dos Santos-Le Roux,16933,211946,2022-05-14
CASH_OUT,183040,Thierry Dos Santos-Le Roux,211946,28906,Agence_moov_Ouidah,300000,116960,2022-05-15
CASH_IN,50410,Agence_moov_Ouidah,300000,249590,Thierry Dos Santos-Le Roux,28906,79316,2022-05-16
TRANSFER,66650,Thierry Dos Santos-Le Roux,79316,12666,Lucy Vaillant,247400,180750,2022-05-18
CASH_OUT,12595,Thierry Dos Santos-Le Roux,12666,71,Agence_moov_Abomey,300000,287405,2022-05-24
CASH_IN,185699,Agence_moov_Ouidah,300000,114301,Thierry Dos Santos-Le Roux,71,185770,2022-05-25
CASH_OUT,183619,Thierry Dos Santos-Le Roux,185770,2151,Agence_moov_Cotonou,300000,116381,2022-05-26
CASH_IN,113086,Agence_moov_Ouidah,300000,186914,Michèle Vallée,778100,891186,2022-05-04
CASH_OUT,397713,Michèle Vallée,891186,493473,Agence_moov_Cotonou,300000,-97713,2022-05-04
CASH_OUT,44801,Michèle Vallée,493473,448672,Agence_moov_Cotonou,300000,255199,2022-05-05
TRANSFER,177244,Michèle Vallée,448672,271428,Marianne Descamps,1433400,1256156,2022-05-05
TRANSFER,155585,Michèle Vallée,271428,115843,Matthieu Carpentier,1905100,1749515,2022-05-05
TRANSFER,62971,Michèle Vallée,115843,52872,Antoine Bourdon de Auger,1838000,1775029,2022-05-05
CASH_OUT,41669,Michèle Vallée,52872,11203,Agence_moov_Abomey,300000,258331,2022-05-08
TRANSFER,108058,Susan de Fontaine,228030,119972,Michèle Vallée,11203,119261,2022-05-10
CASH_OUT,18047,Michèle Vallée,119261,101214,Agence_moov_Cotonou,300000,281953,2022-05-11
TRANSFER,703104,Marthe Pichon,1974400,1271296,Michèle Vallée,101214,804318,2022-05-11
CASH_IN,113045,Agence_moov_Abomey,300000,186955,Michèle Vallée,804318,917363,2022-05-12
CASH_OUT,636310,Michèle Vallée,917363,281053,Agence_moov_Ouidah,300000,-336310,2022-05-12
TRANSFER,58989,Michèle Vallée,281053,222064,Auguste Bousquet,425100,366111,2022-05-14
CASH_OUT,131802,Michèle Vallée,222064,90262,Agence_moov_Abomey,300000,168198,2022-05-16
CASH_IN,251002,Agence_moov_Abomey,300000,48998,Michèle Vallée,90262,341264,2022-05-16
TRANSFER,798226,Maryse Lebreton,1349300,551074,Michèle Vallée,341264,1139490,2022-05-16
CASH_OUT,938062,Michèle Vallée,1139490,201428,Agence_moov_Abomey,300000,-638062,2022-05-17
CASH_IN,20321,Agence_moov_Ouidah,300000,279679,Michèle Vallée,201428,221749,2022-05-17
TRANSFER,622406,Constance Regnier,971000,348594,Michèle Vallée,221749,844155,2022-05-20
TRANSFER,472686,Michèle Vallée,844155,371469,Amélie Gros-Riou,739701,267015,2022-05-21
TRANSFER,271897,Michèle Vallée,371469,99572,Diane-Françoise Raynaud,415900,144003,2022-05-21
TRANSFER,20161,Susan de Fontaine,119972,99811,Michèle Vallée,99572,119733,2022-05-23
TRANSFER,112116,Michèle Vallée,119733,7617,Joseph de la Dubois,1893400,1781284,2022-05-26
TRANSFER,4814,Michèle Vallée,7617,2803,Aimé Allain,1430100,1425286,2022-05-26
CASH_IN,75037,Agence_moov_Cotonou,300000,224963,Adrienne Arnaud,869076,944113,2022-05-01
CASH_OUT,662078,Adrienne Arnaud,944113,282035,Agence_moov_Ouidah,300000,-362078,2022-05-06
CASH_OUT,224217,Adrienne Arnaud,282035,57818,Agence_moov_Ouidah,300000,75783,2022-05-06
CASH_OUT,5498,Adrienne Arnaud,57818,52320,Agence_moov_Ouidah,300000,294502,2022-05-07
CASH_OUT,44867,Adrienne Arnaud,52320,7453,Agence_moov_Cotonou,300000,255133,2022-05-07
CASH_OUT,2646,Adrienne Arnaud,7453,4807,Agence_moov_Cotonou,300000,297354,2022-05-08
TRANSFER,335637,Julie Robin de Gros,426200,90563,Adrienne Arnaud,4807,340444,2022-05-08
CASH_OUT,237497,Adrienne Arnaud,340444,102947,Agence_moov_Cotonou,300000,62503,2022-05-08
CASH_OUT,19654,Adrienne Arnaud,102947,83293,Agence_moov_Abomey,300000,280346,2022-05-10
CASH_IN,104800,Agence_moov_Ouidah,300000,195200,Adrienne Arnaud,83293,188093,2022-05-11
TRANSFER,93193,Adrienne Arnaud,188093,94900,Augustin Benard,526600,433407,2022-05-13
TRANSFER,180264,Lucy Vaillant,180750,486,Adrienne Arnaud,94900,275164,2022-05-13
TRANSFER,105964,Luc Camus,849324,743360,Adrienne Arnaud,275164,381128,2022-05-13
TRANSFER,363124,Adrienne Arnaud,381128,18004,Bernadette Fabre,4500,-358624,2022-05-13
TRANSFER,598084,Théodore-Alfred Fournier,1399000,800916,Adrienne Arnaud,18004,616088,2022-05-14
TRANSFER,221940,Adrienne Arnaud,616088,394148,Maurice Alves,315887,93947,2022-05-16
CASH_OUT,183750,Adrienne Arnaud,394148,210398,Agence_moov_Cotonou,300000,116250,2022-05-16
TRANSFER,109294,Adrienne Arnaud,210398,101104,Josette Guillon-Leclercq,993600,884306,2022-05-16
CASH_IN,22750,Agence_moov_Ouidah,300000,277250,Adrienne Arnaud,101104,123854,2022-05-17
TRANSFER,99414,Adrienne Arnaud,123854,24440,Antoine Bourdon de Auger,1775029,1675615,2022-05-17
CASH_OUT,6354,Adrienne Arnaud,24440,18086,Agence_moov_Abomey,300000,293646,2022-05-22
CASH_OUT,11732,Adrienne Arnaud,18086,6354,Agence_moov_Ouidah,300000,288268,2022-05-24
TRANSFER,1000637,Laurent Perrot,1354936,354299,Adrienne Arnaud,6354,1006991,2022-05-24
CASH_IN,244689,Agence_moov_Abomey,300000,55311,Adrienne Arnaud,1006991,1251680,2022-05-24
CASH_IN,282330,Agence_moov_Cotonou,300000,17670,Adrienne Arnaud,1251680,1534010,2022-05-25
CASH_OUT,834336,Adrienne Arnaud,1534010,699674,Agence_moov_Abomey,300000,-534336,2022-05-25
TRANSFER,258733,Adrienne Arnaud,699674,440941,Arnaude Gaillard,1455300,1196567,2022-05-25
TRANSFER,185051,Frédéric Moreau,472654,287603,Adrienne Arnaud,440941,625992,2022-05-26
TRANSFER,625655,Adrienne Arnaud,625992,337,Paul De Sousa,809400,183745,2022-05-27
TRANSFER,84358,Margot Renaud de Lacombe,146175,61817,Adrienne Arnaud,337,84695,2022-05-27
TRANSFER,59018,Matthieu Renard,326500,267482,Laurence Carlier,997400,938382,2022-05-02
TRANSFER,136250,Matthieu Renard,267482,131232,Antoine Bourdon de Auger,1675615,1539365,2022-05-04
CASH_IN,108185,Agence_moov_Ouidah,300000,191815,Matthieu Renard,131232,239417,2022-05-05
TRANSFER,84270,Matthieu Renard,239417,155147,Auguste Bousquet,366111,281841,2022-05-08
CASH_IN,163464,Agence_moov_Ouidah,300000,136536,Matthieu Renard,155147,318611,2022-05-08
CASH_IN,17244,Agence_moov_Cotonou,300000,282756,Matthieu Renard,318611,335855,2022-05-08
CASH_OUT,240401,Matthieu Renard,335855,95454,Agence_moov_Ouidah,300000,59599,2022-05-10
TRANSFER,43766,Matthieu Renard,95454,51688,David Diallo,787900,744134,2022-05-11
TRANSFER,13979,Matthieu Renard,51688,37709,Jacques-Antoine Gros,488400,474421,2022-05-11
CASH_IN,202862,Agence_moov_Cotonou,300000,97138,Matthieu Renard,37709,240571,2022-05-12
CASH_IN,288863,Agence_moov_Ouidah,300000,11137,Matthieu Renard,240571,529434,2022-05-12
CASH_IN,105935,Agence_moov_Ouidah,300000,194065,Matthieu Renard,529434,635369,2022-05-13
TRANSFER,238650,Matthieu Renard,635369,396719,Auguste Bousquet,281841,43191,2022-05-13
CASH_IN,285451,Agence_moov_Ouidah,300000,14549,Matthieu Renard,396719,682170,2022-05-13
CASH_OUT,553804,Matthieu Renard,682170,128366,Agence_moov_Ouidah,300000,-253804,2022-05-15
TRANSFER,42971,Julie Robin de Gros,90563,47592,Matthieu Renard,128366,171337,2022-05-15
CASH_OUT,120093,Matthieu Renard,171337,51244,Agence_moov_Cotonou,300000,179907,2022-05-15
TRANSFER,16129,Matthieu Renard,51244,35115,Jacques-Antoine Gros,474421,458292,2022-05-17
TRANSFER,135044,Noémi de la Didier,271721,136677,Matthieu Renard,35115,170159,2022-05-18
CASH_IN,108942,Agence_moov_Abomey,300000,191058,Matthieu Renard,170159,279101,2022-05-18
CASH_OUT,233426,Matthieu Renard,279101,45675,Agence_moov_Abomey,300000,66574,2022-05-21
TRANSFER,267983,Élodie Gérard,446400,178417,Matthieu Renard,45675,313658,2022-05-21
CASH_IN,139899,Agence_moov_Cotonou,300000,160101,Matthieu Renard,313658,453557,2022-05-25
CASH_IN,48728,Agence_moov_Abomey,300000,251272,Matthieu Renard,453557,502285,2022-05-25
CASH_OUT,155156,Matthieu Renard,502285,347129,Agence_moov_Ouidah,300000,144844,2022-05-26
CASH_OUT,32840,Matthieu Renard,347129,314289,Agence_moov_Ouidah,300000,267160,2022-05-26
CASH_OUT,230401,Matthieu Renard,314289,83888,Agence_moov_Ouidah,300000,69599,2022-05-27
TRANSFER,15142,Maurice Alves,93947,78805,Matthieu Renard,83888,99030,2022-05-27
CASH_IN,94065,Agence_moov_Ouidah,300000,205935,Alphonse Dupont-Petit,687500,781565,2022-05-01
CASH_IN,175223,Agence_moov_Ouidah,300000,124777,Alphonse Dupont-Petit,781565,956788,2022-05-01
TRANSFER,243239,Théophile Mendès,778526,535287,Alphonse Dupont-Petit,956788,1200027,2022-05-02
CASH_IN,199827,Agence_moov_Cotonou,300000,100173,Alphonse Dupont-Petit,1200027,1399854,2022-05-03
TRANSFER,1291353,Alphonse Dupont-Petit,1399854,108501,Alphonse Dupont-Petit,1399854,2691207,2022-05-07
CASH_OUT,75407,Alphonse Dupont-Petit,108501,33094,Agence_moov_Abomey,300000,224593,2022-05-11
CASH_IN,109843,Agence_moov_Ouidah,300000,190157,Alphonse Dupont-Petit,33094,142937,2022-05-11
CASH_OUT,46164,Alphonse Dupont-Petit,142937,96773,Agence_moov_Cotonou,300000,253836,2022-05-11
CASH_IN,87327,Agence_moov_Abomey,300000,212673,Alphonse Dupont-Petit,96773,184100,2022-05-14
TRANSFER,96681,Nath Léger,124700,28019,Alphonse Dupont-Petit,184100,280781,2022-05-14
CASH_OUT,101419,Alphonse Dupont-Petit,280781,179362,Agence_moov_Ouidah,300000,198581,2022-05-17
CASH_OUT,32378,Alphonse Dupont-Petit,179362,146984,Agence_moov_Cotonou,300000,267622,2022-05-19
TRANSFER,882390,Alfred Chrétien,894300,11910,Alphonse Dupont-Petit,146984,1029374,2022-05-19
CASH_IN,280973,Agence_moov_Cotonou,300000,19027,Alphonse Dupont-Petit,1029374,1310347,2022-05-20
TRANSFER,202742,Alphonse Dupont-Petit,1310347,1107605,Amélie Gros-Riou,267015,64273,2022-05-23
CASH_OUT,579671,Alphonse Dupont-Petit,1107605,527934,Agence_moov_Ouidah,300000,-279671,2022-05-24
CASH_OUT,422823,Alphonse Dupont-Petit,527934,105111,Agence_moov_Cotonou,300000,-122823,2022-05-27
TRANSFER,7219,Alphonse Dupont-Petit,105111,97892,Noémi de la Didier,136677,129458,2022-05-27
CASH_OUT,2135,Alphonse Dupont-Petit,97892,95757,Agence_moov_Abomey,300000,297865,2022-05-27
CASH_IN,193525,Agence_moov_Cotonou,300000,106475,Alphonse Dupont-Petit,95757,289282,2022-05-27
CASH_IN,228594,Agence_moov_Ouidah,300000,71406,Alphonse Dupont-Petit,289282,517876,2022-05-27
CASH_OUT,6770,Christophe Guilbert,80045,73275,Agence_moov_Ouidah,300000,293230,2022-05-02
CASH_IN,296625,Agence_moov_Abomey,300000,3375,Christophe Guilbert,73275,369900,2022-05-02
TRANSFER,137052,Christophe Guilbert,369900,232848,Nathalie-Chantal Jacques,949500,812448,2022-05-02
CASH_IN,23045,Agence_moov_Cotonou,300000,276955,Christophe Guilbert,232848,255893,2022-05-02
CASH_OUT,102554,Christophe Guilbert,255893,153339,Agence_moov_Abomey,300000,197446,2022-05-03
CASH_OUT,11916,Christophe Guilbert,153339,141423,Agence_moov_Ouidah,300000,288084,2022-05-05
TRANSFER,1387073,Aimé Allain,1425286,38213,Christophe Guilbert,141423,1528496,2022-05-06
TRANSFER,817899,Christophe Guilbert,1528496,710597,Maurice Alves,78805,-739094,2022-05-07
TRANSFER,617607,Amélie de la Picard,1578200,960593,Christophe Guilbert,710597,1328204,2022-05-07
CASH_OUT,8349,Christophe Guilbert,1328204,1319855,Agence_moov_Cotonou,300000,291651,2022-05-08
CASH_OUT,390219,Christophe Guilbert,1319855,929636,Agence_moov_Abomey,300000,-90219,2022-05-08
CASH_OUT,763476,Christophe Guilbert,929636,166160,Agence_moov_Cotonou,300000,-463476,2022-05-08
CASH_IN,74996,Agence_moov_Ouidah,300000,225004,Christophe Guilbert,166160,241156,2022-05-10
CASH_OUT,163274,Christophe Guilbert,241156,77882,Agence_moov_Abomey,300000,136726,2022-05-10
TRANSFER,45228,Christophe Guilbert,77882,32654,Caroline Peltier,152960,107732,2022-05-11
CASH_IN,108147,Agence_moov_Ouidah,300000,191853,Christophe Guilbert,32654,140801,2022-05-11
CASH_OUT,54874,Christophe Guilbert,140801,85927,Agence_moov_Cotonou,300000,245126,2022-05-11
CASH_OUT,5696,Christophe Guilbert,85927,80231,Agence_moov_Cotonou,300000,294304,2022-05-12
CASH_OUT,68223,Christophe Guilbert,80231,12008,Agence_moov_Cotonou,300000,231777,2022-05-14
CASH_OUT,8118,Christophe Guilbert,12008,3890,Agence_moov_Abomey,300000,291882,2022-05-14
CASH_OUT,3658,Christophe Guilbert,3890,232,Agence_moov_Abomey,300000,296342,2022-05-18
CASH_IN,111028,Agence_moov_Cotonou,300000,188972,Christophe Guilbert,232,111260,2022-05-21
CASH_IN,264499,Agence_moov_Abomey,300000,35501,Christophe Guilbert,111260,375759,2022-05-23
CASH_IN,14852,Agence_moov_Ouidah,300000,285148,Christophe Guilbert,375759,390611,2022-05-23
CASH_IN,147823,Agence_moov_Ouidah,300000,152177,Christophe Guilbert,390611,538434,2022-05-24
CASH_OUT,102775,Christophe Guilbert,538434,435659,Agence_moov_Abomey,300000,197225,2022-05-24
TRANSFER,1108400,Léon Paris,1275700,167300,Christophe Guilbert,435659,1544059,2022-05-24
CASH_IN,148745,Agence_moov_Cotonou,300000,151255,Christophe Guilbert,1544059,1692804,2022-05-27
CASH_IN,16226,Agence_moov_Cotonou,300000,283774,Guy Guyon,747600,763826,2022-05-01
CASH_OUT,248549,Guy Guyon,763826,515277,Agence_moov_Abomey,300000,51451,2022-05-01
TRANSFER,13027,Guy Guyon,515277,502250,Josette Guillon-Leclercq,884306,871279,2022-05-01
CASH_OUT,26034,Guy Guyon,502250,476216,Agence_moov_Ouidah,300000,273966,2022-05-02
TRANSFER,754391,Josette Guillon-Leclercq,871279,116888,Guy Guyon,476216,1230607,2022-05-03
CASH_OUT,957868,Guy Guyon,1230607,272739,Agence_moov_Ouidah,300000,-657868,2022-05-05
CASH_OUT,138131,Guy Guyon,272739,134608,Agence_moov_Abomey,300000,161869,2022-05-05
CASH_IN,194290,Agence_moov_Ouidah,300000,105710,Guy Guyon,134608,328898,2022-05-06
CASH_IN,263611,Agence_moov_Cotonou,300000,36389,Guy Guyon,328898,592509,2022-05-06
CASH_IN,197036,Agence_moov_Ouidah,300000,102964,Guy Guyon,592509,789545,2022-05-07
TRANSFER,214172,Maryse Lebreton,551074,336902,Guy Guyon,789545,1003717,2022-05-09
CASH_IN,133105,Agence_moov_Cotonou,300000,166895,Guy Guyon,1003717,1136822,2022-05-09
CASH_IN,229766,Agence_moov_Ouidah,300000,70234,Guy Guyon,1136822,1366588,2022-05-09
TRANSFER,1245859,Guy Guyon,1366588,120729,Élodie Gérard,178417,-1067442,2022-05-10
CASH_IN,233260,Agence_moov_Abomey,300000,66740,Guy Guyon,120729,353989,2022-05-11
CASH_IN,128718,Agence_moov_Ouidah,300000,171282,Guy Guyon,353989,482707,2022-05-14
CASH_OUT,422831,Guy Guyon,482707,59876,Agence_moov_Ouidah,300000,-122831,2022-05-14
CASH_IN,21363,Agence_moov_Cotonou,300000,278637,Guy Guyon,59876,81239,2022-05-17
CASH_OUT,26472,Guy Guyon,81239,54767,Agence_moov_Abomey,300000,273528,2022-05-18
CASH_IN,24675,Agence_moov_Cotonou,300000,275325,Guy Guyon,54767,79442,2022-05-19
CASH_OUT,3213,Guy Guyon,79442,76229,Agence_moov_Ouidah,300000,296787,2022-05-19
CASH_IN,205,Agence_moov_Cotonou,300000,299795,Guy Guyon,76229,76434,2022-05-21
CASH_IN,209447,Agence_moov_Abomey,300000,90553,Guy Guyon,76434,285881,2022-05-22
CASH_IN,39830,Agence_moov_Abomey,300000,260170,Guy Guyon,285881,325711,2022-05-25
CASH_IN,286602,Agence_moov_Cotonou,300000,13398,Guy Guyon,325711,612313,2022-05-26
CASH_OUT,1424332,Nicolas Hervé,1440009,15677,Agence_moov_Cotonou,300000,-1124332,2022-05-03
CASH_IN,200594,Agence_moov_Cotonou,300000,99406,Nicolas Hervé,15677,216271,2022-05-03
TRANSFER,8327,Théodore Bertin,12500,4173,Nicolas Hervé,216271,224598,2022-05-04
CASH_IN,26449,Agence_moov_Abomey,300000,273551,Nicolas Hervé,224598,251047,2022-05-05
CASH_IN,127206,Agence_moov_Abomey,300000,172794,Nicolas Hervé,251047,378253,2022-05-06
CASH_IN,53450,Agence_moov_Ouidah,300000,246550,Nicolas Hervé,378253,431703,2022-05-09
CASH_IN,156179,Agence_moov_Abomey,300000,143821,Nicolas Hervé,431703,587882,2022-05-09
CASH_IN,30588,Agence_moov_Cotonou,300000,269412,Nicolas Hervé,587882,618470,2022-05-10
CASH_OUT,86538,Nicolas Hervé,618470,531932,Agence_moov_Abomey,300000,213462,2022-05-10
TRANSFER,330912,Nicolas Hervé,531932,201020,Laurence Carlier,938382,607470,2022-05-10
TRANSFER,168640,Jacques-Antoine Gros,458292,289652,Nicolas Hervé,201020,369660,2022-05-11
TRANSFER,491757,Luc Camus,743360,251603,Nicolas Hervé,369660,861417,2022-05-12
CASH_OUT,377834,Nicolas Hervé,861417,483583,Agence_moov_Ouidah,300000,-77834,2022-05-14
CASH_IN,247367,Agence_moov_Abomey,300000,52633,Nicolas Hervé,483583,730950,2022-05-15
CASH_IN,98311,Agence_moov_Ouidah,300000,201689,Nicolas Hervé,730950,829261,2022-05-15
CASH_IN,226839,Agence_moov_Abomey,300000,73161,Nicolas Hervé,829261,1056100,2022-05-16
CASH_OUT,634735,Nicolas Hervé,1056100,421365,Agence_moov_Ouidah,300000,-334735,2022-05-18
TRANSFER,402949,Théophile Mendès,535287,132338,Nicolas Hervé,421365,824314,2022-05-19
TRANSFER,338735,Nicolas Hervé,824314,485579,Aimé Allain,38213,-300522,2022-05-20
CASH_OUT,114951,Nicolas Hervé,485579,370628,Agence_moov_Ouidah,300000,185049,2022-05-22
TRANSFER,133930,Nicolas Hervé,370628,236698,Isaac Le Pinto,1864600,1730670,2022-05-24
CASH_OUT,68790,Nicolas Hervé,236698,167908,Agence_moov_Ouidah,300000,231210,2022-05-27
CASH_IN,9157,Agence_moov_Cotonou,300000,290843,Marine-Clémence Ferreira,358328,367485,2022-05-01
CASH_IN,142380,Agence_moov_Abomey,300000,157620,Marine-Clémence Ferreira,367485,509865,2022-05-02
TRANSFER,28629,Marine-Clémence Ferreira,509865,481236,Marthe Pichon,1271296,1242667,2022-05-06
CASH_OUT,344974,Marine-Clémence Ferreira,481236,136262,Agence_moov_Abomey,300000,-44974,2022-05-09
CASH_OUT,75768,Marine-Clémence Ferreira,136262,60494,Agence_moov_Abomey,300000,224232,2022-05-09
CASH_OUT,15227,Marine-Clémence Ferreira,60494,45267,Agence_moov_Ouidah,300000,284773,2022-05-11
CASH_OUT,6151,Marine-Clémence Ferreira,45267,39116,Agence_moov_Ouidah,300000,293849,2022-05-11
CASH_IN,121258,Agence_moov_Abomey,300000,178742,Marine-Clémence Ferreira,39116,160374,2022-05-11
CASH_OUT,4390,Marine-Clémence Ferreira,160374,155984,Agence_moov_Cotonou,300000,295610,2022-05-12
TRANSFER,612465,Marianne Descamps,1256156,643691,Marine-Clémence Ferreira,155984,768449,2022-05-12
CASH_IN,241234,Agence_moov_Ouidah,300000,58766,Marine-Clémence Ferreira,768449,1009683,2022-05-14
CASH_IN,282711,Agence_moov_Ouidah,300000,17289,Marine-Clémence Ferreira,1009683,1292394,2022-05-15
CASH_IN,148716,Agence_moov_Ouidah,300000,151284,Marine-Clémence Ferreira,1292394,1441110,2022-05-16
TRANSFER,1333847,Marine-Clémence Ferreira,1441110,107263,Emmanuel Bousquet,131400,-1202447,2022-05-17
CASH_OUT,46050,Marine-Clémence Ferreira,107263,61213,Agence_moov_Abomey,300000,253950,2022-05-20
CASH_OUT,36585,Marine-Clémence Ferreira,61213,24628,Agence_moov_Ouidah,300000,263415,2022-05-20
TRANSFER,302537,Agnès Chrétien-Sanchez,666229,363692,Marine-Clémence Ferreira,24628,327165,2022-05-20
CASH_OUT,157504,Marine-Clémence Ferreira,327165,169661,Agence_moov_Abomey,300000,142496,2022-05-21
TRANSFER,155281,Marine-Clémence Ferreira,169661,14380,Antoine Bourdon de Auger,1539365,1384084,2022-05-21
CASH_OUT,635,Marine-Clémence Ferreira,14380,13745,Agence_moov_Ouidah,300000,299365,2022-05-22
CASH_IN,286399,Agence_moov_Abomey,300000,13601,Marine-Clémence Ferreira,13745,300144,2022-05-22
TRANSFER,1442963,Matthieu Carpentier,1749515,306552,Marine-Clémence Ferreira,300144,1743107,2022-05-24
TRANSFER,773384,Marine-Clémence Ferreira,1743107,969723,Noémi de la Didier,129458,-643926,2022-05-24
CASH_IN,230523,Agence_moov_Cotonou,300000,69477,Marine-Clémence Ferreira,969723,1200246,2022-05-26
CASH_IN,228321,Agence_moov_Cotonou,300000,71679,Constance Regnier,348594,576915,2022-05-01
CASH_OUT,249859,Constance Regnier,576915,327056,Agence_moov_Ouidah,300000,50141,2022-05-01
CASH_IN,295240,Agence_moov_Cotonou,300000,4760,Constance Regnier,327056,622296,2022-05-02
CASH_IN,148604,Agence_moov_Cotonou,300000,151396,Constance Regnier,622296,770900,2022-05-03
TRANSFER,863488,Émile Hebert,1601000,737512,Constance Regnier,770900,1634388,2022-05-03
CASH_OUT,372016,Constance Regnier,1634388,1262372,Agence_moov_Ouidah,300000,-72016,2022-05-04
CASH_OUT,733913,Constance Regnier,1262372,528459,Agence_moov_Ouidah,300000,-433913,2022-05-06
CASH_IN,82767,Agence_moov_Ouidah,300000,217233,Constance Regnier,528459,611226,2022-05-08
CASH_IN,128670,Agence_moov_Abomey,300000,171330,Constance Regnier,611226,739896,2022-05-08
CASH_IN,158110,Agence_moov_Ouidah,300000,141890,Constance Regnier,739896,898006,2022-05-09
TRANSFER,758556,Constance Regnier,898006,139450,Marianne Descamps,643691,-114865,2022-05-11
TRANSFER,939392,Sabine Imbert,1694100,754708,Constance Regnier,139450,1078842,2022-05-12
CASH_OUT,165263,Constance Regnier,1078842,913579,Agence_moov_Ouidah,300000,134737,2022-05-13
CASH_OUT,630970,Constance Regnier,913579,282609,Agence_moov_Ouidah,300000,-330970,2022-05-14
CASH_IN,290329,Agence_moov_Ouidah,300000,9671,Constance Regnier,282609,572938,2022-05-16
TRANSFER,173478,Augustin Benard,433407,259929,Constance Regnier,572938,746416,2022-05-16
TRANSFER,566015,Constance Regnier,746416,180401,Josette Guillon-Leclercq,116888,-449127,2022-05-16
CASH_OUT,38045,Constance Regnier,180401,142356,Agence_moov_Ouidah,300000,261955,2022-05-17
CASH_IN,25556,Agence_moov_Cotonou,300000,274444,Constance Regnier,142356,167912,2022-05-19
TRANSFER,10823,Constance Regnier,167912,157089,Sébastien Jourdan,953300,942477,2022-05-20
CASH_IN,83616,Agence_moov_Cotonou,300000,216384,Constance Regnier,157089,240705,2022-05-22
TRANSFER,205577,Constance Regnier,240705,35128,Frédérique Robin,788500,582923,2022-05-22
CASH_IN,239105,Agence_moov_Ouidah,300000,60895,Constance Regnier,35128,274233,2022-05-22
CASH_OUT,187059,Constance Regnier,274233,87174,Agence_moov_Cotonou,300000,112941,2022-05-26
CASH_OUT,19794,Constance Regnier,87174,67380,Agence_moov_Abomey,300000,280206,2022-05-26
CASH_IN,207129,Agence_moov_Ouidah,300000,92871,Constance Regnier,67380,274509,2022-05-27
CASH_IN,252854,Agence_moov_Cotonou,300000,47146,Stéphane-Timothée Pineau,-125280,127574,2022-05-01
CASH_OUT,78207,Stéphane-Timothée Pineau,127574,49367,Agence_moov_Abomey,300000,221793,2022-05-02
CASH_IN,112516,Agence_moov_Ouidah,300000,187484,Stéphane-Timothée Pineau,49367,161883,2022-05-03
CASH_OUT,159609,Stéphane-Timothée Pineau,161883,2274,Agence_moov_Ouidah,300000,140391,2022-05-07
CASH_IN,261039,Agence_moov_Abomey,300000,38961,Stéphane-Timothée Pineau,2274,263313,2022-05-10
CASH_OUT,98862,Stéphane-Timothée Pineau,263313,164451,Agence_moov_Cotonou,300000,201138,2022-05-12
CASH_OUT,493,Stéphane-Timothée Pineau,164451,163958,Agence_moov_Abomey,300000,299507,2022-05-13
CASH_OUT,74837,Stéphane-Timothée Pineau,163958,89121,Agence_moov_Abomey,300000,225163,2022-05-14
TRANSFER,19452,Juliette Evrard Le Giraud,36808,17356,Stéphane-Timothée Pineau,89121,108573,2022-05-16
CASH_IN,286442,Agence_moov_Abomey,300000,13558,Stéphane-Timothée Pineau,108573,395015,2022-05-16
CASH_OUT,330303,Stéphane-Timothée Pineau,395015,64712,Agence_moov_Abomey,300000,-30303,2022-05-16
TRANSFER,1715526,Isaac Le Pinto,1730670,15144,Stéphane-Timothée Pineau,64712,1780238,2022-05-17
CASH_IN,18677,Agence_moov_Cotonou,300000,281323,Stéphane-Timothée Pineau,1780238,1798915,2022-05-18
CASH_OUT,1369779,Stéphane-Timothée Pineau,1798915,429136,Agence_moov_Abomey,300000,-1069779,2022-05-19
CASH_IN,298504,Agence_moov_Cotonou,300000,1496,Stéphane-Timothée Pineau,429136,727640,2022-05-20
TRANSFER,145181,Augustin Benard,259929,114748,Stéphane-Timothée Pineau,727640,872821,2022-05-22
CASH_IN,147223,Agence_moov_Abomey,300000,152777,Stéphane-Timothée Pineau,872821,1020044,2022-05-22
CASH_IN,189728,Agence_moov_Cotonou,300000,110272,Stéphane-Timothée Pineau,1020044,1209772,2022-05-23
CASH_OUT,442792,Stéphane-Timothée Pineau,1209772,766980,Agence_moov_Cotonou,300000,-142792,2022-05-24
CASH_IN,106883,Agence_moov_Abomey,300000,193117,Stéphane-Timothée Pineau,766980,873863,2022-05-24
CASH_OUT,741668,Stéphane-Timothée Pineau,873863,132195,Agence_moov_Abomey,300000,-441668,2022-05-25
TRANSFER,156020,Nathalie-Chantal Jacques,812448,656428,Stéphane-Timothée Pineau,132195,288215,2022-05-26
CASH_OUT,135153,Stéphane-Timothée Pineau,288215,153062,Agence_moov_Ouidah,300000,164847,2022-05-26
CASH_IN,267083,Agence_moov_Ouidah,300000,32917,Stéphane-Timothée Pineau,153062,420145,2022-05-27
CASH_OUT,16545,Nath Léger,28019,11474,Agence_moov_Ouidah,300000,283455,2022-05-01
CASH_IN,73643,Agence_moov_Ouidah,300000,226357,Nath Léger,11474,85117,2022-05-04
TRANSFER,16092,Océane Boutin,156900,140808,Nath Léger,85117,101209,2022-05-05
CASH_IN,20276,Agence_moov_Abomey,300000,279724,Nath Léger,101209,121485,2022-05-07
CASH_OUT,39063,Nath Léger,121485,82422,Agence_moov_Ouidah,300000,260937,2022-05-09
CASH_OUT,77892,Nath Léger,82422,4530,Agence_moov_Cotonou,300000,222108,2022-05-10
TRANSFER,785,Nath Léger,4530,3745,Agnès Baron,1024000,1023215,2022-05-10
CASH_IN,25778,Agence_moov_Abomey,300000,274222,Nath Léger,3745,29523,2022-05-12
CASH_OUT,4610,Nath Léger,29523,24913,Agence_moov_Abomey,300000,295390,2022-05-12
CASH_OUT,17925,Nath Léger,24913,6988,Agence_moov_Ouidah,300000,282075,2022-05-13
CASH_OUT,1719,Nath Léger,6988,5269,Agence_moov_Abomey,300000,298281,2022-05-13
TRANSFER,77665,Diane-Françoise Raynaud,144003,66338,Nath Léger,5269,82934,2022-05-13
CASH_OUT,34757,Nath Léger,82934,48177,Agence_moov_Abomey,300000,265243,2022-05-14
TRANSFER,28866,Nath Léger,48177,19311,Agnès Chrétien-Sanchez,363692,334826,2022-05-16
CASH_OUT,1251,Nath Léger,19311,18060,Agence_moov_Cotonou,300000,298749,2022-05-18
CASH_OUT,15595,Nath Léger,18060,2465,Agence_moov_Ouidah,300000,284405,2022-05-20
CASH_IN,129728,Agence_moov_Cotonou,300000,170272,Nath Léger,2465,132193,2022-05-21
CASH_IN,176471,Agence_moov_Cotonou,300000,123529,Nath Léger,132193,308664,2022-05-22
TRANSFER,6001,Nath Léger,308664,302663,David Diallo,744134,738133,2022-05-22
CASH_IN,145675,Agence_moov_Abomey,300000,154325,Nath Léger,302663,448338,2022-05-24
CASH_IN,35933,Agence_moov_Cotonou,300000,264067,Nath Léger,448338,484271,2022-05-25
TRANSFER,6312,Juliette Evrard Le Giraud,17356,11044,Hugues Gay,1007413,1013725,2022-05-03
CASH_IN,28326,Agence_moov_Abomey,300000,271674,Hugues Gay,1013725,1042051,2022-05-03
CASH_OUT,453524,Hugues Gay,1042051,588527,Agence_moov_Ouidah,300000,-153524,2022-05-06
TRANSFER,33637,Julie Robin de Gros,47592,13955,Hugues Gay,588527,622164,2022-05-07
CASH_OUT,350940,Hugues Gay,622164,271224,Agence_moov_Abomey,300000,-50940,2022-05-07
CASH_OUT,136119,Hugues Gay,271224,135105,Agence_moov_Abomey,300000,163881,2022-05-09
CASH_OUT,100913,Hugues Gay,135105,34192,Agence_moov_Ouidah,300000,199087,2022-05-12
TRANSFER,13689,Julie Robin de Gros,13955,266,Hugues Gay,34192,47881,2022-05-13
TRANSFER,1016533,Agnès Baron,1023215,6682,Hugues Gay,47881,1064414,2022-05-13
CASH_OUT,657322,Hugues Gay,1064414,407092,Agence_moov_Cotonou,300000,-357322,2022-05-15
CASH_IN,40432,Agence_moov_Ouidah,300000,259568,Hugues Gay,407092,447524,2022-05-15
CASH_IN,91413,Agence_moov_Cotonou,300000,208587,Hugues Gay,447524,538937,2022-05-16
CASH_IN,174028,Agence_moov_Abomey,300000,125972,Hugues Gay,538937,712965,2022-05-17
TRANSFER,187887,Hugues Gay,712965,525078,Sébastien Jourdan,942477,754590,2022-05-17
CASH_IN,293032,Agence_moov_Ouidah,300000,6968,Hugues Gay,525078,818110,2022-05-18
CASH_OUT,226128,Hugues Gay,818110,591982,Agence_moov_Ouidah,300000,73872,2022-05-20
CASH_OUT,363504,Hugues Gay,591982,228478,Agence_moov_Ouidah,300000,-63504,2022-05-22
CASH_OUT,183843,Hugues Gay,228478,44635,Agence_moov_Ouidah,300000,116157,2022-05-22
CASH_OUT,34611,Hugues Gay,44635,10024,Agence_moov_Abomey,300000,265389,2022-05-22
TRANSFER,81377,Paul De Sousa,183745,102368,Hugues Gay,10024,91401,2022-05-25
CASH_OUT,89844,Hugues Gay,91401,1557,Agence_moov_Ouidah,300000,210156,2022-05-27
CASH_OUT,29661,Auguste Bousquet,43191,13530,Agence_moov_Cotonou,300000,270339,2022-05-02
CASH_OUT,12638,Auguste Bousquet,13530,892,Agence_moov_Ouidah,300000,287362,2022-05-03
CASH_OUT,475,Auguste Bousquet,892,417,Agence_moov_Cotonou,300000,299525,2022-05-05
TRANSFER,161166,Frédéric Moreau,287603,126437,Auguste Bousquet,417,161583,2022-05-06
TRANSFER,219759,Sébastien Jourdan,754590,534831,Auguste Bousquet,161583,381342,2022-05-09
TRANSFER,508341,Christine-Constance Gauthier,954200,445859,Auguste Bousquet,381342,889683,2022-05-09
CASH_OUT,786092,Auguste Bousquet,889683,103591,Agence_moov_Cotonou,300000,-486092,2022-05-11
CASH_OUT,81911,Auguste Bousquet,103591,21680,Agence_moov_Abomey,300000,218089,2022-05-14
CASH_IN,291179,Agence_moov_Abomey,300000,8821,Auguste Bousquet,21680,312859,2022-05-16
CASH_OUT,184680,Auguste Bousquet,312859,128179,Agence_moov_Ouidah,300000,115320,2022-05-17
TRANSFER,189695,Maryse Lebreton,336902,147207,Auguste Bousquet,128179,317874,2022-05-17
TRANSFER,226449,Laurent Perrot,354299,127850,Auguste Bousquet,317874,544323,2022-05-18
CASH_IN,122384,Agence_moov_Ouidah,300000,177616,Auguste Bousquet,544323,666707,2022-05-18
CASH_IN,170896,Agence_moov_Abomey,300000,129104,Auguste Bousquet,666707,837603,2022-05-19
TRANSFER,89580,Frédéric Moreau,126437,36857,Auguste Bousquet,837603,927183,2022-05-19
CASH_OUT,751347,Auguste Bousquet,927183,175836,Agence_moov_Cotonou,300000,-451347,2022-05-19
TRANSFER,89356,Auguste Bousquet,175836,86480,Maryse Lebreton,147207,57851,2022-05-19
TRANSFER,446,Lucy Vaillant,486,40,Auguste Bousquet,86480,86926,2022-05-19
TRANSFER,81140,Auguste Bousquet,86926,5786,Agnès Chrétien-Sanchez,334826,253686,2022-05-20
TRANSFER,522698,Nathalie-Chantal Jacques,656428,133730,Auguste Bousquet,5786,528484,2022-05-24
CASH_OUT,85421,Auguste Bousquet,528484,443063,Agence_moov_Abomey,300000,214579,2022-05-26
TRANSFER,608582,David-Théodore Diaz,835474,226892,Auguste Bousquet,443063,1051645,2022-05-26
CASH_OUT,959486,Auguste Bousquet,1051645,92159,Agence_moov_Ouidah,300000,-659486,2022-05-27
CASH_OUT,10783,Théophile Mendès,132338,121555,Agence_moov_Abomey,300000,289217,2022-05-02
CASH_OUT,66979,Théophile Mendès,121555,54576,Agence_moov_Cotonou,300000,233021,2022-05-04
TRANSFER,42756,Théophile Mendès,54576,11820,David-Théodore Diaz,226892,184136,2022-05-04
CASH_OUT,4297,Théophile Mendès,11820,7523,Agence_moov_Ouidah,300000,295703,2022-05-05
TRANSFER,3554,Théophile Mendès,7523,3969,Laurence Dumont de Laroche,650600,647046,2022-05-08
CASH_IN,56916,Agence_moov_Ouidah,300000,243084,Théophile Mendès,3969,60885,2022-05-08
CASH_OUT,40704,Théophile Mendès,60885,20181,Agence_moov_Cotonou,300000,259296,2022-05-09
CASH_IN,31577,Agence_moov_Abomey,300000,268423,Théophile Mendès,20181,51758,2022-05-09
CASH_OUT,48506,Théophile Mendès,51758,3252,Agence_moov_Abomey,300000,251494,2022-05-09
CASH_OUT,102,Théophile Mendès,3252,3150,Agence_moov_Ouidah,300000,299898,2022-05-11
TRANSFER,1427,Théophile Mendès,3150,1723,David Diallo,738133,736706,2022-05-14
CASH_OUT,613,Théophile Mendès,1723,1110,Agence_moov_Ouidah,300000,299387,2022-05-15
TRANSFER,298170,Joseph de la Dubois,1781284,1483114,Théophile Mendès,1110,299280,2022-05-15
CASH_OUT,93850,Théophile Mendès,299280,205430,Agence_moov_Cotonou,300000,206150,2022-05-16
CASH_OUT,152026,Théophile Mendès,205430,53404,Agence_moov_Abomey,300000,147974,2022-05-18
TRANSFER,52963,Jacques-Antoine Gros,289652,236689,Théophile Mendès,53404,106367,2022-05-19
CASH_IN,217902,Agence_moov_Cotonou,300000,82098,Théophile Mendès,106367,324269,2022-05-20
CASH_OUT,149196,Théophile Mendès,324269,175073,Agence_moov_Abomey,300000,150804,2022-05-22
CASH_IN,231938,Agence_moov_Cotonou,300000,68062,Théophile Mendès,175073,407011,2022-05-23
CASH_IN,221312,Agence_moov_Cotonou,300000,78688,Théophile Mendès,407011,628323,2022-05-23
TRANSFER,98301,Léon Paris,167300,68999,Théophile Mendès,628323,726624,2022-05-24
CASH_IN,78565,Agence_moov_Cotonou,300000,221435,Théophile Mendès,726624,805189,2022-05-25
TRANSFER,118192,Amélie de la Picard,960593,842401,Théophile Mendès,805189,923381,2022-05-25
CASH_OUT,212806,Théophile Mendès,923381,710575,Agence_moov_Ouidah,300000,87194,2022-05-25
TRANSFER,564613,Théophile Mendès,710575,145962,Émilie Guillon de Duhamel,24883,-539730,2022-05-25
CASH_OUT,138805,Théophile Mendès,145962,7157,Agence_moov_Cotonou,300000,161195,2022-05-26
TRANSFER,777805,Marie Da Silva,895700,117895,Théophile Mendès,7157,784962,2022-05-26
CASH_IN,119167,Agence_moov_Cotonou,300000,180833,Théophile Mendès,784962,904129,2022-05-26
CASH_IN,285546,Agence_moov_Ouidah,300000,14454,Théophile Mendès,904129,1189675,2022-05-26
TRANSFER,465360,Théophile Mendès,1189675,724315,Isaac Le Pinto,15144,-450216,2022-05-27
CASH_OUT,42881,Maryse Reynaud-Michaud,282628,239747,Agence_moov_Abomey,300000,257119,2022-05-01
TRANSFER,514587,Arnaude Gaillard,1196567,681980,Maryse Reynaud-Michaud,239747,754334,2022-05-01
CASH_OUT,307808,Maryse Reynaud-Michaud,754334,446526,Agence_moov_Abomey,300000,-7808,2022-05-01
TRANSFER,85164,Marie Da Silva,117895,32731,Maryse Reynaud-Michaud,446526,531690,2022-05-02
CASH_OUT,88876,Maryse Reynaud-Michaud,531690,442814,Agence_moov_Cotonou,300000,211124,2022-05-04
CASH_IN,180021,Agence_moov_Cotonou,300000,119979,Maryse Reynaud-Michaud,442814,622835,2022-05-04
CASH_OUT,157797,Maryse Reynaud-Michaud,622835,465038,Agence_moov_Ouidah,300000,142203,2022-05-04
TRANSFER,5689,Caroline Peltier,107732,102043,Maryse Reynaud-Michaud,465038,470727,2022-05-07
CASH_IN,114179,Agence_moov_Abomey,300000,185821,Maryse Reynaud-Michaud,470727,584906,2022-05-08
TRANSFER,7922,Alfred Chrétien,11910,3988,Maryse Reynaud-Michaud,584906,592828,2022-05-08
TRANSFER,436079,Maryse Reynaud-Michaud,592828,156749,Christine-Constance Gauthier,445859,9780,2022-05-12
CASH_IN,131245,Agence_moov_Abomey,300000,168755,Maryse Reynaud-Michaud,156749,287994,2022-05-12
TRANSFER,96551,Maryse Reynaud-Michaud,287994,191443,Amélie Gros-Riou,64273,-32278,2022-05-13
TRANSFER,14918,Laurent Besson,29100,14182,Maryse Reynaud-Michaud,191443,206361,2022-05-14
CASH_OUT,120722,Maryse Reynaud-Michaud,206361,85639,Agence_moov_Abomey,300000,179278,2022-05-14
CASH_IN,283645,Agence_moov_Ouidah,300000,16355,Maryse Reynaud-Michaud,85639,369284,2022-05-17
CASH_IN,91330,Agence_moov_Abomey,300000,208670,Maryse Reynaud-Michaud,369284,460614,2022-05-20
TRANSFER,380152,Maryse Reynaud-Michaud,460614,80462,Julie Robin de Gros,266,-379886,2022-05-20
CASH_OUT,12590,Maryse Reynaud-Michaud,80462,67872,Agence_moov_Abomey,300000,287410,2022-05-21
TRANSFER,21178,Marie Da Silva,32731,11553,Maryse Reynaud-Michaud,67872,89050,2022-05-21
CASH_OUT,53532,Maryse Reynaud-Michaud,89050,35518,Agence_moov_Cotonou,300000,246468,2022-05-22
TRANSFER,159756,Jacques-Antoine Gros,236689,76933,Maryse Reynaud-Michaud,35518,195274,2022-05-22
TRANSFER,1127,Alfred Chrétien,3988,2861,Maryse Reynaud-Michaud,195274,196401,2022-05-23
CASH_OUT,23367,Maryse Reynaud-Michaud,196401,173034,Agence_moov_Abomey,300000,276633,2022-05-23
TRANSFER,1951,Maryse Reynaud-Michaud,173034,171083,Margot Renaud de Lacombe,61817,59866,2022-05-25
CASH_IN,21850,Agence_moov_Cotonou,300000,278150,Julie Robin de Gros,-379886,-358036,2022-05-02
CASH_IN,41365,Agence_moov_Abomey,300000,258635,Julie Robin de Gros,-358036,-316671,2022-05-04
CASH_IN,218366,Agence_moov_Ouidah,300000,81634,Julie Robin de Gros,-316671,-98305,2022-05-04
CASH_IN,284649,Agence_moov_Abomey,300000,15351,Julie Robin de Gros,-98305,186344,2022-05-05
CASH_IN,8210,Agence_moov_Ouidah,300000,291790,Julie Robin de Gros,186344,194554,2022-05-06
CASH_OUT,57322,Julie Robin de Gros,194554,137232,Agence_moov_Cotonou,300000,242678,2022-05-06
TRANSFER,54933,Julie Robin de Gros,137232,82299,Caroline Peltier,102043,47110,2022-05-10
CASH_OUT,70292,Julie Robin de Gros,82299,12007,Agence_moov_Cotonou,300000,229708,2022-05-10
TRANSFER,7528,Julie Robin de Gros,12007,4479,Julie Robin de Gros,12007,19535,2022-05-10
CASH_OUT,2672,Julie Robin de Gros,4479,1807,Agence_moov_Cotonou,300000,297328,2022-05-13
CASH_IN,265618,Agence_moov_Ouidah,300000,34382,Julie Robin de Gros,1807,267425,2022-05-14
CASH_IN,277865,Agence_moov_Abomey,300000,22135,Julie Robin de Gros,267425,545290,2022-05-15
CASH_IN,296401,Agence_moov_Ouidah,300000,3599,Julie Robin de Gros,545290,841691,2022-05-16
CASH_OUT,231660,Julie Robin de Gros,841691,610031,Agence_moov_Ouidah,300000,68340,2022-05-17
CASH_IN,172291,Agence_moov_Abomey,300000,127709,Julie Robin de Gros,610031,782322,2022-05-17
TRANSFER,561519,Julie Robin de Gros,782322,220803,Agnès Baron,6682,-554837,2022-05-18
TRANSFER,15265,Julie Robin de Gros,220803,205538,Luc Camus,251603,236338,2022-05-18
TRANSFER,1870,Théodore Bertin,4173,2303,Julie Robin de Gros,205538,207408,2022-05-18
CASH_OUT,73284,Julie Robin de Gros,207408,134124,Agence_moov_Cotonou,300000,226716,2022-05-18
CASH_IN,23238,Agence_moov_Abomey,300000,276762,Julie Robin de Gros,134124,157362,2022-05-19
CASH_IN,134664,Agence_moov_Ouidah,300000,165336,Julie Robin de Gros,157362,292026,2022-05-20
CASH_IN,91038,Agence_moov_Abomey,300000,208962,Julie Robin de Gros,292026,383064,2022-05-21
CASH_OUT,147349,Julie Robin de Gros,383064,235715,Agence_moov_Ouidah,300000,152651,2022-05-24
CASH_OUT,219612,Julie Robin de Gros,235715,16103,Agence_moov_Ouidah,300000,80388,2022-05-25
CASH_IN,254698,Agence_moov_Ouidah,300000,45302,Julie Robin de Gros,16103,270801,2022-05-25
TRANSFER,187151,Julie Robin de Gros,270801,83650,Susan de Fontaine,99811,-87340,2022-05-26
CASH_OUT,35920,Julie Robin de Gros,83650,47730,Agence_moov_Cotonou,300000,264080,2022-05-26
CASH_OUT,7788,Julie Robin de Gros,47730,39942,Agence_moov_Ouidah,300000,292212,2022-05-27
TRANSFER,345432,Sabine Imbert,754708,409276,Luc Camus,236338,-109094,2022-05-01
CASH_IN,136928,Agence_moov_Cotonou,300000,163072,Sabine Imbert,409276,546204,2022-05-01
CASH_IN,5091,Agence_moov_Abomey,300000,294909,Sabine Imbert,546204,551295,2022-05-02
TRANSFER,234823,Sabine Imbert,551295,316472,Nathalie-Chantal Jacques,133730,-101093,2022-05-03
CASH_IN,211402,Agence_moov_Ouidah,300000,88598,Sabine Imbert,316472,527874,2022-05-03
CASH_IN,153008,Agence_moov_Cotonou,300000,146992,Sabine Imbert,527874,680882,2022-05-03
TRANSFER,143726,Matthieu Carpentier,306552,162826,Sabine Imbert,680882,824608,2022-05-04
TRANSFER,200,Théodore Bertin,2303,2103,Sabine Imbert,824608,824808,2022-05-08
CASH_IN,194319,Agence_moov_Abomey,300000,105681,Sabine Imbert,824808,1019127,2022-05-10
TRANSFER,438240,Sabine Imbert,1019127,580887,Océane Boutin,140808,-297432,2022-05-10
CASH_OUT,424664,Sabine Imbert,580887,156223,Agence_moov_Abomey,300000,-124664,2022-05-12
CASH_OUT,36012,Sabine Imbert,156223,120211,Agence_moov_Ouidah,300000,263988,2022-05-13
TRANSFER,34653,Sabine Imbert,120211,85558,Antoine Bourdon de Auger,1384084,1349431,2022-05-15
CASH_IN,229486,Agence_moov_Cotonou,300000,70514,Sabine Imbert,85558,315044,2022-05-15
TRANSFER,3745,Frédéric Moreau,36857,33112,Sabine Imbert,315044,318789,2022-05-22
CASH_IN,106949,Agence_moov_Abomey,300000,193051,Sabine Imbert,318789,425738,2022-05-23
CASH_IN,220358,Agence_moov_Abomey,300000,79642,Sabine Imbert,425738,646096,2022-05-24
CASH_IN,277401,Agence_moov_Abomey,300000,22599,Sabine Imbert,646096,923497,2022-05-25
TRANSFER,2123,Marie Da Silva,11553,9430,Sabine Imbert,923497,925620,2022-05-25
CASH_OUT,389853,Sabine Imbert,925620,535767,Agence_moov_Cotonou,300000,-89853,2022-05-25
TRANSFER,157034,Sabine Imbert,535767,378733,Matthieu Carpentier,162826,5792,2022-05-25
TRANSFER,337014,Sabine Imbert,378733,41719,David Diallo,736706,399692,2022-05-27
TRANSFER,21487,Sabine Imbert,41719,20232,Maryse Lebreton,57851,36364,2022-05-27
CASH_IN,246543,Agence_moov_Ouidah,300000,53457,Élodie Gérard,-1067442,-820899,2022-05-03
CASH_IN,44146,Agence_moov_Ouidah,300000,255854,Élodie Gérard,-820899,-776753,2022-05-03
CASH_IN,152973,Agence_moov_Abomey,300000,147027,Élodie Gérard,-776753,-623780,2022-05-06
CASH_IN,114972,Agence_moov_Abomey,300000,185028,Élodie Gérard,-623780,-508808,2022-05-07
CASH_IN,54761,Agence_moov_Abomey,300000,245239,Élodie Gérard,-508808,-454047,2022-05-08
CASH_IN,272885,Agence_moov_Ouidah,300000,27115,Élodie Gérard,-454047,-181162,2022-05-09
CASH_IN,276712,Agence_moov_Cotonou,300000,23288,Élodie Gérard,-181162,95550,2022-05-09
CASH_IN,261101,Agence_moov_Cotonou,300000,38899,Élodie Gérard,95550,356651,2022-05-11
TRANSFER,309201,Élodie Gérard,356651,47450,Alfred Chrétien,2861,-306340,2022-05-12
CASH_OUT,1041,Élodie Gérard,47450,46409,Agence_moov_Abomey,300000,298959,2022-05-14
TRANSFER,22209,Élodie Gérard,46409,24200,Élodie Gérard,46409,24200,2022-05-15
TRANSFER,1830,Élodie Gérard,24200,22370,Arnaude Gaillard,681980,680150,2022-05-15
CASH_OUT,16289,Élodie Gérard,22370,6081,Agence_moov_Abomey,300000,283711,2022-05-18
CASH_IN,16727,Agence_moov_Abomey,300000,283273,Élodie Gérard,6081,22808,2022-05-20
CASH_OUT,17112,Élodie Gérard,22808,5696,Agence_moov_Cotonou,300000,282888,2022-05-20
CASH_IN,172234,Agence_moov_Ouidah,300000,127766,Élodie Gérard,5696,177930,2022-05-20
TRANSFER,965896,Joseph de la Dubois,1483114,517218,Élodie Gérard,177930,1143826,2022-05-22
TRANSFER,33180,Élodie Gérard,1143826,1110646,Frédérique Robin,582923,549743,2022-05-22
CASH_OUT,857134,Élodie Gérard,1110646,253512,Agence_moov_Ouidah,300000,-557134,2022-05-23
TRANSFER,3843,Laurent Besson,14182,10339,Élodie Gérard,253512,257355,2022-05-24
CASH_OUT,36983,Élodie Gérard,257355,220372,Agence_moov_Abomey,300000,263017,2022-05-24
CASH_IN,209781,Agence_moov_Cotonou,300000,90219,Élodie Gérard,220372,430153,2022-05-25
CASH_IN,271370,Agence_moov_Cotonou,300000,28630,Élodie Gérard,430153,701523,2022-05-25
TRANSFER,38576,Diane-Françoise Raynaud,66338,27762,Caroline Peltier,47110,8534,2022-05-01
CASH_OUT,27719,Diane-Françoise Raynaud,27762,43,Agence_moov_Ouidah,300000,272281,2022-05-01
CASH_IN,124981,Agence_moov_Ouidah,300000,175019,Diane-Françoise Raynaud,43,125024,2022-05-02
CASH_OUT,43687,Diane-Françoise Raynaud,125024,81337,Agence_moov_Cotonou,300000,256313,2022-05-03
CASH_IN,27418,Agence_moov_Abomey,300000,272582,Diane-Françoise Raynaud,81337,108755,2022-05-04
CASH_IN,253910,Agence_moov_Cotonou,300000,46090,Diane-Françoise Raynaud,108755,362665,2022-05-04
CASH_OUT,198863,Diane-Françoise Raynaud,362665,163802,Agence_moov_Cotonou,300000,101137,2022-05-07
TRANSFER,2614,Diane-Françoise Raynaud,163802,161188,Arnaude Gaillard,680150,677536,2022-05-07
CASH_OUT,54382,Diane-Françoise Raynaud,161188,106806,Agence_moov_Abomey,300000,245618,2022-05-09
CASH_OUT,44211,Diane-Françoise Raynaud,106806,62595,Agence_moov_Abomey,300000,255789,2022-05-10
TRANSFER,21636,Jacques-Antoine Gros,76933,55297,Diane-Françoise Raynaud,62595,84231,2022-05-11
CASH_OUT,67854,Diane-Françoise Raynaud,84231,16377,Agence_moov_Abomey,300000,232146,2022-05-11
TRANSFER,420989,Joseph de la Dubois,517218,96229,Diane-Françoise Raynaud,16377,437366,2022-05-12
TRANSFER,1271,Matthieu Carpentier,5792,4521,Diane-Françoise Raynaud,437366,438637,2022-05-12
TRANSFER,10211,David-Théodore Diaz,184136,173925,Diane-Françoise Raynaud,438637,448848,2022-05-14
CASH_IN,34369,Agence_moov_Abomey,300000,265631,Diane-Françoise Raynaud,448848,483217,2022-05-15
CASH_IN,37133,Agence_moov_Cotonou,300000,262867,Diane-Françoise Raynaud,483217,520350,2022-05-15
CASH_IN,182798,Agence_moov_Abomey,300000,117202,Diane-Françoise Raynaud,520350,703148,2022-05-15
CASH_IN,178561,Agence_moov_Ouidah,300000,121439,Diane-Françoise Raynaud,703148,881709,2022-05-17
CASH_OUT,210428,Diane-Françoise Raynaud,881709,671281,Agence_moov_Cotonou,300000,89572,2022-05-17
TRANSFER,20056,Léon Paris,68999,48943,Diane-Françoise Raynaud,671281,691337,2022-05-18
TRANSFER,466328,Diane-Françoise Raynaud,691337,225009,Matthieu Carpentier,4521,-461807,2022-05-19
CASH_OUT,171825,Diane-Françoise Raynaud,225009,53184,Agence_moov_Cotonou,300000,128175,2022-05-21
CASH_OUT,20884,Diane-Françoise Raynaud,53184,32300,Agence_moov_Cotonou,300000,279116,2022-05-21
CASH_IN,214633,Agence_moov_Abomey,300000,85367,Diane-Françoise Raynaud,32300,246933,2022-05-22
CASH_OUT,34203,Diane-Françoise Raynaud,246933,212730,Agence_moov_Abomey,300000,265797,2022-05-23
CASH_OUT,77125,Diane-Françoise Raynaud,212730,135605,Agence_moov_Abomey,300000,222875,2022-05-23
CASH_OUT,2712,Diane-Françoise Raynaud,135605,132893,Agence_moov_Ouidah,300000,297288,2022-05-24
CASH_IN,264531,Agence_moov_Ouidah,300000,35469,Alfred Chrétien,-306340,-41809,2022-05-01
CASH_IN,68577,Agence_moov_Cotonou,300000,231423,Alfred Chrétien,-41809,26768,2022-05-07
TRANSFER,16694,Joseph de la Dubois,96229,79535,Alfred Chrétien,26768,43462,2022-05-12
CASH_OUT,11238,Alfred Chrétien,43462,32224,Agence_moov_Abomey,300000,288762,2022-05-14
TRANSFER,20620,Alfred Chrétien,32224,11604,Joseph de la Dubois,79535,58915,2022-05-14
CASH_OUT,3983,Alfred Chrétien,11604,7621,Agence_moov_Cotonou,300000,296017,2022-05-15
CASH_OUT,4380,Alfred Chrétien,7621,3241,Agence_moov_Cotonou,300000,295620,2022-05-17
CASH_IN,3348,Agence_moov_Abomey,300000,296652,Alfred Chrétien,3241,6589,2022-05-17
CASH_OUT,2229,Alfred Chrétien,6589,4360,Agence_moov_Ouidah,300000,297771,2022-05-18
CASH_OUT,820,Alfred Chrétien,4360,3540,Agence_moov_Ouidah,300000,299180,2022-05-19
TRANSFER,287266,Sébastien Jourdan,534831,247565,Alfred Chrétien,3540,290806,2022-05-20
CASH_OUT,114498,Alfred Chrétien,290806,176308,Agence_moov_Ouidah,300000,185502,2022-05-21
CASH_IN,254931,Agence_moov_Ouidah,300000,45069,Alfred Chrétien,176308,431239,2022-05-24
CASH_IN,165151,Agence_moov_Ouidah,300000,134849,Agnès Baron,-554837,-389686,2022-05-11
CASH_IN,11072,Agence_moov_Abomey,300000,288928,Agnès Baron,-389686,-378614,2022-05-13
CASH_IN,278716,Agence_moov_Cotonou,300000,21284,Agnès Baron,-378614,-99898,2022-05-15
CASH_IN,250008,Agence_moov_Abomey,300000,49992,Agnès Baron,-99898,150110,2022-05-16
CASH_OUT,79566,Agnès Baron,150110,70544,Agence_moov_Cotonou,300000,220434,2022-05-20
TRANSFER,27062,Agnès Baron,70544,43482,Juliette Evrard Le Giraud,11044,-16018,2022-05-21
CASH_OUT,27577,Agnès Baron,43482,15905,Agence_moov_Abomey,300000,272423,2022-05-24
CASH_IN,128340,Agence_moov_Cotonou,300000,171660,Juliette Evrard Le Giraud,-16018,112322,2022-05-01
CASH_IN,188467,Agence_moov_Ouidah,300000,111533,Juliette Evrard Le Giraud,112322,300789,2022-05-03
CASH_OUT,129318,Juliette Evrard Le Giraud,300789,171471,Agence_moov_Cotonou,300000,170682,2022-05-04
CASH_IN,103899,Agence_moov_Ouidah,300000,196101,Juliette Evrard Le Giraud,171471,275370,2022-05-05
CASH_OUT,217636,Juliette Evrard Le Giraud,275370,57734,Agence_moov_Abomey,300000,82364,2022-05-05
CASH_OUT,52455,Juliette Evrard Le Giraud,57734,5279,Agence_moov_Cotonou,300000,247545,2022-05-06
CASH_OUT,4486,Juliette Evrard Le Giraud,5279,793,Agence_moov_Abomey,300000,295514,2022-05-06
TRANSFER,297,Juliette Evrard Le Giraud,793,496,Agnès Chrétien-Sanchez,253686,253389,2022-05-06
CASH_OUT,228,Juliette Evrard Le Giraud,496,268,Agence_moov_Cotonou,300000,299772,2022-05-07
TRANSFER,149,Juliette Evrard Le Giraud,268,119,Laurent Perrot,127850,127701,2022-05-07
CASH_OUT,108,Juliette Evrard Le Giraud,119,11,Agence_moov_Ouidah,300000,299892,2022-05-12
CASH_IN,167634,Agence_moov_Ouidah,300000,132366,Juliette Evrard Le Giraud,11,167645,2022-05-13
CASH_IN,291439,Agence_moov_Ouidah,300000,8561,Juliette Evrard Le Giraud,167645,459084,2022-05-19
CASH_OUT,301940,Juliette Evrard Le Giraud,459084,157144,Agence_moov_Ouidah,300000,-1940,2022-05-21
CASH_OUT,41852,Juliette Evrard Le Giraud,157144,115292,Agence_moov_Abomey,300000,258148,2022-05-22
TRANSFER,49550,Juliette Evrard Le Giraud,115292,65742,Caroline Peltier,8534,-41016,2022-05-27
CASH_IN,293289,Agence_moov_Ouidah,300000,6711,Juliette Evrard Le Giraud,65742,359031,2022-05-27
CASH_IN,42145,Agence_moov_Ouidah,300000,257855,Juliette Evrard Le Giraud,359031,401176,2022-05-27
TRANSFER,365834,Juliette Evrard Le Giraud,401176,35342,Laurence Carlier,607470,241636,2022-05-27
CASH_IN,73187,Agence_moov_Ouidah,300000,226813,Émile Hebert,737512,810699,2022-05-02
TRANSFER,466187,Émile Hebert,810699,344512,Antoine Bourdon de Auger,1349431,883244,2022-05-03
TRANSFER,185976,Émile Hebert,344512,158536,Laurence Carlier,241636,55660,2022-05-03
CASH_IN,15183,Agence_moov_Abomey,300000,284817,Émile Hebert,158536,173719,2022-05-06
CASH_OUT,24704,Émile Hebert,173719,149015,Agence_moov_Ouidah,300000,275296,2022-05-07
CASH_IN,213124,Agence_moov_Abomey,300000,86876,Émile Hebert,149015,362139,2022-05-07
CASH_OUT,118264,Émile Hebert,362139,243875,Agence_moov_Ouidah,300000,181736,2022-05-09
CASH_IN,242321,Agence_moov_Ouidah,300000,57679,Émile Hebert,243875,486196,2022-05-18
CASH_OUT,477543,Émile Hebert,486196,8653,Agence_moov_Cotonou,300000,-177543,2022-05-19
CASH_IN,280784,Agence_moov_Cotonou,300000,19216,Émile Hebert,8653,289437,2022-05-20
CASH_IN,89557,Agence_moov_Cotonou,300000,210443,Émile Hebert,289437,378994,2022-05-21
CASH_IN,130376,Agence_moov_Abomey,300000,169624,Émile Hebert,378994,509370,2022-05-21
CASH_IN,51960,Agence_moov_Ouidah,300000,248040,Émile Hebert,509370,561330,2022-05-22
CASH_IN,265714,Agence_moov_Ouidah,300000,34286,Émile Hebert,561330,827044,2022-05-24
CASH_OUT,691396,Émile Hebert,827044,135648,Agence_moov_Ouidah,300000,-391396,2022-05-25
CASH_IN,291131,Agence_moov_Abomey,300000,8869,Emmanuel Bousquet,-1202447,-911316,2022-05-05
CASH_IN,174981,Agence_moov_Ouidah,300000,125019,Emmanuel Bousquet,-911316,-736335,2022-05-06
CASH_IN,40427,Agence_moov_Ouidah,300000,259573,Emmanuel Bousquet,-736335,-695908,2022-05-08
CASH_IN,267898,Agence_moov_Ouidah,300000,32102,Emmanuel Bousquet,-695908,-428010,2022-05-10
CASH_IN,144494,Agence_moov_Abomey,300000,155506,Emmanuel Bousquet,-428010,-283516,2022-05-11
CASH_IN,13651,Agence_moov_Abomey,300000,286349,Emmanuel Bousquet,-283516,-269865,2022-05-12
CASH_IN,4970,Agence_moov_Cotonou,300000,295030,Emmanuel Bousquet,-269865,-264895,2022-05-14
CASH_IN,16588,Agence_moov_Ouidah,300000,283412,Emmanuel Bousquet,-264895,-248307,2022-05-17
CASH_IN,112028,Agence_moov_Cotonou,300000,187972,Emmanuel Bousquet,-248307,-136279,2022-05-17
CASH_IN,233824,Agence_moov_Cotonou,300000,66176,Emmanuel Bousquet,-136279,97545,2022-05-19
CASH_IN,49629,Agence_moov_Cotonou,300000,250371,Emmanuel Bousquet,97545,147174,2022-05-19
TRANSFER,589004,Sébastien-Arthur Masse,611292,22288,Emmanuel Bousquet,147174,736178,2022-05-21
CASH_IN,49200,Agence_moov_Abomey,300000,250800,Emmanuel Bousquet,736178,785378,2022-05-23
TRANSFER,8945,Marie Da Silva,9430,485,Emmanuel Bousquet,785378,794323,2022-05-24
CASH_OUT,603566,Emmanuel Bousquet,794323,190757,Agence_moov_Cotonou,300000,-303566,2022-05-25
CASH_OUT,146248,Emmanuel Bousquet,190757,44509,Agence_moov_Abomey,300000,153752,2022-05-25
CASH_OUT,1033,Emmanuel Bousquet,44509,43476,Agence_moov_Abomey,300000,298967,2022-05-26
CASH_IN,112505,Agence_moov_Abomey,300000,187495,Emmanuel Bousquet,43476,155981,2022-05-26
CASH_IN,170447,Agence_moov_Abomey,300000,129553,Aimé Allain,-300522,-130075,2022-05-01
CASH_IN,32478,Agence_moov_Abomey,300000,267522,Aimé Allain,-130075,-97597,2022-05-02
CASH_IN,200457,Agence_moov_Ouidah,300000,99543,Aimé Allain,-97597,102860,2022-05-02
CASH_OUT,75865,Aimé Allain,102860,26995,Agence_moov_Cotonou,300000,224135,2022-05-07
CASH_IN,102655,Agence_moov_Cotonou,300000,197345,Aimé Allain,26995,129650,2022-05-08
TRANSFER,402,Christine-Constance Gauthier,9780,9378,Aimé Allain,129650,130052,2022-05-09
CASH_IN,230072,Agence_moov_Ouidah,300000,69928,Aimé Allain,130052,360124,2022-05-09
TRANSFER,228589,Aimé Allain,360124,131535,David Diallo,399692,171103,2022-05-14
TRANSFER,82070,Aimé Allain,131535,49465,Laurence Carlier,55660,-26410,2022-05-14
CASH_OUT,25161,Aimé Allain,49465,24304,Agence_moov_Ouidah,300000,274839,2022-05-15
CASH_IN,243015,Agence_moov_Abomey,300000,56985,Aimé Allain,24304,267319,2022-05-17
CASH_OUT,34328,Aimé Allain,267319,232991,Agence_moov_Cotonou,300000,265672,2022-05-19
TRANSFER,812,Théodore Bertin,2103,1291,Aimé Allain,232991,233803,2022-05-21
CASH_OUT,56445,Aimé Allain,233803,177358,Agence_moov_Abomey,300000,243555,2022-05-24
TRANSFER,90862,Aimé Allain,177358,86496,Jacques-Antoine Gros,55297,-35565,2022-05-25
CASH_OUT,4922,Aimé Allain,86496,81574,Agence_moov_Ouidah,300000,295078,2022-05-26
CASH_IN,69693,Agence_moov_Abomey,300000,230307,Aimé Allain,81574,151267,2022-05-27
CASH_IN,98286,Agence_moov_Ouidah,300000,201714,Lucy Vaillant,40,98326,2022-05-03
TRANSFER,4389,Sébastien-Arthur Masse,22288,17899,Lucy Vaillant,98326,102715,2022-05-03
CASH_IN,289158,Agence_moov_Cotonou,300000,10842,Lucy Vaillant,102715,391873,2022-05-04
CASH_IN,34611,Agence_moov_Abomey,300000,265389,Lucy Vaillant,391873,426484,2022-05-11
CASH_IN,194240,Agence_moov_Ouidah,300000,105760,Lucy Vaillant,426484,620724,2022-05-15
CASH_OUT,530731,Lucy Vaillant,620724,89993,Agence_moov_Ouidah,300000,-230731,2022-05-17
CASH_IN,268562,Agence_moov_Ouidah,300000,31438,Lucy Vaillant,89993,358555,2022-05-20
CASH_OUT,142429,Lucy Vaillant,358555,216126,Agence_moov_Ouidah,300000,157571,2022-05-23
CASH_IN,115975,Agence_moov_Cotonou,300000,184025,Lucy Vaillant,216126,332101,2022-05-23
CASH_OUT,3107,Christine-Constance Gauthier,9378,6271,Agence_moov_Cotonou,300000,296893,2022-05-02
TRANSFER,5072,Christine-Constance Gauthier,6271,1199,David Diallo,171103,166031,2022-05-03
CASH_OUT,1141,Christine-Constance Gauthier,1199,58,Agence_moov_Abomey,300000,298859,2022-05-05
CASH_IN,51709,Agence_moov_Abomey,300000,248291,Christine-Constance Gauthier,58,51767,2022-05-11
CASH_IN,168440,Agence_moov_Ouidah,300000,131560,Christine-Constance Gauthier,51767,220207,2022-05-11
CASH_OUT,16335,Christine-Constance Gauthier,220207,203872,Agence_moov_Cotonou,300000,283665,2022-05-12
CASH_OUT,4300,Christine-Constance Gauthier,203872,199572,Agence_moov_Cotonou,300000,295700,2022-05-12
CASH_IN,78662,Agence_moov_Ouidah,300000,221338,Christine-Constance Gauthier,199572,278234,2022-05-15
CASH_IN,28148,Agence_moov_Abomey,300000,271852,Christine-Constance Gauthier,278234,306382,2022-05-19
CASH_OUT,111700,Christine-Constance Gauthier,306382,194682,Agence_moov_Cotonou,300000,188300,2022-05-19
CASH_OUT,149875,Christine-Constance Gauthier,194682,44807,Agence_moov_Abomey,300000,150125,2022-05-20
CASH_IN,79022,Agence_moov_Cotonou,300000,220978,Christine-Constance Gauthier,44807,123829,2022-05-21
CASH_IN,295724,Agence_moov_Ouidah,300000,4276,Christine-Constance Gauthier,123829,419553,2022-05-23
CASH_OUT,345377,Christine-Constance Gauthier,419553,74176,Agence_moov_Abomey,300000,-45377,2022-05-23
TRANSFER,28877,Léon Paris,48943,20066,Christine-Constance Gauthier,74176,103053,2022-05-24
CASH_IN,60306,Agence_moov_Abomey,300000,239694,Christine-Constance Gauthier,103053,163359,2022-05-25
TRANSFER,36802,Margot Renaud de Lacombe,59866,23064,Christine-Constance Gauthier,163359,200161,2022-05-27
CASH_IN,52282,Agence_moov_Abomey,300000,247718,Noël Hamel,-1184,51098,2022-05-01
CASH_IN,267212,Agence_moov_Cotonou,300000,32788,Noël Hamel,51098,318310,2022-05-01
TRANSFER,221487,Noël Hamel,318310,96823,Augustin Benard,114748,-106739,2022-05-01
CASH_OUT,95917,Noël Hamel,96823,906,Agence_moov_Cotonou,300000,204083,2022-05-03
TRANSFER,88533,Marthe Pichon,1242667,1154134,Noël Hamel,906,89439,2022-05-04
CASH_IN,101382,Agence_moov_Abomey,300000,198618,Noël Hamel,89439,190821,2022-05-04
CASH_IN,234785,Agence_moov_Abomey,300000,65215,Noël Hamel,190821,425606,2022-05-06
CASH_OUT,304194,Noël Hamel,425606,121412,Agence_moov_Abomey,300000,-4194,2022-05-07
TRANSFER,40100,Noël Hamel,121412,81312,Margot Renaud de Lacombe,23064,-17036,2022-05-07
CASH_OUT,80564,Noël Hamel,81312,748,Agence_moov_Ouidah,300000,219436,2022-05-07
TRANSFER,208279,Frédérique Robin,549743,341464,Noël Hamel,748,209027,2022-05-07
TRANSFER,239719,Laurence Dumont de Laroche,647046,407327,Noël Hamel,209027,448746,2022-05-10
TRANSFER,14028,Maryse Lebreton,36364,22336,Noël Hamel,448746,462774,2022-05-12
TRANSFER,27406,David-Théodore Diaz,173925,146519,Noël Hamel,462774,490180,2022-05-15
CASH_OUT,207756,Noël Hamel,490180,282424,Agence_moov_Ouidah,300000,92244,2022-05-15
CASH_OUT,23888,Noël Hamel,282424,258536,Agence_moov_Cotonou,300000,276112,2022-05-18
TRANSFER,77175,Paul De Sousa,102368,25193,Noël Hamel,258536,335711,2022-05-20
CASH_OUT,22999,Noël Hamel,335711,312712,Agence_moov_Cotonou,300000,277001,2022-05-22
CASH_OUT,254170,Noël Hamel,312712,58542,Agence_moov_Cotonou,300000,45830,2022-05-26
CASH_IN,250881,Agence_moov_Cotonou,300000,49119,Agnès Chrétien-Sanchez,253389,504270,2022-05-02
CASH_IN,83453,Agence_moov_Abomey,300000,216547,Agnès Chrétien-Sanchez,504270,587723,2022-05-04
TRANSFER,112,Marie Da Silva,485,373,Agnès Chrétien-Sanchez,587723,587835,2022-05-05
CASH_IN,282943,Agence_moov_Cotonou,300000,17057,Agnès Chrétien-Sanchez,587835,870778,2022-05-06
CASH_OUT,396637,Agnès Chrétien-Sanchez,870778,474141,Agence_moov_Cotonou,300000,-96637,2022-05-06
CASH_IN,88752,Agence_moov_Cotonou,300000,211248,Agnès Chrétien-Sanchez,474141,562893,2022-05-07
TRANSFER,502778,Agnès Chrétien-Sanchez,562893,60115,David Diallo,166031,-336747,2022-05-07
CASH_OUT,57692,Agnès Chrétien-Sanchez,60115,2423,Agence_moov_Abomey,300000,242308,2022-05-09
CASH_IN,8589,Agence_moov_Ouidah,300000,291411,Agnès Chrétien-Sanchez,2423,11012,2022-05-12
CASH_IN,26240,Agence_moov_Ouidah,300000,273760,Agnès Chrétien-Sanchez,11012,37252,2022-05-14
CASH_IN,207683,Agence_moov_Cotonou,300000,92317,Agnès Chrétien-Sanchez,37252,244935,2022-05-17
CASH_IN,130357,Agence_moov_Ouidah,300000,169643,Agnès Chrétien-Sanchez,244935,375292,2022-05-17
TRANSFER,40833,Agnès Chrétien-Sanchez,375292,334459,Marie Da Silva,373,-40460,2022-05-18
CASH_IN,201218,Agence_moov_Cotonou,300000,98782,Agnès Chrétien-Sanchez,334459,535677,2022-05-19
CASH_OUT,108081,Agnès Chrétien-Sanchez,535677,427596,Agence_moov_Abomey,300000,191919,2022-05-20
CASH_OUT,393195,Agnès Chrétien-Sanchez,427596,34401,Agence_moov_Cotonou,300000,-93195,2022-05-21
TRANSFER,892463,Marthe Pichon,1154134,261671,Agnès Chrétien-Sanchez,34401,926864,2022-05-22
CASH_OUT,141473,Agnès Chrétien-Sanchez,926864,785391,Agence_moov_Abomey,300000,158527,2022-05-24
TRANSFER,63588,Frédérique Robin,341464,277876,Agnès Chrétien-Sanchez,785391,848979,2022-05-26
CASH_OUT,171565,Agnès Chrétien-Sanchez,848979,677414,Agence_moov_Ouidah,300000,128435,2022-05-27
CASH_OUT,8720,Sébastien-Arthur Masse,17899,9179,Agence_moov_Cotonou,300000,291280,2022-05-01
TRANSFER,2267,Sébastien-Arthur Masse,9179,6912,Marthe Pichon,261671,259404,2022-05-08
CASH_OUT,6437,Sébastien-Arthur Masse,6912,475,Agence_moov_Ouidah,300000,293563,2022-05-09
CASH_OUT,120,Sébastien-Arthur Masse,475,355,Agence_moov_Cotonou,300000,299880,2022-05-10
CASH_IN,127809,Agence_moov_Ouidah,300000,172191,Sébastien-Arthur Masse,355,128164,2022-05-17
CASH_IN,272852,Agence_moov_Cotonou,300000,27148,Sébastien-Arthur Masse,128164,401016,2022-05-25
CASH_OUT,136107,Sébastien-Arthur Masse,401016,264909,Agence_moov_Cotonou,300000,163893,2022-05-26
CASH_OUT,141102,Sébastien-Arthur Masse,264909,123807,Agence_moov_Abomey,300000,158898,2022-05-27
CASH_IN,68974,Agence_moov_Abomey,300000,231026,Noémi de la Didier,-643926,-574952,2022-05-03
CASH_IN,98209,Agence_moov_Abomey,300000,201791,Noémi de la Didier,-574952,-476743,2022-05-04
CASH_IN,196730,Agence_moov_Ouidah,300000,103270,Noémi de la Didier,-476743,-280013,2022-05-05
CASH_IN,11428,Agence_moov_Cotonou,300000,288572,Noémi de la Didier,-280013,-268585,2022-05-06
CASH_IN,178420,Agence_moov_Cotonou,300000,121580,Noémi de la Didier,-268585,-90165,2022-05-06
CASH_IN,215242,Agence_moov_Abomey,300000,84758,Noémi de la Didier,-90165,125077,2022-05-06
CASH_OUT,62797,Noémi de la Didier,125077,62280,Agence_moov_Ouidah,300000,237203,2022-05-08
TRANSFER,32049,Noémi de la Didier,62280,30231,Frédérique Robin,277876,245827,2022-05-09
TRANSFER,34847,Joseph de la Dubois,58915,24068,Noémi de la Didier,30231,65078,2022-05-15
TRANSFER,712856,Théodore-Alfred Fournier,800916,88060,Noémi de la Didier,65078,777934,2022-05-16
CASH_OUT,725872,Noémi de la Didier,777934,52062,Agence_moov_Ouidah,300000,-425872,2022-05-17
TRANSFER,28578,Théodore-Alfred Fournier,88060,59482,Noémi de la Didier,52062,80640,2022-05-17
CASH_OUT,78909,Noémi de la Didier,80640,1731,Agence_moov_Ouidah,300000,221091,2022-05-18
TRANSFER,955,Noémi de la Didier,1731,776,Laurence Dumont de Laroche,407327,406372,2022-05-24
CASH_IN,60397,Agence_moov_Ouidah,300000,239603,Noémi de la Didier,776,61173,2022-05-25
CASH_IN,193955,Agence_moov_Cotonou,300000,106045,Claudine Vallet,-531510,-337555,2022-05-01
CASH_IN,224315,Agence_moov_Cotonou,300000,75685,Claudine Vallet,-337555,-113240,2022-05-03
CASH_IN,66299,Agence_moov_Cotonou,300000,233701,Claudine Vallet,-113240,-46941,2022-05-03
CASH_IN,277691,Agence_moov_Abomey,300000,22309,Claudine Vallet,-46941,230750,2022-05-07
TRANSFER,178448,Claudine Vallet,230750,52302,Laurent Perrot,127701,-50747,2022-05-10
TRANSFER,125909,Sébastien Jourdan,247565,121656,Claudine Vallet,52302,178211,2022-05-13
CASH_OUT,121024,Claudine Vallet,178211,57187,Agence_moov_Abomey,300000,178976,2022-05-20
CASH_OUT,26993,Claudine Vallet,57187,30194,Agence_moov_Cotonou,300000,273007,2022-05-20
TRANSFER,6409,Claudine Vallet,30194,23785,Laurence Dumont de Laroche,406372,399963,2022-05-21
CASH_IN,90629,Agence_moov_Ouidah,300000,209371,Claudine Vallet,23785,114414,2022-05-21
CASH_OUT,105111,Claudine Vallet,114414,9303,Agence_moov_Abomey,300000,194889,2022-05-22
TRANSFER,214134,Frédérique Robin,245827,31693,Claudine Vallet,9303,223437,2022-05-22
CASH_IN,261392,Agence_moov_Abomey,300000,38608,Marie Da Silva,-40460,220932,2022-05-02
CASH_IN,77249,Agence_moov_Cotonou,300000,222751,Marie Da Silva,220932,298181,2022-05-02
CASH_IN,245610,Agence_moov_Cotonou,300000,54390,Marie Da Silva,298181,543791,2022-05-03
TRANSFER,16686,Joseph de la Dubois,24068,7382,Marie Da Silva,543791,560477,2022-05-05
CASH_IN,227886,Agence_moov_Ouidah,300000,72114,Marie Da Silva,560477,788363,2022-05-05
CASH_IN,123875,Agence_moov_Ouidah,300000,176125,Marie Da Silva,788363,912238,2022-05-06
TRANSFER,24453,Paul De Sousa,25193,740,Marie Da Silva,912238,936691,2022-05-11
TRANSFER,278808,Laurence Dumont de Laroche,399963,121155,Marie Da Silva,936691,1215499,2022-05-16
CASH_OUT,188617,Marie Da Silva,1215499,1026882,Agence_moov_Ouidah,300000,111383,2022-05-20
CASH_OUT,686382,Marie Da Silva,1026882,340500,Agence_moov_Ouidah,300000,-386382,2022-05-25
CASH_IN,98284,Agence_moov_Abomey,300000,201716,Roland Colin,-448967,-350683,2022-05-01
CASH_IN,137433,Agence_moov_Ouidah,300000,162567,Roland Colin,-350683,-213250,2022-05-01
CASH_IN,254210,Agence_moov_Ouidah,300000,45790,Roland Colin,-213250,40960,2022-05-04
CASH_OUT,11206,Roland Colin,40960,29754,Agence_moov_Cotonou,300000,288794,2022-05-08
TRANSFER,8422,Roland Colin,29754,21332,Joseph de la Dubois,7382,-1040,2022-05-09
CASH_IN,55054,Agence_moov_Cotonou,300000,244946,Roland Colin,21332,76386,2022-05-11
TRANSFER,13899,Roland Colin,76386,62487,Laurent Besson,10339,-3560,2022-05-13
TRANSFER,442186,Antoine Bourdon de Auger,883244,441058,Roland Colin,62487,504673,2022-05-20
CASH_OUT,306933,Roland Colin,504673,197740,Agence_moov_Cotonou,300000,-6933,2022-05-20
CASH_IN,20056,Agence_moov_Abomey,300000,279944,Roland Colin,197740,217796,2022-05-23
CASH_IN,6907,Agence_moov_Abomey,300000,293093,Roland Colin,217796,224703,2022-05-23
CASH_IN,227104,Agence_moov_Abomey,300000,72896,Théodore-Alfred Fournier,59482,286586,2022-05-06
CASH_IN,198981,Agence_moov_Ouidah,300000,101019,Théodore-Alfred Fournier,286586,485567,2022-05-07
CASH_OUT,52810,Théodore-Alfred Fournier,485567,432757,Agence_moov_Ouidah,300000,247190,2022-05-07
CASH_OUT,294616,Théodore-Alfred Fournier,432757,138141,Agence_moov_Abomey,300000,5384,2022-05-13
CASH_IN,100452,Agence_moov_Abomey,300000,199548,Théodore-Alfred Fournier,138141,238593,2022-05-15
TRANSFER,116040,Théodore-Alfred Fournier,238593,122553,Théodore Bertin,1291,-114749,2022-05-17
CASH_OUT,38354,Théodore-Alfred Fournier,122553,84199,Agence_moov_Abomey,300000,261646,2022-05-18
TRANSFER,14798,Théodore-Alfred Fournier,84199,69401,Amélie de la Picard,842401,827603,2022-05-20
TRANSFER,57210,Théodore-Alfred Fournier,69401,12191,Frédéric Moreau,33112,-24098,2022-05-22
CASH_IN,231370,Agence_moov_Cotonou,300000,68630,Théodore-Alfred Fournier,12191,243561,2022-05-23
TRANSFER,226992,Théodore-Alfred Fournier,243561,16569,Arnaude Gaillard,677536,450544,2022-05-26
CASH_IN,99370,Agence_moov_Abomey,300000,200630,Théodore-Alfred Fournier,16569,115939,2022-05-27
CASH_OUT,87625,Théodore-Alfred Fournier,115939,28314,Agence_moov_Cotonou,300000,212375,2022-05-27
CASH_IN,115046,Agence_moov_Ouidah,300000,184954,Josette Guillon-Leclercq,-449127,-334081,2022-05-03
CASH_IN,228145,Agence_moov_Abomey,300000,71855,Josette Guillon-Leclercq,-334081,-105936,2022-05-04
CASH_IN,294200,Agence_moov_Cotonou,300000,5800,Josette Guillon-Leclercq,-105936,188264,2022-05-05
CASH_OUT,78349,Josette Guillon-Leclercq,188264,109915,Agence_moov_Abomey,300000,221651,2022-05-06
TRANSFER,23290,Josette Guillon-Leclercq,109915,86625,David-Théodore Diaz,146519,123229,2022-05-07
CASH_OUT,62568,Josette Guillon-Leclercq,86625,24057,Agence_moov_Cotonou,300000,237432,2022-05-09
CASH_IN,248080,Agence_moov_Cotonou,300000,51920,Josette Guillon-Leclercq,24057,272137,2022-05-14
CASH_IN,215315,Agence_moov_Abomey,300000,84685,Josette Guillon-Leclercq,272137,487452,2022-05-14
CASH_OUT,68859,Josette Guillon-Leclercq,487452,418593,Agence_moov_Abomey,300000,231141,2022-05-15
CASH_OUT,16721,Josette Guillon-Leclercq,418593,401872,Agence_moov_Ouidah,300000,283279,2022-05-17
TRANSFER,14079,Maryse Lebreton,22336,8257,Josette Guillon-Leclercq,401872,415951,2022-05-20
TRANSFER,119162,David-Théodore Diaz,123229,4067,Josette Guillon-Leclercq,415951,535113,2022-05-20
CASH_IN,125579,Agence_moov_Abomey,300000,174421,Josette Guillon-Leclercq,535113,660692,2022-05-20
TRANSFER,253048,Marthe Pichon,259404,6356,Josette Guillon-Leclercq,660692,913740,2022-05-22
CASH_IN,128865,Agence_moov_Cotonou,300000,171135,Josette Guillon-Leclercq,913740,1042605,2022-05-24
TRANSFER,527,Paul De Sousa,740,213,Josette Guillon-Leclercq,1042605,1043132,2022-05-24
CASH_OUT,116942,Josette Guillon-Leclercq,1043132,926190,Agence_moov_Ouidah,300000,183058,2022-05-27
CASH_IN,178697,Agence_moov_Cotonou,300000,121303,Laurence Carlier,-26410,152287,2022-05-02
CASH_OUT,56537,Laurence Carlier,152287,95750,Agence_moov_Ouidah,300000,243463,2022-05-05
CASH_OUT,2671,Laurence Carlier,95750,93079,Agence_moov_Cotonou,300000,297329,2022-05-06
CASH_OUT,16965,Laurence Carlier,93079,76114,Agence_moov_Abomey,300000,283035,2022-05-07
TRANSFER,218,Laurence Carlier,76114,75896,Antoine Bourdon de Auger,441058,440840,2022-05-09
TRANSFER,15476,Laurence Carlier,75896,60420,Laurence Carlier,75896,91372,2022-05-09
CASH_OUT,6003,Laurence Carlier,60420,54417,Agence_moov_Cotonou,300000,293997,2022-05-16
TRANSFER,4214,Laurence Carlier,54417,50203,Paul De Sousa,213,-4001,2022-05-20
CASH_OUT,46836,Laurence Carlier,50203,3367,Agence_moov_Abomey,300000,253164,2022-05-21
CASH_OUT,265,Laurence Carlier,3367,3102,Agence_moov_Cotonou,300000,299735,2022-05-22
CASH_IN,110134,Agence_moov_Abomey,300000,189866,Laurence Carlier,3102,113236,2022-05-25
CASH_IN,282705,Agence_moov_Abomey,300000,17295,Frédéric Moreau,-24098,258607,2022-05-01
CASH_IN,120887,Agence_moov_Abomey,300000,179113,Frédéric Moreau,258607,379494,2022-05-02
TRANSFER,350092,Frédéric Moreau,379494,29402,Marthe Pichon,6356,-343736,2022-05-04
TRANSFER,22305,Frédéric Moreau,29402,7097,Frédéric Moreau,29402,51707,2022-05-05
CASH_OUT,2868,Frédéric Moreau,7097,4229,Agence_moov_Abomey,300000,297132,2022-05-06
CASH_OUT,2351,Frédéric Moreau,4229,1878,Agence_moov_Cotonou,300000,297649,2022-05-06
TRANSFER,4145,Maryse Lebreton,8257,4112,Frédéric Moreau,1878,6023,2022-05-06
CASH_OUT,4694,Frédéric Moreau,6023,1329,Agence_moov_Cotonou,300000,295306,2022-05-07
CASH_OUT,883,Frédéric Moreau,1329,446,Agence_moov_Ouidah,300000,299117,2022-05-10
TRANSFER,189,Frédéric Moreau,446,257,Laurence Dumont de Laroche,121155,120966,2022-05-11
CASH_IN,145615,Agence_moov_Abomey,300000,154385,Frédéric Moreau,257,145872,2022-05-14
CASH_OUT,44552,Frédéric Moreau,145872,101320,Agence_moov_Cotonou,300000,255448,2022-05-14
CASH_OUT,41348,Frédéric Moreau,101320,59972,Agence_moov_Cotonou,300000,258652,2022-05-14
CASH_OUT,55581,Frédéric Moreau,59972,4391,Agence_moov_Ouidah,300000,244419,2022-05-15
CASH_IN,287712,Agence_moov_Ouidah,300000,12288,Frédéric Moreau,4391,292103,2022-05-15
CASH_IN,16747,Agence_moov_Ouidah,300000,283253,Frédéric Moreau,292103,308850,2022-05-15
TRANSFER,272195,Frédéric Moreau,308850,36655,Antoine Bourdon de Auger,440840,168645,2022-05-16
TRANSFER,28226,Frédéric Moreau,36655,8429,Arnaude Gaillard,450544,422318,2022-05-18
CASH_OUT,6367,Frédéric Moreau,8429,2062,Agence_moov_Cotonou,300000,293633,2022-05-21
CASH_OUT,1862,Frédéric Moreau,2062,200,Agence_moov_Cotonou,300000,298138,2022-05-25
CASH_IN,296087,Agence_moov_Abomey,300000,3913,Théodore Bertin,-114749,181338,2022-05-07
CASH_IN,100610,Agence_moov_Ouidah,300000,199390,Théodore Bertin,181338,281948,2022-05-11
CASH_OUT,52433,Théodore Bertin,281948,229515,Agence_moov_Cotonou,300000,247567,2022-05-14
TRANSFER,1956,Arnaude Gaillard,422318,420362,Théodore Bertin,229515,231471,2022-05-16
TRANSFER,15601,Léon Paris,20066,4465,Théodore Bertin,231471,247072,2022-05-20
CASH_IN,213714,Agence_moov_Cotonou,300000,86286,Théodore Bertin,247072,460786,2022-05-20
CASH_IN,293687,Agence_moov_Ouidah,300000,6313,Théodore Bertin,460786,754473,2022-05-25
TRANSFER,602139,Théodore Bertin,754473,152334,Maryse Lebreton,4112,-598027,2022-05-27
CASH_OUT,119671,Théodore Bertin,152334,32663,Agence_moov_Cotonou,300000,180329,2022-05-27
CASH_IN,231204,Agence_moov_Cotonou,300000,68796,Léon Paris,4465,235669,2022-05-02
CASH_IN,223083,Agence_moov_Abomey,300000,76917,Léon Paris,235669,458752,2022-05-02
TRANSFER,451571,Léon Paris,458752,7181,David-Théodore Diaz,4067,-447504,2022-05-05
TRANSFER,97200,Sébastien Jourdan,121656,24456,Léon Paris,7181,104381,2022-05-06
TRANSFER,97856,Léon Paris,104381,6525,Amélie de la Picard,827603,729747,2022-05-09
CASH_IN,251678,Agence_moov_Ouidah,300000,48322,Léon Paris,6525,258203,2022-05-10
TRANSFER,1309,Sébastien Jourdan,24456,23147,Léon Paris,258203,259512,2022-05-12
TRANSFER,39207,Léon Paris,259512,220305,Léon Paris,259512,220305,2022-05-13
CASH_IN,286644,Agence_moov_Abomey,300000,13356,Léon Paris,220305,506949,2022-05-16
TRANSFER,217590,Léon Paris,506949,289359,Sébastien Jourdan,23147,-194443,2022-05-17
CASH_OUT,167356,Léon Paris,289359,122003,Agence_moov_Abomey,300000,132644,2022-05-19
TRANSFER,106961,Léon Paris,122003,15042,Amélie de la Picard,729747,622786,2022-05-21
CASH_IN,77063,Agence_moov_Abomey,300000,222937,Léon Paris,15042,92105,2022-05-24
CASH_OUT,73988,Léon Paris,92105,18117,Agence_moov_Abomey,300000,226012,2022-05-25
CASH_IN,273456,Agence_moov_Abomey,300000,26544,David Diallo,-336747,-63291,2022-05-01
CASH_IN,53320,Agence_moov_Abomey,300000,246680,David Diallo,-63291,-9971,2022-05-03
CASH_IN,147707,Agence_moov_Abomey,300000,152293,David Diallo,-9971,137736,2022-05-03
TRANSFER,345859,Arnaude Gaillard,420362,74503,David Diallo,137736,483595,2022-05-04
CASH_IN,138475,Agence_moov_Ouidah,300000,161525,David Diallo,483595,622070,2022-05-04
CASH_OUT,97819,David Diallo,622070,524251,Agence_moov_Abomey,300000,202181,2022-05-04
TRANSFER,8380,Arnaude Gaillard,74503,66123,David Diallo,524251,532631,2022-05-05
CASH_IN,127544,Agence_moov_Ouidah,300000,172456,David Diallo,532631,660175,2022-05-07
CASH_IN,168469,Agence_moov_Ouidah,300000,131531,David Diallo,660175,828644,2022-05-09
CASH_IN,241921,Agence_moov_Cotonou,300000,58079,David Diallo,828644,1070565,2022-05-10
CASH_OUT,235682,David Diallo,1070565,834883,Agence_moov_Cotonou,300000,64318,2022-05-12
CASH_OUT,618158,David Diallo,834883,216725,Agence_moov_Cotonou,300000,-318158,2022-05-13
CASH_IN,92732,Agence_moov_Abomey,300000,207268,David Diallo,216725,309457,2022-05-13
CASH_IN,102503,Agence_moov_Ouidah,300000,197497,David Diallo,309457,411960,2022-05-16
CASH_IN,159884,Agence_moov_Ouidah,300000,140116,David Diallo,411960,571844,2022-05-16
CASH_OUT,56012,David Diallo,571844,515832,Agence_moov_Cotonou,300000,243988,2022-05-17
TRANSFER,254706,David Diallo,515832,261126,Arnaude Gaillard,66123,-188583,2022-05-20
CASH_IN,293623,Agence_moov_Ouidah,300000,6377,David Diallo,261126,554749,2022-05-24
CASH_IN,128816,Agence_moov_Abomey,300000,171184,Laurent Besson,-3560,125256,2022-05-01
CASH_OUT,55518,Laurent Besson,125256,69738,Agence_moov_Ouidah,300000,244482,2022-05-09
CASH_IN,105855,Agence_moov_Ouidah,300000,194145,Laurent Besson,69738,175593,2022-05-09
TRANSFER,1748,Amélie de la Picard,622786,621038,Laurent Besson,175593,177341,2022-05-12
TRANSFER,134232,Laurent Besson,177341,43109,Amélie de la Picard,621038,486806,2022-05-13
TRANSFER,24643,Laurent Besson,43109,18466,Amélie de la Picard,486806,462163,2022-05-15
CASH_IN,35579,Agence_moov_Cotonou,300000,264421,Laurent Besson,18466,54045,2022-05-15
CASH_IN,44645,Agence_moov_Ouidah,300000,255355,Laurent Besson,54045,98690,2022-05-16
CASH_IN,249454,Agence_moov_Ouidah,300000,50546,Laurent Besson,98690,348144,2022-05-17
TRANSFER,109642,Laurence Dumont de Laroche,120966,11324,Laurent Besson,348144,457786,2022-05-19
TRANSFER,8139,Laurence Dumont de Laroche,11324,3185,Laurent Besson,457786,465925,2022-05-22
CASH_IN,181443,Agence_moov_Cotonou,300000,118557,Laurent Besson,465925,647368,2022-05-22
CASH_IN,95423,Agence_moov_Cotonou,300000,204577,Laurent Besson,647368,742791,2022-05-24
CASH_IN,290070,Agence_moov_Ouidah,300000,9930,Laurent Besson,742791,1032861,2022-05-24
CASH_IN,106331,Agence_moov_Abomey,300000,193669,Maurice Alves,-739094,-632763,2022-05-01
CASH_IN,174217,Agence_moov_Ouidah,300000,125783,Maurice Alves,-632763,-458546,2022-05-09
CASH_IN,288377,Agence_moov_Ouidah,300000,11623,Maurice Alves,-458546,-170169,2022-05-12
CASH_IN,90453,Agence_moov_Abomey,300000,209547,Maurice Alves,-170169,-79716,2022-05-15
CASH_IN,71536,Agence_moov_Cotonou,300000,228464,Maurice Alves,-79716,-8180,2022-05-18
CASH_IN,262102,Agence_moov_Cotonou,300000,37898,Maurice Alves,-8180,253922,2022-05-22
CASH_IN,156219,Agence_moov_Ouidah,300000,143781,Laurent Perrot,-50747,105472,2022-05-04
CASH_OUT,15402,Laurent Perrot,105472,90070,Agence_moov_Abomey,300000,284598,2022-05-07
CASH_OUT,23651,Laurent Perrot,90070,66419,Agence_moov_Abomey,300000,276349,2022-05-07
TRANSFER,13186,Laurent Perrot,66419,53233,Laurent Perrot,66419,79605,2022-05-07
TRANSFER,40486,Laurent Perrot,53233,12747,Laurent Perrot,53233,93719,2022-05-10
CASH_IN,80434,Agence_moov_Cotonou,300000,219566,Laurent Perrot,12747,93181,2022-05-11
CASH_IN,273543,Agence_moov_Ouidah,300000,26457,Laurent Perrot,93181,366724,2022-05-11
TRANSFER,291901,Laurent Perrot,366724,74823,Laurent Perrot,366724,658625,2022-05-12
CASH_OUT,21212,Laurent Perrot,74823,53611,Agence_moov_Ouidah,300000,278788,2022-05-12
CASH_OUT,16874,Laurent Perrot,53611,36737,Agence_moov_Ouidah,300000,283126,2022-05-12
CASH_IN,206458,Agence_moov_Abomey,300000,93542,Laurent Perrot,36737,243195,2022-05-17
TRANSFER,1508,Laurence Dumont de Laroche,3185,1677,Laurent Perrot,243195,244703,2022-05-18
CASH_OUT,145532,Laurent Perrot,244703,99171,Agence_moov_Abomey,300000,154468,2022-05-20
CASH_OUT,74243,Laurent Perrot,99171,24928,Agence_moov_Ouidah,300000,225757,2022-05-22
CASH_IN,212190,Agence_moov_Abomey,300000,87810,Laurent Perrot,24928,237118,2022-05-22
CASH_IN,176550,Agence_moov_Abomey,300000,123450,Laurent Perrot,237118,413668,2022-05-27
CASH_IN,108526,Agence_moov_Cotonou,300000,191474,Caroline Peltier,-41016,67510,2022-05-01
TRANSFER,50644,Caroline Peltier,67510,16866,Laurence Dumont de Laroche,1677,-48967,2022-05-03
TRANSFER,15512,Caroline Peltier,16866,1354,Caroline Peltier,16866,32378,2022-05-03
CASH_OUT,705,Caroline Peltier,1354,649,Agence_moov_Cotonou,300000,299295,2022-05-06
CASH_IN,31768,Agence_moov_Abomey,300000,268232,Caroline Peltier,649,32417,2022-05-09
TRANSFER,5646,Caroline Peltier,32417,26771,Amélie de la Picard,462163,456517,2022-05-13
CASH_OUT,7984,Caroline Peltier,26771,18787,Agence_moov_Ouidah,300000,292016,2022-05-13
CASH_OUT,2585,Caroline Peltier,18787,16202,Agence_moov_Ouidah,300000,297415,2022-05-14
CASH_IN,75192,Agence_moov_Ouidah,300000,224808,Caroline Peltier,16202,91394,2022-05-17
TRANSFER,341608,Amélie de la Picard,456517,114909,Caroline Peltier,91394,433002,2022-05-21
CASH_IN,247494,Agence_moov_Cotonou,300000,52506,Caroline Peltier,433002,680496,2022-05-26
TRANSFER,510192,Caroline Peltier,680496,170304,Amélie de la Picard,114909,-395283,2022-05-26
CASH_IN,97790,Agence_moov_Abomey,300000,202210,Amélie de la Picard,-395283,-297493,2022-05-01
CASH_IN,43126,Agence_moov_Abomey,300000,256874,Amélie de la Picard,-297493,-254367,2022-05-03
CASH_IN,157922,Agence_moov_Abomey,300000,142078,Amélie de la Picard,-254367,-96445,2022-05-05
CASH_IN,251974,Agence_moov_Abomey,300000,48026,Amélie de la Picard,-96445,155529,2022-05-13
CASH_OUT,130477,Amélie de la Picard,155529,25052,Agence_moov_Cotonou,300000,169523,2022-05-14
CASH_IN,214184,Agence_moov_Ouidah,300000,85816,Amélie de la Picard,25052,239236,2022-05-17
CASH_OUT,39082,Amélie de la Picard,239236,200154,Agence_moov_Cotonou,300000,260918,2022-05-17
CASH_IN,81515,Agence_moov_Ouidah,300000,218485,Amélie de la Picard,200154,281669,2022-05-20
CASH_IN,28920,Agence_moov_Abomey,300000,271080,Amélie de la Picard,281669,310589,2022-05-25
CASH_IN,209385,Agence_moov_Abomey,300000,90615,Amélie de la Picard,310589,519974,2022-05-26
CASH_IN,189064,Agence_moov_Ouidah,300000,110936,Bernadette Fabre,-358624,-169560,2022-05-01
CASH_IN,204856,Agence_moov_Abomey,300000,95144,Bernadette Fabre,-169560,35296,2022-05-06
CASH_OUT,33945,Bernadette Fabre,35296,1351,Agence_moov_Ouidah,300000,266055,2022-05-08
CASH_OUT,207,Bernadette Fabre,1351,1144,Agence_moov_Ouidah,300000,299793,2022-05-11
CASH_IN,139043,Agence_moov_Ouidah,300000,160957,Bernadette Fabre,1144,140187,2022-05-16
TRANSFER,118397,Bernadette Fabre,140187,21790,Bernadette Fabre,140187,21790,2022-05-19
TRANSFER,3973,Bernadette Fabre,21790,17817,Bernadette Fabre,21790,25763,2022-05-24
CASH_IN,233155,Agence_moov_Abomey,300000,66845,Bernadette Fabre,17817,250972,2022-05-24
CASH_IN,25581,Agence_moov_Abomey,300000,274419,Sébastien Jourdan,-194443,-168862,2022-05-01
CASH_IN,242491,Agence_moov_Abomey,300000,57509,Sébastien Jourdan,-168862,73629,2022-05-03
CASH_OUT,55274,Sébastien Jourdan,73629,18355,Agence_moov_Cotonou,300000,244726,2022-05-04
TRANSFER,11356,Sébastien Jourdan,18355,6999,Sébastien Jourdan,18355,6999,2022-05-07
CASH_IN,10949,Agence_moov_Cotonou,300000,289051,Sébastien Jourdan,6999,17948,2022-05-13
CASH_IN,270144,Agence_moov_Ouidah,300000,29856,Sébastien Jourdan,17948,288092,2022-05-15
CASH_OUT,43037,Sébastien Jourdan,288092,245055,Agence_moov_Cotonou,300000,256963,2022-05-18
CASH_IN,49674,Agence_moov_Ouidah,300000,250326,Sébastien Jourdan,245055,294729,2022-05-19
CASH_IN,164829,Agence_moov_Ouidah,300000,135171,Sébastien Jourdan,294729,459558,2022-05-23
CASH_IN,189404,Agence_moov_Cotonou,300000,110596,Émilie Guillon de Duhamel,-539730,-350326,2022-05-03
CASH_IN,68018,Agence_moov_Ouidah,300000,231982,Émilie Guillon de Duhamel,-350326,-282308,2022-05-07
CASH_IN,248367,Agence_moov_Abomey,300000,51633,Émilie Guillon de Duhamel,-282308,-33941,2022-05-09
CASH_IN,80831,Agence_moov_Cotonou,300000,219169,Émilie Guillon de Duhamel,-33941,46890,2022-05-11
CASH_IN,33010,Agence_moov_Cotonou,300000,266990,Émilie Guillon de Duhamel,46890,79900,2022-05-16
CASH_IN,83192,Agence_moov_Cotonou,300000,216808,Émilie Guillon de Duhamel,79900,163092,2022-05-17
CASH_OUT,42813,Émilie Guillon de Duhamel,163092,120279,Agence_moov_Abomey,300000,257187,2022-05-18
CASH_OUT,25282,Émilie Guillon de Duhamel,120279,94997,Agence_moov_Ouidah,300000,274718,2022-05-19
CASH_OUT,13295,Émilie Guillon de Duhamel,94997,81702,Agence_moov_Ouidah,300000,286705,2022-05-20
CASH_OUT,9886,Émilie Guillon de Duhamel,81702,71816,Agence_moov_Ouidah,300000,290114,2022-05-22
CASH_OUT,59965,Émilie Guillon de Duhamel,71816,11851,Agence_moov_Abomey,300000,240035,2022-05-23
CASH_IN,88813,Agence_moov_Cotonou,300000,211187,Amélie Gros-Riou,-32278,56535,2022-05-03
TRANSFER,10233,Amélie Gros-Riou,56535,46302,Amélie Gros-Riou,56535,46302,2022-05-03
CASH_IN,163953,Agence_moov_Cotonou,300000,136047,Amélie Gros-Riou,46302,210255,2022-05-07
CASH_IN,44505,Agence_moov_Cotonou,300000,255495,Amélie Gros-Riou,210255,254760,2022-05-09
CASH_IN,206026,Agence_moov_Ouidah,300000,93974,Amélie Gros-Riou,254760,460786,2022-05-10
CASH_IN,3745,Agence_moov_Cotonou,300000,296255,Amélie Gros-Riou,460786,464531,2022-05-10
TRANSFER,443032,Amélie Gros-Riou,464531,21499,Amélie Gros-Riou,464531,907563,2022-05-10
TRANSFER,13229,Amélie Gros-Riou,21499,8270,Amélie Gros-Riou,21499,8270,2022-05-13
CASH_OUT,6291,Amélie Gros-Riou,8270,1979,Agence_moov_Ouidah,300000,293709,2022-05-16
TRANSFER,501,Amélie Gros-Riou,1979,1478,Amélie Gros-Riou,1979,1478,2022-05-17
CASH_OUT,1446,Amélie Gros-Riou,1478,32,Agence_moov_Ouidah,300000,298554,2022-05-17
CASH_IN,120357,Agence_moov_Abomey,300000,179643,Amélie Gros-Riou,32,120389,2022-05-19
CASH_OUT,31932,Amélie Gros-Riou,120389,88457,Agence_moov_Abomey,300000,268068,2022-05-21
CASH_IN,6107,Agence_moov_Abomey,300000,293893,Amélie Gros-Riou,88457,94564,2022-05-23
CASH_OUT,86082,Amélie Gros-Riou,94564,8482,Agence_moov_Abomey,300000,213918,2022-05-24
CASH_IN,46473,Agence_moov_Cotonou,300000,253527,Maryse Lebreton,-598027,-551554,2022-05-02
CASH_IN,208945,Agence_moov_Cotonou,300000,91055,Maryse Lebreton,-551554,-342609,2022-05-05
CASH_IN,174510,Agence_moov_Ouidah,300000,125490,Maryse Lebreton,-342609,-168099,2022-05-06
CASH_IN,169996,Agence_moov_Cotonou,300000,130004,Maryse Lebreton,-168099,1897,2022-05-08
CASH_IN,126529,Agence_moov_Abomey,300000,173471,Maryse Lebreton,1897,128426,2022-05-17
CASH_OUT,7614,Maryse Lebreton,128426,120812,Agence_moov_Ouidah,300000,292386,2022-05-19
CASH_IN,69891,Agence_moov_Cotonou,300000,230109,Maryse Lebreton,120812,190703,2022-05-22
CASH_OUT,20742,Maryse Lebreton,190703,169961,Agence_moov_Cotonou,300000,279258,2022-05-22
CASH_IN,103392,Agence_moov_Cotonou,300000,196608,Maryse Lebreton,169961,273353,2022-05-23
CASH_IN,113995,Agence_moov_Cotonou,300000,186005,Maryse Lebreton,273353,387348,2022-05-27
CASH_IN,199982,Agence_moov_Abomey,300000,100018,Matthieu Carpentier,-461807,-261825,2022-05-03
CASH_IN,56704,Agence_moov_Abomey,300000,243296,Matthieu Carpentier,-261825,-205121,2022-05-03
CASH_IN,173214,Agence_moov_Cotonou,300000,126786,Matthieu Carpentier,-205121,-31907,2022-05-10
CASH_IN,188148,Agence_moov_Ouidah,300000,111852,Matthieu Carpentier,-31907,156241,2022-05-14
CASH_OUT,127813,Matthieu Carpentier,156241,28428,Agence_moov_Cotonou,300000,172187,2022-05-21
CASH_IN,21927,Agence_moov_Cotonou,300000,278073,Matthieu Carpentier,28428,50355,2022-05-26
CASH_IN,227124,Agence_moov_Abomey,300000,72876,Nathalie-Chantal Jacques,-101093,126031,2022-05-03
CASH_OUT,79155,Nathalie-Chantal Jacques,126031,46876,Agence_moov_Ouidah,300000,220845,2022-05-04
CASH_IN,259686,Agence_moov_Cotonou,300000,40314,Nathalie-Chantal Jacques,46876,306562,2022-05-04
TRANSFER,301544,Nathalie-Chantal Jacques,306562,5018,Nathalie-Chantal Jacques,306562,608106,2022-05-05
CASH_OUT,2787,Nathalie-Chantal Jacques,5018,2231,Agence_moov_Ouidah,300000,297213,2022-05-07
CASH_OUT,1774,Nathalie-Chantal Jacques,2231,457,Agence_moov_Cotonou,300000,298226,2022-05-07
CASH_IN,96956,Agence_moov_Cotonou,300000,203044,Nathalie-Chantal Jacques,457,97413,2022-05-20
CASH_IN,175758,Agence_moov_Cotonou,300000,124242,Paul De Sousa,-4001,171757,2022-05-02
CASH_OUT,146025,Paul De Sousa,171757,25732,Agence_moov_Ouidah,300000,153975,2022-05-05
TRANSFER,10292,Paul De Sousa,25732,15440,Paul De Sousa,25732,15440,2022-05-06
CASH_OUT,15028,Paul De Sousa,15440,412,Agence_moov_Cotonou,300000,284972,2022-05-08
CASH_OUT,235,Paul De Sousa,412,177,Agence_moov_Abomey,300000,299765,2022-05-08
CASH_IN,257974,Agence_moov_Abomey,300000,42026,Paul De Sousa,177,258151,2022-05-15
CASH_IN,39676,Agence_moov_Cotonou,300000,260324,Paul De Sousa,258151,297827,2022-05-24
CASH_IN,19376,Agence_moov_Ouidah,300000,280624,Laurence Dumont de Laroche,-48967,-29591,2022-05-05
CASH_IN,35528,Agence_moov_Cotonou,300000,264472,Laurence Dumont de Laroche,-29591,5937,2022-05-06
CASH_IN,223374,Agence_moov_Abomey,300000,76626,Laurence Dumont de Laroche,5937,229311,2022-05-06
TRANSFER,139300,Laurence Dumont de Laroche,229311,90011,Laurence Dumont de Laroche,229311,368611,2022-05-11
CASH_OUT,12261,Laurence Dumont de Laroche,90011,77750,Agence_moov_Ouidah,300000,287739,2022-05-14
TRANSFER,31872,Laurence Dumont de Laroche,77750,45878,Laurence Dumont de Laroche,77750,45878,2022-05-15
CASH_OUT,39522,Laurence Dumont de Laroche,45878,6356,Agence_moov_Abomey,300000,260478,2022-05-15
CASH_IN,291031,Agence_moov_Cotonou,300000,8969,Laurence Dumont de Laroche,6356,297387,2022-05-19
CASH_IN,104659,Agence_moov_Cotonou,300000,195341,Laurence Dumont de Laroche,297387,402046,2022-05-20
CASH_OUT,303497,Laurence Dumont de Laroche,402046,98549,Agence_moov_Ouidah,300000,-3497,2022-05-21
CASH_OUT,82062,Laurence Dumont de Laroche,98549,16487,Agence_moov_Abomey,300000,217938,2022-05-21
CASH_OUT,14750,Laurence Dumont de Laroche,16487,1737,Agence_moov_Cotonou,300000,285250,2022-05-22
CASH_IN,241537,Agence_moov_Cotonou,300000,58463,Laurence Dumont de Laroche,1737,243274,2022-05-23
CASH_OUT,28543,Laurence Dumont de Laroche,243274,214731,Agence_moov_Cotonou,300000,271457,2022-05-24
CASH_OUT,44543,Laurence Dumont de Laroche,214731,170188,Agence_moov_Abomey,300000,255457,2022-05-25
CASH_OUT,141421,Laurence Dumont de Laroche,170188,28767,Agence_moov_Ouidah,300000,158579,2022-05-26
CASH_IN,197116,Agence_moov_Ouidah,300000,102884,Océane Boutin,-297432,-100316,2022-05-01
CASH_IN,230147,Agence_moov_Cotonou,300000,69853,Océane Boutin,-100316,129831,2022-05-06
CASH_IN,294125,Agence_moov_Abomey,300000,5875,Océane Boutin,129831,423956,2022-05-06
TRANSFER,190420,Océane Boutin,423956,233536,Océane Boutin,423956,614376,2022-05-06
CASH_IN,149556,Agence_moov_Ouidah,300000,150444,Océane Boutin,233536,383092,2022-05-07
CASH_IN,215600,Agence_moov_Ouidah,300000,84400,Océane Boutin,383092,598692,2022-05-08
CASH_IN,173891,Agence_moov_Ouidah,300000,126109,Océane Boutin,598692,772583,2022-05-10
TRANSFER,542367,Océane Boutin,772583,230216,Océane Boutin,772583,1314950,2022-05-13
TRANSFER,143523,Océane Boutin,230216,86693,Océane Boutin,230216,373739,2022-05-14
CASH_OUT,31762,Océane Boutin,86693,54931,Agence_moov_Cotonou,300000,268238,2022-05-17
CASH_OUT,4023,Océane Boutin,54931,50908,Agence_moov_Ouidah,300000,295977,2022-05-19
CASH_IN,276300,Agence_moov_Cotonou,300000,23700,Marianne Descamps,-114865,161435,2022-05-05
CASH_OUT,112721,Marianne Descamps,161435,48714,Agence_moov_Abomey,300000,187279,2022-05-06
CASH_OUT,19541,Marianne Descamps,48714,29173,Agence_moov_Ouidah,300000,280459,2022-05-19
CASH_IN,68053,Agence_moov_Abomey,300000,231947,Marianne Descamps,29173,97226,2022-05-21
CASH_OUT,93952,Marianne Descamps,97226,3274,Agence_moov_Ouidah,300000,206048,2022-05-22
CASH_IN,142746,Agence_moov_Ouidah,300000,157254,Marianne Descamps,3274,146020,2022-05-25
CASH_IN,75582,Agence_moov_Cotonou,300000,224418,Isaac Le Pinto,-450216,-374634,2022-05-01
CASH_IN,188029,Agence_moov_Abomey,300000,111971,Isaac Le Pinto,-374634,-186605,2022-05-04
CASH_IN,292156,Agence_moov_Ouidah,300000,7844,Isaac Le Pinto,-186605,105551,2022-05-10
TRANSFER,71634,Isaac Le Pinto,105551,33917,Isaac Le Pinto,105551,177185,2022-05-10
CASH_OUT,1581,Isaac Le Pinto,33917,32336,Agence_moov_Ouidah,300000,298419,2022-05-12
CASH_OUT,14632,Isaac Le Pinto,32336,17704,Agence_moov_Abomey,300000,285368,2022-05-14
CASH_OUT,10607,Isaac Le Pinto,17704,7097,Agence_moov_Cotonou,300000,289393,2022-05-21
CASH_IN,178601,Agence_moov_Cotonou,300000,121399,Isaac Le Pinto,7097,185698,2022-05-26
CASH_IN,89753,Agence_moov_Cotonou,300000,210247,Susan de Fontaine,-87340,2413,2022-05-05
CASH_IN,94730,Agence_moov_Cotonou,300000,205270,Susan de Fontaine,2413,97143,2022-05-07
CASH_IN,177301,Agence_moov_Ouidah,300000,122699,Susan de Fontaine,97143,274444,2022-05-10
CASH_OUT,145281,Susan de Fontaine,274444,129163,Agence_moov_Cotonou,300000,154719,2022-05-12
CASH_IN,156905,Agence_moov_Abomey,300000,143095,Susan de Fontaine,129163,286068,2022-05-13
CASH_IN,41892,Agence_moov_Abomey,300000,258108,Susan de Fontaine,286068,327960,2022-05-13
TRANSFER,230784,Susan de Fontaine,327960,97176,Susan de Fontaine,327960,558744,2022-05-14
CASH_IN,110605,Agence_moov_Abomey,300000,189395,Susan de Fontaine,97176,207781,2022-05-20
CASH_OUT,46857,Susan de Fontaine,207781,160924,Agence_moov_Ouidah,300000,253143,2022-05-26
CASH_IN,170657,Agence_moov_Cotonou,300000,129343,Augustin Benard,-106739,63918,2022-05-10
CASH_IN,164533,Agence_moov_Ouidah,300000,135467,Augustin Benard,63918,228451,2022-05-11
CASH_IN,221346,Agence_moov_Abomey,300000,78654,Augustin Benard,228451,449797,2022-05-11
TRANSFER,188477,Augustin Benard,449797,261320,Augustin Benard,449797,261320,2022-05-14
CASH_IN,257899,Agence_moov_Abomey,300000,42101,Augustin Benard,261320,519219,2022-05-15
TRANSFER,357504,Augustin Benard,519219,161715,Augustin Benard,519219,876723,2022-05-16
TRANSFER,36739,Augustin Benard,161715,124976,Augustin Benard,161715,124976,2022-05-18
TRANSFER,83682,Augustin Benard,124976,41294,Augustin Benard,124976,41294,2022-05-19
CASH_IN,226398,Agence_moov_Ouidah,300000,73602,Augustin Benard,41294,267692,2022-05-20
CASH_OUT,106543,Augustin Benard,267692,161149,Agence_moov_Ouidah,300000,193457,2022-05-21
CASH_OUT,102364,Augustin Benard,161149,58785,Agence_moov_Ouidah,300000,197636,2022-05-21
CASH_IN,165289,Agence_moov_Abomey,300000,134711,Augustin Benard,58785,224074,2022-05-21
CASH_OUT,202642,Augustin Benard,224074,21432,Agence_moov_Abomey,300000,97358,2022-05-23
CASH_IN,74668,Agence_moov_Abomey,300000,225332,Augustin Benard,21432,96100,2022-05-24
CASH_OUT,56983,Augustin Benard,96100,39117,Agence_moov_Abomey,300000,243017,2022-05-25
CASH_IN,260481,Agence_moov_Cotonou,300000,39519,Luc Camus,-109094,151387,2022-05-01
CASH_OUT,89249,Luc Camus,151387,62138,Agence_moov_Ouidah,300000,210751,2022-05-03
CASH_IN,161659,Agence_moov_Ouidah,300000,138341,Luc Camus,62138,223797,2022-05-09
CASH_IN,130148,Agence_moov_Abomey,300000,169852,Luc Camus,223797,353945,2022-05-09
CASH_IN,65102,Agence_moov_Ouidah,300000,234898,Luc Camus,353945,419047,2022-05-10
TRANSFER,120278,Luc Camus,419047,298769,Luc Camus,419047,539325,2022-05-10
CASH_IN,263564,Agence_moov_Ouidah,300000,36436,Luc Camus,298769,562333,2022-05-12
CASH_IN,105336,Agence_moov_Cotonou,300000,194664,Luc Camus,562333,667669,2022-05-12
CASH_OUT,330258,Luc Camus,667669,337411,Agence_moov_Ouidah,300000,-30258,2022-05-16
CASH_IN,128595,Agence_moov_Ouidah,300000,171405,Luc Camus,337411,466006,2022-05-17
CASH_IN,82812,Agence_moov_Ouidah,300000,217188,Margot Renaud de Lacombe,-17036,65776,2022-05-03
CASH_OUT,2391,Margot Renaud de Lacombe,65776,63385,Agence_moov_Ouidah,300000,297609,2022-05-03
CASH_OUT,1713,Margot Renaud de Lacombe,63385,61672,Agence_moov_Ouidah,300000,298287,2022-05-06
TRANSFER,10429,Margot Renaud de Lacombe,61672,51243,Margot Renaud de Lacombe,61672,72101,2022-05-06
CASH_IN,209224,Agence_moov_Cotonou,300000,90776,Margot Renaud de Lacombe,51243,260467,2022-05-08
CASH_IN,227085,Agence_moov_Cotonou,300000,72915,Margot Renaud de Lacombe,260467,487552,2022-05-12
CASH_OUT,47329,Margot Renaud de Lacombe,487552,440223,Agence_moov_Abomey,300000,252671,2022-05-17
CASH_OUT,269659,Margot Renaud de Lacombe,440223,170564,Agence_moov_Cotonou,300000,30341,2022-05-18
CASH_OUT,143611,Margot Renaud de Lacombe,170564,26953,Agence_moov_Cotonou,300000,156389,2022-05-19
CASH_OUT,6344,Margot Renaud de Lacombe,26953,20609,Agence_moov_Ouidah,300000,293656,2022-05-19
CASH_OUT,3596,Margot Renaud de Lacombe,20609,17013,Agence_moov_Ouidah,300000,296404,2022-05-24
CASH_IN,40089,Agence_moov_Abomey,300000,259911,Jacques-Antoine Gros,-35565,4524,2022-05-01
CASH_IN,182106,Agence_moov_Abomey,300000,117894,Jacques-Antoine Gros,4524,186630,2022-05-05
CASH_IN,22788,Agence_moov_Abomey,300000,277212,Jacques-Antoine Gros,186630,209418,2022-05-05
CASH_OUT,166212,Jacques-Antoine Gros,209418,43206,Agence_moov_Abomey,300000,133788,2022-05-07
CASH_OUT,9784,Jacques-Antoine Gros,43206,33422,Agence_moov_Cotonou,300000,290216,2022-05-13
CASH_OUT,30446,Jacques-Antoine Gros,33422,2976,Agence_moov_Ouidah,300000,269554,2022-05-14
CASH_OUT,1281,Jacques-Antoine Gros,2976,1695,Agence_moov_Ouidah,300000,298719,2022-05-23
CASH_IN,135197,Agence_moov_Ouidah,300000,164803,David-Théodore Diaz,-447504,-312307,2022-05-01
CASH_IN,87302,Agence_moov_Ouidah,300000,212698,David-Théodore Diaz,-312307,-225005,2022-05-03
CASH_IN,285963,Agence_moov_Ouidah,300000,14037,David-Théodore Diaz,-225005,60958,2022-05-05
CASH_OUT,16179,David-Théodore Diaz,60958,44779,Agence_moov_Abomey,300000,283821,2022-05-05
CASH_IN,213302,Agence_moov_Abomey,300000,86698,David-Théodore Diaz,44779,258081,2022-05-06
CASH_OUT,163932,David-Théodore Diaz,258081,94149,Agence_moov_Abomey,300000,136068,2022-05-07
CASH_OUT,8482,David-Théodore Diaz,94149,85667,Agence_moov_Abomey,300000,291518,2022-05-07
CASH_IN,147530,Agence_moov_Ouidah,300000,152470,David-Théodore Diaz,85667,233197,2022-05-10
TRANSFER,139143,David-Théodore Diaz,233197,94054,David-Théodore Diaz,233197,372340,2022-05-13
CASH_OUT,5719,David-Théodore Diaz,94054,88335,Agence_moov_Cotonou,300000,294281,2022-05-13
CASH_IN,9806,Agence_moov_Cotonou,300000,290194,David-Théodore Diaz,88335,98141,2022-05-15
CASH_OUT,12002,David-Théodore Diaz,98141,86139,Agence_moov_Abomey,300000,287998,2022-05-19
CASH_IN,73318,Agence_moov_Ouidah,300000,226682,David-Théodore Diaz,86139,159457,2022-05-23
CASH_IN,126480,Agence_moov_Abomey,300000,173520,David-Théodore Diaz,159457,285937,2022-05-27
CASH_IN,87656,Agence_moov_Cotonou,300000,212344,Marthe Pichon,-343736,-256080,2022-05-01
CASH_IN,199683,Agence_moov_Ouidah,300000,100317,Marthe Pichon,-256080,-56397,2022-05-04
CASH_IN,88166,Agence_moov_Ouidah,300000,211834,Marthe Pichon,-56397,31769,2022-05-07
CASH_OUT,29238,Marthe Pichon,31769,2531,Agence_moov_Cotonou,300000,270762,2022-05-08
CASH_OUT,1190,Marthe Pichon,2531,1341,Agence_moov_Ouidah,300000,298810,2022-05-10
CASH_OUT,729,Marthe Pichon,1341,612,Agence_moov_Cotonou,300000,299271,2022-05-11
TRANSFER,359,Marthe Pichon,612,253,Marthe Pichon,612,253,2022-05-12
CASH_OUT,187,Marthe Pichon,253,66,Agence_moov_Abomey,300000,299813,2022-05-13
CASH_IN,266161,Agence_moov_Abomey,300000,33839,Marthe Pichon,66,266227,2022-05-15
CASH_IN,139497,Agence_moov_Cotonou,300000,160503,Marthe Pichon,266227,405724,2022-05-17
CASH_IN,92364,Agence_moov_Ouidah,300000,207636,Marthe Pichon,405724,498088,2022-05-17
CASH_OUT,268263,Marthe Pichon,498088,229825,Agence_moov_Ouidah,300000,31737,2022-05-17
CASH_IN,69784,Agence_moov_Cotonou,300000,230216,Marthe Pichon,229825,299609,2022-05-20
CASH_IN,293797,Agence_moov_Abomey,300000,6203,Marthe Pichon,299609,593406,2022-05-20
CASH_IN,73343,Agence_moov_Cotonou,300000,226657,Marthe Pichon,593406,666749,2022-05-23
CASH_OUT,311015,Marthe Pichon,666749,355734,Agence_moov_Ouidah,300000,-11015,2022-05-24
CASH_OUT,553175,Caroline Peltier,1557300,1004125,Agence_moov_Cotonou,300000,-253175,2022-06-03
CASH_OUT,1022987,Marie Da Silva,1520700,497713,Agence_moov_Cotonou,300000,-722987,2022-06-14
TRANSFER,654405,David-Théodore Diaz,1231300,576895,Anastasie Louis,821400,166995,2022-06-01
CASH_OUT,340463,David-Théodore Diaz,576895,236432,Agence_moov_Cotonou,300000,-40463,2022-06-04
TRANSFER,29276,David-Théodore Diaz,236432,207156,Julie Robin de Gros,1567700,1538424,2022-06-12
CASH_IN,8558,Agence_moov_Cotonou,300000,291442,David-Théodore Diaz,207156,215714,2022-06-21
TRANSFER,188364,Guy Guyon,215600,27236,Nicole Lacroix,1143800,955436,2022-06-09
TRANSFER,2214,Guy Guyon,27236,25022,Stéphanie Bonneau,1522100,1519886,2022-06-10
TRANSFER,1812554,Joseph de la Dubois,1930700,118146,Guy Guyon,25022,1837576,2022-06-14
CASH_IN,128518,Agence_moov_Ouidah,300000,171482,Guy Guyon,1837576,1966094,2022-06-19
CASH_IN,196771,Agence_moov_Ouidah,300000,103229,Guy Guyon,1966094,2162865,2022-06-24
CASH_IN,119358,Agence_moov_Abomey,300000,180642,Frédérique Robin,38700,158058,2022-06-08
CASH_IN,36574,Agence_moov_Abomey,300000,263426,Frédérique Robin,158058,194632,2022-06-08
CASH_IN,293189,Agence_moov_Abomey,300000,6811,Frédérique Robin,194632,487821,2022-06-12
TRANSFER,15017,Frédérique Robin,487821,472804,Susan de Fontaine,1121300,1106283,2022-06-15
TRANSFER,9173,Luc Camus,69400,60227,Frédérique Robin,472804,481977,2022-06-27
CASH_OUT,624687,Auguste Bousquet,824600,199913,Agence_moov_Ouidah,300000,-324687,2022-06-05
CASH_IN,151201,Agence_moov_Abomey,300000,148799,Auguste Bousquet,199913,351114,2022-06-13
CASH_IN,53110,Agence_moov_Abomey,300000,246890,Auguste Bousquet,351114,404224,2022-06-18
CASH_OUT,159349,Auguste Bousquet,404224,244875,Agence_moov_Ouidah,300000,140651,2022-06-20
CASH_IN,109690,Agence_moov_Abomey,300000,190310,Auguste Bousquet,244875,354565,2022-06-24
CASH_IN,98663,Agence_moov_Abomey,300000,201337,Grégoire Delmas de Blanchard,184600,283263,2022-06-01
TRANSFER,106274,Nath Léger,288500,182226,Grégoire Delmas de Blanchard,283263,389537,2022-06-12
CASH_OUT,186199,Grégoire Delmas de Blanchard,389537,203338,Agence_moov_Cotonou,300000,113801,2022-06-18
CASH_IN,11474,Agence_moov_Ouidah,300000,288526,Grégoire Delmas de Blanchard,203338,214812,2022-06-20
CASH_OUT,22484,Grégoire Delmas de Blanchard,214812,192328,Agence_moov_Cotonou,300000,277516,2022-06-26
CASH_IN,12622,Agence_moov_Ouidah,300000,287378,Léon Paris,49600,62222,2022-06-03
TRANSFER,19769,Laurence Carlier,1451600,1431831,Nathalie-Chantal Jacques,1068200,1087969,2022-06-08
TRANSFER,929062,Nathalie-Chantal Jacques,1087969,158907,Noémi de la Didier,548800,-380262,2022-06-15
CASH_IN,35450,Agence_moov_Cotonou,300000,264550,Nathalie-Chantal Jacques,158907,194357,2022-06-27
CASH_OUT,235909,Xavier-Stéphane Ollivier,373500,137591,Agence_moov_Abomey,300000,64091,2022-06-13
CASH_OUT,134282,Xavier-Stéphane Ollivier,137591,3309,Agence_moov_Abomey,300000,165718,2022-06-17
TRANSFER,1044154,Nicolas Hervé,1395700,351546,Xavier-Stéphane Ollivier,3309,1047463,2022-06-20
TRANSFER,862868,Xavier-Stéphane Ollivier,1047463,184595,Maryse Reynaud-Michaud,674200,-188668,2022-06-26
CASH_IN,115439,Agence_moov_Cotonou,300000,184561,Émilie Guillon de Duhamel,56900,172339,2022-06-06
CASH_IN,60543,Agence_moov_Cotonou,300000,239457,Émilie Guillon de Duhamel,172339,232882,2022-06-07
TRANSFER,126229,Alfred Chrétien,146100,19871,Émilie Guillon de Duhamel,232882,359111,2022-06-14
TRANSFER,298288,Émilie Guillon de Duhamel,359111,60823,Frédéric Moreau,1916800,1618512,2022-06-21
TRANSFER,16442,Émilie Guillon de Duhamel,60823,44381,Caroline Monnier,56300,39858,2022-06-27
CASH_IN,23262,Agence_moov_Abomey,300000,276738,Paulette Dias,414900,438162,2022-06-07
CASH_OUT,352807,Paulette Dias,438162,85355,Agence_moov_Abomey,300000,-52807,2022-06-12
CASH_OUT,46765,Paulette Dias,85355,38590,Agence_moov_Abomey,300000,253235,2022-06-12
CASH_OUT,9917,Paulette Dias,38590,28673,Agence_moov_Ouidah,300000,290083,2022-06-13
CASH_IN,102557,Agence_moov_Abomey,300000,197443,Paulette Dias,28673,131230,2022-06-18
CASH_OUT,421463,Antoine Leroux,1319100,897637,Agence_moov_Ouidah,300000,-121463,2022-06-07
CASH_IN,157630,Agence_moov_Abomey,300000,142370,Antoine Leroux,897637,1055267,2022-06-21
CASH_IN,54444,Agence_moov_Ouidah,300000,245556,Antoine Leroux,1055267,1109711,2022-06-26
CASH_IN,59680,Agence_moov_Abomey,300000,240320,Matthieu Renard,994600,1054280,2022-06-03
CASH_OUT,822735,Matthieu Renard,1054280,231545,Agence_moov_Ouidah,300000,-522735,2022-06-05
TRANSFER,75006,Amélie de la Picard,159900,84894,Matthieu Renard,231545,306551,2022-06-12
TRANSFER,1041787,Frédéric Moreau,1618512,576725,Matthieu Renard,306551,1348338,2022-06-14
CASH_OUT,1029777,Matthieu Renard,1348338,318561,Agence_moov_Cotonou,300000,-729777,2022-06-24
CASH_IN,210866,Agence_moov_Abomey,300000,89134,Richard Guibert,1587200,1798066,2022-06-08
CASH_IN,241795,Agence_moov_Abomey,300000,58205,Richard Guibert,1798066,2039861,2022-06-14
CASH_IN,179472,Agence_moov_Abomey,300000,120528,Richard Guibert,2039861,2219333,2022-06-27
CASH_OUT,1194093,Emmanuelle Gilbert,1270400,76307,Agence_moov_Ouidah,300000,-894093,2022-06-06
CASH_IN,52613,Agence_moov_Cotonou,300000,247387,Emmanuelle Gilbert,76307,128920,2022-06-07
TRANSFER,1146402,Paul Pereira,1736900,590498,Emmanuelle Gilbert,128920,1275322,2022-06-12
CASH_IN,89783,Agence_moov_Cotonou,300000,210217,Emmanuelle Gilbert,1275322,1365105,2022-06-13
CASH_IN,112106,Agence_moov_Cotonou,300000,187894,Emmanuelle Gilbert,1365105,1477211,2022-06-24
CASH_OUT,1433537,Clémence Bertin,1854700,421163,Agence_moov_Abomey,300000,-1133537,2022-06-07
CASH_OUT,372594,Clémence Bertin,421163,48569,Agence_moov_Ouidah,300000,-72594,2022-06-17
CASH_IN,202775,Agence_moov_Abomey,300000,97225,Clémence Bertin,48569,251344,2022-06-23
CASH_OUT,66272,Clémence Bertin,251344,185072,Agence_moov_Abomey,300000,233728,2022-06-24
CASH_IN,106954,Agence_moov_Cotonou,300000,193046,Bernadette Fabre,304900,411854,2022-06-20
CASH_IN,76145,Agence_moov_Abomey,300000,223855,Benoît Verdier,1620300,1696445,2022-06-12
CASH_OUT,1293568,Benoît Verdier,1696445,402877,Agence_moov_Abomey,300000,-993568,2022-06-22
TRANSFER,1316690,Juliette Evrard Le Giraud,1948100,631410,Maurice Alves,1507900,2824590,2022-06-12
TRANSFER,346233,Agnès Baron,592200,245967,Maurice Alves,2824590,3170823,2022-06-16
TRANSFER,41862,Roland Colin,581300,539438,Caroline Bonneau,1424800,1382938,2022-06-05
CASH_OUT,292734,Roland Colin,539438,246704,Agence_moov_Cotonou,300000,7266,2022-06-13
TRANSFER,1478433,Christophe Guilbert,1691700,213267,Noël Hamel,1888900,3367333,2022-06-02
CASH_OUT,282096,Noël Hamel,3367333,3085237,Agence_moov_Cotonou,300000,17904,2022-06-09
TRANSFER,76520,Sébastien-Arthur Masse,415000,338480,Noël Hamel,3085237,3161757,2022-06-16
TRANSFER,920557,Valentine Traore,1297600,377043,Noël Hamel,3161757,4082314,2022-06-24
CASH_IN,193761,Agence_moov_Ouidah,300000,106239,Noël Hamel,4082314,4276075,2022-06-25
TRANSFER,380092,Claudine Vallet,641200,261108,Laurent Perrot,1785300,2165392,2022-06-07
TRANSFER,1706699,Laurent Perrot,2165392,458693,Laurent Besson,1701500,-5199,2022-06-26
CASH_OUT,1385899,Stéphanie Bonneau,1519886,133987,Agence_moov_Cotonou,300000,-1085899,2022-06-03
TRANSFER,79611,Stéphanie Bonneau,133987,54376,David Diallo,1040400,960789,2022-06-16
CASH_OUT,32361,Stéphanie Bonneau,54376,22015,Agence_moov_Ouidah,300000,267639,2022-06-18
TRANSFER,2123,Stéphanie Bonneau,22015,19892,Sébastien Jourdan,393100,390977,2022-06-24
TRANSFER,43596,Vincent-Grégoire Brunet,968300,924704,Claudine Vallet,261108,304704,2022-06-01
CASH_IN,122215,Agence_moov_Cotonou,300000,177785,Claudine Vallet,304704,426919,2022-06-05
TRANSFER,50023,Maryse Lebreton,665700,615677,Claudine Vallet,426919,476942,2022-06-05
TRANSFER,278423,Claudine Vallet,476942,198519,Élodie Gérard,914700,636277,2022-06-06
CASH_IN,237617,Agence_moov_Cotonou,300000,62383,Claudine Vallet,198519,436136,2022-06-06
TRANSFER,197054,Josette Guillon-Leclercq,951100,754046,Claudine Vallet,436136,633190,2022-06-07
CASH_OUT,308774,Claudine Vallet,633190,324416,Agence_moov_Cotonou,300000,-8774,2022-06-10
CASH_OUT,209440,Claudine Vallet,324416,114976,Agence_moov_Cotonou,300000,90560,2022-06-10
CASH_OUT,37913,Claudine Vallet,114976,77063,Agence_moov_Ouidah,300000,262087,2022-06-10
CASH_OUT,45469,Claudine Vallet,77063,31594,Agence_moov_Abomey,300000,254531,2022-06-10
CASH_OUT,16756,Claudine Vallet,31594,14838,Agence_moov_Ouidah,300000,283244,2022-06-11
CASH_OUT,12729,Claudine Vallet,14838,2109,Agence_moov_Ouidah,300000,287271,2022-06-14
CASH_OUT,568,Claudine Vallet,2109,1541,Agence_moov_Ouidah,300000,299432,2022-06-14
CASH_IN,18530,Agence_moov_Ouidah,300000,281470,Claudine Vallet,1541,20071,2022-06-14
CASH_IN,128006,Agence_moov_Ouidah,300000,171994,Claudine Vallet,20071,148077,2022-06-15
CASH_IN,92363,Agence_moov_Abomey,300000,207637,Claudine Vallet,148077,240440,2022-06-17
CASH_IN,163745,Agence_moov_Cotonou,300000,136255,Claudine Vallet,240440,404185,2022-06-17
CASH_OUT,331231,Claudine Vallet,404185,72954,Agence_moov_Cotonou,300000,-31231,2022-06-17
CASH_IN,288774,Agence_moov_Abomey,300000,11226,Claudine Vallet,72954,361728,2022-06-19
TRANSFER,583021,Gabriel de Pineau,1453600,870579,Claudine Vallet,361728,944749,2022-06-22
CASH_IN,56878,Agence_moov_Abomey,300000,243122,Claudine Vallet,944749,1001627,2022-06-26
CASH_IN,27151,Agence_moov_Abomey,300000,272849,Claudine Vallet,1001627,1028778,2022-06-27
CASH_OUT,274825,Laurence Dumont de Laroche,1570400,1295575,Agence_moov_Ouidah,300000,25175,2022-06-01
TRANSFER,504738,Marine-Clémence Ferreira,737800,233062,Laurence Dumont de Laroche,1295575,1800313,2022-06-03
CASH_OUT,124824,Laurence Dumont de Laroche,1800313,1675489,Agence_moov_Ouidah,300000,175176,2022-06-03
TRANSFER,1381869,Laurence Dumont de Laroche,1675489,293620,Frédéric Moreau,576725,-805144,2022-06-07
TRANSFER,32745,Sébastien Jourdan,390977,358232,Laurence Dumont de Laroche,293620,326365,2022-06-08
CASH_OUT,120406,Laurence Dumont de Laroche,326365,205959,Agence_moov_Ouidah,300000,179594,2022-06-11
CASH_OUT,158010,Laurence Dumont de Laroche,205959,47949,Agence_moov_Abomey,300000,141990,2022-06-13
CASH_IN,271330,Agence_moov_Abomey,300000,28670,Laurence Dumont de Laroche,47949,319279,2022-06-15
CASH_IN,84914,Agence_moov_Cotonou,300000,215086,Laurence Dumont de Laroche,319279,404193,2022-06-15
CASH_OUT,318380,Laurence Dumont de Laroche,404193,85813,Agence_moov_Ouidah,300000,-18380,2022-06-16
CASH_OUT,71013,Laurence Dumont de Laroche,85813,14800,Agence_moov_Cotonou,300000,228987,2022-06-16
TRANSFER,10133,Laurence Dumont de Laroche,14800,4667,Anastasie Louis,166995,156862,2022-06-18
TRANSFER,1880,Laurence Dumont de Laroche,4667,2787,Matthieu Carpentier,11400,9520,2022-06-19
CASH_IN,140756,Agence_moov_Abomey,300000,159244,Laurence Dumont de Laroche,2787,143543,2022-06-19
CASH_IN,181311,Agence_moov_Ouidah,300000,118689,Laurence Dumont de Laroche,143543,324854,2022-06-19
CASH_OUT,189177,Laurence Dumont de Laroche,324854,135677,Agence_moov_Cotonou,300000,110823,2022-06-19
TRANSFER,40800,Laurence Dumont de Laroche,135677,94877,Sébastien-Arthur Masse,338480,297680,2022-06-20
CASH_OUT,60260,Laurence Dumont de Laroche,94877,34617,Agence_moov_Cotonou,300000,239740,2022-06-22
TRANSFER,34586,Laurence Dumont de Laroche,34617,31,Élodie Gérard,636277,601691,2022-06-22
CASH_IN,36866,Agence_moov_Cotonou,300000,263134,Laurence Dumont de Laroche,31,36897,2022-06-22
CASH_IN,149487,Agence_moov_Ouidah,300000,150513,Laurence Dumont de Laroche,36897,186384,2022-06-23
CASH_IN,201313,Agence_moov_Ouidah,300000,98687,Laurence Dumont de Laroche,186384,387697,2022-06-26
CASH_IN,44779,Agence_moov_Abomey,300000,255221,Laurence Dumont de Laroche,387697,432476,2022-06-27
CASH_IN,234756,Agence_moov_Ouidah,300000,65244,Frédéric Moreau,-805144,-570388,2022-06-01
CASH_IN,101570,Agence_moov_Cotonou,300000,198430,Frédéric Moreau,-570388,-468818,2022-06-02
CASH_IN,159949,Agence_moov_Cotonou,300000,140051,Frédéric Moreau,-468818,-308869,2022-06-02
CASH_IN,187977,Agence_moov_Cotonou,300000,112023,Frédéric Moreau,-308869,-120892,2022-06-03
CASH_IN,68804,Agence_moov_Cotonou,300000,231196,Frédéric Moreau,-120892,-52088,2022-06-03
CASH_IN,289355,Agence_moov_Ouidah,300000,10645,Frédéric Moreau,-52088,237267,2022-06-04
CASH_OUT,22233,Frédéric Moreau,237267,215034,Agence_moov_Cotonou,300000,277767,2022-06-07
CASH_IN,67018,Agence_moov_Cotonou,300000,232982,Frédéric Moreau,215034,282052,2022-06-08
CASH_IN,44062,Agence_moov_Abomey,300000,255938,Frédéric Moreau,282052,326114,2022-06-09
TRANSFER,264176,Augustin Benard,1023900,759724,Frédéric Moreau,326114,590290,2022-06-09
CASH_IN,29804,Agence_moov_Abomey,300000,270196,Frédéric Moreau,590290,620094,2022-06-09
TRANSFER,201686,Antoine Bourdon de Auger,1011000,809314,Frédéric Moreau,620094,821780,2022-06-10
CASH_OUT,501754,Frédéric Moreau,821780,320026,Agence_moov_Ouidah,300000,-201754,2022-06-11
CASH_IN,39751,Agence_moov_Cotonou,300000,260249,Frédéric Moreau,320026,359777,2022-06-13
CASH_OUT,287014,Frédéric Moreau,359777,72763,Agence_moov_Ouidah,300000,12986,2022-06-14
CASH_OUT,42795,Frédéric Moreau,72763,29968,Agence_moov_Abomey,300000,257205,2022-06-14
CASH_OUT,18511,Frédéric Moreau,29968,11457,Agence_moov_Ouidah,300000,281489,2022-06-14
CASH_IN,79758,Agence_moov_Cotonou,300000,220242,Frédéric Moreau,11457,91215,2022-06-16
TRANSFER,286494,Adrienne Arnaud,411500,125006,Frédéric Moreau,91215,377709,2022-06-16
CASH_IN,233591,Agence_moov_Cotonou,300000,66409,Frédéric Moreau,377709,611300,2022-06-18
CASH_OUT,510022,Frédéric Moreau,611300,101278,Agence_moov_Ouidah,300000,-210022,2022-06-19
TRANSFER,33752,Frédéric Moreau,101278,67526,Agnès Baron,245967,212215,2022-06-22
CASH_OUT,20913,Frédéric Moreau,67526,46613,Agence_moov_Abomey,300000,279087,2022-06-22
CASH_IN,84646,Agence_moov_Ouidah,300000,215354,Frédéric Moreau,46613,131259,2022-06-22
CASH_IN,91387,Agence_moov_Ouidah,300000,208613,Frédéric Moreau,131259,222646,2022-06-22
CASH_IN,295839,Agence_moov_Ouidah,300000,4161,Frédéric Moreau,222646,518485,2022-06-26
CASH_IN,167746,Agence_moov_Abomey,300000,132254,Frédéric Moreau,518485,686231,2022-06-27
TRANSFER,37621,Caroline Monnier,39858,2237,Frédéric Moreau,686231,723852,2022-06-27
TRANSFER,562753,Frédéric Moreau,723852,161099,Emmanuel-René Coulon,432900,-129853,2022-06-27
TRANSFER,135036,Anastasie Louis,156862,21826,Arnaude Gaillard,256500,121464,2022-06-02
CASH_IN,283131,Agence_moov_Abomey,300000,16869,Anastasie Louis,21826,304957,2022-06-03
CASH_OUT,34035,Anastasie Louis,304957,270922,Agence_moov_Cotonou,300000,265965,2022-06-04
CASH_OUT,230980,Anastasie Louis,270922,39942,Agence_moov_Ouidah,300000,69020,2022-06-04
CASH_IN,262665,Agence_moov_Ouidah,300000,37335,Anastasie Louis,39942,302607,2022-06-04
TRANSFER,1271,Aimé Allain,84900,83629,Anastasie Louis,302607,303878,2022-06-07
CASH_IN,210594,Agence_moov_Cotonou,300000,89406,Anastasie Louis,303878,514472,2022-06-10
CASH_IN,227001,Agence_moov_Abomey,300000,72999,Anastasie Louis,514472,741473,2022-06-10
CASH_IN,152159,Agence_moov_Abomey,300000,147841,Anastasie Louis,741473,893632,2022-06-12
CASH_OUT,403567,Anastasie Louis,893632,490065,Agence_moov_Abomey,300000,-103567,2022-06-13
CASH_IN,241529,Agence_moov_Cotonou,300000,58471,Anastasie Louis,490065,731594,2022-06-13
TRANSFER,707862,Anastasie Louis,731594,23732,Hugues Gay,1012800,304938,2022-06-13
TRANSFER,17147,Anastasie Louis,23732,6585,Adélaïde-Sophie Leclercq,1435000,1417853,2022-06-13
TRANSFER,4047,Anastasie Louis,6585,2538,Valentine Traore,377043,372996,2022-06-14
CASH_OUT,1897,Anastasie Louis,2538,641,Agence_moov_Ouidah,300000,298103,2022-06-17
TRANSFER,952955,Diane-Françoise Raynaud,1650100,697145,Anastasie Louis,641,953596,2022-06-21
TRANSFER,435140,Anastasie Louis,953596,518456,Josette Guillon-Leclercq,754046,318906,2022-06-21
CASH_IN,282301,Agence_moov_Abomey,300000,17699,Anastasie Louis,518456,800757,2022-06-21
TRANSFER,227775,Anastasie Louis,800757,572982,Hugues Gay,304938,77163,2022-06-22
CASH_IN,297769,Agence_moov_Abomey,300000,2231,Anastasie Louis,572982,870751,2022-06-23
CASH_OUT,171633,Anastasie Louis,870751,699118,Agence_moov_Abomey,300000,128367,2022-06-23
CASH_OUT,391958,Anastasie Louis,699118,307160,Agence_moov_Abomey,300000,-91958,2022-06-23
TRANSFER,693,Luc Camus,60227,59534,Anastasie Louis,307160,307853,2022-06-23
CASH_OUT,272938,Anastasie Louis,307853,34915,Agence_moov_Abomey,300000,27062,2022-06-24
CASH_IN,183516,Agence_moov_Abomey,300000,116484,Anastasie Louis,34915,218431,2022-06-24
CASH_OUT,168335,Anastasie Louis,218431,50096,Agence_moov_Abomey,300000,131665,2022-06-25
CASH_IN,264582,Agence_moov_Abomey,300000,35418,Anastasie Louis,50096,314678,2022-06-26
TRANSFER,146664,Anastasie Louis,314678,168014,Joseph de la Dubois,118146,-28518,2022-06-26
TRANSFER,237500,Constance Regnier,386900,149400,Nicole Lacroix,955436,717936,2022-06-02
CASH_IN,255706,Agence_moov_Abomey,300000,44294,Constance Regnier,149400,405106,2022-06-07
CASH_OUT,308375,Constance Regnier,405106,96731,Agence_moov_Ouidah,300000,-8375,2022-06-08
TRANSFER,78737,Antoine Bourdon de Auger,809314,730577,Constance Regnier,96731,175468,2022-06-09
TRANSFER,98606,Lucy Vaillant,167400,68794,Constance Regnier,175468,274074,2022-06-10
CASH_IN,261154,Agence_moov_Ouidah,300000,38846,Constance Regnier,274074,535228,2022-06-11
CASH_OUT,321451,Constance Regnier,535228,213777,Agence_moov_Cotonou,300000,-21451,2022-06-11
TRANSFER,1091,Caroline Monnier,2237,1146,Constance Regnier,213777,214868,2022-06-12
CASH_IN,33294,Agence_moov_Cotonou,300000,266706,Constance Regnier,214868,248162,2022-06-13
CASH_IN,112151,Agence_moov_Cotonou,300000,187849,Constance Regnier,248162,360313,2022-06-14
CASH_OUT,116243,Constance Regnier,360313,244070,Agence_moov_Abomey,300000,183757,2022-06-15
TRANSFER,204154,Constance Regnier,244070,39916,Alfred Chrétien,19871,-184283,2022-06-15
TRANSFER,171876,Marine-Clémence Ferreira,233062,61186,Constance Regnier,39916,211792,2022-06-17
CASH_IN,258275,Agence_moov_Ouidah,300000,41725,Constance Regnier,211792,470067,2022-06-18
TRANSFER,333182,Constance Regnier,470067,136885,Constance Regnier,470067,803249,2022-06-19
CASH_IN,121643,Agence_moov_Ouidah,300000,178357,Constance Regnier,136885,258528,2022-06-20
TRANSFER,170211,Constance Regnier,258528,88317,Marine-Clémence Ferreira,61186,-109025,2022-06-21
TRANSFER,41572,Constance Regnier,88317,46745,Paul Pereira,590498,548926,2022-06-21
CASH_OUT,36433,Constance Regnier,46745,10312,Agence_moov_Abomey,300000,263567,2022-06-23
CASH_IN,101774,Agence_moov_Ouidah,300000,198226,Constance Regnier,10312,112086,2022-06-24
CASH_IN,73276,Agence_moov_Abomey,300000,226724,Constance Regnier,112086,185362,2022-06-24
CASH_IN,41221,Agence_moov_Ouidah,300000,258779,Constance Regnier,185362,226583,2022-06-25
CASH_OUT,85823,Constance Regnier,226583,140760,Agence_moov_Abomey,300000,214177,2022-06-27
CASH_OUT,69655,Constance Regnier,140760,71105,Agence_moov_Ouidah,300000,230345,2022-06-27
CASH_OUT,632364,Alex Salmon,1881500,1249136,Agence_moov_Ouidah,300000,-332364,2022-06-01
CASH_IN,244578,Agence_moov_Cotonou,300000,55422,Alex Salmon,1249136,1493714,2022-06-03
CASH_IN,199549,Agence_moov_Cotonou,300000,100451,Alex Salmon,1493714,1693263,2022-06-05
CASH_IN,194691,Agence_moov_Abomey,300000,105309,Alex Salmon,1693263,1887954,2022-06-06
TRANSFER,13636,Alex Salmon,1887954,1874318,Marthe Guillet,705700,692064,2022-06-07
TRANSFER,259177,Alex Salmon,1874318,1615141,Aimé Allain,83629,-175548,2022-06-07
CASH_IN,35820,Agence_moov_Abomey,300000,264180,Alex Salmon,1615141,1650961,2022-06-07
TRANSFER,1353061,Alex Salmon,1650961,297900,Emmanuel Bousquet,953500,-399561,2022-06-08
CASH_IN,223082,Agence_moov_Abomey,300000,76918,Alex Salmon,297900,520982,2022-06-08
CASH_IN,237000,Agence_moov_Cotonou,300000,63000,Alex Salmon,520982,757982,2022-06-09
CASH_IN,235710,Agence_moov_Cotonou,300000,64290,Alex Salmon,757982,993692,2022-06-10
TRANSFER,621192,Alex Salmon,993692,372500,Paul Pereira,548926,-72266,2022-06-11
CASH_OUT,339496,Alex Salmon,372500,33004,Agence_moov_Abomey,300000,-39496,2022-06-11
TRANSFER,1173825,Thierry Dos Santos-Le Roux,1495900,322075,Alex Salmon,33004,1206829,2022-06-12
CASH_OUT,403205,Alex Salmon,1206829,803624,Agence_moov_Abomey,300000,-103205,2022-06-12
TRANSFER,608375,Marianne Descamps,662500,54125,Alex Salmon,803624,1411999,2022-06-14
CASH_IN,138872,Agence_moov_Ouidah,300000,161128,Alex Salmon,1411999,1550871,2022-06-14
CASH_IN,273215,Agence_moov_Cotonou,300000,26785,Alex Salmon,1550871,1824086,2022-06-14
CASH_IN,53011,Agence_moov_Abomey,300000,246989,Alex Salmon,1824086,1877097,2022-06-15
CASH_IN,109375,Agence_moov_Cotonou,300000,190625,Alex Salmon,1877097,1986472,2022-06-15
CASH_IN,87572,Agence_moov_Ouidah,300000,212428,Alex Salmon,1986472,2074044,2022-06-16
CASH_OUT,99123,Alex Salmon,2074044,1974921,Agence_moov_Cotonou,300000,200877,2022-06-17
TRANSFER,443,Lucy Vaillant,68794,68351,Alex Salmon,1974921,1975364,2022-06-21
CASH_OUT,461691,Alex Salmon,1975364,1513673,Agence_moov_Ouidah,300000,-161691,2022-06-23
CASH_OUT,727828,Alex Salmon,1513673,785845,Agence_moov_Abomey,300000,-427828,2022-06-24
CASH_IN,116649,Agence_moov_Abomey,300000,183351,Alex Salmon,785845,902494,2022-06-24
TRANSFER,350229,Alex Salmon,902494,552265,Amélie Gros-Riou,155700,-194529,2022-06-25
TRANSFER,411759,Alex Salmon,552265,140506,Lucy Vaillant,68351,-343408,2022-06-26
CASH_IN,223045,Agence_moov_Ouidah,300000,76955,Alex Salmon,140506,363551,2022-06-27
CASH_IN,34613,Agence_moov_Cotonou,300000,265387,Laurent Besson,-5199,29414,2022-06-01
TRANSFER,11343,Laurent Besson,29414,18071,Michèle Vallée,595300,583957,2022-06-02
CASH_IN,135379,Agence_moov_Cotonou,300000,164621,Laurent Besson,18071,153450,2022-06-04
CASH_OUT,141311,Laurent Besson,153450,12139,Agence_moov_Ouidah,300000,158689,2022-06-04
CASH_OUT,9793,Laurent Besson,12139,2346,Agence_moov_Cotonou,300000,290207,2022-06-04
CASH_IN,33404,Agence_moov_Abomey,300000,266596,Laurent Besson,2346,35750,2022-06-04
TRANSFER,4863,Laurent Besson,35750,30887,Josette Guillon-Leclercq,318906,314043,2022-06-05
TRANSFER,11801,Laurent Besson,30887,19086,Margot Renaud de Lacombe,556500,544699,2022-06-06
CASH_IN,4380,Agence_moov_Cotonou,300000,295620,Laurent Besson,19086,23466,2022-06-06
TRANSFER,8971,Laurent Besson,23466,14495,Michèle Vallée,583957,574986,2022-06-08
CASH_IN,268644,Agence_moov_Cotonou,300000,31356,Laurent Besson,14495,283139,2022-06-12
TRANSFER,686632,Susan de Fontaine,1106283,419651,Laurent Besson,283139,969771,2022-06-13
CASH_OUT,53781,Laurent Besson,969771,915990,Agence_moov_Abomey,300000,246219,2022-06-13
TRANSFER,191629,Agnès Baron,212215,20586,Laurent Besson,915990,1107619,2022-06-14
CASH_OUT,264155,Laurent Besson,1107619,843464,Agence_moov_Cotonou,300000,35845,2022-06-14
TRANSFER,771077,Laurent Besson,843464,72387,Thierry Dos Santos-Le Roux,322075,-449002,2022-06-15
TRANSFER,35362,Laurent Besson,72387,37025,Christophe Guilbert,213267,177905,2022-06-15
CASH_OUT,10177,Laurent Besson,37025,26848,Agence_moov_Cotonou,300000,289823,2022-06-18
TRANSFER,937600,Océane Boutin,1516400,578800,Laurent Besson,26848,964448,2022-06-18
CASH_IN,91909,Agence_moov_Cotonou,300000,208091,Laurent Besson,964448,1056357,2022-06-19
CASH_OUT,1052018,Laurent Besson,1056357,4339,Agence_moov_Abomey,300000,-752018,2022-06-19
TRANSFER,3551,Laurent Besson,4339,788,Hugues Gay,77163,73612,2022-06-20
CASH_OUT,188,Laurent Besson,788,600,Agence_moov_Cotonou,300000,299812,2022-06-22
CASH_IN,99595,Agence_moov_Ouidah,300000,200405,Laurent Besson,600,100195,2022-06-24
TRANSFER,1282,Laurent Besson,100195,98913,Luc-Tristan Moreau,241100,239818,2022-06-24
CASH_IN,92820,Agence_moov_Ouidah,300000,207180,Laurent Besson,98913,191733,2022-06-24
CASH_IN,232915,Agence_moov_Ouidah,300000,67085,Laurent Besson,191733,424648,2022-06-26
TRANSFER,198722,Laurent Besson,424648,225926,Christophe Guilbert,177905,-20817,2022-06-27
CASH_IN,115406,Agence_moov_Abomey,300000,184594,Laurent Besson,225926,341332,2022-06-27
CASH_IN,239463,Agence_moov_Cotonou,300000,60537,Lucy Vaillant,-343408,-103945,2022-06-01
CASH_IN,20350,Agence_moov_Abomey,300000,279650,Lucy Vaillant,-103945,-83595,2022-06-02
CASH_IN,176499,Agence_moov_Abomey,300000,123501,Lucy Vaillant,-83595,92904,2022-06-03
CASH_IN,11129,Agence_moov_Ouidah,300000,288871,Lucy Vaillant,92904,104033,2022-06-03
TRANSFER,6452,Vincent-Philippe Rossi,7600,1148,Lucy Vaillant,104033,110485,2022-06-06
CASH_IN,78118,Agence_moov_Abomey,300000,221882,Lucy Vaillant,110485,188603,2022-06-07
CASH_OUT,98903,Lucy Vaillant,188603,89700,Agence_moov_Cotonou,300000,201097,2022-06-07
CASH_IN,10233,Agence_moov_Ouidah,300000,289767,Lucy Vaillant,89700,99933,2022-06-08
CASH_OUT,73871,Lucy Vaillant,99933,26062,Agence_moov_Cotonou,300000,226129,2022-06-10
CASH_OUT,16668,Lucy Vaillant,26062,9394,Agence_moov_Cotonou,300000,283332,2022-06-10
TRANSFER,536221,Adélaïde-Sophie Leclercq,1417853,881632,Lucy Vaillant,9394,545615,2022-06-11
TRANSFER,301493,Laurence Carlier,1431831,1130338,Lucy Vaillant,545615,847108,2022-06-12
TRANSFER,289790,Lucy Vaillant,847108,557318,Arnaude Gaillard,121464,-168326,2022-06-14
CASH_IN,68467,Agence_moov_Abomey,300000,231533,Lucy Vaillant,557318,625785,2022-06-15
TRANSFER,527174,Lucy Vaillant,625785,98611,Alphonse Dupont-Petit,1918600,1391426,2022-06-16
TRANSFER,83460,Lucy Vaillant,98611,15151,Théodore Bertin,1643800,1560340,2022-06-17
CASH_OUT,155,Lucy Vaillant,15151,14996,Agence_moov_Abomey,300000,299845,2022-06-18
CASH_IN,18926,Agence_moov_Ouidah,300000,281074,Lucy Vaillant,14996,33922,2022-06-18
CASH_OUT,8589,Lucy Vaillant,33922,25333,Agence_moov_Ouidah,300000,291411,2022-06-21
TRANSFER,960215,Caroline Bonneau,1382938,422723,Lucy Vaillant,25333,985548,2022-06-21
CASH_OUT,73941,Lucy Vaillant,985548,911607,Agence_moov_Abomey,300000,226059,2022-06-21
CASH_OUT,826446,Lucy Vaillant,911607,85161,Agence_moov_Cotonou,300000,-526446,2022-06-21
CASH_OUT,59653,Lucy Vaillant,85161,25508,Agence_moov_Ouidah,300000,240347,2022-06-24
TRANSFER,13492,Lucy Vaillant,25508,12016,Michèle Vallée,574986,561494,2022-06-24
CASH_OUT,906,Lucy Vaillant,12016,11110,Agence_moov_Ouidah,300000,299094,2022-06-24
TRANSFER,9080,Lucy Vaillant,11110,2030,Luc Camus,59534,50454,2022-06-27
CASH_IN,274598,Agence_moov_Ouidah,300000,25402,Lucy Vaillant,2030,276628,2022-06-27
CASH_OUT,599787,Paul De Sousa,617400,17613,Agence_moov_Cotonou,300000,-299787,2022-06-01
CASH_OUT,12636,Paul De Sousa,17613,4977,Agence_moov_Ouidah,300000,287364,2022-06-02
CASH_OUT,1213,Paul De Sousa,4977,3764,Agence_moov_Cotonou,300000,298787,2022-06-03
CASH_IN,29417,Agence_moov_Cotonou,300000,270583,Paul De Sousa,3764,33181,2022-06-04
TRANSFER,503788,Alphonse Dupont-Petit,1391426,887638,Paul De Sousa,33181,536969,2022-06-04
CASH_IN,249121,Agence_moov_Ouidah,300000,50879,Paul De Sousa,536969,786090,2022-06-05
TRANSFER,185824,Paul De Sousa,786090,600266,Josette Guillon-Leclercq,314043,128219,2022-06-05
CASH_IN,210308,Agence_moov_Cotonou,300000,89692,Paul De Sousa,600266,810574,2022-06-06
TRANSFER,39552,Caroline Bonneau,422723,383171,Paul De Sousa,810574,850126,2022-06-08
CASH_OUT,365391,Paul De Sousa,850126,484735,Agence_moov_Ouidah,300000,-65391,2022-06-11
CASH_IN,45550,Agence_moov_Abomey,300000,254450,Paul De Sousa,484735,530285,2022-06-12
CASH_IN,63171,Agence_moov_Cotonou,300000,236829,Paul De Sousa,530285,593456,2022-06-13
CASH_OUT,362555,Paul De Sousa,593456,230901,Agence_moov_Cotonou,300000,-62555,2022-06-13
CASH_IN,10577,Agence_moov_Abomey,300000,289423,Paul De Sousa,230901,241478,2022-06-14
CASH_OUT,120154,Paul De Sousa,241478,121324,Agence_moov_Cotonou,300000,179846,2022-06-15
TRANSFER,277440,Jacques-Antoine Gros,402400,124960,Paul De Sousa,121324,398764,2022-06-17
CASH_IN,65182,Agence_moov_Ouidah,300000,234818,Paul De Sousa,398764,463946,2022-06-18
CASH_OUT,257930,Paul De Sousa,463946,206016,Agence_moov_Ouidah,300000,42070,2022-06-18
CASH_IN,297058,Agence_moov_Ouidah,300000,2942,Paul De Sousa,206016,503074,2022-06-22
CASH_OUT,341983,Paul De Sousa,503074,161091,Agence_moov_Abomey,300000,-41983,2022-06-22
CASH_OUT,152597,Paul De Sousa,161091,8494,Agence_moov_Abomey,300000,147403,2022-06-22
TRANSFER,41651,Amélie de la Picard,84894,43243,Paul De Sousa,8494,50145,2022-06-23
TRANSFER,25016,Paul De Sousa,50145,25129,Valentine Traore,372996,347980,2022-06-23
CASH_OUT,8518,Paul De Sousa,25129,16611,Agence_moov_Abomey,300000,291482,2022-06-24
CASH_IN,256545,Agence_moov_Ouidah,300000,43455,Paul De Sousa,16611,273156,2022-06-24
CASH_OUT,173513,Paul De Sousa,273156,99643,Agence_moov_Abomey,300000,126487,2022-06-25
CASH_OUT,81443,Paul De Sousa,99643,18200,Agence_moov_Ouidah,300000,218557,2022-06-26
CASH_OUT,1887,Paul De Sousa,18200,16313,Agence_moov_Abomey,300000,298113,2022-06-27
CASH_IN,47306,Agence_moov_Ouidah,300000,252694,Maryse Reynaud-Michaud,-188668,-141362,2022-06-01
CASH_IN,43831,Agence_moov_Abomey,300000,256169,Maryse Reynaud-Michaud,-141362,-97531,2022-06-05
CASH_IN,123727,Agence_moov_Abomey,300000,176273,Maryse Reynaud-Michaud,-97531,26196,2022-06-06
CASH_OUT,7803,Maryse Reynaud-Michaud,26196,18393,Agence_moov_Ouidah,300000,292197,2022-06-08
CASH_IN,277601,Agence_moov_Ouidah,300000,22399,Maryse Reynaud-Michaud,18393,295994,2022-06-09
CASH_OUT,121185,Maryse Reynaud-Michaud,295994,174809,Agence_moov_Abomey,300000,178815,2022-06-09
TRANSFER,5940,Marianne Descamps,54125,48185,Maryse Reynaud-Michaud,174809,180749,2022-06-09
CASH_IN,50187,Agence_moov_Ouidah,300000,249813,Maryse Reynaud-Michaud,180749,230936,2022-06-11
TRANSFER,59442,Maryse Reynaud-Michaud,230936,171494,Théodore-Alfred Fournier,418800,359358,2022-06-11
CASH_IN,206096,Agence_moov_Cotonou,300000,93904,Maryse Reynaud-Michaud,171494,377590,2022-06-11
CASH_IN,97386,Agence_moov_Ouidah,300000,202614,Maryse Reynaud-Michaud,377590,474976,2022-06-12
CASH_OUT,103730,Maryse Reynaud-Michaud,474976,371246,Agence_moov_Abomey,300000,196270,2022-06-12
TRANSFER,868199,Adélaïde-Sophie Leclercq,881632,13433,Maryse Reynaud-Michaud,371246,1239445,2022-06-13
TRANSFER,180467,Augustin Benard,759724,579257,Maryse Reynaud-Michaud,1239445,1419912,2022-06-13
TRANSFER,618114,Maryse Reynaud-Michaud,1419912,801798,Augustin Benard,579257,-38857,2022-06-14
TRANSFER,798438,Maryse Reynaud-Michaud,801798,3360,Nicolas Hervé,351546,-446892,2022-06-15
CASH_OUT,596,Maryse Reynaud-Michaud,3360,2764,Agence_moov_Ouidah,300000,299404,2022-06-17
CASH_IN,10721,Agence_moov_Ouidah,300000,289279,Maryse Reynaud-Michaud,2764,13485,2022-06-18
TRANSFER,420,Vincent-Philippe Rossi,1148,728,Maryse Reynaud-Michaud,13485,13905,2022-06-21
CASH_IN,102502,Agence_moov_Ouidah,300000,197498,Maryse Reynaud-Michaud,13905,116407,2022-06-22
CASH_IN,81985,Agence_moov_Ouidah,300000,218015,Maryse Reynaud-Michaud,116407,198392,2022-06-23
CASH_IN,180610,Agence_moov_Abomey,300000,119390,Maryse Reynaud-Michaud,198392,379002,2022-06-23
TRANSFER,63383,Maryse Reynaud-Michaud,379002,315619,Michèle Vallée,561494,498111,2022-06-24
CASH_IN,51805,Agence_moov_Abomey,300000,248195,Maryse Reynaud-Michaud,315619,367424,2022-06-25
CASH_IN,132839,Agence_moov_Ouidah,300000,167161,Maryse Reynaud-Michaud,367424,500263,2022-06-26
TRANSFER,258401,Maryse Reynaud-Michaud,500263,241862,Sébastien Jourdan,358232,99831,2022-06-27
CASH_OUT,5522,Nath Léger,182226,176704,Agence_moov_Cotonou,300000,294478,2022-06-01
CASH_IN,253155,Agence_moov_Ouidah,300000,46845,Nath Léger,176704,429859,2022-06-01
TRANSFER,1288014,Stéphane-Timothée Pineau,1427100,139086,Nath Léger,429859,1717873,2022-06-02
CASH_IN,19590,Agence_moov_Cotonou,300000,280410,Nath Léger,1717873,1737463,2022-06-05
CASH_IN,194038,Agence_moov_Abomey,300000,105962,Nath Léger,1737463,1931501,2022-06-05
CASH_OUT,790986,Nath Léger,1931501,1140515,Agence_moov_Cotonou,300000,-490986,2022-06-06
TRANSFER,190586,Christophe Alexandre,591300,400714,Nath Léger,1140515,1331101,2022-06-07
CASH_OUT,316336,Nath Léger,1331101,1014765,Agence_moov_Ouidah,300000,-16336,2022-06-09
CASH_IN,61075,Agence_moov_Ouidah,300000,238925,Nath Léger,1014765,1075840,2022-06-11
CASH_IN,50675,Agence_moov_Abomey,300000,249325,Nath Léger,1075840,1126515,2022-06-11
CASH_OUT,894634,Nath Léger,1126515,231881,Agence_moov_Abomey,300000,-594634,2022-06-12
TRANSFER,932132,Sabine Imbert,1001600,69468,Nath Léger,231881,1164013,2022-06-12
CASH_OUT,432723,Nath Léger,1164013,731290,Agence_moov_Cotonou,300000,-132723,2022-06-14
TRANSFER,624849,Nath Léger,731290,106441,Vincent-Grégoire Brunet,924704,299855,2022-06-15
TRANSFER,51786,Nath Léger,106441,54655,Caroline Monnier,1146,-50640,2022-06-16
CASH_IN,169770,Agence_moov_Cotonou,300000,130230,Nath Léger,54655,224425,2022-06-16
CASH_IN,267903,Agence_moov_Abomey,300000,32097,Nath Léger,224425,492328,2022-06-16
CASH_OUT,19661,Nath Léger,492328,472667,Agence_moov_Cotonou,300000,280339,2022-06-21
CASH_OUT,213642,Nath Léger,472667,259025,Agence_moov_Ouidah,300000,86358,2022-06-21
CASH_OUT,155149,Nath Léger,259025,103876,Agence_moov_Cotonou,300000,144851,2022-06-22
CASH_IN,35851,Agence_moov_Cotonou,300000,264149,Nath Léger,103876,139727,2022-06-22
CASH_IN,65168,Agence_moov_Ouidah,300000,234832,Nath Léger,139727,204895,2022-06-24
CASH_IN,45543,Agence_moov_Abomey,300000,254457,Nath Léger,204895,250438,2022-06-25
CASH_OUT,36085,Nath Léger,250438,214353,Agence_moov_Ouidah,300000,263915,2022-06-26
TRANSFER,60553,Nath Léger,214353,153800,Marianne Descamps,48185,-12368,2022-06-27
CASH_IN,20346,Agence_moov_Abomey,300000,279654,Vincent-Grégoire Brunet,299855,320201,2022-06-03
CASH_IN,249838,Agence_moov_Ouidah,300000,50162,Vincent-Grégoire Brunet,320201,570039,2022-06-04
CASH_OUT,357539,Vincent-Grégoire Brunet,570039,212500,Agence_moov_Ouidah,300000,-57539,2022-06-05
CASH_IN,252739,Agence_moov_Abomey,300000,47261,Vincent-Grégoire Brunet,212500,465239,2022-06-05
TRANSFER,626867,Juliette Evrard Le Giraud,631410,4543,Vincent-Grégoire Brunet,465239,1092106,2022-06-05
CASH_IN,245319,Agence_moov_Cotonou,300000,54681,Vincent-Grégoire Brunet,1092106,1337425,2022-06-06
CASH_IN,183427,Agence_moov_Abomey,300000,116573,Vincent-Grégoire Brunet,1337425,1520852,2022-06-06
TRANSFER,223226,Vincent-Grégoire Brunet,1520852,1297626,Margot Renaud de Lacombe,544699,321473,2022-06-08
TRANSFER,1199849,Vincent-Grégoire Brunet,1297626,97777,Christophe Alexandre,400714,-799135,2022-06-08
CASH_IN,73095,Agence_moov_Cotonou,300000,226905,Vincent-Grégoire Brunet,97777,170872,2022-06-09
CASH_OUT,64661,Vincent-Grégoire Brunet,170872,106211,Agence_moov_Ouidah,300000,235339,2022-06-11
CASH_IN,208818,Agence_moov_Cotonou,300000,91182,Vincent-Grégoire Brunet,106211,315029,2022-06-13
TRANSFER,236710,Nicole Lacroix,717936,481226,Vincent-Grégoire Brunet,315029,551739,2022-06-16
CASH_IN,31787,Agence_moov_Cotonou,300000,268213,Vincent-Grégoire Brunet,551739,583526,2022-06-16
TRANSFER,442189,Vincent-Grégoire Brunet,583526,141337,Gabriel de Pineau,870579,428390,2022-06-16
TRANSFER,88056,Vincent-Grégoire Brunet,141337,53281,Jacques-Antoine Gros,124960,36904,2022-06-18
CASH_IN,189901,Agence_moov_Ouidah,300000,110099,Vincent-Grégoire Brunet,53281,243182,2022-06-19
CASH_OUT,48319,Vincent-Grégoire Brunet,243182,194863,Agence_moov_Ouidah,300000,251681,2022-06-20
CASH_IN,293951,Agence_moov_Cotonou,300000,6049,Vincent-Grégoire Brunet,194863,488814,2022-06-24
TRANSFER,465454,Vincent-Grégoire Brunet,488814,23360,Vincent-Grégoire Brunet,488814,23360,2022-06-24
TRANSFER,16598,Vincent-Grégoire Brunet,23360,6762,Théophile Mendès,553300,536702,2022-06-25
CASH_OUT,1175,Vincent-Grégoire Brunet,6762,5587,Agence_moov_Ouidah,300000,298825,2022-06-26
CASH_IN,189978,Agence_moov_Abomey,300000,110022,Vincent-Grégoire Brunet,5587,195565,2022-06-26
CASH_IN,118759,Agence_moov_Cotonou,300000,181241,Vincent-Grégoire Brunet,195565,314324,2022-06-26
CASH_IN,82249,Agence_moov_Cotonou,300000,217751,Sébastien-Arthur Masse,297680,379929,2022-06-01
CASH_IN,194869,Agence_moov_Cotonou,300000,105131,Sébastien-Arthur Masse,379929,574798,2022-06-03
TRANSFER,5875,Adélaïde-Sophie Leclercq,13433,7558,Sébastien-Arthur Masse,574798,580673,2022-06-06
CASH_IN,212619,Agence_moov_Cotonou,300000,87381,Sébastien-Arthur Masse,580673,793292,2022-06-06
TRANSFER,126365,Michèle Vallée,498111,371746,Sébastien-Arthur Masse,793292,919657,2022-06-07
CASH_IN,156617,Agence_moov_Cotonou,300000,143383,Sébastien-Arthur Masse,919657,1076274,2022-06-07
TRANSFER,15249,Hugues Gay,73612,58363,Sébastien-Arthur Masse,1076274,1091523,2022-06-09
CASH_OUT,300214,Sébastien-Arthur Masse,1091523,791309,Agence_moov_Abomey,300000,-214,2022-06-12
CASH_OUT,208874,Sébastien-Arthur Masse,791309,582435,Agence_moov_Abomey,300000,91126,2022-06-13
TRANSFER,94686,Sébastien-Arthur Masse,582435,487749,Théophile Mendès,536702,442016,2022-06-13
TRANSFER,6902,Matthieu Carpentier,9520,2618,Sébastien-Arthur Masse,487749,494651,2022-06-14
CASH_OUT,9495,Sébastien-Arthur Masse,494651,485156,Agence_moov_Ouidah,300000,290505,2022-06-14
CASH_OUT,38425,Sébastien-Arthur Masse,485156,446731,Agence_moov_Abomey,300000,261575,2022-06-14
CASH_OUT,366516,Sébastien-Arthur Masse,446731,80215,Agence_moov_Ouidah,300000,-66516,2022-06-16
TRANSFER,250846,Marthe Pichon,730400,479554,Sébastien-Arthur Masse,80215,331061,2022-06-18
CASH_OUT,208183,Sébastien-Arthur Masse,331061,122878,Agence_moov_Ouidah,300000,91817,2022-06-19
CASH_IN,210893,Agence_moov_Ouidah,300000,89107,Sébastien-Arthur Masse,122878,333771,2022-06-19
CASH_OUT,81652,Sébastien-Arthur Masse,333771,252119,Agence_moov_Cotonou,300000,218348,2022-06-20
CASH_OUT,185320,Sébastien-Arthur Masse,252119,66799,Agence_moov_Abomey,300000,114680,2022-06-20
CASH_OUT,50711,Sébastien-Arthur Masse,66799,16088,Agence_moov_Ouidah,300000,249289,2022-06-20
CASH_IN,85295,Agence_moov_Ouidah,300000,214705,Sébastien-Arthur Masse,16088,101383,2022-06-22
TRANSFER,63974,Sébastien-Arthur Masse,101383,37409,Gabriel de Pineau,428390,364416,2022-06-22
TRANSFER,31719,Sébastien-Arthur Masse,37409,5690,Sébastien Jourdan,99831,68112,2022-06-24
CASH_OUT,1075,Sébastien-Arthur Masse,5690,4615,Agence_moov_Ouidah,300000,298925,2022-06-26
TRANSFER,453895,Nicole Lacroix,481226,27331,Christine-Constance Gauthier,842600,1296495,2022-06-01
CASH_OUT,84740,Christine-Constance Gauthier,1296495,1211755,Agence_moov_Cotonou,300000,215260,2022-06-01
TRANSFER,458928,Diane-Françoise Raynaud,697145,238217,Christine-Constance Gauthier,1211755,1670683,2022-06-03
CASH_OUT,740623,Christine-Constance Gauthier,1670683,930060,Agence_moov_Ouidah,300000,-440623,2022-06-04
TRANSFER,232211,Valentine Traore,347980,115769,Christine-Constance Gauthier,930060,1162271,2022-06-06
CASH_IN,168044,Agence_moov_Ouidah,300000,131956,Christine-Constance Gauthier,1162271,1330315,2022-06-06
TRANSFER,323791,Élodie Gérard,601691,277900,Christine-Constance Gauthier,1330315,1654106,2022-06-08
TRANSFER,340252,Théophile Mendès,442016,101764,Christine-Constance Gauthier,1654106,1994358,2022-06-11
TRANSFER,431250,Christine-Constance Gauthier,1994358,1563108,Luc Camus,50454,-380796,2022-06-12
TRANSFER,33091,Jacques-Antoine Gros,36904,3813,Christine-Constance Gauthier,1563108,1596199,2022-06-15
CASH_OUT,1460494,Christine-Constance Gauthier,1596199,135705,Agence_moov_Cotonou,300000,-1160494,2022-06-17
CASH_IN,81118,Agence_moov_Abomey,300000,218882,Christine-Constance Gauthier,135705,216823,2022-06-19
TRANSFER,52525,Christine-Constance Gauthier,216823,164298,Hugues Gay,58363,5838,2022-06-19
CASH_IN,240387,Agence_moov_Abomey,300000,59613,Christine-Constance Gauthier,164298,404685,2022-06-20
CASH_OUT,100983,Christine-Constance Gauthier,404685,303702,Agence_moov_Abomey,300000,199017,2022-06-22
CASH_OUT,54779,Christine-Constance Gauthier,303702,248923,Agence_moov_Cotonou,300000,245221,2022-06-22
CASH_OUT,50227,Christine-Constance Gauthier,248923,198696,Agence_moov_Ouidah,300000,249773,2022-06-22
CASH_IN,291752,Agence_moov_Cotonou,300000,8248,Christine-Constance Gauthier,198696,490448,2022-06-23
CASH_IN,291092,Agence_moov_Ouidah,300000,8908,Christine-Constance Gauthier,490448,781540,2022-06-23
CASH_OUT,171224,Christine-Constance Gauthier,781540,610316,Agence_moov_Ouidah,300000,128776,2022-06-24
TRANSFER,68195,Alphonse Dupont-Petit,887638,819443,Christine-Constance Gauthier,610316,678511,2022-06-24
CASH_IN,167444,Agence_moov_Cotonou,300000,132556,Christine-Constance Gauthier,678511,845955,2022-06-27
CASH_IN,84275,Agence_moov_Ouidah,300000,215725,Christine-Constance Gauthier,845955,930230,2022-06-27
CASH_IN,111834,Agence_moov_Cotonou,300000,188166,Paul Pereira,-72266,39568,2022-06-01
CASH_IN,141277,Agence_moov_Abomey,300000,158723,Paul Pereira,39568,180845,2022-06-04
TRANSFER,11536,Paul Pereira,180845,169309,Michèle Vallée,371746,360210,2022-06-05
CASH_OUT,29065,Paul Pereira,169309,140244,Agence_moov_Abomey,300000,270935,2022-06-06
CASH_OUT,24012,Paul Pereira,140244,116232,Agence_moov_Abomey,300000,275988,2022-06-06
CASH_OUT,84933,Paul Pereira,116232,31299,Agence_moov_Ouidah,300000,215067,2022-06-07
CASH_IN,134611,Agence_moov_Abomey,300000,165389,Paul Pereira,31299,165910,2022-06-07
CASH_OUT,61453,Paul Pereira,165910,104457,Agence_moov_Abomey,300000,238547,2022-06-08
CASH_IN,83732,Agence_moov_Ouidah,300000,216268,Paul Pereira,104457,188189,2022-06-08
TRANSFER,138689,Théodore-Alfred Fournier,359358,220669,Paul Pereira,188189,326878,2022-06-12
CASH_IN,139636,Agence_moov_Ouidah,300000,160364,Paul Pereira,326878,466514,2022-06-12
CASH_OUT,360312,Paul Pereira,466514,106202,Agence_moov_Ouidah,300000,-60312,2022-06-12
CASH_IN,89489,Agence_moov_Ouidah,300000,210511,Paul Pereira,106202,195691,2022-06-13
CASH_OUT,69723,Paul Pereira,195691,125968,Agence_moov_Ouidah,300000,230277,2022-06-15
CASH_IN,144047,Agence_moov_Cotonou,300000,155953,Paul Pereira,125968,270015,2022-06-15
CASH_OUT,91543,Paul Pereira,270015,178472,Agence_moov_Cotonou,300000,208457,2022-06-16
TRANSFER,899,Juliette Evrard Le Giraud,4543,3644,Paul Pereira,178472,179371,2022-06-17
CASH_IN,66368,Agence_moov_Abomey,300000,233632,Paul Pereira,179371,245739,2022-06-17
CASH_OUT,92218,Paul Pereira,245739,153521,Agence_moov_Abomey,300000,207782,2022-06-18
CASH_OUT,134484,Paul Pereira,153521,19037,Agence_moov_Cotonou,300000,165516,2022-06-19
TRANSFER,3430,Paul Pereira,19037,15607,Michèle Vallée,360210,356780,2022-06-19
CASH_OUT,14480,Paul Pereira,15607,1127,Agence_moov_Cotonou,300000,285520,2022-06-21
CASH_IN,33094,Agence_moov_Abomey,300000,266906,Paul Pereira,1127,34221,2022-06-21
CASH_IN,4303,Agence_moov_Ouidah,300000,295697,Paul Pereira,34221,38524,2022-06-21
CASH_IN,187642,Agence_moov_Abomey,300000,112358,Nicolas Hervé,-446892,-259250,2022-06-03
CASH_IN,152325,Agence_moov_Abomey,300000,147675,Nicolas Hervé,-259250,-106925,2022-06-04
CASH_IN,42676,Agence_moov_Cotonou,300000,257324,Nicolas Hervé,-106925,-64249,2022-06-05
CASH_IN,250163,Agence_moov_Abomey,300000,49837,Nicolas Hervé,-64249,185914,2022-06-05
CASH_IN,153361,Agence_moov_Cotonou,300000,146639,Nicolas Hervé,185914,339275,2022-06-09
TRANSFER,90003,David Diallo,960789,870786,Nicolas Hervé,339275,429278,2022-06-09
CASH_IN,103059,Agence_moov_Ouidah,300000,196941,Nicolas Hervé,429278,532337,2022-06-09
CASH_OUT,280843,Nicolas Hervé,532337,251494,Agence_moov_Abomey,300000,19157,2022-06-09
CASH_OUT,12552,Nicolas Hervé,251494,238942,Agence_moov_Abomey,300000,287448,2022-06-09
TRANSFER,82386,Nicolas Hervé,238942,156556,Adrienne Arnaud,125006,42620,2022-06-11
CASH_OUT,61157,Nicolas Hervé,156556,95399,Agence_moov_Abomey,300000,238843,2022-06-11
CASH_OUT,16316,Nicolas Hervé,95399,79083,Agence_moov_Abomey,300000,283684,2022-06-12
TRANSFER,1156,Matthieu Carpentier,2618,1462,Nicolas Hervé,79083,80239,2022-06-13
CASH_OUT,41741,Nicolas Hervé,80239,38498,Agence_moov_Cotonou,300000,258259,2022-06-14
TRANSFER,33266,Nicolas Hervé,38498,5232,Théophile Mendès,101764,68498,2022-06-15
CASH_OUT,4496,Nicolas Hervé,5232,736,Agence_moov_Cotonou,300000,295504,2022-06-16
TRANSFER,330,Nicolas Hervé,736,406,Nicolas Hervé,736,406,2022-06-16
CASH_OUT,297,Nicolas Hervé,406,109,Agence_moov_Ouidah,300000,299703,2022-06-18
CASH_OUT,109,Nicolas Hervé,109,0,Agence_moov_Ouidah,300000,299891,2022-06-18
CASH_IN,161636,Agence_moov_Cotonou,300000,138364,Nicolas Hervé,0,161636,2022-06-18
CASH_IN,28618,Agence_moov_Ouidah,300000,271382,Nicolas Hervé,161636,190254,2022-06-19
TRANSFER,117687,Susan de Fontaine,419651,301964,Nicolas Hervé,190254,307941,2022-06-20
CASH_OUT,56061,Nicolas Hervé,307941,251880,Agence_moov_Abomey,300000,243939,2022-06-21
TRANSFER,18394,Agnès Baron,20586,2192,Nicolas Hervé,251880,270274,2022-06-22
CASH_OUT,257585,Nicolas Hervé,270274,12689,Agence_moov_Abomey,300000,42415,2022-06-24
TRANSFER,1120,Nicolas Hervé,12689,11569,Agnès Baron,2192,1072,2022-06-25
CASH_IN,17150,Agence_moov_Cotonou,300000,282850,Nicolas Hervé,11569,28719,2022-06-25
CASH_OUT,5203,Nicolas Hervé,28719,23516,Agence_moov_Abomey,300000,294797,2022-06-26
TRANSFER,215596,Maryse Lebreton,615677,400081,Nicole Lacroix,27331,242927,2022-06-02
TRANSFER,793,Jacques-Antoine Gros,3813,3020,Nicole Lacroix,242927,243720,2022-06-04
CASH_OUT,216154,Nicole Lacroix,243720,27566,Agence_moov_Abomey,300000,83846,2022-06-05
CASH_OUT,4453,Nicole Lacroix,27566,23113,Agence_moov_Ouidah,300000,295547,2022-06-06
CASH_IN,73825,Agence_moov_Abomey,300000,226175,Nicole Lacroix,23113,96938,2022-06-07
CASH_IN,291111,Agence_moov_Cotonou,300000,8889,Nicole Lacroix,96938,388049,2022-06-08
CASH_IN,73252,Agence_moov_Cotonou,300000,226748,Nicole Lacroix,388049,461301,2022-06-09
TRANSFER,404586,Antoine Bourdon de Auger,730577,325991,Nicole Lacroix,461301,865887,2022-06-10
CASH_IN,24434,Agence_moov_Abomey,300000,275566,Nicole Lacroix,865887,890321,2022-06-11
TRANSFER,329130,Nicole Lacroix,890321,561191,Caroline Bonneau,383171,54041,2022-06-13
TRANSFER,394226,Joséphine Weber du Bonnin,406700,12474,Nicole Lacroix,561191,955417,2022-06-14
CASH_IN,157770,Agence_moov_Cotonou,300000,142230,Nicole Lacroix,955417,1113187,2022-06-15
TRANSFER,766976,Nicole Lacroix,1113187,346211,Josette Guillon-Leclercq,128219,-638757,2022-06-15
TRANSFER,20030,Nicole Lacroix,346211,326181,Élodie Gérard,277900,257870,2022-06-15
TRANSFER,176308,Nicole Lacroix,326181,149873,Isaac Le Pinto,440700,264392,2022-06-15
CASH_OUT,122601,Nicole Lacroix,149873,27272,Agence_moov_Ouidah,300000,177399,2022-06-17
CASH_IN,94021,Agence_moov_Cotonou,300000,205979,Nicole Lacroix,27272,121293,2022-06-17
CASH_IN,55801,Agence_moov_Cotonou,300000,244199,Nicole Lacroix,121293,177094,2022-06-19
CASH_OUT,107705,Nicole Lacroix,177094,69389,Agence_moov_Cotonou,300000,192295,2022-06-20
TRANSFER,62479,Nicole Lacroix,69389,6910,Julie Robin de Gros,1538424,1475945,2022-06-25
TRANSFER,1365,Nicole Lacroix,6910,5545,Théophile Mendès,68498,67133,2022-06-25
CASH_IN,133972,Agence_moov_Cotonou,300000,166028,Nicole Lacroix,5545,139517,2022-06-27
TRANSFER,84927,Nicole Lacroix,139517,54590,Adrienne Arnaud,42620,-42307,2022-06-27
TRANSFER,39302,Nicole Lacroix,54590,15288,Adélaïde-Sophie Leclercq,7558,-31744,2022-06-27
TRANSFER,3617,Caroline Bonneau,54041,50424,Antoine Bourdon de Auger,325991,329608,2022-06-01
CASH_OUT,39217,Antoine Bourdon de Auger,329608,290391,Agence_moov_Cotonou,300000,260783,2022-06-02
CASH_OUT,254940,Antoine Bourdon de Auger,290391,35451,Agence_moov_Cotonou,300000,45060,2022-06-02
CASH_OUT,9676,Antoine Bourdon de Auger,35451,25775,Agence_moov_Abomey,300000,290324,2022-06-04
TRANSFER,97465,David Diallo,870786,773321,Antoine Bourdon de Auger,25775,123240,2022-06-04
TRANSFER,38453,Théophile Mendès,67133,28680,Antoine Bourdon de Auger,123240,161693,2022-06-05
TRANSFER,104242,Antoine Bourdon de Auger,161693,57451,Sabine Imbert,69468,-34774,2022-06-06
TRANSFER,348647,Marthe Pichon,479554,130907,Antoine Bourdon de Auger,57451,406098,2022-06-08
TRANSFER,185258,Isaac Le Pinto,264392,79134,Antoine Bourdon de Auger,406098,591356,2022-06-08
CASH_IN,91070,Agence_moov_Ouidah,300000,208930,Antoine Bourdon de Auger,591356,682426,2022-06-09
CASH_IN,181518,Agence_moov_Ouidah,300000,118482,Antoine Bourdon de Auger,682426,863944,2022-06-09
TRANSFER,2495,Juliette Evrard Le Giraud,3644,1149,Antoine Bourdon de Auger,863944,866439,2022-06-10
TRANSFER,425821,Antoine Bourdon de Auger,866439,440618,Élodie Gérard,257870,-167951,2022-06-11
CASH_OUT,257119,Antoine Bourdon de Auger,440618,183499,Agence_moov_Cotonou,300000,42881,2022-06-11
CASH_IN,179775,Agence_moov_Cotonou,300000,120225,Antoine Bourdon de Auger,183499,363274,2022-06-11
CASH_IN,259826,Agence_moov_Cotonou,300000,40174,Antoine Bourdon de Auger,363274,623100,2022-06-11
CASH_IN,52168,Agence_moov_Cotonou,300000,247832,Antoine Bourdon de Auger,623100,675268,2022-06-11
CASH_OUT,298621,Antoine Bourdon de Auger,675268,376647,Agence_moov_Ouidah,300000,1379,2022-06-12
CASH_OUT,221708,Antoine Bourdon de Auger,376647,154939,Agence_moov_Ouidah,300000,78292,2022-06-13
CASH_IN,171192,Agence_moov_Cotonou,300000,128808,Antoine Bourdon de Auger,154939,326131,2022-06-15
CASH_OUT,54461,Antoine Bourdon de Auger,326131,271670,Agence_moov_Abomey,300000,245539,2022-06-15
CASH_IN,153763,Agence_moov_Abomey,300000,146237,Antoine Bourdon de Auger,271670,425433,2022-06-15
CASH_OUT,123071,Antoine Bourdon de Auger,425433,302362,Agence_moov_Abomey,300000,176929,2022-06-17
CASH_IN,274907,Agence_moov_Ouidah,300000,25093,Antoine Bourdon de Auger,302362,577269,2022-06-18
TRANSFER,417827,Antoine Bourdon de Auger,577269,159442,Théodore-Alfred Fournier,220669,-197158,2022-06-18
CASH_OUT,48480,Antoine Bourdon de Auger,159442,110962,Agence_moov_Ouidah,300000,251520,2022-06-21
CASH_OUT,93088,Antoine Bourdon de Auger,110962,17874,Agence_moov_Cotonou,300000,206912,2022-06-26
CASH_OUT,3415,Antoine Bourdon de Auger,17874,14459,Agence_moov_Abomey,300000,296585,2022-06-26
CASH_OUT,13985,Antoine Bourdon de Auger,14459,474,Agence_moov_Abomey,300000,286015,2022-06-27
CASH_IN,296333,Agence_moov_Abomey,300000,3667,Caroline Monnier,-50640,245693,2022-06-01
CASH_OUT,7029,Caroline Monnier,245693,238664,Agence_moov_Abomey,300000,292971,2022-06-03
CASH_OUT,152192,Caroline Monnier,238664,86472,Agence_moov_Abomey,300000,147808,2022-06-03
CASH_OUT,65818,Caroline Monnier,86472,20654,Agence_moov_Cotonou,300000,234182,2022-06-04
CASH_IN,40193,Agence_moov_Cotonou,300000,259807,Caroline Monnier,20654,60847,2022-06-05
CASH_OUT,5288,Caroline Monnier,60847,55559,Agence_moov_Abomey,300000,294712,2022-06-05
CASH_IN,40192,Agence_moov_Ouidah,300000,259808,Caroline Monnier,55559,95751,2022-06-06
CASH_IN,152104,Agence_moov_Cotonou,300000,147896,Caroline Monnier,95751,247855,2022-06-06
TRANSFER,136718,Caroline Monnier,247855,111137,Maryse Lebreton,400081,263363,2022-06-06
CASH_IN,133917,Agence_moov_Cotonou,300000,166083,Caroline Monnier,111137,245054,2022-06-07
CASH_OUT,231126,Caroline Monnier,245054,13928,Agence_moov_Ouidah,300000,68874,2022-06-07
TRANSFER,9036,Caroline Monnier,13928,4892,Gabriel de Pineau,364416,355380,2022-06-08
CASH_IN,252912,Agence_moov_Abomey,300000,47088,Caroline Monnier,4892,257804,2022-06-08
CASH_OUT,155268,Caroline Monnier,257804,102536,Agence_moov_Ouidah,300000,144732,2022-06-09
CASH_IN,93064,Agence_moov_Cotonou,300000,206936,Caroline Monnier,102536,195600,2022-06-09
TRANSFER,177598,Caroline Monnier,195600,18002,Julie Robin de Gros,1475945,1298347,2022-06-11
CASH_IN,162163,Agence_moov_Abomey,300000,137837,Caroline Monnier,18002,180165,2022-06-12
TRANSFER,79598,Caroline Monnier,180165,100567,Susan de Fontaine,301964,222366,2022-06-13
TRANSFER,461798,Alphonse Dupont-Petit,819443,357645,Caroline Monnier,100567,562365,2022-06-14
TRANSFER,41995,Susan de Fontaine,222366,180371,Caroline Monnier,562365,604360,2022-06-15
CASH_OUT,78110,Caroline Monnier,604360,526250,Agence_moov_Ouidah,300000,221890,2022-06-18
TRANSFER,214523,Caroline Monnier,526250,311727,Juliette Evrard Le Giraud,1149,-213374,2022-06-20
CASH_IN,115326,Agence_moov_Abomey,300000,184674,Caroline Monnier,311727,427053,2022-06-24
CASH_OUT,219985,Caroline Monnier,427053,207068,Agence_moov_Cotonou,300000,80015,2022-06-25
TRANSFER,201903,Caroline Monnier,207068,5165,Théophile Mendès,28680,-173223,2022-06-26
TRANSFER,62698,Margot Renaud de Lacombe,321473,258775,Caroline Monnier,5165,67863,2022-06-26
CASH_IN,125796,Agence_moov_Abomey,300000,174204,Caroline Monnier,67863,193659,2022-06-26
CASH_OUT,151218,Caroline Monnier,193659,42441,Agence_moov_Ouidah,300000,148782,2022-06-27
CASH_OUT,316692,Michèle Vallée,356780,40088,Agence_moov_Ouidah,300000,-16692,2022-06-02
TRANSFER,19157,Michèle Vallée,40088,20931,Alphonse Dupont-Petit,357645,338488,2022-06-02
CASH_IN,109886,Agence_moov_Ouidah,300000,190114,Michèle Vallée,20931,130817,2022-06-03
CASH_IN,221395,Agence_moov_Abomey,300000,78605,Michèle Vallée,130817,352212,2022-06-05
CASH_OUT,339251,Michèle Vallée,352212,12961,Agence_moov_Cotonou,300000,-39251,2022-06-05
CASH_OUT,12871,Michèle Vallée,12961,90,Agence_moov_Ouidah,300000,287129,2022-06-05
CASH_IN,272809,Agence_moov_Ouidah,300000,27191,Michèle Vallée,90,272899,2022-06-05
CASH_OUT,225661,Michèle Vallée,272899,47238,Agence_moov_Ouidah,300000,74339,2022-06-07
CASH_IN,291841,Agence_moov_Ouidah,300000,8159,Michèle Vallée,47238,339079,2022-06-08
TRANSFER,101892,Michèle Vallée,339079,237187,Michèle Vallée,339079,237187,2022-06-08
TRANSFER,181234,Michèle Vallée,237187,55953,Matthieu Carpentier,1462,-179772,2022-06-11
TRANSFER,492782,Marthe Guillet,692064,199282,Michèle Vallée,55953,548735,2022-06-12
CASH_IN,185567,Agence_moov_Cotonou,300000,114433,Michèle Vallée,548735,734302,2022-06-12
CASH_OUT,465628,Michèle Vallée,734302,268674,Agence_moov_Abomey,300000,-165628,2022-06-13
TRANSFER,181025,Michèle Vallée,268674,87649,Julie Robin de Gros,1298347,1117322,2022-06-16
CASH_OUT,21577,Michèle Vallée,87649,66072,Agence_moov_Abomey,300000,278423,2022-06-16
TRANSFER,1235248,Théodore Bertin,1560340,325092,Michèle Vallée,66072,1301320,2022-06-17
CASH_IN,129510,Agence_moov_Cotonou,300000,170490,Michèle Vallée,1301320,1430830,2022-06-17
TRANSFER,449202,Michèle Vallée,1430830,981628,Amélie de la Picard,43243,-405959,2022-06-17
TRANSFER,181190,Gabriel de Pineau,355380,174190,Michèle Vallée,981628,1162818,2022-06-18
TRANSFER,149081,Gabriel de Pineau,174190,25109,Michèle Vallée,1162818,1311899,2022-06-19
CASH_IN,69025,Agence_moov_Ouidah,300000,230975,Michèle Vallée,1311899,1380924,2022-06-20
CASH_IN,126039,Agence_moov_Abomey,300000,173961,Michèle Vallée,1380924,1506963,2022-06-20
CASH_OUT,1084316,Michèle Vallée,1506963,422647,Agence_moov_Abomey,300000,-784316,2022-06-22
CASH_IN,224541,Agence_moov_Cotonou,300000,75459,Michèle Vallée,422647,647188,2022-06-22
TRANSFER,65816,Isaac Le Pinto,79134,13318,Michèle Vallée,647188,713004,2022-06-23
CASH_OUT,193615,Michèle Vallée,713004,519389,Agence_moov_Abomey,300000,106385,2022-06-23
CASH_IN,57212,Agence_moov_Ouidah,300000,242788,Michèle Vallée,519389,576601,2022-06-25
CASH_OUT,152001,Michèle Vallée,576601,424600,Agence_moov_Ouidah,300000,147999,2022-06-26
CASH_OUT,129183,Michèle Vallée,424600,295417,Agence_moov_Abomey,300000,170817,2022-06-27
CASH_OUT,81145,Théodore Bertin,325092,243947,Agence_moov_Abomey,300000,218855,2022-06-02
CASH_IN,196955,Agence_moov_Abomey,300000,103045,Théodore Bertin,243947,440902,2022-06-05
CASH_OUT,430682,Théodore Bertin,440902,10220,Agence_moov_Cotonou,300000,-130682,2022-06-06
CASH_OUT,5422,Théodore Bertin,10220,4798,Agence_moov_Abomey,300000,294578,2022-06-13
TRANSFER,12720,Sébastien Jourdan,68112,55392,Théodore Bertin,4798,17518,2022-06-14
CASH_IN,139638,Agence_moov_Abomey,300000,160362,Théodore Bertin,17518,157156,2022-06-18
CASH_OUT,69261,Théodore Bertin,157156,87895,Agence_moov_Cotonou,300000,230739,2022-06-20
CASH_OUT,81026,Théodore Bertin,87895,6869,Agence_moov_Ouidah,300000,218974,2022-06-24
CASH_OUT,3955,Théodore Bertin,6869,2914,Agence_moov_Ouidah,300000,296045,2022-06-24
CASH_OUT,970,Théodore Bertin,2914,1944,Agence_moov_Abomey,300000,299030,2022-06-25
TRANSFER,7920,Stéphane-Timothée Pineau,139086,131166,Théodore Bertin,1944,9864,2022-06-26
CASH_IN,181515,Agence_moov_Cotonou,300000,118485,Théodore Bertin,9864,191379,2022-06-26
CASH_IN,198922,Agence_moov_Cotonou,300000,101078,Thierry Dos Santos-Le Roux,-449002,-250080,2022-06-01
CASH_IN,111865,Agence_moov_Cotonou,300000,188135,Thierry Dos Santos-Le Roux,-250080,-138215,2022-06-03
CASH_IN,250972,Agence_moov_Cotonou,300000,49028,Thierry Dos Santos-Le Roux,-138215,112757,2022-06-04
TRANSFER,370,Hugues Gay,5838,5468,Thierry Dos Santos-Le Roux,112757,113127,2022-06-08
CASH_OUT,19425,Thierry Dos Santos-Le Roux,113127,93702,Agence_moov_Ouidah,300000,280575,2022-06-09
CASH_OUT,68888,Thierry Dos Santos-Le Roux,93702,24814,Agence_moov_Abomey,300000,231112,2022-06-11
CASH_OUT,8978,Thierry Dos Santos-Le Roux,24814,15836,Agence_moov_Ouidah,300000,291022,2022-06-14
CASH_OUT,10011,Thierry Dos Santos-Le Roux,15836,5825,Agence_moov_Abomey,300000,289989,2022-06-16
CASH_IN,299214,Agence_moov_Cotonou,300000,786,Thierry Dos Santos-Le Roux,5825,305039,2022-06-17
TRANSFER,562,Jacques-Antoine Gros,3020,2458,Thierry Dos Santos-Le Roux,305039,305601,2022-06-18
TRANSFER,775830,Maurice Seguin,843700,67870,Thierry Dos Santos-Le Roux,305601,1081431,2022-06-18
TRANSFER,319609,Laurence Carlier,1130338,810729,Thierry Dos Santos-Le Roux,1081431,1401040,2022-06-19
TRANSFER,1104490,Thierry Dos Santos-Le Roux,1401040,296550,Thierry Dos Santos-Le Roux,1401040,296550,2022-06-19
CASH_OUT,273563,Thierry Dos Santos-Le Roux,296550,22987,Agence_moov_Cotonou,300000,26437,2022-06-21
CASH_OUT,6915,Thierry Dos Santos-Le Roux,22987,16072,Agence_moov_Abomey,300000,293085,2022-06-22
TRANSFER,2241,Thierry Dos Santos-Le Roux,16072,13831,Sébastien Jourdan,55392,53151,2022-06-22
TRANSFER,3632,Thierry Dos Santos-Le Roux,13831,10199,Caroline Bonneau,50424,46792,2022-06-22
TRANSFER,24482,Gabriel de Pineau,25109,627,Thierry Dos Santos-Le Roux,10199,34681,2022-06-23
CASH_OUT,31799,Thierry Dos Santos-Le Roux,34681,2882,Agence_moov_Abomey,300000,268201,2022-06-26
CASH_OUT,16716,Maurice Seguin,67870,51154,Agence_moov_Cotonou,300000,283284,2022-06-01
TRANSFER,2430,Maurice Seguin,51154,48724,David Diallo,773321,770891,2022-06-02
TRANSFER,38420,Maurice Seguin,48724,10304,Jacques-Antoine Gros,2458,-35962,2022-06-04
CASH_OUT,8292,Maurice Seguin,10304,2012,Agence_moov_Ouidah,300000,291708,2022-06-04
TRANSFER,222,Maurice Seguin,2012,1790,Isaac Le Pinto,13318,13096,2022-06-07
TRANSFER,1708,Maurice Seguin,1790,82,Joséphine Weber du Bonnin,12474,10766,2022-06-08
CASH_IN,100174,Agence_moov_Abomey,300000,199826,Maurice Seguin,82,100256,2022-06-11
CASH_OUT,9891,Maurice Seguin,100256,90365,Agence_moov_Abomey,300000,290109,2022-06-12
TRANSFER,93393,Maryse Lebreton,263363,169970,Maurice Seguin,90365,183758,2022-06-15
TRANSFER,226,Gabriel de Pineau,627,401,Maurice Seguin,183758,183984,2022-06-16
TRANSFER,338964,Laurence Carlier,810729,471765,Maurice Seguin,183984,522948,2022-06-16
CASH_IN,42461,Agence_moov_Ouidah,300000,257539,Maurice Seguin,522948,565409,2022-06-16
CASH_IN,222806,Agence_moov_Abomey,300000,77194,Maurice Seguin,565409,788215,2022-06-18
TRANSFER,402895,Maurice Seguin,788215,385320,Diane-Françoise Raynaud,238217,-164678,2022-06-18
CASH_OUT,340404,Maurice Seguin,385320,44916,Agence_moov_Cotonou,300000,-40404,2022-06-18
CASH_IN,123487,Agence_moov_Cotonou,300000,176513,Maurice Seguin,44916,168403,2022-06-18
CASH_IN,190330,Agence_moov_Ouidah,300000,109670,Maurice Seguin,168403,358733,2022-06-19
TRANSFER,301780,Maurice Seguin,358733,56953,Isaac Le Pinto,13096,-288684,2022-06-25
CASH_OUT,1166,Maurice Seguin,56953,55787,Agence_moov_Abomey,300000,298834,2022-06-27
CASH_IN,248163,Agence_moov_Ouidah,300000,51837,Maurice Seguin,55787,303950,2022-06-27
TRANSFER,94653,Marthe Pichon,130907,36254,Valentine Traore,115769,210422,2022-06-01
TRANSFER,46486,Caroline Bonneau,46792,306,Valentine Traore,210422,256908,2022-06-01
CASH_IN,229537,Agence_moov_Abomey,300000,70463,Valentine Traore,256908,486445,2022-06-02
CASH_OUT,58347,Valentine Traore,486445,428098,Agence_moov_Abomey,300000,241653,2022-06-03
CASH_IN,123082,Agence_moov_Cotonou,300000,176918,Valentine Traore,428098,551180,2022-06-05
CASH_IN,297809,Agence_moov_Abomey,300000,2191,Valentine Traore,551180,848989,2022-06-06
TRANSFER,124076,Valentine Traore,848989,724913,Joséphine Weber du Bonnin,10766,-113310,2022-06-06
CASH_OUT,270255,Valentine Traore,724913,454658,Agence_moov_Abomey,300000,29745,2022-06-08
CASH_IN,210586,Agence_moov_Cotonou,300000,89414,Valentine Traore,454658,665244,2022-06-08
CASH_OUT,107007,Valentine Traore,665244,558237,Agence_moov_Cotonou,300000,192993,2022-06-13
CASH_OUT,112172,Valentine Traore,558237,446065,Agence_moov_Ouidah,300000,187828,2022-06-16
CASH_IN,60022,Agence_moov_Ouidah,300000,239978,Valentine Traore,446065,506087,2022-06-16
CASH_IN,81119,Agence_moov_Ouidah,300000,218881,Valentine Traore,506087,587206,2022-06-19
CASH_OUT,357685,Valentine Traore,587206,229521,Agence_moov_Ouidah,300000,-57685,2022-06-20
CASH_OUT,86833,Valentine Traore,229521,142688,Agence_moov_Abomey,300000,213167,2022-06-21
CASH_IN,42470,Agence_moov_Ouidah,300000,257530,Valentine Traore,142688,185158,2022-06-22
CASH_OUT,111752,Valentine Traore,185158,73406,Agence_moov_Cotonou,300000,188248,2022-06-22
CASH_OUT,8549,Valentine Traore,73406,64857,Agence_moov_Ouidah,300000,291451,2022-06-23
TRANSFER,13837,Valentine Traore,64857,51020,Gabriel de Pineau,401,-13436,2022-06-26
TRANSFER,140321,Marthe Guillet,199282,58961,Marthe Pichon,36254,176575,2022-06-04
CASH_IN,17786,Agence_moov_Abomey,300000,282214,Marthe Pichon,176575,194361,2022-06-04
CASH_IN,139891,Agence_moov_Abomey,300000,160109,Marthe Pichon,194361,334252,2022-06-05
CASH_IN,23751,Agence_moov_Abomey,300000,276249,Marthe Pichon,334252,358003,2022-06-06
CASH_IN,151835,Agence_moov_Abomey,300000,148165,Marthe Pichon,358003,509838,2022-06-07
CASH_IN,206619,Agence_moov_Abomey,300000,93381,Marthe Pichon,509838,716457,2022-06-08
CASH_OUT,468430,Marthe Pichon,716457,248027,Agence_moov_Cotonou,300000,-168430,2022-06-09
CASH_OUT,102512,Marthe Pichon,248027,145515,Agence_moov_Abomey,300000,197488,2022-06-09
TRANSFER,83971,Marthe Pichon,145515,61544,Luc-Tristan Moreau,239818,155847,2022-06-11
CASH_OUT,53492,Marthe Pichon,61544,8052,Agence_moov_Ouidah,300000,246508,2022-06-12
CASH_IN,120368,Agence_moov_Cotonou,300000,179632,Marthe Pichon,8052,128420,2022-06-16
CASH_OUT,89780,Marthe Pichon,128420,38640,Agence_moov_Ouidah,300000,210220,2022-06-16
CASH_OUT,30708,Marthe Pichon,38640,7932,Agence_moov_Cotonou,300000,269292,2022-06-17
CASH_OUT,7672,Marthe Pichon,7932,260,Agence_moov_Abomey,300000,292328,2022-06-19
CASH_IN,298127,Agence_moov_Ouidah,300000,1873,Marthe Pichon,260,298387,2022-06-19
TRANSFER,149093,Océane Boutin,578800,429707,Marthe Pichon,298387,447480,2022-06-23
CASH_IN,169563,Agence_moov_Ouidah,300000,130437,Marthe Pichon,447480,617043,2022-06-24
TRANSFER,20365,Sébastien Jourdan,53151,32786,Marthe Pichon,617043,637408,2022-06-24
CASH_OUT,514737,Marthe Pichon,637408,122671,Agence_moov_Cotonou,300000,-214737,2022-06-26
CASH_OUT,80711,Marthe Pichon,122671,41960,Agence_moov_Cotonou,300000,219289,2022-06-27
CASH_IN,88686,Agence_moov_Abomey,300000,211314,Arnaude Gaillard,-168326,-79640,2022-06-02
CASH_IN,127780,Agence_moov_Ouidah,300000,172220,Arnaude Gaillard,-79640,48140,2022-06-02
TRANSFER,16148,Arnaude Gaillard,48140,31992,Stéphane-Timothée Pineau,131166,115018,2022-06-05
TRANSFER,29660,Arnaude Gaillard,31992,2332,Alphonse Dupont-Petit,338488,308828,2022-06-06
TRANSFER,77098,Océane Boutin,429707,352609,Arnaude Gaillard,2332,79430,2022-06-15
CASH_IN,136158,Agence_moov_Cotonou,300000,163842,Arnaude Gaillard,79430,215588,2022-06-15
CASH_OUT,1367,Arnaude Gaillard,215588,214221,Agence_moov_Abomey,300000,298633,2022-06-22
CASH_OUT,92656,Arnaude Gaillard,214221,121565,Agence_moov_Ouidah,300000,207344,2022-06-22
TRANSFER,285589,Océane Boutin,352609,67020,Maryse Lebreton,169970,-115619,2022-06-01
CASH_OUT,11630,Océane Boutin,67020,55390,Agence_moov_Abomey,300000,288370,2022-06-01
CASH_IN,87139,Agence_moov_Ouidah,300000,212861,Océane Boutin,55390,142529,2022-06-05
TRANSFER,52051,Océane Boutin,142529,90478,Caroline Bonneau,306,-51745,2022-06-06
TRANSFER,524,Agnès Baron,1072,548,Océane Boutin,90478,91002,2022-06-07
CASH_IN,162750,Agence_moov_Cotonou,300000,137250,Océane Boutin,91002,253752,2022-06-08
CASH_OUT,133655,Océane Boutin,253752,120097,Agence_moov_Cotonou,300000,166345,2022-06-08
TRANSFER,58997,Océane Boutin,120097,61100,Luc-Tristan Moreau,155847,96850,2022-06-09
TRANSFER,3639,Hugues Gay,5468,1829,Océane Boutin,61100,64739,2022-06-11
CASH_IN,198473,Agence_moov_Abomey,300000,101527,Océane Boutin,64739,263212,2022-06-12
TRANSFER,68729,Océane Boutin,263212,194483,Océane Boutin,263212,194483,2022-06-13
CASH_IN,33007,Agence_moov_Cotonou,300000,266993,Océane Boutin,194483,227490,2022-06-18
TRANSFER,84148,Océane Boutin,227490,143342,Sébastien Jourdan,32786,-51362,2022-06-20
CASH_OUT,127572,Océane Boutin,143342,15770,Agence_moov_Cotonou,300000,172428,2022-06-23
TRANSFER,393,Océane Boutin,15770,15377,Margot Renaud de Lacombe,258775,258382,2022-06-25
CASH_OUT,14596,Océane Boutin,15377,781,Agence_moov_Ouidah,300000,285404,2022-06-25
CASH_IN,217504,Agence_moov_Abomey,300000,82496,Océane Boutin,781,218285,2022-06-26
TRANSFER,84862,Océane Boutin,218285,133423,Vincent-Philippe Rossi,728,-84134,2022-06-27
CASH_IN,198273,Agence_moov_Ouidah,300000,101727,Adélaïde-Sophie Leclercq,-31744,166529,2022-06-02
CASH_IN,212107,Agence_moov_Ouidah,300000,87893,Adélaïde-Sophie Leclercq,166529,378636,2022-06-03
TRANSFER,51274,Julie Robin de Gros,1117322,1066048,Adélaïde-Sophie Leclercq,378636,429910,2022-06-04
CASH_IN,233137,Agence_moov_Cotonou,300000,66863,Adélaïde-Sophie Leclercq,429910,663047,2022-06-05
TRANSFER,103998,Adélaïde-Sophie Leclercq,663047,559049,Marthe Guillet,58961,-45037,2022-06-12
CASH_OUT,552648,Adélaïde-Sophie Leclercq,559049,6401,Agence_moov_Abomey,300000,-252648,2022-06-13
CASH_IN,76604,Agence_moov_Abomey,300000,223396,Adélaïde-Sophie Leclercq,6401,83005,2022-06-14
CASH_IN,1193,Agence_moov_Ouidah,300000,298807,Adélaïde-Sophie Leclercq,83005,84198,2022-06-17
CASH_IN,209358,Agence_moov_Cotonou,300000,90642,Adélaïde-Sophie Leclercq,84198,293556,2022-06-18
TRANSFER,2143,Luc-Tristan Moreau,96850,94707,Adélaïde-Sophie Leclercq,293556,295699,2022-06-19
CASH_OUT,133287,Adélaïde-Sophie Leclercq,295699,162412,Agence_moov_Cotonou,300000,166713,2022-06-22
CASH_IN,161131,Agence_moov_Ouidah,300000,138869,Adélaïde-Sophie Leclercq,162412,323543,2022-06-27
CASH_IN,200656,Agence_moov_Abomey,300000,99344,Matthieu Carpentier,-179772,20884,2022-06-02
CASH_IN,2344,Agence_moov_Abomey,300000,297656,Matthieu Carpentier,20884,23228,2022-06-04
TRANSFER,19270,Matthieu Carpentier,23228,3958,Laurence Carlier,471765,452495,2022-06-10
TRANSFER,2418,Matthieu Carpentier,3958,1540,Stéphane-Timothée Pineau,115018,112600,2022-06-14
TRANSFER,8188,Luc-Tristan Moreau,94707,86519,Matthieu Carpentier,1540,9728,2022-06-16
CASH_OUT,8400,Matthieu Carpentier,9728,1328,Agence_moov_Ouidah,300000,291600,2022-06-18
TRANSFER,193671,Margot Renaud de Lacombe,258382,64711,Matthieu Carpentier,1328,194999,2022-06-23
CASH_OUT,33436,Matthieu Carpentier,194999,161563,Agence_moov_Cotonou,300000,266564,2022-06-23
TRANSFER,162272,Susan de Fontaine,180371,18099,Matthieu Carpentier,161563,323835,2022-06-26
TRANSFER,116,Agnès Baron,548,432,Luc-Tristan Moreau,86519,86635,2022-06-02
CASH_OUT,46681,Luc-Tristan Moreau,86635,39954,Agence_moov_Ouidah,300000,253319,2022-06-08
CASH_IN,5777,Agence_moov_Cotonou,300000,294223,Luc-Tristan Moreau,39954,45731,2022-06-10
TRANSFER,576517,Julie Robin de Gros,1066048,489531,Luc-Tristan Moreau,45731,622248,2022-06-11
CASH_OUT,580548,Luc-Tristan Moreau,622248,41700,Agence_moov_Abomey,300000,-280548,2022-06-23
TRANSFER,39084,Luc-Tristan Moreau,41700,2616,Stéphane-Timothée Pineau,112600,73516,2022-06-23
TRANSFER,234365,David Diallo,770891,536526,Luc-Tristan Moreau,2616,236981,2022-06-25
CASH_OUT,129038,Luc-Tristan Moreau,236981,107943,Agence_moov_Cotonou,300000,170962,2022-06-27
CASH_IN,289218,Agence_moov_Cotonou,300000,10782,Jacques-Antoine Gros,-35962,253256,2022-06-02
CASH_OUT,788,Jacques-Antoine Gros,253256,252468,Agence_moov_Abomey,300000,299212,2022-06-03
CASH_OUT,113561,Jacques-Antoine Gros,252468,138907,Agence_moov_Abomey,300000,186439,2022-06-07
CASH_IN,297007,Agence_moov_Cotonou,300000,2993,Jacques-Antoine Gros,138907,435914,2022-06-10
TRANSFER,528849,David Diallo,536526,7677,Jacques-Antoine Gros,435914,964763,2022-06-10
CASH_OUT,240113,Jacques-Antoine Gros,964763,724650,Agence_moov_Ouidah,300000,59887,2022-06-10
CASH_OUT,657924,Jacques-Antoine Gros,724650,66726,Agence_moov_Ouidah,300000,-357924,2022-06-11
CASH_IN,182840,Agence_moov_Ouidah,300000,117160,Jacques-Antoine Gros,66726,249566,2022-06-11
CASH_IN,199703,Agence_moov_Cotonou,300000,100297,Jacques-Antoine Gros,249566,449269,2022-06-12
CASH_IN,180509,Agence_moov_Cotonou,300000,119491,Jacques-Antoine Gros,449269,629778,2022-06-15
CASH_OUT,438607,Jacques-Antoine Gros,629778,191171,Agence_moov_Abomey,300000,-138607,2022-06-17
TRANSFER,58563,Margot Renaud de Lacombe,64711,6148,Jacques-Antoine Gros,191171,249734,2022-06-17
TRANSFER,136166,Jacques-Antoine Gros,249734,113568,Agnès Baron,432,-135734,2022-06-20
CASH_OUT,100314,Jacques-Antoine Gros,113568,13254,Agence_moov_Abomey,300000,199686,2022-06-23
CASH_IN,143500,Agence_moov_Abomey,300000,156500,Jacques-Antoine Gros,13254,156754,2022-06-25
CASH_OUT,145957,Jacques-Antoine Gros,156754,10797,Agence_moov_Ouidah,300000,154043,2022-06-25
TRANSFER,127344,Alphonse Dupont-Petit,308828,181484,Jacques-Antoine Gros,10797,138141,2022-06-26
CASH_IN,171975,Agence_moov_Abomey,300000,128025,Alfred Chrétien,-184283,-12308,2022-06-01
CASH_IN,105724,Agence_moov_Abomey,300000,194276,Alfred Chrétien,-12308,93416,2022-06-03
CASH_IN,167811,Agence_moov_Cotonou,300000,132189,Alfred Chrétien,93416,261227,2022-06-03
CASH_OUT,211474,Alfred Chrétien,261227,49753,Agence_moov_Cotonou,300000,88526,2022-06-08
CASH_IN,26870,Agence_moov_Ouidah,300000,273130,Alfred Chrétien,49753,76623,2022-06-10
CASH_IN,210377,Agence_moov_Abomey,300000,89623,Alfred Chrétien,76623,287000,2022-06-14
CASH_IN,289837,Agence_moov_Cotonou,300000,10163,Noémi de la Didier,-380262,-90425,2022-06-01
CASH_IN,57185,Agence_moov_Cotonou,300000,242815,Noémi de la Didier,-90425,-33240,2022-06-01
CASH_IN,52573,Agence_moov_Ouidah,300000,247427,Noémi de la Didier,-33240,19333,2022-06-04
TRANSFER,7013,Noémi de la Didier,19333,12320,Laurence Carlier,452495,445482,2022-06-04
CASH_IN,238925,Agence_moov_Abomey,300000,61075,Noémi de la Didier,12320,251245,2022-06-09
CASH_IN,105752,Agence_moov_Abomey,300000,194248,Noémi de la Didier,251245,356997,2022-06-10
CASH_IN,116019,Agence_moov_Ouidah,300000,183981,Noémi de la Didier,356997,473016,2022-06-13
CASH_OUT,56145,Noémi de la Didier,473016,416871,Agence_moov_Cotonou,300000,243855,2022-06-13
TRANSFER,125926,Alphonse Dupont-Petit,181484,55558,Noémi de la Didier,416871,542797,2022-06-14
TRANSFER,334890,Julie Robin de Gros,489531,154641,Noémi de la Didier,542797,877687,2022-06-15
CASH_OUT,174838,Noémi de la Didier,877687,702849,Agence_moov_Abomey,300000,125162,2022-06-15
CASH_IN,59807,Agence_moov_Ouidah,300000,240193,Noémi de la Didier,702849,762656,2022-06-17
CASH_IN,108890,Agence_moov_Ouidah,300000,191110,Noémi de la Didier,762656,871546,2022-06-19
TRANSFER,5785,David Diallo,7677,1892,Noémi de la Didier,871546,877331,2022-06-19
TRANSFER,66711,Noémi de la Didier,877331,810620,Julie Robin de Gros,154641,87930,2022-06-21
CASH_IN,39855,Agence_moov_Abomey,300000,260145,Noémi de la Didier,810620,850475,2022-06-21
CASH_OUT,86330,Noémi de la Didier,850475,764145,Agence_moov_Cotonou,300000,213670,2022-06-25
CASH_IN,163844,Agence_moov_Abomey,300000,136156,Josette Guillon-Leclercq,-638757,-474913,2022-06-08
CASH_IN,89815,Agence_moov_Ouidah,300000,210185,Josette Guillon-Leclercq,-474913,-385098,2022-06-09
CASH_IN,96080,Agence_moov_Abomey,300000,203920,Josette Guillon-Leclercq,-385098,-289018,2022-06-12
CASH_IN,142837,Agence_moov_Cotonou,300000,157163,Josette Guillon-Leclercq,-289018,-146181,2022-06-16
CASH_IN,32172,Agence_moov_Ouidah,300000,267828,Josette Guillon-Leclercq,-146181,-114009,2022-06-17
CASH_IN,136308,Agence_moov_Abomey,300000,163692,Josette Guillon-Leclercq,-114009,22299,2022-06-17
CASH_OUT,5760,Josette Guillon-Leclercq,22299,16539,Agence_moov_Cotonou,300000,294240,2022-06-18
TRANSFER,17800,Julie Robin de Gros,87930,70130,Josette Guillon-Leclercq,16539,34339,2022-06-18
TRANSFER,4097,Susan de Fontaine,18099,14002,Josette Guillon-Leclercq,34339,38436,2022-06-23
CASH_OUT,381350,Laurence Carlier,445482,64132,Agence_moov_Cotonou,300000,-81350,2022-06-02
CASH_OUT,39226,Laurence Carlier,64132,24906,Agence_moov_Abomey,300000,260774,2022-06-02
CASH_OUT,1251,Laurence Carlier,24906,23655,Agence_moov_Abomey,300000,298749,2022-06-08
CASH_OUT,3342,Laurence Carlier,23655,20313,Agence_moov_Cotonou,300000,296658,2022-06-10
TRANSFER,18430,Laurence Carlier,20313,1883,David Diallo,1892,-16538,2022-06-11
CASH_OUT,414,Laurence Carlier,1883,1469,Agence_moov_Ouidah,300000,299586,2022-06-14
TRANSFER,1166,Laurence Carlier,1469,303,Margot Renaud de Lacombe,6148,4982,2022-06-16
TRANSFER,3897,Margot Renaud de Lacombe,4982,1085,Laurence Carlier,303,4200,2022-06-16
TRANSFER,3972,Laurence Carlier,4200,228,Stéphane-Timothée Pineau,73516,69544,2022-06-17
CASH_OUT,204,Laurence Carlier,228,24,Agence_moov_Cotonou,300000,299796,2022-06-18
CASH_IN,264325,Agence_moov_Ouidah,300000,35675,Laurence Carlier,24,264349,2022-06-20
TRANSFER,3998,Susan de Fontaine,14002,10004,Laurence Carlier,264349,268347,2022-06-20
CASH_OUT,17589,Laurence Carlier,268347,250758,Agence_moov_Abomey,300000,282411,2022-06-22
CASH_IN,64968,Agence_moov_Abomey,300000,235032,Laurence Carlier,250758,315726,2022-06-22
TRANSFER,7084,Laurence Carlier,315726,308642,Susan de Fontaine,10004,2920,2022-06-24
CASH_OUT,179076,Laurence Carlier,308642,129566,Agence_moov_Ouidah,300000,120924,2022-06-25
CASH_IN,198620,Agence_moov_Ouidah,300000,101380,Laurence Carlier,129566,328186,2022-06-27
CASH_IN,79029,Agence_moov_Ouidah,300000,220971,Adrienne Arnaud,-42307,36722,2022-06-05
TRANSFER,25937,Adrienne Arnaud,36722,10785,Susan de Fontaine,2920,-23017,2022-06-07
CASH_OUT,7729,Adrienne Arnaud,10785,3056,Agence_moov_Cotonou,300000,292271,2022-06-08
TRANSFER,34272,Alphonse Dupont-Petit,55558,21286,Adrienne Arnaud,3056,37328,2022-06-09
CASH_IN,62525,Agence_moov_Cotonou,300000,237475,Adrienne Arnaud,37328,99853,2022-06-12
CASH_OUT,93428,Adrienne Arnaud,99853,6425,Agence_moov_Cotonou,300000,206572,2022-06-14
TRANSFER,5397,Adrienne Arnaud,6425,1028,Adrienne Arnaud,6425,11822,2022-06-16
CASH_OUT,225,Adrienne Arnaud,1028,803,Agence_moov_Abomey,300000,299775,2022-06-17
TRANSFER,967,Margot Renaud de Lacombe,1085,118,Adrienne Arnaud,803,1770,2022-06-20
CASH_OUT,1757,Adrienne Arnaud,1770,13,Agence_moov_Cotonou,300000,298243,2022-06-27
CASH_IN,270420,Agence_moov_Cotonou,300000,29580,Aimé Allain,-175548,94872,2022-06-03
CASH_IN,298095,Agence_moov_Cotonou,300000,1905,Aimé Allain,94872,392967,2022-06-06
TRANSFER,252307,Aimé Allain,392967,140660,Stéphane-Timothée Pineau,69544,-182763,2022-06-07
TRANSFER,7898,Julie Robin de Gros,70130,62232,Aimé Allain,140660,148558,2022-06-07
CASH_IN,244423,Agence_moov_Ouidah,300000,55577,Aimé Allain,148558,392981,2022-06-08
CASH_IN,270697,Agence_moov_Cotonou,300000,29303,Aimé Allain,392981,663678,2022-06-10
TRANSFER,114,Margot Renaud de Lacombe,118,4,Aimé Allain,663678,663792,2022-06-12
TRANSFER,449380,Aimé Allain,663792,214412,Aimé Allain,663792,1113172,2022-06-14
TRANSFER,48461,Aimé Allain,214412,165951,Aimé Allain,214412,165951,2022-06-15
CASH_OUT,147618,Aimé Allain,165951,18333,Agence_moov_Ouidah,300000,152382,2022-06-16
CASH_OUT,6901,Aimé Allain,18333,11432,Agence_moov_Ouidah,300000,293099,2022-06-19
CASH_OUT,6567,Aimé Allain,11432,4865,Agence_moov_Abomey,300000,293433,2022-06-21
TRANSFER,3725,Aimé Allain,4865,1140,Julie Robin de Gros,62232,58507,2022-06-25
CASH_OUT,866,Aimé Allain,1140,274,Agence_moov_Abomey,300000,299134,2022-06-25
CASH_IN,212300,Agence_moov_Cotonou,300000,87700,Diane-Françoise Raynaud,-164678,47622,2022-06-05
TRANSFER,16665,Julie Robin de Gros,58507,41842,Diane-Françoise Raynaud,47622,64287,2022-06-12
TRANSFER,22212,Julie Robin de Gros,41842,19630,Diane-Françoise Raynaud,64287,86499,2022-06-14
CASH_IN,118594,Agence_moov_Abomey,300000,181406,Diane-Françoise Raynaud,86499,205093,2022-06-23
CASH_OUT,184362,Diane-Françoise Raynaud,205093,20731,Agence_moov_Abomey,300000,115638,2022-06-25
CASH_OUT,9520,Diane-Françoise Raynaud,20731,11211,Agence_moov_Abomey,300000,290480,2022-06-26
CASH_IN,233640,Agence_moov_Ouidah,300000,66360,Élodie Gérard,-167951,65689,2022-06-01
CASH_OUT,33562,Élodie Gérard,65689,32127,Agence_moov_Cotonou,300000,266438,2022-06-02
CASH_IN,279474,Agence_moov_Abomey,300000,20526,Élodie Gérard,32127,311601,2022-06-03
CASH_OUT,75405,Élodie Gérard,311601,236196,Agence_moov_Cotonou,300000,224595,2022-06-06
TRANSFER,157451,Élodie Gérard,236196,78745,Élodie Gérard,236196,393647,2022-06-07
CASH_OUT,9567,Élodie Gérard,78745,69178,Agence_moov_Cotonou,300000,290433,2022-06-10
CASH_OUT,47357,Élodie Gérard,69178,21821,Agence_moov_Cotonou,300000,252643,2022-06-11
CASH_IN,110690,Agence_moov_Abomey,300000,189310,Élodie Gérard,21821,132511,2022-06-13
CASH_IN,297880,Agence_moov_Cotonou,300000,2120,Élodie Gérard,132511,430391,2022-06-13
TRANSFER,134887,Élodie Gérard,430391,295504,Alphonse Dupont-Petit,21286,-113601,2022-06-14
TRANSFER,1760,Julie Robin de Gros,19630,17870,Élodie Gérard,295504,297264,2022-06-16
CASH_IN,165519,Agence_moov_Abomey,300000,134481,Élodie Gérard,297264,462783,2022-06-19
CASH_OUT,247005,Élodie Gérard,462783,215778,Agence_moov_Cotonou,300000,52995,2022-06-19
TRANSFER,6488,Julie Robin de Gros,17870,11382,Élodie Gérard,215778,222266,2022-06-20
TRANSFER,2570,Julie Robin de Gros,11382,8812,Élodie Gérard,222266,224836,2022-06-21
CASH_OUT,72471,Élodie Gérard,224836,152365,Agence_moov_Abomey,300000,227529,2022-06-23
CASH_IN,8511,Agence_moov_Abomey,300000,291489,Élodie Gérard,152365,160876,2022-06-24
CASH_IN,146314,Agence_moov_Cotonou,300000,153686,Isaac Le Pinto,-288684,-142370,2022-06-03
CASH_IN,218140,Agence_moov_Cotonou,300000,81860,Isaac Le Pinto,-142370,75770,2022-06-03
TRANSFER,55653,Isaac Le Pinto,75770,20117,Isaac Le Pinto,75770,20117,2022-06-06
CASH_IN,151785,Agence_moov_Abomey,300000,148215,Isaac Le Pinto,20117,171902,2022-06-08
CASH_IN,150972,Agence_moov_Abomey,300000,149028,Isaac Le Pinto,171902,322874,2022-06-09
CASH_OUT,117876,Isaac Le Pinto,322874,204998,Agence_moov_Ouidah,300000,182124,2022-06-11
CASH_IN,99854,Agence_moov_Cotonou,300000,200146,Isaac Le Pinto,204998,304852,2022-06-13
CASH_OUT,209094,Isaac Le Pinto,304852,95758,Agence_moov_Cotonou,300000,90906,2022-06-14
CASH_OUT,75043,Isaac Le Pinto,95758,20715,Agence_moov_Abomey,300000,224957,2022-06-17
CASH_IN,5265,Agence_moov_Abomey,300000,294735,Isaac Le Pinto,20715,25980,2022-06-20
CASH_IN,15318,Agence_moov_Abomey,300000,284682,Isaac Le Pinto,25980,41298,2022-06-23
CASH_IN,284473,Agence_moov_Ouidah,300000,15527,Isaac Le Pinto,41298,325771,2022-06-24
CASH_IN,154742,Agence_moov_Cotonou,300000,145258,Augustin Benard,-38857,115885,2022-06-01
CASH_OUT,94938,Augustin Benard,115885,20947,Agence_moov_Cotonou,300000,205062,2022-06-03
CASH_OUT,315,Augustin Benard,20947,20632,Agence_moov_Ouidah,300000,299685,2022-06-05
CASH_OUT,12938,Augustin Benard,20632,7694,Agence_moov_Ouidah,300000,287062,2022-06-07
CASH_IN,138142,Agence_moov_Abomey,300000,161858,Augustin Benard,7694,145836,2022-06-07
CASH_IN,299851,Agence_moov_Ouidah,300000,149,Augustin Benard,145836,445687,2022-06-09
TRANSFER,233517,Augustin Benard,445687,212170,Augustin Benard,445687,679204,2022-06-10
TRANSFER,13673,Augustin Benard,212170,198497,Augustin Benard,212170,198497,2022-06-11
CASH_IN,68820,Agence_moov_Ouidah,300000,231180,Augustin Benard,198497,267317,2022-06-13
CASH_OUT,168639,Augustin Benard,267317,98678,Agence_moov_Ouidah,300000,131361,2022-06-17
CASH_OUT,62119,Augustin Benard,98678,36559,Agence_moov_Ouidah,300000,237881,2022-06-21
CASH_OUT,19230,Augustin Benard,36559,17329,Agence_moov_Cotonou,300000,280770,2022-06-26
CASH_IN,63852,Agence_moov_Ouidah,300000,236148,Théophile Mendès,-173223,-109371,2022-06-04
CASH_IN,47532,Agence_moov_Cotonou,300000,252468,Théophile Mendès,-109371,-61839,2022-06-08
CASH_IN,136362,Agence_moov_Ouidah,300000,163638,Théophile Mendès,-61839,74523,2022-06-09
CASH_OUT,67605,Théophile Mendès,74523,6918,Agence_moov_Abomey,300000,232395,2022-06-11
CASH_OUT,4676,Théophile Mendès,6918,2242,Agence_moov_Ouidah,300000,295324,2022-06-11
CASH_IN,162362,Agence_moov_Cotonou,300000,137638,Théophile Mendès,2242,164604,2022-06-24
CASH_OUT,60603,Théophile Mendès,164604,104001,Agence_moov_Abomey,300000,239397,2022-06-25
CASH_IN,194866,Agence_moov_Abomey,300000,105134,Théophile Mendès,104001,298867,2022-06-26
CASH_IN,162711,Agence_moov_Cotonou,300000,137289,Théophile Mendès,298867,461578,2022-06-26
CASH_IN,192195,Agence_moov_Ouidah,300000,107805,Théophile Mendès,461578,653773,2022-06-27
CASH_IN,285429,Agence_moov_Ouidah,300000,14571,Amélie Gros-Riou,-194529,90900,2022-06-01
CASH_OUT,71158,Amélie Gros-Riou,90900,19742,Agence_moov_Ouidah,300000,228842,2022-06-03
CASH_IN,7384,Agence_moov_Ouidah,300000,292616,Amélie Gros-Riou,19742,27126,2022-06-04
TRANSFER,1409,Amélie Gros-Riou,27126,25717,Amélie Gros-Riou,27126,28535,2022-06-04
TRANSFER,12600,Amélie Gros-Riou,25717,13117,Amélie Gros-Riou,25717,13117,2022-06-05
CASH_IN,273765,Agence_moov_Ouidah,300000,26235,Amélie Gros-Riou,13117,286882,2022-06-08
CASH_OUT,142694,Amélie Gros-Riou,286882,144188,Agence_moov_Ouidah,300000,157306,2022-06-08
TRANSFER,97344,Amélie Gros-Riou,144188,46844,Amélie Gros-Riou,144188,46844,2022-06-09
TRANSFER,30684,Amélie Gros-Riou,46844,16160,Amélie Gros-Riou,46844,77528,2022-06-13
CASH_IN,142373,Agence_moov_Cotonou,300000,157627,Amélie Gros-Riou,16160,158533,2022-06-20
CASH_IN,177700,Agence_moov_Abomey,300000,122300,Amélie Gros-Riou,158533,336233,2022-06-24
CASH_IN,82850,Agence_moov_Ouidah,300000,217150,Amélie Gros-Riou,336233,419083,2022-06-27
CASH_IN,121023,Agence_moov_Abomey,300000,178977,Agnès Baron,-135734,-14711,2022-06-03
CASH_IN,217504,Agence_moov_Ouidah,300000,82496,Agnès Baron,-14711,202793,2022-06-03
TRANSFER,157415,Agnès Baron,202793,45378,Agnès Baron,202793,45378,2022-06-04
CASH_IN,240470,Agence_moov_Cotonou,300000,59530,Agnès Baron,45378,285848,2022-06-05
CASH_OUT,152416,Agnès Baron,285848,133432,Agence_moov_Ouidah,300000,147584,2022-06-07
CASH_IN,293282,Agence_moov_Abomey,300000,6718,Agnès Baron,133432,426714,2022-06-08
CASH_IN,677,Agence_moov_Ouidah,300000,299323,Agnès Baron,426714,427391,2022-06-12
CASH_IN,77097,Agence_moov_Ouidah,300000,222903,Agnès Baron,427391,504488,2022-06-19
CASH_OUT,269534,Agnès Baron,504488,234954,Agence_moov_Cotonou,300000,30466,2022-06-26
CASH_IN,48869,Agence_moov_Ouidah,300000,251131,Théodore-Alfred Fournier,-197158,-148289,2022-06-03
CASH_IN,9155,Agence_moov_Abomey,300000,290845,Théodore-Alfred Fournier,-148289,-139134,2022-06-09
CASH_IN,39657,Agence_moov_Cotonou,300000,260343,Théodore-Alfred Fournier,-139134,-99477,2022-06-11
CASH_IN,175431,Agence_moov_Ouidah,300000,124569,Théodore-Alfred Fournier,-99477,75954,2022-06-12
TRANSFER,17742,Théodore-Alfred Fournier,75954,58212,Théodore-Alfred Fournier,75954,58212,2022-06-13
TRANSFER,29215,Théodore-Alfred Fournier,58212,28997,Théodore-Alfred Fournier,58212,28997,2022-06-13
CASH_OUT,15550,Théodore-Alfred Fournier,28997,13447,Agence_moov_Cotonou,300000,284450,2022-06-15
CASH_OUT,4997,Théodore-Alfred Fournier,13447,8450,Agence_moov_Ouidah,300000,295003,2022-06-16
CASH_OUT,5967,Théodore-Alfred Fournier,8450,2483,Agence_moov_Abomey,300000,294033,2022-06-16
CASH_IN,99609,Agence_moov_Abomey,300000,200391,Théodore-Alfred Fournier,2483,102092,2022-06-19
CASH_IN,77571,Agence_moov_Abomey,300000,222429,Luc Camus,-380796,-303225,2022-06-05
CASH_IN,25225,Agence_moov_Ouidah,300000,274775,Luc Camus,-303225,-278000,2022-06-05
CASH_IN,12567,Agence_moov_Ouidah,300000,287433,Luc Camus,-278000,-265433,2022-06-06
CASH_IN,74554,Agence_moov_Cotonou,300000,225446,Luc Camus,-265433,-190879,2022-06-06
CASH_IN,8328,Agence_moov_Ouidah,300000,291672,Luc Camus,-190879,-182551,2022-06-13
CASH_IN,292512,Agence_moov_Abomey,300000,7488,Luc Camus,-182551,109961,2022-06-18
CASH_OUT,95794,Luc Camus,109961,14167,Agence_moov_Cotonou,300000,204206,2022-06-21
CASH_IN,82754,Agence_moov_Cotonou,300000,217246,Luc Camus,14167,96921,2022-06-26
CASH_IN,8339,Agence_moov_Abomey,300000,291661,Caroline Bonneau,-51745,-43406,2022-06-04
CASH_IN,7270,Agence_moov_Ouidah,300000,292730,Caroline Bonneau,-43406,-36136,2022-06-05
CASH_IN,284050,Agence_moov_Ouidah,300000,15950,Caroline Bonneau,-36136,247914,2022-06-11
CASH_IN,232511,Agence_moov_Cotonou,300000,67489,Caroline Bonneau,247914,480425,2022-06-12
CASH_OUT,151888,Caroline Bonneau,480425,328537,Agence_moov_Ouidah,300000,148112,2022-06-16
CASH_OUT,217680,Caroline Bonneau,328537,110857,Agence_moov_Cotonou,300000,82320,2022-06-16
CASH_IN,185842,Agence_moov_Ouidah,300000,114158,Caroline Bonneau,110857,296699,2022-06-16
CASH_OUT,82920,Caroline Bonneau,296699,213779,Agence_moov_Ouidah,300000,217080,2022-06-17
CASH_IN,22510,Agence_moov_Ouidah,300000,277490,Caroline Bonneau,213779,236289,2022-06-18
CASH_IN,129482,Agence_moov_Cotonou,300000,170518,Caroline Bonneau,236289,365771,2022-06-18
CASH_IN,128321,Agence_moov_Cotonou,300000,171679,Caroline Bonneau,365771,494092,2022-06-27
CASH_IN,224190,Agence_moov_Abomey,300000,75810,Maryse Lebreton,-115619,108571,2022-06-01
CASH_OUT,31283,Maryse Lebreton,108571,77288,Agence_moov_Abomey,300000,268717,2022-06-02
CASH_OUT,4226,Maryse Lebreton,77288,73062,Agence_moov_Abomey,300000,295774,2022-06-07
CASH_OUT,43718,Maryse Lebreton,73062,29344,Agence_moov_Abomey,300000,256282,2022-06-13
CASH_IN,232468,Agence_moov_Cotonou,300000,67532,Maryse Lebreton,29344,261812,2022-06-21
CASH_IN,163886,Agence_moov_Abomey,300000,136114,Maryse Lebreton,261812,425698,2022-06-22
CASH_IN,91702,Agence_moov_Abomey,300000,208298,Christophe Guilbert,-20817,70885,2022-06-01
CASH_OUT,5465,Christophe Guilbert,70885,65420,Agence_moov_Abomey,300000,294535,2022-06-01
CASH_OUT,33506,Christophe Guilbert,65420,31914,Agence_moov_Abomey,300000,266494,2022-06-02
CASH_IN,170251,Agence_moov_Ouidah,300000,129749,Christophe Guilbert,31914,202165,2022-06-09
CASH_IN,140878,Agence_moov_Cotonou,300000,159122,Christophe Guilbert,202165,343043,2022-06-09
TRANSFER,186006,Christophe Guilbert,343043,157037,Christophe Guilbert,343043,157037,2022-06-11
CASH_IN,186017,Agence_moov_Ouidah,300000,113983,Christophe Guilbert,157037,343054,2022-06-11
CASH_IN,108478,Agence_moov_Cotonou,300000,191522,Christophe Guilbert,343054,451532,2022-06-12
CASH_OUT,185855,Christophe Guilbert,451532,265677,Agence_moov_Cotonou,300000,114145,2022-06-15
CASH_OUT,225770,Christophe Guilbert,265677,39907,Agence_moov_Abomey,300000,74230,2022-06-18
TRANSFER,16221,Christophe Guilbert,39907,23686,Christophe Guilbert,39907,23686,2022-06-19
CASH_IN,94559,Agence_moov_Abomey,300000,205441,Christophe Guilbert,23686,118245,2022-06-20
CASH_IN,291989,Agence_moov_Cotonou,300000,8011,Margot Renaud de Lacombe,4,291993,2022-06-06
CASH_IN,294379,Agence_moov_Ouidah,300000,5621,Margot Renaud de Lacombe,291993,586372,2022-06-06
CASH_OUT,533570,Margot Renaud de Lacombe,586372,52802,Agence_moov_Ouidah,300000,-233570,2022-06-07
CASH_IN,143229,Agence_moov_Abomey,300000,156771,Margot Renaud de Lacombe,52802,196031,2022-06-07
CASH_OUT,192587,Margot Renaud de Lacombe,196031,3444,Agence_moov_Abomey,300000,107413,2022-06-11
CASH_OUT,1858,Margot Renaud de Lacombe,3444,1586,Agence_moov_Cotonou,300000,298142,2022-06-17
CASH_IN,118584,Agence_moov_Abomey,300000,181416,Margot Renaud de Lacombe,1586,120170,2022-06-18
CASH_OUT,33605,Margot Renaud de Lacombe,120170,86565,Agence_moov_Ouidah,300000,266395,2022-06-20
CASH_OUT,68471,Margot Renaud de Lacombe,86565,18094,Agence_moov_Cotonou,300000,231529,2022-06-20
CASH_IN,216635,Agence_moov_Ouidah,300000,83365,Margot Renaud de Lacombe,18094,234729,2022-06-27
CASH_IN,277288,Agence_moov_Abomey,300000,22712,Joséphine Weber du Bonnin,-113310,163978,2022-06-04
TRANSFER,10959,Joséphine Weber du Bonnin,163978,153019,Joséphine Weber du Bonnin,163978,174937,2022-06-06
CASH_IN,165786,Agence_moov_Abomey,300000,134214,Joséphine Weber du Bonnin,153019,318805,2022-06-06
TRANSFER,235062,Joséphine Weber du Bonnin,318805,83743,Joséphine Weber du Bonnin,318805,83743,2022-06-09
CASH_OUT,5882,Joséphine Weber du Bonnin,83743,77861,Agence_moov_Abomey,300000,294118,2022-06-10
TRANSFER,6125,Joséphine Weber du Bonnin,77861,71736,Joséphine Weber du Bonnin,77861,71736,2022-06-11
CASH_IN,42868,Agence_moov_Ouidah,300000,257132,Joséphine Weber du Bonnin,71736,114604,2022-06-15
CASH_IN,63194,Agence_moov_Ouidah,300000,236806,Joséphine Weber du Bonnin,114604,177798,2022-06-16
CASH_IN,185311,Agence_moov_Cotonou,300000,114689,Joséphine Weber du Bonnin,177798,363109,2022-06-20
CASH_IN,249647,Agence_moov_Abomey,300000,50353,Juliette Evrard Le Giraud,-213374,36273,2022-06-03
CASH_IN,69973,Agence_moov_Cotonou,300000,230027,Juliette Evrard Le Giraud,36273,106246,2022-06-04
CASH_IN,245726,Agence_moov_Abomey,300000,54274,Juliette Evrard Le Giraud,106246,351972,2022-06-04
CASH_IN,118015,Agence_moov_Cotonou,300000,181985,Juliette Evrard Le Giraud,351972,469987,2022-06-14
CASH_IN,29575,Agence_moov_Cotonou,300000,270425,Juliette Evrard Le Giraud,469987,499562,2022-06-14
CASH_IN,70400,Agence_moov_Cotonou,300000,229600,Juliette Evrard Le Giraud,499562,569962,2022-06-15
CASH_OUT,65404,Juliette Evrard Le Giraud,569962,504558,Agence_moov_Abomey,300000,234596,2022-06-23
CASH_IN,118546,Agence_moov_Cotonou,300000,181454,Juliette Evrard Le Giraud,504558,623104,2022-06-24
CASH_IN,69759,Agence_moov_Abomey,300000,230241,Amélie de la Picard,-405959,-336200,2022-06-04
CASH_IN,182596,Agence_moov_Ouidah,300000,117404,Amélie de la Picard,-336200,-153604,2022-06-04
CASH_IN,159832,Agence_moov_Cotonou,300000,140168,Amélie de la Picard,-153604,6228,2022-06-06
CASH_IN,164099,Agence_moov_Abomey,300000,135901,Amélie de la Picard,6228,170327,2022-06-11
CASH_IN,271969,Agence_moov_Cotonou,300000,28031,Amélie de la Picard,170327,442296,2022-06-12
CASH_IN,91350,Agence_moov_Cotonou,300000,208650,Amélie de la Picard,442296,533646,2022-06-13
CASH_IN,133151,Agence_moov_Cotonou,300000,166849,Amélie de la Picard,533646,666797,2022-06-14
CASH_IN,132196,Agence_moov_Cotonou,300000,167804,Amélie de la Picard,666797,798993,2022-06-26
CASH_IN,154168,Agence_moov_Cotonou,300000,145832,Marthe Guillet,-45037,109131,2022-06-01
CASH_OUT,79306,Marthe Guillet,109131,29825,Agence_moov_Cotonou,300000,220694,2022-06-01
CASH_IN,1086,Agence_moov_Ouidah,300000,298914,Marthe Guillet,29825,30911,2022-06-02
TRANSFER,759,Marthe Guillet,30911,30152,Marthe Guillet,30911,31670,2022-06-05
CASH_IN,156868,Agence_moov_Cotonou,300000,143132,Marthe Guillet,30152,187020,2022-06-10
CASH_IN,183729,Agence_moov_Ouidah,300000,116271,Marthe Guillet,187020,370749,2022-06-10
CASH_OUT,274253,Marthe Guillet,370749,96496,Agence_moov_Abomey,300000,25747,2022-06-11
CASH_IN,162921,Agence_moov_Abomey,300000,137079,Marthe Guillet,96496,259417,2022-06-11
CASH_OUT,150215,Marthe Guillet,259417,109202,Agence_moov_Cotonou,300000,149785,2022-06-13
CASH_IN,85903,Agence_moov_Cotonou,300000,214097,Marthe Guillet,109202,195105,2022-06-15
CASH_OUT,11825,Marthe Guillet,195105,183280,Agence_moov_Abomey,300000,288175,2022-06-16
CASH_OUT,89348,Marthe Guillet,183280,93932,Agence_moov_Abomey,300000,210652,2022-06-22
CASH_OUT,22429,Marthe Guillet,93932,71503,Agence_moov_Cotonou,300000,277571,2022-06-27
CASH_IN,113803,Agence_moov_Abomey,300000,186197,Joseph de la Dubois,-28518,85285,2022-06-01
TRANSFER,74117,Joseph de la Dubois,85285,11168,Joseph de la Dubois,85285,159402,2022-06-01
CASH_IN,197107,Agence_moov_Ouidah,300000,102893,Joseph de la Dubois,11168,208275,2022-06-03
TRANSFER,201851,Joseph de la Dubois,208275,6424,Joseph de la Dubois,208275,410126,2022-06-04
CASH_IN,269402,Agence_moov_Cotonou,300000,30598,Joseph de la Dubois,6424,275826,2022-06-04
TRANSFER,58816,Joseph de la Dubois,275826,217010,Joseph de la Dubois,275826,334642,2022-06-05
CASH_OUT,165026,Joseph de la Dubois,217010,51984,Agence_moov_Abomey,300000,134974,2022-06-06
CASH_OUT,24315,Joseph de la Dubois,51984,27669,Agence_moov_Ouidah,300000,275685,2022-06-10
CASH_IN,173525,Agence_moov_Abomey,300000,126475,Joseph de la Dubois,27669,201194,2022-06-11
CASH_OUT,103854,Joseph de la Dubois,201194,97340,Agence_moov_Abomey,300000,196146,2022-06-13
CASH_OUT,51942,Joseph de la Dubois,97340,45398,Agence_moov_Abomey,300000,248058,2022-06-19
CASH_IN,133849,Agence_moov_Cotonou,300000,166151,Joseph de la Dubois,45398,179247,2022-06-20
TRANSFER,130650,Joseph de la Dubois,179247,48597,Joseph de la Dubois,179247,309897,2022-06-21
CASH_IN,289787,Agence_moov_Cotonou,300000,10213,Joseph de la Dubois,48597,338384,2022-06-21
CASH_OUT,282395,Joseph de la Dubois,338384,55989,Agence_moov_Cotonou,300000,17605,2022-06-22
CASH_OUT,50621,Joseph de la Dubois,55989,5368,Agence_moov_Ouidah,300000,249379,2022-06-25
CASH_IN,24010,Agence_moov_Cotonou,300000,275990,Alphonse Dupont-Petit,-113601,-89591,2022-06-03
CASH_IN,284210,Agence_moov_Ouidah,300000,15790,Alphonse Dupont-Petit,-89591,194619,2022-06-03
TRANSFER,54315,Alphonse Dupont-Petit,194619,140304,Alphonse Dupont-Petit,194619,140304,2022-06-04
CASH_OUT,42000,Alphonse Dupont-Petit,140304,98304,Agence_moov_Abomey,300000,258000,2022-06-04
CASH_IN,109913,Agence_moov_Cotonou,300000,190087,Alphonse Dupont-Petit,98304,208217,2022-06-05
CASH_IN,134034,Agence_moov_Abomey,300000,165966,Alphonse Dupont-Petit,208217,342251,2022-06-07
CASH_IN,93222,Agence_moov_Ouidah,300000,206778,Alphonse Dupont-Petit,342251,435473,2022-06-10
CASH_OUT,206190,Alphonse Dupont-Petit,435473,229283,Agence_moov_Ouidah,300000,93810,2022-06-16
CASH_OUT,158228,Alphonse Dupont-Petit,229283,71055,Agence_moov_Ouidah,300000,141772,2022-06-17
CASH_OUT,18923,Alphonse Dupont-Petit,71055,52132,Agence_moov_Abomey,300000,281077,2022-06-20
CASH_IN,166415,Agence_moov_Abomey,300000,133585,Marine-Clémence Ferreira,-109025,57390,2022-06-01
TRANSFER,18289,Marine-Clémence Ferreira,57390,39101,Marine-Clémence Ferreira,57390,39101,2022-06-03
CASH_OUT,17893,Marine-Clémence Ferreira,39101,21208,Agence_moov_Cotonou,300000,282107,2022-06-04
TRANSFER,16379,Marine-Clémence Ferreira,21208,4829,Marine-Clémence Ferreira,21208,4829,2022-06-06
CASH_OUT,4123,Marine-Clémence Ferreira,4829,706,Agence_moov_Abomey,300000,295877,2022-06-08
CASH_OUT,486,Marine-Clémence Ferreira,706,220,Agence_moov_Abomey,300000,299514,2022-06-09
CASH_OUT,194,Marine-Clémence Ferreira,220,26,Agence_moov_Ouidah,300000,299806,2022-06-10
CASH_IN,32527,Agence_moov_Ouidah,300000,267473,Marine-Clémence Ferreira,26,32553,2022-06-13
CASH_IN,198762,Agence_moov_Ouidah,300000,101238,Marine-Clémence Ferreira,32553,231315,2022-06-13
CASH_IN,285043,Agence_moov_Cotonou,300000,14957,Marine-Clémence Ferreira,231315,516358,2022-06-15
CASH_OUT,40910,Marine-Clémence Ferreira,516358,475448,Agence_moov_Abomey,300000,259090,2022-06-18
CASH_OUT,107260,Marine-Clémence Ferreira,475448,368188,Agence_moov_Cotonou,300000,192740,2022-06-18
CASH_IN,122249,Agence_moov_Abomey,300000,177751,Marine-Clémence Ferreira,368188,490437,2022-06-21
CASH_OUT,122725,Marine-Clémence Ferreira,490437,367712,Agence_moov_Cotonou,300000,177275,2022-06-21
CASH_IN,4646,Agence_moov_Ouidah,300000,295354,Marine-Clémence Ferreira,367712,372358,2022-06-22
CASH_OUT,8077,Marine-Clémence Ferreira,372358,364281,Agence_moov_Cotonou,300000,291923,2022-06-24
CASH_OUT,193318,Marine-Clémence Ferreira,364281,170963,Agence_moov_Abomey,300000,106682,2022-06-27
CASH_IN,25575,Agence_moov_Cotonou,300000,274425,Marianne Descamps,-12368,13207,2022-06-01
TRANSFER,4662,Marianne Descamps,13207,8545,Marianne Descamps,13207,8545,2022-06-01
TRANSFER,8342,Marianne Descamps,8545,203,Marianne Descamps,8545,16887,2022-06-02
TRANSFER,146,Marianne Descamps,203,57,Marianne Descamps,203,57,2022-06-03
CASH_IN,26525,Agence_moov_Cotonou,300000,273475,Marianne Descamps,57,26582,2022-06-03
TRANSFER,26454,Marianne Descamps,26582,128,Marianne Descamps,26582,53036,2022-06-04
TRANSFER,125,Marianne Descamps,128,3,Marianne Descamps,128,3,2022-06-08
CASH_IN,285963,Agence_moov_Abomey,300000,14037,Marianne Descamps,3,285966,2022-06-11
CASH_IN,23575,Agence_moov_Abomey,300000,276425,Marianne Descamps,285966,309541,2022-06-12
CASH_OUT,259864,Marianne Descamps,309541,49677,Agence_moov_Ouidah,300000,40136,2022-06-13
CASH_OUT,34250,Marianne Descamps,49677,15427,Agence_moov_Abomey,300000,265750,2022-06-14
CASH_IN,9132,Agence_moov_Ouidah,300000,290868,Marianne Descamps,15427,24559,2022-06-17
CASH_IN,67495,Agence_moov_Abomey,300000,232505,Marianne Descamps,24559,92054,2022-06-23
CASH_IN,249088,Agence_moov_Abomey,300000,50912,Marianne Descamps,92054,341142,2022-06-26
CASH_IN,193098,Agence_moov_Cotonou,300000,106902,David Diallo,-16538,176560,2022-06-06
CASH_IN,108633,Agence_moov_Ouidah,300000,191367,David Diallo,176560,285193,2022-06-08
CASH_IN,43651,Agence_moov_Cotonou,300000,256349,David Diallo,285193,328844,2022-06-10
TRANSFER,67226,David Diallo,328844,261618,David Diallo,328844,396070,2022-06-11
CASH_IN,73111,Agence_moov_Abomey,300000,226889,David Diallo,261618,334729,2022-06-12
CASH_IN,13725,Agence_moov_Abomey,300000,286275,David Diallo,334729,348454,2022-06-13
CASH_OUT,292845,David Diallo,348454,55609,Agence_moov_Cotonou,300000,7155,2022-06-16
TRANSFER,26111,David Diallo,55609,29498,David Diallo,55609,29498,2022-06-16
CASH_IN,199904,Agence_moov_Ouidah,300000,100096,David Diallo,29498,229402,2022-06-17
CASH_IN,1680,Agence_moov_Cotonou,300000,298320,David Diallo,229402,231082,2022-06-17
CASH_OUT,167172,David Diallo,231082,63910,Agence_moov_Cotonou,300000,132828,2022-06-19
CASH_IN,59794,Agence_moov_Cotonou,300000,240206,David Diallo,63910,123704,2022-06-19
CASH_OUT,83403,David Diallo,123704,40301,Agence_moov_Ouidah,300000,216597,2022-06-22
CASH_OUT,37564,David Diallo,40301,2737,Agence_moov_Cotonou,300000,262436,2022-06-25
CASH_OUT,199,David Diallo,2737,2538,Agence_moov_Cotonou,300000,299801,2022-06-27
CASH_IN,142904,Agence_moov_Abomey,300000,157096,Emmanuel Bousquet,-399561,-256657,2022-06-01
CASH_IN,111965,Agence_moov_Abomey,300000,188035,Emmanuel Bousquet,-256657,-144692,2022-06-07
CASH_IN,13097,Agence_moov_Abomey,300000,286903,Emmanuel Bousquet,-144692,-131595,2022-06-10
CASH_IN,7082,Agence_moov_Cotonou,300000,292918,Emmanuel Bousquet,-131595,-124513,2022-06-10
CASH_IN,194369,Agence_moov_Ouidah,300000,105631,Emmanuel Bousquet,-124513,69856,2022-06-10
CASH_IN,190720,Agence_moov_Abomey,300000,109280,Emmanuel Bousquet,69856,260576,2022-06-13
CASH_IN,19665,Agence_moov_Abomey,300000,280335,Emmanuel Bousquet,260576,280241,2022-06-16
TRANSFER,158303,Emmanuel Bousquet,280241,121938,Emmanuel Bousquet,280241,438544,2022-06-17
CASH_OUT,87130,Emmanuel Bousquet,121938,34808,Agence_moov_Cotonou,300000,212870,2022-06-19
CASH_IN,295281,Agence_moov_Abomey,300000,4719,Emmanuel Bousquet,34808,330089,2022-06-20
CASH_IN,83357,Agence_moov_Ouidah,300000,216643,Emmanuel Bousquet,330089,413446,2022-06-21
CASH_OUT,365519,Emmanuel Bousquet,413446,47927,Agence_moov_Cotonou,300000,-65519,2022-06-26
CASH_IN,34441,Agence_moov_Cotonou,300000,265559,Christophe Alexandre,-799135,-764694,2022-06-08
CASH_IN,12032,Agence_moov_Ouidah,300000,287968,Christophe Alexandre,-764694,-752662,2022-06-13
CASH_IN,34034,Agence_moov_Ouidah,300000,265966,Christophe Alexandre,-752662,-718628,2022-06-18
CASH_IN,87626,Agence_moov_Ouidah,300000,212374,Christophe Alexandre,-718628,-631002,2022-06-23
CASH_IN,32817,Agence_moov_Cotonou,300000,267183,Christophe Alexandre,-631002,-598185,2022-06-24
CASH_IN,98671,Agence_moov_Cotonou,300000,201329,Christophe Alexandre,-598185,-499514,2022-06-27
CASH_IN,85945,Agence_moov_Cotonou,300000,214055,Emmanuel-René Coulon,-129853,-43908,2022-06-05
CASH_IN,78459,Agence_moov_Ouidah,300000,221541,Emmanuel-René Coulon,-43908,34551,2022-06-06
TRANSFER,7672,Emmanuel-René Coulon,34551,26879,Emmanuel-René Coulon,34551,26879,2022-06-08
CASH_IN,23313,Agence_moov_Cotonou,300000,276687,Emmanuel-René Coulon,26879,50192,2022-06-15
CASH_OUT,13798,Emmanuel-René Coulon,50192,36394,Agence_moov_Ouidah,300000,286202,2022-06-16
CASH_OUT,25771,Emmanuel-René Coulon,36394,10623,Agence_moov_Ouidah,300000,274229,2022-06-18
CASH_IN,126248,Agence_moov_Cotonou,300000,173752,Emmanuel-René Coulon,10623,136871,2022-06-19
CASH_OUT,20635,Emmanuel-René Coulon,136871,116236,Agence_moov_Ouidah,300000,279365,2022-06-22
CASH_IN,52095,Agence_moov_Ouidah,300000,247905,Gabriel de Pineau,-13436,38659,2022-06-03
CASH_IN,182881,Agence_moov_Abomey,300000,117119,Gabriel de Pineau,38659,221540,2022-06-04
TRANSFER,213167,Gabriel de Pineau,221540,8373,Gabriel de Pineau,221540,8373,2022-06-09
CASH_IN,231358,Agence_moov_Abomey,300000,68642,Gabriel de Pineau,8373,239731,2022-06-12
CASH_IN,27548,Agence_moov_Abomey,300000,272452,Gabriel de Pineau,239731,267279,2022-06-13
CASH_IN,172191,Agence_moov_Abomey,300000,127809,Gabriel de Pineau,267279,439470,2022-06-17
CASH_OUT,200394,Gabriel de Pineau,439470,239076,Agence_moov_Cotonou,300000,99606,2022-06-19
CASH_OUT,170357,Gabriel de Pineau,239076,68719,Agence_moov_Ouidah,300000,129643,2022-06-22
CASH_IN,293202,Agence_moov_Ouidah,300000,6798,Gabriel de Pineau,68719,361921,2022-06-23
CASH_IN,244680,Agence_moov_Cotonou,300000,55320,Gabriel de Pineau,361921,606601,2022-06-23
CASH_IN,54154,Agence_moov_Cotonou,300000,245846,Gabriel de Pineau,606601,660755,2022-06-26
CASH_OUT,328313,Gabriel de Pineau,660755,332442,Agence_moov_Abomey,300000,-28313,2022-06-26
CASH_IN,189248,Agence_moov_Abomey,300000,110752,Gabriel de Pineau,332442,521690,2022-06-27
CASH_IN,231820,Agence_moov_Abomey,300000,68180,Vincent-Philippe Rossi,-84134,147686,2022-06-01
CASH_IN,222406,Agence_moov_Cotonou,300000,77594,Vincent-Philippe Rossi,147686,370092,2022-06-02
TRANSFER,249015,Vincent-Philippe Rossi,370092,121077,Vincent-Philippe Rossi,370092,121077,2022-06-02
TRANSFER,45200,Vincent-Philippe Rossi,121077,75877,Vincent-Philippe Rossi,121077,166277,2022-06-02
CASH_OUT,42972,Vincent-Philippe Rossi,75877,32905,Agence_moov_Abomey,300000,257028,2022-06-04
CASH_OUT,32696,Vincent-Philippe Rossi,32905,209,Agence_moov_Ouidah,300000,267304,2022-06-05
CASH_OUT,184,Vincent-Philippe Rossi,209,25,Agence_moov_Cotonou,300000,299816,2022-06-05
CASH_IN,21383,Agence_moov_Abomey,300000,278617,Vincent-Philippe Rossi,25,21408,2022-06-07
CASH_OUT,6719,Vincent-Philippe Rossi,21408,14689,Agence_moov_Abomey,300000,293281,2022-06-08
CASH_OUT,6779,Vincent-Philippe Rossi,14689,7910,Agence_moov_Ouidah,300000,293221,2022-06-13
CASH_IN,121060,Agence_moov_Ouidah,300000,178940,Vincent-Philippe Rossi,7910,128970,2022-06-14
TRANSFER,5985,Vincent-Philippe Rossi,128970,122985,Vincent-Philippe Rossi,128970,122985,2022-06-15
CASH_OUT,96516,Vincent-Philippe Rossi,122985,26469,Agence_moov_Ouidah,300000,203484,2022-06-16
CASH_IN,177145,Agence_moov_Cotonou,300000,122855,Vincent-Philippe Rossi,26469,203614,2022-06-18
CASH_OUT,70624,Vincent-Philippe Rossi,203614,132990,Agence_moov_Ouidah,300000,229376,2022-06-23
CASH_OUT,64112,Vincent-Philippe Rossi,132990,68878,Agence_moov_Abomey,300000,235888,2022-06-27
CASH_IN,177951,Agence_moov_Abomey,300000,122049,Sabine Imbert,-34774,143177,2022-06-03
TRANSFER,127379,Sabine Imbert,143177,15798,Sabine Imbert,143177,270556,2022-06-04
TRANSFER,13555,Sabine Imbert,15798,2243,Sabine Imbert,15798,29353,2022-06-13
CASH_IN,43499,Agence_moov_Ouidah,300000,256501,Sabine Imbert,2243,45742,2022-06-13
CASH_OUT,13096,Sabine Imbert,45742,32646,Agence_moov_Abomey,300000,286904,2022-06-20
CASH_IN,265540,Agence_moov_Ouidah,300000,34460,Sébastien Jourdan,-51362,214178,2022-06-01
CASH_OUT,136399,Sébastien Jourdan,214178,77779,Agence_moov_Ouidah,300000,163601,2022-06-13
CASH_OUT,7274,Sébastien Jourdan,77779,70505,Agence_moov_Cotonou,300000,292726,2022-06-17
CASH_IN,7453,Agence_moov_Cotonou,300000,292547,Sébastien Jourdan,70505,77958,2022-06-17
CASH_IN,271621,Agence_moov_Ouidah,300000,28379,Sébastien Jourdan,77958,349579,2022-06-17
CASH_OUT,133610,Sébastien Jourdan,349579,215969,Agence_moov_Abomey,300000,166390,2022-06-21
CASH_IN,143694,Agence_moov_Ouidah,300000,156306,Sébastien Jourdan,215969,359663,2022-06-24
CASH_IN,229515,Agence_moov_Ouidah,300000,70485,Adrienne Arnaud,749400,978915,2022-07-20
TRANSFER,210880,Adrienne Arnaud,978915,768035,Maryse Reynaud-Michaud,640200,429320,2022-07-22
CASH_OUT,623784,Adrienne Arnaud,768035,144251,Agence_moov_Ouidah,300000,-323784,2022-07-23
CASH_IN,175866,Agence_moov_Ouidah,300000,124134,Emmanuelle Gilbert,336600,512466,2022-07-15
TRANSFER,759059,Léon Paris,1600900,841841,Emmanuelle Gilbert,512466,1271525,2022-07-18
CASH_OUT,1030110,Emmanuelle Gilbert,1271525,241415,Agence_moov_Abomey,300000,-730110,2022-07-21
TRANSFER,191456,David Diallo,868000,676544,Caroline Peltier,916600,725144,2022-07-14
CASH_OUT,258614,David Diallo,676544,417930,Agence_moov_Ouidah,300000,41386,2022-07-16
TRANSFER,82492,Matthieu Carpentier,681900,599408,David Diallo,417930,500422,2022-07-25
TRANSFER,299227,David Diallo,500422,201195,Caroline Peltier,725144,425917,2022-07-27
CASH_OUT,16197,David Diallo,201195,184998,Agence_moov_Cotonou,300000,283803,2022-07-27
CASH_OUT,1357649,Caroline Bonneau,1849900,492251,Agence_moov_Ouidah,300000,-1057649,2022-07-01
CASH_IN,85579,Agence_moov_Abomey,300000,214421,Caroline Bonneau,492251,577830,2022-07-15
TRANSFER,338429,Caroline Bonneau,577830,239401,Valentine Traore,1989300,1650871,2022-07-18
TRANSFER,389191,Marc Gilbert,1032000,642809,Juliette Evrard Le Giraud,659400,1048591,2022-07-01
CASH_IN,220490,Agence_moov_Ouidah,300000,79510,Juliette Evrard Le Giraud,1048591,1269081,2022-07-02
CASH_IN,93068,Agence_moov_Ouidah,300000,206932,Juliette Evrard Le Giraud,1269081,1362149,2022-07-19
CASH_OUT,427722,Juliette Evrard Le Giraud,1362149,934427,Agence_moov_Abomey,300000,-127722,2022-07-24
CASH_OUT,807919,Juliette Evrard Le Giraud,934427,126508,Agence_moov_Ouidah,300000,-507919,2022-07-26
TRANSFER,376007,Susan de Fontaine,502600,126593,Guy Guyon,905700,529693,2022-07-04
CASH_IN,171010,Agence_moov_Abomey,300000,128990,Susan de Fontaine,126593,297603,2022-07-26
CASH_OUT,463368,Marthe Guillet,792400,329032,Agence_moov_Ouidah,300000,-163368,2022-07-03
CASH_OUT,220126,Marthe Guillet,329032,108906,Agence_moov_Ouidah,300000,79874,2022-07-04
TRANSFER,38103,Marthe Guillet,108906,70803,David-Théodore Diaz,927100,888997,2022-07-12
CASH_IN,103592,Agence_moov_Cotonou,300000,196408,Marthe Guillet,70803,174395,2022-07-19
CASH_OUT,176198,Maryse Reynaud-Michaud,429320,253122,Agence_moov_Ouidah,300000,123802,2022-07-08
CASH_IN,133304,Agence_moov_Abomey,300000,166696,Maryse Reynaud-Michaud,253122,386426,2022-07-10
CASH_OUT,67819,Maryse Reynaud-Michaud,386426,318607,Agence_moov_Abomey,300000,232181,2022-07-14
CASH_IN,220060,Agence_moov_Abomey,300000,79940,Maryse Reynaud-Michaud,318607,538667,2022-07-16
TRANSFER,32750,Maryse Reynaud-Michaud,538667,505917,Paul Pereira,1627900,1595150,2022-07-26
CASH_OUT,794915,Jacques-Antoine Gros,975400,180485,Agence_moov_Abomey,300000,-494915,2022-07-05
CASH_IN,206418,Agence_moov_Ouidah,300000,93582,Jacques-Antoine Gros,180485,386903,2022-07-08
CASH_IN,254928,Agence_moov_Cotonou,300000,45072,Jacques-Antoine Gros,386903,641831,2022-07-09
TRANSFER,75907,Adélaïde-Sophie Leclercq,146000,70093,Théophile Mendès,1486400,1410493,2022-07-13
CASH_IN,116395,Agence_moov_Ouidah,300000,183605,Michèle Vallée,168000,284395,2022-07-01
CASH_IN,39476,Agence_moov_Abomey,300000,260524,Michèle Vallée,284395,323871,2022-07-02
CASH_IN,206859,Agence_moov_Cotonou,300000,93141,Michèle Vallée,323871,530730,2022-07-06
CASH_OUT,240851,Michèle Vallée,530730,289879,Agence_moov_Cotonou,300000,59149,2022-07-08
CASH_OUT,192166,Alphonse Dupont-Petit,1910100,1717934,Agence_moov_Cotonou,300000,107834,2022-07-17
CASH_OUT,1458346,Alphonse Dupont-Petit,1717934,259588,Agence_moov_Cotonou,300000,-1158346,2022-07-20
CASH_OUT,540991,Luc Camus,1761700,1220709,Agence_moov_Ouidah,300000,-240991,2022-07-20
CASH_IN,224317,Agence_moov_Abomey,300000,75683,Christophe Alexandre,372200,596517,2022-07-14
CASH_OUT,504101,Christophe Alexandre,596517,92416,Agence_moov_Abomey,300000,-204101,2022-07-22
TRANSFER,78877,Christophe Alexandre,92416,13539,Alexandre Poirier,1123800,1044923,2022-07-23
TRANSFER,1829332,Sébastien-Arthur Masse,1882200,52868,Arnaude Gaillard,600700,2430032,2022-07-07
CASH_OUT,661884,Arnaude Gaillard,2430032,1768148,Agence_moov_Ouidah,300000,-361884,2022-07-13
CASH_OUT,488079,Arnaude Gaillard,1768148,1280069,Agence_moov_Abomey,300000,-188079,2022-07-18
CASH_IN,8575,Agence_moov_Cotonou,300000,291425,Arnaude Gaillard,1280069,1288644,2022-07-20
CASH_IN,257285,Agence_moov_Cotonou,300000,42715,Arnaude Gaillard,1288644,1545929,2022-07-24
CASH_OUT,272518,Roland Colin,580000,307482,Agence_moov_Ouidah,300000,27482,2022-07-03
CASH_OUT,5102,Roland Colin,307482,302380,Agence_moov_Ouidah,300000,294898,2022-07-05
CASH_IN,288342,Agence_moov_Abomey,300000,11658,Roland Colin,302380,590722,2022-07-10
TRANSFER,5585,Isaac Le Pinto,1341000,1335415,Caroline Monnier,1326300,1331885,2022-07-08
TRANSFER,1644037,Antoine Bourdon de Auger,1783800,139763,Caroline Monnier,1331885,2975922,2022-07-22
CASH_OUT,115353,Caroline Peltier,425917,310564,Agence_moov_Cotonou,300000,184647,2022-07-01
CASH_IN,183746,Agence_moov_Abomey,300000,116254,Caroline Peltier,310564,494310,2022-07-03
TRANSFER,208414,Caroline Peltier,494310,285896,Agnès Baron,89200,-119214,2022-07-05
TRANSFER,1268256,Nicolas Grondin de la Pinto,1893800,625544,Caroline Peltier,285896,1554152,2022-07-10
TRANSFER,893941,Hugues Gay,1262100,368159,Caroline Peltier,1554152,2448093,2022-07-14
CASH_IN,57950,Agence_moov_Ouidah,300000,242050,Hugues Gay,368159,426109,2022-07-08
CASH_OUT,15114,Hugues Gay,426109,410995,Agence_moov_Ouidah,300000,284886,2022-07-13
CASH_OUT,108413,Hugues Gay,410995,302582,Agence_moov_Cotonou,300000,191587,2022-07-22
CASH_OUT,215846,Hugues Gay,302582,86736,Agence_moov_Abomey,300000,84154,2022-07-27
TRANSFER,134527,Antoine Bourdon de Auger,139763,5236,David-Théodore Diaz,888997,754470,2022-07-10
CASH_IN,239832,Agence_moov_Abomey,300000,60168,Antoine Bourdon de Auger,5236,245068,2022-07-19
CASH_IN,128033,Agence_moov_Abomey,300000,171967,Antoine Bourdon de Auger,245068,373101,2022-07-19
CASH_OUT,901837,Julie Robin de Gros,1258200,356363,Agence_moov_Cotonou,300000,-601837,2022-07-13
CASH_OUT,50384,Julie Robin de Gros,356363,305979,Agence_moov_Abomey,300000,249616,2022-07-16
CASH_IN,80589,Agence_moov_Ouidah,300000,219411,Julie Robin de Gros,305979,386568,2022-07-18
TRANSFER,340898,Laurence Dumont de Laroche,758200,417302,Julie Robin de Gros,386568,727466,2022-07-19
CASH_OUT,95824,Christine-Constance Gauthier,104600,8776,Agence_moov_Abomey,300000,204176,2022-07-01
CASH_OUT,390,Christine-Constance Gauthier,8776,8386,Agence_moov_Ouidah,300000,299610,2022-07-10
CASH_IN,44217,Agence_moov_Ouidah,300000,255783,Christine-Constance Gauthier,8386,52603,2022-07-11
CASH_OUT,50024,Christine-Constance Gauthier,52603,2579,Agence_moov_Cotonou,300000,249976,2022-07-20
TRANSFER,2482,Christine-Constance Gauthier,2579,97,Constance Regnier,783000,780518,2022-07-23
CASH_IN,11360,Agence_moov_Abomey,300000,288640,Élodie Gérard,1754600,1765960,2022-07-04
CASH_IN,235232,Agence_moov_Cotonou,300000,64768,Élodie Gérard,1765960,2001192,2022-07-07
TRANSFER,1787346,Élodie Gérard,2001192,213846,Valentine Traore,1650871,-136475,2022-07-13
CASH_OUT,316845,Nicolas Hervé,339400,22555,Agence_moov_Abomey,300000,-16845,2022-07-04
TRANSFER,11402,Nicolas Hervé,22555,11153,Guy Guyon,529693,518291,2022-07-07
CASH_OUT,2980,Nicolas Hervé,11153,8173,Agence_moov_Abomey,300000,297020,2022-07-10
CASH_OUT,5624,Nicolas Hervé,8173,2549,Agence_moov_Abomey,300000,294376,2022-07-16
CASH_IN,141373,Agence_moov_Abomey,300000,158627,Nicolas Hervé,2549,143922,2022-07-26
CASH_OUT,866553,Noémi de la Didier,1678000,811447,Agence_moov_Cotonou,300000,-566553,2022-07-15
CASH_OUT,551656,Noémi de la Didier,811447,259791,Agence_moov_Ouidah,300000,-251656,2022-07-16
TRANSFER,1228008,Anastasie Louis,1701700,473692,Paul Pereira,1595150,367142,2022-07-08
CASH_OUT,315899,Anastasie Louis,473692,157793,Agence_moov_Cotonou,300000,-15899,2022-07-11
CASH_IN,277878,Agence_moov_Abomey,300000,22122,Anastasie Louis,157793,435671,2022-07-17
CASH_IN,24751,Agence_moov_Abomey,300000,275249,Anastasie Louis,435671,460422,2022-07-24
CASH_OUT,68531,Paul Pereira,367142,298611,Agence_moov_Cotonou,300000,231469,2022-07-05
CASH_IN,156734,Agence_moov_Cotonou,300000,143266,Paul Pereira,298611,455345,2022-07-21
CASH_IN,89760,Agence_moov_Cotonou,300000,210240,Paul Pereira,455345,545105,2022-07-27
CASH_OUT,183908,Constance Regnier,780518,596610,Agence_moov_Ouidah,300000,116092,2022-07-01
CASH_IN,156852,Agence_moov_Ouidah,300000,143148,Constance Regnier,596610,753462,2022-07-02
CASH_IN,112728,Agence_moov_Cotonou,300000,187272,Constance Regnier,753462,866190,2022-07-02
CASH_IN,111275,Agence_moov_Abomey,300000,188725,Constance Regnier,866190,977465,2022-07-03
CASH_IN,100998,Agence_moov_Cotonou,300000,199002,Constance Regnier,977465,1078463,2022-07-04
CASH_OUT,295226,Constance Regnier,1078463,783237,Agence_moov_Ouidah,300000,4774,2022-07-04
TRANSFER,379439,Constance Regnier,783237,403798,Paulette Dias,1329000,949561,2022-07-05
TRANSFER,1170457,Émile Hebert,1812500,642043,Constance Regnier,403798,1574255,2022-07-05
CASH_OUT,1171869,Constance Regnier,1574255,402386,Agence_moov_Abomey,300000,-871869,2022-07-09
TRANSFER,23662,Sébastien-Arthur Masse,52868,29206,Constance Regnier,402386,426048,2022-07-09
CASH_OUT,154371,Constance Regnier,426048,271677,Agence_moov_Abomey,300000,145629,2022-07-10
CASH_IN,276808,Agence_moov_Cotonou,300000,23192,Constance Regnier,271677,548485,2022-07-12
CASH_OUT,543434,Constance Regnier,548485,5051,Agence_moov_Cotonou,300000,-243434,2022-07-14
CASH_IN,267773,Agence_moov_Cotonou,300000,32227,Constance Regnier,5051,272824,2022-07-14
TRANSFER,183803,Nath Léger,439000,255197,Constance Regnier,272824,456627,2022-07-14
TRANSFER,441475,Constance Regnier,456627,15152,Alex Salmon,64500,-376975,2022-07-15
CASH_OUT,9956,Constance Regnier,15152,5196,Agence_moov_Cotonou,300000,290044,2022-07-16
CASH_IN,43913,Agence_moov_Cotonou,300000,256087,Constance Regnier,5196,49109,2022-07-16
TRANSFER,1387494,Théodore Bertin,1921700,534206,Constance Regnier,49109,1436603,2022-07-20
CASH_IN,143934,Agence_moov_Ouidah,300000,156066,Constance Regnier,1436603,1580537,2022-07-23
CASH_OUT,302140,Constance Regnier,1580537,1278397,Agence_moov_Cotonou,300000,-2140,2022-07-24
CASH_IN,292834,Agence_moov_Ouidah,300000,7166,Constance Regnier,1278397,1571231,2022-07-25
CASH_IN,167601,Agence_moov_Ouidah,300000,132399,Constance Regnier,1571231,1738832,2022-07-26
CASH_OUT,969911,Constance Regnier,1738832,768921,Agence_moov_Ouidah,300000,-669911,2022-07-26
CASH_IN,226769,Agence_moov_Ouidah,300000,73231,Sébastien Jourdan,278600,505369,2022-07-01
CASH_IN,11420,Agence_moov_Ouidah,300000,288580,Sébastien Jourdan,505369,516789,2022-07-02
CASH_OUT,491349,Sébastien Jourdan,516789,25440,Agence_moov_Ouidah,300000,-191349,2022-07-03
CASH_IN,57954,Agence_moov_Abomey,300000,242046,Sébastien Jourdan,25440,83394,2022-07-04
CASH_OUT,77720,Sébastien Jourdan,83394,5674,Agence_moov_Cotonou,300000,222280,2022-07-04
CASH_IN,227656,Agence_moov_Cotonou,300000,72344,Sébastien Jourdan,5674,233330,2022-07-06
CASH_IN,175275,Agence_moov_Cotonou,300000,124725,Sébastien Jourdan,233330,408605,2022-07-07
CASH_OUT,57298,Sébastien Jourdan,408605,351307,Agence_moov_Abomey,300000,242702,2022-07-07
CASH_IN,68754,Agence_moov_Abomey,300000,231246,Sébastien Jourdan,351307,420061,2022-07-08
CASH_OUT,385316,Sébastien Jourdan,420061,34745,Agence_moov_Abomey,300000,-85316,2022-07-09
CASH_OUT,4126,Sébastien Jourdan,34745,30619,Agence_moov_Abomey,300000,295874,2022-07-10
CASH_IN,132442,Agence_moov_Abomey,300000,167558,Sébastien Jourdan,30619,163061,2022-07-10
CASH_OUT,107816,Sébastien Jourdan,163061,55245,Agence_moov_Ouidah,300000,192184,2022-07-11
TRANSFER,9371,Sébastien Jourdan,55245,45874,Théophile Mendès,1410493,1401122,2022-07-12
CASH_OUT,29385,Sébastien Jourdan,45874,16489,Agence_moov_Cotonou,300000,270615,2022-07-13
CASH_OUT,5201,Sébastien Jourdan,16489,11288,Agence_moov_Ouidah,300000,294799,2022-07-14
TRANSFER,861397,Matthieu Renard,938000,76603,Sébastien Jourdan,11288,872685,2022-07-14
TRANSFER,41331,Sébastien Jourdan,872685,831354,Paul De Sousa,1186500,1145169,2022-07-14
CASH_IN,75559,Agence_moov_Cotonou,300000,224441,Sébastien Jourdan,831354,906913,2022-07-15
TRANSFER,62398,Amélie Gros-Riou,149700,87302,Sébastien Jourdan,906913,969311,2022-07-16
CASH_OUT,310414,Sébastien Jourdan,969311,658897,Agence_moov_Ouidah,300000,-10414,2022-07-16
TRANSFER,123412,Sébastien Jourdan,658897,535485,Diane-Françoise Raynaud,861700,738288,2022-07-20
CASH_IN,22335,Agence_moov_Ouidah,300000,277665,Sébastien Jourdan,535485,557820,2022-07-22
CASH_OUT,115399,Sébastien Jourdan,557820,442421,Agence_moov_Ouidah,300000,184601,2022-07-22
CASH_IN,65238,Agence_moov_Abomey,300000,234762,Sébastien Jourdan,442421,507659,2022-07-23
TRANSFER,424398,Sébastien Jourdan,507659,83261,David-Théodore Diaz,754470,330072,2022-07-23
CASH_IN,269172,Agence_moov_Cotonou,300000,30828,Sébastien Jourdan,83261,352433,2022-07-24
CASH_IN,202937,Agence_moov_Abomey,300000,97063,Sébastien Jourdan,352433,555370,2022-07-25
CASH_OUT,448234,Sébastien Jourdan,555370,107136,Agence_moov_Ouidah,300000,-148234,2022-07-26
TRANSFER,4612,Emmanuel Bousquet,35200,30588,Sébastien Jourdan,107136,111748,2022-07-27
CASH_IN,231915,Agence_moov_Ouidah,300000,68085,Sébastien-Arthur Masse,29206,261121,2022-07-01
CASH_IN,40550,Agence_moov_Abomey,300000,259450,Sébastien-Arthur Masse,261121,301671,2022-07-02
TRANSFER,1501867,Noël Hamel,1580800,78933,Sébastien-Arthur Masse,301671,1803538,2022-07-03
TRANSFER,39649,Sébastien-Arthur Masse,1803538,1763889,Augustin Benard,1729600,1689951,2022-07-04
CASH_OUT,467870,Sébastien-Arthur Masse,1763889,1296019,Agence_moov_Cotonou,300000,-167870,2022-07-05
CASH_IN,132996,Agence_moov_Ouidah,300000,167004,Sébastien-Arthur Masse,1296019,1429015,2022-07-05
TRANSFER,477038,Théodore Bertin,534206,57168,Sébastien-Arthur Masse,1429015,1906053,2022-07-06
CASH_IN,184006,Agence_moov_Cotonou,300000,115994,Sébastien-Arthur Masse,1906053,2090059,2022-07-07
CASH_OUT,588268,Sébastien-Arthur Masse,2090059,1501791,Agence_moov_Cotonou,300000,-288268,2022-07-08
TRANSFER,231305,Joséphine Weber du Bonnin,498000,266695,Sébastien-Arthur Masse,1501791,1733096,2022-07-08
CASH_IN,210316,Agence_moov_Cotonou,300000,89684,Sébastien-Arthur Masse,1733096,1943412,2022-07-08
CASH_IN,44665,Agence_moov_Cotonou,300000,255335,Sébastien-Arthur Masse,1943412,1988077,2022-07-08
CASH_OUT,1905476,Sébastien-Arthur Masse,1988077,82601,Agence_moov_Cotonou,300000,-1605476,2022-07-10
CASH_IN,79541,Agence_moov_Cotonou,300000,220459,Sébastien-Arthur Masse,82601,162142,2022-07-12
TRANSFER,318236,Guy Guyon,518291,200055,Sébastien-Arthur Masse,162142,480378,2022-07-14
TRANSFER,295707,Sébastien-Arthur Masse,480378,184671,Lucy Vaillant,173700,-122007,2022-07-16
CASH_IN,219480,Agence_moov_Cotonou,300000,80520,Sébastien-Arthur Masse,184671,404151,2022-07-17
CASH_IN,263529,Agence_moov_Cotonou,300000,36471,Sébastien-Arthur Masse,404151,667680,2022-07-18
CASH_IN,170914,Agence_moov_Abomey,300000,129086,Sébastien-Arthur Masse,667680,838594,2022-07-18
TRANSFER,304522,Sébastien-Arthur Masse,838594,534072,Auguste Bousquet,674600,370078,2022-07-18
CASH_IN,199946,Agence_moov_Ouidah,300000,100054,Sébastien-Arthur Masse,534072,734018,2022-07-19
TRANSFER,851007,Émilie Guillon de Duhamel,1644700,793693,Sébastien-Arthur Masse,734018,1585025,2022-07-20
CASH_IN,266124,Agence_moov_Cotonou,300000,33876,Sébastien-Arthur Masse,1585025,1851149,2022-07-25
CASH_IN,222834,Agence_moov_Ouidah,300000,77166,Sébastien-Arthur Masse,1851149,2073983,2022-07-26
CASH_IN,69271,Agence_moov_Cotonou,300000,230729,Sébastien-Arthur Masse,2073983,2143254,2022-07-26
CASH_OUT,1410073,Sébastien-Arthur Masse,2143254,733181,Agence_moov_Ouidah,300000,-1110073,2022-07-26
TRANSFER,14914,Margot Renaud de Lacombe,19000,4086,Sébastien-Arthur Masse,733181,748095,2022-07-27
CASH_OUT,597337,Sébastien-Arthur Masse,748095,150758,Agence_moov_Abomey,300000,-297337,2022-07-27
CASH_OUT,114648,Sébastien-Arthur Masse,150758,36110,Agence_moov_Cotonou,300000,185352,2022-07-27
CASH_OUT,667677,Paul De Sousa,1145169,477492,Agence_moov_Abomey,300000,-367677,2022-07-01
CASH_IN,171266,Agence_moov_Cotonou,300000,128734,Paul De Sousa,477492,648758,2022-07-06
CASH_IN,194554,Agence_moov_Abomey,300000,105446,Paul De Sousa,648758,843312,2022-07-10
TRANSFER,1285019,Richard Guibert,1320600,35581,Paul De Sousa,843312,2128331,2022-07-10
CASH_OUT,831716,Paul De Sousa,2128331,1296615,Agence_moov_Ouidah,300000,-531716,2022-07-10
CASH_IN,266769,Agence_moov_Cotonou,300000,33231,Paul De Sousa,1296615,1563384,2022-07-11
CASH_IN,167324,Agence_moov_Abomey,300000,132676,Paul De Sousa,1563384,1730708,2022-07-13
TRANSFER,907122,Paul De Sousa,1730708,823586,Amélie Gros-Riou,87302,-819820,2022-07-14
CASH_IN,122110,Agence_moov_Ouidah,300000,177890,Paul De Sousa,823586,945696,2022-07-17
TRANSFER,977826,Isaac Le Pinto,1335415,357589,Paul De Sousa,945696,1923522,2022-07-17
TRANSFER,952905,Thierry Dos Santos-Le Roux,1198000,245095,Paul De Sousa,1923522,2876427,2022-07-18
CASH_IN,10165,Agence_moov_Cotonou,300000,289835,Paul De Sousa,2876427,2886592,2022-07-18
TRANSFER,2778794,Paul De Sousa,2886592,107798,Laurence Carlier,342100,-2436694,2022-07-19
CASH_IN,205741,Agence_moov_Abomey,300000,94259,Paul De Sousa,107798,313539,2022-07-21
CASH_IN,141914,Agence_moov_Abomey,300000,158086,Paul De Sousa,313539,455453,2022-07-22
CASH_OUT,192981,Paul De Sousa,455453,262472,Agence_moov_Abomey,300000,107019,2022-07-23
CASH_IN,217681,Agence_moov_Ouidah,300000,82319,Paul De Sousa,262472,480153,2022-07-24
TRANSFER,63180,Paul De Sousa,480153,416973,Gabriel de Pineau,21800,-41380,2022-07-25
TRANSFER,49976,Marthe Pichon,1993900,1943924,Paul De Sousa,416973,466949,2022-07-25
CASH_IN,83982,Agence_moov_Ouidah,300000,216018,Paul De Sousa,466949,550931,2022-07-26
TRANSFER,110770,Paul De Sousa,550931,440161,Laurence Dumont de Laroche,417302,306532,2022-07-26
CASH_IN,20589,Agence_moov_Abomey,300000,279411,Paul De Sousa,440161,460750,2022-07-26
CASH_IN,67726,Agence_moov_Ouidah,300000,232274,Paul De Sousa,460750,528476,2022-07-27
CASH_IN,77609,Agence_moov_Abomey,300000,222391,Paul De Sousa,528476,606085,2022-07-27
TRANSFER,308377,Émilie Guillon de Duhamel,793693,485316,Christophe Guilbert,1291000,982623,2022-07-03
CASH_OUT,227662,Émilie Guillon de Duhamel,485316,257654,Agence_moov_Cotonou,300000,72338,2022-07-04
CASH_OUT,7296,Émilie Guillon de Duhamel,257654,250358,Agence_moov_Abomey,300000,292704,2022-07-05
CASH_OUT,62878,Émilie Guillon de Duhamel,250358,187480,Agence_moov_Abomey,300000,237122,2022-07-06
CASH_OUT,100439,Émilie Guillon de Duhamel,187480,87041,Agence_moov_Cotonou,300000,199561,2022-07-06
TRANSFER,5154,Émilie Guillon de Duhamel,87041,81887,Augustin Benard,1689951,1684797,2022-07-07
CASH_IN,90032,Agence_moov_Abomey,300000,209968,Émilie Guillon de Duhamel,81887,171919,2022-07-07
TRANSFER,592049,Matthieu Carpentier,599408,7359,Émilie Guillon de Duhamel,171919,763968,2022-07-07
TRANSFER,43463,Joséphine Weber du Bonnin,266695,223232,Émilie Guillon de Duhamel,763968,807431,2022-07-09
CASH_IN,41160,Agence_moov_Abomey,300000,258840,Émilie Guillon de Duhamel,807431,848591,2022-07-10
CASH_OUT,540565,Émilie Guillon de Duhamel,848591,308026,Agence_moov_Ouidah,300000,-240565,2022-07-11
CASH_OUT,96061,Émilie Guillon de Duhamel,308026,211965,Agence_moov_Cotonou,300000,203939,2022-07-13
CASH_OUT,111932,Émilie Guillon de Duhamel,211965,100033,Agence_moov_Ouidah,300000,188068,2022-07-14
CASH_IN,187188,Agence_moov_Abomey,300000,112812,Émilie Guillon de Duhamel,100033,287221,2022-07-15
CASH_IN,68703,Agence_moov_Ouidah,300000,231297,Émilie Guillon de Duhamel,287221,355924,2022-07-16
TRANSFER,5350,Emmanuel Bousquet,30588,25238,Émilie Guillon de Duhamel,355924,361274,2022-07-16
TRANSFER,32483,Émilie Guillon de Duhamel,361274,328791,Matthieu Carpentier,7359,-25124,2022-07-18
CASH_IN,79833,Agence_moov_Abomey,300000,220167,Émilie Guillon de Duhamel,328791,408624,2022-07-18
CASH_IN,115861,Agence_moov_Abomey,300000,184139,Émilie Guillon de Duhamel,408624,524485,2022-07-23
TRANSFER,179523,Émilie Guillon de Duhamel,524485,344962,Maurice Alves,1634600,1455077,2022-07-26
CASH_OUT,115492,Émilie Guillon de Duhamel,344962,229470,Agence_moov_Abomey,300000,184508,2022-07-26
TRANSFER,1975,Émilie Guillon de Duhamel,229470,227495,Luc-Tristan Moreau,1200400,1198425,2022-07-26
TRANSFER,71397,Émilie Guillon de Duhamel,227495,156098,Laurent Perrot,13500,-57897,2022-07-27
CASH_IN,192417,Agence_moov_Ouidah,300000,107583,Émilie Guillon de Duhamel,156098,348515,2022-07-27
CASH_IN,112097,Agence_moov_Ouidah,300000,187903,Émilie Guillon de Duhamel,348515,460612,2022-07-27
CASH_OUT,1246068,Grégoire Delmas de Blanchard,1387000,140932,Agence_moov_Cotonou,300000,-946068,2022-07-04
CASH_IN,92113,Agence_moov_Ouidah,300000,207887,Grégoire Delmas de Blanchard,140932,233045,2022-07-04
CASH_OUT,114735,Grégoire Delmas de Blanchard,233045,118310,Agence_moov_Abomey,300000,185265,2022-07-04
CASH_IN,242246,Agence_moov_Ouidah,300000,57754,Grégoire Delmas de Blanchard,118310,360556,2022-07-04
CASH_IN,285691,Agence_moov_Abomey,300000,14309,Grégoire Delmas de Blanchard,360556,646247,2022-07-05
CASH_OUT,586609,Grégoire Delmas de Blanchard,646247,59638,Agence_moov_Cotonou,300000,-286609,2022-07-05
CASH_IN,143041,Agence_moov_Ouidah,300000,156959,Grégoire Delmas de Blanchard,59638,202679,2022-07-06
TRANSFER,24649,Grégoire Delmas de Blanchard,202679,178030,Matthieu Renard,76603,51954,2022-07-06
CASH_OUT,124462,Grégoire Delmas de Blanchard,178030,53568,Agence_moov_Abomey,300000,175538,2022-07-07
CASH_OUT,37462,Grégoire Delmas de Blanchard,53568,16106,Agence_moov_Cotonou,300000,262538,2022-07-07
CASH_IN,35303,Agence_moov_Cotonou,300000,264697,Grégoire Delmas de Blanchard,16106,51409,2022-07-07
CASH_OUT,18129,Grégoire Delmas de Blanchard,51409,33280,Agence_moov_Cotonou,300000,281871,2022-07-08
CASH_IN,253897,Agence_moov_Cotonou,300000,46103,Grégoire Delmas de Blanchard,33280,287177,2022-07-10
CASH_IN,74403,Agence_moov_Ouidah,300000,225597,Grégoire Delmas de Blanchard,287177,361580,2022-07-11
TRANSFER,132002,Antoine Leroux,186300,54298,Grégoire Delmas de Blanchard,361580,493582,2022-07-12
TRANSFER,62971,Agnès Chrétien-Sanchez,442100,379129,Grégoire Delmas de Blanchard,493582,556553,2022-07-13
CASH_IN,288889,Agence_moov_Cotonou,300000,11111,Grégoire Delmas de Blanchard,556553,845442,2022-07-13
CASH_OUT,275220,Grégoire Delmas de Blanchard,845442,570222,Agence_moov_Cotonou,300000,24780,2022-07-14
CASH_IN,1485,Agence_moov_Ouidah,300000,298515,Grégoire Delmas de Blanchard,570222,571707,2022-07-17
CASH_OUT,339504,Grégoire Delmas de Blanchard,571707,232203,Agence_moov_Ouidah,300000,-39504,2022-07-17
TRANSFER,78255,Grégoire Delmas de Blanchard,232203,153948,Aimé Allain,722300,644045,2022-07-17
CASH_OUT,130816,Grégoire Delmas de Blanchard,153948,23132,Agence_moov_Abomey,300000,169184,2022-07-17
CASH_IN,115616,Agence_moov_Ouidah,300000,184384,Grégoire Delmas de Blanchard,23132,138748,2022-07-19
CASH_IN,27724,Agence_moov_Abomey,300000,272276,Grégoire Delmas de Blanchard,138748,166472,2022-07-19
CASH_IN,287888,Agence_moov_Cotonou,300000,12112,Grégoire Delmas de Blanchard,166472,454360,2022-07-23
TRANSFER,315116,Grégoire Delmas de Blanchard,454360,139244,Nicolas Grondin de la Pinto,625544,310428,2022-07-25
TRANSFER,86493,Nath Léger,255197,168704,Grégoire Delmas de Blanchard,139244,225737,2022-07-25
CASH_IN,211806,Agence_moov_Abomey,300000,88194,Grégoire Delmas de Blanchard,225737,437543,2022-07-26
TRANSFER,673585,Alexandre Poirier,1044923,371338,Grégoire Delmas de Blanchard,437543,1111128,2022-07-26
CASH_OUT,180598,Grégoire Delmas de Blanchard,1111128,930530,Agence_moov_Ouidah,300000,119402,2022-07-26
CASH_IN,63507,Agence_moov_Cotonou,300000,236493,Maurice Alves,1455077,1518584,2022-07-01
CASH_OUT,1148280,Maurice Alves,1518584,370304,Agence_moov_Abomey,300000,-848280,2022-07-01
CASH_OUT,255333,Maurice Alves,370304,114971,Agence_moov_Cotonou,300000,44667,2022-07-02
TRANSFER,173587,Guy Guyon,200055,26468,Maurice Alves,114971,288558,2022-07-03
TRANSFER,126800,Maurice Alves,288558,161758,Emmanuel-René Coulon,1567700,1440900,2022-07-04
CASH_IN,20585,Agence_moov_Abomey,300000,279415,Maurice Alves,161758,182343,2022-07-05
CASH_OUT,77943,Maurice Alves,182343,104400,Agence_moov_Ouidah,300000,222057,2022-07-07
TRANSFER,16849,Maurice Alves,104400,87551,Noël Hamel,78933,62084,2022-07-08
TRANSFER,312356,Marc Gilbert,642809,330453,Maurice Alves,87551,399907,2022-07-10
CASH_OUT,314070,Maurice Alves,399907,85837,Agence_moov_Abomey,300000,-14070,2022-07-12
CASH_IN,29755,Agence_moov_Ouidah,300000,270245,Maurice Alves,85837,115592,2022-07-13
TRANSFER,96614,Maurice Alves,115592,18978,Thierry Dos Santos-Le Roux,245095,148481,2022-07-15
CASH_IN,57849,Agence_moov_Abomey,300000,242151,Maurice Alves,18978,76827,2022-07-15
CASH_OUT,33147,Maurice Alves,76827,43680,Agence_moov_Abomey,300000,266853,2022-07-16
CASH_OUT,9453,Maurice Alves,43680,34227,Agence_moov_Abomey,300000,290547,2022-07-17
CASH_OUT,20361,Maurice Alves,34227,13866,Agence_moov_Cotonou,300000,279639,2022-07-18
CASH_OUT,1955,Maurice Alves,13866,11911,Agence_moov_Cotonou,300000,298045,2022-07-20
TRANSFER,3244,Maurice Alves,11911,8667,Marthe Pichon,1943924,1940680,2022-07-20
CASH_OUT,2017,Maurice Alves,8667,6650,Agence_moov_Ouidah,300000,297983,2022-07-22
TRANSFER,4499,Maurice Alves,6650,2151,Marie Da Silva,472100,467601,2022-07-25
CASH_OUT,1806,Maurice Alves,2151,345,Agence_moov_Cotonou,300000,298194,2022-07-27
CASH_OUT,308,Maurice Alves,345,37,Agence_moov_Ouidah,300000,299692,2022-07-27
CASH_IN,170464,Agence_moov_Cotonou,300000,129536,Maurice Alves,37,170501,2022-07-27
TRANSFER,940653,Frédérique Robin,949700,9047,Théophile Mendès,1401122,460469,2022-07-04
TRANSFER,6886,Frédérique Robin,9047,2161,Frédéric Moreau,1466100,1459214,2022-07-05
CASH_IN,202741,Agence_moov_Abomey,300000,97259,Frédérique Robin,2161,204902,2022-07-05
TRANSFER,77504,Frédérique Robin,204902,127398,Stéphanie Bonneau,451300,373796,2022-07-06
TRANSFER,820968,Alfred Chrétien,1372000,551032,Frédérique Robin,127398,948366,2022-07-06
TRANSFER,565080,Stéphane-Timothée Pineau,1968000,1402920,Frédérique Robin,948366,1513446,2022-07-07
CASH_OUT,1000567,Frédérique Robin,1513446,512879,Agence_moov_Abomey,300000,-700567,2022-07-07
TRANSFER,41523,Laurent Besson,632000,590477,Frédérique Robin,512879,554402,2022-07-09
TRANSFER,326388,Émile Hebert,642043,315655,Frédérique Robin,554402,880790,2022-07-10
CASH_IN,135619,Agence_moov_Cotonou,300000,164381,Frédérique Robin,880790,1016409,2022-07-12
CASH_OUT,643359,Frédérique Robin,1016409,373050,Agence_moov_Ouidah,300000,-343359,2022-07-12
TRANSFER,188639,Frédérique Robin,373050,184411,Nath Léger,168704,-19935,2022-07-12
TRANSFER,17727,Xavier-Stéphane Ollivier,115400,97673,Frédérique Robin,184411,202138,2022-07-16
CASH_IN,144155,Agence_moov_Ouidah,300000,155845,Frédérique Robin,202138,346293,2022-07-17
CASH_IN,4546,Agence_moov_Ouidah,300000,295454,Frédérique Robin,346293,350839,2022-07-17
CASH_IN,24109,Agence_moov_Ouidah,300000,275891,Frédérique Robin,350839,374948,2022-07-17
CASH_OUT,373991,Frédérique Robin,374948,957,Agence_moov_Cotonou,300000,-73991,2022-07-20
CASH_OUT,783,Frédérique Robin,957,174,Agence_moov_Abomey,300000,299217,2022-07-22
CASH_IN,169608,Agence_moov_Abomey,300000,130392,Frédérique Robin,174,169782,2022-07-22
TRANSFER,50255,Frédérique Robin,169782,119527,Marine-Clémence Ferreira,45600,-4655,2022-07-23
TRANSFER,64961,Frédérique Robin,119527,54566,Théodore Bertin,57168,-7793,2022-07-24
CASH_IN,75063,Agence_moov_Ouidah,300000,224937,Frédérique Robin,54566,129629,2022-07-24
CASH_IN,272047,Agence_moov_Cotonou,300000,27953,Frédérique Robin,129629,401676,2022-07-26
CASH_OUT,47418,Frédérique Robin,401676,354258,Agence_moov_Abomey,300000,252582,2022-07-27
CASH_IN,214629,Agence_moov_Abomey,300000,85371,Océane Boutin,624100,838729,2022-07-03
TRANSFER,214320,Théodore-Alfred Fournier,355500,141180,Océane Boutin,838729,1053049,2022-07-05
TRANSFER,513316,Emmanuel-René Coulon,1440900,927584,Océane Boutin,1053049,1566365,2022-07-06
CASH_IN,232689,Agence_moov_Abomey,300000,67311,Océane Boutin,1566365,1799054,2022-07-07
TRANSFER,572564,Océane Boutin,1799054,1226490,Benoît Verdier,431400,-141164,2022-07-07
TRANSFER,339345,Stéphanie Bonneau,373796,34451,Océane Boutin,1226490,1565835,2022-07-08
CASH_IN,215526,Agence_moov_Cotonou,300000,84474,Océane Boutin,1565835,1781361,2022-07-09
CASH_IN,90865,Agence_moov_Abomey,300000,209135,Océane Boutin,1781361,1872226,2022-07-09
CASH_IN,148579,Agence_moov_Abomey,300000,151421,Océane Boutin,1872226,2020805,2022-07-11
CASH_IN,129594,Agence_moov_Cotonou,300000,170406,Océane Boutin,2020805,2150399,2022-07-13
CASH_OUT,2028185,Océane Boutin,2150399,122214,Agence_moov_Abomey,300000,-1728185,2022-07-13
CASH_OUT,39664,Océane Boutin,122214,82550,Agence_moov_Abomey,300000,260336,2022-07-14
TRANSFER,44771,Océane Boutin,82550,37779,Marie Da Silva,467601,422830,2022-07-15
TRANSFER,713033,Christophe Guilbert,982623,269590,Océane Boutin,37779,750812,2022-07-17
CASH_OUT,735178,Océane Boutin,750812,15634,Agence_moov_Ouidah,300000,-435178,2022-07-17
TRANSFER,1785,Océane Boutin,15634,13849,Matthieu Renard,51954,50169,2022-07-18
TRANSFER,2108,Océane Boutin,13849,11741,Josette Guillon-Leclercq,1648400,1646292,2022-07-20
TRANSFER,176699,Théophile Mendès,460469,283770,Océane Boutin,11741,188440,2022-07-22
CASH_OUT,78576,Océane Boutin,188440,109864,Agence_moov_Abomey,300000,221424,2022-07-23
TRANSFER,108734,Océane Boutin,109864,1130,Guy Guyon,26468,-82266,2022-07-25
TRANSFER,885,Océane Boutin,1130,245,Margot Renaud de Lacombe,4086,3201,2022-07-25
TRANSFER,516626,Amélie de la Picard,1666100,1149474,Théophile Mendès,283770,800396,2022-07-01
CASH_IN,135422,Agence_moov_Abomey,300000,164578,Théophile Mendès,800396,935818,2022-07-01
CASH_IN,29773,Agence_moov_Abomey,300000,270227,Théophile Mendès,935818,965591,2022-07-03
CASH_IN,39354,Agence_moov_Abomey,300000,260646,Théophile Mendès,965591,1004945,2022-07-06
TRANSFER,375308,Théophile Mendès,1004945,629637,Joséphine Weber du Bonnin,223232,-152076,2022-07-07
CASH_IN,280118,Agence_moov_Cotonou,300000,19882,Théophile Mendès,629637,909755,2022-07-07
CASH_IN,106392,Agence_moov_Abomey,300000,193608,Théophile Mendès,909755,1016147,2022-07-10
CASH_IN,165076,Agence_moov_Abomey,300000,134924,Théophile Mendès,1016147,1181223,2022-07-11
TRANSFER,801584,Théophile Mendès,1181223,379639,Matthieu Renard,50169,-751415,2022-07-12
CASH_OUT,73100,Théophile Mendès,379639,306539,Agence_moov_Ouidah,300000,226900,2022-07-13
CASH_IN,258806,Agence_moov_Cotonou,300000,41194,Théophile Mendès,306539,565345,2022-07-13
TRANSFER,377372,Théophile Mendès,565345,187973,Stéphanie Bonneau,34451,-342921,2022-07-13
CASH_OUT,80304,Théophile Mendès,187973,107669,Agence_moov_Abomey,300000,219696,2022-07-14
TRANSFER,351814,Agnès Chrétien-Sanchez,379129,27315,Théophile Mendès,107669,459483,2022-07-16
CASH_IN,88025,Agence_moov_Ouidah,300000,211975,Théophile Mendès,459483,547508,2022-07-16
CASH_IN,275289,Agence_moov_Ouidah,300000,24711,Théophile Mendès,547508,822797,2022-07-17
CASH_IN,78446,Agence_moov_Ouidah,300000,221554,Théophile Mendès,822797,901243,2022-07-21
CASH_IN,61035,Agence_moov_Abomey,300000,238965,Théophile Mendès,901243,962278,2022-07-21
TRANSFER,380441,Théophile Mendès,962278,581837,Nathalie-Chantal Jacques,1181100,800659,2022-07-22
CASH_OUT,384512,Théophile Mendès,581837,197325,Agence_moov_Ouidah,300000,-84512,2022-07-23
CASH_IN,115550,Agence_moov_Ouidah,300000,184450,Théophile Mendès,197325,312875,2022-07-23
CASH_IN,187561,Agence_moov_Abomey,300000,112439,Théophile Mendès,312875,500436,2022-07-23
CASH_OUT,479941,Théophile Mendès,500436,20495,Agence_moov_Abomey,300000,-179941,2022-07-23
TRANSFER,3871,Théophile Mendès,20495,16624,Isaac Le Pinto,357589,353718,2022-07-26
CASH_IN,238982,Agence_moov_Ouidah,300000,61018,Théophile Mendès,16624,255606,2022-07-27
CASH_IN,218979,Agence_moov_Cotonou,300000,81021,Théophile Mendès,255606,474585,2022-07-27
TRANSFER,316485,Josette Guillon-Leclercq,1646292,1329807,Luc-Tristan Moreau,1198425,881940,2022-07-01
CASH_IN,105439,Agence_moov_Ouidah,300000,194561,Josette Guillon-Leclercq,1329807,1435246,2022-07-02
TRANSFER,266036,Paulette Dias,949561,683525,Josette Guillon-Leclercq,1435246,1701282,2022-07-06
CASH_IN,3569,Agence_moov_Cotonou,300000,296431,Josette Guillon-Leclercq,1701282,1704851,2022-07-07
CASH_OUT,1314078,Josette Guillon-Leclercq,1704851,390773,Agence_moov_Ouidah,300000,-1014078,2022-07-07
CASH_IN,47015,Agence_moov_Cotonou,300000,252985,Josette Guillon-Leclercq,390773,437788,2022-07-08
CASH_OUT,429430,Josette Guillon-Leclercq,437788,8358,Agence_moov_Cotonou,300000,-129430,2022-07-08
CASH_OUT,7611,Josette Guillon-Leclercq,8358,747,Agence_moov_Abomey,300000,292389,2022-07-08
CASH_IN,202633,Agence_moov_Abomey,300000,97367,Josette Guillon-Leclercq,747,203380,2022-07-09
CASH_OUT,169790,Josette Guillon-Leclercq,203380,33590,Agence_moov_Abomey,300000,130210,2022-07-10
CASH_OUT,3626,Josette Guillon-Leclercq,33590,29964,Agence_moov_Abomey,300000,296374,2022-07-10
CASH_OUT,27366,Josette Guillon-Leclercq,29964,2598,Agence_moov_Ouidah,300000,272634,2022-07-11
CASH_IN,98803,Agence_moov_Abomey,300000,201197,Josette Guillon-Leclercq,2598,101401,2022-07-14
CASH_IN,60300,Agence_moov_Ouidah,300000,239700,Josette Guillon-Leclercq,101401,161701,2022-07-14
CASH_OUT,76211,Josette Guillon-Leclercq,161701,85490,Agence_moov_Ouidah,300000,223789,2022-07-15
CASH_OUT,26156,Josette Guillon-Leclercq,85490,59334,Agence_moov_Cotonou,300000,273844,2022-07-21
TRANSFER,68765,Vincent-Philippe Rossi,257200,188435,Josette Guillon-Leclercq,59334,128099,2022-07-22
CASH_IN,13292,Agence_moov_Ouidah,300000,286708,Josette Guillon-Leclercq,128099,141391,2022-07-24
TRANSFER,111479,Josette Guillon-Leclercq,141391,29912,Antoine Leroux,54298,-57181,2022-07-24
CASH_OUT,20601,Josette Guillon-Leclercq,29912,9311,Agence_moov_Ouidah,300000,279399,2022-07-25
CASH_IN,266206,Agence_moov_Ouidah,300000,33794,Josette Guillon-Leclercq,9311,275517,2022-07-26
CASH_IN,245404,Agence_moov_Ouidah,300000,54596,Stéphane-Timothée Pineau,1402920,1648324,2022-07-01
CASH_IN,292219,Agence_moov_Ouidah,300000,7781,Stéphane-Timothée Pineau,1648324,1940543,2022-07-01
TRANSFER,478180,Diane-Françoise Raynaud,738288,260108,Stéphane-Timothée Pineau,1940543,2418723,2022-07-03
CASH_IN,10956,Agence_moov_Ouidah,300000,289044,Stéphane-Timothée Pineau,2418723,2429679,2022-07-04
TRANSFER,505126,Augustin Benard,1684797,1179671,Stéphane-Timothée Pineau,2429679,2934805,2022-07-07
CASH_IN,289182,Agence_moov_Abomey,300000,10818,Stéphane-Timothée Pineau,2934805,3223987,2022-07-11
CASH_IN,10748,Agence_moov_Abomey,300000,289252,Stéphane-Timothée Pineau,3223987,3234735,2022-07-11
TRANSFER,536449,Stéphane-Timothée Pineau,3234735,2698286,Laurence Dumont de Laroche,306532,-229917,2022-07-13
TRANSFER,224469,Paulette Dias,683525,459056,Stéphane-Timothée Pineau,2698286,2922755,2022-07-13
CASH_IN,271357,Agence_moov_Abomey,300000,28643,Stéphane-Timothée Pineau,2922755,3194112,2022-07-15
TRANSFER,2216507,Stéphane-Timothée Pineau,3194112,977605,Auguste Bousquet,370078,-1846429,2022-07-16
CASH_IN,75247,Agence_moov_Abomey,300000,224753,Stéphane-Timothée Pineau,977605,1052852,2022-07-16
TRANSFER,1022736,Stéphane-Timothée Pineau,1052852,30116,Marie Da Silva,422830,-599906,2022-07-17
TRANSFER,24972,Stéphane-Timothée Pineau,30116,5144,Clémence Bertin,606300,581328,2022-07-17
CASH_IN,62542,Agence_moov_Abomey,300000,237458,Stéphane-Timothée Pineau,5144,67686,2022-07-18
CASH_OUT,50864,Stéphane-Timothée Pineau,67686,16822,Agence_moov_Ouidah,300000,249136,2022-07-18
CASH_OUT,15966,Stéphane-Timothée Pineau,16822,856,Agence_moov_Cotonou,300000,284034,2022-07-20
TRANSFER,400,Stéphane-Timothée Pineau,856,456,Émile Hebert,315655,315255,2022-07-20
CASH_IN,185231,Agence_moov_Cotonou,300000,114769,Stéphane-Timothée Pineau,456,185687,2022-07-20
TRANSFER,74988,Stéphane-Timothée Pineau,185687,110699,Thierry Dos Santos-Le Roux,148481,73493,2022-07-22
TRANSFER,174058,Alexandre Poirier,371338,197280,Stéphane-Timothée Pineau,110699,284757,2022-07-23
CASH_OUT,192829,Stéphane-Timothée Pineau,284757,91928,Agence_moov_Cotonou,300000,107171,2022-07-24
CASH_OUT,82047,Stéphane-Timothée Pineau,91928,9881,Agence_moov_Abomey,300000,217953,2022-07-25
CASH_OUT,7674,Stéphane-Timothée Pineau,9881,2207,Agence_moov_Abomey,300000,292326,2022-07-25
CASH_OUT,2041,Stéphane-Timothée Pineau,2207,166,Agence_moov_Cotonou,300000,297959,2022-07-25
TRANSFER,807934,Frédéric Moreau,1459214,651280,Stéphane-Timothée Pineau,166,808100,2022-07-27
CASH_IN,108967,Agence_moov_Ouidah,300000,191033,Stéphane-Timothée Pineau,808100,917067,2022-07-27
TRANSFER,546656,Marthe Pichon,1940680,1394024,Amélie de la Picard,1149474,602818,2022-07-01
CASH_OUT,914206,Marthe Pichon,1394024,479818,Agence_moov_Cotonou,300000,-614206,2022-07-01
TRANSFER,296434,Marthe Pichon,479818,183384,Vincent-Grégoire Brunet,77300,-219134,2022-07-01
CASH_OUT,85245,Marthe Pichon,183384,98139,Agence_moov_Ouidah,300000,214755,2022-07-02
TRANSFER,27533,Marthe Pichon,98139,70606,Noël Hamel,62084,34551,2022-07-03
CASH_IN,70522,Agence_moov_Ouidah,300000,229478,Marthe Pichon,70606,141128,2022-07-04
CASH_OUT,73633,Marthe Pichon,141128,67495,Agence_moov_Cotonou,300000,226367,2022-07-05
CASH_IN,61944,Agence_moov_Cotonou,300000,238056,Marthe Pichon,67495,129439,2022-07-06
CASH_OUT,33743,Marthe Pichon,129439,95696,Agence_moov_Ouidah,300000,266257,2022-07-07
TRANSFER,90852,Marthe Pichon,95696,4844,Léon Paris,841841,750989,2022-07-08
TRANSFER,242012,Isaac Le Pinto,353718,111706,Marthe Pichon,4844,246856,2022-07-08
CASH_IN,204056,Agence_moov_Abomey,300000,95944,Marthe Pichon,246856,450912,2022-07-09
TRANSFER,16552,Théodore-Alfred Fournier,141180,124628,Marthe Pichon,450912,467464,2022-07-10
CASH_OUT,253858,Marthe Pichon,467464,213606,Agence_moov_Abomey,300000,46142,2022-07-11
CASH_IN,73068,Agence_moov_Abomey,300000,226932,Marthe Pichon,213606,286674,2022-07-12
TRANSFER,258014,Marthe Pichon,286674,28660,Thierry Dos Santos-Le Roux,73493,-184521,2022-07-15
CASH_OUT,16146,Marthe Pichon,28660,12514,Agence_moov_Ouidah,300000,283854,2022-07-15
CASH_IN,199894,Agence_moov_Abomey,300000,100106,Marthe Pichon,12514,212408,2022-07-16
CASH_IN,113595,Agence_moov_Cotonou,300000,186405,Marthe Pichon,212408,326003,2022-07-17
TRANSFER,150078,Marthe Pichon,326003,175925,Alfred Chrétien,551032,400954,2022-07-19
TRANSFER,142024,Marthe Pichon,175925,33901,Nicolas Grondin de la Pinto,310428,168404,2022-07-19
TRANSFER,75736,Alfred Chrétien,400954,325218,Marthe Pichon,33901,109637,2022-07-20
CASH_OUT,77558,Marthe Pichon,109637,32079,Agence_moov_Cotonou,300000,222442,2022-07-20
CASH_IN,46230,Agence_moov_Cotonou,300000,253770,Marthe Pichon,32079,78309,2022-07-22
CASH_IN,282992,Agence_moov_Ouidah,300000,17008,Marthe Pichon,78309,361301,2022-07-24
CASH_OUT,211598,Marthe Pichon,361301,149703,Agence_moov_Cotonou,300000,88402,2022-07-25
TRANSFER,41263,Marthe Pichon,149703,108440,Sabine Imbert,1196000,1154737,2022-07-27
CASH_IN,114204,Agence_moov_Ouidah,300000,185796,Christophe Guilbert,269590,383794,2022-07-01
CASH_OUT,179618,Christophe Guilbert,383794,204176,Agence_moov_Cotonou,300000,120382,2022-07-01
TRANSFER,86042,Luc-Tristan Moreau,881940,795898,Christophe Guilbert,204176,290218,2022-07-02
TRANSFER,89173,Luc-Tristan Moreau,795898,706725,Christophe Guilbert,290218,379391,2022-07-04
TRANSFER,43702,Christophe Guilbert,379391,335689,Paulette Dias,459056,415354,2022-07-04
CASH_IN,24439,Agence_moov_Abomey,300000,275561,Christophe Guilbert,335689,360128,2022-07-07
CASH_OUT,340885,Christophe Guilbert,360128,19243,Agence_moov_Cotonou,300000,-40885,2022-07-09
CASH_OUT,16917,Christophe Guilbert,19243,2326,Agence_moov_Cotonou,300000,283083,2022-07-09
CASH_IN,166559,Agence_moov_Abomey,300000,133441,Christophe Guilbert,2326,168885,2022-07-09
CASH_IN,168977,Agence_moov_Cotonou,300000,131023,Christophe Guilbert,168885,337862,2022-07-11
CASH_IN,190988,Agence_moov_Ouidah,300000,109012,Christophe Guilbert,337862,528850,2022-07-13
CASH_IN,119502,Agence_moov_Ouidah,300000,180498,Christophe Guilbert,528850,648352,2022-07-14
CASH_OUT,538793,Christophe Guilbert,648352,109559,Agence_moov_Abomey,300000,-238793,2022-07-14
TRANSFER,2454,Margot Renaud de Lacombe,3201,747,Christophe Guilbert,109559,112013,2022-07-16
CASH_IN,31443,Agence_moov_Ouidah,300000,268557,Christophe Guilbert,112013,143456,2022-07-16
CASH_IN,238047,Agence_moov_Ouidah,300000,61953,Christophe Guilbert,143456,381503,2022-07-16
TRANSFER,380148,Christophe Guilbert,381503,1355,Emmanuel-René Coulon,927584,547436,2022-07-18
CASH_OUT,534,Christophe Guilbert,1355,821,Agence_moov_Ouidah,300000,299466,2022-07-22
CASH_IN,22374,Agence_moov_Ouidah,300000,277626,Christophe Guilbert,821,23195,2022-07-22
TRANSFER,17946,Agnès Chrétien-Sanchez,27315,9369,Christophe Guilbert,23195,41141,2022-07-22
TRANSFER,33285,Christophe Guilbert,41141,7856,Diane-Françoise Raynaud,260108,226823,2022-07-22
CASH_IN,296193,Agence_moov_Cotonou,300000,3807,Christophe Guilbert,7856,304049,2022-07-22
CASH_IN,122271,Agence_moov_Ouidah,300000,177729,Christophe Guilbert,304049,426320,2022-07-22
CASH_OUT,28335,Christophe Guilbert,426320,397985,Agence_moov_Ouidah,300000,271665,2022-07-24
CASH_OUT,256472,Christophe Guilbert,397985,141513,Agence_moov_Ouidah,300000,43528,2022-07-26
TRANSFER,85827,Christophe Guilbert,141513,55686,Marc Gilbert,330453,244626,2022-07-26
CASH_IN,187734,Agence_moov_Cotonou,300000,112266,Christophe Guilbert,55686,243420,2022-07-26
TRANSFER,51686,Xavier-Stéphane Ollivier,97673,45987,Augustin Benard,1179671,1127985,2022-07-01
CASH_IN,249272,Agence_moov_Ouidah,300000,50728,Xavier-Stéphane Ollivier,45987,295259,2022-07-03
CASH_OUT,187208,Xavier-Stéphane Ollivier,295259,108051,Agence_moov_Abomey,300000,112792,2022-07-05
CASH_OUT,31178,Xavier-Stéphane Ollivier,108051,76873,Agence_moov_Abomey,300000,268822,2022-07-06
CASH_IN,108139,Agence_moov_Abomey,300000,191861,Xavier-Stéphane Ollivier,76873,185012,2022-07-06
TRANSFER,6158,Agnès Chrétien-Sanchez,9369,3211,Xavier-Stéphane Ollivier,185012,191170,2022-07-07
CASH_OUT,29467,Xavier-Stéphane Ollivier,191170,161703,Agence_moov_Cotonou,300000,270533,2022-07-08
TRANSFER,75664,Xavier-Stéphane Ollivier,161703,86039,Claudine Vallet,1306100,1230436,2022-07-08
CASH_IN,57416,Agence_moov_Cotonou,300000,242584,Xavier-Stéphane Ollivier,86039,143455,2022-07-09
CASH_OUT,86612,Xavier-Stéphane Ollivier,143455,56843,Agence_moov_Abomey,300000,213388,2022-07-09
CASH_IN,31788,Agence_moov_Ouidah,300000,268212,Xavier-Stéphane Ollivier,56843,88631,2022-07-11
CASH_OUT,57335,Xavier-Stéphane Ollivier,88631,31296,Agence_moov_Cotonou,300000,242665,2022-07-12
CASH_IN,54636,Agence_moov_Abomey,300000,245364,Xavier-Stéphane Ollivier,31296,85932,2022-07-12
CASH_OUT,73662,Xavier-Stéphane Ollivier,85932,12270,Agence_moov_Ouidah,300000,226338,2022-07-13
TRANSFER,4585,Xavier-Stéphane Ollivier,12270,7685,Nathalie-Chantal Jacques,800659,796074,2022-07-14
CASH_IN,272248,Agence_moov_Abomey,300000,27752,Xavier-Stéphane Ollivier,7685,279933,2022-07-16
TRANSFER,224672,Xavier-Stéphane Ollivier,279933,55261,David-Théodore Diaz,330072,105400,2022-07-16
TRANSFER,42505,Xavier-Stéphane Ollivier,55261,12756,Alexandre Poirier,197280,154775,2022-07-19
CASH_IN,182117,Agence_moov_Abomey,300000,117883,Xavier-Stéphane Ollivier,12756,194873,2022-07-19
CASH_OUT,103404,Xavier-Stéphane Ollivier,194873,91469,Agence_moov_Ouidah,300000,196596,2022-07-19
CASH_OUT,73086,Xavier-Stéphane Ollivier,91469,18383,Agence_moov_Abomey,300000,226914,2022-07-21
CASH_IN,222955,Agence_moov_Ouidah,300000,77045,Xavier-Stéphane Ollivier,18383,241338,2022-07-22
CASH_IN,178283,Agence_moov_Ouidah,300000,121717,Xavier-Stéphane Ollivier,241338,419621,2022-07-23
TRANSFER,620466,Aimé Allain,644045,23579,Xavier-Stéphane Ollivier,419621,1040087,2022-07-23
CASH_IN,294919,Agence_moov_Cotonou,300000,5081,Xavier-Stéphane Ollivier,1040087,1335006,2022-07-25
CASH_IN,181250,Agence_moov_Ouidah,300000,118750,Xavier-Stéphane Ollivier,1335006,1516256,2022-07-25
CASH_IN,283487,Agence_moov_Abomey,300000,16513,Xavier-Stéphane Ollivier,1516256,1799743,2022-07-25
TRANSFER,26050,Noël Hamel,34551,8501,Margot Renaud de Lacombe,747,26797,2022-07-01
CASH_OUT,3543,Margot Renaud de Lacombe,26797,23254,Agence_moov_Abomey,300000,296457,2022-07-01
TRANSFER,22990,Margot Renaud de Lacombe,23254,264,Vincent-Philippe Rossi,188435,165445,2022-07-02
CASH_OUT,170,Margot Renaud de Lacombe,264,94,Agence_moov_Cotonou,300000,299830,2022-07-03
CASH_IN,148130,Agence_moov_Ouidah,300000,151870,Margot Renaud de Lacombe,94,148224,2022-07-04
CASH_IN,203640,Agence_moov_Abomey,300000,96360,Margot Renaud de Lacombe,148224,351864,2022-07-04
TRANSFER,185089,Clémence Bertin,581328,396239,Margot Renaud de Lacombe,351864,536953,2022-07-05
CASH_OUT,524508,Margot Renaud de Lacombe,536953,12445,Agence_moov_Abomey,300000,-224508,2022-07-05
CASH_OUT,12352,Margot Renaud de Lacombe,12445,93,Agence_moov_Abomey,300000,287648,2022-07-06
CASH_IN,98872,Agence_moov_Ouidah,300000,201128,Margot Renaud de Lacombe,93,98965,2022-07-06
CASH_IN,194907,Agence_moov_Abomey,300000,105093,Margot Renaud de Lacombe,98965,293872,2022-07-08
CASH_IN,229314,Agence_moov_Abomey,300000,70686,Margot Renaud de Lacombe,293872,523186,2022-07-11
CASH_IN,78093,Agence_moov_Abomey,300000,221907,Margot Renaud de Lacombe,523186,601279,2022-07-14
TRANSFER,218866,Diane-Françoise Raynaud,226823,7957,Margot Renaud de Lacombe,601279,820145,2022-07-14
CASH_OUT,648238,Margot Renaud de Lacombe,820145,171907,Agence_moov_Cotonou,300000,-348238,2022-07-16
CASH_OUT,140333,Margot Renaud de Lacombe,171907,31574,Agence_moov_Cotonou,300000,159667,2022-07-17
CASH_OUT,6249,Margot Renaud de Lacombe,31574,25325,Agence_moov_Ouidah,300000,293751,2022-07-18
CASH_IN,40352,Agence_moov_Abomey,300000,259648,Margot Renaud de Lacombe,25325,65677,2022-07-20
TRANSFER,56042,Margot Renaud de Lacombe,65677,9635,Diane-Françoise Raynaud,7957,-48085,2022-07-22
CASH_IN,142134,Agence_moov_Ouidah,300000,157866,Margot Renaud de Lacombe,9635,151769,2022-07-24
TRANSFER,458235,Laurent Besson,590477,132242,Margot Renaud de Lacombe,151769,610004,2022-07-26
CASH_IN,113708,Agence_moov_Ouidah,300000,186292,Richard Guibert,35581,149289,2022-07-01
CASH_OUT,88799,Richard Guibert,149289,60490,Agence_moov_Cotonou,300000,211201,2022-07-01
CASH_IN,68460,Agence_moov_Cotonou,300000,231540,Richard Guibert,60490,128950,2022-07-03
TRANSFER,251111,Luc-Tristan Moreau,706725,455614,Richard Guibert,128950,380061,2022-07-05
TRANSFER,326586,Joseph de la Dubois,440900,114314,Richard Guibert,380061,706647,2022-07-05
TRANSFER,72582,Richard Guibert,706647,634065,Gilbert Bazin Le Guillet,1849500,1776918,2022-07-07
TRANSFER,185633,Sabine Imbert,1154737,969104,Richard Guibert,634065,819698,2022-07-07
CASH_IN,79293,Agence_moov_Ouidah,300000,220707,Richard Guibert,819698,898991,2022-07-09
TRANSFER,83855,Richard Guibert,898991,815136,Marc Gilbert,244626,160771,2022-07-10
TRANSFER,51906,Richard Guibert,815136,763230,Agnès Chrétien-Sanchez,3211,-48695,2022-07-10
CASH_OUT,335917,Richard Guibert,763230,427313,Agence_moov_Ouidah,300000,-35917,2022-07-11
TRANSFER,43604,Richard Guibert,427313,383709,Nathalie-Chantal Jacques,796074,752470,2022-07-12
TRANSFER,245995,Richard Guibert,383709,137714,Emmanuel Bousquet,25238,-220757,2022-07-15
TRANSFER,304993,Alfred Chrétien,325218,20225,Richard Guibert,137714,442707,2022-07-16
CASH_OUT,349815,Richard Guibert,442707,92892,Agence_moov_Cotonou,300000,-49815,2022-07-17
CASH_IN,41180,Agence_moov_Cotonou,300000,258820,Richard Guibert,92892,134072,2022-07-18
TRANSFER,115422,Richard Guibert,134072,18650,Augustin Benard,1127985,1012563,2022-07-19
TRANSFER,530059,Nathalie-Chantal Jacques,752470,222411,Richard Guibert,18650,548709,2022-07-20
TRANSFER,289589,Émile Hebert,315255,25666,Richard Guibert,548709,838298,2022-07-20
CASH_IN,19514,Agence_moov_Ouidah,300000,280486,Richard Guibert,838298,857812,2022-07-22
CASH_OUT,654814,Richard Guibert,857812,202998,Agence_moov_Ouidah,300000,-354814,2022-07-24
CASH_OUT,156117,Richard Guibert,202998,46881,Agence_moov_Cotonou,300000,143883,2022-07-26
CASH_OUT,46168,Richard Guibert,46881,713,Agence_moov_Cotonou,300000,253832,2022-07-26
CASH_IN,85062,Agence_moov_Cotonou,300000,214938,Marie Da Silva,-599906,-514844,2022-07-01
CASH_IN,143102,Agence_moov_Ouidah,300000,156898,Marie Da Silva,-514844,-371742,2022-07-01
CASH_IN,72555,Agence_moov_Cotonou,300000,227445,Marie Da Silva,-371742,-299187,2022-07-01
CASH_IN,239622,Agence_moov_Ouidah,300000,60378,Marie Da Silva,-299187,-59565,2022-07-02
CASH_IN,144238,Agence_moov_Ouidah,300000,155762,Marie Da Silva,-59565,84673,2022-07-03
TRANSFER,1287,Noël Hamel,8501,7214,Marie Da Silva,84673,85960,2022-07-03
TRANSFER,104122,Joseph de la Dubois,114314,10192,Marie Da Silva,85960,190082,2022-07-06
TRANSFER,3455,Alfred Chrétien,20225,16770,Marie Da Silva,190082,193537,2022-07-06
CASH_OUT,6806,Marie Da Silva,193537,186731,Agence_moov_Cotonou,300000,293194,2022-07-06
CASH_OUT,3708,Marie Da Silva,186731,183023,Agence_moov_Ouidah,300000,296292,2022-07-07
CASH_OUT,96660,Marie Da Silva,183023,86363,Agence_moov_Cotonou,300000,203340,2022-07-11
CASH_OUT,3369,Marie Da Silva,86363,82994,Agence_moov_Abomey,300000,296631,2022-07-14
TRANSFER,76727,Marie Da Silva,82994,6267,Bernadette Fabre,595000,518273,2022-07-15
CASH_OUT,1942,Marie Da Silva,6267,4325,Agence_moov_Ouidah,300000,298058,2022-07-15
CASH_OUT,4230,Marie Da Silva,4325,95,Agence_moov_Abomey,300000,295770,2022-07-16
CASH_IN,147867,Agence_moov_Cotonou,300000,152133,Marie Da Silva,95,147962,2022-07-16
CASH_IN,78763,Agence_moov_Abomey,300000,221237,Marie Da Silva,147962,226725,2022-07-16
TRANSFER,894321,Sabine Imbert,969104,74783,Marie Da Silva,226725,1121046,2022-07-19
CASH_IN,241480,Agence_moov_Abomey,300000,58520,Marie Da Silva,1121046,1362526,2022-07-19
CASH_OUT,1152113,Marie Da Silva,1362526,210413,Agence_moov_Ouidah,300000,-852113,2022-07-21
CASH_OUT,107016,Marie Da Silva,210413,103397,Agence_moov_Ouidah,300000,192984,2022-07-21
TRANSFER,14780,Marie Da Silva,103397,88617,Gilbert Bazin Le Guillet,1776918,1762138,2022-07-21
CASH_IN,135618,Agence_moov_Cotonou,300000,164382,Marie Da Silva,88617,224235,2022-07-22
CASH_OUT,73716,Marie Da Silva,224235,150519,Agence_moov_Cotonou,300000,226284,2022-07-24
CASH_IN,160768,Agence_moov_Abomey,300000,139232,Marie Da Silva,150519,311287,2022-07-24
CASH_IN,298962,Agence_moov_Cotonou,300000,1038,Marie Da Silva,311287,610249,2022-07-24
CASH_IN,258763,Agence_moov_Cotonou,300000,41237,Marie Da Silva,610249,869012,2022-07-26
CASH_IN,166907,Agence_moov_Cotonou,300000,133093,Marie Da Silva,869012,1035919,2022-07-27
CASH_IN,102439,Agence_moov_Cotonou,300000,197561,Marine-Clémence Ferreira,-4655,97784,2022-07-02
CASH_OUT,30391,Marine-Clémence Ferreira,97784,67393,Agence_moov_Ouidah,300000,269609,2022-07-03
CASH_OUT,49977,Marine-Clémence Ferreira,67393,17416,Agence_moov_Cotonou,300000,250023,2022-07-03
CASH_IN,142699,Agence_moov_Abomey,300000,157301,Marine-Clémence Ferreira,17416,160115,2022-07-03
TRANSFER,477139,Augustin Benard,1012563,535424,Marine-Clémence Ferreira,160115,637254,2022-07-03
CASH_OUT,139460,Marine-Clémence Ferreira,637254,497794,Agence_moov_Cotonou,300000,160540,2022-07-04
CASH_IN,102990,Agence_moov_Abomey,300000,197010,Marine-Clémence Ferreira,497794,600784,2022-07-05
CASH_OUT,87286,Marine-Clémence Ferreira,600784,513498,Agence_moov_Abomey,300000,212714,2022-07-06
CASH_OUT,88774,Marine-Clémence Ferreira,513498,424724,Agence_moov_Ouidah,300000,211226,2022-07-08
CASH_OUT,46470,Marine-Clémence Ferreira,424724,378254,Agence_moov_Ouidah,300000,253530,2022-07-08
TRANSFER,388891,Bernadette Fabre,518273,129382,Marine-Clémence Ferreira,378254,767145,2022-07-09
CASH_IN,280801,Agence_moov_Ouidah,300000,19199,Marine-Clémence Ferreira,767145,1047946,2022-07-09
CASH_OUT,331156,Marine-Clémence Ferreira,1047946,716790,Agence_moov_Ouidah,300000,-31156,2022-07-11
TRANSFER,103308,Marine-Clémence Ferreira,716790,613482,Isaac Le Pinto,111706,8398,2022-07-11
CASH_OUT,434489,Marine-Clémence Ferreira,613482,178993,Agence_moov_Ouidah,300000,-134489,2022-07-11
CASH_OUT,172180,Marine-Clémence Ferreira,178993,6813,Agence_moov_Cotonou,300000,127820,2022-07-12
CASH_OUT,180,Marine-Clémence Ferreira,6813,6633,Agence_moov_Abomey,300000,299820,2022-07-13
CASH_OUT,5194,Marine-Clémence Ferreira,6633,1439,Agence_moov_Cotonou,300000,294806,2022-07-13
TRANSFER,60596,Nathalie-Chantal Jacques,222411,161815,Marine-Clémence Ferreira,1439,62035,2022-07-14
CASH_OUT,794,Marine-Clémence Ferreira,62035,61241,Agence_moov_Abomey,300000,299206,2022-07-18
CASH_IN,209239,Agence_moov_Cotonou,300000,90761,Marine-Clémence Ferreira,61241,270480,2022-07-18
CASH_OUT,211321,Marine-Clémence Ferreira,270480,59159,Agence_moov_Cotonou,300000,88679,2022-07-19
TRANSFER,56427,Marine-Clémence Ferreira,59159,2732,Marine-Clémence Ferreira,59159,2732,2022-07-23
CASH_IN,75515,Agence_moov_Abomey,300000,224485,Marine-Clémence Ferreira,2732,78247,2022-07-24
CASH_IN,122448,Agence_moov_Cotonou,300000,177552,Marine-Clémence Ferreira,78247,200695,2022-07-25
CASH_IN,130308,Agence_moov_Cotonou,300000,169692,Marine-Clémence Ferreira,200695,331003,2022-07-25
CASH_IN,141319,Agence_moov_Ouidah,300000,158681,Marine-Clémence Ferreira,331003,472322,2022-07-26
TRANSFER,111482,Laurent Besson,132242,20760,Marine-Clémence Ferreira,472322,583804,2022-07-27
TRANSFER,446968,Marine-Clémence Ferreira,583804,136836,Isaac Le Pinto,8398,-438570,2022-07-27
CASH_OUT,133390,Marine-Clémence Ferreira,136836,3446,Agence_moov_Cotonou,300000,166610,2022-07-27
CASH_IN,60836,Agence_moov_Abomey,300000,239164,Nathalie-Chantal Jacques,161815,222651,2022-07-01
TRANSFER,121708,Amélie de la Picard,602818,481110,Nathalie-Chantal Jacques,222651,344359,2022-07-03
CASH_OUT,162007,Nathalie-Chantal Jacques,344359,182352,Agence_moov_Ouidah,300000,137993,2022-07-04
TRANSFER,4847,Joseph de la Dubois,10192,5345,Nathalie-Chantal Jacques,182352,187199,2022-07-05
CASH_IN,198319,Agence_moov_Ouidah,300000,101681,Nathalie-Chantal Jacques,187199,385518,2022-07-07
CASH_OUT,115867,Nathalie-Chantal Jacques,385518,269651,Agence_moov_Abomey,300000,184133,2022-07-07
TRANSFER,57230,Sabine Imbert,74783,17553,Nathalie-Chantal Jacques,269651,326881,2022-07-08
TRANSFER,215195,Nathalie-Chantal Jacques,326881,111686,Luc-Tristan Moreau,455614,240419,2022-07-10
TRANSFER,65516,Nathalie-Chantal Jacques,111686,46170,Nathalie-Chantal Jacques,111686,177202,2022-07-13
CASH_OUT,456,Nathalie-Chantal Jacques,46170,45714,Agence_moov_Cotonou,300000,299544,2022-07-15
CASH_IN,147108,Agence_moov_Cotonou,300000,152892,Nathalie-Chantal Jacques,45714,192822,2022-07-15
CASH_IN,160065,Agence_moov_Cotonou,300000,139935,Nathalie-Chantal Jacques,192822,352887,2022-07-15
CASH_IN,294199,Agence_moov_Abomey,300000,5801,Nathalie-Chantal Jacques,352887,647086,2022-07-15
CASH_IN,276165,Agence_moov_Cotonou,300000,23835,Nathalie-Chantal Jacques,647086,923251,2022-07-16
CASH_OUT,567058,Nathalie-Chantal Jacques,923251,356193,Agence_moov_Abomey,300000,-267058,2022-07-16
TRANSFER,17664,Théodore-Alfred Fournier,124628,106964,Nathalie-Chantal Jacques,356193,373857,2022-07-18
TRANSFER,233142,Nicole Lacroix,336100,102958,Nathalie-Chantal Jacques,373857,606999,2022-07-19
TRANSFER,4340,Noël Hamel,7214,2874,Nathalie-Chantal Jacques,606999,611339,2022-07-20
CASH_OUT,79154,Nathalie-Chantal Jacques,611339,532185,Agence_moov_Ouidah,300000,220846,2022-07-20
TRANSFER,77431,Théodore-Alfred Fournier,106964,29533,Nathalie-Chantal Jacques,532185,609616,2022-07-21
TRANSFER,463870,Nathalie-Chantal Jacques,609616,145746,Joseph de la Dubois,5345,-458525,2022-07-22
TRANSFER,532742,Augustin Benard,535424,2682,Nathalie-Chantal Jacques,145746,678488,2022-07-22
CASH_IN,213649,Agence_moov_Abomey,300000,86351,Nathalie-Chantal Jacques,678488,892137,2022-07-23
TRANSFER,335,Bernadette Fabre,129382,129047,Nathalie-Chantal Jacques,892137,892472,2022-07-25
CASH_IN,111756,Agence_moov_Abomey,300000,188244,Emmanuel Bousquet,-220757,-109001,2022-07-01
CASH_IN,57732,Agence_moov_Ouidah,300000,242268,Emmanuel Bousquet,-109001,-51269,2022-07-02
CASH_IN,173262,Agence_moov_Abomey,300000,126738,Emmanuel Bousquet,-51269,121993,2022-07-02
TRANSFER,94484,Emmanuel Bousquet,121993,27509,Léon Paris,750989,656505,2022-07-05
CASH_OUT,5712,Emmanuel Bousquet,27509,21797,Agence_moov_Abomey,300000,294288,2022-07-05
CASH_IN,9076,Agence_moov_Cotonou,300000,290924,Emmanuel Bousquet,21797,30873,2022-07-10
TRANSFER,112964,Alexandre Poirier,154775,41811,Emmanuel Bousquet,30873,143837,2022-07-11
CASH_IN,161823,Agence_moov_Ouidah,300000,138177,Emmanuel Bousquet,143837,305660,2022-07-11
CASH_OUT,264757,Emmanuel Bousquet,305660,40903,Agence_moov_Ouidah,300000,35243,2022-07-12
CASH_OUT,31354,Emmanuel Bousquet,40903,9549,Agence_moov_Ouidah,300000,268646,2022-07-14
TRANSFER,147997,Marc Gilbert,160771,12774,Emmanuel Bousquet,9549,157546,2022-07-15
CASH_IN,239794,Agence_moov_Ouidah,300000,60206,Emmanuel Bousquet,157546,397340,2022-07-18
CASH_OUT,330271,Emmanuel Bousquet,397340,67069,Agence_moov_Abomey,300000,-30271,2022-07-19
CASH_IN,279443,Agence_moov_Abomey,300000,20557,Emmanuel Bousquet,67069,346512,2022-07-21
TRANSFER,49976,Emmanuel Bousquet,346512,296536,Amélie de la Picard,481110,431134,2022-07-26
CASH_IN,122943,Agence_moov_Ouidah,300000,177057,Vincent-Philippe Rossi,165445,288388,2022-07-01
CASH_IN,14935,Agence_moov_Ouidah,300000,285065,Vincent-Philippe Rossi,288388,303323,2022-07-05
CASH_OUT,75188,Vincent-Philippe Rossi,303323,228135,Agence_moov_Cotonou,300000,224812,2022-07-06
CASH_IN,36653,Agence_moov_Cotonou,300000,263347,Vincent-Philippe Rossi,228135,264788,2022-07-07
TRANSFER,123783,Vincent-Philippe Rossi,264788,141005,Clémence Bertin,396239,272456,2022-07-08
CASH_IN,108796,Agence_moov_Cotonou,300000,191204,Vincent-Philippe Rossi,141005,249801,2022-07-10
CASH_OUT,37122,Vincent-Philippe Rossi,249801,212679,Agence_moov_Ouidah,300000,262878,2022-07-10
CASH_OUT,161367,Vincent-Philippe Rossi,212679,51312,Agence_moov_Abomey,300000,138633,2022-07-11
CASH_OUT,38948,Vincent-Philippe Rossi,51312,12364,Agence_moov_Ouidah,300000,261052,2022-07-20
CASH_IN,106534,Agence_moov_Ouidah,300000,193466,Laurence Carlier,-2436694,-2330160,2022-07-05
CASH_IN,255090,Agence_moov_Ouidah,300000,44910,Laurence Carlier,-2330160,-2075070,2022-07-07
CASH_IN,183830,Agence_moov_Cotonou,300000,116170,Laurence Carlier,-2075070,-1891240,2022-07-08
CASH_IN,161841,Agence_moov_Ouidah,300000,138159,Laurence Carlier,-1891240,-1729399,2022-07-09
CASH_IN,282120,Agence_moov_Abomey,300000,17880,Laurence Carlier,-1729399,-1447279,2022-07-13
CASH_IN,50420,Agence_moov_Ouidah,300000,249580,Laurence Carlier,-1447279,-1396859,2022-07-13
CASH_IN,211048,Agence_moov_Ouidah,300000,88952,Laurence Carlier,-1396859,-1185811,2022-07-14
CASH_OUT,101537,Bernadette Fabre,129047,27510,Agence_moov_Abomey,300000,198463,2022-07-01
TRANSFER,1879,Augustin Benard,2682,803,Bernadette Fabre,27510,29389,2022-07-05
TRANSFER,10845,Laurent Besson,20760,9915,Bernadette Fabre,29389,40234,2022-07-05
CASH_OUT,16911,Bernadette Fabre,40234,23323,Agence_moov_Ouidah,300000,283089,2022-07-06
TRANSFER,12679,Sabine Imbert,17553,4874,Bernadette Fabre,23323,36002,2022-07-06
TRANSFER,14197,Émile Hebert,25666,11469,Bernadette Fabre,36002,50199,2022-07-07
TRANSFER,3402,Bernadette Fabre,50199,46797,Nicolas Grondin de la Pinto,168404,165002,2022-07-09
TRANSFER,6877,Bernadette Fabre,46797,39920,Noël Hamel,2874,-4003,2022-07-09
CASH_IN,4953,Agence_moov_Cotonou,300000,295047,Bernadette Fabre,39920,44873,2022-07-10
CASH_OUT,35531,Bernadette Fabre,44873,9342,Agence_moov_Cotonou,300000,264469,2022-07-12
TRANSFER,73008,David-Théodore Diaz,105400,32392,Bernadette Fabre,9342,82350,2022-07-13
CASH_OUT,56576,Bernadette Fabre,82350,25774,Agence_moov_Cotonou,300000,243424,2022-07-13
TRANSFER,3827,Bernadette Fabre,25774,21947,Emmanuel-René Coulon,547436,543609,2022-07-15
TRANSFER,125755,Gilbert Bazin Le Guillet,1762138,1636383,Bernadette Fabre,21947,147702,2022-07-15
CASH_OUT,7582,Bernadette Fabre,147702,140120,Agence_moov_Cotonou,300000,292418,2022-07-16
CASH_IN,60816,Agence_moov_Cotonou,300000,239184,Bernadette Fabre,140120,200936,2022-07-21
CASH_IN,241868,Agence_moov_Cotonou,300000,58132,Bernadette Fabre,200936,442804,2022-07-25
CASH_IN,271254,Agence_moov_Abomey,300000,28746,Bernadette Fabre,442804,714058,2022-07-25
TRANSFER,2634,Alfred Chrétien,16770,14136,Bernadette Fabre,714058,716692,2022-07-25
CASH_IN,93374,Agence_moov_Abomey,300000,206626,Noël Hamel,-4003,89371,2022-07-01
CASH_IN,69411,Agence_moov_Cotonou,300000,230589,Noël Hamel,89371,158782,2022-07-01
CASH_IN,95077,Agence_moov_Abomey,300000,204923,Noël Hamel,158782,253859,2022-07-05
CASH_OUT,151757,Noël Hamel,253859,102102,Agence_moov_Ouidah,300000,148243,2022-07-06
CASH_IN,298990,Agence_moov_Cotonou,300000,1010,Noël Hamel,102102,401092,2022-07-06
TRANSFER,277617,Noël Hamel,401092,123475,Léon Paris,656505,378888,2022-07-09
CASH_IN,236740,Agence_moov_Ouidah,300000,63260,Noël Hamel,123475,360215,2022-07-13
TRANSFER,11798,David-Théodore Diaz,32392,20594,Noël Hamel,360215,372013,2022-07-15
TRANSFER,37676,Alexandre Poirier,41811,4135,Noël Hamel,372013,409689,2022-07-18
CASH_OUT,336364,Noël Hamel,409689,73325,Agence_moov_Cotonou,300000,-36364,2022-07-18
TRANSFER,8261,Laurent Besson,9915,1654,Noël Hamel,73325,81586,2022-07-20
CASH_IN,65602,Agence_moov_Cotonou,300000,234398,Noël Hamel,81586,147188,2022-07-21
CASH_OUT,66097,Noël Hamel,147188,81091,Agence_moov_Abomey,300000,233903,2022-07-25
TRANSFER,18949,Nicole Lacroix,102958,84009,Noël Hamel,81091,100040,2022-07-26
CASH_IN,148585,Agence_moov_Ouidah,300000,151415,Noël Hamel,100040,248625,2022-07-27
CASH_OUT,117412,Noël Hamel,248625,131213,Agence_moov_Ouidah,300000,182588,2022-07-27
CASH_OUT,916,David-Théodore Diaz,20594,19678,Agence_moov_Ouidah,300000,299084,2022-07-01
CASH_IN,135314,Agence_moov_Abomey,300000,164686,David-Théodore Diaz,19678,154992,2022-07-03
CASH_OUT,37077,David-Théodore Diaz,154992,117915,Agence_moov_Ouidah,300000,262923,2022-07-06
TRANSFER,102632,David-Théodore Diaz,117915,15283,Gilbert Bazin Le Guillet,1636383,1533751,2022-07-08
CASH_IN,230080,Agence_moov_Abomey,300000,69920,David-Théodore Diaz,15283,245363,2022-07-12
TRANSFER,147549,David-Théodore Diaz,245363,97814,Nicolas Grondin de la Pinto,165002,17453,2022-07-15
CASH_IN,1032,Agence_moov_Cotonou,300000,298968,David-Théodore Diaz,97814,98846,2022-07-16
CASH_IN,112814,Agence_moov_Cotonou,300000,187186,David-Théodore Diaz,98846,211660,2022-07-17
CASH_IN,6416,Agence_moov_Cotonou,300000,293584,Stéphanie Bonneau,-342921,-336505,2022-07-03
CASH_IN,292323,Agence_moov_Abomey,300000,7677,Stéphanie Bonneau,-336505,-44182,2022-07-06
CASH_IN,287437,Agence_moov_Ouidah,300000,12563,Stéphanie Bonneau,-44182,243255,2022-07-09
TRANSFER,62522,Stéphanie Bonneau,243255,180733,Aimé Allain,23579,-38943,2022-07-12
CASH_OUT,139653,Stéphanie Bonneau,180733,41080,Agence_moov_Abomey,300000,160347,2022-07-15
TRANSFER,1027,Sabine Imbert,4874,3847,Stéphanie Bonneau,41080,42107,2022-07-23
CASH_IN,288002,Agence_moov_Cotonou,300000,11998,Stéphanie Bonneau,42107,330109,2022-07-27
CASH_IN,112718,Agence_moov_Abomey,300000,187282,Agnès Chrétien-Sanchez,-48695,64023,2022-07-03
CASH_IN,275180,Agence_moov_Cotonou,300000,24820,Agnès Chrétien-Sanchez,64023,339203,2022-07-04
CASH_IN,33027,Agence_moov_Cotonou,300000,266973,Agnès Chrétien-Sanchez,339203,372230,2022-07-09
TRANSFER,279462,Agnès Chrétien-Sanchez,372230,92768,Gilbert Bazin Le Guillet,1533751,1254289,2022-07-10
CASH_OUT,67814,Agnès Chrétien-Sanchez,92768,24954,Agence_moov_Cotonou,300000,232186,2022-07-12
TRANSFER,307630,Gilbert Bazin Le Guillet,1254289,946659,Agnès Chrétien-Sanchez,24954,332584,2022-07-15
CASH_OUT,161056,Agnès Chrétien-Sanchez,332584,171528,Agence_moov_Cotonou,300000,138944,2022-07-16
CASH_IN,232462,Agence_moov_Cotonou,300000,67538,Agnès Chrétien-Sanchez,171528,403990,2022-07-18
CASH_OUT,331930,Agnès Chrétien-Sanchez,403990,72060,Agence_moov_Ouidah,300000,-31930,2022-07-18
CASH_IN,186165,Agence_moov_Ouidah,300000,113835,Agnès Chrétien-Sanchez,72060,258225,2022-07-20
TRANSFER,110513,Agnès Chrétien-Sanchez,258225,147712,Emmanuel-René Coulon,543609,433096,2022-07-21
CASH_IN,80678,Agence_moov_Ouidah,300000,219322,Agnès Chrétien-Sanchez,147712,228390,2022-07-21
CASH_OUT,120357,Agnès Chrétien-Sanchez,228390,108033,Agence_moov_Ouidah,300000,179643,2022-07-22
CASH_OUT,88179,Agnès Chrétien-Sanchez,108033,19854,Agence_moov_Cotonou,300000,211821,2022-07-23
CASH_IN,278310,Agence_moov_Ouidah,300000,21690,Agnès Chrétien-Sanchez,19854,298164,2022-07-23
CASH_IN,181465,Agence_moov_Abomey,300000,118535,Agnès Chrétien-Sanchez,298164,479629,2022-07-23
CASH_OUT,34256,Agnès Chrétien-Sanchez,479629,445373,Agence_moov_Ouidah,300000,265744,2022-07-26
TRANSFER,365282,Agnès Chrétien-Sanchez,445373,80091,Nicole Lacroix,84009,-281273,2022-07-26
CASH_OUT,18479,Agnès Chrétien-Sanchez,80091,61612,Agence_moov_Cotonou,300000,281521,2022-07-26
TRANSFER,249246,Gilbert Bazin Le Guillet,946659,697413,Agnès Chrétien-Sanchez,61612,310858,2022-07-27
CASH_IN,288286,Agence_moov_Cotonou,300000,11714,Joséphine Weber du Bonnin,-152076,136210,2022-07-01
CASH_OUT,79846,Joséphine Weber du Bonnin,136210,56364,Agence_moov_Cotonou,300000,220154,2022-07-02
CASH_OUT,6057,Joséphine Weber du Bonnin,56364,50307,Agence_moov_Ouidah,300000,293943,2022-07-04
TRANSFER,2743,Alexandre Poirier,4135,1392,Joséphine Weber du Bonnin,50307,53050,2022-07-06
CASH_OUT,14188,Joséphine Weber du Bonnin,53050,38862,Agence_moov_Cotonou,300000,285812,2022-07-11
CASH_IN,283207,Agence_moov_Cotonou,300000,16793,Joséphine Weber du Bonnin,38862,322069,2022-07-12
CASH_IN,173318,Agence_moov_Cotonou,300000,126682,Joséphine Weber du Bonnin,322069,495387,2022-07-13
CASH_OUT,98704,Joséphine Weber du Bonnin,495387,396683,Agence_moov_Cotonou,300000,201296,2022-07-16
CASH_IN,220357,Agence_moov_Abomey,300000,79643,Joséphine Weber du Bonnin,396683,617040,2022-07-17
TRANSFER,608553,Joséphine Weber du Bonnin,617040,8487,Paulette Dias,415354,-193199,2022-07-18
CASH_IN,9148,Agence_moov_Ouidah,300000,290852,Joséphine Weber du Bonnin,8487,17635,2022-07-21
TRANSFER,679544,Gilbert Bazin Le Guillet,697413,17869,Émile Hebert,11469,691013,2022-07-02
CASH_IN,93412,Agence_moov_Cotonou,300000,206588,Émile Hebert,691013,784425,2022-07-04
CASH_OUT,731660,Émile Hebert,784425,52765,Agence_moov_Cotonou,300000,-431660,2022-07-06
TRANSFER,249552,Amélie de la Picard,431134,181582,Émile Hebert,52765,302317,2022-07-09
TRANSFER,257868,Émile Hebert,302317,44449,Nicolas Grondin de la Pinto,17453,-240415,2022-07-10
CASH_IN,218222,Agence_moov_Cotonou,300000,81778,Émile Hebert,44449,262671,2022-07-13
CASH_OUT,25815,Émile Hebert,262671,236856,Agence_moov_Abomey,300000,274185,2022-07-14
TRANSFER,403,Augustin Benard,803,400,Émile Hebert,236856,237259,2022-07-19
TRANSFER,48987,Émile Hebert,237259,188272,Luc-Tristan Moreau,240419,191432,2022-07-22
CASH_OUT,64948,Émile Hebert,188272,123324,Agence_moov_Cotonou,300000,235052,2022-07-24
TRANSFER,104476,Émile Hebert,123324,18848,Clémence Bertin,272456,167980,2022-07-24
TRANSFER,5784,Émile Hebert,18848,13064,Alexandre Poirier,1392,-4392,2022-07-24
CASH_OUT,4768,Émile Hebert,13064,8296,Agence_moov_Ouidah,300000,295232,2022-07-27
CASH_OUT,2262,Émile Hebert,8296,6034,Agence_moov_Ouidah,300000,297738,2022-07-27
CASH_IN,192750,Agence_moov_Ouidah,300000,107250,Agnès Baron,-119214,73536,2022-07-04
CASH_IN,283587,Agence_moov_Cotonou,300000,16413,Agnès Baron,73536,357123,2022-07-06
CASH_IN,23259,Agence_moov_Cotonou,300000,276741,Agnès Baron,357123,380382,2022-07-08
CASH_IN,130991,Agence_moov_Ouidah,300000,169009,Agnès Baron,380382,511373,2022-07-10
TRANSFER,343965,Agnès Baron,511373,167408,Emmanuel-René Coulon,433096,89131,2022-07-10
CASH_OUT,112034,Agnès Baron,167408,55374,Agence_moov_Abomey,300000,187966,2022-07-11
TRANSFER,2451,Alfred Chrétien,14136,11685,Agnès Baron,55374,57825,2022-07-11
CASH_IN,160903,Agence_moov_Cotonou,300000,139097,Agnès Baron,57825,218728,2022-07-12
CASH_OUT,103320,Agnès Baron,218728,115408,Agence_moov_Cotonou,300000,196680,2022-07-14
CASH_OUT,71008,Agnès Baron,115408,44400,Agence_moov_Abomey,300000,228992,2022-07-16
CASH_OUT,26710,Agnès Baron,44400,17690,Agence_moov_Ouidah,300000,273290,2022-07-19
TRANSFER,7379,Théodore-Alfred Fournier,29533,22154,Agnès Baron,17690,25069,2022-07-21
TRANSFER,8232,Marc Gilbert,12774,4542,Agnès Baron,25069,33301,2022-07-22
CASH_IN,206706,Agence_moov_Abomey,300000,93294,Agnès Baron,33301,240007,2022-07-22
TRANSFER,99974,Amélie de la Picard,181582,81608,Agnès Baron,240007,339981,2022-07-27
CASH_OUT,43855,Agnès Baron,339981,296126,Agence_moov_Ouidah,300000,256145,2022-07-27
TRANSFER,6304,Théodore-Alfred Fournier,22154,15850,Frédéric Moreau,651280,644976,2022-07-03
CASH_OUT,2764,Théodore-Alfred Fournier,15850,13086,Agence_moov_Cotonou,300000,297236,2022-07-04
TRANSFER,3384,Marc Gilbert,4542,1158,Théodore-Alfred Fournier,13086,16470,2022-07-04
CASH_OUT,10007,Théodore-Alfred Fournier,16470,6463,Agence_moov_Abomey,300000,289993,2022-07-07
CASH_OUT,2810,Théodore-Alfred Fournier,6463,3653,Agence_moov_Cotonou,300000,297190,2022-07-10
CASH_OUT,185,Théodore-Alfred Fournier,3653,3468,Agence_moov_Abomey,300000,299815,2022-07-11
TRANSFER,1841,Théodore-Alfred Fournier,3468,1627,Gilbert Bazin Le Guillet,17869,16028,2022-07-15
CASH_IN,201045,Agence_moov_Abomey,300000,98955,Théodore-Alfred Fournier,1627,202672,2022-07-17
TRANSFER,1019,Marc Gilbert,1158,139,Théodore-Alfred Fournier,202672,203691,2022-07-19
CASH_OUT,164068,Théodore-Alfred Fournier,203691,39623,Agence_moov_Ouidah,300000,135932,2022-07-21
CASH_OUT,20513,Théodore-Alfred Fournier,39623,19110,Agence_moov_Cotonou,300000,279487,2022-07-22
CASH_OUT,1425,Théodore-Alfred Fournier,19110,17685,Agence_moov_Abomey,300000,298575,2022-07-22
CASH_IN,247288,Agence_moov_Abomey,300000,52712,Théodore-Alfred Fournier,17685,264973,2022-07-26
CASH_IN,187684,Agence_moov_Abomey,300000,112316,Laurent Perrot,-57897,129787,2022-07-07
CASH_IN,271829,Agence_moov_Cotonou,300000,28171,Laurent Perrot,129787,401616,2022-07-12
CASH_OUT,364280,Laurent Perrot,401616,37336,Agence_moov_Ouidah,300000,-64280,2022-07-12
CASH_IN,63756,Agence_moov_Ouidah,300000,236244,Laurent Perrot,37336,101092,2022-07-16
CASH_IN,35814,Agence_moov_Abomey,300000,264186,Laurent Perrot,101092,136906,2022-07-22
CASH_OUT,5591,Laurent Perrot,136906,131315,Agence_moov_Cotonou,300000,294409,2022-07-25
CASH_IN,175779,Agence_moov_Abomey,300000,124221,Laurent Perrot,131315,307094,2022-07-26
CASH_IN,114317,Agence_moov_Cotonou,300000,185683,Vincent-Grégoire Brunet,-219134,-104817,2022-07-01
CASH_IN,143297,Agence_moov_Cotonou,300000,156703,Vincent-Grégoire Brunet,-104817,38480,2022-07-02
CASH_IN,143039,Agence_moov_Abomey,300000,156961,Vincent-Grégoire Brunet,38480,181519,2022-07-07
TRANSFER,26588,Vincent-Grégoire Brunet,181519,154931,Amélie de la Picard,81608,55020,2022-07-12
CASH_OUT,139503,Vincent-Grégoire Brunet,154931,15428,Agence_moov_Cotonou,300000,160497,2022-07-17
CASH_IN,210637,Agence_moov_Cotonou,300000,89363,Vincent-Grégoire Brunet,15428,226065,2022-07-18
TRANSFER,136056,Vincent-Grégoire Brunet,226065,90009,Vincent-Grégoire Brunet,226065,90009,2022-07-19
CASH_OUT,3001,Vincent-Grégoire Brunet,90009,87008,Agence_moov_Cotonou,300000,296999,2022-07-20
CASH_OUT,48325,Vincent-Grégoire Brunet,87008,38683,Agence_moov_Ouidah,300000,251675,2022-07-21
CASH_IN,146361,Agence_moov_Ouidah,300000,153639,Vincent-Grégoire Brunet,38683,185044,2022-07-21
CASH_OUT,179721,Vincent-Grégoire Brunet,185044,5323,Agence_moov_Cotonou,300000,120279,2022-07-22
TRANSFER,2968,Sabine Imbert,3847,879,Vincent-Grégoire Brunet,5323,8291,2022-07-23
TRANSFER,4898,Vincent-Grégoire Brunet,8291,3393,Luc-Tristan Moreau,191432,186534,2022-07-24
TRANSFER,846,Vincent-Grégoire Brunet,3393,2547,Emmanuel-René Coulon,89131,88285,2022-07-26
CASH_IN,203875,Agence_moov_Cotonou,300000,96125,Théodore Bertin,-7793,196082,2022-07-02
CASH_IN,289889,Agence_moov_Ouidah,300000,10111,Théodore Bertin,196082,485971,2022-07-05
CASH_IN,89999,Agence_moov_Cotonou,300000,210001,Théodore Bertin,485971,575970,2022-07-05
CASH_OUT,559935,Théodore Bertin,575970,16035,Agence_moov_Abomey,300000,-259935,2022-07-06
CASH_OUT,7407,Théodore Bertin,16035,8628,Agence_moov_Cotonou,300000,292593,2022-07-12
CASH_OUT,2513,Théodore Bertin,8628,6115,Agence_moov_Cotonou,300000,297487,2022-07-13
TRANSFER,5491,Théodore Bertin,6115,624,Emmanuel-René Coulon,88285,82794,2022-07-16
TRANSFER,3581,Gilbert Bazin Le Guillet,16028,12447,Théodore Bertin,624,4205,2022-07-23
TRANSFER,400,Laurent Besson,1654,1254,Théodore Bertin,4205,4605,2022-07-24
CASH_IN,34933,Agence_moov_Ouidah,300000,265067,Théodore Bertin,4605,39538,2022-07-27
CASH_IN,171339,Agence_moov_Abomey,300000,128661,Théodore Bertin,39538,210877,2022-07-27
CASH_IN,290517,Agence_moov_Cotonou,300000,9483,Thierry Dos Santos-Le Roux,-184521,105996,2022-07-02
CASH_OUT,35811,Thierry Dos Santos-Le Roux,105996,70185,Agence_moov_Ouidah,300000,264189,2022-07-03
CASH_OUT,36748,Thierry Dos Santos-Le Roux,70185,33437,Agence_moov_Cotonou,300000,263252,2022-07-06
TRANSFER,161057,Luc-Tristan Moreau,186534,25477,Thierry Dos Santos-Le Roux,33437,194494,2022-07-07
TRANSFER,67433,Clémence Bertin,167980,100547,Thierry Dos Santos-Le Roux,194494,261927,2022-07-09
TRANSFER,836,Sabine Imbert,879,43,Thierry Dos Santos-Le Roux,261927,262763,2022-07-09
CASH_IN,109307,Agence_moov_Ouidah,300000,190693,Thierry Dos Santos-Le Roux,262763,372070,2022-07-10
TRANSFER,133,Marc Gilbert,139,6,Thierry Dos Santos-Le Roux,372070,372203,2022-07-13
CASH_IN,249260,Agence_moov_Ouidah,300000,50740,Thierry Dos Santos-Le Roux,372203,621463,2022-07-16
CASH_OUT,176751,Thierry Dos Santos-Le Roux,621463,444712,Agence_moov_Abomey,300000,123249,2022-07-23
CASH_OUT,247992,Thierry Dos Santos-Le Roux,444712,196720,Agence_moov_Cotonou,300000,52008,2022-07-27
CASH_IN,99607,Agence_moov_Ouidah,300000,200393,Nicole Lacroix,-281273,-181666,2022-07-04
CASH_IN,98663,Agence_moov_Cotonou,300000,201337,Nicole Lacroix,-181666,-83003,2022-07-05
CASH_IN,193781,Agence_moov_Ouidah,300000,106219,Nicole Lacroix,-83003,110778,2022-07-07
CASH_OUT,95269,Nicole Lacroix,110778,15509,Agence_moov_Abomey,300000,204731,2022-07-07
TRANSFER,10975,Nicole Lacroix,15509,4534,Léon Paris,378888,367913,2022-07-10
TRANSFER,1262,Nicole Lacroix,4534,3272,Nicole Lacroix,4534,3272,2022-07-11
CASH_IN,38396,Agence_moov_Cotonou,300000,261604,Nicole Lacroix,3272,41668,2022-07-14
CASH_IN,38966,Agence_moov_Ouidah,300000,261034,Nicole Lacroix,41668,80634,2022-07-14
CASH_OUT,75016,Nicole Lacroix,80634,5618,Agence_moov_Cotonou,300000,224984,2022-07-16
TRANSFER,62960,Clémence Bertin,100547,37587,Nicole Lacroix,5618,68578,2022-07-17
CASH_IN,20865,Agence_moov_Ouidah,300000,279135,Nicole Lacroix,68578,89443,2022-07-17
TRANSFER,35548,Nicole Lacroix,89443,53895,Emmanuel-René Coulon,82794,47246,2022-07-20
CASH_OUT,34901,Nicole Lacroix,53895,18994,Agence_moov_Abomey,300000,265099,2022-07-24
TRANSFER,12826,Nicole Lacroix,18994,6168,Léon Paris,367913,355087,2022-07-25
TRANSFER,4650,Emmanuel-René Coulon,47246,42596,Nicole Lacroix,6168,10818,2022-07-26
CASH_IN,67408,Agence_moov_Ouidah,300000,232592,Nicole Lacroix,10818,78226,2022-07-27
CASH_IN,281294,Agence_moov_Abomey,300000,18706,Sabine Imbert,43,281337,2022-07-01
CASH_OUT,184432,Sabine Imbert,281337,96905,Agence_moov_Ouidah,300000,115568,2022-07-03
CASH_IN,225997,Agence_moov_Abomey,300000,74003,Sabine Imbert,96905,322902,2022-07-05
CASH_IN,232932,Agence_moov_Abomey,300000,67068,Sabine Imbert,322902,555834,2022-07-09
CASH_OUT,553323,Sabine Imbert,555834,2511,Agence_moov_Ouidah,300000,-253323,2022-07-12
TRANSFER,644,Sabine Imbert,2511,1867,Clémence Bertin,37587,36943,2022-07-12
TRANSFER,680,Sabine Imbert,1867,1187,Gilbert Bazin Le Guillet,12447,11767,2022-07-15
CASH_OUT,710,Sabine Imbert,1187,477,Agence_moov_Ouidah,300000,299290,2022-07-15
CASH_IN,266645,Agence_moov_Abomey,300000,33355,Sabine Imbert,477,267122,2022-07-16
CASH_OUT,117473,Sabine Imbert,267122,149649,Agence_moov_Abomey,300000,182527,2022-07-17
CASH_IN,192940,Agence_moov_Abomey,300000,107060,Sabine Imbert,149649,342589,2022-07-18
CASH_IN,21918,Agence_moov_Cotonou,300000,278082,Sabine Imbert,342589,364507,2022-07-23
TRANSFER,191474,Sabine Imbert,364507,173033,Emmanuel-René Coulon,42596,-148878,2022-07-25
CASH_IN,287241,Agence_moov_Abomey,300000,12759,Sabine Imbert,173033,460274,2022-07-26
CASH_IN,256261,Agence_moov_Ouidah,300000,43739,Sabine Imbert,460274,716535,2022-07-27
CASH_IN,132878,Agence_moov_Abomey,300000,167122,Laurent Besson,1254,134132,2022-07-01
CASH_IN,133768,Agence_moov_Abomey,300000,166232,Laurent Besson,134132,267900,2022-07-02
TRANSFER,68368,Laurent Besson,267900,199532,Amélie de la Picard,55020,-13348,2022-07-04
TRANSFER,49250,Laurent Besson,199532,150282,Claudine Vallet,1230436,1181186,2022-07-05
CASH_IN,243097,Agence_moov_Cotonou,300000,56903,Laurent Besson,150282,393379,2022-07-05
CASH_OUT,357546,Laurent Besson,393379,35833,Agence_moov_Ouidah,300000,-57546,2022-07-06
CASH_IN,187167,Agence_moov_Abomey,300000,112833,Laurent Besson,35833,223000,2022-07-07
CASH_OUT,181839,Laurent Besson,223000,41161,Agence_moov_Cotonou,300000,118161,2022-07-09
CASH_IN,284211,Agence_moov_Ouidah,300000,15789,Laurent Besson,41161,325372,2022-07-10
TRANSFER,830994,Claudine Vallet,1181186,350192,Laurent Besson,325372,1156366,2022-07-11
CASH_OUT,360601,Laurent Besson,1156366,795765,Agence_moov_Cotonou,300000,-60601,2022-07-15
CASH_OUT,162903,Laurent Besson,795765,632862,Agence_moov_Ouidah,300000,137097,2022-07-16
TRANSFER,23561,Claudine Vallet,350192,326631,Laurent Besson,632862,656423,2022-07-16
CASH_OUT,102614,Laurent Besson,656423,553809,Agence_moov_Abomey,300000,197386,2022-07-17
CASH_OUT,347051,Laurent Besson,553809,206758,Agence_moov_Cotonou,300000,-47051,2022-07-19
CASH_IN,269840,Agence_moov_Cotonou,300000,30160,Laurent Besson,206758,476598,2022-07-20
CASH_IN,90429,Agence_moov_Abomey,300000,209571,Laurent Besson,476598,567027,2022-07-20
CASH_IN,281721,Agence_moov_Ouidah,300000,18279,Laurent Besson,567027,848748,2022-07-21
CASH_IN,299724,Agence_moov_Abomey,300000,276,Laurent Besson,848748,1148472,2022-07-21
CASH_OUT,1020611,Laurent Besson,1148472,127861,Agence_moov_Cotonou,300000,-720611,2022-07-23
CASH_IN,33898,Agence_moov_Abomey,300000,266102,Gabriel de Pineau,-41380,-7482,2022-07-03
CASH_IN,184221,Agence_moov_Abomey,300000,115779,Gabriel de Pineau,-7482,176739,2022-07-04
TRANSFER,162611,Gabriel de Pineau,176739,14128,Frédéric Moreau,644976,482365,2022-07-04
CASH_IN,76866,Agence_moov_Ouidah,300000,223134,Gabriel de Pineau,14128,90994,2022-07-06
CASH_OUT,21486,Gabriel de Pineau,90994,69508,Agence_moov_Ouidah,300000,278514,2022-07-07
TRANSFER,21152,Luc-Tristan Moreau,25477,4325,Gabriel de Pineau,69508,90660,2022-07-08
CASH_OUT,13024,Gabriel de Pineau,90660,77636,Agence_moov_Cotonou,300000,286976,2022-07-09
CASH_OUT,17963,Gabriel de Pineau,77636,59673,Agence_moov_Abomey,300000,282037,2022-07-13
TRANSFER,39603,Gabriel de Pineau,59673,20070,Gabriel de Pineau,59673,99276,2022-07-14
CASH_IN,216520,Agence_moov_Cotonou,300000,83480,Gabriel de Pineau,20070,236590,2022-07-17
TRANSFER,389512,Frédéric Moreau,482365,92853,Gabriel de Pineau,236590,626102,2022-07-19
CASH_IN,111355,Agence_moov_Ouidah,300000,188645,Diane-Françoise Raynaud,-48085,63270,2022-07-02
CASH_IN,255076,Agence_moov_Cotonou,300000,44924,Diane-Françoise Raynaud,63270,318346,2022-07-06
CASH_IN,276728,Agence_moov_Abomey,300000,23272,Diane-Françoise Raynaud,318346,595074,2022-07-07
CASH_IN,160476,Agence_moov_Ouidah,300000,139524,Diane-Françoise Raynaud,595074,755550,2022-07-07
TRANSFER,325124,Diane-Françoise Raynaud,755550,430426,Diane-Françoise Raynaud,755550,430426,2022-07-08
CASH_IN,214237,Agence_moov_Ouidah,300000,85763,Diane-Françoise Raynaud,430426,644663,2022-07-09
CASH_IN,178791,Agence_moov_Cotonou,300000,121209,Diane-Françoise Raynaud,644663,823454,2022-07-10
TRANSFER,153032,Diane-Françoise Raynaud,823454,670422,Diane-Françoise Raynaud,823454,976486,2022-07-13
TRANSFER,2623,Luc-Tristan Moreau,4325,1702,Diane-Françoise Raynaud,670422,673045,2022-07-14
TRANSFER,369133,Diane-Françoise Raynaud,673045,303912,Frédéric Moreau,92853,-276280,2022-07-14
CASH_OUT,268841,Diane-Françoise Raynaud,303912,35071,Agence_moov_Ouidah,300000,31159,2022-07-16
CASH_OUT,25760,Diane-Françoise Raynaud,35071,9311,Agence_moov_Cotonou,300000,274240,2022-07-16
TRANSFER,539,Diane-Françoise Raynaud,9311,8772,Claudine Vallet,326631,326092,2022-07-18
CASH_IN,232575,Agence_moov_Abomey,300000,67425,Diane-Françoise Raynaud,8772,241347,2022-07-22
CASH_OUT,167039,Diane-Françoise Raynaud,241347,74308,Agence_moov_Ouidah,300000,132961,2022-07-22
TRANSFER,660,Luc-Tristan Moreau,1702,1042,Diane-Françoise Raynaud,74308,74968,2022-07-22
TRANSFER,70195,Diane-Françoise Raynaud,74968,4773,Claudine Vallet,326092,255897,2022-07-23
CASH_OUT,4060,Diane-Françoise Raynaud,4773,713,Agence_moov_Abomey,300000,295940,2022-07-25
TRANSFER,113019,Claudine Vallet,255897,142878,Diane-Françoise Raynaud,713,113732,2022-07-25
TRANSFER,95835,Claudine Vallet,142878,47043,Claudine Vallet,142878,238713,2022-07-01
CASH_IN,162807,Agence_moov_Cotonou,300000,137193,Claudine Vallet,47043,209850,2022-07-03
CASH_OUT,28726,Claudine Vallet,209850,181124,Agence_moov_Ouidah,300000,271274,2022-07-04
CASH_IN,272459,Agence_moov_Abomey,300000,27541,Claudine Vallet,181124,453583,2022-07-04
CASH_IN,257399,Agence_moov_Abomey,300000,42601,Claudine Vallet,453583,710982,2022-07-06
CASH_OUT,629625,Claudine Vallet,710982,81357,Agence_moov_Cotonou,300000,-329625,2022-07-07
CASH_IN,276083,Agence_moov_Abomey,300000,23917,Claudine Vallet,81357,357440,2022-07-08
CASH_IN,57809,Agence_moov_Ouidah,300000,242191,Claudine Vallet,357440,415249,2022-07-11
CASH_OUT,271940,Claudine Vallet,415249,143309,Agence_moov_Abomey,300000,28060,2022-07-13
CASH_OUT,137480,Claudine Vallet,143309,5829,Agence_moov_Abomey,300000,162520,2022-07-15
CASH_OUT,4520,Claudine Vallet,5829,1309,Agence_moov_Abomey,300000,295480,2022-07-19
CASH_OUT,896,Claudine Vallet,1309,413,Agence_moov_Abomey,300000,299104,2022-07-20
CASH_OUT,309,Claudine Vallet,413,104,Agence_moov_Ouidah,300000,299691,2022-07-21
CASH_IN,104578,Agence_moov_Ouidah,300000,195422,Claudine Vallet,104,104682,2022-07-22
CASH_IN,70959,Agence_moov_Cotonou,300000,229041,Claudine Vallet,104682,175641,2022-07-23
CASH_OUT,90702,Claudine Vallet,175641,84939,Agence_moov_Abomey,300000,209298,2022-07-25
CASH_IN,233780,Agence_moov_Ouidah,300000,66220,Amélie Gros-Riou,-819820,-586040,2022-07-03
CASH_IN,12954,Agence_moov_Ouidah,300000,287046,Amélie Gros-Riou,-586040,-573086,2022-07-03
CASH_IN,104257,Agence_moov_Cotonou,300000,195743,Amélie Gros-Riou,-573086,-468829,2022-07-05
CASH_IN,107380,Agence_moov_Ouidah,300000,192620,Amélie Gros-Riou,-468829,-361449,2022-07-06
CASH_IN,210757,Agence_moov_Abomey,300000,89243,Amélie Gros-Riou,-361449,-150692,2022-07-06
CASH_IN,172355,Agence_moov_Ouidah,300000,127645,Amélie Gros-Riou,-150692,21663,2022-07-06
CASH_OUT,14333,Amélie Gros-Riou,21663,7330,Agence_moov_Ouidah,300000,285667,2022-07-08
CASH_OUT,6819,Amélie Gros-Riou,7330,511,Agence_moov_Cotonou,300000,293181,2022-07-13
CASH_OUT,394,Amélie Gros-Riou,511,117,Agence_moov_Ouidah,300000,299606,2022-07-13
CASH_OUT,107,Amélie Gros-Riou,117,10,Agence_moov_Abomey,300000,299893,2022-07-17
CASH_IN,255798,Agence_moov_Ouidah,300000,44202,Amélie Gros-Riou,10,255808,2022-07-17
CASH_OUT,130864,Amélie Gros-Riou,255808,124944,Agence_moov_Abomey,300000,169136,2022-07-17
CASH_OUT,116831,Amélie Gros-Riou,124944,8113,Agence_moov_Ouidah,300000,183169,2022-07-17
CASH_OUT,1779,Amélie Gros-Riou,8113,6334,Agence_moov_Ouidah,300000,298221,2022-07-18
CASH_OUT,440,Amélie Gros-Riou,6334,5894,Agence_moov_Abomey,300000,299560,2022-07-18
TRANSFER,3180,Amélie Gros-Riou,5894,2714,Amélie Gros-Riou,5894,2714,2022-07-19
CASH_OUT,577,Amélie Gros-Riou,2714,2137,Agence_moov_Abomey,300000,299423,2022-07-20
CASH_OUT,737,Amélie Gros-Riou,2137,1400,Agence_moov_Cotonou,300000,299263,2022-07-24
CASH_OUT,1111,Amélie Gros-Riou,1400,289,Agence_moov_Abomey,300000,298889,2022-07-24
CASH_IN,108175,Agence_moov_Ouidah,300000,191825,Matthieu Carpentier,-25124,83051,2022-07-03
CASH_IN,87569,Agence_moov_Cotonou,300000,212431,Matthieu Carpentier,83051,170620,2022-07-07
CASH_IN,34040,Agence_moov_Abomey,300000,265960,Matthieu Carpentier,170620,204660,2022-07-07
CASH_IN,32749,Agence_moov_Ouidah,300000,267251,Matthieu Carpentier,204660,237409,2022-07-09
CASH_IN,203513,Agence_moov_Cotonou,300000,96487,Matthieu Carpentier,237409,440922,2022-07-15
TRANSFER,159927,Matthieu Carpentier,440922,280995,Matthieu Carpentier,440922,280995,2022-07-15
CASH_OUT,268597,Matthieu Carpentier,280995,12398,Agence_moov_Ouidah,300000,31403,2022-07-19
TRANSFER,4510,Matthieu Carpentier,12398,7888,Matthieu Carpentier,12398,7888,2022-07-21
CASH_IN,105543,Agence_moov_Ouidah,300000,194457,Matthieu Carpentier,7888,113431,2022-07-23
CASH_IN,49722,Agence_moov_Ouidah,300000,250278,Matthieu Carpentier,113431,163153,2022-07-25
CASH_IN,217303,Agence_moov_Cotonou,300000,82697,Alexandre Poirier,-4392,212911,2022-07-02
CASH_OUT,80806,Alexandre Poirier,212911,132105,Agence_moov_Abomey,300000,219194,2022-07-02
CASH_IN,144064,Agence_moov_Abomey,300000,155936,Alexandre Poirier,132105,276169,2022-07-03
CASH_IN,125302,Agence_moov_Ouidah,300000,174698,Alexandre Poirier,276169,401471,2022-07-07
CASH_OUT,262392,Alexandre Poirier,401471,139079,Agence_moov_Abomey,300000,37608,2022-07-08
CASH_OUT,101421,Alexandre Poirier,139079,37658,Agence_moov_Ouidah,300000,198579,2022-07-13
CASH_OUT,13952,Alexandre Poirier,37658,23706,Agence_moov_Cotonou,300000,286048,2022-07-15
CASH_OUT,6081,Alexandre Poirier,23706,17625,Agence_moov_Cotonou,300000,293919,2022-07-16
CASH_IN,195146,Agence_moov_Ouidah,300000,104854,Alexandre Poirier,17625,212771,2022-07-22
CASH_IN,253714,Agence_moov_Ouidah,300000,46286,Laurence Dumont de Laroche,-229917,23797,2022-07-03
CASH_OUT,20937,Laurence Dumont de Laroche,23797,2860,Agence_moov_Cotonou,300000,279063,2022-07-03
CASH_OUT,354,Laurence Dumont de Laroche,2860,2506,Agence_moov_Cotonou,300000,299646,2022-07-05
TRANSFER,1104,Laurence Dumont de Laroche,2506,1402,Laurence Dumont de Laroche,2506,3610,2022-07-06
CASH_OUT,1046,Laurence Dumont de Laroche,1402,356,Agence_moov_Ouidah,300000,298954,2022-07-08
CASH_IN,293770,Agence_moov_Ouidah,300000,6230,Laurence Dumont de Laroche,356,294126,2022-07-17
CASH_IN,208637,Agence_moov_Ouidah,300000,91363,Laurence Dumont de Laroche,294126,502763,2022-07-17
CASH_IN,217414,Agence_moov_Cotonou,300000,82586,Laurence Dumont de Laroche,502763,720177,2022-07-18
CASH_IN,49576,Agence_moov_Cotonou,300000,250424,Laurence Dumont de Laroche,720177,769753,2022-07-23
CASH_OUT,459979,Laurence Dumont de Laroche,769753,309774,Agence_moov_Ouidah,300000,-159979,2022-07-23
CASH_IN,279314,Agence_moov_Ouidah,300000,20686,Isaac Le Pinto,-438570,-159256,2022-07-03
CASH_IN,43555,Agence_moov_Ouidah,300000,256445,Isaac Le Pinto,-159256,-115701,2022-07-13
CASH_IN,71857,Agence_moov_Ouidah,300000,228143,Isaac Le Pinto,-115701,-43844,2022-07-15
CASH_IN,129324,Agence_moov_Cotonou,300000,170676,Isaac Le Pinto,-43844,85480,2022-07-16
CASH_OUT,83793,Isaac Le Pinto,85480,1687,Agence_moov_Cotonou,300000,216207,2022-07-16
CASH_IN,95349,Agence_moov_Cotonou,300000,204651,Isaac Le Pinto,1687,97036,2022-07-19
CASH_OUT,96343,Isaac Le Pinto,97036,693,Agence_moov_Ouidah,300000,203657,2022-07-20
CASH_OUT,591,Isaac Le Pinto,693,102,Agence_moov_Abomey,300000,299409,2022-07-21
CASH_IN,80373,Agence_moov_Abomey,300000,219627,Isaac Le Pinto,102,80475,2022-07-22
CASH_IN,98590,Agence_moov_Abomey,300000,201410,Isaac Le Pinto,80475,179065,2022-07-22
CASH_OUT,44981,Isaac Le Pinto,179065,134084,Agence_moov_Cotonou,300000,255019,2022-07-26
CASH_IN,101906,Agence_moov_Cotonou,300000,198094,Alex Salmon,-376975,-275069,2022-07-01
CASH_IN,95702,Agence_moov_Cotonou,300000,204298,Alex Salmon,-275069,-179367,2022-07-02
CASH_IN,218887,Agence_moov_Abomey,300000,81113,Alex Salmon,-179367,39520,2022-07-05
CASH_OUT,22389,Alex Salmon,39520,17131,Agence_moov_Ouidah,300000,277611,2022-07-05
CASH_OUT,13415,Alex Salmon,17131,3716,Agence_moov_Ouidah,300000,286585,2022-07-08
TRANSFER,3000,Alex Salmon,3716,716,Alex Salmon,3716,6716,2022-07-12
TRANSFER,118,Alex Salmon,716,598,Alex Salmon,716,834,2022-07-13
CASH_IN,14282,Agence_moov_Abomey,300000,285718,Alex Salmon,598,14880,2022-07-18
CASH_OUT,6394,Alex Salmon,14880,8486,Agence_moov_Abomey,300000,293606,2022-07-27
CASH_IN,91155,Agence_moov_Abomey,300000,208845,Paulette Dias,-193199,-102044,2022-07-02
CASH_IN,279047,Agence_moov_Abomey,300000,20953,Paulette Dias,-102044,177003,2022-07-12
CASH_OUT,58159,Paulette Dias,177003,118844,Agence_moov_Abomey,300000,241841,2022-07-17
CASH_OUT,87607,Paulette Dias,118844,31237,Agence_moov_Cotonou,300000,212393,2022-07-18
CASH_OUT,13717,Paulette Dias,31237,17520,Agence_moov_Cotonou,300000,286283,2022-07-27
CASH_IN,206228,Agence_moov_Ouidah,300000,93772,Auguste Bousquet,-1846429,-1640201,2022-07-06
CASH_IN,106767,Agence_moov_Ouidah,300000,193233,Auguste Bousquet,-1640201,-1533434,2022-07-08
CASH_IN,272434,Agence_moov_Abomey,300000,27566,Auguste Bousquet,-1533434,-1261000,2022-07-09
CASH_IN,148940,Agence_moov_Cotonou,300000,151060,Auguste Bousquet,-1261000,-1112060,2022-07-10
CASH_IN,218745,Agence_moov_Abomey,300000,81255,Auguste Bousquet,-1112060,-893315,2022-07-11
CASH_IN,154232,Agence_moov_Cotonou,300000,145768,Auguste Bousquet,-893315,-739083,2022-07-14
CASH_IN,296770,Agence_moov_Cotonou,300000,3230,Auguste Bousquet,-739083,-442313,2022-07-15
CASH_IN,193925,Agence_moov_Cotonou,300000,106075,Auguste Bousquet,-442313,-248388,2022-07-17
CASH_IN,162125,Agence_moov_Abomey,300000,137875,Auguste Bousquet,-248388,-86263,2022-07-19
CASH_IN,66261,Agence_moov_Ouidah,300000,233739,Auguste Bousquet,-86263,-20002,2022-07-19
CASH_IN,244329,Agence_moov_Cotonou,300000,55671,Auguste Bousquet,-20002,224327,2022-07-22
CASH_IN,180826,Agence_moov_Ouidah,300000,119174,Auguste Bousquet,224327,405153,2022-07-23
CASH_OUT,267409,Auguste Bousquet,405153,137744,Agence_moov_Cotonou,300000,32591,2022-07-24
CASH_OUT,83412,Auguste Bousquet,137744,54332,Agence_moov_Abomey,300000,216588,2022-07-27
CASH_IN,268337,Agence_moov_Cotonou,300000,31663,Joseph de la Dubois,-458525,-190188,2022-07-01
CASH_IN,258339,Agence_moov_Abomey,300000,41661,Joseph de la Dubois,-190188,68151,2022-07-01
CASH_IN,192947,Agence_moov_Ouidah,300000,107053,Joseph de la Dubois,68151,261098,2022-07-05
TRANSFER,127625,Joseph de la Dubois,261098,133473,Joseph de la Dubois,261098,133473,2022-07-06
CASH_OUT,107373,Joseph de la Dubois,133473,26100,Agence_moov_Ouidah,300000,192627,2022-07-06
CASH_IN,87191,Agence_moov_Abomey,300000,212809,Joseph de la Dubois,26100,113291,2022-07-07
TRANSFER,66668,Joseph de la Dubois,113291,46623,Joseph de la Dubois,113291,46623,2022-07-07
CASH_IN,241370,Agence_moov_Cotonou,300000,58630,Joseph de la Dubois,46623,287993,2022-07-10
TRANSFER,273172,Joseph de la Dubois,287993,14821,Joseph de la Dubois,287993,561165,2022-07-11
CASH_IN,127952,Agence_moov_Abomey,300000,172048,Joseph de la Dubois,14821,142773,2022-07-17
CASH_OUT,57861,Joseph de la Dubois,142773,84912,Agence_moov_Cotonou,300000,242139,2022-07-17
CASH_IN,150941,Agence_moov_Ouidah,300000,149059,Joseph de la Dubois,84912,235853,2022-07-18
CASH_OUT,16895,Joseph de la Dubois,235853,218958,Agence_moov_Ouidah,300000,283105,2022-07-20
CASH_IN,62482,Agence_moov_Abomey,300000,237518,Joseph de la Dubois,218958,281440,2022-07-21
CASH_IN,260616,Agence_moov_Cotonou,300000,39384,Joseph de la Dubois,281440,542056,2022-07-22
CASH_IN,76441,Agence_moov_Abomey,300000,223559,Amélie de la Picard,-13348,63093,2022-07-06
CASH_OUT,27668,Amélie de la Picard,63093,35425,Agence_moov_Cotonou,300000,272332,2022-07-07
CASH_IN,153345,Agence_moov_Ouidah,300000,146655,Amélie de la Picard,35425,188770,2022-07-09
CASH_IN,235380,Agence_moov_Cotonou,300000,64620,Amélie de la Picard,188770,424150,2022-07-11
CASH_IN,58419,Agence_moov_Ouidah,300000,241581,Amélie de la Picard,424150,482569,2022-07-12
CASH_IN,262126,Agence_moov_Cotonou,300000,37874,Amélie de la Picard,482569,744695,2022-07-17
CASH_OUT,378450,Amélie de la Picard,744695,366245,Agence_moov_Ouidah,300000,-78450,2022-07-18
CASH_IN,96985,Agence_moov_Ouidah,300000,203015,Amélie de la Picard,366245,463230,2022-07-21
CASH_OUT,65485,Amélie de la Picard,463230,397745,Agence_moov_Ouidah,300000,234515,2022-07-23
CASH_OUT,241664,Amélie de la Picard,397745,156081,Agence_moov_Cotonou,300000,58336,2022-07-25
CASH_IN,38499,Agence_moov_Ouidah,300000,261501,Nath Léger,-19935,18564,2022-07-04
TRANSFER,1972,Nath Léger,18564,16592,Nath Léger,18564,20536,2022-07-06
TRANSFER,12710,Nath Léger,16592,3882,Nath Léger,16592,29302,2022-07-07
TRANSFER,1827,Nath Léger,3882,2055,Nath Léger,3882,2055,2022-07-10
CASH_IN,101169,Agence_moov_Abomey,300000,198831,Nath Léger,2055,103224,2022-07-12
CASH_OUT,65660,Nath Léger,103224,37564,Agence_moov_Abomey,300000,234340,2022-07-13
CASH_OUT,32851,Nath Léger,37564,4713,Agence_moov_Abomey,300000,267149,2022-07-17
CASH_IN,85797,Agence_moov_Cotonou,300000,214203,Nath Léger,4713,90510,2022-07-21
CASH_OUT,879,Nath Léger,90510,89631,Agence_moov_Abomey,300000,299121,2022-07-22
CASH_IN,79714,Agence_moov_Abomey,300000,220286,Valentine Traore,-136475,-56761,2022-07-01
CASH_IN,128762,Agence_moov_Ouidah,300000,171238,Valentine Traore,-56761,72001,2022-07-02
CASH_IN,163742,Agence_moov_Ouidah,300000,136258,Valentine Traore,72001,235743,2022-07-04
TRANSFER,101282,Valentine Traore,235743,134461,Valentine Traore,235743,134461,2022-07-10
TRANSFER,82151,Valentine Traore,134461,52310,Valentine Traore,134461,216612,2022-07-12
CASH_OUT,36231,Valentine Traore,52310,16079,Agence_moov_Abomey,300000,263769,2022-07-13
CASH_OUT,5974,Valentine Traore,16079,10105,Agence_moov_Cotonou,300000,294026,2022-07-16
TRANSFER,3698,Valentine Traore,10105,6407,Valentine Traore,10105,13803,2022-07-17
CASH_OUT,5454,Valentine Traore,6407,953,Agence_moov_Ouidah,300000,294546,2022-07-23
CASH_OUT,925,Valentine Traore,953,28,Agence_moov_Abomey,300000,299075,2022-07-27
CASH_IN,274269,Agence_moov_Ouidah,300000,25731,Guy Guyon,-82266,192003,2022-07-01
TRANSFER,103547,Guy Guyon,192003,88456,Guy Guyon,192003,88456,2022-07-03
CASH_OUT,61679,Guy Guyon,88456,26777,Agence_moov_Abomey,300000,238321,2022-07-04
CASH_IN,200170,Agence_moov_Cotonou,300000,99830,Guy Guyon,26777,226947,2022-07-07
CASH_IN,256198,Agence_moov_Abomey,300000,43802,Guy Guyon,226947,483145,2022-07-09
CASH_OUT,7296,Guy Guyon,483145,475849,Agence_moov_Cotonou,300000,292704,2022-07-09
CASH_IN,260984,Agence_moov_Abomey,300000,39016,Guy Guyon,475849,736833,2022-07-10
CASH_OUT,521866,Guy Guyon,736833,214967,Agence_moov_Cotonou,300000,-221866,2022-07-13
CASH_IN,147129,Agence_moov_Ouidah,300000,152871,Guy Guyon,214967,362096,2022-07-15
CASH_IN,5708,Agence_moov_Cotonou,300000,294292,Guy Guyon,362096,367804,2022-07-19
CASH_OUT,115081,Guy Guyon,367804,252723,Agence_moov_Abomey,300000,184919,2022-07-22
CASH_OUT,13247,Guy Guyon,252723,239476,Agence_moov_Abomey,300000,286753,2022-07-26
CASH_IN,231657,Agence_moov_Cotonou,300000,68343,Frédéric Moreau,-276280,-44623,2022-07-01
CASH_IN,295997,Agence_moov_Ouidah,300000,4003,Frédéric Moreau,-44623,251374,2022-07-03
TRANSFER,1179,Frédéric Moreau,251374,250195,Frédéric Moreau,251374,250195,2022-07-08
TRANSFER,73686,Frédéric Moreau,250195,176509,Frédéric Moreau,250195,176509,2022-07-11
TRANSFER,52244,Frédéric Moreau,176509,124265,Frédéric Moreau,176509,228753,2022-07-12
CASH_IN,223075,Agence_moov_Cotonou,300000,76925,Frédéric Moreau,124265,347340,2022-07-13
CASH_IN,58073,Agence_moov_Cotonou,300000,241927,Frédéric Moreau,347340,405413,2022-07-16
CASH_OUT,96448,Frédéric Moreau,405413,308965,Agence_moov_Cotonou,300000,203552,2022-07-19
CASH_IN,231540,Agence_moov_Cotonou,300000,68460,Frédéric Moreau,308965,540505,2022-07-20
CASH_OUT,199600,Frédéric Moreau,540505,340905,Agence_moov_Abomey,300000,100400,2022-07-22
CASH_OUT,292140,Frédéric Moreau,340905,48765,Agence_moov_Cotonou,300000,7860,2022-07-22
CASH_OUT,17917,Frédéric Moreau,48765,30848,Agence_moov_Cotonou,300000,282083,2022-07-23
CASH_IN,279760,Agence_moov_Abomey,300000,20240,Lucy Vaillant,-122007,157753,2022-07-02
CASH_IN,25640,Agence_moov_Cotonou,300000,274360,Lucy Vaillant,157753,183393,2022-07-06
TRANSFER,60185,Lucy Vaillant,183393,123208,Lucy Vaillant,183393,243578,2022-07-07
CASH_IN,253367,Agence_moov_Ouidah,300000,46633,Lucy Vaillant,123208,376575,2022-07-07
TRANSFER,360224,Lucy Vaillant,376575,16351,Lucy Vaillant,376575,736799,2022-07-09
CASH_OUT,9103,Lucy Vaillant,16351,7248,Agence_moov_Cotonou,300000,290897,2022-07-10
CASH_IN,237976,Agence_moov_Cotonou,300000,62024,Lucy Vaillant,7248,245224,2022-07-10
TRANSFER,122212,Lucy Vaillant,245224,123012,Lucy Vaillant,245224,367436,2022-07-14
TRANSFER,43782,Lucy Vaillant,123012,79230,Lucy Vaillant,123012,166794,2022-07-15
TRANSFER,59912,Lucy Vaillant,79230,19318,Lucy Vaillant,79230,139142,2022-07-20
CASH_OUT,13687,Lucy Vaillant,19318,5631,Agence_moov_Abomey,300000,286313,2022-07-23
CASH_IN,78641,Agence_moov_Abomey,300000,221359,Lucy Vaillant,5631,84272,2022-07-25
CASH_OUT,50331,Lucy Vaillant,84272,33941,Agence_moov_Cotonou,300000,249669,2022-07-26
CASH_IN,18381,Agence_moov_Cotonou,300000,281619,Marc Gilbert,6,18387,2022-07-01
CASH_OUT,7533,Marc Gilbert,18387,10854,Agence_moov_Abomey,300000,292467,2022-07-01
CASH_OUT,5978,Marc Gilbert,10854,4876,Agence_moov_Ouidah,300000,294022,2022-07-02
CASH_IN,281400,Agence_moov_Ouidah,300000,18600,Marc Gilbert,4876,286276,2022-07-02
CASH_OUT,272070,Marc Gilbert,286276,14206,Agence_moov_Abomey,300000,27930,2022-07-18
CASH_OUT,10397,Marc Gilbert,14206,3809,Agence_moov_Abomey,300000,289603,2022-07-23
CASH_OUT,199,Marc Gilbert,3809,3610,Agence_moov_Abomey,300000,299801,2022-07-23
CASH_IN,251704,Agence_moov_Cotonou,300000,48296,Marc Gilbert,3610,255314,2022-07-25
CASH_IN,137206,Agence_moov_Ouidah,300000,162794,Aimé Allain,-38943,98263,2022-07-06
CASH_OUT,16893,Aimé Allain,98263,81370,Agence_moov_Cotonou,300000,283107,2022-07-06
CASH_OUT,2872,Aimé Allain,81370,78498,Agence_moov_Abomey,300000,297128,2022-07-06
TRANSFER,57075,Aimé Allain,78498,21423,Aimé Allain,78498,21423,2022-07-07
CASH_IN,132540,Agence_moov_Cotonou,300000,167460,Aimé Allain,21423,153963,2022-07-09
CASH_OUT,96353,Aimé Allain,153963,57610,Agence_moov_Ouidah,300000,203647,2022-07-11
CASH_OUT,35492,Aimé Allain,57610,22118,Agence_moov_Ouidah,300000,264508,2022-07-12
CASH_OUT,8928,Aimé Allain,22118,13190,Agence_moov_Abomey,300000,291072,2022-07-12
CASH_OUT,7970,Aimé Allain,13190,5220,Agence_moov_Cotonou,300000,292030,2022-07-16
CASH_OUT,1465,Aimé Allain,5220,3755,Agence_moov_Cotonou,300000,298535,2022-07-19
CASH_IN,40527,Agence_moov_Cotonou,300000,259473,Aimé Allain,3755,44282,2022-07-19
CASH_IN,47583,Agence_moov_Abomey,300000,252417,Nicolas Grondin de la Pinto,-240415,-192832,2022-07-03
CASH_IN,127698,Agence_moov_Abomey,300000,172302,Nicolas Grondin de la Pinto,-192832,-65134,2022-07-04
CASH_IN,210182,Agence_moov_Abomey,300000,89818,Nicolas Grondin de la Pinto,-65134,145048,2022-07-07
CASH_OUT,34561,Nicolas Grondin de la Pinto,145048,110487,Agence_moov_Abomey,300000,265439,2022-07-08
CASH_OUT,38427,Nicolas Grondin de la Pinto,110487,72060,Agence_moov_Abomey,300000,261573,2022-07-11
CASH_OUT,37773,Nicolas Grondin de la Pinto,72060,34287,Agence_moov_Ouidah,300000,262227,2022-07-12
CASH_IN,15133,Agence_moov_Ouidah,300000,284867,Nicolas Grondin de la Pinto,34287,49420,2022-07-19
CASH_IN,114480,Agence_moov_Abomey,300000,185520,Nicolas Grondin de la Pinto,49420,163900,2022-07-20
CASH_OUT,146768,Nicolas Grondin de la Pinto,163900,17132,Agence_moov_Abomey,300000,153232,2022-07-27
CASH_IN,277281,Agence_moov_Ouidah,300000,22719,Matthieu Renard,-751415,-474134,2022-07-01
CASH_IN,260732,Agence_moov_Cotonou,300000,39268,Matthieu Renard,-474134,-213402,2022-07-05
CASH_IN,70581,Agence_moov_Abomey,300000,229419,Matthieu Renard,-213402,-142821,2022-07-05
CASH_IN,288311,Agence_moov_Cotonou,300000,11689,Matthieu Renard,-142821,145490,2022-07-06
CASH_OUT,47115,Matthieu Renard,145490,98375,Agence_moov_Abomey,300000,252885,2022-07-18
CASH_IN,164853,Agence_moov_Cotonou,300000,135147,Benoît Verdier,-141164,23689,2022-07-01
CASH_OUT,17746,Benoît Verdier,23689,5943,Agence_moov_Ouidah,300000,282254,2022-07-02
CASH_IN,274410,Agence_moov_Abomey,300000,25590,Benoît Verdier,5943,280353,2022-07-03
CASH_OUT,64799,Benoît Verdier,280353,215554,Agence_moov_Abomey,300000,235201,2022-07-06
TRANSFER,57857,Benoît Verdier,215554,157697,Benoît Verdier,215554,157697,2022-07-10
CASH_IN,112092,Agence_moov_Abomey,300000,187908,Benoît Verdier,157697,269789,2022-07-14
TRANSFER,81692,Benoît Verdier,269789,188097,Benoît Verdier,269789,188097,2022-07-14
CASH_IN,72104,Agence_moov_Cotonou,300000,227896,Benoît Verdier,188097,260201,2022-07-16
CASH_IN,292867,Agence_moov_Abomey,300000,7133,Benoît Verdier,260201,553068,2022-07-20
CASH_IN,112325,Agence_moov_Abomey,300000,187675,Benoît Verdier,553068,665393,2022-07-23
CASH_IN,8756,Agence_moov_Abomey,300000,291244,Benoît Verdier,665393,674149,2022-07-26
CASH_IN,169017,Agence_moov_Ouidah,300000,130983,Antoine Leroux,-57181,111836,2022-07-03
TRANSFER,81287,Antoine Leroux,111836,30549,Antoine Leroux,111836,193123,2022-07-03
CASH_IN,124143,Agence_moov_Cotonou,300000,175857,Antoine Leroux,30549,154692,2022-07-06
CASH_OUT,103104,Antoine Leroux,154692,51588,Agence_moov_Abomey,300000,196896,2022-07-07
CASH_IN,130470,Agence_moov_Abomey,300000,169530,Antoine Leroux,51588,182058,2022-07-08
CASH_IN,226778,Agence_moov_Ouidah,300000,73222,Antoine Leroux,182058,408836,2022-07-11
CASH_OUT,190130,Antoine Leroux,408836,218706,Agence_moov_Ouidah,300000,109870,2022-07-12
CASH_OUT,116391,Antoine Leroux,218706,102315,Agence_moov_Ouidah,300000,183609,2022-07-16
CASH_IN,35985,Agence_moov_Abomey,300000,264015,Antoine Leroux,102315,138300,2022-07-16
CASH_IN,128508,Agence_moov_Ouidah,300000,171492,Antoine Leroux,138300,266808,2022-07-17
CASH_OUT,116587,Antoine Leroux,266808,150221,Agence_moov_Abomey,300000,183413,2022-07-24
CASH_IN,169469,Agence_moov_Cotonou,300000,130531,Antoine Leroux,150221,319690,2022-07-24
CASH_IN,70483,Agence_moov_Abomey,300000,229517,Antoine Leroux,319690,390173,2022-07-27
TRANSFER,1402136,Émilie Guillon de Duhamel,1676800,274664,Gabriel de Pineau,811800,2213936,2022-08-07
CASH_OUT,1666302,Gabriel de Pineau,2213936,547634,Agence_moov_Ouidah,300000,-1366302,2022-08-24
CASH_OUT,459679,Amélie Gros-Riou,1486300,1026621,Agence_moov_Abomey,300000,-159679,2022-08-06
CASH_OUT,761553,Amélie Gros-Riou,1026621,265068,Agence_moov_Abomey,300000,-461553,2022-08-20
CASH_IN,211767,Agence_moov_Abomey,300000,88233,Claudine Vallet,783800,995567,2022-08-09
CASH_IN,106367,Agence_moov_Abomey,300000,193633,Claudine Vallet,995567,1101934,2022-08-15
TRANSFER,404983,Claudine Vallet,1101934,696951,Grégoire Delmas de Blanchard,1419900,1014917,2022-08-15
TRANSFER,47152,Claudine Vallet,696951,649799,Marianne Descamps,884100,836948,2022-08-23
CASH_OUT,778057,Matthieu Carpentier,1228900,450843,Agence_moov_Ouidah,300000,-478057,2022-08-16
CASH_OUT,1173389,Richard Guibert,1615900,442511,Agence_moov_Abomey,300000,-873389,2022-08-06
CASH_OUT,237250,Richard Guibert,442511,205261,Agence_moov_Ouidah,300000,62750,2022-08-08
CASH_IN,92641,Agence_moov_Cotonou,300000,207359,Richard Guibert,205261,297902,2022-08-08
CASH_IN,39017,Agence_moov_Cotonou,300000,260983,Richard Guibert,297902,336919,2022-08-12
CASH_IN,299459,Agence_moov_Cotonou,300000,541,Richard Guibert,336919,636378,2022-08-14
CASH_OUT,89616,Laurence Dumont de Laroche,402700,313084,Agence_moov_Abomey,300000,210384,2022-08-06
CASH_IN,13691,Agence_moov_Abomey,300000,286309,Laurence Dumont de Laroche,313084,326775,2022-08-13
CASH_IN,235219,Agence_moov_Cotonou,300000,64781,Laurence Dumont de Laroche,326775,561994,2022-08-26
CASH_IN,119416,Agence_moov_Cotonou,300000,180584,Isaac Le Pinto,1618300,1737716,2022-08-01
CASH_IN,96565,Agence_moov_Ouidah,300000,203435,Isaac Le Pinto,1737716,1834281,2022-08-04
CASH_IN,71825,Agence_moov_Ouidah,300000,228175,Isaac Le Pinto,1834281,1906106,2022-08-04
CASH_OUT,1149515,Isaac Le Pinto,1906106,756591,Agence_moov_Cotonou,300000,-849515,2022-08-10
TRANSFER,195552,Emmanuelle Gilbert,1573500,1377948,Noël Hamel,1886100,2081652,2022-08-12
CASH_IN,20742,Agence_moov_Abomey,300000,279258,Grégoire Delmas de Blanchard,1014917,1035659,2022-08-05
CASH_IN,176987,Agence_moov_Ouidah,300000,123013,Grégoire Delmas de Blanchard,1035659,1212646,2022-08-21
CASH_IN,151617,Agence_moov_Ouidah,300000,148383,Grégoire Delmas de Blanchard,1212646,1364263,2022-08-26
CASH_OUT,272534,Juliette Evrard Le Giraud,454000,181466,Agence_moov_Cotonou,300000,27466,2022-08-09
CASH_OUT,172749,Juliette Evrard Le Giraud,181466,8717,Agence_moov_Cotonou,300000,127251,2022-08-11
CASH_IN,131648,Agence_moov_Cotonou,300000,168352,Juliette Evrard Le Giraud,8717,140365,2022-08-17
TRANSFER,1801872,Aimé Allain,1921300,119428,Paul Pereira,493800,-1308072,2022-08-15
TRANSFER,35330,Laurent Perrot,66600,31270,Léon Paris,218900,254230,2022-08-02
CASH_IN,69880,Agence_moov_Abomey,300000,230120,Léon Paris,254230,324110,2022-08-14
CASH_OUT,5582,Léon Paris,324110,318528,Agence_moov_Abomey,300000,294418,2022-08-25
TRANSFER,58626,Léon Paris,318528,259902,Julie Robin de Gros,496400,437774,2022-08-26
CASH_IN,158449,Agence_moov_Abomey,300000,141551,Léon Paris,259902,418351,2022-08-27
CASH_OUT,1838681,Marc Gilbert,1905100,66419,Agence_moov_Abomey,300000,-1538681,2022-08-17
CASH_OUT,23287,Marc Gilbert,66419,43132,Agence_moov_Cotonou,300000,276713,2022-08-18
CASH_OUT,22076,Marc Gilbert,43132,21056,Agence_moov_Ouidah,300000,277924,2022-08-19
CASH_IN,99101,Agence_moov_Ouidah,300000,200899,Marc Gilbert,21056,120157,2022-08-19
TRANSFER,491489,Sébastien-Arthur Masse,1980500,1489011,Caroline Monnier,948600,457111,2022-08-03
TRANSFER,29866,Sabine Imbert,1498400,1468534,Sébastien-Arthur Masse,1489011,1518877,2022-08-04
CASH_IN,46164,Agence_moov_Ouidah,300000,253836,Sébastien-Arthur Masse,1518877,1565041,2022-08-12
CASH_IN,219678,Agence_moov_Abomey,300000,80322,Sébastien-Arthur Masse,1565041,1784719,2022-08-16
TRANSFER,1398675,Sébastien-Arthur Masse,1784719,386044,Alphonse Dupont-Petit,1650600,251925,2022-08-21
TRANSFER,64640,Laurent Besson,208300,143660,Laurent Besson,208300,143660,2022-08-09
CASH_OUT,3459,Laurent Besson,143660,140201,Agence_moov_Ouidah,300000,296541,2022-08-13
CASH_IN,258351,Agence_moov_Ouidah,300000,41649,Laurent Besson,140201,398552,2022-08-22
CASH_IN,273293,Agence_moov_Ouidah,300000,26707,Laurent Besson,398552,671845,2022-08-25
CASH_IN,153069,Agence_moov_Ouidah,300000,146931,Laurent Besson,671845,824914,2022-08-25
CASH_IN,220176,Agence_moov_Cotonou,300000,79824,Adrienne Arnaud,1078700,1298876,2022-08-02
CASH_OUT,103149,Marine-Clémence Ferreira,190300,87151,Agence_moov_Ouidah,300000,196851,2022-08-03
CASH_OUT,7404,Marine-Clémence Ferreira,87151,79747,Agence_moov_Ouidah,300000,292596,2022-08-11
CASH_OUT,78421,Marine-Clémence Ferreira,79747,1326,Agence_moov_Ouidah,300000,221579,2022-08-26
CASH_OUT,853165,Paul De Sousa,1260500,407335,Agence_moov_Abomey,300000,-553165,2022-08-02
CASH_IN,52007,Agence_moov_Abomey,300000,247993,Paul De Sousa,407335,459342,2022-08-05
CASH_IN,163703,Agence_moov_Abomey,300000,136297,Paul De Sousa,459342,623045,2022-08-19
CASH_OUT,546943,Paul De Sousa,623045,76102,Agence_moov_Cotonou,300000,-246943,2022-08-21
TRANSFER,205622,Paulette Dias,840700,635078,Paul De Sousa,76102,281724,2022-08-27
CASH_IN,177240,Agence_moov_Cotonou,300000,122760,Vincent-Philippe Rossi,1254600,1431840,2022-08-01
TRANSFER,268576,Vincent-Philippe Rossi,1431840,1163264,Stéphanie Bonneau,70100,-198476,2022-08-04
TRANSFER,40408,Christine-Constance Gauthier,378200,337792,Vincent-Philippe Rossi,1163264,1203672,2022-08-16
TRANSFER,1196647,Vincent-Philippe Rossi,1203672,7025,Vincent-Philippe Rossi,1203672,2400319,2022-08-20
CASH_OUT,342125,Maryse Lebreton,713700,371575,Agence_moov_Ouidah,300000,-42125,2022-08-23
TRANSFER,387578,Frédéric Moreau,1554300,1166722,Maryse Lebreton,371575,759153,2022-08-27
CASH_IN,245646,Agence_moov_Abomey,300000,54354,Emmanuel-René Coulon,1129500,1375146,2022-08-08
CASH_IN,89974,Agence_moov_Ouidah,300000,210026,Paulette Dias,635078,725052,2022-08-15
TRANSFER,159264,Paulette Dias,725052,565788,Élodie Gérard,298900,139636,2022-08-19
CASH_IN,262408,Agence_moov_Cotonou,300000,37592,Paulette Dias,565788,828196,2022-08-25
CASH_IN,109760,Agence_moov_Ouidah,300000,190240,Paulette Dias,828196,937956,2022-08-26
CASH_IN,160863,Agence_moov_Ouidah,300000,139137,Amélie de la Picard,864900,1025763,2022-08-09
TRANSFER,8229,Laurent Perrot,31270,23041,Amélie de la Picard,1025763,1033992,2022-08-11
TRANSFER,306307,Alfred Chrétien,459700,153393,Amélie de la Picard,1033992,1340299,2022-08-14
TRANSFER,437477,Sabine Imbert,1468534,1031057,Amélie de la Picard,1340299,1777776,2022-08-16
TRANSFER,1169180,Amélie de la Picard,1777776,608596,Luc-Tristan Moreau,945200,-223980,2022-08-18
CASH_OUT,737378,Diane-Françoise Raynaud,1049200,311822,Agence_moov_Ouidah,300000,-437378,2022-08-15
CASH_IN,280102,Agence_moov_Cotonou,300000,19898,David-Théodore Diaz,1781700,2061802,2022-08-08
CASH_IN,138017,Agence_moov_Ouidah,300000,161983,David-Théodore Diaz,2061802,2199819,2022-08-11
TRANSFER,652499,David-Théodore Diaz,2199819,1547320,Stéphane-Timothée Pineau,745700,93201,2022-08-12
TRANSFER,190545,David-Théodore Diaz,1547320,1356775,Océane Boutin,966600,776055,2022-08-18
CASH_IN,171560,Agence_moov_Abomey,300000,128440,David-Théodore Diaz,1356775,1528335,2022-08-23
CASH_IN,45681,Agence_moov_Ouidah,300000,254319,Nicolas Hervé,1255000,1300681,2022-08-01
CASH_IN,272714,Agence_moov_Ouidah,300000,27286,Nicolas Hervé,1300681,1573395,2022-08-02
CASH_IN,10570,Agence_moov_Cotonou,300000,289430,Nicolas Hervé,1573395,1583965,2022-08-02
CASH_OUT,1373476,Nicolas Hervé,1583965,210489,Agence_moov_Abomey,300000,-1073476,2022-08-05
TRANSFER,109932,Nicolas Hervé,210489,100557,Christophe Alexandre,627200,517268,2022-08-05
CASH_OUT,72835,Nicolas Hervé,100557,27722,Agence_moov_Cotonou,300000,227165,2022-08-06
CASH_OUT,3295,Nicolas Hervé,27722,24427,Agence_moov_Cotonou,300000,296705,2022-08-06
CASH_IN,58256,Agence_moov_Cotonou,300000,241744,Nicolas Hervé,24427,82683,2022-08-08
CASH_IN,79091,Agence_moov_Cotonou,300000,220909,Nicolas Hervé,82683,161774,2022-08-09
TRANSFER,231,Anastasie Louis,10200,9969,Nicolas Hervé,161774,162005,2022-08-10
TRANSFER,16773,Augustin Benard,58100,41327,Nicolas Hervé,162005,178778,2022-08-11
CASH_IN,108360,Agence_moov_Abomey,300000,191640,Nicolas Hervé,178778,287138,2022-08-12
CASH_OUT,181166,Nicolas Hervé,287138,105972,Agence_moov_Abomey,300000,118834,2022-08-13
CASH_IN,84141,Agence_moov_Ouidah,300000,215859,Nicolas Hervé,105972,190113,2022-08-13
CASH_OUT,133088,Nicolas Hervé,190113,57025,Agence_moov_Cotonou,300000,166912,2022-08-16
CASH_OUT,8018,Nicolas Hervé,57025,49007,Agence_moov_Abomey,300000,291982,2022-08-17
CASH_IN,133654,Agence_moov_Abomey,300000,166346,Nicolas Hervé,49007,182661,2022-08-18
TRANSFER,17925,Auguste Bousquet,1046800,1028875,Nicolas Hervé,182661,200586,2022-08-18
CASH_IN,171879,Agence_moov_Cotonou,300000,128121,Nicolas Hervé,200586,372465,2022-08-19
CASH_IN,94179,Agence_moov_Cotonou,300000,205821,Nicolas Hervé,372465,466644,2022-08-20
CASH_OUT,311348,Nicolas Hervé,466644,155296,Agence_moov_Cotonou,300000,-11348,2022-08-20
TRANSFER,147381,Nicolas Hervé,155296,7915,Marianne Descamps,836948,689567,2022-08-20
CASH_IN,226555,Agence_moov_Ouidah,300000,73445,Nicolas Hervé,7915,234470,2022-08-20
CASH_OUT,113222,Nicolas Hervé,234470,121248,Agence_moov_Ouidah,300000,186778,2022-08-22
CASH_OUT,25240,Nicolas Hervé,121248,96008,Agence_moov_Cotonou,300000,274760,2022-08-23
TRANSFER,5359,Nicolas Hervé,96008,90649,Caroline Peltier,773800,768441,2022-08-25
CASH_OUT,52560,Nicolas Hervé,90649,38089,Agence_moov_Abomey,300000,247440,2022-08-26
CASH_OUT,25616,Nicolas Hervé,38089,12473,Agence_moov_Abomey,300000,274384,2022-08-26
TRANSFER,208865,Alphonse Dupont-Petit,251925,43060,Nicolas Hervé,12473,221338,2022-08-26
CASH_IN,157240,Agence_moov_Abomey,300000,142760,Luc-Tristan Moreau,-223980,-66740,2022-08-02
CASH_IN,268413,Agence_moov_Cotonou,300000,31587,Luc-Tristan Moreau,-66740,201673,2022-08-05
CASH_IN,127727,Agence_moov_Abomey,300000,172273,Luc-Tristan Moreau,201673,329400,2022-08-08
CASH_OUT,76228,Luc-Tristan Moreau,329400,253172,Agence_moov_Abomey,300000,223772,2022-08-08
CASH_OUT,139095,Luc-Tristan Moreau,253172,114077,Agence_moov_Cotonou,300000,160905,2022-08-09
CASH_OUT,37718,Luc-Tristan Moreau,114077,76359,Agence_moov_Abomey,300000,262282,2022-08-10
TRANSFER,71588,Luc-Tristan Moreau,76359,4771,Christine-Constance Gauthier,337792,266204,2022-08-11
CASH_OUT,420,Luc-Tristan Moreau,4771,4351,Agence_moov_Abomey,300000,299580,2022-08-12
TRANSFER,273170,Lucy Vaillant,880600,607430,Luc-Tristan Moreau,4351,277521,2022-08-12
CASH_OUT,271002,Luc-Tristan Moreau,277521,6519,Agence_moov_Cotonou,300000,28998,2022-08-13
CASH_OUT,3750,Luc-Tristan Moreau,6519,2769,Agence_moov_Ouidah,300000,296250,2022-08-14
CASH_OUT,2008,Luc-Tristan Moreau,2769,761,Agence_moov_Cotonou,300000,297992,2022-08-14
CASH_OUT,231,Luc-Tristan Moreau,761,530,Agence_moov_Abomey,300000,299769,2022-08-20
CASH_OUT,518,Luc-Tristan Moreau,530,12,Agence_moov_Abomey,300000,299482,2022-08-20
CASH_IN,139666,Agence_moov_Cotonou,300000,160334,Luc-Tristan Moreau,12,139678,2022-08-21
TRANSFER,70090,Bernadette Fabre,148800,78710,Luc-Tristan Moreau,139678,209768,2022-08-22
TRANSFER,909790,Antoine Leroux,1920000,1010210,Luc-Tristan Moreau,209768,1119558,2022-08-22
TRANSFER,7964,Agnès Baron,350100,342136,Luc-Tristan Moreau,1119558,1127522,2022-08-22
CASH_OUT,617629,Luc-Tristan Moreau,1127522,509893,Agence_moov_Ouidah,300000,-317629,2022-08-23
TRANSFER,326842,Luc-Tristan Moreau,509893,183051,Anastasie Louis,9969,-316873,2022-08-25
TRANSFER,198901,Marianne Descamps,689567,490666,Luc-Tristan Moreau,183051,381952,2022-08-26
CASH_OUT,164670,Luc-Tristan Moreau,381952,217282,Agence_moov_Ouidah,300000,135330,2022-08-26
CASH_OUT,904957,Valentine Traore,1717300,812343,Agence_moov_Ouidah,300000,-604957,2022-08-01
CASH_OUT,69631,Valentine Traore,812343,742712,Agence_moov_Ouidah,300000,230369,2022-08-02
CASH_OUT,218645,Valentine Traore,742712,524067,Agence_moov_Cotonou,300000,81355,2022-08-03
CASH_IN,93864,Agence_moov_Cotonou,300000,206136,Valentine Traore,524067,617931,2022-08-03
CASH_OUT,453089,Valentine Traore,617931,164842,Agence_moov_Cotonou,300000,-153089,2022-08-05
CASH_OUT,35088,Valentine Traore,164842,129754,Agence_moov_Cotonou,300000,264912,2022-08-08
CASH_IN,248061,Agence_moov_Abomey,300000,51939,Valentine Traore,129754,377815,2022-08-08
TRANSFER,19320,Valentine Traore,377815,358495,Jacques-Antoine Gros,514400,495080,2022-08-09
CASH_IN,282115,Agence_moov_Ouidah,300000,17885,Valentine Traore,358495,640610,2022-08-09
TRANSFER,560163,Valentine Traore,640610,80447,Nathalie-Chantal Jacques,944300,384137,2022-08-09
CASH_IN,164322,Agence_moov_Cotonou,300000,135678,Valentine Traore,80447,244769,2022-08-10
TRANSFER,327534,Constance Regnier,1481500,1153966,Valentine Traore,244769,572303,2022-08-12
CASH_IN,272289,Agence_moov_Abomey,300000,27711,Valentine Traore,572303,844592,2022-08-12
CASH_OUT,444054,Valentine Traore,844592,400538,Agence_moov_Abomey,300000,-144054,2022-08-13
TRANSFER,725618,Théodore-Alfred Fournier,988300,262682,Valentine Traore,400538,1126156,2022-08-14
TRANSFER,218013,Constance Regnier,1153966,935953,Valentine Traore,1126156,1344169,2022-08-15
TRANSFER,381053,Valentine Traore,1344169,963116,Josette Guillon-Leclercq,1190100,809047,2022-08-15
TRANSFER,432488,Valentine Traore,963116,530628,Théodore-Alfred Fournier,262682,-169806,2022-08-17
TRANSFER,106740,Valentine Traore,530628,423888,Augustin Benard,41327,-65413,2022-08-19
CASH_IN,3777,Agence_moov_Ouidah,300000,296223,Valentine Traore,423888,427665,2022-08-20
CASH_IN,294444,Agence_moov_Abomey,300000,5556,Valentine Traore,427665,722109,2022-08-23
CASH_IN,148630,Agence_moov_Abomey,300000,151370,Valentine Traore,722109,870739,2022-08-24
CASH_OUT,639363,Valentine Traore,870739,231376,Agence_moov_Abomey,300000,-339363,2022-08-24
CASH_OUT,210468,Valentine Traore,231376,20908,Agence_moov_Ouidah,300000,89532,2022-08-25
TRANSFER,64224,Jacques-Antoine Gros,495080,430856,Valentine Traore,20908,85132,2022-08-27
CASH_IN,143421,Agence_moov_Ouidah,300000,156579,Roland Colin,233600,377021,2022-08-01
CASH_OUT,191682,Roland Colin,377021,185339,Agence_moov_Ouidah,300000,108318,2022-08-03
TRANSFER,264273,Marianne Descamps,490666,226393,Roland Colin,185339,449612,2022-08-04
CASH_OUT,308524,Roland Colin,449612,141088,Agence_moov_Cotonou,300000,-8524,2022-08-04
CASH_IN,156140,Agence_moov_Abomey,300000,143860,Roland Colin,141088,297228,2022-08-05
CASH_OUT,153085,Roland Colin,297228,144143,Agence_moov_Cotonou,300000,146915,2022-08-05
CASH_IN,18835,Agence_moov_Abomey,300000,281165,Roland Colin,144143,162978,2022-08-07
CASH_IN,28203,Agence_moov_Cotonou,300000,271797,Roland Colin,162978,191181,2022-08-08
CASH_OUT,51070,Roland Colin,191181,140111,Agence_moov_Cotonou,300000,248930,2022-08-10
TRANSFER,21936,Roland Colin,140111,118175,Émile Hebert,209000,187064,2022-08-10
CASH_OUT,45549,Roland Colin,118175,72626,Agence_moov_Abomey,300000,254451,2022-08-12
TRANSFER,93416,Marianne Descamps,226393,132977,Roland Colin,72626,166042,2022-08-12
CASH_IN,193706,Agence_moov_Ouidah,300000,106294,Roland Colin,166042,359748,2022-08-13
TRANSFER,431297,Océane Boutin,776055,344758,Roland Colin,359748,791045,2022-08-13
CASH_OUT,751866,Roland Colin,791045,39179,Agence_moov_Cotonou,300000,-451866,2022-08-16
CASH_OUT,38076,Roland Colin,39179,1103,Agence_moov_Abomey,300000,261924,2022-08-18
CASH_IN,272756,Agence_moov_Cotonou,300000,27244,Roland Colin,1103,273859,2022-08-18
CASH_OUT,197882,Roland Colin,273859,75977,Agence_moov_Cotonou,300000,102118,2022-08-19
CASH_IN,278915,Agence_moov_Ouidah,300000,21085,Roland Colin,75977,354892,2022-08-19
CASH_IN,208392,Agence_moov_Ouidah,300000,91608,Roland Colin,354892,563284,2022-08-20
CASH_IN,230213,Agence_moov_Ouidah,300000,69787,Roland Colin,563284,793497,2022-08-20
TRANSFER,30082,Alphonse Dupont-Petit,43060,12978,Roland Colin,793497,823579,2022-08-20
CASH_IN,181058,Agence_moov_Ouidah,300000,118942,Roland Colin,823579,1004637,2022-08-21
CASH_IN,50742,Agence_moov_Cotonou,300000,249258,Roland Colin,1004637,1055379,2022-08-22
CASH_OUT,568277,Roland Colin,1055379,487102,Agence_moov_Cotonou,300000,-268277,2022-08-23
TRANSFER,671151,Frédéric Moreau,1166722,495571,Roland Colin,487102,1158253,2022-08-25
CASH_OUT,119033,Roland Colin,1158253,1039220,Agence_moov_Abomey,300000,180967,2022-08-27
TRANSFER,898634,Joseph de la Dubois,1376100,477466,Constance Regnier,935953,37319,2022-08-01
CASH_IN,13945,Agence_moov_Abomey,300000,286055,Joseph de la Dubois,477466,491411,2022-08-01
TRANSFER,320335,Joseph de la Dubois,491411,171076,Sabine Imbert,1031057,710722,2022-08-02
CASH_OUT,91260,Joseph de la Dubois,171076,79816,Agence_moov_Cotonou,300000,208740,2022-08-05
CASH_IN,131899,Agence_moov_Ouidah,300000,168101,Joseph de la Dubois,79816,211715,2022-08-05
CASH_OUT,82748,Joseph de la Dubois,211715,128967,Agence_moov_Ouidah,300000,217252,2022-08-06
CASH_IN,62643,Agence_moov_Cotonou,300000,237357,Joseph de la Dubois,128967,191610,2022-08-07
TRANSFER,72812,Joseph de la Dubois,191610,118798,Christophe Guilbert,1739300,1666488,2022-08-07
TRANSFER,108318,Alfred Chrétien,153393,45075,Joseph de la Dubois,118798,227116,2022-08-08
CASH_IN,111831,Agence_moov_Abomey,300000,188169,Joseph de la Dubois,227116,338947,2022-08-08
CASH_IN,258187,Agence_moov_Abomey,300000,41813,Joseph de la Dubois,338947,597134,2022-08-08
CASH_OUT,438865,Joseph de la Dubois,597134,158269,Agence_moov_Cotonou,300000,-138865,2022-08-09
TRANSFER,44607,Joseph de la Dubois,158269,113662,Joseph de la Dubois,158269,113662,2022-08-10
TRANSFER,364549,Lucy Vaillant,607430,242881,Joseph de la Dubois,113662,478211,2022-08-13
CASH_OUT,426280,Joseph de la Dubois,478211,51931,Agence_moov_Abomey,300000,-126280,2022-08-15
TRANSFER,31777,Joseph de la Dubois,51931,20154,Sabine Imbert,710722,678945,2022-08-16
TRANSFER,17294,Joseph de la Dubois,20154,2860,Stéphane-Timothée Pineau,93201,75907,2022-08-17
CASH_IN,118319,Agence_moov_Abomey,300000,181681,Joseph de la Dubois,2860,121179,2022-08-18
TRANSFER,747154,Caroline Peltier,768441,21287,Joseph de la Dubois,121179,868333,2022-08-20
TRANSFER,646448,Joseph de la Dubois,868333,221885,Agnès Baron,342136,-304312,2022-08-22
CASH_IN,285064,Agence_moov_Ouidah,300000,14936,Joseph de la Dubois,221885,506949,2022-08-22
TRANSFER,352276,Emmanuelle Gilbert,1377948,1025672,Joseph de la Dubois,506949,859225,2022-08-23
CASH_IN,89429,Agence_moov_Abomey,300000,210571,Joseph de la Dubois,859225,948654,2022-08-23
CASH_IN,132002,Agence_moov_Ouidah,300000,167998,Joseph de la Dubois,948654,1080656,2022-08-24
CASH_IN,202338,Agence_moov_Cotonou,300000,97662,Joseph de la Dubois,1080656,1282994,2022-08-27
TRANSFER,69653,Adélaïde-Sophie Leclercq,1401700,1332047,Émile Hebert,187064,117411,2022-08-02
TRANSFER,428979,Adélaïde-Sophie Leclercq,1332047,903068,Susan de Fontaine,503700,74721,2022-08-05
CASH_OUT,121698,Adélaïde-Sophie Leclercq,903068,781370,Agence_moov_Abomey,300000,178302,2022-08-05
CASH_OUT,168023,Adélaïde-Sophie Leclercq,781370,613347,Agence_moov_Abomey,300000,131977,2022-08-05
CASH_IN,79019,Agence_moov_Cotonou,300000,220981,Adélaïde-Sophie Leclercq,613347,692366,2022-08-06
TRANSFER,136894,Christine-Constance Gauthier,266204,129310,Adélaïde-Sophie Leclercq,692366,829260,2022-08-11
CASH_IN,149171,Agence_moov_Abomey,300000,150829,Adélaïde-Sophie Leclercq,829260,978431,2022-08-11
CASH_OUT,861952,Adélaïde-Sophie Leclercq,978431,116479,Agence_moov_Abomey,300000,-561952,2022-08-13
CASH_OUT,42944,Adélaïde-Sophie Leclercq,116479,73535,Agence_moov_Cotonou,300000,257056,2022-08-13
TRANSFER,65934,Adélaïde-Sophie Leclercq,73535,7601,Christophe Alexandre,517268,451334,2022-08-14
CASH_OUT,1162,Adélaïde-Sophie Leclercq,7601,6439,Agence_moov_Ouidah,300000,298838,2022-08-14
CASH_IN,130387,Agence_moov_Abomey,300000,169613,Adélaïde-Sophie Leclercq,6439,136826,2022-08-14
CASH_OUT,57515,Adélaïde-Sophie Leclercq,136826,79311,Agence_moov_Cotonou,300000,242485,2022-08-14
CASH_IN,195552,Agence_moov_Cotonou,300000,104448,Adélaïde-Sophie Leclercq,79311,274863,2022-08-14
TRANSFER,319199,Marie Da Silva,752800,433601,Adélaïde-Sophie Leclercq,274863,594062,2022-08-15
TRANSFER,613024,Alexandre Poirier,1624100,1011076,Adélaïde-Sophie Leclercq,594062,1207086,2022-08-15
CASH_IN,298682,Agence_moov_Ouidah,300000,1318,Adélaïde-Sophie Leclercq,1207086,1505768,2022-08-16
CASH_IN,187705,Agence_moov_Ouidah,300000,112295,Adélaïde-Sophie Leclercq,1505768,1693473,2022-08-19
CASH_OUT,1545881,Adélaïde-Sophie Leclercq,1693473,147592,Agence_moov_Abomey,300000,-1245881,2022-08-20
TRANSFER,55960,Adélaïde-Sophie Leclercq,147592,91632,Maryse Reynaud-Michaud,1452400,1396440,2022-08-21
CASH_IN,190001,Agence_moov_Abomey,300000,109999,Adélaïde-Sophie Leclercq,91632,281633,2022-08-21
CASH_IN,69296,Agence_moov_Cotonou,300000,230704,Adélaïde-Sophie Leclercq,281633,350929,2022-08-23
CASH_IN,59267,Agence_moov_Ouidah,300000,240733,Adélaïde-Sophie Leclercq,350929,410196,2022-08-24
CASH_OUT,235876,Adélaïde-Sophie Leclercq,410196,174320,Agence_moov_Abomey,300000,64124,2022-08-24
TRANSFER,111741,Adélaïde-Sophie Leclercq,174320,62579,Adélaïde-Sophie Leclercq,174320,62579,2022-08-24
CASH_OUT,53901,Adélaïde-Sophie Leclercq,62579,8678,Agence_moov_Ouidah,300000,246099,2022-08-25
CASH_OUT,8400,Adélaïde-Sophie Leclercq,8678,278,Agence_moov_Abomey,300000,291600,2022-08-26
TRANSFER,237932,Lucy Vaillant,242881,4949,Adélaïde-Sophie Leclercq,278,238210,2022-08-26
TRANSFER,111349,Adélaïde-Sophie Leclercq,238210,126861,Constance Regnier,37319,-74030,2022-08-27
CASH_OUT,712324,Guy Guyon,1074500,362176,Agence_moov_Ouidah,300000,-412324,2022-08-02
CASH_IN,57550,Agence_moov_Cotonou,300000,242450,Guy Guyon,362176,419726,2022-08-03
TRANSFER,341666,Guy Guyon,419726,78060,Emmanuel Bousquet,606000,264334,2022-08-04
CASH_IN,8425,Agence_moov_Abomey,300000,291575,Guy Guyon,78060,86485,2022-08-06
CASH_OUT,16716,Guy Guyon,86485,69769,Agence_moov_Cotonou,300000,283284,2022-08-06
TRANSFER,11785,Guy Guyon,69769,57984,Susan de Fontaine,74721,62936,2022-08-06
CASH_OUT,54968,Guy Guyon,57984,3016,Agence_moov_Cotonou,300000,245032,2022-08-06
CASH_IN,134330,Agence_moov_Ouidah,300000,165670,Guy Guyon,3016,137346,2022-08-09
TRANSFER,127760,Guy Guyon,137346,9586,Caroline Bonneau,1450200,1322440,2022-08-12
CASH_OUT,8983,Guy Guyon,9586,603,Agence_moov_Cotonou,300000,291017,2022-08-16
TRANSFER,8045,Laurent Perrot,23041,14996,Guy Guyon,603,8648,2022-08-17
TRANSFER,4805,Guy Guyon,8648,3843,Alphonse Dupont-Petit,12978,8173,2022-08-18
TRANSFER,2807,Guy Guyon,3843,1036,Arnaude Gaillard,281300,278493,2022-08-19
TRANSFER,458,Guy Guyon,1036,578,Émile Hebert,117411,116953,2022-08-20
TRANSFER,21687,Océane Boutin,344758,323071,Guy Guyon,578,22265,2022-08-21
CASH_OUT,5886,Guy Guyon,22265,16379,Agence_moov_Ouidah,300000,294114,2022-08-21
CASH_OUT,4039,Guy Guyon,16379,12340,Agence_moov_Ouidah,300000,295961,2022-08-22
CASH_IN,282532,Agence_moov_Abomey,300000,17468,Guy Guyon,12340,294872,2022-08-23
CASH_IN,127558,Agence_moov_Ouidah,300000,172442,Guy Guyon,294872,422430,2022-08-23
CASH_IN,186288,Agence_moov_Ouidah,300000,113712,Guy Guyon,422430,608718,2022-08-26
TRANSFER,179602,David Diallo,1190300,1010698,Guy Guyon,608718,788320,2022-08-26
TRANSFER,661653,Guy Guyon,788320,126667,Frédéric Moreau,495571,-166082,2022-08-26
TRANSFER,991843,Emmanuelle Gilbert,1025672,33829,Nicolas Grondin de la Pinto,1693800,2685643,2022-08-02
TRANSFER,156921,Jacques-Antoine Gros,430856,273935,Nicolas Grondin de la Pinto,2685643,2842564,2022-08-02
TRANSFER,718697,Nicolas Grondin de la Pinto,2842564,2123867,Élodie Gérard,139636,-579061,2022-08-02
TRANSFER,5098,Alfred Chrétien,45075,39977,Nicolas Grondin de la Pinto,2123867,2128965,2022-08-03
CASH_OUT,1428746,Nicolas Grondin de la Pinto,2128965,700219,Agence_moov_Abomey,300000,-1128746,2022-08-04
CASH_IN,15113,Agence_moov_Ouidah,300000,284887,Nicolas Grondin de la Pinto,700219,715332,2022-08-08
CASH_IN,62601,Agence_moov_Ouidah,300000,237399,Nicolas Grondin de la Pinto,715332,777933,2022-08-09
TRANSFER,626621,Maryse Reynaud-Michaud,1396440,769819,Nicolas Grondin de la Pinto,777933,1404554,2022-08-10
TRANSFER,71465,Nicolas Grondin de la Pinto,1404554,1333089,Nathalie-Chantal Jacques,384137,312672,2022-08-10
CASH_IN,147971,Agence_moov_Abomey,300000,152029,Nicolas Grondin de la Pinto,1333089,1481060,2022-08-10
TRANSFER,1265910,Nicolas Grondin de la Pinto,1481060,215150,Noémi de la Didier,1506300,240390,2022-08-11
CASH_OUT,184355,Nicolas Grondin de la Pinto,215150,30795,Agence_moov_Ouidah,300000,115645,2022-08-13
CASH_OUT,10895,Nicolas Grondin de la Pinto,30795,19900,Agence_moov_Cotonou,300000,289105,2022-08-13
CASH_OUT,883,Nicolas Grondin de la Pinto,19900,19017,Agence_moov_Abomey,300000,299117,2022-08-15
TRANSFER,193233,Julie Robin de Gros,437774,244541,Nicolas Grondin de la Pinto,19017,212250,2022-08-15
CASH_OUT,11527,Nicolas Grondin de la Pinto,212250,200723,Agence_moov_Abomey,300000,288473,2022-08-15
TRANSFER,133875,Nicolas Grondin de la Pinto,200723,66848,Jacques-Antoine Gros,273935,140060,2022-08-16
CASH_IN,81708,Agence_moov_Ouidah,300000,218292,Nicolas Grondin de la Pinto,66848,148556,2022-08-17
TRANSFER,97095,Arnaude Gaillard,278493,181398,Nicolas Grondin de la Pinto,148556,245651,2022-08-17
CASH_IN,162775,Agence_moov_Ouidah,300000,137225,Nicolas Grondin de la Pinto,245651,408426,2022-08-17
CASH_IN,211866,Agence_moov_Abomey,300000,88134,Nicolas Grondin de la Pinto,408426,620292,2022-08-19
TRANSFER,600713,Caroline Bonneau,1322440,721727,Nicolas Grondin de la Pinto,620292,1221005,2022-08-20
CASH_OUT,528359,Nicolas Grondin de la Pinto,1221005,692646,Agence_moov_Abomey,300000,-228359,2022-08-20
CASH_OUT,455062,Nicolas Grondin de la Pinto,692646,237584,Agence_moov_Cotonou,300000,-155062,2022-08-21
CASH_IN,8630,Agence_moov_Ouidah,300000,291370,Nicolas Grondin de la Pinto,237584,246214,2022-08-24
CASH_IN,142340,Agence_moov_Cotonou,300000,157660,Frédéric Moreau,-166082,-23742,2022-08-02
CASH_IN,91141,Agence_moov_Cotonou,300000,208859,Frédéric Moreau,-23742,67399,2022-08-02
TRANSFER,56246,Frédéric Moreau,67399,11153,Laurence Carlier,412200,355954,2022-08-03
TRANSFER,333952,Margot Renaud de Lacombe,977100,643148,Frédéric Moreau,11153,345105,2022-08-03
TRANSFER,271788,Laurence Carlier,355954,84166,Frédéric Moreau,345105,616893,2022-08-03
CASH_OUT,250499,Frédéric Moreau,616893,366394,Agence_moov_Abomey,300000,49501,2022-08-05
CASH_OUT,337348,Frédéric Moreau,366394,29046,Agence_moov_Ouidah,300000,-37348,2022-08-06
CASH_OUT,563,Frédéric Moreau,29046,28483,Agence_moov_Abomey,300000,299437,2022-08-06
CASH_OUT,3977,Frédéric Moreau,28483,24506,Agence_moov_Abomey,300000,296023,2022-08-08
CASH_IN,226489,Agence_moov_Ouidah,300000,73511,Frédéric Moreau,24506,250995,2022-08-08
TRANSFER,114509,Gilbert Bazin Le Guillet,1121700,1007191,Frédéric Moreau,250995,365504,2022-08-11
TRANSFER,1084,Lucy Vaillant,4949,3865,Frédéric Moreau,365504,366588,2022-08-11
CASH_IN,294860,Agence_moov_Ouidah,300000,5140,Frédéric Moreau,366588,661448,2022-08-11
TRANSFER,3871,Laurent Perrot,14996,11125,Frédéric Moreau,661448,665319,2022-08-15
CASH_OUT,259303,Frédéric Moreau,665319,406016,Agence_moov_Abomey,300000,40697,2022-08-16
CASH_IN,57009,Agence_moov_Ouidah,300000,242991,Frédéric Moreau,406016,463025,2022-08-16
TRANSFER,255051,Frédéric Moreau,463025,207974,Luc Camus,1536700,1281649,2022-08-18
TRANSFER,191719,Frédéric Moreau,207974,16255,Julie Robin de Gros,244541,52822,2022-08-19
CASH_OUT,5559,Frédéric Moreau,16255,10696,Agence_moov_Ouidah,300000,294441,2022-08-20
CASH_IN,18931,Agence_moov_Abomey,300000,281069,Frédéric Moreau,10696,29627,2022-08-20
CASH_OUT,17748,Frédéric Moreau,29627,11879,Agence_moov_Abomey,300000,282252,2022-08-21
CASH_OUT,3199,Frédéric Moreau,11879,8680,Agence_moov_Cotonou,300000,296801,2022-08-22
TRANSFER,140941,Maryse Reynaud-Michaud,769819,628878,Frédéric Moreau,8680,149621,2022-08-22
TRANSFER,105021,Frédéric Moreau,149621,44600,Marianne Descamps,132977,27956,2022-08-23
CASH_OUT,42487,Frédéric Moreau,44600,2113,Agence_moov_Cotonou,300000,257513,2022-08-24
CASH_IN,157325,Agence_moov_Ouidah,300000,142675,Frédéric Moreau,2113,159438,2022-08-24
TRANSFER,348553,Nath Léger,1604200,1255647,Frédéric Moreau,159438,507991,2022-08-26
CASH_IN,233839,Agence_moov_Ouidah,300000,66161,Frédéric Moreau,507991,741830,2022-08-27
CASH_IN,62335,Agence_moov_Abomey,300000,237665,Frédéric Moreau,741830,804165,2022-08-27
TRANSFER,196085,Margot Renaud de Lacombe,643148,447063,Marie Da Silva,433601,237516,2022-08-01
CASH_IN,70010,Agence_moov_Ouidah,300000,229990,Margot Renaud de Lacombe,447063,517073,2022-08-01
CASH_OUT,76540,Margot Renaud de Lacombe,517073,440533,Agence_moov_Ouidah,300000,223460,2022-08-04
TRANSFER,281217,Margot Renaud de Lacombe,440533,159316,Antoine Bourdon de Auger,890000,608783,2022-08-06
CASH_OUT,80666,Margot Renaud de Lacombe,159316,78650,Agence_moov_Ouidah,300000,219334,2022-08-06
CASH_OUT,21421,Margot Renaud de Lacombe,78650,57229,Agence_moov_Abomey,300000,278579,2022-08-07
TRANSFER,33334,Margot Renaud de Lacombe,57229,23895,Alex Salmon,1099900,1066566,2022-08-08
TRANSFER,15925,Margot Renaud de Lacombe,23895,7970,Matthieu Renard,1253900,1237975,2022-08-12
CASH_IN,96812,Agence_moov_Abomey,300000,203188,Margot Renaud de Lacombe,7970,104782,2022-08-13
TRANSFER,92030,Jacques-Antoine Gros,140060,48030,Margot Renaud de Lacombe,104782,196812,2022-08-14
CASH_IN,272408,Agence_moov_Cotonou,300000,27592,Margot Renaud de Lacombe,196812,469220,2022-08-14
CASH_IN,141353,Agence_moov_Ouidah,300000,158647,Margot Renaud de Lacombe,469220,610573,2022-08-14
TRANSFER,473467,Margot Renaud de Lacombe,610573,137106,Agnès Chrétien-Sanchez,398500,-74967,2022-08-16
CASH_IN,248828,Agence_moov_Abomey,300000,51172,Margot Renaud de Lacombe,137106,385934,2022-08-17
TRANSFER,797120,Christophe Guilbert,1666488,869368,Margot Renaud de Lacombe,385934,1183054,2022-08-18
CASH_IN,193944,Agence_moov_Cotonou,300000,106056,Margot Renaud de Lacombe,1183054,1376998,2022-08-18
CASH_IN,80380,Agence_moov_Abomey,300000,219620,Margot Renaud de Lacombe,1376998,1457378,2022-08-18
CASH_IN,78418,Agence_moov_Ouidah,300000,221582,Margot Renaud de Lacombe,1457378,1535796,2022-08-20
TRANSFER,732923,Antoine Leroux,1010210,277287,Margot Renaud de Lacombe,1535796,2268719,2022-08-21
CASH_IN,87945,Agence_moov_Ouidah,300000,212055,Margot Renaud de Lacombe,2268719,2356664,2022-08-22
CASH_IN,82833,Agence_moov_Cotonou,300000,217167,Margot Renaud de Lacombe,2356664,2439497,2022-08-22
TRANSFER,52147,Marthe Guillet,562400,510253,Margot Renaud de Lacombe,2439497,2491644,2022-08-22
CASH_OUT,36939,Margot Renaud de Lacombe,2491644,2454705,Agence_moov_Abomey,300000,263061,2022-08-27
CASH_OUT,1381333,Margot Renaud de Lacombe,2454705,1073372,Agence_moov_Cotonou,300000,-1081333,2022-08-27
CASH_OUT,9300,Susan de Fontaine,62936,53636,Agence_moov_Abomey,300000,290700,2022-08-01
CASH_OUT,34056,Susan de Fontaine,53636,19580,Agence_moov_Ouidah,300000,265944,2022-08-02
CASH_IN,219951,Agence_moov_Abomey,300000,80049,Susan de Fontaine,19580,239531,2022-08-02
TRANSFER,120131,Susan de Fontaine,239531,119400,Alexandre Poirier,1011076,890945,2022-08-03
CASH_IN,93182,Agence_moov_Ouidah,300000,206818,Susan de Fontaine,119400,212582,2022-08-03
CASH_IN,229077,Agence_moov_Ouidah,300000,70923,Susan de Fontaine,212582,441659,2022-08-04
TRANSFER,419532,Susan de Fontaine,441659,22127,Gilbert Bazin Le Guillet,1007191,587659,2022-08-04
CASH_IN,62295,Agence_moov_Ouidah,300000,237705,Susan de Fontaine,22127,84422,2022-08-04
CASH_OUT,72185,Susan de Fontaine,84422,12237,Agence_moov_Abomey,300000,227815,2022-08-05
CASH_OUT,11435,Susan de Fontaine,12237,802,Agence_moov_Cotonou,300000,288565,2022-08-05
CASH_OUT,156,Susan de Fontaine,802,646,Agence_moov_Cotonou,300000,299844,2022-08-05
TRANSFER,202457,Émilie Guillon de Duhamel,274664,72207,Susan de Fontaine,646,203103,2022-08-06
CASH_IN,140733,Agence_moov_Ouidah,300000,159267,Susan de Fontaine,203103,343836,2022-08-08
CASH_OUT,311498,Susan de Fontaine,343836,32338,Agence_moov_Ouidah,300000,-11498,2022-08-08
CASH_IN,26448,Agence_moov_Ouidah,300000,273552,Susan de Fontaine,32338,58786,2022-08-10
CASH_OUT,21819,Susan de Fontaine,58786,36967,Agence_moov_Cotonou,300000,278181,2022-08-11
TRANSFER,11305,Susan de Fontaine,36967,25662,Maryse Reynaud-Michaud,628878,617573,2022-08-11
CASH_IN,184394,Agence_moov_Abomey,300000,115606,Susan de Fontaine,25662,210056,2022-08-12
CASH_IN,192971,Agence_moov_Cotonou,300000,107029,Susan de Fontaine,210056,403027,2022-08-12
TRANSFER,268786,Susan de Fontaine,403027,134241,Théophile Mendès,1122000,853214,2022-08-15
TRANSFER,65137,Océane Boutin,323071,257934,Susan de Fontaine,134241,199378,2022-08-16
TRANSFER,75355,Antoine Bourdon de Auger,608783,533428,Susan de Fontaine,199378,274733,2022-08-17
CASH_IN,197554,Agence_moov_Abomey,300000,102446,Susan de Fontaine,274733,472287,2022-08-17
TRANSFER,394429,Susan de Fontaine,472287,77858,Susan de Fontaine,472287,77858,2022-08-18
CASH_IN,111061,Agence_moov_Ouidah,300000,188939,Susan de Fontaine,77858,188919,2022-08-18
TRANSFER,240475,Frédérique Robin,1213300,972825,Susan de Fontaine,188919,429394,2022-08-20
CASH_OUT,263638,Susan de Fontaine,429394,165756,Agence_moov_Cotonou,300000,36362,2022-08-20
CASH_OUT,66681,Susan de Fontaine,165756,99075,Agence_moov_Ouidah,300000,233319,2022-08-21
CASH_IN,32326,Agence_moov_Abomey,300000,267674,Susan de Fontaine,99075,131401,2022-08-22
CASH_IN,178203,Agence_moov_Ouidah,300000,121797,Susan de Fontaine,131401,309604,2022-08-25
CASH_IN,278072,Agence_moov_Ouidah,300000,21928,Matthieu Renard,1237975,1516047,2022-08-01
CASH_IN,105279,Agence_moov_Ouidah,300000,194721,Matthieu Renard,1516047,1621326,2022-08-02
TRANSFER,429100,Matthieu Renard,1621326,1192226,Christine-Constance Gauthier,129310,-299790,2022-08-03
CASH_OUT,829299,Matthieu Renard,1192226,362927,Agence_moov_Cotonou,300000,-529299,2022-08-04
CASH_OUT,123996,Matthieu Renard,362927,238931,Agence_moov_Ouidah,300000,176004,2022-08-07
CASH_OUT,204015,Matthieu Renard,238931,34916,Agence_moov_Abomey,300000,95985,2022-08-11
CASH_OUT,4815,Matthieu Renard,34916,30101,Agence_moov_Ouidah,300000,295185,2022-08-11
TRANSFER,48325,Caroline Bonneau,721727,673402,Matthieu Renard,30101,78426,2022-08-12
TRANSFER,35745,Bernadette Fabre,78710,42965,Matthieu Renard,78426,114171,2022-08-14
CASH_OUT,12455,Matthieu Renard,114171,101716,Agence_moov_Abomey,300000,287545,2022-08-14
CASH_OUT,1191,Matthieu Renard,101716,100525,Agence_moov_Cotonou,300000,298809,2022-08-15
CASH_OUT,1105,Matthieu Renard,100525,99420,Agence_moov_Cotonou,300000,298895,2022-08-17
TRANSFER,146016,Noémi de la Didier,240390,94374,Matthieu Renard,99420,245436,2022-08-18
TRANSFER,190087,Nath Léger,1255647,1065560,Matthieu Renard,245436,435523,2022-08-19
CASH_OUT,371202,Matthieu Renard,435523,64321,Agence_moov_Ouidah,300000,-71202,2022-08-20
TRANSFER,59384,Matthieu Renard,64321,4937,Luc Camus,1281649,1222265,2022-08-22
CASH_OUT,2304,Matthieu Renard,4937,2633,Agence_moov_Ouidah,300000,297696,2022-08-22
TRANSFER,411659,Gilbert Bazin Le Guillet,587659,176000,Matthieu Renard,2633,414292,2022-08-23
CASH_IN,254854,Agence_moov_Ouidah,300000,45146,Matthieu Renard,414292,669146,2022-08-24
TRANSFER,1425946,Clémence Bertin,1547700,121754,Matthieu Renard,669146,2095092,2022-08-26
CASH_OUT,1751648,Matthieu Renard,2095092,343444,Agence_moov_Ouidah,300000,-1451648,2022-08-27
TRANSFER,260246,Matthieu Renard,343444,83198,Océane Boutin,257934,-2312,2022-08-27
CASH_OUT,114324,Marie Da Silva,237516,123192,Agence_moov_Cotonou,300000,185676,2022-08-04
TRANSFER,17825,Marie Da Silva,123192,105367,Alphonse Dupont-Petit,8173,-9652,2022-08-05
TRANSFER,74150,Marie Da Silva,105367,31217,Marianne Descamps,27956,-46194,2022-08-05
CASH_IN,125531,Agence_moov_Cotonou,300000,174469,Marie Da Silva,31217,156748,2022-08-06
TRANSFER,82736,Marie Da Silva,156748,74012,Hugues Gay,861600,778864,2022-08-09
CASH_IN,26344,Agence_moov_Ouidah,300000,273656,Marie Da Silva,74012,100356,2022-08-09
CASH_OUT,17113,Marie Da Silva,100356,83243,Agence_moov_Ouidah,300000,282887,2022-08-10
CASH_OUT,16798,Marie Da Silva,83243,66445,Agence_moov_Ouidah,300000,283202,2022-08-11
TRANSFER,45734,Marie Da Silva,66445,20711,Christophe Alexandre,451334,405600,2022-08-11
CASH_IN,77160,Agence_moov_Abomey,300000,222840,Marie Da Silva,20711,97871,2022-08-13
TRANSFER,92622,Marie Da Silva,97871,5249,Antoine Bourdon de Auger,533428,440806,2022-08-13
CASH_OUT,4345,Marie Da Silva,5249,904,Agence_moov_Cotonou,300000,295655,2022-08-16
CASH_IN,246263,Agence_moov_Cotonou,300000,53737,Marie Da Silva,904,247167,2022-08-17
CASH_OUT,93908,Marie Da Silva,247167,153259,Agence_moov_Cotonou,300000,206092,2022-08-17
TRANSFER,432625,Frédérique Robin,972825,540200,Marie Da Silva,153259,585884,2022-08-18
CASH_OUT,93073,Marie Da Silva,585884,492811,Agence_moov_Abomey,300000,206927,2022-08-22
CASH_IN,89232,Agence_moov_Cotonou,300000,210768,Marie Da Silva,492811,582043,2022-08-22
CASH_IN,25543,Agence_moov_Cotonou,300000,274457,Marie Da Silva,582043,607586,2022-08-25
TRANSFER,418485,Marie Da Silva,607586,189101,Vincent-Grégoire Brunet,515400,96915,2022-08-26
CASH_IN,83582,Agence_moov_Cotonou,300000,216418,Marie Da Silva,189101,272683,2022-08-26
CASH_IN,183190,Agence_moov_Abomey,300000,116810,Marie Da Silva,272683,455873,2022-08-26
TRANSFER,269396,Christophe Guilbert,869368,599972,Marie Da Silva,455873,725269,2022-08-27
CASH_OUT,362816,Marie Da Silva,725269,362453,Agence_moov_Cotonou,300000,-62816,2022-08-27
TRANSFER,137558,Marthe Guillet,510253,372695,Marie Da Silva,362453,500011,2022-08-27
CASH_OUT,28737,Julie Robin de Gros,52822,24085,Agence_moov_Cotonou,300000,271263,2022-08-03
CASH_OUT,23771,Julie Robin de Gros,24085,314,Agence_moov_Ouidah,300000,276229,2022-08-04
CASH_IN,243059,Agence_moov_Ouidah,300000,56941,Julie Robin de Gros,314,243373,2022-08-05
CASH_OUT,227894,Julie Robin de Gros,243373,15479,Agence_moov_Cotonou,300000,72106,2022-08-06
CASH_IN,98747,Agence_moov_Cotonou,300000,201253,Julie Robin de Gros,15479,114226,2022-08-10
CASH_OUT,2160,Julie Robin de Gros,114226,112066,Agence_moov_Abomey,300000,297840,2022-08-11
TRANSFER,116681,Caroline Bonneau,673402,556721,Julie Robin de Gros,112066,228747,2022-08-11
TRANSFER,109365,Michèle Vallée,161800,52435,Julie Robin de Gros,228747,338112,2022-08-12
TRANSFER,115667,Julie Robin de Gros,338112,222445,Alexandre Poirier,890945,775278,2022-08-13
CASH_OUT,118555,Julie Robin de Gros,222445,103890,Agence_moov_Abomey,300000,181445,2022-08-13
CASH_OUT,92544,Julie Robin de Gros,103890,11346,Agence_moov_Cotonou,300000,207456,2022-08-14
CASH_OUT,9663,Julie Robin de Gros,11346,1683,Agence_moov_Abomey,300000,290337,2022-08-14
CASH_IN,190118,Agence_moov_Ouidah,300000,109882,Julie Robin de Gros,1683,191801,2022-08-15
CASH_OUT,35664,Julie Robin de Gros,191801,156137,Agence_moov_Cotonou,300000,264336,2022-08-16
CASH_OUT,25135,Julie Robin de Gros,156137,131002,Agence_moov_Abomey,300000,274865,2022-08-17
CASH_IN,140267,Agence_moov_Ouidah,300000,159733,Julie Robin de Gros,131002,271269,2022-08-17
CASH_OUT,265622,Julie Robin de Gros,271269,5647,Agence_moov_Abomey,300000,34378,2022-08-18
TRANSFER,3818,Julie Robin de Gros,5647,1829,Vincent-Grégoire Brunet,96915,93097,2022-08-18
CASH_OUT,192,Julie Robin de Gros,1829,1637,Agence_moov_Abomey,300000,299808,2022-08-21
CASH_IN,64374,Agence_moov_Abomey,300000,235626,Julie Robin de Gros,1637,66011,2022-08-21
CASH_OUT,21918,Julie Robin de Gros,66011,44093,Agence_moov_Cotonou,300000,278082,2022-08-21
CASH_OUT,32947,Julie Robin de Gros,44093,11146,Agence_moov_Cotonou,300000,267053,2022-08-21
CASH_IN,26898,Agence_moov_Cotonou,300000,273102,Julie Robin de Gros,11146,38044,2022-08-23
CASH_IN,152670,Agence_moov_Ouidah,300000,147330,Julie Robin de Gros,38044,190714,2022-08-23
CASH_OUT,73616,Julie Robin de Gros,190714,117098,Agence_moov_Abomey,300000,226384,2022-08-23
TRANSFER,785619,Auguste Bousquet,1028875,243256,Luc Camus,1222265,2007884,2022-08-01
TRANSFER,1811110,Luc Camus,2007884,196774,Laurent Perrot,11125,-1799985,2022-08-01
CASH_OUT,20272,Luc Camus,196774,176502,Agence_moov_Ouidah,300000,279728,2022-08-01
TRANSFER,233687,Auguste Bousquet,243256,9569,Luc Camus,176502,410189,2022-08-03
CASH_OUT,212075,Luc Camus,410189,198114,Agence_moov_Ouidah,300000,87925,2022-08-05
TRANSFER,110663,Luc Camus,198114,87451,Marthe Guillet,372695,262032,2022-08-07
TRANSFER,172569,Josette Guillon-Leclercq,809047,636478,Luc Camus,87451,260020,2022-08-08
TRANSFER,1960,Bernadette Fabre,42965,41005,Luc Camus,260020,261980,2022-08-14
CASH_OUT,73228,Luc Camus,261980,188752,Agence_moov_Ouidah,300000,226772,2022-08-14
CASH_IN,149785,Agence_moov_Abomey,300000,150215,Luc Camus,188752,338537,2022-08-16
CASH_IN,140114,Agence_moov_Ouidah,300000,159886,Luc Camus,338537,478651,2022-08-18
CASH_OUT,43009,Luc Camus,478651,435642,Agence_moov_Abomey,300000,256991,2022-08-18
TRANSFER,80661,Clémence Bertin,121754,41093,Luc Camus,435642,516303,2022-08-18
TRANSFER,263650,Luc Camus,516303,252653,Alexandre Poirier,775278,511628,2022-08-20
CASH_OUT,136906,Luc Camus,252653,115747,Agence_moov_Cotonou,300000,163094,2022-08-20
CASH_OUT,31258,Luc Camus,115747,84489,Agence_moov_Ouidah,300000,268742,2022-08-21
CASH_OUT,69529,Luc Camus,84489,14960,Agence_moov_Ouidah,300000,230471,2022-08-23
CASH_IN,20120,Agence_moov_Abomey,300000,279880,Luc Camus,14960,35080,2022-08-24
TRANSFER,38106,Laurence Carlier,84166,46060,Luc Camus,35080,73186,2022-08-24
CASH_OUT,37168,Luc Camus,73186,36018,Agence_moov_Ouidah,300000,262832,2022-08-26
CASH_IN,66349,Agence_moov_Ouidah,300000,233651,Luc Camus,36018,102367,2022-08-27
CASH_OUT,158295,Emmanuel Bousquet,264334,106039,Agence_moov_Cotonou,300000,141705,2022-08-01
CASH_OUT,4951,Emmanuel Bousquet,106039,101088,Agence_moov_Ouidah,300000,295049,2022-08-01
TRANSFER,64556,Émilie Guillon de Duhamel,72207,7651,Emmanuel Bousquet,101088,165644,2022-08-01
CASH_OUT,53912,Emmanuel Bousquet,165644,111732,Agence_moov_Abomey,300000,246088,2022-08-04
CASH_OUT,11637,Emmanuel Bousquet,111732,100095,Agence_moov_Ouidah,300000,288363,2022-08-05
TRANSFER,23978,Emmanuel Bousquet,100095,76117,Théophile Mendès,853214,829236,2022-08-05
CASH_OUT,2060,Emmanuel Bousquet,76117,74057,Agence_moov_Ouidah,300000,297940,2022-08-07
TRANSFER,266788,Alexandre Poirier,511628,244840,Emmanuel Bousquet,74057,340845,2022-08-07
TRANSFER,36752,Emmanuel Bousquet,340845,304093,Nicole Lacroix,731600,694848,2022-08-08
TRANSFER,115946,Nath Léger,1065560,949614,Emmanuel Bousquet,304093,420039,2022-08-09
CASH_OUT,293708,Emmanuel Bousquet,420039,126331,Agence_moov_Ouidah,300000,6292,2022-08-10
CASH_IN,222407,Agence_moov_Ouidah,300000,77593,Emmanuel Bousquet,126331,348738,2022-08-11
CASH_OUT,13703,Emmanuel Bousquet,348738,335035,Agence_moov_Cotonou,300000,286297,2022-08-14
TRANSFER,9335,Emmanuel Bousquet,335035,325700,Sabine Imbert,678945,669610,2022-08-15
TRANSFER,153945,Emmanuel Bousquet,325700,171755,Frédérique Robin,540200,386255,2022-08-15
CASH_IN,271984,Agence_moov_Abomey,300000,28016,Emmanuel Bousquet,171755,443739,2022-08-17
CASH_IN,117770,Agence_moov_Ouidah,300000,182230,Emmanuel Bousquet,443739,561509,2022-08-18
CASH_OUT,492745,Emmanuel Bousquet,561509,68764,Agence_moov_Ouidah,300000,-192745,2022-08-20
CASH_OUT,15091,Emmanuel Bousquet,68764,53673,Agence_moov_Ouidah,300000,284909,2022-08-23
CASH_OUT,21385,Emmanuel Bousquet,53673,32288,Agence_moov_Ouidah,300000,278615,2022-08-23
CASH_IN,93209,Agence_moov_Abomey,300000,206791,Emmanuel Bousquet,32288,125497,2022-08-24
CASH_IN,44425,Agence_moov_Cotonou,300000,255575,Emmanuel Bousquet,125497,169922,2022-08-25
CASH_OUT,56096,Vincent-Grégoire Brunet,93097,37001,Agence_moov_Cotonou,300000,243904,2022-08-01
CASH_IN,22316,Agence_moov_Abomey,300000,277684,Vincent-Grégoire Brunet,37001,59317,2022-08-02
CASH_OUT,32343,Vincent-Grégoire Brunet,59317,26974,Agence_moov_Cotonou,300000,267657,2022-08-03
TRANSFER,33291,Bernadette Fabre,41005,7714,Vincent-Grégoire Brunet,26974,60265,2022-08-05
CASH_IN,17006,Agence_moov_Ouidah,300000,282994,Vincent-Grégoire Brunet,60265,77271,2022-08-06
CASH_IN,62414,Agence_moov_Ouidah,300000,237586,Vincent-Grégoire Brunet,77271,139685,2022-08-07
TRANSFER,49134,Vincent-Grégoire Brunet,139685,90551,Clémence Bertin,41093,-8041,2022-08-09
TRANSFER,1680,Bernadette Fabre,7714,6034,Vincent-Grégoire Brunet,90551,92231,2022-08-09
CASH_OUT,38247,Vincent-Grégoire Brunet,92231,53984,Agence_moov_Cotonou,300000,261753,2022-08-11
TRANSFER,215,Émilie Guillon de Duhamel,7651,7436,Vincent-Grégoire Brunet,53984,54199,2022-08-12
CASH_IN,44550,Agence_moov_Abomey,300000,255450,Vincent-Grégoire Brunet,54199,98749,2022-08-12
CASH_OUT,79275,Vincent-Grégoire Brunet,98749,19474,Agence_moov_Cotonou,300000,220725,2022-08-12
CASH_OUT,9487,Vincent-Grégoire Brunet,19474,9987,Agence_moov_Ouidah,300000,290513,2022-08-14
TRANSFER,177302,Frédérique Robin,386255,208953,Vincent-Grégoire Brunet,9987,187289,2022-08-15
TRANSFER,1419,Jacques-Antoine Gros,48030,46611,Vincent-Grégoire Brunet,187289,188708,2022-08-15
CASH_IN,236123,Agence_moov_Abomey,300000,63877,Vincent-Grégoire Brunet,188708,424831,2022-08-18
CASH_OUT,7312,Vincent-Grégoire Brunet,424831,417519,Agence_moov_Abomey,300000,292688,2022-08-19
TRANSFER,373287,Caroline Bonneau,556721,183434,Vincent-Grégoire Brunet,417519,790806,2022-08-20
CASH_IN,290435,Agence_moov_Cotonou,300000,9565,Vincent-Grégoire Brunet,790806,1081241,2022-08-21
CASH_IN,91530,Agence_moov_Ouidah,300000,208470,Vincent-Grégoire Brunet,1081241,1172771,2022-08-22
CASH_IN,165486,Agence_moov_Cotonou,300000,134514,Vincent-Grégoire Brunet,1172771,1338257,2022-08-22
CASH_OUT,777467,Vincent-Grégoire Brunet,1338257,560790,Agence_moov_Cotonou,300000,-477467,2022-08-24
CASH_IN,108035,Agence_moov_Ouidah,300000,191965,Vincent-Grégoire Brunet,560790,668825,2022-08-26
CASH_IN,215022,Agence_moov_Abomey,300000,84978,Vincent-Grégoire Brunet,668825,883847,2022-08-26
TRANSFER,151090,Alexandre Poirier,244840,93750,Théophile Mendès,829236,980326,2022-08-01
CASH_IN,163117,Agence_moov_Abomey,300000,136883,Théophile Mendès,980326,1143443,2022-08-01
CASH_OUT,1058683,Théophile Mendès,1143443,84760,Agence_moov_Cotonou,300000,-758683,2022-08-02
CASH_OUT,56994,Théophile Mendès,84760,27766,Agence_moov_Abomey,300000,243006,2022-08-02
CASH_IN,243622,Agence_moov_Ouidah,300000,56378,Théophile Mendès,27766,271388,2022-08-03
CASH_OUT,97288,Théophile Mendès,271388,174100,Agence_moov_Abomey,300000,202712,2022-08-03
CASH_IN,149574,Agence_moov_Abomey,300000,150426,Théophile Mendès,174100,323674,2022-08-03
CASH_IN,62686,Agence_moov_Ouidah,300000,237314,Théophile Mendès,323674,386360,2022-08-05
CASH_OUT,41759,Théophile Mendès,386360,344601,Agence_moov_Abomey,300000,258241,2022-08-07
CASH_OUT,330256,Théophile Mendès,344601,14345,Agence_moov_Cotonou,300000,-30256,2022-08-09
CASH_IN,114854,Agence_moov_Cotonou,300000,185146,Théophile Mendès,14345,129199,2022-08-09
CASH_IN,81832,Agence_moov_Abomey,300000,218168,Théophile Mendès,129199,211031,2022-08-11
TRANSFER,162257,Théophile Mendès,211031,48774,Caroline Monnier,457111,294854,2022-08-14
CASH_IN,266968,Agence_moov_Abomey,300000,33032,Théophile Mendès,48774,315742,2022-08-14
CASH_IN,87591,Agence_moov_Ouidah,300000,212409,Théophile Mendès,315742,403333,2022-08-15
CASH_IN,26727,Agence_moov_Ouidah,300000,273273,Théophile Mendès,403333,430060,2022-08-16
CASH_IN,264683,Agence_moov_Cotonou,300000,35317,Théophile Mendès,430060,694743,2022-08-16
CASH_IN,190159,Agence_moov_Cotonou,300000,109841,Théophile Mendès,694743,884902,2022-08-17
CASH_IN,197419,Agence_moov_Abomey,300000,102581,Théophile Mendès,884902,1082321,2022-08-18
CASH_OUT,914502,Théophile Mendès,1082321,167819,Agence_moov_Cotonou,300000,-614502,2022-08-19
TRANSFER,29345,Laurence Carlier,46060,16715,Théophile Mendès,167819,197164,2022-08-20
CASH_OUT,50205,Théophile Mendès,197164,146959,Agence_moov_Cotonou,300000,249795,2022-08-22
CASH_IN,121852,Agence_moov_Ouidah,300000,178148,Antoine Leroux,277287,399139,2022-08-01
CASH_IN,74562,Agence_moov_Ouidah,300000,225438,Antoine Leroux,399139,473701,2022-08-02
TRANSFER,177832,Frédérique Robin,208953,31121,Antoine Leroux,473701,651533,2022-08-03
CASH_OUT,218236,Antoine Leroux,651533,433297,Agence_moov_Cotonou,300000,81764,2022-08-05
CASH_OUT,89917,Antoine Leroux,433297,343380,Agence_moov_Cotonou,300000,210083,2022-08-06
CASH_OUT,140303,Antoine Leroux,343380,203077,Agence_moov_Abomey,300000,159697,2022-08-06
CASH_IN,244743,Agence_moov_Ouidah,300000,55257,Antoine Leroux,203077,447820,2022-08-06
TRANSFER,6405,Laurence Carlier,16715,10310,Antoine Leroux,447820,454225,2022-08-07
CASH_IN,137005,Agence_moov_Cotonou,300000,162995,Antoine Leroux,454225,591230,2022-08-08
CASH_IN,170584,Agence_moov_Ouidah,300000,129416,Antoine Leroux,591230,761814,2022-08-10
CASH_OUT,557156,Antoine Leroux,761814,204658,Agence_moov_Abomey,300000,-257156,2022-08-11
TRANSFER,125511,Antoine Leroux,204658,79147,Emmanuelle Gilbert,33829,-91682,2022-08-12
TRANSFER,76563,Antoine Leroux,79147,2584,Émile Hebert,116953,40390,2022-08-12
TRANSFER,981,Antoine Leroux,2584,1603,Marthe Guillet,262032,261051,2022-08-13
TRANSFER,1512,Antoine Leroux,1603,91,Lucy Vaillant,3865,2353,2022-08-13
CASH_IN,181781,Agence_moov_Abomey,300000,118219,Antoine Leroux,91,181872,2022-08-13
TRANSFER,30812,Antoine Leroux,181872,151060,Caroline Bonneau,183434,152622,2022-08-14
CASH_IN,241866,Agence_moov_Cotonou,300000,58134,Antoine Leroux,151060,392926,2022-08-15
TRANSFER,2066,Frédérique Robin,31121,29055,Antoine Leroux,392926,394992,2022-08-19
TRANSFER,263506,Antoine Leroux,394992,131486,Xavier-Stéphane Ollivier,13300,-250206,2022-08-19
CASH_OUT,80686,Antoine Leroux,131486,50800,Agence_moov_Ouidah,300000,219314,2022-08-19
CASH_OUT,26263,Antoine Leroux,50800,24537,Agence_moov_Cotonou,300000,273737,2022-08-20
CASH_OUT,15437,Antoine Leroux,24537,9100,Agence_moov_Abomey,300000,284563,2022-08-21
CASH_IN,213502,Agence_moov_Ouidah,300000,86498,Antoine Leroux,9100,222602,2022-08-23
TRANSFER,8579,Auguste Bousquet,9569,990,Antoine Leroux,222602,231181,2022-08-24
CASH_IN,17225,Agence_moov_Abomey,300000,282775,Antoine Leroux,231181,248406,2022-08-24
TRANSFER,206211,Antoine Leroux,248406,42195,Émilie Guillon de Duhamel,7436,-198775,2022-08-25
CASH_IN,212228,Agence_moov_Cotonou,300000,87772,Antoine Leroux,42195,254423,2022-08-26
TRANSFER,305900,Nath Léger,949614,643714,Antoine Leroux,254423,560323,2022-08-27
CASH_IN,169846,Agence_moov_Cotonou,300000,130154,Laurence Carlier,10310,180156,2022-08-01
TRANSFER,159484,Laurence Carlier,180156,20672,Jacques-Antoine Gros,46611,-112873,2022-08-04
CASH_IN,195792,Agence_moov_Cotonou,300000,104208,Laurence Carlier,20672,216464,2022-08-05
CASH_IN,257284,Agence_moov_Abomey,300000,42716,Laurence Carlier,216464,473748,2022-08-05
CASH_IN,136691,Agence_moov_Ouidah,300000,163309,Laurence Carlier,473748,610439,2022-08-06
CASH_OUT,211846,Laurence Carlier,610439,398593,Agence_moov_Cotonou,300000,88154,2022-08-08
CASH_OUT,248852,Laurence Carlier,398593,149741,Agence_moov_Cotonou,300000,51148,2022-08-09
TRANSFER,5944,Laurence Carlier,149741,143797,Nicole Lacroix,694848,688904,2022-08-10
CASH_OUT,48727,Laurence Carlier,143797,95070,Agence_moov_Cotonou,300000,251273,2022-08-12
CASH_OUT,76611,Laurence Carlier,95070,18459,Agence_moov_Ouidah,300000,223389,2022-08-12
CASH_IN,23996,Agence_moov_Ouidah,300000,276004,Laurence Carlier,18459,42455,2022-08-14
CASH_OUT,39002,Laurence Carlier,42455,3453,Agence_moov_Ouidah,300000,260998,2022-08-15
CASH_IN,209189,Agence_moov_Cotonou,300000,90811,Laurence Carlier,3453,212642,2022-08-16
TRANSFER,20465,Caroline Peltier,21287,822,Laurence Carlier,212642,233107,2022-08-17
TRANSFER,228678,Laurence Carlier,233107,4429,Caroline Bonneau,152622,-76056,2022-08-17
CASH_OUT,2991,Laurence Carlier,4429,1438,Agence_moov_Ouidah,300000,297009,2022-08-18
CASH_IN,291487,Agence_moov_Abomey,300000,8513,Laurence Carlier,1438,292925,2022-08-18
CASH_OUT,151030,Laurence Carlier,292925,141895,Agence_moov_Ouidah,300000,148970,2022-08-18
CASH_IN,59371,Agence_moov_Cotonou,300000,240629,Laurence Carlier,141895,201266,2022-08-21
CASH_OUT,146637,Laurence Carlier,201266,54629,Agence_moov_Cotonou,300000,153363,2022-08-23
TRANSFER,32364,Laurence Carlier,54629,22265,Lucy Vaillant,2353,-30011,2022-08-23
TRANSFER,8974,Laurence Carlier,22265,13291,Bernadette Fabre,6034,-2940,2022-08-23
CASH_IN,36438,Agence_moov_Abomey,300000,263562,Laurence Carlier,13291,49729,2022-08-23
CASH_OUT,8024,Laurence Carlier,49729,41705,Agence_moov_Cotonou,300000,291976,2022-08-24
CASH_IN,219744,Agence_moov_Cotonou,300000,80256,Laurence Carlier,41705,261449,2022-08-25
CASH_OUT,4091,Laurence Carlier,261449,257358,Agence_moov_Cotonou,300000,295909,2022-08-26
CASH_OUT,39184,Laurence Carlier,257358,218174,Agence_moov_Ouidah,300000,260816,2022-08-26
TRANSFER,325149,Christophe Guilbert,599972,274823,Laurence Carlier,218174,543323,2022-08-26
TRANSFER,285227,Laurence Carlier,543323,258096,David Diallo,1010698,725471,2022-08-27
CASH_OUT,112126,Laurence Carlier,258096,145970,Agence_moov_Ouidah,300000,187874,2022-08-27
CASH_IN,168799,Agence_moov_Abomey,300000,131201,Jacques-Antoine Gros,-112873,55926,2022-08-03
TRANSFER,842370,Thierry Dos Santos-Le Roux,1711100,868730,Jacques-Antoine Gros,55926,898296,2022-08-05
CASH_IN,32089,Agence_moov_Cotonou,300000,267911,Jacques-Antoine Gros,898296,930385,2022-08-06
CASH_OUT,554262,Jacques-Antoine Gros,930385,376123,Agence_moov_Ouidah,300000,-254262,2022-08-07
CASH_OUT,367855,Jacques-Antoine Gros,376123,8268,Agence_moov_Abomey,300000,-67855,2022-08-09
CASH_OUT,4195,Jacques-Antoine Gros,8268,4073,Agence_moov_Abomey,300000,295805,2022-08-12
TRANSFER,1859,Jacques-Antoine Gros,4073,2214,Michèle Vallée,52435,50576,2022-08-15
CASH_IN,198267,Agence_moov_Abomey,300000,101733,Jacques-Antoine Gros,2214,200481,2022-08-16
CASH_OUT,126673,Jacques-Antoine Gros,200481,73808,Agence_moov_Cotonou,300000,173327,2022-08-17
TRANSFER,583,Jacques-Antoine Gros,73808,73225,Auguste Bousquet,990,407,2022-08-17
CASH_OUT,65827,Jacques-Antoine Gros,73225,7398,Agence_moov_Ouidah,300000,234173,2022-08-21
CASH_IN,80442,Agence_moov_Ouidah,300000,219558,Jacques-Antoine Gros,7398,87840,2022-08-24
CASH_OUT,27278,Jacques-Antoine Gros,87840,60562,Agence_moov_Abomey,300000,272722,2022-08-27
TRANSFER,139255,Christophe Alexandre,405600,266345,Marthe Guillet,261051,121796,2022-08-01
TRANSFER,153636,Christophe Alexandre,266345,112709,David Diallo,725471,571835,2022-08-05
CASH_OUT,26024,Christophe Alexandre,112709,86685,Agence_moov_Ouidah,300000,273976,2022-08-08
CASH_IN,40759,Agence_moov_Cotonou,300000,259241,Christophe Alexandre,86685,127444,2022-08-09
CASH_OUT,117215,Christophe Alexandre,127444,10229,Agence_moov_Cotonou,300000,182785,2022-08-11
TRANSFER,70901,Marthe Guillet,121796,50895,Christophe Alexandre,10229,81130,2022-08-11
TRANSFER,36608,Christophe Alexandre,81130,44522,Caroline Peltier,822,-35786,2022-08-17
CASH_OUT,29424,Christophe Alexandre,44522,15098,Agence_moov_Abomey,300000,270576,2022-08-19
CASH_IN,298246,Agence_moov_Ouidah,300000,1754,Christophe Alexandre,15098,313344,2022-08-19
CASH_OUT,219083,Christophe Alexandre,313344,94261,Agence_moov_Ouidah,300000,80917,2022-08-21
CASH_OUT,87743,Christophe Alexandre,94261,6518,Agence_moov_Cotonou,300000,212257,2022-08-22
CASH_IN,122441,Agence_moov_Ouidah,300000,177559,Clémence Bertin,-8041,114400,2022-08-07
CASH_IN,216902,Agence_moov_Abomey,300000,83098,Clémence Bertin,114400,331302,2022-08-16
CASH_IN,5713,Agence_moov_Ouidah,300000,294287,Clémence Bertin,331302,337015,2022-08-17
TRANSFER,281231,Clémence Bertin,337015,55784,Alex Salmon,1066566,785335,2022-08-19
TRANSFER,55784,Clémence Bertin,55784,0,Stéphane-Timothée Pineau,75907,20123,2022-08-25
CASH_IN,196843,Agence_moov_Abomey,300000,103157,Clémence Bertin,0,196843,2022-08-26
CASH_IN,219695,Agence_moov_Abomey,300000,80305,Clémence Bertin,196843,416538,2022-08-27
CASH_IN,229735,Agence_moov_Abomey,300000,70265,Sabine Imbert,669610,899345,2022-08-02
CASH_IN,188812,Agence_moov_Abomey,300000,111188,Sabine Imbert,899345,1088157,2022-08-05
CASH_OUT,800119,Sabine Imbert,1088157,288038,Agence_moov_Cotonou,300000,-500119,2022-08-07
TRANSFER,221502,Sabine Imbert,288038,66536,Sabine Imbert,288038,66536,2022-08-08
CASH_OUT,3952,Sabine Imbert,66536,62584,Agence_moov_Cotonou,300000,296048,2022-08-09
CASH_OUT,55174,Sabine Imbert,62584,7410,Agence_moov_Ouidah,300000,244826,2022-08-11
CASH_OUT,3618,Sabine Imbert,7410,3792,Agence_moov_Ouidah,300000,296382,2022-08-11
CASH_OUT,2354,Sabine Imbert,3792,1438,Agence_moov_Cotonou,300000,297646,2022-08-12
CASH_OUT,497,Sabine Imbert,1438,941,Agence_moov_Ouidah,300000,299503,2022-08-12
CASH_OUT,237,Sabine Imbert,941,704,Agence_moov_Ouidah,300000,299763,2022-08-14
CASH_IN,119813,Agence_moov_Cotonou,300000,180187,Sabine Imbert,704,120517,2022-08-15
TRANSFER,429871,Josette Guillon-Leclercq,636478,206607,Sabine Imbert,120517,550388,2022-08-15
TRANSFER,29623,Michèle Vallée,50576,20953,Sabine Imbert,550388,580011,2022-08-15
CASH_IN,80065,Agence_moov_Abomey,300000,219935,Sabine Imbert,580011,660076,2022-08-16
CASH_OUT,432699,Sabine Imbert,660076,227377,Agence_moov_Cotonou,300000,-132699,2022-08-18
CASH_OUT,170344,Sabine Imbert,227377,57033,Agence_moov_Ouidah,300000,129656,2022-08-20
TRANSFER,361,Auguste Bousquet,407,46,Sabine Imbert,57033,57394,2022-08-22
CASH_IN,27138,Agence_moov_Ouidah,300000,272862,Sabine Imbert,57394,84532,2022-08-23
CASH_IN,261290,Agence_moov_Cotonou,300000,38710,Sabine Imbert,84532,345822,2022-08-23
CASH_IN,13760,Agence_moov_Cotonou,300000,286240,Sabine Imbert,345822,359582,2022-08-24
CASH_IN,85491,Agence_moov_Abomey,300000,214509,Élodie Gérard,-579061,-493570,2022-08-02
CASH_IN,89826,Agence_moov_Ouidah,300000,210174,Élodie Gérard,-493570,-403744,2022-08-07
CASH_IN,6749,Agence_moov_Ouidah,300000,293251,Élodie Gérard,-403744,-396995,2022-08-09
CASH_IN,29534,Agence_moov_Ouidah,300000,270466,Élodie Gérard,-396995,-367461,2022-08-10
CASH_IN,82580,Agence_moov_Cotonou,300000,217420,Élodie Gérard,-367461,-284881,2022-08-11
CASH_IN,244537,Agence_moov_Abomey,300000,55463,Élodie Gérard,-284881,-40344,2022-08-12
CASH_IN,134242,Agence_moov_Abomey,300000,165758,Élodie Gérard,-40344,93898,2022-08-15
TRANSFER,3220,Élodie Gérard,93898,90678,Michèle Vallée,20953,17733,2022-08-16
CASH_IN,289509,Agence_moov_Cotonou,300000,10491,Élodie Gérard,90678,380187,2022-08-18
CASH_OUT,207222,Élodie Gérard,380187,172965,Agence_moov_Cotonou,300000,92778,2022-08-19
TRANSFER,3752,Alfred Chrétien,39977,36225,Élodie Gérard,172965,176717,2022-08-22
CASH_IN,21403,Agence_moov_Ouidah,300000,278597,Élodie Gérard,176717,198120,2022-08-22
CASH_IN,168092,Agence_moov_Ouidah,300000,131908,Élodie Gérard,198120,366212,2022-08-25
CASH_OUT,144179,Élodie Gérard,366212,222033,Agence_moov_Cotonou,300000,155821,2022-08-26
CASH_IN,173803,Agence_moov_Cotonou,300000,126197,Océane Boutin,-2312,171491,2022-08-07
CASH_OUT,52846,Océane Boutin,171491,118645,Agence_moov_Abomey,300000,247154,2022-08-16
CASH_OUT,28816,Océane Boutin,118645,89829,Agence_moov_Cotonou,300000,271184,2022-08-16
CASH_IN,243213,Agence_moov_Ouidah,300000,56787,Océane Boutin,89829,333042,2022-08-22
TRANSFER,2599,Frédérique Robin,29055,26456,Océane Boutin,333042,335641,2022-08-24
CASH_IN,143373,Agence_moov_Cotonou,300000,156627,Océane Boutin,335641,479014,2022-08-27
CASH_IN,189061,Agence_moov_Ouidah,300000,110939,Emmanuelle Gilbert,-91682,97379,2022-08-04
TRANSFER,7635,Michèle Vallée,17733,10098,Emmanuelle Gilbert,97379,105014,2022-08-06
CASH_OUT,5197,Emmanuelle Gilbert,105014,99817,Agence_moov_Abomey,300000,294803,2022-08-08
CASH_OUT,99566,Emmanuelle Gilbert,99817,251,Agence_moov_Ouidah,300000,200434,2022-08-08
CASH_OUT,241,Emmanuelle Gilbert,251,10,Agence_moov_Cotonou,300000,299759,2022-08-11
CASH_IN,131750,Agence_moov_Cotonou,300000,168250,Emmanuelle Gilbert,10,131760,2022-08-11
CASH_IN,169449,Agence_moov_Ouidah,300000,130551,Emmanuelle Gilbert,131760,301209,2022-08-13
TRANSFER,21472,Marthe Guillet,50895,29423,Emmanuelle Gilbert,301209,322681,2022-08-13
TRANSFER,67062,Emmanuelle Gilbert,322681,255619,Emmanuelle Gilbert,322681,255619,2022-08-15
CASH_OUT,194777,Emmanuelle Gilbert,255619,60842,Agence_moov_Cotonou,300000,105223,2022-08-16
TRANSFER,12143,Emmanuelle Gilbert,60842,48699,Alex Salmon,785335,773192,2022-08-18
CASH_IN,17616,Agence_moov_Cotonou,300000,282384,Emmanuelle Gilbert,48699,66315,2022-08-19
CASH_IN,89222,Agence_moov_Abomey,300000,210778,Emmanuelle Gilbert,66315,155537,2022-08-19
CASH_IN,138409,Agence_moov_Abomey,300000,161591,Emmanuelle Gilbert,155537,293946,2022-08-22
CASH_IN,73002,Agence_moov_Abomey,300000,226998,Emmanuelle Gilbert,293946,366948,2022-08-26
TRANSFER,587108,Thierry Dos Santos-Le Roux,868730,281622,Hugues Gay,778864,1365972,2022-08-02
CASH_OUT,681165,Hugues Gay,1365972,684807,Agence_moov_Ouidah,300000,-381165,2022-08-09
TRANSFER,163580,Thierry Dos Santos-Le Roux,281622,118042,Hugues Gay,684807,848387,2022-08-10
TRANSFER,480237,Hugues Gay,848387,368150,Hugues Gay,848387,1328624,2022-08-12
TRANSFER,40749,Nath Léger,643714,602965,Hugues Gay,368150,408899,2022-08-14
CASH_IN,58918,Agence_moov_Abomey,300000,241082,Hugues Gay,408899,467817,2022-08-17
CASH_OUT,200721,Hugues Gay,467817,267096,Agence_moov_Abomey,300000,99279,2022-08-19
CASH_OUT,90212,Hugues Gay,267096,176884,Agence_moov_Ouidah,300000,209788,2022-08-21
CASH_IN,114774,Agence_moov_Cotonou,300000,185226,Hugues Gay,176884,291658,2022-08-21
CASH_IN,181313,Agence_moov_Ouidah,300000,118687,Hugues Gay,291658,472971,2022-08-23
CASH_IN,94796,Agence_moov_Abomey,300000,205204,Marthe Guillet,29423,124219,2022-08-02
CASH_OUT,109065,Marthe Guillet,124219,15154,Agence_moov_Abomey,300000,190935,2022-08-04
CASH_IN,233833,Agence_moov_Cotonou,300000,66167,Marthe Guillet,15154,248987,2022-08-05
CASH_IN,180182,Agence_moov_Ouidah,300000,119818,Marthe Guillet,248987,429169,2022-08-14
TRANSFER,249531,Marthe Guillet,429169,179638,Alexandre Poirier,93750,-155781,2022-08-16
CASH_IN,76222,Agence_moov_Ouidah,300000,223778,Marthe Guillet,179638,255860,2022-08-20
CASH_OUT,68072,Marthe Guillet,255860,187788,Agence_moov_Abomey,300000,231928,2022-08-21
CASH_IN,241270,Agence_moov_Abomey,300000,58730,Marthe Guillet,187788,429058,2022-08-22
CASH_IN,280824,Agence_moov_Abomey,300000,19176,Marthe Guillet,429058,709882,2022-08-23
TRANSFER,634260,Marthe Guillet,709882,75622,David Diallo,571835,-62425,2022-08-25
CASH_OUT,46681,Marthe Guillet,75622,28941,Agence_moov_Abomey,300000,253319,2022-08-26
CASH_IN,162757,Agence_moov_Ouidah,300000,137243,Caroline Bonneau,-76056,86701,2022-08-01
CASH_IN,260178,Agence_moov_Cotonou,300000,39822,Caroline Bonneau,86701,346879,2022-08-02
CASH_OUT,5313,Caroline Bonneau,346879,341566,Agence_moov_Abomey,300000,294687,2022-08-05
TRANSFER,169046,Caroline Monnier,294854,125808,Caroline Bonneau,341566,510612,2022-08-06
CASH_OUT,219809,Caroline Bonneau,510612,290803,Agence_moov_Abomey,300000,80191,2022-08-12
CASH_IN,23544,Agence_moov_Cotonou,300000,276456,Caroline Bonneau,290803,314347,2022-08-12
CASH_OUT,262055,Caroline Bonneau,314347,52292,Agence_moov_Abomey,300000,37945,2022-08-13
TRANSFER,74425,Thierry Dos Santos-Le Roux,118042,43617,Caroline Bonneau,52292,126717,2022-08-14
CASH_OUT,17807,Caroline Bonneau,126717,108910,Agence_moov_Ouidah,300000,282193,2022-08-15
TRANSFER,57927,Caroline Bonneau,108910,50983,Frédérique Robin,26456,-31471,2022-08-16
CASH_IN,290937,Agence_moov_Cotonou,300000,9063,Caroline Bonneau,50983,341920,2022-08-18
CASH_OUT,140921,Caroline Bonneau,341920,200999,Agence_moov_Cotonou,300000,159079,2022-08-20
CASH_IN,91090,Agence_moov_Ouidah,300000,208910,Caroline Bonneau,200999,292089,2022-08-20
TRANSFER,53879,Caroline Bonneau,292089,238210,Alfred Chrétien,36225,-17654,2022-08-22
CASH_OUT,190982,Caroline Bonneau,238210,47228,Agence_moov_Cotonou,300000,109018,2022-08-26
TRANSFER,77498,Noémi de la Didier,94374,16876,Caroline Bonneau,47228,124726,2022-08-27
CASH_IN,74442,Agence_moov_Cotonou,300000,225558,Bernadette Fabre,-2940,71502,2022-08-05
CASH_OUT,2251,Bernadette Fabre,71502,69251,Agence_moov_Abomey,300000,297749,2022-08-05
TRANSFER,3139,Bernadette Fabre,69251,66112,Arnaude Gaillard,181398,178259,2022-08-05
CASH_IN,9713,Agence_moov_Cotonou,300000,290287,Bernadette Fabre,66112,75825,2022-08-06
TRANSFER,27845,Émile Hebert,40390,12545,Bernadette Fabre,75825,103670,2022-08-06
CASH_OUT,17869,Bernadette Fabre,103670,85801,Agence_moov_Abomey,300000,282131,2022-08-07
CASH_OUT,34258,Bernadette Fabre,85801,51543,Agence_moov_Abomey,300000,265742,2022-08-08
CASH_OUT,48067,Bernadette Fabre,51543,3476,Agence_moov_Abomey,300000,251933,2022-08-11
CASH_IN,93753,Agence_moov_Ouidah,300000,206247,Bernadette Fabre,3476,97229,2022-08-12
CASH_IN,181015,Agence_moov_Abomey,300000,118985,Bernadette Fabre,97229,278244,2022-08-20
TRANSFER,14947,Noémi de la Didier,16876,1929,Bernadette Fabre,278244,293191,2022-08-20
CASH_IN,161405,Agence_moov_Ouidah,300000,138595,Bernadette Fabre,293191,454596,2022-08-21
TRANSFER,199624,Christophe Guilbert,274823,75199,Bernadette Fabre,454596,654220,2022-08-23
CASH_OUT,360033,Bernadette Fabre,654220,294187,Agence_moov_Cotonou,300000,-60033,2022-08-26
TRANSFER,24071,Bernadette Fabre,294187,270116,Maryse Reynaud-Michaud,617573,593502,2022-08-26
CASH_OUT,6787,Bernadette Fabre,270116,263329,Agence_moov_Abomey,300000,293213,2022-08-27
TRANSFER,420853,Nath Léger,602965,182112,Caroline Monnier,125808,-295045,2022-08-01
TRANSFER,170833,Maurice Alves,210100,39267,Nath Léger,182112,352945,2022-08-03
CASH_OUT,330051,Nath Léger,352945,22894,Agence_moov_Abomey,300000,-30051,2022-08-03
CASH_IN,16795,Agence_moov_Abomey,300000,283205,Nath Léger,22894,39689,2022-08-03
CASH_IN,112118,Agence_moov_Cotonou,300000,187882,Nath Léger,39689,151807,2022-08-04
TRANSFER,674878,Marthe Pichon,1684100,1009222,Nath Léger,151807,826685,2022-08-07
CASH_IN,134726,Agence_moov_Ouidah,300000,165274,Nath Léger,826685,961411,2022-08-09
TRANSFER,415155,Nath Léger,961411,546256,Nathalie-Chantal Jacques,312672,-102483,2022-08-11
TRANSFER,296569,Nath Léger,546256,249687,Nath Léger,546256,842825,2022-08-15
TRANSFER,189093,Nath Léger,249687,60594,Arnaude Gaillard,178259,-10834,2022-08-16
CASH_OUT,51567,Nath Léger,60594,9027,Agence_moov_Ouidah,300000,248433,2022-08-19
CASH_IN,142912,Agence_moov_Ouidah,300000,157088,Nath Léger,9027,151939,2022-08-19
TRANSFER,180132,Antoine Bourdon de Auger,440806,260674,Nath Léger,151939,332071,2022-08-20
TRANSFER,201266,Maryse Reynaud-Michaud,593502,392236,Nath Léger,332071,533337,2022-08-21
CASH_OUT,323474,Nath Léger,533337,209863,Agence_moov_Ouidah,300000,-23474,2022-08-21
TRANSFER,1241,Émile Hebert,12545,11304,Nath Léger,209863,211104,2022-08-21
CASH_IN,77356,Agence_moov_Cotonou,300000,222644,Nath Léger,211104,288460,2022-08-24
CASH_OUT,10272,Nath Léger,288460,278188,Agence_moov_Cotonou,300000,289728,2022-08-27
CASH_IN,245461,Agence_moov_Cotonou,300000,54539,Agnès Chrétien-Sanchez,-74967,170494,2022-08-01
TRANSFER,1055,Noémi de la Didier,1929,874,Agnès Chrétien-Sanchez,170494,171549,2022-08-02
TRANSFER,442,Stéphane-Timothée Pineau,20123,19681,Agnès Chrétien-Sanchez,171549,171991,2022-08-07
CASH_IN,19364,Agence_moov_Abomey,300000,280636,Agnès Chrétien-Sanchez,171991,191355,2022-08-07
TRANSFER,186773,Alex Salmon,773192,586419,Agnès Chrétien-Sanchez,191355,378128,2022-08-10
CASH_OUT,223458,Agnès Chrétien-Sanchez,378128,154670,Agence_moov_Cotonou,300000,76542,2022-08-10
CASH_IN,109139,Agence_moov_Ouidah,300000,190861,Agnès Chrétien-Sanchez,154670,263809,2022-08-12
TRANSFER,44235,Agnès Chrétien-Sanchez,263809,219574,Josette Guillon-Leclercq,206607,162372,2022-08-12
CASH_IN,271065,Agence_moov_Abomey,300000,28935,Agnès Chrétien-Sanchez,219574,490639,2022-08-13
CASH_IN,158532,Agence_moov_Abomey,300000,141468,Agnès Chrétien-Sanchez,490639,649171,2022-08-14
CASH_IN,239325,Agence_moov_Abomey,300000,60675,Agnès Chrétien-Sanchez,649171,888496,2022-08-14
CASH_IN,282628,Agence_moov_Abomey,300000,17372,Agnès Chrétien-Sanchez,888496,1171124,2022-08-15
TRANSFER,419334,Agnès Chrétien-Sanchez,1171124,751790,Christophe Guilbert,75199,-344135,2022-08-17
CASH_IN,164686,Agence_moov_Ouidah,300000,135314,Agnès Chrétien-Sanchez,751790,916476,2022-08-19
CASH_OUT,112707,Agnès Chrétien-Sanchez,916476,803769,Agence_moov_Cotonou,300000,187293,2022-08-19
TRANSFER,655427,Agnès Chrétien-Sanchez,803769,148342,Noémi de la Didier,874,-654553,2022-08-20
TRANSFER,118562,Nicole Lacroix,688904,570342,Agnès Chrétien-Sanchez,148342,266904,2022-08-20
CASH_IN,270439,Agence_moov_Ouidah,300000,29561,Agnès Chrétien-Sanchez,266904,537343,2022-08-22
CASH_IN,118662,Agence_moov_Ouidah,300000,181338,Agnès Chrétien-Sanchez,537343,656005,2022-08-27
CASH_IN,290357,Agence_moov_Abomey,300000,9643,David Diallo,-62425,227932,2022-08-03
CASH_IN,267405,Agence_moov_Abomey,300000,32595,David Diallo,227932,495337,2022-08-03
CASH_OUT,375251,David Diallo,495337,120086,Agence_moov_Ouidah,300000,-75251,2022-08-08
CASH_IN,8819,Agence_moov_Ouidah,300000,291181,David Diallo,120086,128905,2022-08-08
CASH_IN,183439,Agence_moov_Abomey,300000,116561,David Diallo,128905,312344,2022-08-13
CASH_IN,172376,Agence_moov_Cotonou,300000,127624,David Diallo,312344,484720,2022-08-15
CASH_OUT,205966,David Diallo,484720,278754,Agence_moov_Cotonou,300000,94034,2022-08-16
TRANSFER,150327,David Diallo,278754,128427,Émile Hebert,11304,-139023,2022-08-18
TRANSFER,4716,Michèle Vallée,10098,5382,David Diallo,128427,133143,2022-08-19
CASH_OUT,105334,David Diallo,133143,27809,Agence_moov_Ouidah,300000,194666,2022-08-20
CASH_IN,146739,Agence_moov_Ouidah,300000,153261,Marianne Descamps,-46194,100545,2022-08-01
CASH_IN,129830,Agence_moov_Abomey,300000,170170,Marianne Descamps,100545,230375,2022-08-13
CASH_OUT,90130,Marianne Descamps,230375,140245,Agence_moov_Ouidah,300000,209870,2022-08-13
TRANSFER,38969,Marianne Descamps,140245,101276,Nicole Lacroix,570342,531373,2022-08-17
CASH_IN,44410,Agence_moov_Abomey,300000,255590,Marianne Descamps,101276,145686,2022-08-17
CASH_IN,84397,Agence_moov_Ouidah,300000,215603,Marianne Descamps,145686,230083,2022-08-17
CASH_IN,292946,Agence_moov_Abomey,300000,7054,Marianne Descamps,230083,523029,2022-08-19
TRANSFER,496895,Marianne Descamps,523029,26134,Thierry Dos Santos-Le Roux,43617,-453278,2022-08-24
TRANSFER,7980,Stéphane-Timothée Pineau,19681,11701,Marianne Descamps,26134,34114,2022-08-27
CASH_IN,190627,Agence_moov_Cotonou,300000,109373,Agnès Baron,-304312,-113685,2022-08-01
CASH_IN,220864,Agence_moov_Cotonou,300000,79136,Agnès Baron,-113685,107179,2022-08-01
CASH_OUT,6488,Agnès Baron,107179,100691,Agence_moov_Abomey,300000,293512,2022-08-04
TRANSFER,712899,Marthe Pichon,1009222,296323,Agnès Baron,100691,813590,2022-08-06
CASH_OUT,398708,Agnès Baron,813590,414882,Agence_moov_Ouidah,300000,-98708,2022-08-06
CASH_OUT,177911,Agnès Baron,414882,236971,Agence_moov_Abomey,300000,122089,2022-08-08
CASH_IN,82392,Agence_moov_Cotonou,300000,217608,Agnès Baron,236971,319363,2022-08-11
CASH_OUT,315314,Agnès Baron,319363,4049,Agence_moov_Abomey,300000,-15314,2022-08-12
CASH_OUT,1515,Agnès Baron,4049,2534,Agence_moov_Ouidah,300000,298485,2022-08-15
CASH_OUT,1913,Agnès Baron,2534,621,Agence_moov_Abomey,300000,298087,2022-08-16
CASH_IN,114844,Agence_moov_Cotonou,300000,185156,Agnès Baron,621,115465,2022-08-18
CASH_IN,123901,Agence_moov_Ouidah,300000,176099,Agnès Baron,115465,239366,2022-08-19
CASH_OUT,119795,Agnès Baron,239366,119571,Agence_moov_Ouidah,300000,180205,2022-08-23
CASH_IN,95752,Agence_moov_Cotonou,300000,204248,Agnès Baron,119571,215323,2022-08-25
CASH_IN,271106,Agence_moov_Ouidah,300000,28894,Xavier-Stéphane Ollivier,-250206,20900,2022-08-06
TRANSFER,14135,Marthe Pichon,296323,282188,Xavier-Stéphane Ollivier,20900,35035,2022-08-08
CASH_IN,291405,Agence_moov_Abomey,300000,8595,Xavier-Stéphane Ollivier,35035,326440,2022-08-08
TRANSFER,113660,Xavier-Stéphane Ollivier,326440,212780,Maryse Reynaud-Michaud,392236,278576,2022-08-12
CASH_OUT,63393,Xavier-Stéphane Ollivier,212780,149387,Agence_moov_Abomey,300000,236607,2022-08-13
CASH_IN,117995,Agence_moov_Cotonou,300000,182005,Xavier-Stéphane Ollivier,149387,267382,2022-08-15
CASH_IN,194187,Agence_moov_Cotonou,300000,105813,Xavier-Stéphane Ollivier,267382,461569,2022-08-17
CASH_OUT,402596,Xavier-Stéphane Ollivier,461569,58973,Agence_moov_Cotonou,300000,-102596,2022-08-18
TRANSFER,46749,Xavier-Stéphane Ollivier,58973,12224,Nicole Lacroix,531373,484624,2022-08-23
CASH_IN,18542,Agence_moov_Ouidah,300000,281458,Xavier-Stéphane Ollivier,12224,30766,2022-08-25
TRANSFER,104299,Alex Salmon,586419,482120,Alex Salmon,586419,690718,2022-08-01
CASH_IN,163416,Agence_moov_Cotonou,300000,136584,Alex Salmon,482120,645536,2022-08-01
CASH_IN,36729,Agence_moov_Cotonou,300000,263271,Alex Salmon,645536,682265,2022-08-02
CASH_OUT,321742,Alex Salmon,682265,360523,Agence_moov_Ouidah,300000,-21742,2022-08-03
CASH_IN,60784,Agence_moov_Cotonou,300000,239216,Alex Salmon,360523,421307,2022-08-04
TRANSFER,409509,Alex Salmon,421307,11798,Gilbert Bazin Le Guillet,176000,-233509,2022-08-05
TRANSFER,11698,Alex Salmon,11798,100,Stéphane-Timothée Pineau,11701,3,2022-08-05
CASH_IN,75679,Agence_moov_Abomey,300000,224321,Alex Salmon,100,75779,2022-08-06
CASH_IN,92148,Agence_moov_Cotonou,300000,207852,Alex Salmon,75779,167927,2022-08-09
TRANSFER,40055,Alex Salmon,167927,127872,Antoine Bourdon de Auger,260674,220619,2022-08-11
CASH_OUT,84533,Alex Salmon,127872,43339,Agence_moov_Cotonou,300000,215467,2022-08-15
CASH_OUT,23537,Alex Salmon,43339,19802,Agence_moov_Ouidah,300000,276463,2022-08-16
CASH_OUT,8975,Alex Salmon,19802,10827,Agence_moov_Ouidah,300000,291025,2022-08-17
CASH_IN,173346,Agence_moov_Abomey,300000,126654,Alex Salmon,10827,184173,2022-08-20
CASH_IN,248904,Agence_moov_Ouidah,300000,51096,Alex Salmon,184173,433077,2022-08-20
CASH_IN,298572,Agence_moov_Abomey,300000,1428,Alex Salmon,433077,731649,2022-08-23
CASH_IN,92405,Agence_moov_Ouidah,300000,207595,Alex Salmon,731649,824054,2022-08-23
CASH_IN,214785,Agence_moov_Ouidah,300000,85215,Alexandre Poirier,-155781,59004,2022-08-01
CASH_IN,27396,Agence_moov_Cotonou,300000,272604,Alexandre Poirier,59004,86400,2022-08-03
CASH_OUT,78863,Alexandre Poirier,86400,7537,Agence_moov_Abomey,300000,221137,2022-08-04
CASH_IN,169933,Agence_moov_Cotonou,300000,130067,Alexandre Poirier,7537,177470,2022-08-06
CASH_OUT,37848,Alexandre Poirier,177470,139622,Agence_moov_Cotonou,300000,262152,2022-08-09
CASH_OUT,92978,Alexandre Poirier,139622,46644,Agence_moov_Cotonou,300000,207022,2022-08-09
CASH_IN,185568,Agence_moov_Cotonou,300000,114432,Alexandre Poirier,46644,232212,2022-08-15
CASH_IN,178560,Agence_moov_Ouidah,300000,121440,Alexandre Poirier,232212,410772,2022-08-16
CASH_IN,21643,Agence_moov_Abomey,300000,278357,Alexandre Poirier,410772,432415,2022-08-20
CASH_IN,1347,Agence_moov_Abomey,300000,298653,Alexandre Poirier,432415,433762,2022-08-21
TRANSFER,27356,Marthe Pichon,282188,254832,Alexandre Poirier,433762,461118,2022-08-21
TRANSFER,31179,Maurice Alves,39267,8088,Alexandre Poirier,461118,492297,2022-08-23
CASH_IN,132278,Agence_moov_Cotonou,300000,167722,Alexandre Poirier,492297,624575,2022-08-24
TRANSFER,460287,Alexandre Poirier,624575,164288,Maurice Alves,8088,-452199,2022-08-24
TRANSFER,145436,Antoine Bourdon de Auger,220619,75183,Alexandre Poirier,164288,309724,2022-08-26
CASH_IN,101621,Agence_moov_Abomey,300000,198379,Christophe Guilbert,-344135,-242514,2022-08-03
CASH_IN,144672,Agence_moov_Ouidah,300000,155328,Christophe Guilbert,-242514,-97842,2022-08-03
CASH_IN,65921,Agence_moov_Cotonou,300000,234079,Christophe Guilbert,-97842,-31921,2022-08-07
CASH_IN,207910,Agence_moov_Ouidah,300000,92090,Christophe Guilbert,-31921,175989,2022-08-09
CASH_IN,146227,Agence_moov_Abomey,300000,153773,Christophe Guilbert,175989,322216,2022-08-09
CASH_OUT,31270,Christophe Guilbert,322216,290946,Agence_moov_Cotonou,300000,268730,2022-08-09
CASH_IN,295049,Agence_moov_Abomey,300000,4951,Christophe Guilbert,290946,585995,2022-08-13
CASH_IN,22706,Agence_moov_Abomey,300000,277294,Christophe Guilbert,585995,608701,2022-08-13
CASH_IN,168212,Agence_moov_Ouidah,300000,131788,Christophe Guilbert,608701,776913,2022-08-14
CASH_OUT,97407,Christophe Guilbert,776913,679506,Agence_moov_Abomey,300000,202593,2022-08-16
TRANSFER,1208,Michèle Vallée,5382,4174,Christophe Guilbert,679506,680714,2022-08-21
CASH_IN,133682,Agence_moov_Ouidah,300000,166318,Christophe Guilbert,680714,814396,2022-08-21
CASH_IN,236086,Agence_moov_Ouidah,300000,63914,Christophe Guilbert,814396,1050482,2022-08-22
CASH_IN,1077,Agence_moov_Abomey,300000,298923,Christophe Guilbert,1050482,1051559,2022-08-23
CASH_OUT,838918,Christophe Guilbert,1051559,212641,Agence_moov_Cotonou,300000,-538918,2022-08-24
CASH_OUT,5786,Christophe Guilbert,212641,206855,Agence_moov_Ouidah,300000,294214,2022-08-25
CASH_IN,108353,Agence_moov_Abomey,300000,191647,Christophe Guilbert,206855,315208,2022-08-26
TRANSFER,26425,Christophe Guilbert,315208,288783,Marthe Pichon,254832,228407,2022-08-26
CASH_IN,15257,Agence_moov_Ouidah,300000,284743,Alfred Chrétien,-17654,-2397,2022-08-05
CASH_IN,54778,Agence_moov_Abomey,300000,245222,Alfred Chrétien,-2397,52381,2022-08-11
CASH_IN,28819,Agence_moov_Ouidah,300000,271181,Alfred Chrétien,52381,81200,2022-08-12
TRANSFER,46831,Alfred Chrétien,81200,34369,Nicole Lacroix,484624,437793,2022-08-15
CASH_IN,72330,Agence_moov_Abomey,300000,227670,Alfred Chrétien,34369,106699,2022-08-25
CASH_OUT,89096,Alfred Chrétien,106699,17603,Agence_moov_Abomey,300000,210904,2022-08-27
CASH_IN,248157,Agence_moov_Ouidah,300000,51843,Christine-Constance Gauthier,-299790,-51633,2022-08-03
CASH_IN,167390,Agence_moov_Abomey,300000,132610,Christine-Constance Gauthier,-51633,115757,2022-08-03
TRANSFER,254819,Nicole Lacroix,437793,182974,Christine-Constance Gauthier,115757,370576,2022-08-04
CASH_OUT,111554,Christine-Constance Gauthier,370576,259022,Agence_moov_Ouidah,300000,188446,2022-08-04
CASH_OUT,169053,Christine-Constance Gauthier,259022,89969,Agence_moov_Ouidah,300000,130947,2022-08-05
CASH_IN,62110,Agence_moov_Cotonou,300000,237890,Christine-Constance Gauthier,89969,152079,2022-08-06
TRANSFER,38468,Christine-Constance Gauthier,152079,113611,Christine-Constance Gauthier,152079,113611,2022-08-07
CASH_IN,206846,Agence_moov_Abomey,300000,93154,Christine-Constance Gauthier,113611,320457,2022-08-09
CASH_OUT,6018,Christine-Constance Gauthier,320457,314439,Agence_moov_Cotonou,300000,293982,2022-08-10
CASH_OUT,28818,Christine-Constance Gauthier,314439,285621,Agence_moov_Abomey,300000,271182,2022-08-11
CASH_OUT,102510,Christine-Constance Gauthier,285621,183111,Agence_moov_Ouidah,300000,197490,2022-08-14
CASH_OUT,123849,Christine-Constance Gauthier,183111,59262,Agence_moov_Cotonou,300000,176151,2022-08-14
TRANSFER,51423,Christine-Constance Gauthier,59262,7839,Antoine Bourdon de Auger,75183,23760,2022-08-15
TRANSFER,1671,Christine-Constance Gauthier,7839,6168,Josette Guillon-Leclercq,162372,160701,2022-08-18
CASH_OUT,2149,Christine-Constance Gauthier,6168,4019,Agence_moov_Cotonou,300000,297851,2022-08-22
CASH_IN,66361,Agence_moov_Abomey,300000,233639,Caroline Monnier,-295045,-228684,2022-08-02
CASH_IN,14167,Agence_moov_Cotonou,300000,285833,Caroline Monnier,-228684,-214517,2022-08-03
CASH_IN,98888,Agence_moov_Ouidah,300000,201112,Caroline Monnier,-214517,-115629,2022-08-03
CASH_IN,48647,Agence_moov_Cotonou,300000,251353,Caroline Monnier,-115629,-66982,2022-08-03
CASH_IN,199220,Agence_moov_Ouidah,300000,100780,Caroline Monnier,-66982,132238,2022-08-05
CASH_IN,216701,Agence_moov_Cotonou,300000,83299,Caroline Monnier,132238,348939,2022-08-09
CASH_IN,75312,Agence_moov_Cotonou,300000,224688,Caroline Monnier,348939,424251,2022-08-10
TRANSFER,191940,Caroline Monnier,424251,232311,Marthe Pichon,228407,36467,2022-08-12
TRANSFER,8206,Caroline Monnier,232311,224105,Marthe Pichon,36467,28261,2022-08-13
CASH_OUT,118950,Caroline Monnier,224105,105155,Agence_moov_Abomey,300000,181050,2022-08-13
CASH_IN,187619,Agence_moov_Ouidah,300000,112381,Caroline Monnier,105155,292774,2022-08-14
CASH_IN,223363,Agence_moov_Cotonou,300000,76637,Caroline Monnier,292774,516137,2022-08-15
CASH_OUT,196769,Caroline Monnier,516137,319368,Agence_moov_Abomey,300000,103231,2022-08-16
CASH_OUT,126584,Caroline Monnier,319368,192784,Agence_moov_Ouidah,300000,173416,2022-08-20
TRANSFER,182921,Caroline Monnier,192784,9863,Antoine Bourdon de Auger,23760,-159161,2022-08-20
CASH_OUT,6629,Caroline Monnier,9863,3234,Agence_moov_Cotonou,300000,293371,2022-08-27
CASH_IN,168995,Agence_moov_Ouidah,300000,131005,Gilbert Bazin Le Guillet,-233509,-64514,2022-08-01
CASH_IN,4774,Agence_moov_Ouidah,300000,295226,Gilbert Bazin Le Guillet,-64514,-59740,2022-08-02
CASH_IN,18818,Agence_moov_Ouidah,300000,281182,Gilbert Bazin Le Guillet,-59740,-40922,2022-08-04
CASH_IN,179480,Agence_moov_Abomey,300000,120520,Gilbert Bazin Le Guillet,-40922,138558,2022-08-05
TRANSFER,25704,Gilbert Bazin Le Guillet,138558,112854,Gilbert Bazin Le Guillet,138558,112854,2022-08-05
CASH_OUT,25936,Gilbert Bazin Le Guillet,112854,86918,Agence_moov_Abomey,300000,274064,2022-08-08
CASH_OUT,54720,Gilbert Bazin Le Guillet,86918,32198,Agence_moov_Ouidah,300000,245280,2022-08-09
CASH_IN,130999,Agence_moov_Ouidah,300000,169001,Gilbert Bazin Le Guillet,32198,163197,2022-08-11
CASH_OUT,154171,Gilbert Bazin Le Guillet,163197,9026,Agence_moov_Ouidah,300000,145829,2022-08-11
CASH_OUT,1560,Gilbert Bazin Le Guillet,9026,7466,Agence_moov_Cotonou,300000,298440,2022-08-12
CASH_OUT,1878,Gilbert Bazin Le Guillet,7466,5588,Agence_moov_Cotonou,300000,298122,2022-08-17
TRANSFER,997,Gilbert Bazin Le Guillet,5588,4591,Nicole Lacroix,182974,181977,2022-08-17
CASH_IN,100218,Agence_moov_Abomey,300000,199782,Gilbert Bazin Le Guillet,4591,104809,2022-08-18
CASH_OUT,41923,Gilbert Bazin Le Guillet,104809,62886,Agence_moov_Cotonou,300000,258077,2022-08-20
TRANSFER,40669,Gilbert Bazin Le Guillet,62886,22217,Josette Guillon-Leclercq,160701,120032,2022-08-20
TRANSFER,3286,Marthe Pichon,28261,24975,Gilbert Bazin Le Guillet,22217,25503,2022-08-22
CASH_OUT,23413,Gilbert Bazin Le Guillet,25503,2090,Agence_moov_Abomey,300000,276587,2022-08-23
TRANSFER,349,Gilbert Bazin Le Guillet,2090,1741,Michèle Vallée,4174,3825,2022-08-24
TRANSFER,203,Gilbert Bazin Le Guillet,1741,1538,Nicole Lacroix,181977,181774,2022-08-27
CASH_IN,26747,Agence_moov_Ouidah,300000,273253,Laurent Perrot,-1799985,-1773238,2022-08-01
CASH_IN,247558,Agence_moov_Cotonou,300000,52442,Laurent Perrot,-1773238,-1525680,2022-08-02
CASH_IN,165305,Agence_moov_Ouidah,300000,134695,Laurent Perrot,-1525680,-1360375,2022-08-02
CASH_IN,133126,Agence_moov_Abomey,300000,166874,Laurent Perrot,-1360375,-1227249,2022-08-04
CASH_IN,185261,Agence_moov_Abomey,300000,114739,Laurent Perrot,-1227249,-1041988,2022-08-06
CASH_IN,223212,Agence_moov_Abomey,300000,76788,Laurent Perrot,-1041988,-818776,2022-08-08
CASH_IN,142922,Agence_moov_Ouidah,300000,157078,Laurent Perrot,-818776,-675854,2022-08-10
CASH_IN,97594,Agence_moov_Abomey,300000,202406,Laurent Perrot,-675854,-578260,2022-08-13
CASH_IN,142404,Agence_moov_Cotonou,300000,157596,Laurent Perrot,-578260,-435856,2022-08-14
CASH_IN,68478,Agence_moov_Cotonou,300000,231522,Laurent Perrot,-435856,-367378,2022-08-21
CASH_IN,240227,Agence_moov_Ouidah,300000,59773,Laurent Perrot,-367378,-127151,2022-08-21
CASH_IN,220567,Agence_moov_Ouidah,300000,79433,Laurent Perrot,-127151,93416,2022-08-21
CASH_IN,197848,Agence_moov_Abomey,300000,102152,Laurent Perrot,93416,291264,2022-08-21
CASH_IN,76771,Agence_moov_Cotonou,300000,223229,Laurent Perrot,291264,368035,2022-08-22
TRANSFER,244803,Laurent Perrot,368035,123232,Josette Guillon-Leclercq,120032,-124771,2022-08-23
CASH_OUT,82100,Laurent Perrot,123232,41132,Agence_moov_Abomey,300000,217900,2022-08-27
CASH_IN,143371,Agence_moov_Abomey,300000,156629,Frédérique Robin,-31471,111900,2022-08-02
CASH_OUT,28709,Frédérique Robin,111900,83191,Agence_moov_Cotonou,300000,271291,2022-08-02
TRANSFER,19819,Marthe Pichon,24975,5156,Frédérique Robin,83191,103010,2022-08-02
CASH_OUT,52458,Frédérique Robin,103010,50552,Agence_moov_Abomey,300000,247542,2022-08-05
TRANSFER,13586,Frédérique Robin,50552,36966,Frédérique Robin,50552,36966,2022-08-06
CASH_OUT,14569,Frédérique Robin,36966,22397,Agence_moov_Ouidah,300000,285431,2022-08-07
CASH_OUT,5421,Frédérique Robin,22397,16976,Agence_moov_Ouidah,300000,294579,2022-08-07
CASH_OUT,8660,Frédérique Robin,16976,8316,Agence_moov_Ouidah,300000,291340,2022-08-07
CASH_IN,77614,Agence_moov_Abomey,300000,222386,Frédérique Robin,8316,85930,2022-08-12
CASH_OUT,586,Frédérique Robin,85930,85344,Agence_moov_Abomey,300000,299414,2022-08-17
TRANSFER,60322,Nicole Lacroix,181774,121452,Frédérique Robin,85344,145666,2022-08-19
CASH_IN,35659,Agence_moov_Abomey,300000,264341,Frédérique Robin,145666,181325,2022-08-19
TRANSFER,2696,Michèle Vallée,3825,1129,Frédérique Robin,181325,184021,2022-08-20
TRANSFER,102895,Frédérique Robin,184021,81126,Marthe Pichon,5156,-97739,2022-08-21
CASH_OUT,30267,Frédérique Robin,81126,50859,Agence_moov_Cotonou,300000,269733,2022-08-21
CASH_IN,283408,Agence_moov_Abomey,300000,16592,Frédérique Robin,50859,334267,2022-08-23
CASH_OUT,116031,Frédérique Robin,334267,218236,Agence_moov_Cotonou,300000,183969,2022-08-24
CASH_OUT,195586,Frédérique Robin,218236,22650,Agence_moov_Ouidah,300000,104414,2022-08-24
CASH_IN,170848,Agence_moov_Ouidah,300000,129152,Arnaude Gaillard,-10834,160014,2022-08-01
CASH_IN,83274,Agence_moov_Cotonou,300000,216726,Arnaude Gaillard,160014,243288,2022-08-02
CASH_IN,148533,Agence_moov_Abomey,300000,151467,Arnaude Gaillard,243288,391821,2022-08-05
CASH_IN,46525,Agence_moov_Cotonou,300000,253475,Arnaude Gaillard,391821,438346,2022-08-05
CASH_IN,152099,Agence_moov_Ouidah,300000,147901,Arnaude Gaillard,438346,590445,2022-08-06
CASH_IN,270727,Agence_moov_Ouidah,300000,29273,Arnaude Gaillard,590445,861172,2022-08-07
CASH_IN,18307,Agence_moov_Ouidah,300000,281693,Arnaude Gaillard,861172,879479,2022-08-10
CASH_IN,286601,Agence_moov_Cotonou,300000,13399,Arnaude Gaillard,879479,1166080,2022-08-11
CASH_OUT,257317,Arnaude Gaillard,1166080,908763,Agence_moov_Ouidah,300000,42683,2022-08-13
TRANSFER,496386,Arnaude Gaillard,908763,412377,Michèle Vallée,1129,-495257,2022-08-13
TRANSFER,332646,Arnaude Gaillard,412377,79731,Nicole Lacroix,121452,-211194,2022-08-16
CASH_OUT,7046,Arnaude Gaillard,79731,72685,Agence_moov_Ouidah,300000,292954,2022-08-16
CASH_OUT,57776,Arnaude Gaillard,72685,14909,Agence_moov_Cotonou,300000,242224,2022-08-21
TRANSFER,12040,Arnaude Gaillard,14909,2869,Arnaude Gaillard,14909,26949,2022-08-23
CASH_IN,155294,Agence_moov_Ouidah,300000,144706,Arnaude Gaillard,2869,158163,2022-08-23
CASH_IN,9861,Agence_moov_Cotonou,300000,290139,Arnaude Gaillard,158163,168024,2022-08-23
CASH_IN,275530,Agence_moov_Abomey,300000,24470,Arnaude Gaillard,168024,443554,2022-08-26
CASH_IN,253932,Agence_moov_Cotonou,300000,46068,Alphonse Dupont-Petit,-9652,244280,2022-08-01
CASH_OUT,69339,Alphonse Dupont-Petit,244280,174941,Agence_moov_Ouidah,300000,230661,2022-08-03
TRANSFER,124317,Alphonse Dupont-Petit,174941,50624,Alphonse Dupont-Petit,174941,299258,2022-08-04
CASH_IN,137583,Agence_moov_Cotonou,300000,162417,Alphonse Dupont-Petit,50624,188207,2022-08-05
CASH_OUT,145835,Alphonse Dupont-Petit,188207,42372,Agence_moov_Ouidah,300000,154165,2022-08-06
CASH_OUT,13459,Alphonse Dupont-Petit,42372,28913,Agence_moov_Ouidah,300000,286541,2022-08-08
TRANSFER,9984,Alphonse Dupont-Petit,28913,18929,Alphonse Dupont-Petit,28913,18929,2022-08-11
CASH_IN,293671,Agence_moov_Cotonou,300000,6329,Alphonse Dupont-Petit,18929,312600,2022-08-16
CASH_OUT,106660,Alphonse Dupont-Petit,312600,205940,Agence_moov_Ouidah,300000,193340,2022-08-17
CASH_IN,117561,Agence_moov_Cotonou,300000,182439,Alphonse Dupont-Petit,205940,323501,2022-08-20
CASH_OUT,197792,Alphonse Dupont-Petit,323501,125709,Agence_moov_Cotonou,300000,102208,2022-08-21
CASH_OUT,22583,Alphonse Dupont-Petit,125709,103126,Agence_moov_Abomey,300000,277417,2022-08-23
CASH_IN,238152,Agence_moov_Ouidah,300000,61848,Alphonse Dupont-Petit,103126,341278,2022-08-24
CASH_IN,61349,Agence_moov_Cotonou,300000,238651,Caroline Peltier,-35786,25563,2022-08-01
TRANSFER,5734,Caroline Peltier,25563,19829,Caroline Peltier,25563,31297,2022-08-01
CASH_OUT,10963,Caroline Peltier,19829,8866,Agence_moov_Abomey,300000,289037,2022-08-11
CASH_IN,122228,Agence_moov_Cotonou,300000,177772,Caroline Peltier,8866,131094,2022-08-12
CASH_OUT,91275,Caroline Peltier,131094,39819,Agence_moov_Ouidah,300000,208725,2022-08-13
CASH_IN,228213,Agence_moov_Abomey,300000,71787,Stéphane-Timothée Pineau,3,228216,2022-08-02
CASH_OUT,70574,Stéphane-Timothée Pineau,228216,157642,Agence_moov_Ouidah,300000,229426,2022-08-02
TRANSFER,18585,Stéphane-Timothée Pineau,157642,139057,Stéphane-Timothée Pineau,157642,176227,2022-08-04
TRANSFER,86191,Stéphane-Timothée Pineau,139057,52866,Stéphane-Timothée Pineau,139057,225248,2022-08-07
TRANSFER,6274,Stéphane-Timothée Pineau,52866,46592,Stéphane-Timothée Pineau,52866,59140,2022-08-08
CASH_OUT,5941,Stéphane-Timothée Pineau,46592,40651,Agence_moov_Abomey,300000,294059,2022-08-09
CASH_OUT,33018,Stéphane-Timothée Pineau,40651,7633,Agence_moov_Ouidah,300000,266982,2022-08-17
CASH_OUT,5011,Stéphane-Timothée Pineau,7633,2622,Agence_moov_Ouidah,300000,294989,2022-08-20
CASH_IN,260574,Agence_moov_Cotonou,300000,39426,Stéphane-Timothée Pineau,2622,263196,2022-08-20
CASH_OUT,56464,Stéphane-Timothée Pineau,263196,206732,Agence_moov_Abomey,300000,243536,2022-08-26
CASH_IN,30964,Agence_moov_Ouidah,300000,269036,Stéphanie Bonneau,-198476,-167512,2022-08-10
CASH_IN,266270,Agence_moov_Cotonou,300000,33730,Stéphanie Bonneau,-167512,98758,2022-08-13
CASH_OUT,63407,Stéphanie Bonneau,98758,35351,Agence_moov_Cotonou,300000,236593,2022-08-14
CASH_IN,102637,Agence_moov_Abomey,300000,197363,Stéphanie Bonneau,35351,137988,2022-08-15
TRANSFER,94240,Stéphanie Bonneau,137988,43748,Stéphanie Bonneau,137988,43748,2022-08-17
CASH_IN,17936,Agence_moov_Abomey,300000,282064,Stéphanie Bonneau,43748,61684,2022-08-18
TRANSFER,2800,Stéphanie Bonneau,61684,58884,Stéphanie Bonneau,61684,64484,2022-08-18
CASH_IN,69518,Agence_moov_Cotonou,300000,230482,Stéphanie Bonneau,58884,128402,2022-08-25
CASH_IN,218576,Agence_moov_Abomey,300000,81424,Michèle Vallée,-495257,-276681,2022-08-03
CASH_IN,271964,Agence_moov_Abomey,300000,28036,Michèle Vallée,-276681,-4717,2022-08-10
CASH_IN,150494,Agence_moov_Cotonou,300000,149506,Michèle Vallée,-4717,145777,2022-08-11
CASH_IN,115999,Agence_moov_Cotonou,300000,184001,Michèle Vallée,145777,261776,2022-08-15
CASH_OUT,211004,Michèle Vallée,261776,50772,Agence_moov_Abomey,300000,88996,2022-08-15
CASH_OUT,11005,Michèle Vallée,50772,39767,Agence_moov_Ouidah,300000,288995,2022-08-19
CASH_IN,221048,Agence_moov_Abomey,300000,78952,Michèle Vallée,39767,260815,2022-08-22
CASH_OUT,165907,Michèle Vallée,260815,94908,Agence_moov_Ouidah,300000,134093,2022-08-25
CASH_IN,280106,Agence_moov_Abomey,300000,19894,Augustin Benard,-65413,214693,2022-08-01
TRANSFER,27962,Augustin Benard,214693,186731,Augustin Benard,214693,242655,2022-08-02
CASH_OUT,101527,Augustin Benard,186731,85204,Agence_moov_Ouidah,300000,198473,2022-08-03
CASH_IN,53621,Agence_moov_Abomey,300000,246379,Augustin Benard,85204,138825,2022-08-05
TRANSFER,48838,Augustin Benard,138825,89987,Augustin Benard,138825,187663,2022-08-07
CASH_IN,123502,Agence_moov_Abomey,300000,176498,Augustin Benard,89987,213489,2022-08-08
CASH_IN,68641,Agence_moov_Cotonou,300000,231359,Augustin Benard,213489,282130,2022-08-09
CASH_OUT,115896,Augustin Benard,282130,166234,Agence_moov_Ouidah,300000,184104,2022-08-11
CASH_OUT,147834,Augustin Benard,166234,18400,Agence_moov_Ouidah,300000,152166,2022-08-12
CASH_IN,125565,Agence_moov_Ouidah,300000,174435,Augustin Benard,18400,143965,2022-08-13
CASH_OUT,64145,Augustin Benard,143965,79820,Agence_moov_Ouidah,300000,235855,2022-08-15
CASH_IN,35609,Agence_moov_Abomey,300000,264391,Augustin Benard,79820,115429,2022-08-18
CASH_OUT,63591,Augustin Benard,115429,51838,Agence_moov_Ouidah,300000,236409,2022-08-19
CASH_IN,34286,Agence_moov_Cotonou,300000,265714,Augustin Benard,51838,86124,2022-08-21
CASH_IN,185992,Agence_moov_Ouidah,300000,114008,Nicole Lacroix,-211194,-25202,2022-08-01
CASH_IN,72066,Agence_moov_Abomey,300000,227934,Nicole Lacroix,-25202,46864,2022-08-01
CASH_OUT,40827,Nicole Lacroix,46864,6037,Agence_moov_Cotonou,300000,259173,2022-08-01
TRANSFER,4656,Nicole Lacroix,6037,1381,Nicole Lacroix,6037,10693,2022-08-01
TRANSFER,1315,Nicole Lacroix,1381,66,Nicole Lacroix,1381,66,2022-08-02
CASH_IN,296959,Agence_moov_Cotonou,300000,3041,Nicole Lacroix,66,297025,2022-08-07
CASH_OUT,24851,Nicole Lacroix,297025,272174,Agence_moov_Ouidah,300000,275149,2022-08-11
CASH_OUT,250083,Nicole Lacroix,272174,22091,Agence_moov_Cotonou,300000,49917,2022-08-14
CASH_OUT,929,Nicole Lacroix,22091,21162,Agence_moov_Ouidah,300000,299071,2022-08-14
CASH_IN,278419,Agence_moov_Ouidah,300000,21581,Nicole Lacroix,21162,299581,2022-08-16
CASH_IN,219905,Agence_moov_Cotonou,300000,80095,Nicole Lacroix,299581,519486,2022-08-16
CASH_OUT,470549,Nicole Lacroix,519486,48937,Agence_moov_Cotonou,300000,-170549,2022-08-19
CASH_OUT,17791,Nicole Lacroix,48937,31146,Agence_moov_Ouidah,300000,282209,2022-08-21
CASH_IN,171940,Agence_moov_Abomey,300000,128060,Nicole Lacroix,31146,203086,2022-08-24
CASH_IN,236250,Agence_moov_Abomey,300000,63750,Nicole Lacroix,203086,439336,2022-08-25
CASH_IN,96370,Agence_moov_Abomey,300000,203630,Thierry Dos Santos-Le Roux,-453278,-356908,2022-08-02
CASH_IN,62585,Agence_moov_Abomey,300000,237415,Thierry Dos Santos-Le Roux,-356908,-294323,2022-08-08
CASH_IN,62831,Agence_moov_Cotonou,300000,237169,Thierry Dos Santos-Le Roux,-294323,-231492,2022-08-10
CASH_IN,204844,Agence_moov_Cotonou,300000,95156,Thierry Dos Santos-Le Roux,-231492,-26648,2022-08-13
CASH_IN,20770,Agence_moov_Ouidah,300000,279230,Thierry Dos Santos-Le Roux,-26648,-5878,2022-08-17
CASH_IN,55371,Agence_moov_Cotonou,300000,244629,Thierry Dos Santos-Le Roux,-5878,49493,2022-08-20
CASH_OUT,7767,Thierry Dos Santos-Le Roux,49493,41726,Agence_moov_Ouidah,300000,292233,2022-08-23
CASH_IN,134802,Agence_moov_Cotonou,300000,165198,Maurice Alves,-452199,-317397,2022-08-04
CASH_IN,117337,Agence_moov_Cotonou,300000,182663,Maurice Alves,-317397,-200060,2022-08-09
CASH_IN,212901,Agence_moov_Ouidah,300000,87099,Maurice Alves,-200060,12841,2022-08-13
CASH_OUT,2810,Maurice Alves,12841,10031,Agence_moov_Ouidah,300000,297190,2022-08-21
CASH_IN,127664,Agence_moov_Ouidah,300000,172336,Maurice Alves,10031,137695,2022-08-26
CASH_IN,132474,Agence_moov_Cotonou,300000,167526,Antoine Bourdon de Auger,-159161,-26687,2022-08-01
CASH_IN,255834,Agence_moov_Ouidah,300000,44166,Antoine Bourdon de Auger,-26687,229147,2022-08-01
CASH_IN,288631,Agence_moov_Abomey,300000,11369,Antoine Bourdon de Auger,229147,517778,2022-08-02
TRANSFER,461855,Antoine Bourdon de Auger,517778,55923,Antoine Bourdon de Auger,517778,55923,2022-08-05
CASH_OUT,10704,Antoine Bourdon de Auger,55923,45219,Agence_moov_Abomey,300000,289296,2022-08-10
TRANSFER,5756,Antoine Bourdon de Auger,45219,39463,Antoine Bourdon de Auger,45219,39463,2022-08-10
TRANSFER,30495,Antoine Bourdon de Auger,39463,8968,Antoine Bourdon de Auger,39463,8968,2022-08-11
CASH_IN,259534,Agence_moov_Ouidah,300000,40466,Antoine Bourdon de Auger,8968,268502,2022-08-11
CASH_OUT,267170,Antoine Bourdon de Auger,268502,1332,Agence_moov_Ouidah,300000,32830,2022-08-12
CASH_IN,267818,Agence_moov_Abomey,300000,32182,Antoine Bourdon de Auger,1332,269150,2022-08-12
CASH_OUT,19689,Antoine Bourdon de Auger,269150,249461,Agence_moov_Ouidah,300000,280311,2022-08-13
CASH_OUT,216268,Antoine Bourdon de Auger,249461,33193,Agence_moov_Ouidah,300000,83732,2022-08-15
CASH_IN,47457,Agence_moov_Cotonou,300000,252543,Antoine Bourdon de Auger,33193,80650,2022-08-17
CASH_IN,39373,Agence_moov_Ouidah,300000,260627,Antoine Bourdon de Auger,80650,120023,2022-08-17
CASH_IN,242467,Agence_moov_Cotonou,300000,57533,Antoine Bourdon de Auger,120023,362490,2022-08-18
CASH_IN,51411,Agence_moov_Cotonou,300000,248589,Antoine Bourdon de Auger,362490,413901,2022-08-19
CASH_IN,36683,Agence_moov_Ouidah,300000,263317,Antoine Bourdon de Auger,413901,450584,2022-08-23
CASH_IN,138357,Agence_moov_Cotonou,300000,161643,Auguste Bousquet,46,138403,2022-08-02
CASH_IN,268333,Agence_moov_Abomey,300000,31667,Auguste Bousquet,138403,406736,2022-08-11
CASH_IN,214868,Agence_moov_Abomey,300000,85132,Auguste Bousquet,406736,621604,2022-08-13
CASH_IN,93807,Agence_moov_Abomey,300000,206193,Auguste Bousquet,621604,715411,2022-08-14
TRANSFER,590825,Auguste Bousquet,715411,124586,Auguste Bousquet,715411,124586,2022-08-19
CASH_IN,33034,Agence_moov_Abomey,300000,266966,Auguste Bousquet,124586,157620,2022-08-20
CASH_OUT,55795,Auguste Bousquet,157620,101825,Agence_moov_Abomey,300000,244205,2022-08-20
CASH_IN,148146,Agence_moov_Cotonou,300000,151854,Auguste Bousquet,101825,249971,2022-08-22
CASH_OUT,113933,Auguste Bousquet,249971,136038,Agence_moov_Cotonou,300000,186067,2022-08-23
CASH_IN,17803,Agence_moov_Abomey,300000,282197,Émilie Guillon de Duhamel,-198775,-180972,2022-08-05
CASH_IN,39278,Agence_moov_Ouidah,300000,260722,Émilie Guillon de Duhamel,-180972,-141694,2022-08-08
CASH_IN,253182,Agence_moov_Ouidah,300000,46818,Émilie Guillon de Duhamel,-141694,111488,2022-08-08
CASH_IN,16019,Agence_moov_Ouidah,300000,283981,Émilie Guillon de Duhamel,111488,127507,2022-08-11
CASH_OUT,99101,Émilie Guillon de Duhamel,127507,28406,Agence_moov_Ouidah,300000,200899,2022-08-12
TRANSFER,9826,Émilie Guillon de Duhamel,28406,18580,Émilie Guillon de Duhamel,28406,18580,2022-08-13
CASH_OUT,3467,Émilie Guillon de Duhamel,18580,15113,Agence_moov_Cotonou,300000,296533,2022-08-14
CASH_IN,160890,Agence_moov_Abomey,300000,139110,Émilie Guillon de Duhamel,15113,176003,2022-08-16
CASH_OUT,97256,Émilie Guillon de Duhamel,176003,78747,Agence_moov_Abomey,300000,202744,2022-08-18
CASH_IN,215132,Agence_moov_Abomey,300000,84868,Émilie Guillon de Duhamel,78747,293879,2022-08-18
CASH_IN,33204,Agence_moov_Ouidah,300000,266796,Anastasie Louis,-316873,-283669,2022-08-02
CASH_IN,54546,Agence_moov_Cotonou,300000,245454,Anastasie Louis,-283669,-229123,2022-08-03
CASH_IN,69000,Agence_moov_Ouidah,300000,231000,Anastasie Louis,-229123,-160123,2022-08-04
CASH_IN,187632,Agence_moov_Abomey,300000,112368,Anastasie Louis,-160123,27509,2022-08-06
TRANSFER,20631,Anastasie Louis,27509,6878,Anastasie Louis,27509,48140,2022-08-08
CASH_OUT,4441,Anastasie Louis,6878,2437,Agence_moov_Cotonou,300000,295559,2022-08-10
TRANSFER,2041,Anastasie Louis,2437,396,Anastasie Louis,2437,396,2022-08-11
CASH_OUT,336,Anastasie Louis,396,60,Agence_moov_Ouidah,300000,299664,2022-08-12
CASH_IN,114335,Agence_moov_Ouidah,300000,185665,Anastasie Louis,60,114395,2022-08-15
CASH_IN,222376,Agence_moov_Ouidah,300000,77624,Anastasie Louis,114395,336771,2022-08-20
CASH_OUT,50149,Anastasie Louis,336771,286622,Agence_moov_Ouidah,300000,249851,2022-08-20
TRANSFER,229750,Anastasie Louis,286622,56872,Anastasie Louis,286622,516372,2022-08-22
CASH_OUT,53472,Anastasie Louis,56872,3400,Agence_moov_Abomey,300000,246528,2022-08-23
CASH_OUT,1068,Anastasie Louis,3400,2332,Agence_moov_Cotonou,300000,298932,2022-08-23
CASH_OUT,1074,Anastasie Louis,2332,1258,Agence_moov_Ouidah,300000,298926,2022-08-24
CASH_IN,21418,Agence_moov_Cotonou,300000,278582,Anastasie Louis,1258,22676,2022-08-27
CASH_IN,91263,Agence_moov_Cotonou,300000,208737,Marthe Pichon,-97739,-6476,2022-08-04
CASH_IN,250243,Agence_moov_Cotonou,300000,49757,Marthe Pichon,-6476,243767,2022-08-06
CASH_OUT,166771,Marthe Pichon,243767,76996,Agence_moov_Abomey,300000,133229,2022-08-08
TRANSFER,49582,Marthe Pichon,76996,27414,Marthe Pichon,76996,126578,2022-08-14
CASH_IN,25737,Agence_moov_Ouidah,300000,274263,Marthe Pichon,27414,53151,2022-08-16
CASH_OUT,22702,Marthe Pichon,53151,30449,Agence_moov_Ouidah,300000,277298,2022-08-19
CASH_OUT,8178,Marthe Pichon,30449,22271,Agence_moov_Ouidah,300000,291822,2022-08-20
CASH_IN,250258,Agence_moov_Ouidah,300000,49742,Marthe Pichon,22271,272529,2022-08-20
CASH_OUT,13946,Marthe Pichon,272529,258583,Agence_moov_Cotonou,300000,286054,2022-08-20
CASH_OUT,245941,Marthe Pichon,258583,12642,Agence_moov_Cotonou,300000,54059,2022-08-21
CASH_IN,89195,Agence_moov_Abomey,300000,210805,Marthe Pichon,12642,101837,2022-08-21
CASH_IN,219210,Agence_moov_Ouidah,300000,80790,Marthe Pichon,101837,321047,2022-08-21
CASH_OUT,253745,Marthe Pichon,321047,67302,Agence_moov_Abomey,300000,46255,2022-08-24
CASH_IN,275979,Agence_moov_Abomey,300000,24021,Marthe Pichon,67302,343281,2022-08-26
CASH_IN,113703,Agence_moov_Ouidah,300000,186297,Marthe Pichon,343281,456984,2022-08-27
CASH_IN,210049,Agence_moov_Abomey,300000,89951,Émile Hebert,-139023,71026,2022-08-02
CASH_IN,110381,Agence_moov_Abomey,300000,189619,Émile Hebert,71026,181407,2022-08-05
CASH_IN,61392,Agence_moov_Abomey,300000,238608,Émile Hebert,181407,242799,2022-08-06
CASH_IN,45800,Agence_moov_Ouidah,300000,254200,Émile Hebert,242799,288599,2022-08-12
CASH_IN,279103,Agence_moov_Cotonou,300000,20897,Émile Hebert,288599,567702,2022-08-16
CASH_OUT,267738,Émile Hebert,567702,299964,Agence_moov_Cotonou,300000,32262,2022-08-18
CASH_IN,40296,Agence_moov_Abomey,300000,259704,Émile Hebert,299964,340260,2022-08-19
CASH_IN,2891,Agence_moov_Cotonou,300000,297109,Émile Hebert,340260,343151,2022-08-21
CASH_OUT,8582,Émile Hebert,343151,334569,Agence_moov_Abomey,300000,291418,2022-08-22
CASH_IN,19552,Agence_moov_Cotonou,300000,280448,Émile Hebert,334569,354121,2022-08-27
CASH_IN,205195,Agence_moov_Ouidah,300000,94805,Lucy Vaillant,-30011,175184,2022-08-02
TRANSFER,173313,Lucy Vaillant,175184,1871,Lucy Vaillant,175184,348497,2022-08-02
TRANSFER,1646,Lucy Vaillant,1871,225,Lucy Vaillant,1871,225,2022-08-03
TRANSFER,207,Lucy Vaillant,225,18,Lucy Vaillant,225,432,2022-08-07
CASH_IN,213082,Agence_moov_Cotonou,300000,86918,Lucy Vaillant,18,213100,2022-08-08
CASH_OUT,135921,Lucy Vaillant,213100,77179,Agence_moov_Cotonou,300000,164079,2022-08-09
TRANSFER,29990,Lucy Vaillant,77179,47189,Lucy Vaillant,77179,47189,2022-08-12
TRANSFER,24922,Lucy Vaillant,47189,22267,Lucy Vaillant,47189,72111,2022-08-14
TRANSFER,4650,Lucy Vaillant,22267,17617,Lucy Vaillant,22267,17617,2022-08-14
CASH_IN,28692,Agence_moov_Cotonou,300000,271308,Lucy Vaillant,17617,46309,2022-08-18
CASH_OUT,12859,Lucy Vaillant,46309,33450,Agence_moov_Abomey,300000,287141,2022-08-20
CASH_IN,189208,Agence_moov_Ouidah,300000,110792,Lucy Vaillant,33450,222658,2022-08-22
CASH_OUT,44493,Lucy Vaillant,222658,178165,Agence_moov_Ouidah,300000,255507,2022-08-23
CASH_IN,15495,Agence_moov_Ouidah,300000,284505,Lucy Vaillant,178165,193660,2022-08-24
CASH_IN,85726,Agence_moov_Cotonou,300000,214274,Lucy Vaillant,193660,279386,2022-08-25
CASH_OUT,12709,Lucy Vaillant,279386,266677,Agence_moov_Ouidah,300000,287291,2022-08-27
CASH_IN,137411,Agence_moov_Abomey,300000,162589,Constance Regnier,-74030,63381,2022-08-07
TRANSFER,35470,Constance Regnier,63381,27911,Constance Regnier,63381,98851,2022-08-12
CASH_OUT,15776,Constance Regnier,27911,12135,Agence_moov_Abomey,300000,284224,2022-08-17
TRANSFER,8449,Constance Regnier,12135,3686,Constance Regnier,12135,3686,2022-08-22
CASH_IN,257803,Agence_moov_Abomey,300000,42197,Constance Regnier,3686,261489,2022-08-23
CASH_IN,251770,Agence_moov_Cotonou,300000,48230,Constance Regnier,261489,513259,2022-08-25
CASH_OUT,240582,Constance Regnier,513259,272677,Agence_moov_Abomey,300000,59418,2022-08-25
CASH_OUT,227897,Constance Regnier,272677,44780,Agence_moov_Ouidah,300000,72103,2022-08-26
CASH_IN,162797,Agence_moov_Abomey,300000,137203,Noémi de la Didier,-654553,-491756,2022-08-02
CASH_IN,280707,Agence_moov_Abomey,300000,19293,Noémi de la Didier,-491756,-211049,2022-08-03
CASH_IN,243546,Agence_moov_Ouidah,300000,56454,Noémi de la Didier,-211049,32497,2022-08-10
CASH_IN,184001,Agence_moov_Ouidah,300000,115999,Noémi de la Didier,32497,216498,2022-08-15
CASH_OUT,201802,Noémi de la Didier,216498,14696,Agence_moov_Ouidah,300000,98198,2022-08-18
CASH_IN,227678,Agence_moov_Ouidah,300000,72322,Noémi de la Didier,14696,242374,2022-08-19
CASH_OUT,163091,Noémi de la Didier,242374,79283,Agence_moov_Abomey,300000,136909,2022-08-27
CASH_IN,54216,Agence_moov_Abomey,300000,245784,Théodore-Alfred Fournier,-169806,-115590,2022-08-09
CASH_IN,236963,Agence_moov_Cotonou,300000,63037,Théodore-Alfred Fournier,-115590,121373,2022-08-09
CASH_IN,266980,Agence_moov_Cotonou,300000,33020,Théodore-Alfred Fournier,121373,388353,2022-08-09
TRANSFER,134234,Théodore-Alfred Fournier,388353,254119,Théodore-Alfred Fournier,388353,522587,2022-08-11
TRANSFER,182266,Théodore-Alfred Fournier,254119,71853,Théodore-Alfred Fournier,254119,436385,2022-08-13
TRANSFER,12899,Théodore-Alfred Fournier,71853,58954,Théodore-Alfred Fournier,71853,84752,2022-08-13
CASH_OUT,5521,Théodore-Alfred Fournier,58954,53433,Agence_moov_Ouidah,300000,294479,2022-08-15
CASH_OUT,34689,Théodore-Alfred Fournier,53433,18744,Agence_moov_Cotonou,300000,265311,2022-08-16
CASH_OUT,2419,Théodore-Alfred Fournier,18744,16325,Agence_moov_Cotonou,300000,297581,2022-08-18
CASH_IN,125257,Agence_moov_Ouidah,300000,174743,Théodore-Alfred Fournier,16325,141582,2022-08-21
CASH_IN,244298,Agence_moov_Abomey,300000,55702,Théodore-Alfred Fournier,141582,385880,2022-08-21
CASH_IN,147351,Agence_moov_Ouidah,300000,152649,Théodore-Alfred Fournier,385880,533231,2022-08-22
CASH_IN,43403,Agence_moov_Abomey,300000,256597,Théodore-Alfred Fournier,533231,576634,2022-08-22
CASH_OUT,256499,Théodore-Alfred Fournier,576634,320135,Agence_moov_Abomey,300000,43501,2022-08-25
CASH_IN,65999,Agence_moov_Cotonou,300000,234001,Paul Pereira,-1308072,-1242073,2022-08-02
CASH_IN,224266,Agence_moov_Abomey,300000,75734,Paul Pereira,-1242073,-1017807,2022-08-04
CASH_IN,178716,Agence_moov_Cotonou,300000,121284,Paul Pereira,-1017807,-839091,2022-08-04
CASH_IN,75047,Agence_moov_Cotonou,300000,224953,Paul Pereira,-839091,-764044,2022-08-06
CASH_IN,69336,Agence_moov_Ouidah,300000,230664,Paul Pereira,-764044,-694708,2022-08-11
CASH_IN,223239,Agence_moov_Ouidah,300000,76761,Paul Pereira,-694708,-471469,2022-08-17
CASH_IN,176744,Agence_moov_Cotonou,300000,123256,Nathalie-Chantal Jacques,-102483,74261,2022-08-01
CASH_OUT,50234,Nathalie-Chantal Jacques,74261,24027,Agence_moov_Cotonou,300000,249766,2022-08-11
TRANSFER,11842,Nathalie-Chantal Jacques,24027,12185,Nathalie-Chantal Jacques,24027,35869,2022-08-18
CASH_OUT,7671,Nathalie-Chantal Jacques,12185,4514,Agence_moov_Abomey,300000,292329,2022-08-27
CASH_OUT,3522,Nathalie-Chantal Jacques,4514,992,Agence_moov_Abomey,300000,296478,2022-08-27
CASH_IN,229462,Agence_moov_Cotonou,300000,70538,Josette Guillon-Leclercq,-124771,104691,2022-08-01
TRANSFER,93064,Josette Guillon-Leclercq,104691,11627,Josette Guillon-Leclercq,104691,197755,2022-08-01
CASH_IN,68084,Agence_moov_Abomey,300000,231916,Josette Guillon-Leclercq,11627,79711,2022-08-05
TRANSFER,71392,Josette Guillon-Leclercq,79711,8319,Josette Guillon-Leclercq,79711,8319,2022-08-06
CASH_OUT,4933,Josette Guillon-Leclercq,8319,3386,Agence_moov_Abomey,300000,295067,2022-08-07
CASH_OUT,1995,Josette Guillon-Leclercq,3386,1391,Agence_moov_Cotonou,300000,298005,2022-08-08
CASH_IN,292296,Agence_moov_Ouidah,300000,7704,Josette Guillon-Leclercq,1391,293687,2022-08-11
CASH_IN,6466,Agence_moov_Abomey,300000,293534,Josette Guillon-Leclercq,293687,300153,2022-08-12
CASH_IN,172051,Agence_moov_Ouidah,300000,127949,Josette Guillon-Leclercq,300153,472204,2022-08-18
CASH_OUT,442814,Josette Guillon-Leclercq,472204,29390,Agence_moov_Ouidah,300000,-142814,2022-08-23
CASH_IN,204063,Agence_moov_Ouidah,300000,95937,Noémi de la Didier,379100,583163,2022-09-04
CASH_OUT,558090,Noémi de la Didier,583163,25073,Agence_moov_Cotonou,300000,-258090,2022-09-07
CASH_IN,263515,Agence_moov_Cotonou,300000,36485,Noémi de la Didier,25073,288588,2022-09-13
CASH_OUT,150784,Noémi de la Didier,288588,137804,Agence_moov_Abomey,300000,149216,2022-09-16
CASH_IN,234307,Agence_moov_Cotonou,300000,65693,Agnès Baron,1006000,1240307,2022-09-08
CASH_IN,93180,Agence_moov_Cotonou,300000,206820,Agnès Baron,1240307,1333487,2022-09-09
CASH_IN,267447,Agence_moov_Abomey,300000,32553,Agnès Baron,1333487,1600934,2022-09-15
CASH_OUT,1223063,Agnès Baron,1600934,377871,Agence_moov_Abomey,300000,-923063,2022-09-26
TRANSFER,121073,Amélie Gros-Riou,236200,115127,Amélie Gros-Riou,236200,357273,2022-09-03
CASH_IN,118887,Agence_moov_Abomey,300000,181113,Constance Regnier,1401400,1520287,2022-09-03
CASH_OUT,124845,Constance Regnier,1520287,1395442,Agence_moov_Cotonou,300000,175155,2022-09-17
CASH_OUT,1274753,Constance Regnier,1395442,120689,Agence_moov_Cotonou,300000,-974753,2022-09-19
TRANSFER,394336,Antoine Leroux,1332500,938164,Constance Regnier,120689,515025,2022-09-23
TRANSFER,81136,Stéphanie Bonneau,259600,178464,Constance Regnier,515025,596161,2022-09-24
TRANSFER,224185,Caroline Monnier,237800,13615,Christophe Guilbert,1864100,1639915,2022-09-12
TRANSFER,228511,Isaac Le Pinto,439600,211089,Sébastien Jourdan,538600,767111,2022-09-11
TRANSFER,247316,Théophile Mendès,923700,676384,Diane-Françoise Raynaud,1160000,912684,2022-09-20
CASH_OUT,184830,Valentine Traore,218000,33170,Agence_moov_Ouidah,300000,115170,2022-09-12
TRANSFER,1278539,Alfred Chrétien,1893000,614461,Maurice Seguin,1672900,2951439,2022-09-10
CASH_IN,74507,Agence_moov_Ouidah,300000,225493,Maurice Seguin,2951439,3025946,2022-09-14
CASH_IN,259648,Agence_moov_Cotonou,300000,40352,Claudine Vallet,563300,822948,2022-09-13
TRANSFER,239986,Marthe Pichon,1597900,1357914,Claudine Vallet,822948,1062934,2022-09-22
TRANSFER,1203141,Richard Guibert,1574800,371659,Claudine Vallet,1062934,2266075,2022-09-26
TRANSFER,8020,Claudine Vallet,2266075,2258055,Thierry Dos Santos-Le Roux,1911900,1903880,2022-09-26
CASH_IN,81119,Agence_moov_Abomey,300000,218881,Claudine Vallet,2258055,2339174,2022-09-27
TRANSFER,361327,Vincent-Grégoire Brunet,624300,262973,Élodie Gérard,934900,1296227,2022-09-02
CASH_IN,279216,Agence_moov_Cotonou,300000,20784,Élodie Gérard,1296227,1575443,2022-09-13
TRANSFER,273920,Élodie Gérard,1575443,1301523,Susan de Fontaine,546700,272780,2022-09-20
CASH_IN,76028,Agence_moov_Ouidah,300000,223972,Élodie Gérard,1301523,1377551,2022-09-26
TRANSFER,249943,Élodie Gérard,1377551,1127608,Nath Léger,1766700,1516757,2022-09-27
TRANSFER,240148,Matthieu Renard,293100,52952,Nicole Lacroix,649800,889948,2022-09-11
CASH_OUT,132277,Nicole Lacroix,889948,757671,Agence_moov_Ouidah,300000,167723,2022-09-17
CASH_IN,26475,Agence_moov_Cotonou,300000,273525,Adrienne Arnaud,1839000,1865475,2022-09-03
TRANSFER,675193,Adrienne Arnaud,1865475,1190282,Antoine Bourdon de Auger,61100,-614093,2022-09-04
CASH_IN,96981,Agence_moov_Abomey,300000,203019,Adrienne Arnaud,1190282,1287263,2022-09-09
CASH_OUT,969872,Adrienne Arnaud,1287263,317391,Agence_moov_Abomey,300000,-669872,2022-09-20
CASH_IN,133650,Agence_moov_Cotonou,300000,166350,Adrienne Arnaud,317391,451041,2022-09-21
CASH_IN,196864,Agence_moov_Cotonou,300000,103136,Stéphanie Bonneau,178464,375328,2022-09-03
CASH_OUT,212387,Stéphanie Bonneau,375328,162941,Agence_moov_Ouidah,300000,87613,2022-09-10
CASH_IN,86041,Agence_moov_Cotonou,300000,213959,Stéphanie Bonneau,162941,248982,2022-09-12
TRANSFER,16331,Stéphanie Bonneau,248982,232651,Marie Da Silva,1187500,1171169,2022-09-13
CASH_IN,197623,Agence_moov_Ouidah,300000,102377,Stéphanie Bonneau,232651,430274,2022-09-27
TRANSFER,382767,Juliette Evrard Le Giraud,653000,270233,David-Théodore Diaz,1649800,1267033,2022-09-02
TRANSFER,836879,Roland Colin,1409400,572521,Juliette Evrard Le Giraud,270233,1107112,2022-09-11
TRANSFER,773425,Juliette Evrard Le Giraud,1107112,333687,Matthieu Renard,52952,-720473,2022-09-20
CASH_OUT,53749,Michèle Vallée,547700,493951,Agence_moov_Ouidah,300000,246251,2022-09-22
CASH_IN,104447,Agence_moov_Cotonou,300000,195553,Michèle Vallée,493951,598398,2022-09-25
TRANSFER,103315,Christophe Alexandre,150100,46785,Jacques-Antoine Gros,121900,225215,2022-09-01
TRANSFER,127871,Jacques-Antoine Gros,225215,97344,Alfred Chrétien,614461,486590,2022-09-05
CASH_OUT,6422,Jacques-Antoine Gros,97344,90922,Agence_moov_Ouidah,300000,293578,2022-09-19
TRANSFER,382887,Maurice Alves,1572000,1189113,Jacques-Antoine Gros,90922,473809,2022-09-21
TRANSFER,1049914,Nath Léger,1516757,466843,Émilie Guillon de Duhamel,350500,-699414,2022-09-05
CASH_OUT,455450,Nath Léger,466843,11393,Agence_moov_Abomey,300000,-155450,2022-09-06
CASH_OUT,10918,Nath Léger,11393,475,Agence_moov_Ouidah,300000,289082,2022-09-15
TRANSFER,71663,Hugues Gay,154700,83037,Nath Léger,475,72138,2022-09-27
CASH_OUT,264428,Caroline Peltier,488300,223872,Agence_moov_Abomey,300000,35572,2022-09-06
TRANSFER,8662,Luc Camus,34000,25338,Caroline Peltier,223872,232534,2022-09-21
CASH_OUT,166183,Caroline Peltier,232534,66351,Agence_moov_Ouidah,300000,133817,2022-09-23
CASH_OUT,367498,Sébastien-Arthur Masse,726500,359002,Agence_moov_Ouidah,300000,-67498,2022-09-09
CASH_OUT,833508,Matthieu Carpentier,1758800,925292,Agence_moov_Cotonou,300000,-533508,2022-09-11
CASH_IN,119658,Agence_moov_Abomey,300000,180342,Matthieu Carpentier,925292,1044950,2022-09-19
TRANSFER,199352,Matthieu Carpentier,1044950,845598,Clémence Bertin,279700,80348,2022-09-27
TRANSFER,32287,Théodore-Alfred Fournier,90200,57913,Agnès Chrétien-Sanchez,355300,387587,2022-09-15
TRANSFER,348049,Christine-Constance Gauthier,883300,535251,Agnès Chrétien-Sanchez,387587,735636,2022-09-19
CASH_IN,206305,Agence_moov_Abomey,300000,93695,Augustin Benard,182200,388505,2022-09-27
CASH_IN,90942,Agence_moov_Ouidah,300000,209058,Alexandre Poirier,205800,296742,2022-09-25
CASH_IN,279522,Agence_moov_Abomey,300000,20478,Marianne Descamps,966900,1246422,2022-09-05
CASH_OUT,149811,Marianne Descamps,1246422,1096611,Agence_moov_Cotonou,300000,150189,2022-09-07
CASH_IN,235244,Agence_moov_Cotonou,300000,64756,Marianne Descamps,1096611,1331855,2022-09-11
TRANSFER,885818,Benoît Verdier,1567800,681982,Marianne Descamps,1331855,2217673,2022-09-13
CASH_OUT,1293163,Marianne Descamps,2217673,924510,Agence_moov_Cotonou,300000,-993163,2022-09-18
CASH_IN,264606,Agence_moov_Ouidah,300000,35394,Amélie de la Picard,417900,682506,2022-09-17
CASH_IN,129681,Agence_moov_Abomey,300000,170319,Amélie de la Picard,682506,812187,2022-09-25
CASH_IN,181377,Agence_moov_Ouidah,300000,118623,Laurent Perrot,1709000,1890377,2022-09-01
CASH_OUT,59029,Laurent Perrot,1890377,1831348,Agence_moov_Abomey,300000,240971,2022-09-05
CASH_OUT,558623,Laurent Perrot,1831348,1272725,Agence_moov_Ouidah,300000,-258623,2022-09-06
TRANSFER,594777,Laurent Perrot,1272725,677948,David Diallo,1594500,999723,2022-09-13
CASH_OUT,434468,Laurent Perrot,677948,243480,Agence_moov_Cotonou,300000,-134468,2022-09-22
TRANSFER,807609,Alex Salmon,814700,7091,Hugues Gay,83037,-724572,2022-09-12
CASH_IN,112293,Agence_moov_Cotonou,300000,187707,Marine-Clémence Ferreira,360600,472893,2022-09-01
CASH_IN,164927,Agence_moov_Ouidah,300000,135073,Marine-Clémence Ferreira,472893,637820,2022-09-01
CASH_IN,67003,Agence_moov_Cotonou,300000,232997,Marine-Clémence Ferreira,637820,704823,2022-09-02
TRANSFER,157660,Stéphane-Timothée Pineau,451300,293640,Marine-Clémence Ferreira,704823,862483,2022-09-05
CASH_IN,83068,Agence_moov_Ouidah,300000,216932,Marine-Clémence Ferreira,862483,945551,2022-09-06
TRANSFER,712835,Maryse Reynaud-Michaud,1931300,1218465,Marine-Clémence Ferreira,945551,1658386,2022-09-06
CASH_OUT,142252,Marine-Clémence Ferreira,1658386,1516134,Agence_moov_Ouidah,300000,157748,2022-09-08
CASH_IN,74713,Agence_moov_Ouidah,300000,225287,Marine-Clémence Ferreira,1516134,1590847,2022-09-08
CASH_IN,218229,Agence_moov_Abomey,300000,81771,Marine-Clémence Ferreira,1590847,1809076,2022-09-11
CASH_OUT,1510810,Marine-Clémence Ferreira,1809076,298266,Agence_moov_Ouidah,300000,-1210810,2022-09-12
CASH_IN,234717,Agence_moov_Cotonou,300000,65283,Marine-Clémence Ferreira,298266,532983,2022-09-13
CASH_OUT,341658,Marine-Clémence Ferreira,532983,191325,Agence_moov_Ouidah,300000,-41658,2022-09-13
CASH_OUT,190426,Marine-Clémence Ferreira,191325,899,Agence_moov_Cotonou,300000,109574,2022-09-16
CASH_OUT,729,Marine-Clémence Ferreira,899,170,Agence_moov_Cotonou,300000,299271,2022-09-17
CASH_OUT,137,Marine-Clémence Ferreira,170,33,Agence_moov_Cotonou,300000,299863,2022-09-17
CASH_IN,265874,Agence_moov_Abomey,300000,34126,Marine-Clémence Ferreira,33,265907,2022-09-18
CASH_OUT,262078,Marine-Clémence Ferreira,265907,3829,Agence_moov_Ouidah,300000,37922,2022-09-18
CASH_IN,293456,Agence_moov_Abomey,300000,6544,Marine-Clémence Ferreira,3829,297285,2022-09-18
CASH_IN,211841,Agence_moov_Abomey,300000,88159,Marine-Clémence Ferreira,297285,509126,2022-09-18
TRANSFER,1258344,Caroline Bonneau,1986100,727756,Marine-Clémence Ferreira,509126,1767470,2022-09-19
CASH_OUT,1159331,Marine-Clémence Ferreira,1767470,608139,Agence_moov_Cotonou,300000,-859331,2022-09-19
TRANSFER,536967,Marine-Clémence Ferreira,608139,71172,Marthe Guillet,1943100,1406133,2022-09-19
TRANSFER,44641,Marine-Clémence Ferreira,71172,26531,Laurence Dumont de Laroche,107700,63059,2022-09-20
CASH_OUT,130,Marine-Clémence Ferreira,26531,26401,Agence_moov_Cotonou,300000,299870,2022-09-21
TRANSFER,3738,Marine-Clémence Ferreira,26401,22663,Anastasie Louis,586900,583162,2022-09-21
CASH_IN,13004,Agence_moov_Ouidah,300000,286996,Marine-Clémence Ferreira,22663,35667,2022-09-22
TRANSFER,32081,Marine-Clémence Ferreira,35667,3586,Emmanuelle Gilbert,233100,201019,2022-09-23
CASH_IN,131062,Agence_moov_Ouidah,300000,168938,Marine-Clémence Ferreira,3586,134648,2022-09-23
TRANSFER,89625,Marine-Clémence Ferreira,134648,45023,Aimé Allain,1368500,1278875,2022-09-25
CASH_IN,230769,Agence_moov_Abomey,300000,69231,Marine-Clémence Ferreira,45023,275792,2022-09-26
CASH_IN,130388,Agence_moov_Ouidah,300000,169612,Thierry Dos Santos-Le Roux,1903880,2034268,2022-09-01
TRANSFER,43320,Clémence Bertin,80348,37028,Thierry Dos Santos-Le Roux,2034268,2077588,2022-09-01
CASH_IN,152340,Agence_moov_Abomey,300000,147660,Thierry Dos Santos-Le Roux,2077588,2229928,2022-09-02
TRANSFER,431916,Thierry Dos Santos-Le Roux,2229928,1798012,Anastasie Louis,583162,151246,2022-09-02
CASH_OUT,624894,Thierry Dos Santos-Le Roux,1798012,1173118,Agence_moov_Ouidah,300000,-324894,2022-09-05
TRANSFER,124594,Thierry Dos Santos-Le Roux,1173118,1048524,David-Théodore Diaz,1267033,1142439,2022-09-06
TRANSFER,20025,Thierry Dos Santos-Le Roux,1048524,1028499,David Diallo,999723,979698,2022-09-07
CASH_OUT,432208,Thierry Dos Santos-Le Roux,1028499,596291,Agence_moov_Cotonou,300000,-132208,2022-09-09
CASH_OUT,355465,Thierry Dos Santos-Le Roux,596291,240826,Agence_moov_Ouidah,300000,-55465,2022-09-09
CASH_IN,174504,Agence_moov_Abomey,300000,125496,Thierry Dos Santos-Le Roux,240826,415330,2022-09-09
CASH_OUT,104150,Thierry Dos Santos-Le Roux,415330,311180,Agence_moov_Ouidah,300000,195850,2022-09-11
CASH_IN,97463,Agence_moov_Abomey,300000,202537,Thierry Dos Santos-Le Roux,311180,408643,2022-09-11
CASH_IN,291345,Agence_moov_Abomey,300000,8655,Thierry Dos Santos-Le Roux,408643,699988,2022-09-11
TRANSFER,201697,Thierry Dos Santos-Le Roux,699988,498291,Émile Hebert,508600,306903,2022-09-13
CASH_OUT,297978,Thierry Dos Santos-Le Roux,498291,200313,Agence_moov_Abomey,300000,2022,2022-09-15
TRANSFER,909599,Noël Hamel,1318400,408801,Thierry Dos Santos-Le Roux,200313,1109912,2022-09-16
CASH_IN,184529,Agence_moov_Abomey,300000,115471,Thierry Dos Santos-Le Roux,1109912,1294441,2022-09-17
CASH_IN,33642,Agence_moov_Abomey,300000,266358,Thierry Dos Santos-Le Roux,1294441,1328083,2022-09-17
CASH_IN,54175,Agence_moov_Abomey,300000,245825,Thierry Dos Santos-Le Roux,1328083,1382258,2022-09-17
TRANSFER,32414,Paul Pereira,899200,866786,Thierry Dos Santos-Le Roux,1382258,1414672,2022-09-17
CASH_IN,267037,Agence_moov_Ouidah,300000,32963,Thierry Dos Santos-Le Roux,1414672,1681709,2022-09-17
TRANSFER,1033280,Marthe Guillet,1406133,372853,Thierry Dos Santos-Le Roux,1681709,2714989,2022-09-19
CASH_OUT,2576176,Thierry Dos Santos-Le Roux,2714989,138813,Agence_moov_Cotonou,300000,-2276176,2022-09-21
TRANSFER,71905,Thierry Dos Santos-Le Roux,138813,66908,Frédéric Moreau,531000,459095,2022-09-25
TRANSFER,21478,Thierry Dos Santos-Le Roux,66908,45430,Nathalie-Chantal Jacques,658100,636622,2022-09-25
TRANSFER,561979,Roland Colin,572521,10542,Thierry Dos Santos-Le Roux,45430,607409,2022-09-26
CASH_IN,180569,Agence_moov_Abomey,300000,119431,Marthe Guillet,372853,553422,2022-09-01
TRANSFER,41750,Marthe Guillet,553422,511672,Richard Guibert,371659,329909,2022-09-01
CASH_OUT,215842,Marthe Guillet,511672,295830,Agence_moov_Abomey,300000,84158,2022-09-03
CASH_IN,57318,Agence_moov_Ouidah,300000,242682,Marthe Guillet,295830,353148,2022-09-05
TRANSFER,263659,Théodore Bertin,472000,208341,Marthe Guillet,353148,616807,2022-09-05
CASH_OUT,396004,Marthe Guillet,616807,220803,Agence_moov_Ouidah,300000,-96004,2022-09-05
CASH_OUT,195634,Marthe Guillet,220803,25169,Agence_moov_Abomey,300000,104366,2022-09-08
CASH_IN,278665,Agence_moov_Ouidah,300000,21335,Marthe Guillet,25169,303834,2022-09-08
TRANSFER,285239,Marthe Guillet,303834,18595,Joseph de la Dubois,129900,-155339,2022-09-08
CASH_OUT,17042,Marthe Guillet,18595,1553,Agence_moov_Abomey,300000,282958,2022-09-09
CASH_IN,274763,Agence_moov_Abomey,300000,25237,Marthe Guillet,1553,276316,2022-09-13
CASH_IN,282257,Agence_moov_Ouidah,300000,17743,Marthe Guillet,276316,558573,2022-09-14
CASH_OUT,190079,Marthe Guillet,558573,368494,Agence_moov_Cotonou,300000,109921,2022-09-14
CASH_OUT,114751,Marthe Guillet,368494,253743,Agence_moov_Ouidah,300000,185249,2022-09-16
CASH_OUT,97028,Marthe Guillet,253743,156715,Agence_moov_Cotonou,300000,202972,2022-09-18
CASH_IN,121476,Agence_moov_Cotonou,300000,178524,Marthe Guillet,156715,278191,2022-09-19
TRANSFER,43485,Christophe Alexandre,46785,3300,Marthe Guillet,278191,321676,2022-09-20
CASH_OUT,212733,Marthe Guillet,321676,108943,Agence_moov_Cotonou,300000,87267,2022-09-22
CASH_IN,210901,Agence_moov_Ouidah,300000,89099,Marthe Guillet,108943,319844,2022-09-23
CASH_OUT,106735,Marthe Guillet,319844,213109,Agence_moov_Ouidah,300000,193265,2022-09-25
CASH_IN,70074,Agence_moov_Cotonou,300000,229926,Marthe Guillet,213109,283183,2022-09-26
CASH_OUT,94484,Marthe Guillet,283183,188699,Agence_moov_Ouidah,300000,205516,2022-09-26
CASH_IN,37162,Agence_moov_Cotonou,300000,262838,Marthe Guillet,188699,225861,2022-09-26
TRANSFER,95859,David-Théodore Diaz,1142439,1046580,Marthe Guillet,225861,321720,2022-09-26
CASH_IN,277860,Agence_moov_Abomey,300000,22140,Marthe Guillet,321720,599580,2022-09-26
CASH_OUT,376437,Marthe Guillet,599580,223143,Agence_moov_Abomey,300000,-76437,2022-09-27
CASH_IN,243052,Agence_moov_Abomey,300000,56948,Marthe Guillet,223143,466195,2022-09-27
CASH_OUT,29873,Marthe Guillet,466195,436322,Agence_moov_Ouidah,300000,270127,2022-09-27
CASH_OUT,442497,Adélaïde-Sophie Leclercq,585600,143103,Agence_moov_Ouidah,300000,-142497,2022-09-02
TRANSFER,79372,Adélaïde-Sophie Leclercq,143103,63731,Émile Hebert,306903,227531,2022-09-03
TRANSFER,48865,Adélaïde-Sophie Leclercq,63731,14866,Benoît Verdier,681982,633117,2022-09-04
CASH_IN,130350,Agence_moov_Ouidah,300000,169650,Adélaïde-Sophie Leclercq,14866,145216,2022-09-06
CASH_OUT,37813,Adélaïde-Sophie Leclercq,145216,107403,Agence_moov_Abomey,300000,262187,2022-09-06
CASH_OUT,55650,Adélaïde-Sophie Leclercq,107403,51753,Agence_moov_Cotonou,300000,244350,2022-09-07
CASH_OUT,39762,Adélaïde-Sophie Leclercq,51753,11991,Agence_moov_Abomey,300000,260238,2022-09-07
CASH_IN,39349,Agence_moov_Abomey,300000,260651,Adélaïde-Sophie Leclercq,11991,51340,2022-09-09
CASH_IN,169941,Agence_moov_Ouidah,300000,130059,Adélaïde-Sophie Leclercq,51340,221281,2022-09-09
CASH_OUT,37208,Adélaïde-Sophie Leclercq,221281,184073,Agence_moov_Abomey,300000,262792,2022-09-11
CASH_IN,124766,Agence_moov_Cotonou,300000,175234,Adélaïde-Sophie Leclercq,184073,308839,2022-09-11
CASH_OUT,151531,Adélaïde-Sophie Leclercq,308839,157308,Agence_moov_Cotonou,300000,148469,2022-09-13
TRANSFER,88415,Adélaïde-Sophie Leclercq,157308,68893,Alphonse Dupont-Petit,445400,356985,2022-09-14
CASH_OUT,60941,Adélaïde-Sophie Leclercq,68893,7952,Agence_moov_Cotonou,300000,239059,2022-09-14
CASH_IN,233764,Agence_moov_Abomey,300000,66236,Adélaïde-Sophie Leclercq,7952,241716,2022-09-19
CASH_IN,104785,Agence_moov_Cotonou,300000,195215,Adélaïde-Sophie Leclercq,241716,346501,2022-09-20
TRANSFER,263568,Gilbert Bazin Le Guillet,1461600,1198032,Adélaïde-Sophie Leclercq,346501,610069,2022-09-21
CASH_OUT,241017,Adélaïde-Sophie Leclercq,610069,369052,Agence_moov_Ouidah,300000,58983,2022-09-22
CASH_IN,160494,Agence_moov_Cotonou,300000,139506,Adélaïde-Sophie Leclercq,369052,529546,2022-09-23
CASH_OUT,27201,Adélaïde-Sophie Leclercq,529546,502345,Agence_moov_Cotonou,300000,272799,2022-09-23
CASH_OUT,170903,Adélaïde-Sophie Leclercq,502345,331442,Agence_moov_Abomey,300000,129097,2022-09-23
TRANSFER,762716,Guy Guyon,1141200,378484,Adélaïde-Sophie Leclercq,331442,1094158,2022-09-23
TRANSFER,923475,Adélaïde-Sophie Leclercq,1094158,170683,Guy Guyon,378484,-544991,2022-09-23
CASH_IN,61327,Agence_moov_Ouidah,300000,238673,Adélaïde-Sophie Leclercq,170683,232010,2022-09-24
CASH_IN,88590,Agence_moov_Abomey,300000,211410,Adélaïde-Sophie Leclercq,232010,320600,2022-09-26
CASH_IN,185448,Agence_moov_Cotonou,300000,114552,Adélaïde-Sophie Leclercq,320600,506048,2022-09-26
CASH_IN,286311,Agence_moov_Ouidah,300000,13689,Adélaïde-Sophie Leclercq,506048,792359,2022-09-27
TRANSFER,3137,Christophe Alexandre,3300,163,Marc Gilbert,1010400,1007263,2022-09-01
CASH_OUT,110,Christophe Alexandre,163,53,Agence_moov_Abomey,300000,299890,2022-09-01
CASH_IN,145919,Agence_moov_Abomey,300000,154081,Christophe Alexandre,53,145972,2022-09-02
CASH_IN,34175,Agence_moov_Ouidah,300000,265825,Christophe Alexandre,145972,180147,2022-09-03
CASH_OUT,150786,Christophe Alexandre,180147,29361,Agence_moov_Cotonou,300000,149214,2022-09-10
TRANSFER,25372,Christophe Alexandre,29361,3989,Caroline Bonneau,727756,702384,2022-09-10
CASH_IN,241766,Agence_moov_Abomey,300000,58234,Christophe Alexandre,3989,245755,2022-09-11
CASH_IN,198675,Agence_moov_Abomey,300000,101325,Christophe Alexandre,245755,444430,2022-09-12
CASH_OUT,69679,Christophe Alexandre,444430,374751,Agence_moov_Abomey,300000,230321,2022-09-13
CASH_OUT,67372,Christophe Alexandre,374751,307379,Agence_moov_Abomey,300000,232628,2022-09-14
CASH_OUT,300862,Christophe Alexandre,307379,6517,Agence_moov_Abomey,300000,-862,2022-09-14
TRANSFER,3803,Christophe Alexandre,6517,2714,Maryse Reynaud-Michaud,1218465,1214662,2022-09-15
CASH_OUT,801,Christophe Alexandre,2714,1913,Agence_moov_Ouidah,300000,299199,2022-09-15
CASH_IN,168004,Agence_moov_Cotonou,300000,131996,Christophe Alexandre,1913,169917,2022-09-17
CASH_OUT,36635,Christophe Alexandre,169917,133282,Agence_moov_Abomey,300000,263365,2022-09-17
TRANSFER,108976,Christophe Alexandre,133282,24306,Laurence Carlier,1336300,1227324,2022-09-18
CASH_OUT,18695,Christophe Alexandre,24306,5611,Agence_moov_Abomey,300000,281305,2022-09-19
CASH_OUT,2798,Christophe Alexandre,5611,2813,Agence_moov_Ouidah,300000,297202,2022-09-19
CASH_OUT,1436,Christophe Alexandre,2813,1377,Agence_moov_Cotonou,300000,298564,2022-09-21
CASH_OUT,206,Christophe Alexandre,1377,1171,Agence_moov_Abomey,300000,299794,2022-09-22
TRANSFER,58539,Xavier-Stéphane Ollivier,202400,143861,Christophe Alexandre,1171,59710,2022-09-23
CASH_OUT,49130,Christophe Alexandre,59710,10580,Agence_moov_Cotonou,300000,250870,2022-09-23
CASH_OUT,3934,Christophe Alexandre,10580,6646,Agence_moov_Abomey,300000,296066,2022-09-24
CASH_OUT,630,Christophe Alexandre,6646,6016,Agence_moov_Ouidah,300000,299370,2022-09-24
CASH_OUT,2818,Christophe Alexandre,6016,3198,Agence_moov_Cotonou,300000,297182,2022-09-24
CASH_OUT,2212,Christophe Alexandre,3198,986,Agence_moov_Ouidah,300000,297788,2022-09-26
CASH_OUT,526409,Christine-Constance Gauthier,535251,8842,Agence_moov_Cotonou,300000,-226409,2022-09-02
TRANSFER,8024,Christine-Constance Gauthier,8842,818,Laurent Besson,652400,644376,2022-09-04
TRANSFER,95112,Anastasie Louis,151246,56134,Christine-Constance Gauthier,818,95930,2022-09-05
TRANSFER,259547,Grégoire Delmas de Blanchard,320600,61053,Christine-Constance Gauthier,95930,355477,2022-09-05
TRANSFER,133793,Christine-Constance Gauthier,355477,221684,Christophe Guilbert,1639915,1506122,2022-09-06
TRANSFER,520840,David Diallo,979698,458858,Christine-Constance Gauthier,221684,742524,2022-09-07
TRANSFER,241637,Christine-Constance Gauthier,742524,500887,Marc Gilbert,1007263,765626,2022-09-09
TRANSFER,284110,Joséphine Weber du Bonnin,1668500,1384390,Christine-Constance Gauthier,500887,784997,2022-09-11
TRANSFER,1000639,Emmanuel-René Coulon,1743800,743161,Christine-Constance Gauthier,784997,1785636,2022-09-11
TRANSFER,29018,Christophe Guilbert,1506122,1477104,Christine-Constance Gauthier,1785636,1814654,2022-09-12
CASH_IN,154280,Agence_moov_Ouidah,300000,145720,Christine-Constance Gauthier,1814654,1968934,2022-09-12
CASH_IN,179803,Agence_moov_Ouidah,300000,120197,Christine-Constance Gauthier,1968934,2148737,2022-09-14
CASH_OUT,868027,Christine-Constance Gauthier,2148737,1280710,Agence_moov_Abomey,300000,-568027,2022-09-20
TRANSFER,307282,Christine-Constance Gauthier,1280710,973428,Emmanuel-René Coulon,743161,435879,2022-09-20
TRANSFER,115398,Vincent-Grégoire Brunet,262973,147575,Christine-Constance Gauthier,973428,1088826,2022-09-20
CASH_IN,62525,Agence_moov_Cotonou,300000,237475,Christine-Constance Gauthier,1088826,1151351,2022-09-20
CASH_IN,272506,Agence_moov_Ouidah,300000,27494,Christine-Constance Gauthier,1151351,1423857,2022-09-22
CASH_IN,167589,Agence_moov_Ouidah,300000,132411,Christine-Constance Gauthier,1423857,1591446,2022-09-22
TRANSFER,278595,Arnaude Gaillard,1575800,1297205,Christine-Constance Gauthier,1591446,1870041,2022-09-25
CASH_IN,86941,Agence_moov_Abomey,300000,213059,Christine-Constance Gauthier,1870041,1956982,2022-09-25
CASH_IN,90007,Agence_moov_Abomey,300000,209993,Christine-Constance Gauthier,1956982,2046989,2022-09-27
TRANSFER,37601,Laurence Dumont de Laroche,63059,25458,Luc Camus,25338,62939,2022-09-03
CASH_OUT,14090,Luc Camus,62939,48849,Agence_moov_Cotonou,300000,285910,2022-09-04
CASH_OUT,31294,Luc Camus,48849,17555,Agence_moov_Ouidah,300000,268706,2022-09-05
CASH_OUT,1566,Luc Camus,17555,15989,Agence_moov_Cotonou,300000,298434,2022-09-06
TRANSFER,897716,Vincent-Philippe Rossi,1094800,197084,Luc Camus,15989,913705,2022-09-07
TRANSFER,348713,Luc Camus,913705,564992,Arnaude Gaillard,1297205,948492,2022-09-07
CASH_OUT,462113,Luc Camus,564992,102879,Agence_moov_Abomey,300000,-162113,2022-09-07
CASH_OUT,76776,Luc Camus,102879,26103,Agence_moov_Abomey,300000,223224,2022-09-09
CASH_OUT,9535,Luc Camus,26103,16568,Agence_moov_Abomey,300000,290465,2022-09-09
CASH_IN,108859,Agence_moov_Cotonou,300000,191141,Luc Camus,16568,125427,2022-09-10
CASH_IN,273719,Agence_moov_Cotonou,300000,26281,Luc Camus,125427,399146,2022-09-12
TRANSFER,150902,Paulette Dias,482500,331598,Luc Camus,399146,550048,2022-09-12
CASH_IN,272129,Agence_moov_Abomey,300000,27871,Luc Camus,550048,822177,2022-09-16
CASH_OUT,604558,Luc Camus,822177,217619,Agence_moov_Abomey,300000,-304558,2022-09-16
TRANSFER,216860,Luc Camus,217619,759,Isaac Le Pinto,211089,-5771,2022-09-16
TRANSFER,592670,Nathalie-Chantal Jacques,636622,43952,Luc Camus,759,593429,2022-09-19
CASH_IN,47746,Agence_moov_Abomey,300000,252254,Luc Camus,593429,641175,2022-09-22
TRANSFER,22041,Sabine Imbert,930300,908259,Luc Camus,641175,663216,2022-09-22
CASH_OUT,312554,Luc Camus,663216,350662,Agence_moov_Cotonou,300000,-12554,2022-09-22
CASH_IN,257388,Agence_moov_Abomey,300000,42612,Luc Camus,350662,608050,2022-09-22
TRANSFER,33571,Luc Camus,608050,574479,Roland Colin,10542,-23029,2022-09-24
CASH_OUT,306018,Luc Camus,574479,268461,Agence_moov_Ouidah,300000,-6018,2022-09-24
CASH_OUT,42104,Luc Camus,268461,226357,Agence_moov_Ouidah,300000,257896,2022-09-25
CASH_IN,51912,Agence_moov_Cotonou,300000,248088,Luc Camus,226357,278269,2022-09-25
TRANSFER,115752,Luc Camus,278269,162517,Clémence Bertin,37028,-78724,2022-09-27
CASH_IN,168765,Agence_moov_Abomey,300000,131235,Arnaude Gaillard,948492,1117257,2022-09-01
TRANSFER,54653,Émile Hebert,227531,172878,Arnaude Gaillard,1117257,1171910,2022-09-02
CASH_IN,26972,Agence_moov_Cotonou,300000,273028,Arnaude Gaillard,1171910,1198882,2022-09-04
CASH_OUT,882351,Arnaude Gaillard,1198882,316531,Agence_moov_Ouidah,300000,-582351,2022-09-04
CASH_OUT,140033,Arnaude Gaillard,316531,176498,Agence_moov_Cotonou,300000,159967,2022-09-04
CASH_OUT,126825,Arnaude Gaillard,176498,49673,Agence_moov_Cotonou,300000,173175,2022-09-04
CASH_OUT,15248,Arnaude Gaillard,49673,34425,Agence_moov_Cotonou,300000,284752,2022-09-09
CASH_IN,283966,Agence_moov_Abomey,300000,16034,Arnaude Gaillard,34425,318391,2022-09-09
TRANSFER,13799,Xavier-Stéphane Ollivier,143861,130062,Arnaude Gaillard,318391,332190,2022-09-09
TRANSFER,267331,Sabine Imbert,908259,640928,Arnaude Gaillard,332190,599521,2022-09-09
CASH_IN,183621,Agence_moov_Ouidah,300000,116379,Arnaude Gaillard,599521,783142,2022-09-09
CASH_OUT,102560,Arnaude Gaillard,783142,680582,Agence_moov_Abomey,300000,197440,2022-09-11
CASH_OUT,451388,Arnaude Gaillard,680582,229194,Agence_moov_Cotonou,300000,-151388,2022-09-11
CASH_OUT,30968,Arnaude Gaillard,229194,198226,Agence_moov_Cotonou,300000,269032,2022-09-12
TRANSFER,38638,Nathalie-Chantal Jacques,43952,5314,Arnaude Gaillard,198226,236864,2022-09-12
CASH_OUT,231488,Arnaude Gaillard,236864,5376,Agence_moov_Cotonou,300000,68512,2022-09-14
TRANSFER,50736,Emmanuel-René Coulon,435879,385143,Arnaude Gaillard,5376,56112,2022-09-18
TRANSFER,40476,Arnaude Gaillard,56112,15636,Nathalie-Chantal Jacques,5314,-35162,2022-09-19
CASH_IN,210929,Agence_moov_Cotonou,300000,89071,Arnaude Gaillard,15636,226565,2022-09-19
CASH_OUT,102266,Arnaude Gaillard,226565,124299,Agence_moov_Abomey,300000,197734,2022-09-19
CASH_OUT,52756,Arnaude Gaillard,124299,71543,Agence_moov_Abomey,300000,247244,2022-09-20
CASH_OUT,23478,Arnaude Gaillard,71543,48065,Agence_moov_Abomey,300000,276522,2022-09-21
CASH_OUT,28263,Arnaude Gaillard,48065,19802,Agence_moov_Abomey,300000,271737,2022-09-24
CASH_OUT,4083,Arnaude Gaillard,19802,15719,Agence_moov_Cotonou,300000,295917,2022-09-24
CASH_OUT,751,Arnaude Gaillard,15719,14968,Agence_moov_Ouidah,300000,299249,2022-09-26
TRANSFER,363658,Frédéric Moreau,459095,95437,Laurent Besson,644376,1008034,2022-09-02
CASH_IN,251694,Agence_moov_Ouidah,300000,48306,Laurent Besson,1008034,1259728,2022-09-03
CASH_OUT,161727,Laurent Besson,1259728,1098001,Agence_moov_Abomey,300000,138273,2022-09-03
TRANSFER,564617,Laurent Besson,1098001,533384,Vincent-Philippe Rossi,197084,-367533,2022-09-05
CASH_IN,294350,Agence_moov_Abomey,300000,5650,Laurent Besson,533384,827734,2022-09-05
TRANSFER,160727,David Diallo,458858,298131,Laurent Besson,827734,988461,2022-09-06
CASH_OUT,877134,Laurent Besson,988461,111327,Agence_moov_Abomey,300000,-577134,2022-09-07
CASH_IN,3118,Agence_moov_Abomey,300000,296882,Laurent Besson,111327,114445,2022-09-11
CASH_OUT,33266,Laurent Besson,114445,81179,Agence_moov_Ouidah,300000,266734,2022-09-12
CASH_IN,202401,Agence_moov_Ouidah,300000,97599,Laurent Besson,81179,283580,2022-09-13
TRANSFER,124937,Emmanuelle Gilbert,201019,76082,Laurent Besson,283580,408517,2022-09-15
CASH_IN,120634,Agence_moov_Ouidah,300000,179366,Laurent Besson,408517,529151,2022-09-15
TRANSFER,877083,Aimé Allain,1278875,401792,Laurent Besson,529151,1406234,2022-09-16
CASH_OUT,1135885,Laurent Besson,1406234,270349,Agence_moov_Ouidah,300000,-835885,2022-09-19
CASH_IN,226730,Agence_moov_Abomey,300000,73270,Laurent Besson,270349,497079,2022-09-20
CASH_IN,292292,Agence_moov_Abomey,300000,7708,Laurent Besson,497079,789371,2022-09-21
TRANSFER,576953,Laurent Besson,789371,212418,Aimé Allain,401792,-175161,2022-09-21
CASH_OUT,65202,Laurent Besson,212418,147216,Agence_moov_Cotonou,300000,234798,2022-09-22
CASH_OUT,438,Laurent Besson,147216,146778,Agence_moov_Cotonou,300000,299562,2022-09-23
TRANSFER,121825,Laurent Besson,146778,24953,Laurence Dumont de Laroche,25458,-96367,2022-09-24
CASH_OUT,24808,Laurent Besson,24953,145,Agence_moov_Cotonou,300000,275192,2022-09-24
CASH_IN,297325,Agence_moov_Abomey,300000,2675,David-Théodore Diaz,1046580,1343905,2022-09-01
CASH_OUT,360119,David-Théodore Diaz,1343905,983786,Agence_moov_Ouidah,300000,-60119,2022-09-02
CASH_OUT,72840,David-Théodore Diaz,983786,910946,Agence_moov_Ouidah,300000,227160,2022-09-02
CASH_OUT,21434,David-Théodore Diaz,910946,889512,Agence_moov_Abomey,300000,278566,2022-09-02
CASH_IN,146363,Agence_moov_Cotonou,300000,153637,David-Théodore Diaz,889512,1035875,2022-09-02
CASH_IN,38464,Agence_moov_Cotonou,300000,261536,David-Théodore Diaz,1035875,1074339,2022-09-10
CASH_OUT,321156,David-Théodore Diaz,1074339,753183,Agence_moov_Abomey,300000,-21156,2022-09-13
CASH_IN,129844,Agence_moov_Cotonou,300000,170156,David-Théodore Diaz,753183,883027,2022-09-13
CASH_OUT,26639,David-Théodore Diaz,883027,856388,Agence_moov_Ouidah,300000,273361,2022-09-13
CASH_OUT,601717,David-Théodore Diaz,856388,254671,Agence_moov_Ouidah,300000,-301717,2022-09-14
CASH_IN,237678,Agence_moov_Ouidah,300000,62322,David-Théodore Diaz,254671,492349,2022-09-16
CASH_IN,245773,Agence_moov_Abomey,300000,54227,David-Théodore Diaz,492349,738122,2022-09-18
CASH_OUT,490272,David-Théodore Diaz,738122,247850,Agence_moov_Ouidah,300000,-190272,2022-09-20
TRANSFER,475467,Bernadette Fabre,879900,404433,David-Théodore Diaz,247850,723317,2022-09-20
CASH_OUT,131440,David-Théodore Diaz,723317,591877,Agence_moov_Cotonou,300000,168560,2022-09-20
CASH_IN,212871,Agence_moov_Cotonou,300000,87129,David-Théodore Diaz,591877,804748,2022-09-20
CASH_IN,63992,Agence_moov_Ouidah,300000,236008,David-Théodore Diaz,804748,868740,2022-09-20
CASH_IN,217463,Agence_moov_Ouidah,300000,82537,David-Théodore Diaz,868740,1086203,2022-09-21
CASH_IN,94508,Agence_moov_Abomey,300000,205492,David-Théodore Diaz,1086203,1180711,2022-09-21
CASH_OUT,529015,David-Théodore Diaz,1180711,651696,Agence_moov_Ouidah,300000,-229015,2022-09-22
CASH_OUT,348618,David-Théodore Diaz,651696,303078,Agence_moov_Cotonou,300000,-48618,2022-09-23
TRANSFER,146472,David-Théodore Diaz,303078,156606,Caroline Bonneau,702384,555912,2022-09-23
CASH_IN,64153,Agence_moov_Ouidah,300000,235847,David-Théodore Diaz,156606,220759,2022-09-24
CASH_IN,133919,Agence_moov_Cotonou,300000,166081,David-Théodore Diaz,220759,354678,2022-09-26
CASH_IN,205233,Agence_moov_Ouidah,300000,94767,David-Théodore Diaz,354678,559911,2022-09-26
TRANSFER,258314,David-Théodore Diaz,559911,301597,Paul Pereira,866786,608472,2022-09-27
TRANSFER,152611,David Diallo,298131,145520,Richard Guibert,329909,177298,2022-09-01
CASH_IN,66267,Agence_moov_Cotonou,300000,233733,David Diallo,145520,211787,2022-09-01
CASH_IN,36835,Agence_moov_Abomey,300000,263165,David Diallo,211787,248622,2022-09-02
CASH_OUT,120456,David Diallo,248622,128166,Agence_moov_Cotonou,300000,179544,2022-09-03
TRANSFER,47622,Anastasie Louis,56134,8512,David Diallo,128166,175788,2022-09-04
TRANSFER,773929,Maurice Alves,1189113,415184,David Diallo,175788,949717,2022-09-04
CASH_IN,248933,Agence_moov_Ouidah,300000,51067,David Diallo,949717,1198650,2022-09-05
TRANSFER,492950,David Diallo,1198650,705700,Julie Robin de Gros,1610600,1117650,2022-09-05
TRANSFER,477774,David Diallo,705700,227926,David Diallo,705700,1183474,2022-09-06
CASH_OUT,59989,David Diallo,227926,167937,Agence_moov_Ouidah,300000,240011,2022-09-08
TRANSFER,111106,David Diallo,167937,56831,Frédérique Robin,922800,811694,2022-09-09
TRANSFER,136655,Caroline Bonneau,555912,419257,David Diallo,56831,193486,2022-09-13
TRANSFER,47254,David Diallo,193486,146232,Sabine Imbert,640928,593674,2022-09-14
CASH_IN,124499,Agence_moov_Abomey,300000,175501,David Diallo,146232,270731,2022-09-15
CASH_OUT,120200,David Diallo,270731,150531,Agence_moov_Abomey,300000,179800,2022-09-16
CASH_IN,225715,Agence_moov_Cotonou,300000,74285,David Diallo,150531,376246,2022-09-21
CASH_OUT,187279,David Diallo,376246,188967,Agence_moov_Abomey,300000,112721,2022-09-22
TRANSFER,35446,David Diallo,188967,153521,Théodore-Alfred Fournier,57913,22467,2022-09-22
CASH_IN,183089,Agence_moov_Abomey,300000,116911,David Diallo,153521,336610,2022-09-22
CASH_IN,143639,Agence_moov_Cotonou,300000,156361,David Diallo,336610,480249,2022-09-24
CASH_OUT,411604,David Diallo,480249,68645,Agence_moov_Ouidah,300000,-111604,2022-09-25
CASH_OUT,102459,Maryse Reynaud-Michaud,1214662,1112203,Agence_moov_Ouidah,300000,197541,2022-09-01
CASH_OUT,124192,Maryse Reynaud-Michaud,1112203,988011,Agence_moov_Ouidah,300000,175808,2022-09-01
CASH_IN,247098,Agence_moov_Ouidah,300000,52902,Maryse Reynaud-Michaud,988011,1235109,2022-09-04
CASH_IN,130248,Agence_moov_Abomey,300000,169752,Maryse Reynaud-Michaud,1235109,1365357,2022-09-05
CASH_OUT,1238952,Maryse Reynaud-Michaud,1365357,126405,Agence_moov_Abomey,300000,-938952,2022-09-05
TRANSFER,15339,Stéphane-Timothée Pineau,293640,278301,Maryse Reynaud-Michaud,126405,141744,2022-09-06
CASH_IN,20206,Agence_moov_Ouidah,300000,279794,Maryse Reynaud-Michaud,141744,161950,2022-09-06
CASH_IN,159381,Agence_moov_Abomey,300000,140619,Maryse Reynaud-Michaud,161950,321331,2022-09-07
CASH_IN,212843,Agence_moov_Ouidah,300000,87157,Maryse Reynaud-Michaud,321331,534174,2022-09-07
TRANSFER,78463,Maryse Reynaud-Michaud,534174,455711,Alfred Chrétien,486590,408127,2022-09-10
CASH_OUT,46851,Maryse Reynaud-Michaud,455711,408860,Agence_moov_Ouidah,300000,253149,2022-09-11
TRANSFER,15025,Théodore Bertin,208341,193316,Maryse Reynaud-Michaud,408860,423885,2022-09-12
TRANSFER,44080,Maryse Lebreton,839200,795120,Maryse Reynaud-Michaud,423885,467965,2022-09-13
TRANSFER,321853,Maryse Reynaud-Michaud,467965,146112,Émile Hebert,172878,-148975,2022-09-17
TRANSFER,130742,Maryse Reynaud-Michaud,146112,15370,Paul De Sousa,1534800,1404058,2022-09-18
CASH_IN,230764,Agence_moov_Ouidah,300000,69236,Maryse Reynaud-Michaud,15370,246134,2022-09-18
CASH_IN,180188,Agence_moov_Ouidah,300000,119812,Maryse Reynaud-Michaud,246134,426322,2022-09-19
TRANSFER,15815,Théodore-Alfred Fournier,22467,6652,Maryse Reynaud-Michaud,426322,442137,2022-09-19
CASH_OUT,391420,Maryse Reynaud-Michaud,442137,50717,Agence_moov_Ouidah,300000,-91420,2022-09-19
CASH_IN,288013,Agence_moov_Abomey,300000,11987,Maryse Reynaud-Michaud,50717,338730,2022-09-20
CASH_IN,60880,Agence_moov_Cotonou,300000,239120,Maryse Reynaud-Michaud,338730,399610,2022-09-21
CASH_IN,231234,Agence_moov_Abomey,300000,68766,Maryse Reynaud-Michaud,399610,630844,2022-09-21
CASH_IN,15276,Agence_moov_Ouidah,300000,284724,Maryse Reynaud-Michaud,630844,646120,2022-09-23
TRANSFER,99981,Maryse Reynaud-Michaud,646120,546139,Paulette Dias,331598,231617,2022-09-24
CASH_OUT,528186,Maryse Reynaud-Michaud,546139,17953,Agence_moov_Ouidah,300000,-228186,2022-09-24
CASH_OUT,3464,Maryse Reynaud-Michaud,17953,14489,Agence_moov_Abomey,300000,296536,2022-09-26
CASH_IN,77161,Agence_moov_Abomey,300000,222839,Maryse Reynaud-Michaud,14489,91650,2022-09-26
CASH_OUT,16868,Maryse Reynaud-Michaud,91650,74782,Agence_moov_Abomey,300000,283132,2022-09-27
CASH_IN,175498,Agence_moov_Ouidah,300000,124502,Matthieu Renard,-720473,-544975,2022-09-02
CASH_IN,147755,Agence_moov_Cotonou,300000,152245,Matthieu Renard,-544975,-397220,2022-09-02
CASH_IN,212922,Agence_moov_Cotonou,300000,87078,Matthieu Renard,-397220,-184298,2022-09-03
CASH_IN,280832,Agence_moov_Abomey,300000,19168,Matthieu Renard,-184298,96534,2022-09-03
CASH_IN,160860,Agence_moov_Ouidah,300000,139140,Matthieu Renard,96534,257394,2022-09-03
CASH_IN,150301,Agence_moov_Ouidah,300000,149699,Matthieu Renard,257394,407695,2022-09-04
TRANSFER,296579,Matthieu Renard,407695,111116,Auguste Bousquet,1040100,743521,2022-09-12
TRANSFER,58498,Matthieu Renard,111116,52618,Josette Guillon-Leclercq,893400,834902,2022-09-13
CASH_IN,274672,Agence_moov_Cotonou,300000,25328,Matthieu Renard,52618,327290,2022-09-15
TRANSFER,78436,Matthieu Renard,327290,248854,Sabine Imbert,593674,515238,2022-09-15
TRANSFER,46742,Frédéric Moreau,95437,48695,Matthieu Renard,248854,295596,2022-09-16
CASH_OUT,89215,Matthieu Renard,295596,206381,Agence_moov_Ouidah,300000,210785,2022-09-16
CASH_OUT,29526,Matthieu Renard,206381,176855,Agence_moov_Cotonou,300000,270474,2022-09-18
CASH_OUT,154144,Matthieu Renard,176855,22711,Agence_moov_Abomey,300000,145856,2022-09-19
CASH_OUT,5093,Matthieu Renard,22711,17618,Agence_moov_Ouidah,300000,294907,2022-09-23
CASH_IN,88321,Agence_moov_Ouidah,300000,211679,Matthieu Renard,17618,105939,2022-09-24
CASH_IN,75088,Agence_moov_Cotonou,300000,224912,Matthieu Renard,105939,181027,2022-09-24
CASH_IN,119747,Agence_moov_Cotonou,300000,180253,Matthieu Renard,181027,300774,2022-09-25
CASH_IN,130346,Agence_moov_Ouidah,300000,169654,Matthieu Renard,300774,431120,2022-09-26
CASH_IN,15199,Agence_moov_Cotonou,300000,284801,Matthieu Renard,431120,446319,2022-09-27
TRANSFER,403907,Matthieu Renard,446319,42412,Antoine Leroux,938164,534257,2022-09-27
TRANSFER,24349,Matthieu Renard,42412,18063,Laurence Carlier,1227324,1202975,2022-09-27
CASH_IN,267066,Agence_moov_Abomey,300000,32934,Théodore Bertin,193316,460382,2022-09-01
CASH_IN,283728,Agence_moov_Ouidah,300000,16272,Théodore Bertin,460382,744110,2022-09-02
CASH_OUT,590062,Théodore Bertin,744110,154048,Agence_moov_Abomey,300000,-290062,2022-09-02
CASH_IN,189828,Agence_moov_Cotonou,300000,110172,Théodore Bertin,154048,343876,2022-09-03
CASH_OUT,115514,Théodore Bertin,343876,228362,Agence_moov_Abomey,300000,184486,2022-09-04
CASH_IN,150354,Agence_moov_Ouidah,300000,149646,Théodore Bertin,228362,378716,2022-09-05
TRANSFER,22998,Théodore Bertin,378716,355718,Paul Pereira,608472,585474,2022-09-05
CASH_IN,218045,Agence_moov_Ouidah,300000,81955,Théodore Bertin,355718,573763,2022-09-06
CASH_OUT,83331,Théodore Bertin,573763,490432,Agence_moov_Abomey,300000,216669,2022-09-08
CASH_IN,267947,Agence_moov_Cotonou,300000,32053,Théodore Bertin,490432,758379,2022-09-08
TRANSFER,61723,Théodore Bertin,758379,696656,Diane-Françoise Raynaud,912684,850961,2022-09-08
TRANSFER,692864,Théodore Bertin,696656,3792,Julie Robin de Gros,1117650,424786,2022-09-09
TRANSFER,2851,Théodore Bertin,3792,941,Gabriel de Pineau,452200,449349,2022-09-10
TRANSFER,1287888,Paul De Sousa,1404058,116170,Théodore Bertin,941,1288829,2022-09-11
CASH_IN,184649,Agence_moov_Ouidah,300000,115351,Théodore Bertin,1288829,1473478,2022-09-11
TRANSFER,57753,Grégoire Delmas de Blanchard,61053,3300,Théodore Bertin,1473478,1531231,2022-09-11
TRANSFER,170379,Théodore Bertin,1531231,1360852,Richard Guibert,177298,6919,2022-09-12
CASH_IN,290943,Agence_moov_Ouidah,300000,9057,Théodore Bertin,1360852,1651795,2022-09-13
CASH_IN,250616,Agence_moov_Abomey,300000,49384,Théodore Bertin,1651795,1902411,2022-09-14
TRANSFER,1480449,Théodore Bertin,1902411,421962,Antoine Leroux,534257,-946192,2022-09-15
TRANSFER,131685,Théodore Bertin,421962,290277,Noël Hamel,408801,277116,2022-09-18
TRANSFER,119558,Théodore Bertin,290277,170719,Gilbert Bazin Le Guillet,1198032,1078474,2022-09-19
CASH_OUT,34720,Théodore Bertin,170719,135999,Agence_moov_Cotonou,300000,265280,2022-09-20
CASH_IN,69669,Agence_moov_Abomey,300000,230331,Théodore Bertin,135999,205668,2022-09-21
CASH_IN,67063,Agence_moov_Ouidah,300000,232937,Théodore Bertin,205668,272731,2022-09-24
CASH_OUT,94367,Théodore Bertin,272731,178364,Agence_moov_Abomey,300000,205633,2022-09-26
CASH_IN,263055,Agence_moov_Ouidah,300000,36945,Théodore Bertin,178364,441419,2022-09-26
CASH_OUT,267960,Théodore Bertin,441419,173459,Agence_moov_Abomey,300000,32040,2022-09-27
TRANSFER,13857,Nicolas Grondin de la Pinto,114900,101043,Théodore Bertin,173459,187316,2022-09-27
TRANSFER,553,Xavier-Stéphane Ollivier,130062,129509,Théodore Bertin,187316,187869,2022-09-27
CASH_IN,115961,Agence_moov_Cotonou,300000,184039,Gilbert Bazin Le Guillet,1078474,1194435,2022-09-01
TRANSFER,530833,Gilbert Bazin Le Guillet,1194435,663602,Nicolas Grondin de la Pinto,101043,-429790,2022-09-02
TRANSFER,211810,Gilbert Bazin Le Guillet,663602,451792,Gilbert Bazin Le Guillet,663602,451792,2022-09-03
TRANSFER,192196,Gilbert Bazin Le Guillet,451792,259596,Joséphine Weber du Bonnin,1384390,1192194,2022-09-03
TRANSFER,104199,Gilbert Bazin Le Guillet,259596,155397,Maurice Alves,415184,310985,2022-09-03
CASH_IN,206545,Agence_moov_Ouidah,300000,93455,Gilbert Bazin Le Guillet,155397,361942,2022-09-05
CASH_IN,145331,Agence_moov_Cotonou,300000,154669,Gilbert Bazin Le Guillet,361942,507273,2022-09-08
CASH_OUT,61445,Gilbert Bazin Le Guillet,507273,445828,Agence_moov_Abomey,300000,238555,2022-09-08
TRANSFER,266106,Gilbert Bazin Le Guillet,445828,179722,Joséphine Weber du Bonnin,1192194,926088,2022-09-08
CASH_OUT,90084,Gilbert Bazin Le Guillet,179722,89638,Agence_moov_Ouidah,300000,209916,2022-09-11
TRANSFER,4132,Gilbert Bazin Le Guillet,89638,85506,Nicolas Hervé,294700,290568,2022-09-13
CASH_IN,75680,Agence_moov_Cotonou,300000,224320,Gilbert Bazin Le Guillet,85506,161186,2022-09-13
TRANSFER,230763,Marie Da Silva,1171169,940406,Gilbert Bazin Le Guillet,161186,391949,2022-09-13
CASH_OUT,175774,Gilbert Bazin Le Guillet,391949,216175,Agence_moov_Cotonou,300000,124226,2022-09-14
TRANSFER,84484,Gilbert Bazin Le Guillet,216175,131691,Nicolas Hervé,290568,206084,2022-09-14
CASH_OUT,69475,Gilbert Bazin Le Guillet,131691,62216,Agence_moov_Abomey,300000,230525,2022-09-14
CASH_IN,244209,Agence_moov_Cotonou,300000,55791,Gilbert Bazin Le Guillet,62216,306425,2022-09-15
CASH_OUT,180772,Gilbert Bazin Le Guillet,306425,125653,Agence_moov_Ouidah,300000,119228,2022-09-16
CASH_IN,242050,Agence_moov_Ouidah,300000,57950,Gilbert Bazin Le Guillet,125653,367703,2022-09-17
CASH_IN,44815,Agence_moov_Cotonou,300000,255185,Gilbert Bazin Le Guillet,367703,412518,2022-09-17
CASH_IN,191020,Agence_moov_Abomey,300000,108980,Gilbert Bazin Le Guillet,412518,603538,2022-09-18
TRANSFER,780233,Christophe Guilbert,1477104,696871,Gilbert Bazin Le Guillet,603538,1383771,2022-09-20
TRANSFER,1321929,Gilbert Bazin Le Guillet,1383771,61842,Paul De Sousa,116170,-1205759,2022-09-22
CASH_IN,283235,Agence_moov_Ouidah,300000,16765,Gilbert Bazin Le Guillet,61842,345077,2022-09-23
TRANSFER,125088,Gilbert Bazin Le Guillet,345077,219989,Richard Guibert,6919,-118169,2022-09-24
CASH_IN,19886,Agence_moov_Cotonou,300000,280114,Gilbert Bazin Le Guillet,219989,239875,2022-09-24
CASH_IN,184588,Agence_moov_Abomey,300000,115412,Gilbert Bazin Le Guillet,239875,424463,2022-09-25
TRANSFER,270023,Paul Pereira,585474,315451,Gilbert Bazin Le Guillet,424463,694486,2022-09-27
CASH_IN,261716,Agence_moov_Ouidah,300000,38284,Laurence Dumont de Laroche,-96367,165349,2022-09-01
CASH_IN,203365,Agence_moov_Ouidah,300000,96635,Laurence Dumont de Laroche,165349,368714,2022-09-02
CASH_OUT,332904,Laurence Dumont de Laroche,368714,35810,Agence_moov_Ouidah,300000,-32904,2022-09-03
TRANSFER,20318,Laurence Dumont de Laroche,35810,15492,Josette Guillon-Leclercq,834902,814584,2022-09-04
CASH_IN,160231,Agence_moov_Abomey,300000,139769,Laurence Dumont de Laroche,15492,175723,2022-09-05
CASH_IN,270051,Agence_moov_Abomey,300000,29949,Laurence Dumont de Laroche,175723,445774,2022-09-07
TRANSFER,356966,Laurence Dumont de Laroche,445774,88808,Paul Pereira,315451,-41515,2022-09-08
CASH_IN,45382,Agence_moov_Ouidah,300000,254618,Laurence Dumont de Laroche,88808,134190,2022-09-10
CASH_IN,142850,Agence_moov_Abomey,300000,157150,Laurence Dumont de Laroche,134190,277040,2022-09-10
CASH_IN,155766,Agence_moov_Ouidah,300000,144234,Laurence Dumont de Laroche,277040,432806,2022-09-11
TRANSFER,53416,Emmanuel-René Coulon,385143,331727,Laurence Dumont de Laroche,432806,486222,2022-09-12
CASH_IN,53592,Agence_moov_Ouidah,300000,246408,Laurence Dumont de Laroche,486222,539814,2022-09-12
CASH_IN,79622,Agence_moov_Abomey,300000,220378,Laurence Dumont de Laroche,539814,619436,2022-09-13
CASH_IN,207712,Agence_moov_Abomey,300000,92288,Laurence Dumont de Laroche,619436,827148,2022-09-16
TRANSFER,557699,Laurence Dumont de Laroche,827148,269449,Anastasie Louis,8512,-549187,2022-09-17
CASH_IN,246621,Agence_moov_Cotonou,300000,53379,Laurence Dumont de Laroche,269449,516070,2022-09-17
CASH_IN,102011,Agence_moov_Cotonou,300000,197989,Laurence Dumont de Laroche,516070,618081,2022-09-17
CASH_IN,68057,Agence_moov_Abomey,300000,231943,Laurence Dumont de Laroche,618081,686138,2022-09-18
CASH_OUT,573940,Laurence Dumont de Laroche,686138,112198,Agence_moov_Cotonou,300000,-273940,2022-09-19
CASH_IN,89877,Agence_moov_Abomey,300000,210123,Laurence Dumont de Laroche,112198,202075,2022-09-19
CASH_OUT,89861,Laurence Dumont de Laroche,202075,112214,Agence_moov_Cotonou,300000,210139,2022-09-20
TRANSFER,376187,Bernadette Fabre,404433,28246,Laurence Dumont de Laroche,112214,488401,2022-09-21
CASH_OUT,79985,Laurence Dumont de Laroche,488401,408416,Agence_moov_Abomey,300000,220015,2022-09-23
TRANSFER,754382,Marc Gilbert,765626,11244,Laurence Dumont de Laroche,408416,1162798,2022-09-24
TRANSFER,583628,Laurence Dumont de Laroche,1162798,579170,Noël Hamel,277116,-306512,2022-09-25
TRANSFER,578044,Laurence Dumont de Laroche,579170,1126,Maurice Alves,310985,-267059,2022-09-26
CASH_OUT,781,Laurence Dumont de Laroche,1126,345,Agence_moov_Cotonou,300000,299219,2022-09-26
CASH_OUT,128,Laurence Dumont de Laroche,345,217,Agence_moov_Cotonou,300000,299872,2022-09-27
CASH_IN,78249,Agence_moov_Cotonou,300000,221751,Christophe Guilbert,696871,775120,2022-09-01
TRANSFER,187862,Frédérique Robin,811694,623832,Christophe Guilbert,775120,962982,2022-09-02
CASH_OUT,375410,Christophe Guilbert,962982,587572,Agence_moov_Ouidah,300000,-75410,2022-09-03
CASH_OUT,437454,Christophe Guilbert,587572,150118,Agence_moov_Ouidah,300000,-137454,2022-09-03
TRANSFER,62589,Christophe Guilbert,150118,87529,Margot Renaud de Lacombe,153100,90511,2022-09-04
CASH_IN,12154,Agence_moov_Abomey,300000,287846,Christophe Guilbert,87529,99683,2022-09-05
CASH_OUT,43779,Christophe Guilbert,99683,55904,Agence_moov_Abomey,300000,256221,2022-09-06
CASH_OUT,13288,Christophe Guilbert,55904,42616,Agence_moov_Ouidah,300000,286712,2022-09-06
CASH_OUT,860,Christophe Guilbert,42616,41756,Agence_moov_Ouidah,300000,299140,2022-09-07
CASH_OUT,9512,Christophe Guilbert,41756,32244,Agence_moov_Abomey,300000,290488,2022-09-07
CASH_IN,244691,Agence_moov_Ouidah,300000,55309,Christophe Guilbert,32244,276935,2022-09-08
CASH_OUT,194217,Christophe Guilbert,276935,82718,Agence_moov_Cotonou,300000,105783,2022-09-08
TRANSFER,15107,Christophe Guilbert,82718,67611,Margot Renaud de Lacombe,90511,75404,2022-09-09
CASH_IN,67271,Agence_moov_Cotonou,300000,232729,Christophe Guilbert,67611,134882,2022-09-11
CASH_IN,10060,Agence_moov_Abomey,300000,289940,Christophe Guilbert,134882,144942,2022-09-12
CASH_IN,149501,Agence_moov_Cotonou,300000,150499,Christophe Guilbert,144942,294443,2022-09-13
CASH_IN,151175,Agence_moov_Abomey,300000,148825,Christophe Guilbert,294443,445618,2022-09-13
CASH_OUT,254114,Christophe Guilbert,445618,191504,Agence_moov_Ouidah,300000,45886,2022-09-18
CASH_IN,135636,Agence_moov_Cotonou,300000,164364,Christophe Guilbert,191504,327140,2022-09-19
TRANSFER,322028,Alphonse Dupont-Petit,356985,34957,Christophe Guilbert,327140,649168,2022-09-19
TRANSFER,142818,Vincent-Grégoire Brunet,147575,4757,Christophe Guilbert,649168,791986,2022-09-20
CASH_OUT,59396,Christophe Guilbert,791986,732590,Agence_moov_Abomey,300000,240604,2022-09-21
CASH_OUT,71347,Christophe Guilbert,732590,661243,Agence_moov_Cotonou,300000,228653,2022-09-23
TRANSFER,613036,Christophe Guilbert,661243,48207,Luc-Tristan Moreau,562400,-50636,2022-09-26
CASH_OUT,16569,Christophe Guilbert,48207,31638,Agence_moov_Cotonou,300000,283431,2022-09-26
CASH_IN,270756,Agence_moov_Ouidah,300000,29244,Christophe Guilbert,31638,302394,2022-09-27
CASH_OUT,218684,Christophe Guilbert,302394,83710,Agence_moov_Cotonou,300000,81316,2022-09-27
CASH_IN,95657,Agence_moov_Ouidah,300000,204343,Caroline Bonneau,419257,514914,2022-09-01
TRANSFER,77604,Caroline Bonneau,514914,437310,Frédéric Moreau,48695,-28909,2022-09-01
CASH_IN,20133,Agence_moov_Ouidah,300000,279867,Caroline Bonneau,437310,457443,2022-09-02
TRANSFER,436178,Caroline Bonneau,457443,21265,Caroline Bonneau,457443,893621,2022-09-03
CASH_OUT,20826,Caroline Bonneau,21265,439,Agence_moov_Cotonou,300000,279174,2022-09-05
CASH_OUT,117,Caroline Bonneau,439,322,Agence_moov_Cotonou,300000,299883,2022-09-08
TRANSFER,142,Caroline Bonneau,322,180,Auguste Bousquet,743521,743379,2022-09-09
CASH_OUT,105,Caroline Bonneau,180,75,Agence_moov_Cotonou,300000,299895,2022-09-11
CASH_IN,25996,Agence_moov_Cotonou,300000,274004,Caroline Bonneau,75,26071,2022-09-11
CASH_OUT,25795,Caroline Bonneau,26071,276,Agence_moov_Cotonou,300000,274205,2022-09-11
CASH_OUT,146,Caroline Bonneau,276,130,Agence_moov_Ouidah,300000,299854,2022-09-12
CASH_IN,148729,Agence_moov_Abomey,300000,151271,Caroline Bonneau,130,148859,2022-09-13
CASH_IN,12834,Agence_moov_Abomey,300000,287166,Caroline Bonneau,148859,161693,2022-09-14
CASH_OUT,123833,Caroline Bonneau,161693,37860,Agence_moov_Abomey,300000,176167,2022-09-16
TRANSFER,109562,Julie Robin de Gros,424786,315224,Caroline Bonneau,37860,147422,2022-09-17
CASH_OUT,39605,Caroline Bonneau,147422,107817,Agence_moov_Ouidah,300000,260395,2022-09-21
TRANSFER,87972,Caroline Bonneau,107817,19845,Xavier-Stéphane Ollivier,129509,41537,2022-09-21
CASH_OUT,9149,Caroline Bonneau,19845,10696,Agence_moov_Abomey,300000,290851,2022-09-21
TRANSFER,944064,Marthe Pichon,1357914,413850,Caroline Bonneau,10696,954760,2022-09-22
TRANSFER,3743,Vincent-Grégoire Brunet,4757,1014,Caroline Bonneau,954760,958503,2022-09-24
CASH_OUT,614650,Caroline Bonneau,958503,343853,Agence_moov_Ouidah,300000,-314650,2022-09-25
CASH_IN,149947,Agence_moov_Ouidah,300000,150053,Caroline Bonneau,343853,493800,2022-09-26
TRANSFER,51457,Alfred Chrétien,408127,356670,Caroline Bonneau,493800,545257,2022-09-26
CASH_OUT,522262,Caroline Bonneau,545257,22995,Agence_moov_Cotonou,300000,-222262,2022-09-26
CASH_OUT,7638,Caroline Bonneau,22995,15357,Agence_moov_Cotonou,300000,292362,2022-09-26
TRANSFER,588113,Frédérique Robin,623832,35719,Caroline Bonneau,15357,603470,2022-09-27
CASH_OUT,2202,Théodore-Alfred Fournier,6652,4450,Agence_moov_Ouidah,300000,297798,2022-09-02
CASH_IN,56016,Agence_moov_Abomey,300000,243984,Théodore-Alfred Fournier,4450,60466,2022-09-03
CASH_OUT,27290,Théodore-Alfred Fournier,60466,33176,Agence_moov_Cotonou,300000,272710,2022-09-04
CASH_IN,23694,Agence_moov_Abomey,300000,276306,Théodore-Alfred Fournier,33176,56870,2022-09-05
CASH_IN,18218,Agence_moov_Cotonou,300000,281782,Théodore-Alfred Fournier,56870,75088,2022-09-05
CASH_IN,132749,Agence_moov_Ouidah,300000,167251,Théodore-Alfred Fournier,75088,207837,2022-09-07
TRANSFER,115012,Théodore-Alfred Fournier,207837,92825,Susan de Fontaine,272780,157768,2022-09-08
CASH_IN,245306,Agence_moov_Abomey,300000,54694,Théodore-Alfred Fournier,92825,338131,2022-09-08
CASH_OUT,335806,Théodore-Alfred Fournier,338131,2325,Agence_moov_Abomey,300000,-35806,2022-09-10
CASH_IN,198133,Agence_moov_Cotonou,300000,101867,Théodore-Alfred Fournier,2325,200458,2022-09-10
CASH_IN,291492,Agence_moov_Cotonou,300000,8508,Théodore-Alfred Fournier,200458,491950,2022-09-11
CASH_IN,189899,Agence_moov_Abomey,300000,110101,Théodore-Alfred Fournier,491950,681849,2022-09-11
CASH_IN,5828,Agence_moov_Abomey,300000,294172,Théodore-Alfred Fournier,681849,687677,2022-09-12
CASH_IN,53852,Agence_moov_Ouidah,300000,246148,Théodore-Alfred Fournier,687677,741529,2022-09-15
CASH_IN,14128,Agence_moov_Ouidah,300000,285872,Théodore-Alfred Fournier,741529,755657,2022-09-16
TRANSFER,183561,Théodore-Alfred Fournier,755657,572096,Lucy Vaillant,935700,752139,2022-09-17
TRANSFER,812,Vincent-Grégoire Brunet,1014,202,Théodore-Alfred Fournier,572096,572908,2022-09-19
CASH_OUT,430382,Théodore-Alfred Fournier,572908,142526,Agence_moov_Cotonou,300000,-130382,2022-09-19
CASH_OUT,1957,Théodore-Alfred Fournier,142526,140569,Agence_moov_Cotonou,300000,298043,2022-09-22
TRANSFER,259865,Sabine Imbert,515238,255373,Théodore-Alfred Fournier,140569,400434,2022-09-23
TRANSFER,243165,Théodore-Alfred Fournier,400434,157269,Paulette Dias,231617,-11548,2022-09-23
CASH_OUT,117480,Théodore-Alfred Fournier,157269,39789,Agence_moov_Ouidah,300000,182520,2022-09-23
TRANSFER,33329,Théodore-Alfred Fournier,39789,6460,Frédérique Robin,35719,2390,2022-09-24
CASH_OUT,5176,Théodore-Alfred Fournier,6460,1284,Agence_moov_Abomey,300000,294824,2022-09-25
CASH_IN,42799,Agence_moov_Abomey,300000,257201,Théodore-Alfred Fournier,1284,44083,2022-09-25
CASH_IN,47857,Agence_moov_Abomey,300000,252143,Théodore-Alfred Fournier,44083,91940,2022-09-27
CASH_OUT,60809,Théodore-Alfred Fournier,91940,31131,Agence_moov_Cotonou,300000,239191,2022-09-27
CASH_OUT,136897,Maryse Lebreton,795120,658223,Agence_moov_Ouidah,300000,163103,2022-09-02
TRANSFER,644900,Maryse Lebreton,658223,13323,Julie Robin de Gros,315224,-329676,2022-09-03
TRANSFER,4110,Bernadette Fabre,28246,24136,Maryse Lebreton,13323,17433,2022-09-04
CASH_OUT,2390,Maryse Lebreton,17433,15043,Agence_moov_Cotonou,300000,297610,2022-09-04
CASH_OUT,12897,Maryse Lebreton,15043,2146,Agence_moov_Abomey,300000,287103,2022-09-06
TRANSFER,2103,Maryse Lebreton,2146,43,Marie Da Silva,940406,938303,2022-09-07
CASH_IN,234480,Agence_moov_Ouidah,300000,65520,Maryse Lebreton,43,234523,2022-09-08
TRANSFER,22523,Maryse Lebreton,234523,212000,Susan de Fontaine,157768,135245,2022-09-09
CASH_IN,252121,Agence_moov_Ouidah,300000,47879,Maryse Lebreton,212000,464121,2022-09-09
TRANSFER,241826,Maryse Lebreton,464121,222295,Diane-Françoise Raynaud,850961,609135,2022-09-10
CASH_OUT,91227,Maryse Lebreton,222295,131068,Agence_moov_Cotonou,300000,208773,2022-09-11
CASH_OUT,35161,Maryse Lebreton,131068,95907,Agence_moov_Abomey,300000,264839,2022-09-11
CASH_IN,138904,Agence_moov_Cotonou,300000,161096,Maryse Lebreton,95907,234811,2022-09-12
CASH_IN,9617,Agence_moov_Abomey,300000,290383,Maryse Lebreton,234811,244428,2022-09-13
TRANSFER,155180,Maryse Lebreton,244428,89248,Frédérique Robin,2390,-152790,2022-09-15
CASH_IN,130857,Agence_moov_Ouidah,300000,169143,Maryse Lebreton,89248,220105,2022-09-15
CASH_IN,39352,Agence_moov_Ouidah,300000,260648,Maryse Lebreton,220105,259457,2022-09-16
CASH_IN,53228,Agence_moov_Abomey,300000,246772,Maryse Lebreton,259457,312685,2022-09-18
CASH_IN,87050,Agence_moov_Ouidah,300000,212950,Maryse Lebreton,312685,399735,2022-09-18
TRANSFER,192994,Maryse Lebreton,399735,206741,Vincent-Grégoire Brunet,202,-192792,2022-09-18
CASH_OUT,33643,Maryse Lebreton,206741,173098,Agence_moov_Abomey,300000,266357,2022-09-19
CASH_IN,159138,Agence_moov_Ouidah,300000,140862,Maryse Lebreton,173098,332236,2022-09-20
CASH_IN,127911,Agence_moov_Ouidah,300000,172089,Maryse Lebreton,332236,460147,2022-09-20
CASH_IN,269115,Agence_moov_Abomey,300000,30885,Maryse Lebreton,460147,729262,2022-09-23
TRANSFER,28736,Xavier-Stéphane Ollivier,41537,12801,Maryse Lebreton,729262,757998,2022-09-27
CASH_OUT,202015,Maryse Lebreton,757998,555983,Agence_moov_Cotonou,300000,97985,2022-09-27
CASH_IN,292785,Agence_moov_Abomey,300000,7215,Frédéric Moreau,-28909,263876,2022-09-04
CASH_OUT,95641,Frédéric Moreau,263876,168235,Agence_moov_Abomey,300000,204359,2022-09-04
CASH_OUT,101717,Frédéric Moreau,168235,66518,Agence_moov_Abomey,300000,198283,2022-09-07
CASH_IN,120730,Agence_moov_Ouidah,300000,179270,Frédéric Moreau,66518,187248,2022-09-08
CASH_IN,67537,Agence_moov_Abomey,300000,232463,Frédéric Moreau,187248,254785,2022-09-09
CASH_IN,17472,Agence_moov_Ouidah,300000,282528,Frédéric Moreau,254785,272257,2022-09-13
CASH_IN,8028,Agence_moov_Ouidah,300000,291972,Frédéric Moreau,272257,280285,2022-09-15
CASH_OUT,236884,Frédéric Moreau,280285,43401,Agence_moov_Cotonou,300000,63116,2022-09-17
TRANSFER,102195,Stéphane-Timothée Pineau,278301,176106,Frédéric Moreau,43401,145596,2022-09-18
CASH_OUT,1856,Grégoire Delmas de Blanchard,3300,1444,Agence_moov_Cotonou,300000,298144,2022-09-10
CASH_OUT,940,Grégoire Delmas de Blanchard,1444,504,Agence_moov_Abomey,300000,299060,2022-09-16
CASH_OUT,427,Grégoire Delmas de Blanchard,504,77,Agence_moov_Ouidah,300000,299573,2022-09-20
CASH_IN,25877,Agence_moov_Cotonou,300000,274123,Grégoire Delmas de Blanchard,77,25954,2022-09-21
CASH_IN,298367,Agence_moov_Ouidah,300000,1633,Grégoire Delmas de Blanchard,25954,324321,2022-09-22
CASH_IN,184229,Agence_moov_Ouidah,300000,115771,Grégoire Delmas de Blanchard,324321,508550,2022-09-24
CASH_IN,42205,Agence_moov_Abomey,300000,257795,Antoine Bourdon de Auger,-614093,-571888,2022-09-12
CASH_IN,281581,Agence_moov_Cotonou,300000,18419,Antoine Bourdon de Auger,-571888,-290307,2022-09-12
CASH_IN,126232,Agence_moov_Cotonou,300000,173768,Antoine Bourdon de Auger,-290307,-164075,2022-09-13
CASH_IN,91568,Agence_moov_Cotonou,300000,208432,Antoine Bourdon de Auger,-164075,-72507,2022-09-14
CASH_IN,204299,Agence_moov_Cotonou,300000,95701,Antoine Bourdon de Auger,-72507,131792,2022-09-15
CASH_OUT,98448,Antoine Bourdon de Auger,131792,33344,Agence_moov_Ouidah,300000,201552,2022-09-16
CASH_OUT,6460,Antoine Bourdon de Auger,33344,26884,Agence_moov_Cotonou,300000,293540,2022-09-25
CASH_IN,62880,Agence_moov_Abomey,300000,237120,Paul De Sousa,-1205759,-1142879,2022-09-01
CASH_IN,59395,Agence_moov_Cotonou,300000,240605,Paul De Sousa,-1142879,-1083484,2022-09-01
CASH_IN,3917,Agence_moov_Abomey,300000,296083,Paul De Sousa,-1083484,-1079567,2022-09-01
CASH_IN,84297,Agence_moov_Ouidah,300000,215703,Paul De Sousa,-1079567,-995270,2022-09-02
CASH_IN,138216,Agence_moov_Cotonou,300000,161784,Paul De Sousa,-995270,-857054,2022-09-03
CASH_IN,206008,Agence_moov_Cotonou,300000,93992,Paul De Sousa,-857054,-651046,2022-09-04
CASH_IN,98455,Agence_moov_Abomey,300000,201545,Paul De Sousa,-651046,-552591,2022-09-06
CASH_IN,71738,Agence_moov_Abomey,300000,228262,Paul De Sousa,-552591,-480853,2022-09-08
CASH_IN,185918,Agence_moov_Ouidah,300000,114082,Paul De Sousa,-480853,-294935,2022-09-09
CASH_IN,55995,Agence_moov_Cotonou,300000,244005,Paul De Sousa,-294935,-238940,2022-09-11
CASH_IN,145821,Agence_moov_Cotonou,300000,154179,Paul De Sousa,-238940,-93119,2022-09-13
CASH_IN,55861,Agence_moov_Abomey,300000,244139,Paul De Sousa,-93119,-37258,2022-09-13
CASH_IN,168021,Agence_moov_Ouidah,300000,131979,Paul De Sousa,-37258,130763,2022-09-14
TRANSFER,270696,Gabriel de Pineau,449349,178653,Paul De Sousa,130763,401459,2022-09-15
CASH_OUT,8764,Paul De Sousa,401459,392695,Agence_moov_Ouidah,300000,291236,2022-09-16
CASH_IN,174811,Agence_moov_Ouidah,300000,125189,Paul De Sousa,392695,567506,2022-09-23
CASH_IN,299654,Agence_moov_Ouidah,300000,346,Paul De Sousa,567506,867160,2022-09-23
CASH_OUT,38078,Paul De Sousa,867160,829082,Agence_moov_Abomey,300000,261922,2022-09-24
CASH_IN,11747,Agence_moov_Abomey,300000,288253,Roland Colin,-23029,-11282,2022-09-01
CASH_IN,159903,Agence_moov_Cotonou,300000,140097,Roland Colin,-11282,148621,2022-09-05
CASH_OUT,63199,Roland Colin,148621,85422,Agence_moov_Cotonou,300000,236801,2022-09-06
TRANSFER,26330,Roland Colin,85422,59092,Emmanuelle Gilbert,76082,49752,2022-09-08
TRANSFER,44159,Roland Colin,59092,14933,Gabriel de Pineau,178653,134494,2022-09-12
CASH_IN,255894,Agence_moov_Abomey,300000,44106,Roland Colin,14933,270827,2022-09-14
CASH_OUT,183326,Roland Colin,270827,87501,Agence_moov_Ouidah,300000,116674,2022-09-24
TRANSFER,11232,Roland Colin,87501,76269,Diane-Françoise Raynaud,609135,597903,2022-09-25
TRANSFER,592943,Joséphine Weber du Bonnin,926088,333145,Roland Colin,76269,669212,2022-09-26
CASH_IN,204853,Agence_moov_Abomey,300000,95147,Marc Gilbert,11244,216097,2022-09-01
TRANSFER,215548,Marc Gilbert,216097,549,Benoît Verdier,633117,417569,2022-09-03
TRANSFER,307342,Lucy Vaillant,752139,444797,Marc Gilbert,549,307891,2022-09-03
CASH_IN,171037,Agence_moov_Ouidah,300000,128963,Marc Gilbert,307891,478928,2022-09-04
CASH_OUT,196076,Marc Gilbert,478928,282852,Agence_moov_Cotonou,300000,103924,2022-09-05
TRANSFER,203545,Marc Gilbert,282852,79307,Margot Renaud de Lacombe,75404,-128141,2022-09-06
CASH_IN,238874,Agence_moov_Abomey,300000,61126,Marc Gilbert,79307,318181,2022-09-08
CASH_IN,294941,Agence_moov_Abomey,300000,5059,Marc Gilbert,318181,613122,2022-09-12
TRANSFER,84553,Marc Gilbert,613122,528569,Joséphine Weber du Bonnin,333145,248592,2022-09-13
CASH_OUT,2932,Marc Gilbert,528569,525637,Agence_moov_Cotonou,300000,297068,2022-09-14
CASH_IN,235630,Agence_moov_Cotonou,300000,64370,Marc Gilbert,525637,761267,2022-09-14
CASH_OUT,613735,Marc Gilbert,761267,147532,Agence_moov_Cotonou,300000,-313735,2022-09-15
CASH_OUT,38839,Marc Gilbert,147532,108693,Agence_moov_Abomey,300000,261161,2022-09-16
TRANSFER,684463,Auguste Bousquet,743379,58916,Marc Gilbert,108693,793156,2022-09-20
CASH_IN,140399,Agence_moov_Ouidah,300000,159601,Marc Gilbert,793156,933555,2022-09-21
CASH_OUT,912128,Marc Gilbert,933555,21427,Agence_moov_Cotonou,300000,-612128,2022-09-22
CASH_OUT,16099,Marc Gilbert,21427,5328,Agence_moov_Abomey,300000,283901,2022-09-23
CASH_OUT,454,Marc Gilbert,5328,4874,Agence_moov_Cotonou,300000,299546,2022-09-26
CASH_OUT,2662,Marc Gilbert,4874,2212,Agence_moov_Ouidah,300000,297338,2022-09-27
CASH_OUT,56957,Auguste Bousquet,58916,1959,Agence_moov_Cotonou,300000,243043,2022-09-10
CASH_IN,287613,Agence_moov_Ouidah,300000,12387,Auguste Bousquet,1959,289572,2022-09-16
CASH_IN,284514,Agence_moov_Abomey,300000,15486,Auguste Bousquet,289572,574086,2022-09-17
CASH_OUT,48495,Auguste Bousquet,574086,525591,Agence_moov_Abomey,300000,251505,2022-09-23
TRANSFER,80088,Sabine Imbert,255373,175285,Auguste Bousquet,525591,605679,2022-09-24
TRANSFER,503538,Auguste Bousquet,605679,102141,Nicolas Hervé,206084,-297454,2022-09-24
CASH_OUT,95754,Auguste Bousquet,102141,6387,Agence_moov_Ouidah,300000,204246,2022-09-26
CASH_IN,256999,Agence_moov_Ouidah,300000,43001,Isaac Le Pinto,-5771,251228,2022-09-03
CASH_OUT,7755,Isaac Le Pinto,251228,243473,Agence_moov_Ouidah,300000,292245,2022-09-05
TRANSFER,235244,Isaac Le Pinto,243473,8229,Diane-Françoise Raynaud,597903,362659,2022-09-08
TRANSFER,419036,Laurence Carlier,1202975,783939,Isaac Le Pinto,8229,427265,2022-09-09
CASH_IN,243513,Agence_moov_Cotonou,300000,56487,Isaac Le Pinto,427265,670778,2022-09-12
TRANSFER,565503,Isaac Le Pinto,670778,105275,Bernadette Fabre,24136,-541367,2022-09-15
CASH_OUT,7229,Isaac Le Pinto,105275,98046,Agence_moov_Cotonou,300000,292771,2022-09-18
TRANSFER,94725,Isaac Le Pinto,98046,3321,Joséphine Weber du Bonnin,248592,153867,2022-09-20
CASH_OUT,2650,Isaac Le Pinto,3321,671,Agence_moov_Cotonou,300000,297350,2022-09-24
CASH_IN,197101,Agence_moov_Cotonou,300000,102899,Isaac Le Pinto,671,197772,2022-09-26
CASH_IN,133157,Agence_moov_Abomey,300000,166843,Julie Robin de Gros,-329676,-196519,2022-09-01
CASH_IN,159352,Agence_moov_Ouidah,300000,140648,Julie Robin de Gros,-196519,-37167,2022-09-01
CASH_IN,270016,Agence_moov_Abomey,300000,29984,Julie Robin de Gros,-37167,232849,2022-09-01
CASH_IN,52225,Agence_moov_Cotonou,300000,247775,Julie Robin de Gros,232849,285074,2022-09-02
TRANSFER,159695,Julie Robin de Gros,285074,125379,Alfred Chrétien,356670,196975,2022-09-04
CASH_OUT,86572,Julie Robin de Gros,125379,38807,Agence_moov_Cotonou,300000,213428,2022-09-05
TRANSFER,123681,Sabine Imbert,175285,51604,Julie Robin de Gros,38807,162488,2022-09-11
TRANSFER,386968,Lucy Vaillant,444797,57829,Julie Robin de Gros,162488,549456,2022-09-11
TRANSFER,76161,Julie Robin de Gros,549456,473295,Benoît Verdier,417569,341408,2022-09-11
CASH_IN,88993,Agence_moov_Ouidah,300000,211007,Julie Robin de Gros,473295,562288,2022-09-12
TRANSFER,98588,Gabriel de Pineau,134494,35906,Julie Robin de Gros,562288,660876,2022-09-13
CASH_IN,28997,Agence_moov_Ouidah,300000,271003,Julie Robin de Gros,660876,689873,2022-09-13
CASH_OUT,566596,Julie Robin de Gros,689873,123277,Agence_moov_Cotonou,300000,-266596,2022-09-14
TRANSFER,90435,Julie Robin de Gros,123277,32842,Sabine Imbert,51604,-38831,2022-09-18
TRANSFER,28752,Julie Robin de Gros,32842,4090,Alphonse Dupont-Petit,34957,6205,2022-09-18
TRANSFER,224654,Laurence Carlier,783939,559285,Julie Robin de Gros,4090,228744,2022-09-19
TRANSFER,311734,Emmanuel-René Coulon,331727,19993,Julie Robin de Gros,228744,540478,2022-09-23
TRANSFER,278103,Julie Robin de Gros,540478,262375,Alphonse Dupont-Petit,6205,-271898,2022-09-24
TRANSFER,1697,Julie Robin de Gros,262375,260678,Josette Guillon-Leclercq,814584,812887,2022-09-27
CASH_IN,253709,Agence_moov_Cotonou,300000,46291,Julie Robin de Gros,260678,514387,2022-09-27
CASH_OUT,557484,Marie Da Silva,938303,380819,Agence_moov_Cotonou,300000,-257484,2022-09-01
CASH_IN,67469,Agence_moov_Ouidah,300000,232531,Marie Da Silva,380819,448288,2022-09-04
TRANSFER,16363,Emmanuelle Gilbert,49752,33389,Marie Da Silva,448288,464651,2022-09-12
TRANSFER,359827,Marie Da Silva,464651,104824,Susan de Fontaine,135245,-224582,2022-09-14
CASH_IN,100435,Agence_moov_Abomey,300000,199565,Marie Da Silva,104824,205259,2022-09-16
CASH_IN,173751,Agence_moov_Abomey,300000,126249,Marie Da Silva,205259,379010,2022-09-20
CASH_IN,83040,Agence_moov_Cotonou,300000,216960,Marie Da Silva,379010,462050,2022-09-23
CASH_OUT,332908,Marie Da Silva,462050,129142,Agence_moov_Cotonou,300000,-32908,2022-09-25
CASH_OUT,63481,Marie Da Silva,129142,65661,Agence_moov_Ouidah,300000,236519,2022-09-26
CASH_IN,209561,Agence_moov_Abomey,300000,90439,Vincent-Philippe Rossi,-367533,-157972,2022-09-05
CASH_IN,264799,Agence_moov_Cotonou,300000,35201,Vincent-Philippe Rossi,-157972,106827,2022-09-07
TRANSFER,115897,Benoît Verdier,341408,225511,Vincent-Philippe Rossi,106827,222724,2022-09-09
CASH_OUT,33670,Vincent-Philippe Rossi,222724,189054,Agence_moov_Abomey,300000,266330,2022-09-10
CASH_IN,31088,Agence_moov_Cotonou,300000,268912,Vincent-Philippe Rossi,189054,220142,2022-09-10
CASH_IN,279530,Agence_moov_Cotonou,300000,20470,Vincent-Philippe Rossi,220142,499672,2022-09-14
CASH_OUT,125566,Vincent-Philippe Rossi,499672,374106,Agence_moov_Cotonou,300000,174434,2022-09-17
CASH_IN,212944,Agence_moov_Cotonou,300000,87056,Vincent-Philippe Rossi,374106,587050,2022-09-18
TRANSFER,14495,Emmanuel-René Coulon,19993,5498,Vincent-Philippe Rossi,587050,601545,2022-09-19
CASH_IN,24127,Agence_moov_Ouidah,300000,275873,Vincent-Philippe Rossi,601545,625672,2022-09-23
TRANSFER,521157,Vincent-Philippe Rossi,625672,104515,Emmanuelle Gilbert,33389,-487768,2022-09-24
TRANSFER,184117,Benoît Verdier,225511,41394,Vincent-Philippe Rossi,104515,288632,2022-09-26
CASH_IN,104225,Agence_moov_Cotonou,300000,195775,Vincent-Philippe Rossi,288632,392857,2022-09-26
CASH_IN,89103,Agence_moov_Cotonou,300000,210897,Vincent-Philippe Rossi,392857,481960,2022-09-27
CASH_IN,226570,Agence_moov_Cotonou,300000,73430,Vincent-Philippe Rossi,481960,708530,2022-09-27
CASH_IN,88087,Agence_moov_Abomey,300000,211913,Emmanuelle Gilbert,-487768,-399681,2022-09-01
CASH_IN,218360,Agence_moov_Cotonou,300000,81640,Emmanuelle Gilbert,-399681,-181321,2022-09-01
CASH_IN,74912,Agence_moov_Ouidah,300000,225088,Emmanuelle Gilbert,-181321,-106409,2022-09-02
CASH_IN,194359,Agence_moov_Cotonou,300000,105641,Emmanuelle Gilbert,-106409,87950,2022-09-09
TRANSFER,22910,Joséphine Weber du Bonnin,153867,130957,Emmanuelle Gilbert,87950,110860,2022-09-20
TRANSFER,368668,Laurence Carlier,559285,190617,Emmanuelle Gilbert,110860,479528,2022-09-21
CASH_IN,228745,Agence_moov_Ouidah,300000,71255,Susan de Fontaine,-224582,4163,2022-09-08
CASH_IN,262361,Agence_moov_Abomey,300000,37639,Susan de Fontaine,4163,266524,2022-09-08
TRANSFER,149079,Susan de Fontaine,266524,117445,Stéphane-Timothée Pineau,176106,27027,2022-09-09
CASH_OUT,61054,Susan de Fontaine,117445,56391,Agence_moov_Ouidah,300000,238946,2022-09-12
TRANSFER,19557,Susan de Fontaine,56391,36834,Laurence Carlier,190617,171060,2022-09-19
TRANSFER,27502,Susan de Fontaine,36834,9332,Benoît Verdier,41394,13892,2022-09-27
CASH_IN,181383,Agence_moov_Abomey,300000,118617,Richard Guibert,-118169,63214,2022-09-03
TRANSFER,893682,Léon Paris,894500,818,Richard Guibert,63214,956896,2022-09-06
CASH_IN,190694,Agence_moov_Cotonou,300000,109306,Richard Guibert,956896,1147590,2022-09-06
CASH_IN,117895,Agence_moov_Cotonou,300000,182105,Richard Guibert,1147590,1265485,2022-09-09
TRANSFER,1102121,Richard Guibert,1265485,163364,Marthe Pichon,413850,-688271,2022-09-13
CASH_OUT,26726,Richard Guibert,163364,136638,Agence_moov_Ouidah,300000,273274,2022-09-14
TRANSFER,4818,Benoît Verdier,13892,9074,Richard Guibert,136638,141456,2022-09-17
CASH_OUT,4368,Richard Guibert,141456,137088,Agence_moov_Ouidah,300000,295632,2022-09-17
CASH_OUT,86962,Richard Guibert,137088,50126,Agence_moov_Abomey,300000,213038,2022-09-21
CASH_IN,38113,Agence_moov_Ouidah,300000,261887,Nicolas Grondin de la Pinto,-429790,-391677,2022-09-01
CASH_IN,291669,Agence_moov_Cotonou,300000,8331,Nicolas Grondin de la Pinto,-391677,-100008,2022-09-02
CASH_IN,12495,Agence_moov_Ouidah,300000,287505,Nicolas Grondin de la Pinto,-100008,-87513,2022-09-04
CASH_IN,115587,Agence_moov_Ouidah,300000,184413,Nicolas Grondin de la Pinto,-87513,28074,2022-09-04
CASH_IN,245508,Agence_moov_Cotonou,300000,54492,Nicolas Grondin de la Pinto,28074,273582,2022-09-07
CASH_OUT,123896,Nicolas Grondin de la Pinto,273582,149686,Agence_moov_Abomey,300000,176104,2022-09-08
CASH_OUT,106671,Nicolas Grondin de la Pinto,149686,43015,Agence_moov_Cotonou,300000,193329,2022-09-08
CASH_IN,237653,Agence_moov_Abomey,300000,62347,Nicolas Grondin de la Pinto,43015,280668,2022-09-08
CASH_OUT,226647,Nicolas Grondin de la Pinto,280668,54021,Agence_moov_Abomey,300000,73353,2022-09-10
CASH_OUT,53279,Nicolas Grondin de la Pinto,54021,742,Agence_moov_Ouidah,300000,246721,2022-09-11
CASH_IN,111086,Agence_moov_Cotonou,300000,188914,Nicolas Grondin de la Pinto,742,111828,2022-09-16
CASH_IN,43595,Agence_moov_Ouidah,300000,256405,Nicolas Grondin de la Pinto,111828,155423,2022-09-16
CASH_OUT,116583,Nicolas Grondin de la Pinto,155423,38840,Agence_moov_Abomey,300000,183417,2022-09-16
CASH_IN,228435,Agence_moov_Abomey,300000,71565,Nicolas Grondin de la Pinto,38840,267275,2022-09-16
CASH_OUT,3039,Nicolas Grondin de la Pinto,267275,264236,Agence_moov_Ouidah,300000,296961,2022-09-19
CASH_IN,147299,Agence_moov_Ouidah,300000,152701,Nicolas Grondin de la Pinto,264236,411535,2022-09-20
CASH_IN,214183,Agence_moov_Ouidah,300000,85817,Nicolas Grondin de la Pinto,411535,625718,2022-09-21
CASH_OUT,266778,Nicolas Grondin de la Pinto,625718,358940,Agence_moov_Cotonou,300000,33222,2022-09-21
TRANSFER,241753,Nicolas Grondin de la Pinto,358940,117187,Lucy Vaillant,57829,-183924,2022-09-22
CASH_IN,169074,Agence_moov_Ouidah,300000,130926,Nicolas Grondin de la Pinto,117187,286261,2022-09-25
CASH_IN,62060,Agence_moov_Ouidah,300000,237940,Joseph de la Dubois,-155339,-93279,2022-09-02
CASH_IN,48993,Agence_moov_Ouidah,300000,251007,Joseph de la Dubois,-93279,-44286,2022-09-03
CASH_IN,289405,Agence_moov_Ouidah,300000,10595,Joseph de la Dubois,-44286,245119,2022-09-07
TRANSFER,186821,Joseph de la Dubois,245119,58298,Emmanuel-René Coulon,5498,-181323,2022-09-08
CASH_IN,73623,Agence_moov_Cotonou,300000,226377,Joseph de la Dubois,58298,131921,2022-09-10
CASH_IN,155650,Agence_moov_Abomey,300000,144350,Joseph de la Dubois,131921,287571,2022-09-10
TRANSFER,4248,Joseph de la Dubois,287571,283323,Benoît Verdier,9074,4826,2022-09-10
TRANSFER,9427,Stéphane-Timothée Pineau,27027,17600,Joseph de la Dubois,283323,292750,2022-09-11
TRANSFER,111552,Joseph de la Dubois,292750,181198,Alfred Chrétien,196975,85423,2022-09-12
CASH_OUT,125715,Joseph de la Dubois,181198,55483,Agence_moov_Ouidah,300000,174285,2022-09-13
TRANSFER,10125,Xavier-Stéphane Ollivier,12801,2676,Joseph de la Dubois,55483,65608,2022-09-18
CASH_IN,193131,Agence_moov_Ouidah,300000,106869,Joseph de la Dubois,65608,258739,2022-09-20
CASH_IN,179808,Agence_moov_Ouidah,300000,120192,Joseph de la Dubois,258739,438547,2022-09-21
CASH_IN,213685,Agence_moov_Ouidah,300000,86315,Joseph de la Dubois,438547,652232,2022-09-24
CASH_IN,182762,Agence_moov_Cotonou,300000,117238,Joseph de la Dubois,652232,834994,2022-09-24
CASH_IN,181685,Agence_moov_Ouidah,300000,118315,Paulette Dias,-11548,170137,2022-09-05
CASH_IN,171331,Agence_moov_Abomey,300000,128669,Paulette Dias,170137,341468,2022-09-05
CASH_OUT,62717,Paulette Dias,341468,278751,Agence_moov_Cotonou,300000,237283,2022-09-07
CASH_IN,176871,Agence_moov_Abomey,300000,123129,Paulette Dias,278751,455622,2022-09-13
CASH_OUT,354701,Paulette Dias,455622,100921,Agence_moov_Cotonou,300000,-54701,2022-09-14
CASH_OUT,67399,Paulette Dias,100921,33522,Agence_moov_Abomey,300000,232601,2022-09-15
CASH_OUT,11696,Paulette Dias,33522,21826,Agence_moov_Ouidah,300000,288304,2022-09-21
CASH_OUT,15795,Paulette Dias,21826,6031,Agence_moov_Cotonou,300000,284205,2022-09-25
CASH_IN,102181,Agence_moov_Cotonou,300000,197819,Paulette Dias,6031,108212,2022-09-26
CASH_IN,202138,Agence_moov_Abomey,300000,97862,Bernadette Fabre,-541367,-339229,2022-09-05
CASH_IN,189821,Agence_moov_Ouidah,300000,110179,Bernadette Fabre,-339229,-149408,2022-09-06
CASH_IN,25740,Agence_moov_Cotonou,300000,274260,Bernadette Fabre,-149408,-123668,2022-09-07
CASH_IN,234336,Agence_moov_Cotonou,300000,65664,Bernadette Fabre,-123668,110668,2022-09-07
TRANSFER,13972,Alfred Chrétien,85423,71451,Bernadette Fabre,110668,124640,2022-09-08
CASH_IN,193033,Agence_moov_Ouidah,300000,106967,Bernadette Fabre,124640,317673,2022-09-11
TRANSFER,203548,Bernadette Fabre,317673,114125,Diane-Françoise Raynaud,362659,159111,2022-09-11
TRANSFER,28576,Joséphine Weber du Bonnin,130957,102381,Bernadette Fabre,114125,142701,2022-09-13
CASH_IN,237624,Agence_moov_Abomey,300000,62376,Bernadette Fabre,142701,380325,2022-09-14
CASH_OUT,129882,Bernadette Fabre,380325,250443,Agence_moov_Abomey,300000,170118,2022-09-14
CASH_OUT,41278,Bernadette Fabre,250443,209165,Agence_moov_Ouidah,300000,258722,2022-09-15
TRANSFER,9836,Bernadette Fabre,209165,199329,Xavier-Stéphane Ollivier,2676,-7160,2022-09-17
CASH_OUT,71764,Bernadette Fabre,199329,127565,Agence_moov_Abomey,300000,228236,2022-09-18
CASH_OUT,34028,Bernadette Fabre,127565,93537,Agence_moov_Abomey,300000,265972,2022-09-19
TRANSFER,52917,Joséphine Weber du Bonnin,102381,49464,Bernadette Fabre,93537,146454,2022-09-24
CASH_IN,255352,Agence_moov_Cotonou,300000,44648,Alfred Chrétien,71451,326803,2022-09-04
CASH_OUT,152220,Alfred Chrétien,326803,174583,Agence_moov_Cotonou,300000,147780,2022-09-06
CASH_OUT,41245,Alfred Chrétien,174583,133338,Agence_moov_Cotonou,300000,258755,2022-09-08
TRANSFER,937,Alfred Chrétien,133338,132401,Laurence Carlier,171060,170123,2022-09-08
TRANSFER,1029,Alfred Chrétien,132401,131372,Stéphane-Timothée Pineau,17600,16571,2022-09-13
CASH_IN,281309,Agence_moov_Abomey,300000,18691,Alfred Chrétien,131372,412681,2022-09-16
CASH_OUT,87139,Alfred Chrétien,412681,325542,Agence_moov_Ouidah,300000,212861,2022-09-16
TRANSFER,193368,Alfred Chrétien,325542,132174,Gabriel de Pineau,35906,-157462,2022-09-16
TRANSFER,641,Léon Paris,818,177,Alfred Chrétien,132174,132815,2022-09-18
CASH_IN,63030,Agence_moov_Cotonou,300000,236970,Alfred Chrétien,132815,195845,2022-09-22
CASH_OUT,15414,Alfred Chrétien,195845,180431,Agence_moov_Abomey,300000,284586,2022-09-25
TRANSFER,48732,Joséphine Weber du Bonnin,49464,732,Alfred Chrétien,180431,229163,2022-09-26
CASH_IN,130241,Agence_moov_Cotonou,300000,169759,Emmanuel-René Coulon,-181323,-51082,2022-09-03
CASH_IN,194175,Agence_moov_Cotonou,300000,105825,Emmanuel-René Coulon,-51082,143093,2022-09-03
CASH_IN,100623,Agence_moov_Ouidah,300000,199377,Emmanuel-René Coulon,143093,243716,2022-09-03
TRANSFER,94249,Emmanuel-René Coulon,243716,149467,Léon Paris,177,-94072,2022-09-10
CASH_IN,223117,Agence_moov_Abomey,300000,76883,Emmanuel-René Coulon,149467,372584,2022-09-15
CASH_IN,99147,Agence_moov_Cotonou,300000,200853,Emmanuel-René Coulon,372584,471731,2022-09-17
CASH_OUT,163981,Emmanuel-René Coulon,471731,307750,Agence_moov_Abomey,300000,136019,2022-09-18
TRANSFER,499,Joséphine Weber du Bonnin,732,233,Emmanuel-René Coulon,307750,308249,2022-09-20
CASH_IN,227071,Agence_moov_Ouidah,300000,72929,Emmanuel-René Coulon,308249,535320,2022-09-21
CASH_IN,105192,Agence_moov_Abomey,300000,194808,Emmanuel-René Coulon,535320,640512,2022-09-22
TRANSFER,116922,Emmanuel-René Coulon,640512,523590,Joséphine Weber du Bonnin,233,-116689,2022-09-26
TRANSFER,41590,Diane-Françoise Raynaud,159111,117521,Emmanuel-René Coulon,523590,565180,2022-09-26
CASH_IN,244365,Agence_moov_Cotonou,300000,55635,Gabriel de Pineau,-157462,86903,2022-09-01
CASH_IN,283348,Agence_moov_Abomey,300000,16652,Gabriel de Pineau,86903,370251,2022-09-04
CASH_IN,180688,Agence_moov_Cotonou,300000,119312,Gabriel de Pineau,370251,550939,2022-09-08
CASH_IN,52105,Agence_moov_Abomey,300000,247895,Gabriel de Pineau,550939,603044,2022-09-11
CASH_IN,293098,Agence_moov_Ouidah,300000,6902,Gabriel de Pineau,603044,896142,2022-09-11
CASH_OUT,544231,Gabriel de Pineau,896142,351911,Agence_moov_Cotonou,300000,-244231,2022-09-18
CASH_OUT,345138,Gabriel de Pineau,351911,6773,Agence_moov_Abomey,300000,-45138,2022-09-27
CASH_IN,79589,Agence_moov_Abomey,300000,220411,Xavier-Stéphane Ollivier,-7160,72429,2022-09-01
TRANSFER,27968,Xavier-Stéphane Ollivier,72429,44461,Stéphane-Timothée Pineau,16571,-11397,2022-09-04
CASH_IN,162436,Agence_moov_Abomey,300000,137564,Xavier-Stéphane Ollivier,44461,206897,2022-09-06
CASH_IN,277155,Agence_moov_Cotonou,300000,22845,Xavier-Stéphane Ollivier,206897,484052,2022-09-08
CASH_IN,4675,Agence_moov_Ouidah,300000,295325,Xavier-Stéphane Ollivier,484052,488727,2022-09-09
CASH_OUT,355868,Xavier-Stéphane Ollivier,488727,132859,Agence_moov_Cotonou,300000,-55868,2022-09-12
CASH_IN,202061,Agence_moov_Cotonou,300000,97939,Xavier-Stéphane Ollivier,132859,334920,2022-09-12
TRANSFER,178305,Xavier-Stéphane Ollivier,334920,156615,Benoît Verdier,4826,-173479,2022-09-15
CASH_IN,205865,Agence_moov_Cotonou,300000,94135,Xavier-Stéphane Ollivier,156615,362480,2022-09-15
TRANSFER,14933,Diane-Françoise Raynaud,117521,102588,Xavier-Stéphane Ollivier,362480,377413,2022-09-18
TRANSFER,22761,Diane-Françoise Raynaud,102588,79827,Xavier-Stéphane Ollivier,377413,400174,2022-09-21
TRANSFER,406308,Josette Guillon-Leclercq,812887,406579,Xavier-Stéphane Ollivier,400174,806482,2022-09-23
CASH_IN,257719,Agence_moov_Cotonou,300000,42281,Xavier-Stéphane Ollivier,806482,1064201,2022-09-24
CASH_IN,14911,Agence_moov_Ouidah,300000,285089,Marthe Pichon,-688271,-673360,2022-09-02
CASH_IN,37914,Agence_moov_Ouidah,300000,262086,Marthe Pichon,-673360,-635446,2022-09-06
CASH_IN,269397,Agence_moov_Ouidah,300000,30603,Marthe Pichon,-635446,-366049,2022-09-08
CASH_IN,242984,Agence_moov_Abomey,300000,57016,Marthe Pichon,-366049,-123065,2022-09-11
CASH_IN,142152,Agence_moov_Abomey,300000,157848,Marthe Pichon,-123065,19087,2022-09-11
TRANSFER,2725,Marthe Pichon,19087,16362,Diane-Françoise Raynaud,79827,77102,2022-09-12
CASH_IN,123758,Agence_moov_Abomey,300000,176242,Marthe Pichon,16362,140120,2022-09-12
CASH_OUT,70302,Marthe Pichon,140120,69818,Agence_moov_Cotonou,300000,229698,2022-09-13
CASH_IN,238785,Agence_moov_Abomey,300000,61215,Marthe Pichon,69818,308603,2022-09-16
CASH_OUT,265838,Marthe Pichon,308603,42765,Agence_moov_Ouidah,300000,34162,2022-09-17
CASH_OUT,12183,Marthe Pichon,42765,30582,Agence_moov_Ouidah,300000,287817,2022-09-21
CASH_OUT,21642,Marthe Pichon,30582,8940,Agence_moov_Ouidah,300000,278358,2022-09-21
CASH_OUT,113,Marthe Pichon,8940,8827,Agence_moov_Cotonou,300000,299887,2022-09-23
CASH_IN,72429,Agence_moov_Abomey,300000,227571,Marthe Pichon,8827,81256,2022-09-24
CASH_OUT,22251,Marthe Pichon,81256,59005,Agence_moov_Cotonou,300000,277749,2022-09-24
CASH_IN,166058,Agence_moov_Cotonou,300000,133942,Alphonse Dupont-Petit,-271898,-105840,2022-09-05
CASH_IN,5550,Agence_moov_Abomey,300000,294450,Alphonse Dupont-Petit,-105840,-100290,2022-09-06
CASH_IN,51455,Agence_moov_Abomey,300000,248545,Alphonse Dupont-Petit,-100290,-48835,2022-09-07
CASH_IN,1022,Agence_moov_Cotonou,300000,298978,Alphonse Dupont-Petit,-48835,-47813,2022-09-10
CASH_IN,154269,Agence_moov_Abomey,300000,145731,Alphonse Dupont-Petit,-47813,106456,2022-09-14
CASH_OUT,98062,Alphonse Dupont-Petit,106456,8394,Agence_moov_Cotonou,300000,201938,2022-09-15
TRANSFER,5461,Alphonse Dupont-Petit,8394,2933,Diane-Françoise Raynaud,77102,71641,2022-09-18
CASH_IN,6055,Agence_moov_Cotonou,300000,293945,Alphonse Dupont-Petit,2933,8988,2022-09-19
TRANSFER,67421,Diane-Françoise Raynaud,71641,4220,Alphonse Dupont-Petit,8988,76409,2022-09-19
CASH_OUT,38051,Alphonse Dupont-Petit,76409,38358,Agence_moov_Ouidah,300000,261949,2022-09-22
CASH_IN,193105,Agence_moov_Cotonou,300000,106895,Nicolas Hervé,-297454,-104349,2022-09-05
CASH_IN,90875,Agence_moov_Ouidah,300000,209125,Nicolas Hervé,-104349,-13474,2022-09-13
CASH_IN,256884,Agence_moov_Ouidah,300000,43116,Nicolas Hervé,-13474,243410,2022-09-14
CASH_IN,269532,Agence_moov_Cotonou,300000,30468,Nicolas Hervé,243410,512942,2022-09-16
CASH_OUT,82351,Nicolas Hervé,512942,430591,Agence_moov_Ouidah,300000,217649,2022-09-17
CASH_IN,36632,Agence_moov_Cotonou,300000,263368,Nicolas Hervé,430591,467223,2022-09-18
CASH_IN,220017,Agence_moov_Abomey,300000,79983,Vincent-Grégoire Brunet,-192792,27225,2022-09-01
CASH_OUT,26741,Vincent-Grégoire Brunet,27225,484,Agence_moov_Cotonou,300000,273259,2022-09-06
CASH_OUT,311,Vincent-Grégoire Brunet,484,173,Agence_moov_Ouidah,300000,299689,2022-09-08
CASH_OUT,160,Vincent-Grégoire Brunet,173,13,Agence_moov_Abomey,300000,299840,2022-09-09
CASH_IN,33272,Agence_moov_Ouidah,300000,266728,Vincent-Grégoire Brunet,13,33285,2022-09-19
CASH_OUT,11465,Vincent-Grégoire Brunet,33285,21820,Agence_moov_Ouidah,300000,288535,2022-09-20
CASH_OUT,7249,Vincent-Grégoire Brunet,21820,14571,Agence_moov_Ouidah,300000,292751,2022-09-22
CASH_IN,173116,Agence_moov_Ouidah,300000,126884,Frédérique Robin,-152790,20326,2022-09-02
TRANSFER,13360,Frédérique Robin,20326,6966,Josette Guillon-Leclercq,406579,393219,2022-09-06
TRANSFER,2023,Frédérique Robin,6966,4943,Frédérique Robin,6966,4943,2022-09-13
CASH_IN,119811,Agence_moov_Abomey,300000,180189,Frédérique Robin,4943,124754,2022-09-13
TRANSFER,1820,Diane-Françoise Raynaud,4220,2400,Frédérique Robin,124754,126574,2022-09-13
TRANSFER,92266,Frédérique Robin,126574,34308,Frédérique Robin,126574,34308,2022-09-14
CASH_IN,59283,Agence_moov_Ouidah,300000,240717,Frédérique Robin,34308,93591,2022-09-14
CASH_IN,224375,Agence_moov_Abomey,300000,75625,Frédérique Robin,93591,317966,2022-09-16
CASH_OUT,165453,Frédérique Robin,317966,152513,Agence_moov_Cotonou,300000,134547,2022-09-21
TRANSFER,46972,Frédérique Robin,152513,105541,Josette Guillon-Leclercq,393219,346247,2022-09-23
CASH_IN,253015,Agence_moov_Abomey,300000,46985,Frédérique Robin,105541,358556,2022-09-23
CASH_OUT,103144,Frédérique Robin,358556,255412,Agence_moov_Abomey,300000,196856,2022-09-23
CASH_OUT,244803,Frédérique Robin,255412,10609,Agence_moov_Abomey,300000,55197,2022-09-25
CASH_OUT,792,Frédérique Robin,10609,9817,Agence_moov_Abomey,300000,299208,2022-09-25
CASH_IN,289770,Agence_moov_Cotonou,300000,10230,Paul Pereira,-41515,248255,2022-09-07
CASH_IN,224886,Agence_moov_Abomey,300000,75114,Paul Pereira,248255,473141,2022-09-15
CASH_OUT,418386,Paul Pereira,473141,54755,Agence_moov_Abomey,300000,-118386,2022-09-17
CASH_OUT,29625,Paul Pereira,54755,25130,Agence_moov_Ouidah,300000,270375,2022-09-19
CASH_IN,264268,Agence_moov_Cotonou,300000,35732,Paul Pereira,25130,289398,2022-09-20
CASH_IN,248132,Agence_moov_Abomey,300000,51868,Paul Pereira,289398,537530,2022-09-23
CASH_OUT,397895,Paul Pereira,537530,139635,Agence_moov_Abomey,300000,-97895,2022-09-24
CASH_IN,39564,Agence_moov_Ouidah,300000,260436,Nathalie-Chantal Jacques,-35162,4402,2022-09-04
TRANSFER,1040,Nathalie-Chantal Jacques,4402,3362,Diane-Françoise Raynaud,2400,1360,2022-09-07
TRANSFER,2841,Nathalie-Chantal Jacques,3362,521,Josette Guillon-Leclercq,346247,343406,2022-09-08
CASH_OUT,293,Nathalie-Chantal Jacques,521,228,Agence_moov_Abomey,300000,299707,2022-09-08
CASH_OUT,190,Nathalie-Chantal Jacques,228,38,Agence_moov_Ouidah,300000,299810,2022-09-12
CASH_IN,222207,Agence_moov_Cotonou,300000,77793,Nathalie-Chantal Jacques,38,222245,2022-09-27
CASH_IN,89678,Agence_moov_Ouidah,300000,210322,Guy Guyon,-544991,-455313,2022-09-02
CASH_IN,80583,Agence_moov_Ouidah,300000,219417,Guy Guyon,-455313,-374730,2022-09-02
CASH_IN,261218,Agence_moov_Cotonou,300000,38782,Guy Guyon,-374730,-113512,2022-09-04
CASH_IN,94212,Agence_moov_Ouidah,300000,205788,Guy Guyon,-113512,-19300,2022-09-05
CASH_IN,222528,Agence_moov_Abomey,300000,77472,Guy Guyon,-19300,203228,2022-09-06
CASH_OUT,110296,Guy Guyon,203228,92932,Agence_moov_Abomey,300000,189704,2022-09-12
TRANSFER,27361,Guy Guyon,92932,65571,Josette Guillon-Leclercq,343406,316045,2022-09-13
TRANSFER,61900,Guy Guyon,65571,3671,Josette Guillon-Leclercq,316045,254145,2022-09-14
CASH_IN,225284,Agence_moov_Ouidah,300000,74716,Guy Guyon,3671,228955,2022-09-14
CASH_IN,239139,Agence_moov_Cotonou,300000,60861,Guy Guyon,228955,468094,2022-09-14
CASH_OUT,296426,Guy Guyon,468094,171668,Agence_moov_Cotonou,300000,3574,2022-09-14
TRANSFER,155427,Josette Guillon-Leclercq,254145,98718,Guy Guyon,171668,327095,2022-09-17
TRANSFER,180444,Guy Guyon,327095,146651,Guy Guyon,327095,146651,2022-09-20
CASH_OUT,15651,Guy Guyon,146651,131000,Agence_moov_Ouidah,300000,284349,2022-09-20
CASH_OUT,89714,Guy Guyon,131000,41286,Agence_moov_Cotonou,300000,210286,2022-09-23
TRANSFER,3025,Guy Guyon,41286,38261,Josette Guillon-Leclercq,98718,95693,2022-09-24
CASH_OUT,15925,Guy Guyon,38261,22336,Agence_moov_Cotonou,300000,284075,2022-09-26
CASH_IN,86877,Agence_moov_Ouidah,300000,213123,Joséphine Weber du Bonnin,-116689,-29812,2022-09-03
CASH_IN,278549,Agence_moov_Ouidah,300000,21451,Joséphine Weber du Bonnin,-29812,248737,2022-09-05
TRANSFER,50190,Joséphine Weber du Bonnin,248737,198547,Josette Guillon-Leclercq,95693,45503,2022-09-08
TRANSFER,82082,Joséphine Weber du Bonnin,198547,116465,Joséphine Weber du Bonnin,198547,116465,2022-09-09
CASH_IN,92445,Agence_moov_Abomey,300000,207555,Joséphine Weber du Bonnin,116465,208910,2022-09-09
TRANSFER,35244,Josette Guillon-Leclercq,45503,10259,Joséphine Weber du Bonnin,208910,244154,2022-09-11
TRANSFER,189387,Joséphine Weber du Bonnin,244154,54767,Josette Guillon-Leclercq,10259,-179128,2022-09-16
CASH_IN,185834,Agence_moov_Ouidah,300000,114166,Joséphine Weber du Bonnin,54767,240601,2022-09-17
CASH_OUT,80403,Joséphine Weber du Bonnin,240601,160198,Agence_moov_Cotonou,300000,219597,2022-09-18
CASH_OUT,87984,Joséphine Weber du Bonnin,160198,72214,Agence_moov_Ouidah,300000,212016,2022-09-19
CASH_OUT,1527,Joséphine Weber du Bonnin,72214,70687,Agence_moov_Cotonou,300000,298473,2022-09-20
CASH_IN,81122,Agence_moov_Abomey,300000,218878,Joséphine Weber du Bonnin,70687,151809,2022-09-20
CASH_IN,233487,Agence_moov_Abomey,300000,66513,Joséphine Weber du Bonnin,151809,385296,2022-09-20
CASH_IN,152116,Agence_moov_Abomey,300000,147884,Joséphine Weber du Bonnin,385296,537412,2022-09-21
CASH_OUT,463348,Joséphine Weber du Bonnin,537412,74064,Agence_moov_Abomey,300000,-163348,2022-09-23
CASH_IN,225280,Agence_moov_Cotonou,300000,74720,Joséphine Weber du Bonnin,74064,299344,2022-09-24
CASH_IN,270268,Agence_moov_Abomey,300000,29732,Joséphine Weber du Bonnin,299344,569612,2022-09-24
CASH_IN,220467,Agence_moov_Abomey,300000,79533,Joséphine Weber du Bonnin,569612,790079,2022-09-25
CASH_IN,202548,Agence_moov_Abomey,300000,97452,Joséphine Weber du Bonnin,790079,992627,2022-09-26
CASH_IN,33580,Agence_moov_Abomey,300000,266420,Anastasie Louis,-549187,-515607,2022-09-02
CASH_IN,184666,Agence_moov_Ouidah,300000,115334,Anastasie Louis,-515607,-330941,2022-09-03
CASH_IN,20626,Agence_moov_Cotonou,300000,279374,Anastasie Louis,-330941,-310315,2022-09-03
CASH_IN,273918,Agence_moov_Ouidah,300000,26082,Anastasie Louis,-310315,-36397,2022-09-03
CASH_IN,47255,Agence_moov_Ouidah,300000,252745,Anastasie Louis,-36397,10858,2022-09-04
TRANSFER,7993,Anastasie Louis,10858,2865,Anastasie Louis,10858,18851,2022-09-10
TRANSFER,1965,Anastasie Louis,2865,900,Anastasie Louis,2865,900,2022-09-12
CASH_IN,211728,Agence_moov_Abomey,300000,88272,Anastasie Louis,900,212628,2022-09-13
CASH_IN,50212,Agence_moov_Ouidah,300000,249788,Anastasie Louis,212628,262840,2022-09-14
CASH_IN,211116,Agence_moov_Cotonou,300000,88884,Anastasie Louis,262840,473956,2022-09-19
CASH_IN,1696,Agence_moov_Abomey,300000,298304,Antoine Leroux,-946192,-944496,2022-09-03
CASH_IN,49534,Agence_moov_Cotonou,300000,250466,Antoine Leroux,-944496,-894962,2022-09-05
CASH_IN,28312,Agence_moov_Ouidah,300000,271688,Antoine Leroux,-894962,-866650,2022-09-06
CASH_IN,29811,Agence_moov_Cotonou,300000,270189,Antoine Leroux,-866650,-836839,2022-09-08
CASH_IN,218332,Agence_moov_Cotonou,300000,81668,Antoine Leroux,-836839,-618507,2022-09-09
CASH_IN,4558,Agence_moov_Cotonou,300000,295442,Antoine Leroux,-618507,-613949,2022-09-11
CASH_IN,121565,Agence_moov_Cotonou,300000,178435,Antoine Leroux,-613949,-492384,2022-09-14
CASH_IN,131312,Agence_moov_Abomey,300000,168688,Antoine Leroux,-492384,-361072,2022-09-14
CASH_IN,37398,Agence_moov_Abomey,300000,262602,Antoine Leroux,-361072,-323674,2022-09-16
CASH_IN,122214,Agence_moov_Ouidah,300000,177786,Antoine Leroux,-323674,-201460,2022-09-17
CASH_IN,247744,Agence_moov_Abomey,300000,52256,Antoine Leroux,-201460,46284,2022-09-17
TRANSFER,19130,Antoine Leroux,46284,27154,Antoine Leroux,46284,27154,2022-09-17
TRANSFER,2275,Antoine Leroux,27154,24879,Antoine Leroux,27154,24879,2022-09-19
CASH_IN,34883,Agence_moov_Cotonou,300000,265117,Antoine Leroux,24879,59762,2022-09-19
CASH_IN,199794,Agence_moov_Abomey,300000,100206,Antoine Leroux,59762,259556,2022-09-20
CASH_OUT,20365,Antoine Leroux,259556,239191,Agence_moov_Cotonou,300000,279635,2022-09-21
CASH_OUT,113930,Antoine Leroux,239191,125261,Agence_moov_Ouidah,300000,186070,2022-09-23
CASH_IN,255555,Agence_moov_Ouidah,300000,44445,Antoine Leroux,125261,380816,2022-09-25
CASH_IN,240579,Agence_moov_Ouidah,300000,59421,Maurice Alves,-267059,-26480,2022-09-05
CASH_IN,52448,Agence_moov_Ouidah,300000,247552,Maurice Alves,-26480,25968,2022-09-05
TRANSFER,11996,Maurice Alves,25968,13972,Maurice Alves,25968,37964,2022-09-06
CASH_IN,292615,Agence_moov_Cotonou,300000,7385,Maurice Alves,13972,306587,2022-09-07
CASH_IN,264214,Agence_moov_Ouidah,300000,35786,Maurice Alves,306587,570801,2022-09-08
CASH_IN,198456,Agence_moov_Abomey,300000,101544,Maurice Alves,570801,769257,2022-09-12
TRANSFER,253948,Maurice Alves,769257,515309,Maurice Alves,769257,515309,2022-09-13
TRANSFER,25767,Maurice Alves,515309,489542,Maurice Alves,515309,541076,2022-09-13
CASH_OUT,4533,Maurice Alves,489542,485009,Agence_moov_Ouidah,300000,295467,2022-09-13
CASH_OUT,423430,Maurice Alves,485009,61579,Agence_moov_Abomey,300000,-123430,2022-09-15
CASH_IN,244783,Agence_moov_Cotonou,300000,55217,Maurice Alves,61579,306362,2022-09-16
CASH_IN,22315,Agence_moov_Abomey,300000,277685,Maurice Alves,306362,328677,2022-09-19
CASH_OUT,103999,Maurice Alves,328677,224678,Agence_moov_Cotonou,300000,196001,2022-09-20
CASH_OUT,75262,Maurice Alves,224678,149416,Agence_moov_Ouidah,300000,224738,2022-09-24
CASH_OUT,30953,Maurice Alves,149416,118463,Agence_moov_Ouidah,300000,269047,2022-09-27
CASH_IN,124156,Agence_moov_Ouidah,300000,175844,Lucy Vaillant,-183924,-59768,2022-09-04
CASH_IN,116715,Agence_moov_Ouidah,300000,183285,Lucy Vaillant,-59768,56947,2022-09-09
TRANSFER,51117,Lucy Vaillant,56947,5830,Lucy Vaillant,56947,5830,2022-09-11
TRANSFER,242,Lucy Vaillant,5830,5588,Lucy Vaillant,5830,5588,2022-09-15
CASH_IN,124755,Agence_moov_Cotonou,300000,175245,Lucy Vaillant,5588,130343,2022-09-18
CASH_OUT,24831,Lucy Vaillant,130343,105512,Agence_moov_Ouidah,300000,275169,2022-09-22
CASH_IN,123046,Agence_moov_Ouidah,300000,176954,Stéphane-Timothée Pineau,-11397,111649,2022-09-05
TRANSFER,40182,Stéphane-Timothée Pineau,111649,71467,Stéphane-Timothée Pineau,111649,71467,2022-09-07
TRANSFER,56049,Stéphane-Timothée Pineau,71467,15418,Stéphane-Timothée Pineau,71467,15418,2022-09-07
CASH_OUT,10719,Stéphane-Timothée Pineau,15418,4699,Agence_moov_Ouidah,300000,289281,2022-09-08
CASH_IN,48053,Agence_moov_Ouidah,300000,251947,Stéphane-Timothée Pineau,4699,52752,2022-09-08
TRANSFER,38496,Stéphane-Timothée Pineau,52752,14256,Stéphane-Timothée Pineau,52752,91248,2022-09-08
CASH_OUT,7796,Stéphane-Timothée Pineau,14256,6460,Agence_moov_Ouidah,300000,292204,2022-09-09
TRANSFER,3981,Stéphane-Timothée Pineau,6460,2479,Stéphane-Timothée Pineau,6460,2479,2022-09-09
CASH_IN,218208,Agence_moov_Cotonou,300000,81792,Stéphane-Timothée Pineau,2479,220687,2022-09-12
CASH_OUT,157225,Stéphane-Timothée Pineau,220687,63462,Agence_moov_Cotonou,300000,142775,2022-09-14
CASH_OUT,19559,Stéphane-Timothée Pineau,63462,43903,Agence_moov_Ouidah,300000,280441,2022-09-18
CASH_IN,111394,Agence_moov_Ouidah,300000,188606,Stéphane-Timothée Pineau,43903,155297,2022-09-18
CASH_IN,286837,Agence_moov_Cotonou,300000,13163,Stéphane-Timothée Pineau,155297,442134,2022-09-23
CASH_IN,48461,Agence_moov_Ouidah,300000,251539,Stéphane-Timothée Pineau,442134,490595,2022-09-24
CASH_IN,136468,Agence_moov_Cotonou,300000,163532,Stéphane-Timothée Pineau,490595,627063,2022-09-25
CASH_IN,187777,Agence_moov_Ouidah,300000,112223,Sabine Imbert,-38831,148946,2022-09-01
CASH_IN,64911,Agence_moov_Abomey,300000,235089,Sabine Imbert,148946,213857,2022-09-04
TRANSFER,107095,Sabine Imbert,213857,106762,Sabine Imbert,213857,320952,2022-09-06
TRANSFER,47954,Sabine Imbert,106762,58808,Sabine Imbert,106762,154716,2022-09-09
TRANSFER,785,Sabine Imbert,58808,58023,Sabine Imbert,58808,59593,2022-09-10
CASH_OUT,3751,Sabine Imbert,58023,54272,Agence_moov_Ouidah,300000,296249,2022-09-10
TRANSFER,14798,Sabine Imbert,54272,39474,Sabine Imbert,54272,39474,2022-09-13
CASH_OUT,38139,Sabine Imbert,39474,1335,Agence_moov_Cotonou,300000,261861,2022-09-14
CASH_OUT,1094,Sabine Imbert,1335,241,Agence_moov_Abomey,300000,298906,2022-09-16
CASH_IN,215752,Agence_moov_Abomey,300000,84248,Sabine Imbert,241,215993,2022-09-17
CASH_OUT,92895,Sabine Imbert,215993,123098,Agence_moov_Ouidah,300000,207105,2022-09-20
CASH_IN,121661,Agence_moov_Ouidah,300000,178339,Sabine Imbert,123098,244759,2022-09-22
CASH_IN,146510,Agence_moov_Cotonou,300000,153490,Sabine Imbert,244759,391269,2022-09-22
CASH_IN,28582,Agence_moov_Ouidah,300000,271418,Émilie Guillon de Duhamel,-699414,-670832,2022-09-01
CASH_IN,142138,Agence_moov_Ouidah,300000,157862,Émilie Guillon de Duhamel,-670832,-528694,2022-09-02
CASH_IN,58669,Agence_moov_Cotonou,300000,241331,Émilie Guillon de Duhamel,-528694,-470025,2022-09-07
CASH_IN,111754,Agence_moov_Abomey,300000,188246,Émilie Guillon de Duhamel,-470025,-358271,2022-09-08
CASH_IN,8949,Agence_moov_Cotonou,300000,291051,Émilie Guillon de Duhamel,-358271,-349322,2022-09-08
CASH_IN,159270,Agence_moov_Abomey,300000,140730,Émilie Guillon de Duhamel,-349322,-190052,2022-09-12
CASH_IN,155716,Agence_moov_Abomey,300000,144284,Émilie Guillon de Duhamel,-190052,-34336,2022-09-12
CASH_IN,36757,Agence_moov_Abomey,300000,263243,Émilie Guillon de Duhamel,-34336,2421,2022-09-15
CASH_OUT,355,Émilie Guillon de Duhamel,2421,2066,Agence_moov_Cotonou,300000,299645,2022-09-15
CASH_OUT,517,Émilie Guillon de Duhamel,2066,1549,Agence_moov_Cotonou,300000,299483,2022-09-16
CASH_OUT,369,Émilie Guillon de Duhamel,1549,1180,Agence_moov_Cotonou,300000,299631,2022-09-17
CASH_OUT,1118,Émilie Guillon de Duhamel,1180,62,Agence_moov_Ouidah,300000,298882,2022-09-17
CASH_IN,230059,Agence_moov_Ouidah,300000,69941,Émilie Guillon de Duhamel,62,230121,2022-09-22
CASH_OUT,181849,Émilie Guillon de Duhamel,230121,48272,Agence_moov_Abomey,300000,118151,2022-09-23
CASH_OUT,28606,Émilie Guillon de Duhamel,48272,19666,Agence_moov_Cotonou,300000,271394,2022-09-24
CASH_OUT,18874,Émilie Guillon de Duhamel,19666,792,Agence_moov_Ouidah,300000,281126,2022-09-27
CASH_IN,14097,Agence_moov_Ouidah,300000,285903,Émile Hebert,-148975,-134878,2022-09-02
CASH_IN,151177,Agence_moov_Cotonou,300000,148823,Émile Hebert,-134878,16299,2022-09-08
CASH_IN,289212,Agence_moov_Ouidah,300000,10788,Émile Hebert,16299,305511,2022-09-08
CASH_IN,89434,Agence_moov_Abomey,300000,210566,Émile Hebert,305511,394945,2022-09-13
CASH_IN,188894,Agence_moov_Cotonou,300000,111106,Émile Hebert,394945,583839,2022-09-21
CASH_IN,2471,Agence_moov_Abomey,300000,297529,Émile Hebert,583839,586310,2022-09-21
CASH_IN,9116,Agence_moov_Cotonou,300000,290884,Émile Hebert,586310,595426,2022-09-21
CASH_IN,85069,Agence_moov_Ouidah,300000,214931,Noël Hamel,-306512,-221443,2022-09-04
CASH_IN,1509,Agence_moov_Abomey,300000,298491,Noël Hamel,-221443,-219934,2022-09-05
CASH_IN,202802,Agence_moov_Ouidah,300000,97198,Noël Hamel,-219934,-17132,2022-09-06
CASH_IN,291311,Agence_moov_Abomey,300000,8689,Noël Hamel,-17132,274179,2022-09-11
CASH_OUT,90713,Noël Hamel,274179,183466,Agence_moov_Cotonou,300000,209287,2022-09-11
TRANSFER,158810,Noël Hamel,183466,24656,Noël Hamel,183466,24656,2022-09-11
CASH_IN,258572,Agence_moov_Cotonou,300000,41428,Noël Hamel,24656,283228,2022-09-11
CASH_IN,199965,Agence_moov_Ouidah,300000,100035,Noël Hamel,283228,483193,2022-09-12
CASH_OUT,93422,Noël Hamel,483193,389771,Agence_moov_Abomey,300000,206578,2022-09-14
CASH_IN,167010,Agence_moov_Ouidah,300000,132990,Noël Hamel,389771,556781,2022-09-23
CASH_IN,55319,Agence_moov_Cotonou,300000,244681,Noël Hamel,556781,612100,2022-09-24
CASH_IN,294456,Agence_moov_Ouidah,300000,5544,Luc-Tristan Moreau,-50636,243820,2022-09-06
CASH_OUT,192475,Luc-Tristan Moreau,243820,51345,Agence_moov_Cotonou,300000,107525,2022-09-06
CASH_IN,159424,Agence_moov_Cotonou,300000,140576,Luc-Tristan Moreau,51345,210769,2022-09-10
CASH_IN,95657,Agence_moov_Ouidah,300000,204343,Luc-Tristan Moreau,210769,306426,2022-09-18
CASH_IN,173384,Agence_moov_Abomey,300000,126616,Luc-Tristan Moreau,306426,479810,2022-09-19
CASH_OUT,378400,Luc-Tristan Moreau,479810,101410,Agence_moov_Cotonou,300000,-78400,2022-09-19
CASH_OUT,55592,Luc-Tristan Moreau,101410,45818,Agence_moov_Ouidah,300000,244408,2022-09-20
TRANSFER,38045,Luc-Tristan Moreau,45818,7773,Luc-Tristan Moreau,45818,83863,2022-09-21
CASH_OUT,4773,Luc-Tristan Moreau,7773,3000,Agence_moov_Cotonou,300000,295227,2022-09-27
CASH_IN,9620,Agence_moov_Abomey,300000,290380,Aimé Allain,-175161,-165541,2022-09-04
CASH_IN,168000,Agence_moov_Abomey,300000,132000,Aimé Allain,-165541,2459,2022-09-07
TRANSFER,1612,Aimé Allain,2459,847,Aimé Allain,2459,4071,2022-09-09
CASH_IN,225656,Agence_moov_Cotonou,300000,74344,Aimé Allain,847,226503,2022-09-12
CASH_IN,173462,Agence_moov_Abomey,300000,126538,Aimé Allain,226503,399965,2022-09-13
CASH_IN,290262,Agence_moov_Cotonou,300000,9738,Aimé Allain,399965,690227,2022-09-15
CASH_OUT,210440,Aimé Allain,690227,479787,Agence_moov_Abomey,300000,89560,2022-09-18
CASH_IN,74205,Agence_moov_Ouidah,300000,225795,Léon Paris,-94072,-19867,2022-09-01
CASH_IN,256295,Agence_moov_Cotonou,300000,43705,Léon Paris,-19867,236428,2022-09-12
CASH_IN,140326,Agence_moov_Abomey,300000,159674,Léon Paris,236428,376754,2022-09-16
CASH_OUT,364759,Léon Paris,376754,11995,Agence_moov_Abomey,300000,-64759,2022-09-17
CASH_OUT,2737,Léon Paris,11995,9258,Agence_moov_Cotonou,300000,297263,2022-09-26
CASH_IN,186841,Agence_moov_Abomey,300000,113159,Hugues Gay,-724572,-537731,2022-09-01
CASH_IN,193597,Agence_moov_Cotonou,300000,106403,Hugues Gay,-537731,-344134,2022-09-03
CASH_IN,101501,Agence_moov_Abomey,300000,198499,Hugues Gay,-344134,-242633,2022-09-04
CASH_IN,280722,Agence_moov_Cotonou,300000,19278,Hugues Gay,-242633,38089,2022-09-07
TRANSFER,33042,Hugues Gay,38089,5047,Hugues Gay,38089,5047,2022-09-10
TRANSFER,2930,Hugues Gay,5047,2117,Hugues Gay,5047,7977,2022-09-10
CASH_IN,255875,Agence_moov_Abomey,300000,44125,Hugues Gay,2117,257992,2022-09-11
CASH_OUT,81831,Hugues Gay,257992,176161,Agence_moov_Ouidah,300000,218169,2022-09-13
CASH_IN,60878,Agence_moov_Abomey,300000,239122,Hugues Gay,176161,237039,2022-09-15
CASH_IN,69329,Agence_moov_Abomey,300000,230671,Hugues Gay,237039,306368,2022-09-21
CASH_OUT,219348,Hugues Gay,306368,87020,Agence_moov_Ouidah,300000,80652,2022-09-24
CASH_IN,14917,Agence_moov_Cotonou,300000,285083,Clémence Bertin,-78724,-63807,2022-09-02
CASH_IN,199673,Agence_moov_Abomey,300000,100327,Clémence Bertin,-63807,135866,2022-09-04
CASH_IN,211151,Agence_moov_Ouidah,300000,88849,Clémence Bertin,135866,347017,2022-09-05
TRANSFER,280451,Clémence Bertin,347017,66566,Clémence Bertin,347017,627468,2022-09-07
CASH_IN,79208,Agence_moov_Abomey,300000,220792,Clémence Bertin,66566,145774,2022-09-12
CASH_OUT,79199,Clémence Bertin,145774,66575,Agence_moov_Ouidah,300000,220801,2022-09-22
CASH_IN,156052,Agence_moov_Abomey,300000,143948,Margot Renaud de Lacombe,-128141,27911,2022-09-01
CASH_OUT,21157,Margot Renaud de Lacombe,27911,6754,Agence_moov_Cotonou,300000,278843,2022-09-03
CASH_OUT,2666,Margot Renaud de Lacombe,6754,4088,Agence_moov_Cotonou,300000,297334,2022-09-05
CASH_OUT,3429,Margot Renaud de Lacombe,4088,659,Agence_moov_Cotonou,300000,296571,2022-09-07
TRANSFER,537,Margot Renaud de Lacombe,659,122,Margot Renaud de Lacombe,659,122,2022-09-09
TRANSFER,120,Margot Renaud de Lacombe,122,2,Margot Renaud de Lacombe,122,242,2022-09-11
CASH_IN,22632,Agence_moov_Cotonou,300000,277368,Margot Renaud de Lacombe,2,22634,2022-09-15
CASH_IN,83589,Agence_moov_Cotonou,300000,216411,Margot Renaud de Lacombe,22634,106223,2022-09-16
CASH_IN,90113,Agence_moov_Cotonou,300000,209887,Margot Renaud de Lacombe,106223,196336,2022-09-22
CASH_IN,39620,Agence_moov_Abomey,300000,260380,Margot Renaud de Lacombe,196336,235956,2022-09-25
CASH_OUT,134478,Margot Renaud de Lacombe,235956,101478,Agence_moov_Cotonou,300000,165522,2022-09-26
TRANSFER,753351,Agnès Baron,1843600,1090249,Nicole Lacroix,1597900,2351251,2022-10-07
CASH_IN,278709,Agence_moov_Cotonou,300000,21291,Nicole Lacroix,2351251,2629960,2022-10-09
TRANSFER,2034988,Nicole Lacroix,2629960,594972,Marine-Clémence Ferreira,1808500,-226488,2022-10-22
CASH_IN,198392,Agence_moov_Abomey,300000,101608,Claudine Vallet,929600,1127992,2022-10-13
CASH_OUT,34649,Claudine Vallet,1127992,1093343,Agence_moov_Ouidah,300000,265351,2022-10-19
CASH_IN,183842,Agence_moov_Ouidah,300000,116158,Claudine Vallet,1093343,1277185,2022-10-25
CASH_IN,99875,Agence_moov_Ouidah,300000,200125,Claudine Vallet,1277185,1377060,2022-10-26
CASH_IN,214522,Agence_moov_Cotonou,300000,85478,Stéphane-Timothée Pineau,1229800,1444322,2022-10-09
TRANSFER,737359,Stéphane-Timothée Pineau,1444322,706963,Maryse Lebreton,253600,-483759,2022-10-11
CASH_IN,210173,Agence_moov_Abomey,300000,89827,Stéphane-Timothée Pineau,706963,917136,2022-10-25
CASH_OUT,827872,Stéphane-Timothée Pineau,917136,89264,Agence_moov_Ouidah,300000,-527872,2022-10-26
CASH_OUT,288769,Maryse Reynaud-Michaud,1124300,835531,Agence_moov_Ouidah,300000,11231,2022-10-02
CASH_OUT,803301,Thierry Dos Santos-Le Roux,1903500,1100199,Agence_moov_Ouidah,300000,-503301,2022-10-05
TRANSFER,1243962,Vincent-Philippe Rossi,1335100,91138,Thierry Dos Santos-Le Roux,1100199,2344161,2022-10-11
TRANSFER,119727,Léon Paris,141300,21573,Stéphanie Bonneau,215100,95373,2022-10-01
CASH_IN,20504,Agence_moov_Ouidah,300000,279496,Léon Paris,21573,42077,2022-10-02
TRANSFER,186737,Alphonse Dupont-Petit,723000,536263,Léon Paris,42077,228814,2022-10-24
CASH_IN,40530,Agence_moov_Cotonou,300000,259470,Léon Paris,228814,269344,2022-10-25
CASH_IN,66501,Agence_moov_Ouidah,300000,233499,Laurence Dumont de Laroche,937000,1003501,2022-10-20
TRANSFER,806477,Laurence Dumont de Laroche,1003501,197024,Marc Gilbert,1652400,845923,2022-10-21
TRANSFER,196810,Laurence Dumont de Laroche,197024,214,Marc Gilbert,845923,649113,2022-10-22
CASH_OUT,420347,Noël Hamel,708300,287953,Agence_moov_Abomey,300000,-120347,2022-10-15
CASH_OUT,116024,Noël Hamel,287953,171929,Agence_moov_Abomey,300000,183976,2022-10-24
CASH_OUT,46821,Noël Hamel,171929,125108,Agence_moov_Abomey,300000,253179,2022-10-24
CASH_IN,236093,Agence_moov_Cotonou,300000,63907,Marianne Descamps,732400,968493,2022-10-09
CASH_OUT,187501,Adélaïde-Sophie Leclercq,297000,109499,Agence_moov_Abomey,300000,112499,2022-10-06
TRANSFER,67532,Adélaïde-Sophie Leclercq,109499,41967,Laurent Perrot,1276200,1208668,2022-10-08
TRANSFER,29553,Adélaïde-Sophie Leclercq,41967,12414,Maurice Seguin,859800,830247,2022-10-12
TRANSFER,1295564,Emmanuel Bousquet,1364900,69336,Adélaïde-Sophie Leclercq,12414,1307978,2022-10-16
CASH_OUT,582717,Adélaïde-Sophie Leclercq,1307978,725261,Agence_moov_Cotonou,300000,-282717,2022-10-16
TRANSFER,1212379,Susan de Fontaine,1450600,238221,Christophe Alexandre,844100,2056479,2022-10-04
CASH_OUT,635636,Christophe Alexandre,2056479,1420843,Agence_moov_Abomey,300000,-335636,2022-10-10
CASH_OUT,1386594,Christophe Alexandre,1420843,34249,Agence_moov_Ouidah,300000,-1086594,2022-10-12
CASH_IN,65350,Agence_moov_Abomey,300000,234650,Christophe Alexandre,34249,99599,2022-10-15
CASH_IN,1117,Agence_moov_Abomey,300000,298883,Christophe Alexandre,99599,100716,2022-10-27
CASH_IN,196311,Agence_moov_Abomey,300000,103689,Julie Robin de Gros,363300,559611,2022-10-07
CASH_OUT,443792,Julie Robin de Gros,559611,115819,Agence_moov_Cotonou,300000,-143792,2022-10-11
CASH_OUT,103540,Julie Robin de Gros,115819,12279,Agence_moov_Ouidah,300000,196460,2022-10-14
CASH_IN,1232,Agence_moov_Abomey,300000,298768,Julie Robin de Gros,12279,13511,2022-10-27
CASH_OUT,682057,Maurice Alves,1276900,594843,Agence_moov_Ouidah,300000,-382057,2022-10-05
TRANSFER,407367,Maurice Alves,594843,187476,Isaac Le Pinto,1322900,915533,2022-10-08
CASH_OUT,92802,Maurice Alves,187476,94674,Agence_moov_Cotonou,300000,207198,2022-10-14
CASH_IN,274140,Agence_moov_Cotonou,300000,25860,Maurice Alves,94674,368814,2022-10-15
TRANSFER,603586,Joseph de la Dubois,1114100,510514,Maurice Alves,368814,972400,2022-10-21
CASH_OUT,568686,Antoine Bourdon de Auger,902800,334114,Agence_moov_Ouidah,300000,-268686,2022-10-07
CASH_OUT,120044,Antoine Bourdon de Auger,334114,214070,Agence_moov_Ouidah,300000,179956,2022-10-17
TRANSFER,241936,Diane-Françoise Raynaud,684000,442064,Antoine Bourdon de Auger,214070,456006,2022-10-18
CASH_OUT,421819,Antoine Bourdon de Auger,456006,34187,Agence_moov_Abomey,300000,-121819,2022-10-23
CASH_IN,226097,Agence_moov_Cotonou,300000,73903,Antoine Bourdon de Auger,34187,260284,2022-10-27
CASH_IN,95908,Agence_moov_Abomey,300000,204092,Emmanuelle Gilbert,1254200,1350108,2022-10-01
CASH_OUT,1285659,Emmanuelle Gilbert,1350108,64449,Agence_moov_Abomey,300000,-985659,2022-10-13
CASH_OUT,6862,Emmanuelle Gilbert,64449,57587,Agence_moov_Cotonou,300000,293138,2022-10-14
TRANSFER,51307,Grégoire Delmas de Blanchard,308800,257493,Emmanuelle Gilbert,57587,108894,2022-10-19
CASH_OUT,73277,Emmanuelle Gilbert,108894,35617,Agence_moov_Ouidah,300000,226723,2022-10-22
CASH_OUT,41753,Vincent-Philippe Rossi,91138,49385,Agence_moov_Ouidah,300000,258247,2022-10-04
CASH_OUT,30968,Vincent-Philippe Rossi,49385,18417,Agence_moov_Cotonou,300000,269032,2022-10-13
TRANSFER,2102,Vincent-Philippe Rossi,18417,16315,Matthieu Carpentier,1657800,1655698,2022-10-21
CASH_OUT,13297,Vincent-Philippe Rossi,16315,3018,Agence_moov_Cotonou,300000,286703,2022-10-26
CASH_IN,68752,Agence_moov_Cotonou,300000,231248,Matthieu Carpentier,1655698,1724450,2022-10-13
CASH_OUT,842697,Matthieu Carpentier,1724450,881753,Agence_moov_Abomey,300000,-542697,2022-10-25
CASH_IN,186979,Agence_moov_Abomey,300000,113021,Matthieu Carpentier,881753,1068732,2022-10-27
TRANSFER,48883,Frédérique Robin,600700,551817,Matthieu Carpentier,1068732,1117615,2022-10-27
TRANSFER,279358,Xavier-Stéphane Ollivier,282800,3442,Emmanuel-René Coulon,1413500,1692858,2022-10-14
CASH_OUT,1748437,Josette Guillon-Leclercq,1924200,175763,Agence_moov_Abomey,300000,-1448437,2022-10-07
TRANSFER,584648,Richard Guibert,1936500,1351852,Josette Guillon-Leclercq,175763,760411,2022-10-16
CASH_IN,2025,Agence_moov_Ouidah,300000,297975,Josette Guillon-Leclercq,760411,762436,2022-10-21
TRANSFER,460986,Josette Guillon-Leclercq,762436,301450,Xavier-Stéphane Ollivier,3442,-457544,2022-10-22
TRANSFER,693168,Luc Camus,1501900,808732,Nathalie-Chantal Jacques,1561500,868332,2022-10-15
CASH_IN,199523,Agence_moov_Cotonou,300000,100477,Marine-Clémence Ferreira,-226488,-26965,2022-10-06
CASH_IN,191977,Agence_moov_Ouidah,300000,108023,Marine-Clémence Ferreira,-26965,165012,2022-10-11
TRANSFER,265232,Frédérique Robin,551817,286585,Marine-Clémence Ferreira,165012,430244,2022-10-20
TRANSFER,374888,Hugues Gay,1479700,1104812,Marine-Clémence Ferreira,430244,805132,2022-10-22
CASH_OUT,31379,Bernadette Fabre,48200,16821,Agence_moov_Abomey,300000,268621,2022-10-17
CASH_IN,83503,Agence_moov_Cotonou,300000,216497,Bernadette Fabre,16821,100324,2022-10-17
TRANSFER,53030,Bernadette Fabre,100324,47294,Bernadette Fabre,100324,153354,2022-10-25
CASH_OUT,195482,Grégoire Delmas de Blanchard,257493,62011,Agence_moov_Abomey,300000,104518,2022-10-15
TRANSFER,11083,Grégoire Delmas de Blanchard,62011,50928,Agnès Baron,1090249,1079166,2022-10-20
TRANSFER,42284,Grégoire Delmas de Blanchard,50928,8644,Gilbert Bazin Le Guillet,1878500,1836216,2022-10-22
CASH_OUT,7051,Grégoire Delmas de Blanchard,8644,1593,Agence_moov_Cotonou,300000,292949,2022-10-24
CASH_OUT,145545,Caroline Monnier,216800,71255,Agence_moov_Cotonou,300000,154455,2022-10-02
CASH_OUT,32141,Caroline Monnier,71255,39114,Agence_moov_Ouidah,300000,267859,2022-10-09
TRANSFER,29436,Caroline Monnier,39114,9678,Gabriel de Pineau,1535500,1506064,2022-10-11
TRANSFER,641072,Alfred Chrétien,908500,267428,Caroline Monnier,9678,650750,2022-10-23
TRANSFER,22065,Clémence Bertin,329400,307335,Isaac Le Pinto,915533,893468,2022-10-14
TRANSFER,264452,Clémence Bertin,307335,42883,Alfred Chrétien,267428,2976,2022-10-14
CASH_IN,5727,Agence_moov_Cotonou,300000,294273,Adrienne Arnaud,1545500,1551227,2022-10-03
TRANSFER,1318402,Jacques-Antoine Gros,1370600,52198,Adrienne Arnaud,1551227,2869629,2022-10-09
CASH_OUT,2111619,Adrienne Arnaud,2869629,758010,Agence_moov_Abomey,300000,-1811619,2022-10-13
CASH_IN,44350,Agence_moov_Abomey,300000,255650,Adrienne Arnaud,758010,802360,2022-10-20
CASH_IN,83675,Agence_moov_Ouidah,300000,216325,Adrienne Arnaud,802360,886035,2022-10-25
CASH_IN,261218,Agence_moov_Abomey,300000,38782,Auguste Bousquet,1710800,1972018,2022-10-01
TRANSFER,76270,Vincent-Grégoire Brunet,246900,170630,Auguste Bousquet,1972018,2048288,2022-10-05
CASH_OUT,154708,Auguste Bousquet,2048288,1893580,Agence_moov_Cotonou,300000,145292,2022-10-06
CASH_OUT,345573,Auguste Bousquet,1893580,1548007,Agence_moov_Ouidah,300000,-45573,2022-10-07
CASH_OUT,310727,Auguste Bousquet,1548007,1237280,Agence_moov_Abomey,300000,-10727,2022-10-07
CASH_OUT,1036047,Auguste Bousquet,1237280,201233,Agence_moov_Cotonou,300000,-736047,2022-10-07
TRANSFER,146800,Auguste Bousquet,201233,54433,Jacques-Antoine Gros,52198,-94602,2022-10-08
CASH_IN,266785,Agence_moov_Cotonou,300000,33215,Auguste Bousquet,54433,321218,2022-10-08
TRANSFER,144768,Auguste Bousquet,321218,176450,Laurent Besson,1765200,1620432,2022-10-11
CASH_OUT,125449,Auguste Bousquet,176450,51001,Agence_moov_Cotonou,300000,174551,2022-10-13
CASH_OUT,45780,Auguste Bousquet,51001,5221,Agence_moov_Cotonou,300000,254220,2022-10-15
CASH_IN,151915,Agence_moov_Abomey,300000,148085,Auguste Bousquet,5221,157136,2022-10-15
TRANSFER,1263787,Christine-Constance Gauthier,1936000,672213,Auguste Bousquet,157136,1420923,2022-10-15
CASH_IN,13023,Agence_moov_Cotonou,300000,286977,Auguste Bousquet,1420923,1433946,2022-10-16
CASH_IN,181796,Agence_moov_Cotonou,300000,118204,Auguste Bousquet,1433946,1615742,2022-10-16
CASH_OUT,142211,Auguste Bousquet,1615742,1473531,Agence_moov_Abomey,300000,157789,2022-10-17
CASH_OUT,1238270,Auguste Bousquet,1473531,235261,Agence_moov_Abomey,300000,-938270,2022-10-18
CASH_OUT,65932,Auguste Bousquet,235261,169329,Agence_moov_Cotonou,300000,234068,2022-10-20
CASH_OUT,3554,Auguste Bousquet,169329,165775,Agence_moov_Ouidah,300000,296446,2022-10-21
TRANSFER,127950,Auguste Bousquet,165775,37825,Auguste Bousquet,165775,293725,2022-10-22
TRANSFER,28689,Auguste Bousquet,37825,9136,Paul Pereira,1554000,1525311,2022-10-22
CASH_IN,57766,Agence_moov_Abomey,300000,242234,Auguste Bousquet,9136,66902,2022-10-24
TRANSFER,47662,Auguste Bousquet,66902,19240,Stéphanie Bonneau,95373,47711,2022-10-25
TRANSFER,10632,Auguste Bousquet,19240,8608,Caroline Bonneau,1920800,1910168,2022-10-26
CASH_OUT,5846,Auguste Bousquet,8608,2762,Agence_moov_Ouidah,300000,294154,2022-10-26
CASH_OUT,620,Auguste Bousquet,2762,2142,Agence_moov_Ouidah,300000,299380,2022-10-26
TRANSFER,1094,Auguste Bousquet,2142,1048,Guy Guyon,1425300,1424206,2022-10-26
CASH_IN,58395,Agence_moov_Abomey,300000,241605,Auguste Bousquet,1048,59443,2022-10-27
CASH_IN,24061,Agence_moov_Ouidah,300000,275939,Michèle Vallée,1689900,1713961,2022-10-01
CASH_IN,248615,Agence_moov_Cotonou,300000,51385,Michèle Vallée,1713961,1962576,2022-10-02
CASH_OUT,39441,Michèle Vallée,1962576,1923135,Agence_moov_Ouidah,300000,260559,2022-10-02
TRANSFER,274737,Michèle Vallée,1923135,1648398,Élodie Gérard,124700,-150037,2022-10-04
TRANSFER,93137,Michèle Vallée,1648398,1555261,Marie Da Silva,1932500,1839363,2022-10-05
TRANSFER,5562,Théodore Bertin,153400,147838,Michèle Vallée,1555261,1560823,2022-10-05
CASH_IN,30756,Agence_moov_Cotonou,300000,269244,Michèle Vallée,1560823,1591579,2022-10-08
CASH_OUT,1579286,Michèle Vallée,1591579,12293,Agence_moov_Ouidah,300000,-1279286,2022-10-08
TRANSFER,9178,Michèle Vallée,12293,3115,Isaac Le Pinto,893468,884290,2022-10-10
CASH_OUT,1458,Michèle Vallée,3115,1657,Agence_moov_Cotonou,300000,298542,2022-10-10
CASH_IN,62223,Agence_moov_Abomey,300000,237777,Michèle Vallée,1657,63880,2022-10-12
CASH_IN,101527,Agence_moov_Ouidah,300000,198473,Michèle Vallée,63880,165407,2022-10-12
CASH_IN,68970,Agence_moov_Abomey,300000,231030,Michèle Vallée,165407,234377,2022-10-12
TRANSFER,192323,Michèle Vallée,234377,42054,Roland Colin,943000,750677,2022-10-13
TRANSFER,28205,Hugues Gay,1104812,1076607,Michèle Vallée,42054,70259,2022-10-14
CASH_OUT,26863,Michèle Vallée,70259,43396,Agence_moov_Cotonou,300000,273137,2022-10-15
CASH_IN,184572,Agence_moov_Ouidah,300000,115428,Michèle Vallée,43396,227968,2022-10-15
TRANSFER,53202,Michèle Vallée,227968,174766,Théophile Mendès,1381400,1328198,2022-10-17
CASH_IN,39457,Agence_moov_Abomey,300000,260543,Michèle Vallée,174766,214223,2022-10-18
CASH_OUT,166779,Michèle Vallée,214223,47444,Agence_moov_Cotonou,300000,133221,2022-10-18
TRANSFER,1386,Michèle Vallée,47444,46058,Noémi de la Didier,1195700,1194314,2022-10-19
CASH_IN,32455,Agence_moov_Abomey,300000,267545,Michèle Vallée,46058,78513,2022-10-21
CASH_OUT,49567,Michèle Vallée,78513,28946,Agence_moov_Abomey,300000,250433,2022-10-21
CASH_IN,249974,Agence_moov_Abomey,300000,50026,Michèle Vallée,28946,278920,2022-10-22
CASH_OUT,139924,Michèle Vallée,278920,138996,Agence_moov_Cotonou,300000,160076,2022-10-22
CASH_IN,23421,Agence_moov_Abomey,300000,276579,Michèle Vallée,138996,162417,2022-10-23
CASH_OUT,153548,Michèle Vallée,162417,8869,Agence_moov_Ouidah,300000,146452,2022-10-26
TRANSFER,139250,Théodore Bertin,147838,8588,Stéphanie Bonneau,47711,-91539,2022-10-01
CASH_OUT,2723,Théodore Bertin,8588,5865,Agence_moov_Cotonou,300000,297277,2022-10-02
CASH_IN,47842,Agence_moov_Abomey,300000,252158,Théodore Bertin,5865,53707,2022-10-04
CASH_IN,263190,Agence_moov_Abomey,300000,36810,Théodore Bertin,53707,316897,2022-10-06
TRANSFER,76690,Théodore Bertin,316897,240207,Caroline Bonneau,1910168,1833478,2022-10-06
CASH_OUT,52596,Théodore Bertin,240207,187611,Agence_moov_Abomey,300000,247404,2022-10-07
CASH_IN,91012,Agence_moov_Ouidah,300000,208988,Théodore Bertin,187611,278623,2022-10-07
TRANSFER,140949,Marthe Guillet,415700,274751,Théodore Bertin,278623,419572,2022-10-07
TRANSFER,609184,Paulette Dias,612400,3216,Théodore Bertin,419572,1028756,2022-10-09
CASH_IN,4614,Agence_moov_Ouidah,300000,295386,Théodore Bertin,1028756,1033370,2022-10-12
CASH_IN,38080,Agence_moov_Cotonou,300000,261920,Théodore Bertin,1033370,1071450,2022-10-12
CASH_IN,36039,Agence_moov_Cotonou,300000,263961,Théodore Bertin,1071450,1107489,2022-10-13
CASH_IN,145420,Agence_moov_Ouidah,300000,154580,Théodore Bertin,1107489,1252909,2022-10-14
CASH_OUT,10664,Théodore Bertin,1252909,1242245,Agence_moov_Ouidah,300000,289336,2022-10-14
CASH_OUT,886417,Théodore Bertin,1242245,355828,Agence_moov_Ouidah,300000,-586417,2022-10-16
TRANSFER,37777,Théodore Bertin,355828,318051,Vincent-Grégoire Brunet,170630,132853,2022-10-17
CASH_IN,161644,Agence_moov_Cotonou,300000,138356,Théodore Bertin,318051,479695,2022-10-17
CASH_IN,245674,Agence_moov_Cotonou,300000,54326,Théodore Bertin,479695,725369,2022-10-17
CASH_IN,291147,Agence_moov_Cotonou,300000,8853,Théodore Bertin,725369,1016516,2022-10-17
CASH_IN,201939,Agence_moov_Cotonou,300000,98061,Théodore Bertin,1016516,1218455,2022-10-18
CASH_OUT,291972,Théodore Bertin,1218455,926483,Agence_moov_Abomey,300000,8028,2022-10-18
TRANSFER,88304,Guy Guyon,1424206,1335902,Théodore Bertin,926483,1014787,2022-10-20
CASH_IN,156616,Agence_moov_Cotonou,300000,143384,Théodore Bertin,1014787,1171403,2022-10-21
CASH_IN,56409,Agence_moov_Cotonou,300000,243591,Théodore Bertin,1171403,1227812,2022-10-21
TRANSFER,1062041,Émile Hebert,1309600,247559,Théodore Bertin,1227812,2289853,2022-10-22
CASH_IN,99641,Agence_moov_Cotonou,300000,200359,Théodore Bertin,2289853,2389494,2022-10-25
CASH_OUT,1602845,Théodore Bertin,2389494,786649,Agence_moov_Ouidah,300000,-1302845,2022-10-27
CASH_OUT,751580,Théodore Bertin,786649,35069,Agence_moov_Ouidah,300000,-451580,2022-10-27
CASH_OUT,229514,Marthe Pichon,718200,488686,Agence_moov_Ouidah,300000,70486,2022-10-02
CASH_IN,41465,Agence_moov_Ouidah,300000,258535,Marthe Pichon,488686,530151,2022-10-02
CASH_OUT,457653,Marthe Pichon,530151,72498,Agence_moov_Ouidah,300000,-157653,2022-10-02
CASH_IN,239673,Agence_moov_Ouidah,300000,60327,Marthe Pichon,72498,312171,2022-10-03
CASH_OUT,96699,Marthe Pichon,312171,215472,Agence_moov_Ouidah,300000,203301,2022-10-03
CASH_IN,18760,Agence_moov_Abomey,300000,281240,Marthe Pichon,215472,234232,2022-10-04
CASH_OUT,4326,Marthe Pichon,234232,229906,Agence_moov_Ouidah,300000,295674,2022-10-04
CASH_OUT,137769,Marthe Pichon,229906,92137,Agence_moov_Ouidah,300000,162231,2022-10-05
CASH_IN,136347,Agence_moov_Ouidah,300000,163653,Marthe Pichon,92137,228484,2022-10-07
CASH_OUT,100786,Marthe Pichon,228484,127698,Agence_moov_Ouidah,300000,199214,2022-10-07
TRANSFER,92556,Marthe Pichon,127698,35142,Nicolas Grondin de la Pinto,1431200,1338644,2022-10-08
TRANSFER,293254,Guy Guyon,1335902,1042648,Marthe Pichon,35142,328396,2022-10-08
CASH_OUT,32625,Marthe Pichon,328396,295771,Agence_moov_Ouidah,300000,267375,2022-10-09
CASH_OUT,174718,Marthe Pichon,295771,121053,Agence_moov_Cotonou,300000,125282,2022-10-11
CASH_OUT,44869,Marthe Pichon,121053,76184,Agence_moov_Abomey,300000,255131,2022-10-11
CASH_OUT,11251,Marthe Pichon,76184,64933,Agence_moov_Cotonou,300000,288749,2022-10-12
TRANSFER,1403042,Nath Léger,1980700,577658,Marthe Pichon,64933,1467975,2022-10-14
CASH_IN,52307,Agence_moov_Ouidah,300000,247693,Marthe Pichon,1467975,1520282,2022-10-15
CASH_IN,106476,Agence_moov_Ouidah,300000,193524,Marthe Pichon,1520282,1626758,2022-10-16
TRANSFER,1508081,Matthieu Renard,1576000,67919,Marthe Pichon,1626758,3134839,2022-10-17
CASH_IN,87398,Agence_moov_Abomey,300000,212602,Marthe Pichon,3134839,3222237,2022-10-17
TRANSFER,59713,Vincent-Grégoire Brunet,132853,73140,Marthe Pichon,3222237,3281950,2022-10-20
TRANSFER,2590922,Marthe Pichon,3281950,691028,Alphonse Dupont-Petit,536263,-2054659,2022-10-21
CASH_IN,60810,Agence_moov_Abomey,300000,239190,Marthe Pichon,691028,751838,2022-10-21
CASH_OUT,254949,Marthe Pichon,751838,496889,Agence_moov_Ouidah,300000,45051,2022-10-22
TRANSFER,14259,Marthe Pichon,496889,482630,Margot Renaud de Lacombe,464500,450241,2022-10-23
CASH_OUT,54653,Marthe Pichon,482630,427977,Agence_moov_Abomey,300000,245347,2022-10-23
TRANSFER,174203,Marthe Pichon,427977,253774,Joséphine Weber du Bonnin,382100,207897,2022-10-24
CASH_OUT,139318,Marthe Pichon,253774,114456,Agence_moov_Ouidah,300000,160682,2022-10-24
CASH_OUT,19787,Marthe Pichon,114456,94669,Agence_moov_Cotonou,300000,280213,2022-10-26
CASH_IN,266690,Agence_moov_Cotonou,300000,33310,Christine-Constance Gauthier,672213,938903,2022-10-01
CASH_OUT,390726,Christine-Constance Gauthier,938903,548177,Agence_moov_Ouidah,300000,-90726,2022-10-01
TRANSFER,44401,Christine-Constance Gauthier,548177,503776,Roland Colin,750677,706276,2022-10-02
TRANSFER,1321440,Richard Guibert,1351852,30412,Christine-Constance Gauthier,503776,1825216,2022-10-03
CASH_OUT,756791,Christine-Constance Gauthier,1825216,1068425,Agence_moov_Cotonou,300000,-456791,2022-10-05
CASH_OUT,59157,Christine-Constance Gauthier,1068425,1009268,Agence_moov_Abomey,300000,240843,2022-10-07
CASH_IN,163597,Agence_moov_Abomey,300000,136403,Christine-Constance Gauthier,1009268,1172865,2022-10-08
TRANSFER,239151,Frédérique Robin,286585,47434,Christine-Constance Gauthier,1172865,1412016,2022-10-08
CASH_IN,255565,Agence_moov_Ouidah,300000,44435,Christine-Constance Gauthier,1412016,1667581,2022-10-08
CASH_IN,65161,Agence_moov_Abomey,300000,234839,Christine-Constance Gauthier,1667581,1732742,2022-10-09
CASH_OUT,588224,Christine-Constance Gauthier,1732742,1144518,Agence_moov_Ouidah,300000,-288224,2022-10-09
TRANSFER,1100243,Christine-Constance Gauthier,1144518,44275,Susan de Fontaine,238221,-862022,2022-10-10
CASH_OUT,16857,Christine-Constance Gauthier,44275,27418,Agence_moov_Ouidah,300000,283143,2022-10-12
CASH_OUT,2795,Christine-Constance Gauthier,27418,24623,Agence_moov_Abomey,300000,297205,2022-10-15
CASH_OUT,3002,Christine-Constance Gauthier,24623,21621,Agence_moov_Abomey,300000,296998,2022-10-15
CASH_OUT,5941,Christine-Constance Gauthier,21621,15680,Agence_moov_Ouidah,300000,294059,2022-10-15
CASH_IN,192082,Agence_moov_Abomey,300000,107918,Christine-Constance Gauthier,15680,207762,2022-10-20
TRANSFER,155061,Christine-Constance Gauthier,207762,52701,Isaac Le Pinto,884290,729229,2022-10-21
CASH_IN,247860,Agence_moov_Cotonou,300000,52140,Christine-Constance Gauthier,52701,300561,2022-10-22
TRANSFER,267706,Christine-Constance Gauthier,300561,32855,Paul De Sousa,1785100,1517394,2022-10-25
CASH_OUT,15823,Christine-Constance Gauthier,32855,17032,Agence_moov_Abomey,300000,284177,2022-10-27
CASH_IN,235371,Agence_moov_Ouidah,300000,64629,Christine-Constance Gauthier,17032,252403,2022-10-27
TRANSFER,135195,Marthe Guillet,274751,139556,Marie Da Silva,1839363,1974558,2022-10-02
TRANSFER,1933180,Marie Da Silva,1974558,41378,Théophile Mendès,1328198,-604982,2022-10-03
CASH_OUT,9637,Marie Da Silva,41378,31741,Agence_moov_Cotonou,300000,290363,2022-10-03
TRANSFER,15016,Marie Da Silva,31741,16725,Arnaude Gaillard,1546700,1531684,2022-10-06
CASH_IN,36961,Agence_moov_Abomey,300000,263039,Marie Da Silva,16725,53686,2022-10-06
CASH_IN,254218,Agence_moov_Cotonou,300000,45782,Marie Da Silva,53686,307904,2022-10-07
CASH_OUT,53338,Marie Da Silva,307904,254566,Agence_moov_Ouidah,300000,246662,2022-10-08
CASH_OUT,96781,Marie Da Silva,254566,157785,Agence_moov_Cotonou,300000,203219,2022-10-09
TRANSFER,1236912,Nicolas Grondin de la Pinto,1338644,101732,Marie Da Silva,157785,1394697,2022-10-09
TRANSFER,197674,Benoît Verdier,909100,711426,Marie Da Silva,1394697,1592371,2022-10-11
CASH_OUT,830691,Marie Da Silva,1592371,761680,Agence_moov_Cotonou,300000,-530691,2022-10-12
TRANSFER,514649,Christophe Guilbert,983100,468451,Marie Da Silva,761680,1276329,2022-10-12
CASH_OUT,695007,Marie Da Silva,1276329,581322,Agence_moov_Ouidah,300000,-395007,2022-10-12
CASH_OUT,466830,Marie Da Silva,581322,114492,Agence_moov_Cotonou,300000,-166830,2022-10-13
CASH_IN,95876,Agence_moov_Ouidah,300000,204124,Marie Da Silva,114492,210368,2022-10-13
TRANSFER,31786,Marie Da Silva,210368,178582,Émilie Guillon de Duhamel,1028600,996814,2022-10-16
TRANSFER,641562,Hugues Gay,1076607,435045,Marie Da Silva,178582,820144,2022-10-18
TRANSFER,255935,Diane-Françoise Raynaud,442064,186129,Marie Da Silva,820144,1076079,2022-10-20
CASH_IN,216120,Agence_moov_Abomey,300000,83880,Marie Da Silva,1076079,1292199,2022-10-20
TRANSFER,943171,Marie Da Silva,1292199,349028,David-Théodore Diaz,966100,22929,2022-10-21
TRANSFER,186447,Marie Da Silva,349028,162581,Alfred Chrétien,2976,-183471,2022-10-22
CASH_OUT,88425,Marie Da Silva,162581,74156,Agence_moov_Abomey,300000,211575,2022-10-26
CASH_IN,287977,Agence_moov_Cotonou,300000,12023,Marie Da Silva,74156,362133,2022-10-26
TRANSFER,280088,Marie Da Silva,362133,82045,Laurence Carlier,1778800,1498712,2022-10-27
CASH_OUT,229543,Émile Hebert,247559,18016,Agence_moov_Abomey,300000,70457,2022-10-01
TRANSFER,7733,Émile Hebert,18016,10283,Caroline Peltier,682500,674767,2022-10-02
CASH_IN,284844,Agence_moov_Ouidah,300000,15156,Émile Hebert,10283,295127,2022-10-03
CASH_IN,111452,Agence_moov_Cotonou,300000,188548,Émile Hebert,295127,406579,2022-10-05
CASH_IN,93948,Agence_moov_Cotonou,300000,206052,Émile Hebert,406579,500527,2022-10-05
CASH_OUT,294632,Émile Hebert,500527,205895,Agence_moov_Ouidah,300000,5368,2022-10-05
CASH_OUT,18455,Émile Hebert,205895,187440,Agence_moov_Abomey,300000,281545,2022-10-06
CASH_IN,37380,Agence_moov_Abomey,300000,262620,Émile Hebert,187440,224820,2022-10-06
CASH_OUT,31097,Émile Hebert,224820,193723,Agence_moov_Cotonou,300000,268903,2022-10-06
TRANSFER,44166,Marthe Guillet,139556,95390,Émile Hebert,193723,237889,2022-10-07
CASH_IN,23924,Agence_moov_Abomey,300000,276076,Émile Hebert,237889,261813,2022-10-07
CASH_OUT,234278,Émile Hebert,261813,27535,Agence_moov_Cotonou,300000,65722,2022-10-07
CASH_OUT,11437,Émile Hebert,27535,16098,Agence_moov_Ouidah,300000,288563,2022-10-08
TRANSFER,15093,Émile Hebert,16098,1005,Marc Gilbert,649113,634020,2022-10-09
CASH_IN,264933,Agence_moov_Cotonou,300000,35067,Émile Hebert,1005,265938,2022-10-10
CASH_OUT,212511,Émile Hebert,265938,53427,Agence_moov_Cotonou,300000,87489,2022-10-11
CASH_OUT,28974,Émile Hebert,53427,24453,Agence_moov_Abomey,300000,271026,2022-10-12
CASH_IN,208213,Agence_moov_Ouidah,300000,91787,Émile Hebert,24453,232666,2022-10-12
CASH_IN,84675,Agence_moov_Abomey,300000,215325,Émile Hebert,232666,317341,2022-10-17
CASH_IN,292498,Agence_moov_Ouidah,300000,7502,Émile Hebert,317341,609839,2022-10-18
CASH_OUT,120666,Émile Hebert,609839,489173,Agence_moov_Ouidah,300000,179334,2022-10-20
CASH_OUT,234951,Émile Hebert,489173,254222,Agence_moov_Cotonou,300000,65049,2022-10-22
TRANSFER,142431,Marc Gilbert,634020,491589,Émile Hebert,254222,396653,2022-10-22
CASH_OUT,373279,Émile Hebert,396653,23374,Agence_moov_Ouidah,300000,-73279,2022-10-22
CASH_IN,187100,Agence_moov_Cotonou,300000,112900,Émile Hebert,23374,210474,2022-10-23
CASH_IN,226974,Agence_moov_Ouidah,300000,73026,Paul De Sousa,1517394,1744368,2022-10-01
CASH_IN,191628,Agence_moov_Ouidah,300000,108372,Paul De Sousa,1744368,1935996,2022-10-02
CASH_OUT,784317,Paul De Sousa,1935996,1151679,Agence_moov_Ouidah,300000,-484317,2022-10-03
TRANSFER,359153,Paul De Sousa,1151679,792526,Noémi de la Didier,1194314,835161,2022-10-03
CASH_OUT,563409,Paul De Sousa,792526,229117,Agence_moov_Cotonou,300000,-263409,2022-10-03
CASH_OUT,148831,Paul De Sousa,229117,80286,Agence_moov_Cotonou,300000,151169,2022-10-06
CASH_IN,10492,Agence_moov_Ouidah,300000,289508,Paul De Sousa,80286,90778,2022-10-06
TRANSFER,31984,Frédérique Robin,47434,15450,Paul De Sousa,90778,122762,2022-10-06
TRANSFER,413421,Roland Colin,706276,292855,Paul De Sousa,122762,536183,2022-10-08
TRANSFER,11643,Vincent-Grégoire Brunet,73140,61497,Paul De Sousa,536183,547826,2022-10-10
CASH_IN,71701,Agence_moov_Ouidah,300000,228299,Paul De Sousa,547826,619527,2022-10-10
CASH_OUT,352201,Paul De Sousa,619527,267326,Agence_moov_Cotonou,300000,-52201,2022-10-16
TRANSFER,11485,Agnès Chrétien-Sanchez,387400,375915,Paul De Sousa,267326,278811,2022-10-17
TRANSFER,66180,Paul De Sousa,278811,212631,Marthe Guillet,95390,29210,2022-10-18
CASH_OUT,90440,Paul De Sousa,212631,122191,Agence_moov_Abomey,300000,209560,2022-10-19
TRANSFER,43611,Augustin Benard,1590300,1546689,Paul De Sousa,122191,165802,2022-10-19
TRANSFER,328087,Marc Gilbert,491589,163502,Paul De Sousa,165802,493889,2022-10-19
TRANSFER,487850,Paul De Sousa,493889,6039,David-Théodore Diaz,22929,-464921,2022-10-20
CASH_OUT,3213,Paul De Sousa,6039,2826,Agence_moov_Cotonou,300000,296787,2022-10-22
TRANSFER,119698,David Diallo,279500,159802,Paul De Sousa,2826,122524,2022-10-25
CASH_OUT,28093,Paul De Sousa,122524,94431,Agence_moov_Cotonou,300000,271907,2022-10-25
CASH_IN,64585,Agence_moov_Cotonou,300000,235415,Paul De Sousa,94431,159016,2022-10-25
CASH_IN,266548,Agence_moov_Abomey,300000,33452,Paul De Sousa,159016,425564,2022-10-25
CASH_IN,126898,Agence_moov_Ouidah,300000,173102,Lucy Vaillant,996700,1123598,2022-10-02
CASH_OUT,661054,Lucy Vaillant,1123598,462544,Agence_moov_Cotonou,300000,-361054,2022-10-02
TRANSFER,601359,Gilbert Bazin Le Guillet,1836216,1234857,Lucy Vaillant,462544,1063903,2022-10-03
CASH_OUT,814215,Lucy Vaillant,1063903,249688,Agence_moov_Cotonou,300000,-514215,2022-10-03
CASH_OUT,153082,Lucy Vaillant,249688,96606,Agence_moov_Ouidah,300000,146918,2022-10-04
CASH_OUT,75204,Lucy Vaillant,96606,21402,Agence_moov_Ouidah,300000,224796,2022-10-05
CASH_OUT,8897,Lucy Vaillant,21402,12505,Agence_moov_Ouidah,300000,291103,2022-10-06
CASH_IN,105246,Agence_moov_Cotonou,300000,194754,Lucy Vaillant,12505,117751,2022-10-08
TRANSFER,17055,Valentine Traore,1387000,1369945,Lucy Vaillant,117751,134806,2022-10-09
CASH_OUT,37581,Lucy Vaillant,134806,97225,Agence_moov_Ouidah,300000,262419,2022-10-09
CASH_IN,29150,Agence_moov_Cotonou,300000,270850,Lucy Vaillant,97225,126375,2022-10-10
CASH_IN,152861,Agence_moov_Abomey,300000,147139,Lucy Vaillant,126375,279236,2022-10-14
TRANSFER,785436,Alex Salmon,1484100,698664,Lucy Vaillant,279236,1064672,2022-10-17
CASH_IN,40671,Agence_moov_Abomey,300000,259329,Lucy Vaillant,1064672,1105343,2022-10-18
TRANSFER,121567,David Diallo,159802,38235,Lucy Vaillant,1105343,1226910,2022-10-22
CASH_IN,183708,Agence_moov_Cotonou,300000,116292,Lucy Vaillant,1226910,1410618,2022-10-23
TRANSFER,370843,Lucy Vaillant,1410618,1039775,Benoît Verdier,711426,340583,2022-10-23
CASH_OUT,628104,Lucy Vaillant,1039775,411671,Agence_moov_Abomey,300000,-328104,2022-10-24
CASH_IN,56732,Agence_moov_Ouidah,300000,243268,Lucy Vaillant,411671,468403,2022-10-25
TRANSFER,253500,Anastasie Louis,956200,702700,Lucy Vaillant,468403,721903,2022-10-25
TRANSFER,223223,Gilbert Bazin Le Guillet,1234857,1011634,Lucy Vaillant,721903,945126,2022-10-26
TRANSFER,289865,Roland Colin,292855,2990,Lucy Vaillant,945126,1234991,2022-10-27
CASH_IN,221916,Agence_moov_Cotonou,300000,78084,Stéphanie Bonneau,-91539,130377,2022-10-01
CASH_IN,38259,Agence_moov_Abomey,300000,261741,Stéphanie Bonneau,130377,168636,2022-10-02
CASH_OUT,87656,Stéphanie Bonneau,168636,80980,Agence_moov_Abomey,300000,212344,2022-10-03
CASH_OUT,13867,Stéphanie Bonneau,80980,67113,Agence_moov_Ouidah,300000,286133,2022-10-03
CASH_IN,96999,Agence_moov_Cotonou,300000,203001,Stéphanie Bonneau,67113,164112,2022-10-04
TRANSFER,602077,Guy Guyon,1042648,440571,Stéphanie Bonneau,164112,766189,2022-10-04
CASH_OUT,335058,Stéphanie Bonneau,766189,431131,Agence_moov_Abomey,300000,-35058,2022-10-05
TRANSFER,514240,Luc-Tristan Moreau,638200,123960,Stéphanie Bonneau,431131,945371,2022-10-06
CASH_IN,1219,Agence_moov_Cotonou,300000,298781,Stéphanie Bonneau,945371,946590,2022-10-06
CASH_OUT,696347,Stéphanie Bonneau,946590,250243,Agence_moov_Cotonou,300000,-396347,2022-10-07
TRANSFER,27964,Richard Guibert,30412,2448,Stéphanie Bonneau,250243,278207,2022-10-07
CASH_IN,204024,Agence_moov_Cotonou,300000,95976,Stéphanie Bonneau,278207,482231,2022-10-08
CASH_OUT,239961,Stéphanie Bonneau,482231,242270,Agence_moov_Ouidah,300000,60039,2022-10-08
CASH_OUT,87391,Stéphanie Bonneau,242270,154879,Agence_moov_Cotonou,300000,212609,2022-10-11
TRANSFER,294623,Benoît Verdier,340583,45960,Stéphanie Bonneau,154879,449502,2022-10-13
TRANSFER,262512,Agnès Chrétien-Sanchez,375915,113403,Stéphanie Bonneau,449502,712014,2022-10-13
CASH_OUT,196152,Stéphanie Bonneau,712014,515862,Agence_moov_Abomey,300000,103848,2022-10-15
CASH_IN,105193,Agence_moov_Cotonou,300000,194807,Stéphanie Bonneau,515862,621055,2022-10-17
TRANSFER,73203,Guy Guyon,440571,367368,Stéphanie Bonneau,621055,694258,2022-10-17
CASH_IN,132188,Agence_moov_Abomey,300000,167812,Stéphanie Bonneau,694258,826446,2022-10-17
TRANSFER,11112,Agnès Chrétien-Sanchez,113403,102291,Stéphanie Bonneau,826446,837558,2022-10-18
CASH_IN,154201,Agence_moov_Ouidah,300000,145799,Stéphanie Bonneau,837558,991759,2022-10-18
TRANSFER,44489,Vincent-Grégoire Brunet,61497,17008,Stéphanie Bonneau,991759,1036248,2022-10-21
CASH_OUT,179824,Stéphanie Bonneau,1036248,856424,Agence_moov_Abomey,300000,120176,2022-10-22
CASH_OUT,160154,Stéphanie Bonneau,856424,696270,Agence_moov_Cotonou,300000,139846,2022-10-22
CASH_IN,200096,Agence_moov_Abomey,300000,99904,Stéphanie Bonneau,696270,896366,2022-10-23
CASH_OUT,588329,Stéphanie Bonneau,896366,308037,Agence_moov_Ouidah,300000,-288329,2022-10-24
TRANSFER,633180,Isaac Le Pinto,729229,96049,Stéphanie Bonneau,308037,941217,2022-10-27
CASH_IN,81034,Agence_moov_Abomey,300000,218966,Stéphanie Bonneau,941217,1022251,2022-10-27
CASH_IN,26649,Agence_moov_Ouidah,300000,273351,Joseph de la Dubois,510514,537163,2022-10-01
TRANSFER,287277,Joseph de la Dubois,537163,249886,Roland Colin,2990,-284287,2022-10-01
CASH_OUT,69292,Joseph de la Dubois,249886,180594,Agence_moov_Cotonou,300000,230708,2022-10-02
CASH_OUT,15751,Joseph de la Dubois,180594,164843,Agence_moov_Cotonou,300000,284249,2022-10-06
TRANSFER,59464,Océane Boutin,280200,220736,Joseph de la Dubois,164843,224307,2022-10-06
TRANSFER,71207,Joseph de la Dubois,224307,153100,Caroline Peltier,674767,603560,2022-10-06
TRANSFER,150323,Joseph de la Dubois,153100,2777,Antoine Leroux,396000,245677,2022-10-11
TRANSFER,2412,Joseph de la Dubois,2777,365,Laurence Carlier,1498712,1496300,2022-10-12
TRANSFER,2298,Arnaude Gaillard,1531684,1529386,Joseph de la Dubois,365,2663,2022-10-12
CASH_OUT,2554,Joseph de la Dubois,2663,109,Agence_moov_Cotonou,300000,297446,2022-10-13
CASH_OUT,109,Joseph de la Dubois,109,0,Agence_moov_Abomey,300000,299891,2022-10-13
CASH_IN,102405,Agence_moov_Abomey,300000,197595,Joseph de la Dubois,0,102405,2022-10-14
CASH_OUT,48740,Joseph de la Dubois,102405,53665,Agence_moov_Cotonou,300000,251260,2022-10-14
CASH_IN,116592,Agence_moov_Abomey,300000,183408,Joseph de la Dubois,53665,170257,2022-10-15
TRANSFER,30402,Joseph de la Dubois,170257,139855,Marc Gilbert,163502,133100,2022-10-16
CASH_OUT,139098,Joseph de la Dubois,139855,757,Agence_moov_Cotonou,300000,160902,2022-10-17
TRANSFER,70838,Marc Gilbert,133100,62262,Joseph de la Dubois,757,71595,2022-10-17
CASH_OUT,63505,Joseph de la Dubois,71595,8090,Agence_moov_Ouidah,300000,236495,2022-10-17
CASH_OUT,7718,Joseph de la Dubois,8090,372,Agence_moov_Abomey,300000,292282,2022-10-18
CASH_IN,51585,Agence_moov_Ouidah,300000,248415,Joseph de la Dubois,372,51957,2022-10-21
CASH_OUT,24365,Joseph de la Dubois,51957,27592,Agence_moov_Ouidah,300000,275635,2022-10-22
TRANSFER,140330,Aimé Allain,1648600,1508270,Joseph de la Dubois,27592,167922,2022-10-23
CASH_OUT,46461,Joseph de la Dubois,167922,121461,Agence_moov_Ouidah,300000,253539,2022-10-27
TRANSFER,392207,Margot Renaud de Lacombe,450241,58034,Aimé Allain,1508270,1900477,2022-10-01
TRANSFER,1070966,Aimé Allain,1900477,829511,Théodore-Alfred Fournier,1655600,584634,2022-10-04
TRANSFER,216322,Aimé Allain,829511,613189,Joséphine Weber du Bonnin,207897,-8425,2022-10-07
CASH_IN,250342,Agence_moov_Ouidah,300000,49658,Aimé Allain,613189,863531,2022-10-08
CASH_OUT,126985,Aimé Allain,863531,736546,Agence_moov_Cotonou,300000,173015,2022-10-08
TRANSFER,616076,Aimé Allain,736546,120470,Guy Guyon,367368,-248708,2022-10-11
CASH_IN,20729,Agence_moov_Abomey,300000,279271,Aimé Allain,120470,141199,2022-10-11
CASH_IN,296980,Agence_moov_Abomey,300000,3020,Aimé Allain,141199,438179,2022-10-11
CASH_IN,295458,Agence_moov_Ouidah,300000,4542,Aimé Allain,438179,733637,2022-10-12
CASH_OUT,692053,Aimé Allain,733637,41584,Agence_moov_Ouidah,300000,-392053,2022-10-13
CASH_OUT,39517,Aimé Allain,41584,2067,Agence_moov_Abomey,300000,260483,2022-10-13
CASH_OUT,1434,Aimé Allain,2067,633,Agence_moov_Abomey,300000,298566,2022-10-15
CASH_OUT,569,Aimé Allain,633,64,Agence_moov_Cotonou,300000,299431,2022-10-16
CASH_IN,266862,Agence_moov_Abomey,300000,33138,Aimé Allain,64,266926,2022-10-18
CASH_OUT,121997,Aimé Allain,266926,144929,Agence_moov_Abomey,300000,178003,2022-10-19
CASH_IN,258049,Agence_moov_Cotonou,300000,41951,Aimé Allain,144929,402978,2022-10-21
CASH_OUT,29418,Aimé Allain,402978,373560,Agence_moov_Cotonou,300000,270582,2022-10-21
CASH_IN,95541,Agence_moov_Cotonou,300000,204459,Aimé Allain,373560,469101,2022-10-22
TRANSFER,148418,Aimé Allain,469101,320683,Sébastien Jourdan,293300,144882,2022-10-23
CASH_IN,222214,Agence_moov_Abomey,300000,77786,Aimé Allain,320683,542897,2022-10-25
TRANSFER,45374,Arnaude Gaillard,1529386,1484012,Aimé Allain,542897,588271,2022-10-26
CASH_IN,24453,Agence_moov_Ouidah,300000,275547,Théophile Mendès,-604982,-580529,2022-10-01
CASH_IN,251653,Agence_moov_Abomey,300000,48347,Théophile Mendès,-580529,-328876,2022-10-04
CASH_IN,37599,Agence_moov_Cotonou,300000,262401,Théophile Mendès,-328876,-291277,2022-10-05
CASH_IN,248244,Agence_moov_Cotonou,300000,51756,Théophile Mendès,-291277,-43033,2022-10-07
CASH_IN,185883,Agence_moov_Ouidah,300000,114117,Théophile Mendès,-43033,142850,2022-10-08
TRANSFER,112774,Théophile Mendès,142850,30076,Anastasie Louis,702700,589926,2022-10-09
TRANSFER,346078,Noémi de la Didier,835161,489083,Théophile Mendès,30076,376154,2022-10-11
CASH_OUT,209389,Théophile Mendès,376154,166765,Agence_moov_Cotonou,300000,90611,2022-10-13
CASH_OUT,127025,Théophile Mendès,166765,39740,Agence_moov_Cotonou,300000,172975,2022-10-13
CASH_IN,49674,Agence_moov_Ouidah,300000,250326,Théophile Mendès,39740,89414,2022-10-15
TRANSFER,56190,Théophile Mendès,89414,33224,Matthieu Renard,67919,11729,2022-10-17
TRANSFER,9700,Théophile Mendès,33224,23524,Maurice Seguin,830247,820547,2022-10-17
TRANSFER,21579,Théophile Mendès,23524,1945,Théodore-Alfred Fournier,584634,563055,2022-10-18
TRANSFER,442,Théophile Mendès,1945,1503,Richard Guibert,2448,2006,2022-10-19
CASH_OUT,505,Théophile Mendès,1503,998,Agence_moov_Cotonou,300000,299495,2022-10-20
CASH_IN,130110,Agence_moov_Cotonou,300000,169890,Théophile Mendès,998,131108,2022-10-20
CASH_OUT,81940,Théophile Mendès,131108,49168,Agence_moov_Cotonou,300000,218060,2022-10-21
CASH_IN,151605,Agence_moov_Cotonou,300000,148395,Théophile Mendès,49168,200773,2022-10-22
CASH_OUT,191819,Théophile Mendès,200773,8954,Agence_moov_Ouidah,300000,108181,2022-10-23
CASH_IN,268088,Agence_moov_Abomey,300000,31912,Théophile Mendès,8954,277042,2022-10-23
CASH_IN,187072,Agence_moov_Cotonou,300000,112928,Théophile Mendès,277042,464114,2022-10-24
CASH_IN,20707,Agence_moov_Ouidah,300000,279293,Théophile Mendès,464114,484821,2022-10-24
CASH_IN,53874,Agence_moov_Cotonou,300000,246126,Théophile Mendès,484821,538695,2022-10-25
CASH_OUT,535270,Théophile Mendès,538695,3425,Agence_moov_Abomey,300000,-235270,2022-10-27
CASH_IN,280002,Agence_moov_Cotonou,300000,19998,Isaac Le Pinto,96049,376051,2022-10-01
CASH_OUT,262045,Isaac Le Pinto,376051,114006,Agence_moov_Ouidah,300000,37955,2022-10-01
CASH_IN,278823,Agence_moov_Ouidah,300000,21177,Isaac Le Pinto,114006,392829,2022-10-02
TRANSFER,34243,Émilie Guillon de Duhamel,996814,962571,Isaac Le Pinto,392829,427072,2022-10-03
TRANSFER,4976,Matthieu Renard,11729,6753,Isaac Le Pinto,427072,432048,2022-10-05
CASH_OUT,190330,Isaac Le Pinto,432048,241718,Agence_moov_Ouidah,300000,109670,2022-10-06
CASH_OUT,112065,Isaac Le Pinto,241718,129653,Agence_moov_Cotonou,300000,187935,2022-10-06
TRANSFER,23198,Luc-Tristan Moreau,123960,100762,Isaac Le Pinto,129653,152851,2022-10-06
CASH_IN,116636,Agence_moov_Cotonou,300000,183364,Isaac Le Pinto,152851,269487,2022-10-06
TRANSFER,74674,Isaac Le Pinto,269487,194813,Gabriel de Pineau,1506064,1431390,2022-10-07
CASH_IN,48127,Agence_moov_Cotonou,300000,251873,Isaac Le Pinto,194813,242940,2022-10-08
CASH_IN,151080,Agence_moov_Cotonou,300000,148920,Isaac Le Pinto,242940,394020,2022-10-08
TRANSFER,207448,Isaac Le Pinto,394020,186572,Alexandre Poirier,647200,439752,2022-10-09
TRANSFER,106072,Isaac Le Pinto,186572,80500,Laurence Carlier,1496300,1390228,2022-10-10
CASH_IN,9463,Agence_moov_Ouidah,300000,290537,Isaac Le Pinto,80500,89963,2022-10-11
CASH_IN,276860,Agence_moov_Ouidah,300000,23140,Isaac Le Pinto,89963,366823,2022-10-13
CASH_OUT,239783,Isaac Le Pinto,366823,127040,Agence_moov_Cotonou,300000,60217,2022-10-13
CASH_OUT,57890,Isaac Le Pinto,127040,69150,Agence_moov_Cotonou,300000,242110,2022-10-14
CASH_IN,53372,Agence_moov_Cotonou,300000,246628,Isaac Le Pinto,69150,122522,2022-10-15
TRANSFER,98896,Isaac Le Pinto,122522,23626,Marc Gilbert,62262,-36634,2022-10-17
CASH_IN,234807,Agence_moov_Ouidah,300000,65193,Isaac Le Pinto,23626,258433,2022-10-17
CASH_OUT,110856,Isaac Le Pinto,258433,147577,Agence_moov_Abomey,300000,189144,2022-10-19
CASH_OUT,28451,Isaac Le Pinto,147577,119126,Agence_moov_Ouidah,300000,271549,2022-10-20
CASH_IN,90933,Agence_moov_Cotonou,300000,209067,Isaac Le Pinto,119126,210059,2022-10-23
CASH_IN,187856,Agence_moov_Cotonou,300000,112144,Isaac Le Pinto,210059,397915,2022-10-24
TRANSFER,113506,Anastasie Louis,589926,476420,Isaac Le Pinto,397915,511421,2022-10-24
CASH_OUT,186958,Isaac Le Pinto,511421,324463,Agence_moov_Cotonou,300000,113042,2022-10-26
TRANSFER,50865,Isaac Le Pinto,324463,273598,Margot Renaud de Lacombe,58034,7169,2022-10-26
CASH_IN,42894,Agence_moov_Ouidah,300000,257106,Isaac Le Pinto,273598,316492,2022-10-27
CASH_IN,20572,Agence_moov_Cotonou,300000,279428,Jacques-Antoine Gros,-94602,-74030,2022-10-01
CASH_IN,6161,Agence_moov_Cotonou,300000,293839,Jacques-Antoine Gros,-74030,-67869,2022-10-02
CASH_IN,28683,Agence_moov_Ouidah,300000,271317,Jacques-Antoine Gros,-67869,-39186,2022-10-03
CASH_IN,205854,Agence_moov_Abomey,300000,94146,Jacques-Antoine Gros,-39186,166668,2022-10-03
CASH_IN,32960,Agence_moov_Abomey,300000,267040,Jacques-Antoine Gros,166668,199628,2022-10-04
CASH_IN,62202,Agence_moov_Abomey,300000,237798,Jacques-Antoine Gros,199628,261830,2022-10-06
CASH_OUT,185594,Jacques-Antoine Gros,261830,76236,Agence_moov_Cotonou,300000,114406,2022-10-08
TRANSFER,635963,Paul Pereira,1525311,889348,Jacques-Antoine Gros,76236,712199,2022-10-10
CASH_OUT,407778,Jacques-Antoine Gros,712199,304421,Agence_moov_Cotonou,300000,-107778,2022-10-10
CASH_OUT,129949,Jacques-Antoine Gros,304421,174472,Agence_moov_Ouidah,300000,170051,2022-10-12
CASH_IN,147987,Agence_moov_Cotonou,300000,152013,Jacques-Antoine Gros,174472,322459,2022-10-12
CASH_IN,288304,Agence_moov_Cotonou,300000,11696,Jacques-Antoine Gros,322459,610763,2022-10-13
CASH_IN,22166,Agence_moov_Abomey,300000,277834,Jacques-Antoine Gros,610763,632929,2022-10-13
CASH_OUT,53881,Jacques-Antoine Gros,632929,579048,Agence_moov_Ouidah,300000,246119,2022-10-15
TRANSFER,392198,Jacques-Antoine Gros,579048,186850,Jacques-Antoine Gros,579048,971246,2022-10-16
CASH_OUT,114101,Jacques-Antoine Gros,186850,72749,Agence_moov_Cotonou,300000,185899,2022-10-18
CASH_IN,266935,Agence_moov_Ouidah,300000,33065,Jacques-Antoine Gros,72749,339684,2022-10-19
CASH_IN,139203,Agence_moov_Abomey,300000,160797,Jacques-Antoine Gros,339684,478887,2022-10-19
TRANSFER,416613,Jacques-Antoine Gros,478887,62274,Caroline Peltier,603560,186947,2022-10-22
CASH_IN,94748,Agence_moov_Ouidah,300000,205252,Jacques-Antoine Gros,62274,157022,2022-10-22
CASH_IN,279649,Agence_moov_Cotonou,300000,20351,Jacques-Antoine Gros,157022,436671,2022-10-26
CASH_OUT,219307,Jacques-Antoine Gros,436671,217364,Agence_moov_Cotonou,300000,80693,2022-10-26
CASH_OUT,28974,Marthe Guillet,29210,236,Agence_moov_Cotonou,300000,271026,2022-10-03
TRANSFER,536566,Laurent Besson,1620432,1083866,Marthe Guillet,236,536802,2022-10-05
TRANSFER,1036114,Amélie Gros-Riou,1165300,129186,Marthe Guillet,536802,1572916,2022-10-05
TRANSFER,1225457,Marthe Guillet,1572916,347459,Richard Guibert,2006,-1223451,2022-10-05
TRANSFER,346757,Marthe Guillet,347459,702,Diane-Françoise Raynaud,186129,-160628,2022-10-05
CASH_IN,76503,Agence_moov_Cotonou,300000,223497,Marthe Guillet,702,77205,2022-10-06
CASH_OUT,60972,Marthe Guillet,77205,16233,Agence_moov_Cotonou,300000,239028,2022-10-07
CASH_IN,77651,Agence_moov_Cotonou,300000,222349,Marthe Guillet,16233,93884,2022-10-08
CASH_OUT,58129,Marthe Guillet,93884,35755,Agence_moov_Ouidah,300000,241871,2022-10-08
TRANSFER,181410,Alexandre Poirier,439752,258342,Marthe Guillet,35755,217165,2022-10-08
TRANSFER,73181,Marthe Guillet,217165,143984,Arnaude Gaillard,1484012,1410831,2022-10-08
CASH_OUT,95235,Marthe Guillet,143984,48749,Agence_moov_Cotonou,300000,204765,2022-10-09
CASH_IN,211137,Agence_moov_Cotonou,300000,88863,Marthe Guillet,48749,259886,2022-10-09
CASH_OUT,107428,Marthe Guillet,259886,152458,Agence_moov_Abomey,300000,192572,2022-10-11
CASH_OUT,78133,Marthe Guillet,152458,74325,Agence_moov_Ouidah,300000,221867,2022-10-12
CASH_OUT,72076,Marthe Guillet,74325,2249,Agence_moov_Ouidah,300000,227924,2022-10-18
CASH_OUT,2225,Marthe Guillet,2249,24,Agence_moov_Abomey,300000,297775,2022-10-18
CASH_IN,75378,Agence_moov_Ouidah,300000,224622,Marthe Guillet,24,75402,2022-10-18
CASH_IN,138144,Agence_moov_Cotonou,300000,161856,Marthe Guillet,75402,213546,2022-10-19
TRANSFER,1656843,Caroline Bonneau,1833478,176635,Marthe Guillet,213546,1870389,2022-10-20
CASH_OUT,1028385,Marthe Guillet,1870389,842004,Agence_moov_Cotonou,300000,-728385,2022-10-20
TRANSFER,783108,Marthe Guillet,842004,58896,Antoine Leroux,245677,-537431,2022-10-20
TRANSFER,226379,Paul Pereira,889348,662969,Marthe Guillet,58896,285275,2022-10-21
CASH_OUT,35036,Marthe Guillet,285275,250239,Agence_moov_Abomey,300000,264964,2022-10-22
TRANSFER,180293,Marthe Guillet,250239,69946,Luc-Tristan Moreau,100762,-79531,2022-10-25
CASH_OUT,21064,Marthe Guillet,69946,48882,Agence_moov_Abomey,300000,278936,2022-10-26
CASH_OUT,10688,Frédérique Robin,15450,4762,Agence_moov_Cotonou,300000,289312,2022-10-01
CASH_IN,228847,Agence_moov_Ouidah,300000,71153,Frédérique Robin,4762,233609,2022-10-01
CASH_OUT,222179,Frédérique Robin,233609,11430,Agence_moov_Abomey,300000,77821,2022-10-03
CASH_IN,9594,Agence_moov_Abomey,300000,290406,Frédérique Robin,11430,21024,2022-10-05
CASH_IN,296380,Agence_moov_Ouidah,300000,3620,Frédérique Robin,21024,317404,2022-10-06
CASH_IN,219358,Agence_moov_Abomey,300000,80642,Frédérique Robin,317404,536762,2022-10-06
CASH_OUT,192050,Frédérique Robin,536762,344712,Agence_moov_Ouidah,300000,107950,2022-10-09
TRANSFER,1320,Paulette Dias,3216,1896,Frédérique Robin,344712,346032,2022-10-10
CASH_OUT,311535,Frédérique Robin,346032,34497,Agence_moov_Abomey,300000,-11535,2022-10-10
TRANSFER,49883,Juliette Evrard Le Giraud,59300,9417,Frédérique Robin,34497,84380,2022-10-10
TRANSFER,50743,Frédérique Robin,84380,33637,Augustin Benard,1546689,1495946,2022-10-12
CASH_IN,183542,Agence_moov_Ouidah,300000,116458,Frédérique Robin,33637,217179,2022-10-14
TRANSFER,211540,Frédérique Robin,217179,5639,Agnès Chrétien-Sanchez,102291,-109249,2022-10-16
CASH_OUT,3790,Frédérique Robin,5639,1849,Agence_moov_Ouidah,300000,296210,2022-10-17
CASH_IN,273836,Agence_moov_Abomey,300000,26164,Frédérique Robin,1849,275685,2022-10-19
CASH_OUT,141181,Frédérique Robin,275685,134504,Agence_moov_Cotonou,300000,158819,2022-10-19
CASH_IN,49167,Agence_moov_Cotonou,300000,250833,Frédérique Robin,134504,183671,2022-10-19
CASH_IN,137235,Agence_moov_Abomey,300000,162765,Frédérique Robin,183671,320906,2022-10-21
CASH_OUT,265717,Frédérique Robin,320906,55189,Agence_moov_Abomey,300000,34283,2022-10-22
CASH_OUT,34548,Frédérique Robin,55189,20641,Agence_moov_Abomey,300000,265452,2022-10-23
CASH_OUT,1291,Frédérique Robin,20641,19350,Agence_moov_Cotonou,300000,298709,2022-10-26
CASH_IN,64863,Agence_moov_Ouidah,300000,235137,Roland Colin,-284287,-219424,2022-10-01
CASH_IN,142898,Agence_moov_Abomey,300000,157102,Roland Colin,-219424,-76526,2022-10-02
CASH_IN,297094,Agence_moov_Cotonou,300000,2906,Roland Colin,-76526,220568,2022-10-03
CASH_IN,42661,Agence_moov_Ouidah,300000,257339,Roland Colin,220568,263229,2022-10-04
CASH_IN,220543,Agence_moov_Ouidah,300000,79457,Roland Colin,263229,483772,2022-10-07
CASH_OUT,230774,Roland Colin,483772,252998,Agence_moov_Cotonou,300000,69226,2022-10-08
CASH_OUT,168664,Roland Colin,252998,84334,Agence_moov_Cotonou,300000,131336,2022-10-09
CASH_OUT,45026,Roland Colin,84334,39308,Agence_moov_Cotonou,300000,254974,2022-10-09
CASH_IN,129320,Agence_moov_Cotonou,300000,170680,Roland Colin,39308,168628,2022-10-10
CASH_IN,88989,Agence_moov_Cotonou,300000,211011,Roland Colin,168628,257617,2022-10-10
TRANSFER,368904,Maurice Seguin,820547,451643,Roland Colin,257617,626521,2022-10-13
TRANSFER,303973,Nicolas Hervé,1005000,701027,Roland Colin,626521,930494,2022-10-14
CASH_IN,32582,Agence_moov_Cotonou,300000,267418,Roland Colin,930494,963076,2022-10-15
CASH_IN,55935,Agence_moov_Cotonou,300000,244065,Roland Colin,963076,1019011,2022-10-17
TRANSFER,288973,Roland Colin,1019011,730038,Valentine Traore,1369945,1080972,2022-10-17
TRANSFER,414499,Roland Colin,730038,315539,Sabine Imbert,1445100,1030601,2022-10-17
CASH_OUT,4812,Roland Colin,315539,310727,Agence_moov_Cotonou,300000,295188,2022-10-19
CASH_OUT,34062,Roland Colin,310727,276665,Agence_moov_Cotonou,300000,265938,2022-10-19
TRANSFER,373384,Valentine Traore,1080972,707588,Roland Colin,276665,650049,2022-10-20
CASH_OUT,42885,Roland Colin,650049,607164,Agence_moov_Abomey,300000,257115,2022-10-20
CASH_OUT,15694,Roland Colin,607164,591470,Agence_moov_Ouidah,300000,284306,2022-10-20
CASH_IN,74314,Agence_moov_Cotonou,300000,225686,Roland Colin,591470,665784,2022-10-20
CASH_IN,261719,Agence_moov_Cotonou,300000,38281,Roland Colin,665784,927503,2022-10-21
TRANSFER,204278,Gilbert Bazin Le Guillet,1011634,807356,Roland Colin,927503,1131781,2022-10-21
CASH_IN,143643,Agence_moov_Ouidah,300000,156357,Roland Colin,1131781,1275424,2022-10-22
TRANSFER,54189,Nicolas Grondin de la Pinto,101732,47543,Roland Colin,1275424,1329613,2022-10-24
CASH_OUT,859882,Roland Colin,1329613,469731,Agence_moov_Ouidah,300000,-559882,2022-10-25
TRANSFER,1062897,Gabriel de Pineau,1431390,368493,Roland Colin,469731,1532628,2022-10-27
CASH_OUT,206754,Valentine Traore,707588,500834,Agence_moov_Ouidah,300000,93246,2022-10-01
CASH_OUT,485288,Valentine Traore,500834,15546,Agence_moov_Abomey,300000,-185288,2022-10-01
CASH_OUT,3021,Valentine Traore,15546,12525,Agence_moov_Abomey,300000,296979,2022-10-01
CASH_OUT,8072,Valentine Traore,12525,4453,Agence_moov_Cotonou,300000,291928,2022-10-02
CASH_IN,57869,Agence_moov_Ouidah,300000,242131,Valentine Traore,4453,62322,2022-10-02
TRANSFER,486306,Émilie Guillon de Duhamel,962571,476265,Valentine Traore,62322,548628,2022-10-05
CASH_OUT,321697,Valentine Traore,548628,226931,Agence_moov_Ouidah,300000,-21697,2022-10-06
TRANSFER,102529,Alexandre Poirier,258342,155813,Valentine Traore,226931,329460,2022-10-07
TRANSFER,4715,Matthieu Renard,6753,2038,Valentine Traore,329460,334175,2022-10-08
CASH_IN,38979,Agence_moov_Cotonou,300000,261021,Valentine Traore,334175,373154,2022-10-09
CASH_IN,14094,Agence_moov_Abomey,300000,285906,Valentine Traore,373154,387248,2022-10-10
CASH_IN,7722,Agence_moov_Cotonou,300000,292278,Valentine Traore,387248,394970,2022-10-13
CASH_IN,146091,Agence_moov_Ouidah,300000,153909,Valentine Traore,394970,541061,2022-10-14
CASH_OUT,356571,Valentine Traore,541061,184490,Agence_moov_Cotonou,300000,-56571,2022-10-17
TRANSFER,23898,Valentine Traore,184490,160592,Christophe Guilbert,468451,444553,2022-10-18
TRANSFER,11454,Valentine Traore,160592,149138,Nathalie-Chantal Jacques,868332,856878,2022-10-18
CASH_OUT,90896,Valentine Traore,149138,58242,Agence_moov_Abomey,300000,209104,2022-10-19
TRANSFER,30007,Valentine Traore,58242,28235,Juliette Evrard Le Giraud,9417,-20590,2022-10-19
CASH_OUT,17016,Valentine Traore,28235,11219,Agence_moov_Abomey,300000,282984,2022-10-20
CASH_OUT,7655,Valentine Traore,11219,3564,Agence_moov_Abomey,300000,292345,2022-10-22
CASH_OUT,3234,Valentine Traore,3564,330,Agence_moov_Cotonou,300000,296766,2022-10-22
CASH_IN,134396,Agence_moov_Abomey,300000,165604,Valentine Traore,330,134726,2022-10-22
CASH_IN,145457,Agence_moov_Abomey,300000,154543,Valentine Traore,134726,280183,2022-10-23
CASH_IN,174389,Agence_moov_Ouidah,300000,125611,Valentine Traore,280183,454572,2022-10-23
CASH_IN,65033,Agence_moov_Ouidah,300000,234967,Valentine Traore,454572,519605,2022-10-24
CASH_IN,165114,Agence_moov_Abomey,300000,134886,Valentine Traore,519605,684719,2022-10-24
TRANSFER,655103,Valentine Traore,684719,29616,Paulette Dias,1896,-653207,2022-10-25
TRANSFER,246004,Nath Léger,577658,331654,Valentine Traore,29616,275620,2022-10-26
CASH_IN,181181,Agence_moov_Ouidah,300000,118819,Valentine Traore,275620,456801,2022-10-26
TRANSFER,595749,Arnaude Gaillard,1410831,815082,Arnaude Gaillard,1410831,815082,2022-10-03
CASH_IN,286777,Agence_moov_Cotonou,300000,13223,Arnaude Gaillard,815082,1101859,2022-10-03
TRANSFER,127897,Océane Boutin,220736,92839,Arnaude Gaillard,1101859,1229756,2022-10-05
CASH_OUT,792763,Arnaude Gaillard,1229756,436993,Agence_moov_Cotonou,300000,-492763,2022-10-05
CASH_OUT,111219,Arnaude Gaillard,436993,325774,Agence_moov_Ouidah,300000,188781,2022-10-06
CASH_IN,204273,Agence_moov_Abomey,300000,95727,Arnaude Gaillard,325774,530047,2022-10-06
TRANSFER,117218,Caroline Bonneau,176635,59417,Arnaude Gaillard,530047,647265,2022-10-06
TRANSFER,603703,Nicolas Hervé,701027,97324,Arnaude Gaillard,647265,1250968,2022-10-11
CASH_OUT,1078403,Arnaude Gaillard,1250968,172565,Agence_moov_Cotonou,300000,-778403,2022-10-11
CASH_IN,143942,Agence_moov_Ouidah,300000,156058,Arnaude Gaillard,172565,316507,2022-10-12
CASH_OUT,216793,Arnaude Gaillard,316507,99714,Agence_moov_Abomey,300000,83207,2022-10-12
TRANSFER,63520,Arnaude Gaillard,99714,36194,Arnaude Gaillard,99714,36194,2022-10-13
CASH_IN,88716,Agence_moov_Abomey,300000,211284,Arnaude Gaillard,36194,124910,2022-10-14
TRANSFER,118951,Laurent Perrot,1208668,1089717,Arnaude Gaillard,124910,243861,2022-10-14
CASH_IN,60374,Agence_moov_Abomey,300000,239626,Arnaude Gaillard,243861,304235,2022-10-14
TRANSFER,41510,Arnaude Gaillard,304235,262725,Nicolas Hervé,97324,55814,2022-10-17
TRANSFER,381041,Théodore-Alfred Fournier,563055,182014,Arnaude Gaillard,262725,643766,2022-10-17
CASH_IN,148174,Agence_moov_Cotonou,300000,151826,Arnaude Gaillard,643766,791940,2022-10-18
CASH_IN,249211,Agence_moov_Abomey,300000,50789,Arnaude Gaillard,791940,1041151,2022-10-18
CASH_OUT,965031,Arnaude Gaillard,1041151,76120,Agence_moov_Cotonou,300000,-665031,2022-10-18
TRANSFER,116016,Nath Léger,331654,215638,Arnaude Gaillard,76120,192136,2022-10-20
TRANSFER,771290,Laurence Carlier,1390228,618938,Arnaude Gaillard,192136,963426,2022-10-21
CASH_OUT,324867,Arnaude Gaillard,963426,638559,Agence_moov_Ouidah,300000,-24867,2022-10-21
CASH_IN,112934,Agence_moov_Cotonou,300000,187066,Arnaude Gaillard,638559,751493,2022-10-22
TRANSFER,46020,Caroline Peltier,186947,140927,Arnaude Gaillard,751493,797513,2022-10-23
TRANSFER,123407,Émilie Guillon de Duhamel,476265,352858,Arnaude Gaillard,797513,920920,2022-10-24
CASH_IN,23058,Agence_moov_Cotonou,300000,276942,Arnaude Gaillard,920920,943978,2022-10-25
CASH_IN,185695,Agence_moov_Abomey,300000,114305,Arnaude Gaillard,943978,1129673,2022-10-27
CASH_OUT,1011111,Arnaude Gaillard,1129673,118562,Agence_moov_Cotonou,300000,-711111,2022-10-27
TRANSFER,480405,Noémi de la Didier,489083,8678,Arnaude Gaillard,118562,598967,2022-10-27
CASH_IN,119479,Agence_moov_Ouidah,300000,180521,Agnès Chrétien-Sanchez,-109249,10230,2022-10-01
TRANSFER,1640,Agnès Chrétien-Sanchez,10230,8590,Noémi de la Didier,8678,7038,2022-10-03
CASH_OUT,5414,Agnès Chrétien-Sanchez,8590,3176,Agence_moov_Abomey,300000,294586,2022-10-09
TRANSFER,1564,Agnès Chrétien-Sanchez,3176,1612,Gabriel de Pineau,368493,366929,2022-10-12
CASH_IN,174459,Agence_moov_Cotonou,300000,125541,Agnès Chrétien-Sanchez,1612,176071,2022-10-12
CASH_OUT,4989,Agnès Chrétien-Sanchez,176071,171082,Agence_moov_Cotonou,300000,295011,2022-10-13
CASH_IN,268423,Agence_moov_Abomey,300000,31577,Agnès Chrétien-Sanchez,171082,439505,2022-10-16
CASH_OUT,225467,Agnès Chrétien-Sanchez,439505,214038,Agence_moov_Ouidah,300000,74533,2022-10-21
TRANSFER,60216,Agnès Chrétien-Sanchez,214038,153822,Nicolas Grondin de la Pinto,47543,-12673,2022-10-25
CASH_IN,291947,Agence_moov_Ouidah,300000,8053,Juliette Evrard Le Giraud,-20590,271357,2022-10-01
CASH_IN,171460,Agence_moov_Cotonou,300000,128540,Juliette Evrard Le Giraud,271357,442817,2022-10-04
CASH_IN,97956,Agence_moov_Ouidah,300000,202044,Juliette Evrard Le Giraud,442817,540773,2022-10-08
CASH_IN,189240,Agence_moov_Abomey,300000,110760,Juliette Evrard Le Giraud,540773,730013,2022-10-13
TRANSFER,16428,Caroline Peltier,140927,124499,Juliette Evrard Le Giraud,730013,746441,2022-10-16
CASH_IN,172901,Agence_moov_Abomey,300000,127099,Juliette Evrard Le Giraud,746441,919342,2022-10-19
TRANSFER,46497,Juliette Evrard Le Giraud,919342,872845,Nicolas Hervé,55814,9317,2022-10-19
TRANSFER,26438,Benoît Verdier,45960,19522,Juliette Evrard Le Giraud,872845,899283,2022-10-25
CASH_IN,6953,Agence_moov_Abomey,300000,293047,Guy Guyon,-248708,-241755,2022-10-01
CASH_IN,160614,Agence_moov_Ouidah,300000,139386,Guy Guyon,-241755,-81141,2022-10-04
CASH_IN,241439,Agence_moov_Cotonou,300000,58561,Guy Guyon,-81141,160298,2022-10-05
CASH_IN,90396,Agence_moov_Cotonou,300000,209604,Guy Guyon,160298,250694,2022-10-07
CASH_OUT,144893,Guy Guyon,250694,105801,Agence_moov_Ouidah,300000,155107,2022-10-10
CASH_IN,187464,Agence_moov_Cotonou,300000,112536,Guy Guyon,105801,293265,2022-10-10
CASH_IN,90579,Agence_moov_Abomey,300000,209421,Guy Guyon,293265,383844,2022-10-11
CASH_IN,145980,Agence_moov_Abomey,300000,154020,Guy Guyon,383844,529824,2022-10-11
CASH_IN,176579,Agence_moov_Cotonou,300000,123421,Guy Guyon,529824,706403,2022-10-13
TRANSFER,303904,Guy Guyon,706403,402499,Alex Salmon,698664,394760,2022-10-13
CASH_OUT,70619,Guy Guyon,402499,331880,Agence_moov_Abomey,300000,229381,2022-10-14
CASH_IN,87471,Agence_moov_Abomey,300000,212529,Guy Guyon,331880,419351,2022-10-14
CASH_IN,187716,Agence_moov_Abomey,300000,112284,Guy Guyon,419351,607067,2022-10-14
CASH_IN,98881,Agence_moov_Cotonou,300000,201119,Guy Guyon,607067,705948,2022-10-17
CASH_OUT,667497,Guy Guyon,705948,38451,Agence_moov_Cotonou,300000,-367497,2022-10-17
CASH_OUT,31919,Guy Guyon,38451,6532,Agence_moov_Abomey,300000,268081,2022-10-19
CASH_IN,279109,Agence_moov_Ouidah,300000,20891,Guy Guyon,6532,285641,2022-10-20
CASH_IN,271135,Agence_moov_Ouidah,300000,28865,Guy Guyon,285641,556776,2022-10-25
TRANSFER,527564,Guy Guyon,556776,29212,Agnès Baron,1079166,551602,2022-10-26
TRANSFER,73416,Agnès Baron,551602,478186,Guy Guyon,29212,102628,2022-10-27
CASH_IN,90300,Agence_moov_Abomey,300000,209700,Laurence Carlier,618938,709238,2022-10-03
CASH_OUT,637650,Laurence Carlier,709238,71588,Agence_moov_Cotonou,300000,-337650,2022-10-03
TRANSFER,5859,Vincent-Grégoire Brunet,17008,11149,Laurence Carlier,71588,77447,2022-10-05
CASH_IN,143674,Agence_moov_Ouidah,300000,156326,Laurence Carlier,77447,221121,2022-10-14
CASH_IN,25312,Agence_moov_Cotonou,300000,274688,Laurence Carlier,221121,246433,2022-10-19
CASH_OUT,77865,Laurence Carlier,246433,168568,Agence_moov_Ouidah,300000,222135,2022-10-20
CASH_IN,293877,Agence_moov_Abomey,300000,6123,Laurence Carlier,168568,462445,2022-10-20
CASH_OUT,146890,Laurence Carlier,462445,315555,Agence_moov_Ouidah,300000,153110,2022-10-21
CASH_IN,75627,Agence_moov_Cotonou,300000,224373,Laurence Carlier,315555,391182,2022-10-22
TRANSFER,102488,Sébastien Jourdan,144882,42394,Laurence Carlier,391182,493670,2022-10-23
CASH_IN,26002,Agence_moov_Cotonou,300000,273998,Laurence Carlier,493670,519672,2022-10-24
CASH_IN,383,Agence_moov_Cotonou,300000,299617,Laurence Carlier,519672,520055,2022-10-25
TRANSFER,157403,Laurence Carlier,520055,362652,Alexandre Poirier,155813,-1590,2022-10-25
TRANSFER,12249,David Diallo,38235,25986,Laurent Perrot,1089717,1077468,2022-10-01
TRANSFER,8317,David Diallo,25986,17669,Maurice Seguin,451643,443326,2022-10-03
CASH_OUT,3236,David Diallo,17669,14433,Agence_moov_Ouidah,300000,296764,2022-10-03
TRANSFER,8448,David Diallo,14433,5985,Agnès Baron,478186,469738,2022-10-03
TRANSFER,1685,David Diallo,5985,4300,Océane Boutin,92839,91154,2022-10-05
CASH_OUT,4003,David Diallo,4300,297,Agence_moov_Cotonou,300000,295997,2022-10-06
CASH_OUT,271,David Diallo,297,26,Agence_moov_Ouidah,300000,299729,2022-10-07
CASH_IN,51475,Agence_moov_Ouidah,300000,248525,David Diallo,26,51501,2022-10-11
CASH_OUT,29621,David Diallo,51501,21880,Agence_moov_Abomey,300000,270379,2022-10-11
CASH_OUT,13257,David Diallo,21880,8623,Agence_moov_Abomey,300000,286743,2022-10-13
TRANSFER,2835,David Diallo,8623,5788,Océane Boutin,91154,88319,2022-10-17
TRANSFER,393,Noémi de la Didier,7038,6645,David Diallo,5788,6181,2022-10-19
CASH_IN,199967,Agence_moov_Abomey,300000,100033,David Diallo,6181,206148,2022-10-21
TRANSFER,157869,David Diallo,206148,48279,Anastasie Louis,476420,318551,2022-10-22
CASH_IN,293109,Agence_moov_Ouidah,300000,6891,David Diallo,48279,341388,2022-10-23
CASH_OUT,124251,David Diallo,341388,217137,Agence_moov_Abomey,300000,175749,2022-10-25
CASH_OUT,179171,David Diallo,217137,37966,Agence_moov_Abomey,300000,120829,2022-10-27
CASH_IN,82409,Agence_moov_Abomey,300000,217591,Luc-Tristan Moreau,-79531,2878,2022-10-01
TRANSFER,468,Luc-Tristan Moreau,2878,2410,Gabriel de Pineau,366929,366461,2022-10-10
TRANSFER,6048,Nicolas Hervé,9317,3269,Luc-Tristan Moreau,2410,8458,2022-10-14
CASH_OUT,584,Luc-Tristan Moreau,8458,7874,Agence_moov_Cotonou,300000,299416,2022-10-20
TRANSFER,386264,Agnès Baron,469738,83474,Luc-Tristan Moreau,7874,394138,2022-10-20
CASH_OUT,95153,Luc-Tristan Moreau,394138,298985,Agence_moov_Ouidah,300000,204847,2022-10-26
CASH_IN,201714,Agence_moov_Ouidah,300000,98286,Luc-Tristan Moreau,298985,500699,2022-10-26
CASH_IN,152007,Agence_moov_Abomey,300000,147993,Sébastien Jourdan,42394,194401,2022-10-01
TRANSFER,14631,Nath Léger,215638,201007,Sébastien Jourdan,194401,209032,2022-10-02
CASH_IN,194733,Agence_moov_Abomey,300000,105267,Sébastien Jourdan,209032,403765,2022-10-02
TRANSFER,142449,Sébastien Jourdan,403765,261316,Gilbert Bazin Le Guillet,807356,664907,2022-10-06
TRANSFER,68943,Amélie Gros-Riou,129186,60243,Sébastien Jourdan,261316,330259,2022-10-09
CASH_OUT,55701,Sébastien Jourdan,330259,274558,Agence_moov_Ouidah,300000,244299,2022-10-09
CASH_OUT,156740,Sébastien Jourdan,274558,117818,Agence_moov_Cotonou,300000,143260,2022-10-09
CASH_IN,110407,Agence_moov_Cotonou,300000,189593,Sébastien Jourdan,117818,228225,2022-10-11
CASH_OUT,18313,Sébastien Jourdan,228225,209912,Agence_moov_Ouidah,300000,281687,2022-10-11
TRANSFER,137061,Sébastien Jourdan,209912,72851,Matthieu Renard,2038,-135023,2022-10-12
CASH_OUT,68892,Sébastien Jourdan,72851,3959,Agence_moov_Abomey,300000,231108,2022-10-14
TRANSFER,791219,Laurent Perrot,1077468,286249,Sébastien Jourdan,3959,795178,2022-10-18
CASH_IN,238838,Agence_moov_Abomey,300000,61162,Sébastien Jourdan,795178,1034016,2022-10-19
CASH_OUT,136694,Sébastien Jourdan,1034016,897322,Agence_moov_Abomey,300000,163306,2022-10-19
CASH_IN,288622,Agence_moov_Cotonou,300000,11378,Sébastien Jourdan,897322,1185944,2022-10-19
TRANSFER,12582,Amélie Gros-Riou,60243,47661,Sébastien Jourdan,1185944,1198526,2022-10-25
CASH_IN,26645,Agence_moov_Abomey,300000,273355,Sébastien Jourdan,1198526,1225171,2022-10-25
CASH_IN,163944,Agence_moov_Cotonou,300000,136056,Benoît Verdier,19522,183466,2022-10-01
TRANSFER,152035,Benoît Verdier,183466,31431,Nicolas Hervé,3269,-148766,2022-10-02
TRANSFER,26206,Benoît Verdier,31431,5225,Gabriel de Pineau,366461,340255,2022-10-03
TRANSFER,118934,Caroline Peltier,124499,5565,Benoît Verdier,5225,124159,2022-10-05
TRANSFER,27101,Benoît Verdier,124159,97058,Laurent Perrot,286249,259148,2022-10-05
TRANSFER,57621,Paul Pereira,662969,605348,Benoît Verdier,97058,154679,2022-10-09
CASH_IN,273464,Agence_moov_Cotonou,300000,26536,Benoît Verdier,154679,428143,2022-10-12
TRANSFER,181284,Christophe Guilbert,444553,263269,Benoît Verdier,428143,609427,2022-10-12
CASH_IN,192895,Agence_moov_Abomey,300000,107105,Benoît Verdier,609427,802322,2022-10-14
CASH_IN,279895,Agence_moov_Ouidah,300000,20105,Benoît Verdier,802322,1082217,2022-10-16
TRANSFER,21253,Laurent Perrot,259148,237895,Benoît Verdier,1082217,1103470,2022-10-16
TRANSFER,807305,Benoît Verdier,1103470,296165,Émilie Guillon de Duhamel,352858,-454447,2022-10-22
CASH_IN,277619,Agence_moov_Ouidah,300000,22381,Benoît Verdier,296165,573784,2022-10-24
CASH_IN,54360,Agence_moov_Abomey,300000,245640,Joséphine Weber du Bonnin,-8425,45935,2022-10-02
TRANSFER,98321,Paul Pereira,605348,507027,Joséphine Weber du Bonnin,45935,144256,2022-10-02
TRANSFER,838419,Sabine Imbert,1030601,192182,Joséphine Weber du Bonnin,144256,982675,2022-10-03
TRANSFER,18083,Caroline Bonneau,59417,41334,Joséphine Weber du Bonnin,982675,1000758,2022-10-06
CASH_IN,97365,Agence_moov_Abomey,300000,202635,Joséphine Weber du Bonnin,1000758,1098123,2022-10-08
CASH_OUT,545695,Joséphine Weber du Bonnin,1098123,552428,Agence_moov_Abomey,300000,-245695,2022-10-09
TRANSFER,209698,Joséphine Weber du Bonnin,552428,342730,Maurice Seguin,443326,233628,2022-10-12
TRANSFER,9025,Joséphine Weber du Bonnin,342730,333705,Margot Renaud de Lacombe,7169,-1856,2022-10-13
CASH_OUT,278058,Joséphine Weber du Bonnin,333705,55647,Agence_moov_Cotonou,300000,21942,2022-10-13
CASH_OUT,29826,Joséphine Weber du Bonnin,55647,25821,Agence_moov_Ouidah,300000,270174,2022-10-19
CASH_IN,103402,Agence_moov_Cotonou,300000,196598,Joséphine Weber du Bonnin,25821,129223,2022-10-23
CASH_IN,245808,Agence_moov_Abomey,300000,54192,Joséphine Weber du Bonnin,129223,375031,2022-10-27
CASH_OUT,39249,Océane Boutin,88319,49070,Agence_moov_Ouidah,300000,260751,2022-10-10
TRANSFER,42321,Océane Boutin,49070,6749,Caroline Peltier,5565,-36756,2022-10-10
CASH_IN,278559,Agence_moov_Abomey,300000,21441,Océane Boutin,6749,285308,2022-10-10
TRANSFER,126106,Océane Boutin,285308,159202,Alex Salmon,394760,268654,2022-10-12
CASH_IN,153352,Agence_moov_Cotonou,300000,146648,Océane Boutin,159202,312554,2022-10-13
CASH_OUT,160153,Océane Boutin,312554,152401,Agence_moov_Ouidah,300000,139847,2022-10-13
CASH_IN,176787,Agence_moov_Ouidah,300000,123213,Océane Boutin,152401,329188,2022-10-13
CASH_OUT,164991,Océane Boutin,329188,164197,Agence_moov_Abomey,300000,135009,2022-10-18
CASH_IN,214550,Agence_moov_Cotonou,300000,85450,Océane Boutin,164197,378747,2022-10-18
TRANSFER,242343,Alex Salmon,268654,26311,Océane Boutin,378747,621090,2022-10-19
TRANSFER,44259,Amélie Gros-Riou,47661,3402,Océane Boutin,621090,665349,2022-10-25
TRANSFER,490424,Océane Boutin,665349,174925,Amélie Gros-Riou,3402,-487022,2022-10-25
TRANSFER,32859,Océane Boutin,174925,142066,Caroline Bonneau,41334,8475,2022-10-26
TRANSFER,401981,Gilbert Bazin Le Guillet,664907,262926,Océane Boutin,142066,544047,2022-10-26
CASH_IN,252506,Agence_moov_Abomey,300000,47494,Océane Boutin,544047,796553,2022-10-26
TRANSFER,285797,Anastasie Louis,318551,32754,Océane Boutin,796553,1082350,2022-10-27
TRANSFER,327592,Océane Boutin,1082350,754758,Caroline Bonneau,8475,-319117,2022-10-27
CASH_IN,109062,Agence_moov_Cotonou,300000,190938,Nicolas Grondin de la Pinto,-12673,96389,2022-10-01
TRANSFER,63602,Laurent Perrot,237895,174293,Nicolas Grondin de la Pinto,96389,159991,2022-10-02
CASH_OUT,25062,Nicolas Grondin de la Pinto,159991,134929,Agence_moov_Ouidah,300000,274938,2022-10-07
TRANSFER,41081,Nicolas Grondin de la Pinto,134929,93848,Laurent Perrot,174293,133212,2022-10-07
CASH_OUT,13379,Nicolas Grondin de la Pinto,93848,80469,Agence_moov_Ouidah,300000,286621,2022-10-08
TRANSFER,67212,Nicolas Grondin de la Pinto,80469,13257,Paul Pereira,507027,439815,2022-10-09
TRANSFER,3081,Nicolas Grondin de la Pinto,13257,10176,Nicolas Grondin de la Pinto,13257,16338,2022-10-12
CASH_IN,227832,Agence_moov_Cotonou,300000,72168,Nicolas Grondin de la Pinto,10176,238008,2022-10-16
CASH_IN,229750,Agence_moov_Abomey,300000,70250,Nicolas Grondin de la Pinto,238008,467758,2022-10-18
CASH_OUT,152948,Nicolas Grondin de la Pinto,467758,314810,Agence_moov_Ouidah,300000,147052,2022-10-20
CASH_IN,225780,Agence_moov_Cotonou,300000,74220,Nicolas Grondin de la Pinto,314810,540590,2022-10-24
CASH_OUT,376053,Nicolas Grondin de la Pinto,540590,164537,Agence_moov_Abomey,300000,-76053,2022-10-24
CASH_OUT,16972,Nicolas Grondin de la Pinto,164537,147565,Agence_moov_Abomey,300000,283028,2022-10-24
CASH_OUT,53621,Nicolas Grondin de la Pinto,147565,93944,Agence_moov_Ouidah,300000,246379,2022-10-27
CASH_OUT,101874,Nath Léger,201007,99133,Agence_moov_Ouidah,300000,198126,2022-10-04
TRANSFER,82524,Gilbert Bazin Le Guillet,262926,180402,Nath Léger,99133,181657,2022-10-04
CASH_OUT,144921,Nath Léger,181657,36736,Agence_moov_Cotonou,300000,155079,2022-10-07
CASH_IN,165068,Agence_moov_Ouidah,300000,134932,Nath Léger,36736,201804,2022-10-08
CASH_OUT,5159,Nath Léger,201804,196645,Agence_moov_Cotonou,300000,294841,2022-10-08
CASH_OUT,187856,Nath Léger,196645,8789,Agence_moov_Cotonou,300000,112144,2022-10-09
CASH_OUT,2777,Nath Léger,8789,6012,Agence_moov_Ouidah,300000,297223,2022-10-17
CASH_IN,183945,Agence_moov_Cotonou,300000,116055,Nath Léger,6012,189957,2022-10-19
CASH_IN,281938,Agence_moov_Ouidah,300000,18062,Nath Léger,189957,471895,2022-10-26
CASH_IN,21450,Agence_moov_Cotonou,300000,278550,Maryse Lebreton,-483759,-462309,2022-10-01
CASH_IN,261054,Agence_moov_Abomey,300000,38946,Maryse Lebreton,-462309,-201255,2022-10-02
CASH_IN,29521,Agence_moov_Ouidah,300000,270479,Maryse Lebreton,-201255,-171734,2022-10-07
CASH_IN,15238,Agence_moov_Abomey,300000,284762,Maryse Lebreton,-171734,-156496,2022-10-08
CASH_IN,249901,Agence_moov_Abomey,300000,50099,Maryse Lebreton,-156496,93405,2022-10-08
CASH_OUT,57844,Maryse Lebreton,93405,35561,Agence_moov_Cotonou,300000,242156,2022-10-09
CASH_OUT,27498,Maryse Lebreton,35561,8063,Agence_moov_Cotonou,300000,272502,2022-10-10
TRANSFER,454,Maryse Lebreton,8063,7609,Gabriel de Pineau,340255,339801,2022-10-11
TRANSFER,8406,Anastasie Louis,32754,24348,Maryse Lebreton,7609,16015,2022-10-14
CASH_IN,231559,Agence_moov_Cotonou,300000,68441,Maryse Lebreton,16015,247574,2022-10-15
TRANSFER,129233,Maryse Lebreton,247574,118341,Constance Regnier,1646000,1516767,2022-10-19
CASH_IN,133293,Agence_moov_Cotonou,300000,166707,Maryse Lebreton,118341,251634,2022-10-19
TRANSFER,52121,Maryse Lebreton,251634,199513,Agnès Baron,83474,31353,2022-10-20
CASH_IN,113144,Agence_moov_Abomey,300000,186856,Maryse Lebreton,199513,312657,2022-10-22
CASH_IN,17477,Agence_moov_Ouidah,300000,282523,Maryse Lebreton,312657,330134,2022-10-23
CASH_IN,134508,Agence_moov_Abomey,300000,165492,Maryse Lebreton,330134,464642,2022-10-23
TRANSFER,18343,Maryse Lebreton,464642,446299,Paul Pereira,439815,421472,2022-10-26
CASH_IN,131773,Agence_moov_Ouidah,300000,168227,Alexandre Poirier,-1590,130183,2022-10-02
CASH_IN,198466,Agence_moov_Ouidah,300000,101534,Alexandre Poirier,130183,328649,2022-10-03
CASH_OUT,261287,Alexandre Poirier,328649,67362,Agence_moov_Ouidah,300000,38713,2022-10-03
CASH_OUT,10536,Alexandre Poirier,67362,56826,Agence_moov_Cotonou,300000,289464,2022-10-05
CASH_IN,143191,Agence_moov_Abomey,300000,156809,Alexandre Poirier,56826,200017,2022-10-09
CASH_IN,2392,Agence_moov_Ouidah,300000,297608,Alexandre Poirier,200017,202409,2022-10-11
TRANSFER,84723,Alexandre Poirier,202409,117686,Alex Salmon,26311,-58412,2022-10-14
CASH_OUT,17897,Alexandre Poirier,117686,99789,Agence_moov_Abomey,300000,282103,2022-10-14
CASH_IN,3224,Agence_moov_Cotonou,300000,296776,Alexandre Poirier,99789,103013,2022-10-16
CASH_OUT,21872,Alexandre Poirier,103013,81141,Agence_moov_Cotonou,300000,278128,2022-10-16
CASH_IN,48394,Agence_moov_Ouidah,300000,251606,Alexandre Poirier,81141,129535,2022-10-16
TRANSFER,30338,Alexandre Poirier,129535,99197,Sabine Imbert,192182,161844,2022-10-18
CASH_IN,295315,Agence_moov_Abomey,300000,4685,Alexandre Poirier,99197,394512,2022-10-21
CASH_OUT,169780,Alexandre Poirier,394512,224732,Agence_moov_Ouidah,300000,130220,2022-10-23
CASH_IN,133109,Agence_moov_Abomey,300000,166891,Alexandre Poirier,224732,357841,2022-10-25
CASH_IN,268039,Agence_moov_Abomey,300000,31961,Laurent Besson,1083866,1351905,2022-10-08
TRANSFER,6721,Anastasie Louis,24348,17627,Laurent Besson,1351905,1358626,2022-10-08
CASH_IN,199708,Agence_moov_Ouidah,300000,100292,Laurent Besson,1358626,1558334,2022-10-12
CASH_IN,151958,Agence_moov_Abomey,300000,148042,Laurent Besson,1558334,1710292,2022-10-12
CASH_IN,104107,Agence_moov_Ouidah,300000,195893,Laurent Besson,1710292,1814399,2022-10-20
CASH_OUT,1459690,Laurent Besson,1814399,354709,Agence_moov_Ouidah,300000,-1159690,2022-10-20
TRANSFER,279499,Laurent Besson,354709,75210,Augustin Benard,1495946,1216447,2022-10-26
CASH_IN,245008,Agence_moov_Cotonou,300000,54992,Laurent Besson,75210,320218,2022-10-27
CASH_IN,54619,Agence_moov_Ouidah,300000,245381,Caroline Peltier,-36756,17863,2022-10-03
TRANSFER,15788,Caroline Peltier,17863,2075,Constance Regnier,1516767,1500979,2022-10-04
CASH_OUT,1075,Caroline Peltier,2075,1000,Agence_moov_Abomey,300000,298925,2022-10-08
CASH_OUT,893,Caroline Peltier,1000,107,Agence_moov_Ouidah,300000,299107,2022-10-09
TRANSFER,105,Caroline Peltier,107,2,Augustin Benard,1216447,1216342,2022-10-13
CASH_IN,290407,Agence_moov_Abomey,300000,9593,Caroline Peltier,2,290409,2022-10-13
CASH_IN,223490,Agence_moov_Abomey,300000,76510,Caroline Peltier,290409,513899,2022-10-14
TRANSFER,183701,Caroline Peltier,513899,330198,Nathalie-Chantal Jacques,856878,673177,2022-10-15
TRANSFER,57614,Caroline Peltier,330198,272584,Christophe Guilbert,263269,205655,2022-10-16
CASH_IN,7645,Agence_moov_Abomey,300000,292355,Caroline Peltier,272584,280229,2022-10-19
TRANSFER,251834,Caroline Peltier,280229,28395,Gilbert Bazin Le Guillet,180402,-71432,2022-10-21
TRANSFER,12546,Caroline Peltier,28395,15849,Anastasie Louis,17627,5081,2022-10-23
CASH_OUT,4987,Caroline Peltier,15849,10862,Agence_moov_Ouidah,300000,295013,2022-10-26
CASH_OUT,6810,Vincent-Grégoire Brunet,11149,4339,Agence_moov_Cotonou,300000,293190,2022-10-05
CASH_IN,85555,Agence_moov_Ouidah,300000,214445,Vincent-Grégoire Brunet,4339,89894,2022-10-06
TRANSFER,8741,Vincent-Grégoire Brunet,89894,81153,Vincent-Grégoire Brunet,89894,81153,2022-10-08
CASH_IN,25426,Agence_moov_Cotonou,300000,274574,Vincent-Grégoire Brunet,81153,106579,2022-10-11
CASH_IN,172853,Agence_moov_Cotonou,300000,127147,Vincent-Grégoire Brunet,106579,279432,2022-10-14
CASH_OUT,23077,Vincent-Grégoire Brunet,279432,256355,Agence_moov_Abomey,300000,276923,2022-10-16
TRANSFER,1499728,Constance Regnier,1500979,1251,Vincent-Grégoire Brunet,256355,1756083,2022-10-18
CASH_IN,143282,Agence_moov_Cotonou,300000,156718,Vincent-Grégoire Brunet,1756083,1899365,2022-10-19
TRANSFER,1509103,Vincent-Grégoire Brunet,1899365,390262,Augustin Benard,1216342,-292761,2022-10-20
TRANSFER,13483,Paul Pereira,421472,407989,Vincent-Grégoire Brunet,390262,403745,2022-10-20
TRANSFER,71169,Vincent-Grégoire Brunet,403745,332576,Paul Pereira,407989,336820,2022-10-21
TRANSFER,285299,Vincent-Grégoire Brunet,332576,47277,Constance Regnier,1251,-284048,2022-10-21
CASH_IN,177401,Agence_moov_Cotonou,300000,122599,Vincent-Grégoire Brunet,47277,224678,2022-10-22
CASH_IN,297497,Agence_moov_Ouidah,300000,2503,Vincent-Grégoire Brunet,224678,522175,2022-10-23
CASH_IN,121732,Agence_moov_Cotonou,300000,178268,Vincent-Grégoire Brunet,522175,643907,2022-10-24
CASH_IN,17160,Agence_moov_Cotonou,300000,282840,Marc Gilbert,-36634,-19474,2022-10-08
CASH_IN,202672,Agence_moov_Ouidah,300000,97328,Marc Gilbert,-19474,183198,2022-10-09
CASH_OUT,50271,Marc Gilbert,183198,132927,Agence_moov_Abomey,300000,249729,2022-10-10
TRANSFER,199517,Christophe Guilbert,205655,6138,Marc Gilbert,132927,332444,2022-10-11
CASH_IN,104637,Agence_moov_Cotonou,300000,195363,Marc Gilbert,332444,437081,2022-10-18
CASH_IN,5231,Agence_moov_Abomey,300000,294769,Marc Gilbert,437081,442312,2022-10-18
TRANSFER,285554,Marc Gilbert,442312,156758,Nathalie-Chantal Jacques,673177,387623,2022-10-20
TRANSFER,117393,Marc Gilbert,156758,39365,Théodore-Alfred Fournier,182014,64621,2022-10-21
CASH_IN,61142,Agence_moov_Cotonou,300000,238858,Marc Gilbert,39365,100507,2022-10-21
CASH_IN,97088,Agence_moov_Abomey,300000,202912,Nicolas Hervé,-148766,-51678,2022-10-01
CASH_IN,120339,Agence_moov_Cotonou,300000,179661,Nicolas Hervé,-51678,68661,2022-10-08
CASH_IN,234562,Agence_moov_Ouidah,300000,65438,Nicolas Hervé,68661,303223,2022-10-11
CASH_IN,211551,Agence_moov_Ouidah,300000,88449,Nicolas Hervé,303223,514774,2022-10-16
TRANSFER,87099,Sabine Imbert,161844,74745,Nicolas Hervé,514774,601873,2022-10-19
TRANSFER,479382,Nicolas Hervé,601873,122491,Gabriel de Pineau,339801,-139581,2022-10-22
TRANSFER,42493,Nicolas Hervé,122491,79998,Laurent Perrot,133212,90719,2022-10-25
TRANSFER,2600,Anastasie Louis,5081,2481,Nicolas Hervé,79998,82598,2022-10-26
CASH_OUT,81020,Nicolas Hervé,82598,1578,Agence_moov_Ouidah,300000,218980,2022-10-26
CASH_IN,31651,Agence_moov_Cotonou,300000,268349,Nicolas Hervé,1578,33229,2022-10-27
CASH_IN,184691,Agence_moov_Cotonou,300000,115309,Alfred Chrétien,-183471,1220,2022-10-02
CASH_IN,191515,Agence_moov_Abomey,300000,108485,Alfred Chrétien,1220,192735,2022-10-02
CASH_IN,114025,Agence_moov_Ouidah,300000,185975,Alfred Chrétien,192735,306760,2022-10-04
CASH_IN,66200,Agence_moov_Ouidah,300000,233800,Alfred Chrétien,306760,372960,2022-10-04
CASH_IN,232014,Agence_moov_Abomey,300000,67986,Alfred Chrétien,372960,604974,2022-10-10
CASH_OUT,169923,Alfred Chrétien,604974,435051,Agence_moov_Ouidah,300000,130077,2022-10-13
CASH_OUT,162608,Alfred Chrétien,435051,272443,Agence_moov_Abomey,300000,137392,2022-10-19
CASH_IN,206107,Agence_moov_Cotonou,300000,93893,Alfred Chrétien,272443,478550,2022-10-23
CASH_IN,95419,Agence_moov_Ouidah,300000,204581,Antoine Leroux,-537431,-442012,2022-10-01
CASH_IN,4067,Agence_moov_Ouidah,300000,295933,Antoine Leroux,-442012,-437945,2022-10-02
CASH_IN,258639,Agence_moov_Ouidah,300000,41361,Antoine Leroux,-437945,-179306,2022-10-04
CASH_IN,75730,Agence_moov_Cotonou,300000,224270,Antoine Leroux,-179306,-103576,2022-10-05
CASH_IN,229001,Agence_moov_Cotonou,300000,70999,Antoine Leroux,-103576,125425,2022-10-09
CASH_IN,182551,Agence_moov_Cotonou,300000,117449,Antoine Leroux,125425,307976,2022-10-10
TRANSFER,75294,Hugues Gay,435045,359751,Antoine Leroux,307976,383270,2022-10-12
TRANSFER,35087,Sabine Imbert,74745,39658,Antoine Leroux,383270,418357,2022-10-19
CASH_IN,291597,Agence_moov_Ouidah,300000,8403,Antoine Leroux,418357,709954,2022-10-22
CASH_OUT,451440,Antoine Leroux,709954,258514,Agence_moov_Abomey,300000,-151440,2022-10-23
CASH_IN,35733,Agence_moov_Ouidah,300000,264267,Antoine Leroux,258514,294247,2022-10-26
CASH_IN,219992,Agence_moov_Ouidah,300000,80008,Gilbert Bazin Le Guillet,-71432,148560,2022-10-02
CASH_OUT,39836,Gilbert Bazin Le Guillet,148560,108724,Agence_moov_Ouidah,300000,260164,2022-10-02
CASH_IN,252725,Agence_moov_Cotonou,300000,47275,Gilbert Bazin Le Guillet,108724,361449,2022-10-11
CASH_OUT,307120,Gilbert Bazin Le Guillet,361449,54329,Agence_moov_Abomey,300000,-7120,2022-10-12
CASH_OUT,29200,Gilbert Bazin Le Guillet,54329,25129,Agence_moov_Ouidah,300000,270800,2022-10-16
TRANSFER,272616,Hugues Gay,359751,87135,Gilbert Bazin Le Guillet,25129,297745,2022-10-17
CASH_OUT,91210,Gilbert Bazin Le Guillet,297745,206535,Agence_moov_Ouidah,300000,208790,2022-10-18
CASH_OUT,113707,Gilbert Bazin Le Guillet,206535,92828,Agence_moov_Ouidah,300000,186293,2022-10-23
CASH_OUT,37839,Gilbert Bazin Le Guillet,92828,54989,Agence_moov_Ouidah,300000,262161,2022-10-26
TRANSFER,24818,Gilbert Bazin Le Guillet,54989,30171,Hugues Gay,87135,62317,2022-10-26
TRANSFER,10062,Gilbert Bazin Le Guillet,30171,20109,Paul Pereira,336820,326758,2022-10-26
CASH_IN,199335,Agence_moov_Cotonou,300000,100665,Gilbert Bazin Le Guillet,20109,219444,2022-10-27
CASH_IN,35883,Agence_moov_Abomey,300000,264117,Gilbert Bazin Le Guillet,219444,255327,2022-10-27
CASH_OUT,10045,Théodore-Alfred Fournier,64621,54576,Agence_moov_Ouidah,300000,289955,2022-10-06
TRANSFER,17291,Théodore-Alfred Fournier,54576,37285,Nathalie-Chantal Jacques,387623,370332,2022-10-07
TRANSFER,16048,Hugues Gay,62317,46269,Théodore-Alfred Fournier,37285,53333,2022-10-11
CASH_OUT,34888,Théodore-Alfred Fournier,53333,18445,Agence_moov_Cotonou,300000,265112,2022-10-13
CASH_IN,50441,Agence_moov_Abomey,300000,249559,Théodore-Alfred Fournier,18445,68886,2022-10-14
CASH_OUT,20863,Théodore-Alfred Fournier,68886,48023,Agence_moov_Abomey,300000,279137,2022-10-19
CASH_IN,297758,Agence_moov_Ouidah,300000,2242,Théodore-Alfred Fournier,48023,345781,2022-10-21
TRANSFER,28673,Hugues Gay,46269,17596,Théodore-Alfred Fournier,345781,374454,2022-10-27
CASH_IN,254709,Agence_moov_Abomey,300000,45291,David-Théodore Diaz,-464921,-210212,2022-10-02
CASH_IN,84580,Agence_moov_Abomey,300000,215420,David-Théodore Diaz,-210212,-125632,2022-10-02
CASH_IN,101798,Agence_moov_Ouidah,300000,198202,David-Théodore Diaz,-125632,-23834,2022-10-02
CASH_IN,267343,Agence_moov_Ouidah,300000,32657,David-Théodore Diaz,-23834,243509,2022-10-03
TRANSFER,34218,David-Théodore Diaz,243509,209291,David-Théodore Diaz,243509,277727,2022-10-05
CASH_IN,259262,Agence_moov_Abomey,300000,40738,David-Théodore Diaz,209291,468553,2022-10-07
CASH_OUT,35714,David-Théodore Diaz,468553,432839,Agence_moov_Abomey,300000,264286,2022-10-11
CASH_OUT,50848,David-Théodore Diaz,432839,381991,Agence_moov_Abomey,300000,249152,2022-10-11
CASH_OUT,301879,David-Théodore Diaz,381991,80112,Agence_moov_Abomey,300000,-1879,2022-10-11
CASH_IN,107483,Agence_moov_Ouidah,300000,192517,David-Théodore Diaz,80112,187595,2022-10-12
CASH_OUT,55129,David-Théodore Diaz,187595,132466,Agence_moov_Abomey,300000,244871,2022-10-14
CASH_IN,279371,Agence_moov_Cotonou,300000,20629,David-Théodore Diaz,132466,411837,2022-10-16
CASH_OUT,284392,David-Théodore Diaz,411837,127445,Agence_moov_Ouidah,300000,15608,2022-10-16
CASH_IN,145320,Agence_moov_Abomey,300000,154680,David-Théodore Diaz,127445,272765,2022-10-17
CASH_IN,146089,Agence_moov_Abomey,300000,153911,David-Théodore Diaz,272765,418854,2022-10-17
CASH_IN,20877,Agence_moov_Ouidah,300000,279123,David-Théodore Diaz,418854,439731,2022-10-18
CASH_OUT,370908,David-Théodore Diaz,439731,68823,Agence_moov_Cotonou,300000,-70908,2022-10-21
CASH_IN,264970,Agence_moov_Cotonou,300000,35030,David-Théodore Diaz,68823,333793,2022-10-24
CASH_IN,119896,Agence_moov_Ouidah,300000,180104,David-Théodore Diaz,333793,453689,2022-10-24
CASH_IN,3543,Agence_moov_Cotonou,300000,296457,Alex Salmon,-58412,-54869,2022-10-04
CASH_IN,80347,Agence_moov_Cotonou,300000,219653,Alex Salmon,-54869,25478,2022-10-07
CASH_IN,115801,Agence_moov_Abomey,300000,184199,Alex Salmon,25478,141279,2022-10-08
CASH_OUT,131286,Alex Salmon,141279,9993,Agence_moov_Ouidah,300000,168714,2022-10-19
TRANSFER,251885,Nathalie-Chantal Jacques,370332,118447,Alex Salmon,9993,261878,2022-10-20
CASH_IN,63066,Agence_moov_Ouidah,300000,236934,Alex Salmon,261878,324944,2022-10-20
CASH_OUT,299359,Alex Salmon,324944,25585,Agence_moov_Cotonou,300000,641,2022-10-21
TRANSFER,15248,Hugues Gay,17596,2348,Alex Salmon,25585,40833,2022-10-25
CASH_OUT,18553,Alex Salmon,40833,22280,Agence_moov_Abomey,300000,281447,2022-10-26
CASH_IN,43629,Agence_moov_Ouidah,300000,256371,Alex Salmon,22280,65909,2022-10-26
TRANSFER,210705,Paul Pereira,326758,116053,Sabine Imbert,39658,-171047,2022-10-03
CASH_OUT,32444,Paul Pereira,116053,83609,Agence_moov_Abomey,300000,267556,2022-10-03
CASH_OUT,78382,Paul Pereira,83609,5227,Agence_moov_Abomey,300000,221618,2022-10-05
TRANSFER,4218,Paul Pereira,5227,1009,Paul Pereira,5227,1009,2022-10-07
CASH_OUT,263,Paul Pereira,1009,746,Agence_moov_Cotonou,300000,299737,2022-10-07
TRANSFER,672,Paul Pereira,746,74,Laurent Perrot,90719,90047,2022-10-08
CASH_IN,108926,Agence_moov_Ouidah,300000,191074,Paul Pereira,74,109000,2022-10-11
CASH_OUT,35256,Paul Pereira,109000,73744,Agence_moov_Cotonou,300000,264744,2022-10-13
CASH_IN,187760,Agence_moov_Abomey,300000,112240,Paul Pereira,73744,261504,2022-10-13
CASH_IN,65792,Agence_moov_Abomey,300000,234208,Paul Pereira,261504,327296,2022-10-14
TRANSFER,415,Christophe Guilbert,6138,5723,Paul Pereira,327296,327711,2022-10-17
CASH_IN,15060,Agence_moov_Ouidah,300000,284940,Paul Pereira,327711,342771,2022-10-20
TRANSFER,34977,Laurent Perrot,90047,55070,Paul Pereira,342771,377748,2022-10-22
CASH_IN,24205,Agence_moov_Cotonou,300000,275795,Paul Pereira,377748,401953,2022-10-27
CASH_IN,295864,Agence_moov_Cotonou,300000,4136,Matthieu Renard,-135023,160841,2022-10-04
TRANSFER,158081,Matthieu Renard,160841,2760,Matthieu Renard,160841,2760,2022-10-06
TRANSFER,2751,Matthieu Renard,2760,9,Matthieu Renard,2760,5511,2022-10-10
CASH_IN,125435,Agence_moov_Cotonou,300000,174565,Matthieu Renard,9,125444,2022-10-12
CASH_IN,139361,Agence_moov_Cotonou,300000,160639,Matthieu Renard,125444,264805,2022-10-12
CASH_IN,126205,Agence_moov_Cotonou,300000,173795,Matthieu Renard,264805,391010,2022-10-16
CASH_OUT,309355,Matthieu Renard,391010,81655,Agence_moov_Ouidah,300000,-9355,2022-10-16
CASH_IN,256289,Agence_moov_Ouidah,300000,43711,Matthieu Renard,81655,337944,2022-10-18
CASH_IN,150180,Agence_moov_Cotonou,300000,149820,Matthieu Renard,337944,488124,2022-10-21
CASH_IN,116398,Agence_moov_Cotonou,300000,183602,Matthieu Renard,488124,604522,2022-10-23
TRANSFER,246588,Matthieu Renard,604522,357934,Maurice Seguin,233628,-12960,2022-10-23
CASH_IN,158250,Agence_moov_Cotonou,300000,141750,Caroline Bonneau,-319117,-160867,2022-10-02
CASH_IN,4214,Agence_moov_Ouidah,300000,295786,Caroline Bonneau,-160867,-156653,2022-10-04
CASH_IN,36988,Agence_moov_Abomey,300000,263012,Caroline Bonneau,-156653,-119665,2022-10-07
CASH_IN,241977,Agence_moov_Ouidah,300000,58023,Caroline Bonneau,-119665,122312,2022-10-11
TRANSFER,8412,Caroline Bonneau,122312,113900,Hugues Gay,2348,-6064,2022-10-12
CASH_IN,140000,Agence_moov_Cotonou,300000,160000,Caroline Bonneau,113900,253900,2022-10-15
CASH_OUT,213635,Caroline Bonneau,253900,40265,Agence_moov_Abomey,300000,86365,2022-10-16
CASH_IN,298503,Agence_moov_Cotonou,300000,1497,Caroline Bonneau,40265,338768,2022-10-18
TRANSFER,23709,Laurent Perrot,55070,31361,Caroline Bonneau,338768,362477,2022-10-20
CASH_IN,70708,Agence_moov_Abomey,300000,229292,Caroline Bonneau,362477,433185,2022-10-23
CASH_IN,20172,Agence_moov_Abomey,300000,279828,Caroline Bonneau,433185,453357,2022-10-26
CASH_IN,282792,Agence_moov_Ouidah,300000,17208,Augustin Benard,-292761,-9969,2022-10-02
CASH_IN,62658,Agence_moov_Ouidah,300000,237342,Augustin Benard,-9969,52689,2022-10-02
CASH_OUT,490,Augustin Benard,52689,52199,Agence_moov_Cotonou,300000,299510,2022-10-04
CASH_OUT,32170,Augustin Benard,52199,20029,Agence_moov_Cotonou,300000,267830,2022-10-05
TRANSFER,202,Augustin Benard,20029,19827,Augustin Benard,20029,20231,2022-10-06
CASH_IN,297055,Agence_moov_Ouidah,300000,2945,Augustin Benard,19827,316882,2022-10-09
CASH_IN,49935,Agence_moov_Ouidah,300000,250065,Augustin Benard,316882,366817,2022-10-19
CASH_OUT,131785,Augustin Benard,366817,235032,Agence_moov_Abomey,300000,168215,2022-10-21
CASH_IN,20917,Agence_moov_Ouidah,300000,279083,Augustin Benard,235032,255949,2022-10-22
CASH_OUT,27093,Augustin Benard,255949,228856,Agence_moov_Cotonou,300000,272907,2022-10-23
CASH_IN,278660,Agence_moov_Ouidah,300000,21340,Augustin Benard,228856,507516,2022-10-25
TRANSFER,4256,Christophe Guilbert,5723,1467,Augustin Benard,507516,511772,2022-10-25
CASH_OUT,239635,Augustin Benard,511772,272137,Agence_moov_Ouidah,300000,60365,2022-10-25
CASH_IN,68537,Agence_moov_Ouidah,300000,231463,Augustin Benard,272137,340674,2022-10-27
CASH_IN,155972,Agence_moov_Cotonou,300000,144028,Émilie Guillon de Duhamel,-454447,-298475,2022-10-05
CASH_IN,8712,Agence_moov_Ouidah,300000,291288,Émilie Guillon de Duhamel,-298475,-289763,2022-10-06
CASH_IN,68358,Agence_moov_Abomey,300000,231642,Émilie Guillon de Duhamel,-289763,-221405,2022-10-07
CASH_IN,290892,Agence_moov_Abomey,300000,9108,Émilie Guillon de Duhamel,-221405,69487,2022-10-08
CASH_OUT,9132,Émilie Guillon de Duhamel,69487,60355,Agence_moov_Abomey,300000,290868,2022-10-08
CASH_OUT,36126,Émilie Guillon de Duhamel,60355,24229,Agence_moov_Ouidah,300000,263874,2022-10-12
TRANSFER,948,Christophe Guilbert,1467,519,Émilie Guillon de Duhamel,24229,25177,2022-10-18
CASH_OUT,2501,Émilie Guillon de Duhamel,25177,22676,Agence_moov_Cotonou,300000,297499,2022-10-20
CASH_IN,100599,Agence_moov_Cotonou,300000,199401,Émilie Guillon de Duhamel,22676,123275,2022-10-24
CASH_IN,171846,Agence_moov_Cotonou,300000,128154,Émilie Guillon de Duhamel,123275,295121,2022-10-24
TRANSFER,66948,Émilie Guillon de Duhamel,295121,228173,Christophe Guilbert,519,-66429,2022-10-26
CASH_IN,81624,Agence_moov_Ouidah,300000,218376,Diane-Françoise Raynaud,-160628,-79004,2022-10-02
CASH_IN,14466,Agence_moov_Ouidah,300000,285534,Diane-Françoise Raynaud,-79004,-64538,2022-10-03
CASH_IN,100739,Agence_moov_Abomey,300000,199261,Diane-Françoise Raynaud,-64538,36201,2022-10-04
CASH_OUT,23304,Diane-Françoise Raynaud,36201,12897,Agence_moov_Cotonou,300000,276696,2022-10-04
TRANSFER,10555,Diane-Françoise Raynaud,12897,2342,Diane-Françoise Raynaud,12897,23452,2022-10-05
TRANSFER,2323,Diane-Françoise Raynaud,2342,19,Diane-Françoise Raynaud,2342,4665,2022-10-10
CASH_IN,268524,Agence_moov_Abomey,300000,31476,Diane-Françoise Raynaud,19,268543,2022-10-10
CASH_OUT,230441,Diane-Françoise Raynaud,268543,38102,Agence_moov_Cotonou,300000,69559,2022-10-19
CASH_IN,42174,Agence_moov_Abomey,300000,257826,Xavier-Stéphane Ollivier,-457544,-415370,2022-10-01
CASH_IN,241212,Agence_moov_Ouidah,300000,58788,Xavier-Stéphane Ollivier,-415370,-174158,2022-10-02
CASH_IN,102870,Agence_moov_Cotonou,300000,197130,Xavier-Stéphane Ollivier,-174158,-71288,2022-10-03
CASH_IN,197690,Agence_moov_Abomey,300000,102310,Xavier-Stéphane Ollivier,-71288,126402,2022-10-04
CASH_OUT,48959,Xavier-Stéphane Ollivier,126402,77443,Agence_moov_Cotonou,300000,251041,2022-10-07
TRANSFER,60607,Xavier-Stéphane Ollivier,77443,16836,Xavier-Stéphane Ollivier,77443,16836,2022-10-09
TRANSFER,5070,Xavier-Stéphane Ollivier,16836,11766,Xavier-Stéphane Ollivier,16836,11766,2022-10-11
CASH_OUT,11733,Xavier-Stéphane Ollivier,11766,33,Agence_moov_Cotonou,300000,288267,2022-10-11
CASH_IN,255816,Agence_moov_Cotonou,300000,44184,Xavier-Stéphane Ollivier,33,255849,2022-10-22
CASH_OUT,187407,Xavier-Stéphane Ollivier,255849,68442,Agence_moov_Ouidah,300000,112593,2022-10-22
CASH_IN,219191,Agence_moov_Abomey,300000,80809,Xavier-Stéphane Ollivier,68442,287633,2022-10-23
CASH_IN,151358,Agence_moov_Abomey,300000,148642,Xavier-Stéphane Ollivier,287633,438991,2022-10-26
CASH_IN,132120,Agence_moov_Ouidah,300000,167880,Xavier-Stéphane Ollivier,438991,571111,2022-10-27
CASH_IN,272289,Agence_moov_Abomey,300000,27711,Maurice Seguin,-12960,259329,2022-10-04
TRANSFER,204652,Maurice Seguin,259329,54677,Maurice Seguin,259329,54677,2022-10-05
CASH_IN,266753,Agence_moov_Cotonou,300000,33247,Maurice Seguin,54677,321430,2022-10-11
CASH_IN,238686,Agence_moov_Cotonou,300000,61314,Maurice Seguin,321430,560116,2022-10-16
CASH_IN,105916,Agence_moov_Ouidah,300000,194084,Maurice Seguin,560116,666032,2022-10-17
CASH_IN,205221,Agence_moov_Cotonou,300000,94779,Maurice Seguin,666032,871253,2022-10-23
CASH_OUT,177747,Maurice Seguin,871253,693506,Agence_moov_Abomey,300000,122253,2022-10-24
CASH_IN,206521,Agence_moov_Abomey,300000,93479,Sabine Imbert,-171047,35474,2022-10-01
TRANSFER,31686,Sabine Imbert,35474,3788,Sabine Imbert,35474,3788,2022-10-01
CASH_OUT,1098,Sabine Imbert,3788,2690,Agence_moov_Cotonou,300000,298902,2022-10-02
TRANSFER,1504,Sabine Imbert,2690,1186,Sabine Imbert,2690,4194,2022-10-02
CASH_OUT,1145,Sabine Imbert,1186,41,Agence_moov_Ouidah,300000,298855,2022-10-03
CASH_IN,107018,Agence_moov_Ouidah,300000,192982,Sabine Imbert,41,107059,2022-10-05
TRANSFER,87020,Sabine Imbert,107059,20039,Sabine Imbert,107059,20039,2022-10-06
CASH_IN,2234,Agence_moov_Cotonou,300000,297766,Sabine Imbert,20039,22273,2022-10-06
TRANSFER,9580,Sabine Imbert,22273,12693,Sabine Imbert,22273,31853,2022-10-08
CASH_IN,132688,Agence_moov_Cotonou,300000,167312,Sabine Imbert,12693,145381,2022-10-11
CASH_IN,86731,Agence_moov_Cotonou,300000,213269,Sabine Imbert,145381,232112,2022-10-15
CASH_IN,127675,Agence_moov_Ouidah,300000,172325,Sabine Imbert,232112,359787,2022-10-18
CASH_IN,194235,Agence_moov_Abomey,300000,105765,Sabine Imbert,359787,554022,2022-10-27
CASH_IN,264750,Agence_moov_Ouidah,300000,35250,Margot Renaud de Lacombe,-1856,262894,2022-10-02
TRANSFER,121475,Margot Renaud de Lacombe,262894,141419,Margot Renaud de Lacombe,262894,384369,2022-10-02
CASH_IN,78420,Agence_moov_Abomey,300000,221580,Margot Renaud de Lacombe,141419,219839,2022-10-05
CASH_IN,291104,Agence_moov_Abomey,300000,8896,Margot Renaud de Lacombe,219839,510943,2022-10-05
CASH_OUT,55067,Margot Renaud de Lacombe,510943,455876,Agence_moov_Ouidah,300000,244933,2022-10-09
CASH_IN,107810,Agence_moov_Ouidah,300000,192190,Margot Renaud de Lacombe,455876,563686,2022-10-19
CASH_OUT,153516,Margot Renaud de Lacombe,563686,410170,Agence_moov_Abomey,300000,146484,2022-10-21
CASH_OUT,84543,Margot Renaud de Lacombe,410170,325627,Agence_moov_Ouidah,300000,215457,2022-10-23
CASH_IN,12528,Agence_moov_Ouidah,300000,287472,Susan de Fontaine,-862022,-849494,2022-10-01
CASH_IN,103871,Agence_moov_Cotonou,300000,196129,Susan de Fontaine,-849494,-745623,2022-10-02
CASH_IN,121974,Agence_moov_Cotonou,300000,178026,Susan de Fontaine,-745623,-623649,2022-10-03
CASH_IN,71787,Agence_moov_Cotonou,300000,228213,Susan de Fontaine,-623649,-551862,2022-10-03
CASH_IN,141483,Agence_moov_Ouidah,300000,158517,Susan de Fontaine,-551862,-410379,2022-10-08
CASH_IN,266374,Agence_moov_Ouidah,300000,33626,Susan de Fontaine,-410379,-144005,2022-10-09
CASH_IN,87378,Agence_moov_Ouidah,300000,212622,Susan de Fontaine,-144005,-56627,2022-10-10
CASH_IN,187668,Agence_moov_Cotonou,300000,112332,Susan de Fontaine,-56627,131041,2022-10-10
CASH_IN,167075,Agence_moov_Abomey,300000,132925,Susan de Fontaine,131041,298116,2022-10-16
TRANSFER,271289,Susan de Fontaine,298116,26827,Susan de Fontaine,298116,26827,2022-10-17
CASH_OUT,24768,Susan de Fontaine,26827,2059,Agence_moov_Ouidah,300000,275232,2022-10-19
CASH_OUT,767,Susan de Fontaine,2059,1292,Agence_moov_Abomey,300000,299233,2022-10-19
CASH_OUT,882,Susan de Fontaine,1292,410,Agence_moov_Cotonou,300000,299118,2022-10-21
TRANSFER,213,Susan de Fontaine,410,197,Susan de Fontaine,410,623,2022-10-22
CASH_IN,88157,Agence_moov_Ouidah,300000,211843,Susan de Fontaine,197,88354,2022-10-23
CASH_IN,82906,Agence_moov_Ouidah,300000,217094,Susan de Fontaine,88354,171260,2022-10-25
CASH_IN,24867,Agence_moov_Ouidah,300000,275133,Gabriel de Pineau,-139581,-114714,2022-10-05
CASH_IN,36116,Agence_moov_Abomey,300000,263884,Gabriel de Pineau,-114714,-78598,2022-10-05
CASH_IN,18073,Agence_moov_Cotonou,300000,281927,Gabriel de Pineau,-78598,-60525,2022-10-06
CASH_IN,265795,Agence_moov_Cotonou,300000,34205,Gabriel de Pineau,-60525,205270,2022-10-08
CASH_OUT,174300,Gabriel de Pineau,205270,30970,Agence_moov_Ouidah,300000,125700,2022-10-14
CASH_IN,292869,Agence_moov_Abomey,300000,7131,Gabriel de Pineau,30970,323839,2022-10-17
CASH_OUT,109382,Gabriel de Pineau,323839,214457,Agence_moov_Ouidah,300000,190618,2022-10-21
CASH_OUT,96491,Gabriel de Pineau,214457,117966,Agence_moov_Abomey,300000,203509,2022-10-24
CASH_IN,130725,Agence_moov_Ouidah,300000,169275,Christophe Guilbert,-66429,64296,2022-10-03
TRANSFER,61497,Christophe Guilbert,64296,2799,Christophe Guilbert,64296,125793,2022-10-05
CASH_OUT,943,Christophe Guilbert,2799,1856,Agence_moov_Abomey,300000,299057,2022-10-06
CASH_IN,607,Agence_moov_Abomey,300000,299393,Christophe Guilbert,1856,2463,2022-10-06
CASH_IN,60165,Agence_moov_Ouidah,300000,239835,Christophe Guilbert,2463,62628,2022-10-06
CASH_OUT,37113,Christophe Guilbert,62628,25515,Agence_moov_Abomey,300000,262887,2022-10-07
CASH_OUT,22220,Christophe Guilbert,25515,3295,Agence_moov_Ouidah,300000,277780,2022-10-13
CASH_OUT,1053,Christophe Guilbert,3295,2242,Agence_moov_Ouidah,300000,298947,2022-10-14
CASH_IN,235907,Agence_moov_Cotonou,300000,64093,Christophe Guilbert,2242,238149,2022-10-18
CASH_OUT,158549,Christophe Guilbert,238149,79600,Agence_moov_Abomey,300000,141451,2022-10-19
CASH_IN,118648,Agence_moov_Abomey,300000,181352,Christophe Guilbert,79600,198248,2022-10-21
CASH_OUT,154026,Christophe Guilbert,198248,44222,Agence_moov_Abomey,300000,145974,2022-10-23
CASH_OUT,1749,Christophe Guilbert,44222,42473,Agence_moov_Ouidah,300000,298251,2022-10-25
CASH_IN,198156,Agence_moov_Abomey,300000,101844,Christophe Guilbert,42473,240629,2022-10-26
CASH_IN,200935,Agence_moov_Ouidah,300000,99065,Élodie Gérard,-150037,50898,2022-10-09
CASH_IN,241666,Agence_moov_Cotonou,300000,58334,Élodie Gérard,50898,292564,2022-10-09
TRANSFER,13724,Élodie Gérard,292564,278840,Élodie Gérard,292564,278840,2022-10-15
TRANSFER,43958,Élodie Gérard,278840,234882,Élodie Gérard,278840,234882,2022-10-17
CASH_IN,3579,Agence_moov_Ouidah,300000,296421,Élodie Gérard,234882,238461,2022-10-20
CASH_IN,171934,Agence_moov_Ouidah,300000,128066,Élodie Gérard,238461,410395,2022-10-22
CASH_IN,160370,Agence_moov_Cotonou,300000,139630,Constance Regnier,-284048,-123678,2022-10-05
CASH_IN,202593,Agence_moov_Cotonou,300000,97407,Constance Regnier,-123678,78915,2022-10-09
CASH_OUT,61573,Constance Regnier,78915,17342,Agence_moov_Ouidah,300000,238427,2022-10-09
TRANSFER,9665,Constance Regnier,17342,7677,Constance Regnier,17342,7677,2022-10-14
CASH_IN,251220,Agence_moov_Cotonou,300000,48780,Constance Regnier,7677,258897,2022-10-16
CASH_IN,149445,Agence_moov_Cotonou,300000,150555,Constance Regnier,258897,408342,2022-10-17
CASH_IN,53820,Agence_moov_Cotonou,300000,246180,Constance Regnier,408342,462162,2022-10-17
CASH_OUT,164695,Constance Regnier,462162,297467,Agence_moov_Ouidah,300000,135305,2022-10-19
CASH_IN,246139,Agence_moov_Ouidah,300000,53861,Constance Regnier,297467,543606,2022-10-20
CASH_IN,205380,Agence_moov_Abomey,300000,94620,Alphonse Dupont-Petit,-2054659,-1849279,2022-10-10
CASH_IN,151538,Agence_moov_Cotonou,300000,148462,Alphonse Dupont-Petit,-1849279,-1697741,2022-10-11
CASH_IN,204984,Agence_moov_Ouidah,300000,95016,Alphonse Dupont-Petit,-1697741,-1492757,2022-10-16
CASH_IN,53415,Agence_moov_Cotonou,300000,246585,Alphonse Dupont-Petit,-1492757,-1439342,2022-10-21
CASH_IN,19933,Agence_moov_Ouidah,300000,280067,Alphonse Dupont-Petit,-1439342,-1419409,2022-10-26
CASH_IN,296840,Agence_moov_Abomey,300000,3160,Alphonse Dupont-Petit,-1419409,-1122569,2022-10-26
CASH_IN,125773,Agence_moov_Cotonou,300000,174227,Amélie Gros-Riou,-487022,-361249,2022-10-07
CASH_IN,175016,Agence_moov_Ouidah,300000,124984,Amélie Gros-Riou,-361249,-186233,2022-10-09
CASH_IN,149282,Agence_moov_Ouidah,300000,150718,Amélie Gros-Riou,-186233,-36951,2022-10-10
CASH_IN,141623,Agence_moov_Cotonou,300000,158377,Amélie Gros-Riou,-36951,104672,2022-10-10
CASH_OUT,93316,Amélie Gros-Riou,104672,11356,Agence_moov_Ouidah,300000,206684,2022-10-11
CASH_OUT,5075,Amélie Gros-Riou,11356,6281,Agence_moov_Ouidah,300000,294925,2022-10-17
CASH_IN,114761,Agence_moov_Cotonou,300000,185239,Amélie Gros-Riou,6281,121042,2022-10-18
CASH_IN,201141,Agence_moov_Abomey,300000,98859,Amélie Gros-Riou,121042,322183,2022-10-20
CASH_IN,165812,Agence_moov_Abomey,300000,134188,Amélie Gros-Riou,322183,487995,2022-10-22
CASH_IN,7034,Agence_moov_Abomey,300000,292966,Amélie Gros-Riou,487995,495029,2022-10-23
CASH_OUT,13157,Amélie Gros-Riou,495029,481872,Agence_moov_Ouidah,300000,286843,2022-10-25
CASH_IN,225803,Agence_moov_Abomey,300000,74197,Richard Guibert,-1223451,-997648,2022-10-01
CASH_IN,97099,Agence_moov_Cotonou,300000,202901,Richard Guibert,-997648,-900549,2022-10-02
CASH_IN,209599,Agence_moov_Abomey,300000,90401,Richard Guibert,-900549,-690950,2022-10-05
CASH_IN,114288,Agence_moov_Abomey,300000,185712,Richard Guibert,-690950,-576662,2022-10-06
CASH_IN,232793,Agence_moov_Cotonou,300000,67207,Richard Guibert,-576662,-343869,2022-10-07
CASH_IN,215644,Agence_moov_Cotonou,300000,84356,Richard Guibert,-343869,-128225,2022-10-11
CASH_IN,255074,Agence_moov_Abomey,300000,44926,Richard Guibert,-128225,126849,2022-10-14
CASH_IN,287394,Agence_moov_Ouidah,300000,12606,Richard Guibert,126849,414243,2022-10-18
CASH_OUT,133777,Richard Guibert,414243,280466,Agence_moov_Cotonou,300000,166223,2022-10-19
CASH_IN,230149,Agence_moov_Cotonou,300000,69851,Richard Guibert,280466,510615,2022-10-22
CASH_OUT,63123,Richard Guibert,510615,447492,Agence_moov_Ouidah,300000,236877,2022-10-22
CASH_IN,149113,Agence_moov_Abomey,300000,150887,Hugues Gay,-6064,143049,2022-10-02
CASH_OUT,124670,Hugues Gay,143049,18379,Agence_moov_Abomey,300000,175330,2022-10-03
CASH_IN,277811,Agence_moov_Ouidah,300000,22189,Hugues Gay,18379,296190,2022-10-04
TRANSFER,13194,Hugues Gay,296190,282996,Hugues Gay,296190,282996,2022-10-04
CASH_IN,175340,Agence_moov_Cotonou,300000,124660,Hugues Gay,282996,458336,2022-10-11
CASH_IN,260255,Agence_moov_Cotonou,300000,39745,Hugues Gay,458336,718591,2022-10-12
CASH_IN,146469,Agence_moov_Cotonou,300000,153531,Hugues Gay,718591,865060,2022-10-14
CASH_OUT,559781,Hugues Gay,865060,305279,Agence_moov_Abomey,300000,-259781,2022-10-17
CASH_IN,187179,Agence_moov_Abomey,300000,112821,Hugues Gay,305279,492458,2022-10-19
CASH_IN,19405,Agence_moov_Abomey,300000,280595,Hugues Gay,492458,511863,2022-10-20
CASH_IN,290027,Agence_moov_Abomey,300000,9973,Hugues Gay,511863,801890,2022-10-20
CASH_OUT,689547,Hugues Gay,801890,112343,Agence_moov_Abomey,300000,-389547,2022-10-25
CASH_IN,8378,Agence_moov_Ouidah,300000,291622,Paulette Dias,-653207,-644829,2022-10-03
CASH_IN,103000,Agence_moov_Abomey,300000,197000,Paulette Dias,-644829,-541829,2022-10-05
CASH_IN,27792,Agence_moov_Abomey,300000,272208,Paulette Dias,-541829,-514037,2022-10-13
CASH_IN,21123,Agence_moov_Abomey,300000,278877,Paulette Dias,-514037,-492914,2022-10-13
CASH_IN,33455,Agence_moov_Ouidah,300000,266545,Paulette Dias,-492914,-459459,2022-10-21
CASH_IN,132550,Agence_moov_Ouidah,300000,167450,Paulette Dias,-459459,-326909,2022-10-22
CASH_IN,207856,Agence_moov_Cotonou,300000,92144,Paulette Dias,-326909,-119053,2022-10-23
CASH_IN,94934,Agence_moov_Ouidah,300000,205066,Paulette Dias,-119053,-24119,2022-10-23
CASH_OUT,234365,Émile Hebert,252500,18135,Agence_moov_Ouidah,300000,65635,2022-11-14
CASH_OUT,12081,Émile Hebert,18135,6054,Agence_moov_Abomey,300000,287919,2022-11-16
CASH_IN,30793,Agence_moov_Abomey,300000,269207,Amélie Gros-Riou,460400,491193,2022-11-10
CASH_IN,190429,Agence_moov_Ouidah,300000,109571,Amélie Gros-Riou,491193,681622,2022-11-16
CASH_OUT,114375,Amélie Gros-Riou,681622,567247,Agence_moov_Abomey,300000,185625,2022-11-18
CASH_IN,108565,Agence_moov_Abomey,300000,191435,Amélie Gros-Riou,567247,675812,2022-11-23
CASH_OUT,520781,Amélie Gros-Riou,675812,155031,Agence_moov_Abomey,300000,-220781,2022-11-26
TRANSFER,549820,Sabine Imbert,851500,301680,Nicole Lacroix,206400,756220,2022-11-02
CASH_OUT,622112,Nicole Lacroix,756220,134108,Agence_moov_Cotonou,300000,-322112,2022-11-10
CASH_IN,278536,Agence_moov_Cotonou,300000,21464,Nicole Lacroix,134108,412644,2022-11-12
CASH_OUT,212605,Nicole Lacroix,412644,200039,Agence_moov_Cotonou,300000,87395,2022-11-17
CASH_OUT,1196163,Marc Gilbert,1294900,98737,Agence_moov_Abomey,300000,-896163,2022-11-01
TRANSFER,88399,Marc Gilbert,98737,10338,Auguste Bousquet,67500,-20899,2022-11-02
TRANSFER,9311,Marc Gilbert,10338,1027,Marie Da Silva,438600,429289,2022-11-07
CASH_OUT,592,Marc Gilbert,1027,435,Agence_moov_Ouidah,300000,299408,2022-11-23
TRANSFER,163,Marc Gilbert,435,272,Théodore-Alfred Fournier,474400,474237,2022-11-26
CASH_IN,245668,Agence_moov_Ouidah,300000,54332,Alexandre Poirier,1059200,1304868,2022-11-05
CASH_IN,93995,Agence_moov_Abomey,300000,206005,Alexandre Poirier,1304868,1398863,2022-11-07
TRANSFER,87859,David-Théodore Diaz,135300,47441,Alexandre Poirier,1398863,1486722,2022-11-10
CASH_IN,184639,Agence_moov_Cotonou,300000,115361,Alexandre Poirier,1486722,1671361,2022-11-14
CASH_OUT,187350,Alexandre Poirier,1671361,1484011,Agence_moov_Cotonou,300000,112650,2022-11-23
CASH_IN,35968,Agence_moov_Cotonou,300000,264032,Élodie Gérard,353200,389168,2022-11-25
TRANSFER,216305,Élodie Gérard,389168,172863,Vincent-Philippe Rossi,300100,83795,2022-11-26
CASH_IN,10687,Agence_moov_Abomey,300000,289313,Diane-Françoise Raynaud,883500,894187,2022-11-04
CASH_IN,12120,Agence_moov_Ouidah,300000,287880,Antoine Bourdon de Auger,523100,535220,2022-11-01
CASH_IN,297983,Agence_moov_Cotonou,300000,2017,Antoine Bourdon de Auger,535220,833203,2022-11-23
CASH_IN,158813,Agence_moov_Cotonou,300000,141187,Maurice Alves,1605200,1764013,2022-11-12
CASH_IN,160704,Agence_moov_Cotonou,300000,139296,Maurice Alves,1764013,1924717,2022-11-14
TRANSFER,446061,David Diallo,791900,345839,Matthieu Renard,705000,258939,2022-11-22
CASH_IN,61492,Agence_moov_Abomey,300000,238508,Alphonse Dupont-Petit,533200,594692,2022-11-03
CASH_OUT,571433,Alphonse Dupont-Petit,594692,23259,Agence_moov_Cotonou,300000,-271433,2022-11-11
TRANSFER,13184,Alphonse Dupont-Petit,23259,10075,Agnès Chrétien-Sanchez,1579000,1565816,2022-11-12
CASH_IN,85276,Agence_moov_Ouidah,300000,214724,Alphonse Dupont-Petit,10075,95351,2022-11-20
CASH_IN,94863,Agence_moov_Ouidah,300000,205137,Alphonse Dupont-Petit,95351,190214,2022-11-27
CASH_IN,224903,Agence_moov_Abomey,300000,75097,Alex Salmon,802100,1027003,2022-11-17
CASH_IN,161025,Agence_moov_Abomey,300000,138975,David-Théodore Diaz,47441,208466,2022-11-09
CASH_OUT,73269,David-Théodore Diaz,208466,135197,Agence_moov_Cotonou,300000,226731,2022-11-10
CASH_OUT,27171,David-Théodore Diaz,135197,108026,Agence_moov_Ouidah,300000,272829,2022-11-10
CASH_OUT,66963,David-Théodore Diaz,108026,41063,Agence_moov_Ouidah,300000,233037,2022-11-15
TRANSFER,1177438,Laurent Besson,1931400,753962,David-Théodore Diaz,41063,1218501,2022-11-20
CASH_OUT,68149,Arnaude Gaillard,138400,70251,Agence_moov_Abomey,300000,231851,2022-11-03
CASH_IN,93690,Agence_moov_Cotonou,300000,206310,Arnaude Gaillard,70251,163941,2022-11-07
CASH_IN,9266,Agence_moov_Abomey,300000,290734,Arnaude Gaillard,163941,173207,2022-11-13
TRANSFER,269408,Jacques-Antoine Gros,597400,327992,Océane Boutin,1128100,858692,2022-11-04
CASH_IN,77497,Agence_moov_Abomey,300000,222503,Jacques-Antoine Gros,327992,405489,2022-11-22
TRANSFER,169444,Clémence Bertin,957600,788156,Bernadette Fabre,208700,39256,2022-11-23
CASH_OUT,656477,Clémence Bertin,788156,131679,Agence_moov_Abomey,300000,-356477,2022-11-25
CASH_OUT,157499,Christine-Constance Gauthier,1497900,1340401,Agence_moov_Cotonou,300000,142501,2022-11-18
CASH_IN,59427,Agence_moov_Cotonou,300000,240573,Christophe Alexandre,606700,666127,2022-11-04
TRANSFER,424495,Christophe Alexandre,666127,241632,Gilbert Bazin Le Guillet,254400,-170095,2022-11-04
CASH_IN,250980,Agence_moov_Ouidah,300000,49020,Christophe Alexandre,241632,492612,2022-11-07
CASH_OUT,627542,Christophe Guilbert,673100,45558,Agence_moov_Cotonou,300000,-327542,2022-11-24
CASH_IN,176737,Agence_moov_Abomey,300000,123263,Laurence Dumont de Laroche,1350600,1527337,2022-11-06
CASH_OUT,1314961,Laurence Dumont de Laroche,1527337,212376,Agence_moov_Abomey,300000,-1014961,2022-11-10
TRANSFER,96908,Léon Paris,810200,713292,Laurence Dumont de Laroche,212376,309284,2022-11-17
CASH_OUT,769097,Nath Léger,818100,49003,Agence_moov_Ouidah,300000,-469097,2022-11-07
CASH_OUT,48186,Nath Léger,49003,817,Agence_moov_Ouidah,300000,251814,2022-11-10
CASH_OUT,770,Nath Léger,817,47,Agence_moov_Cotonou,300000,299230,2022-11-10
CASH_IN,19724,Agence_moov_Abomey,300000,280276,Océane Boutin,858692,878416,2022-11-02
CASH_OUT,543370,Océane Boutin,878416,335046,Agence_moov_Cotonou,300000,-243370,2022-11-11
CASH_OUT,5893,Océane Boutin,335046,329153,Agence_moov_Ouidah,300000,294107,2022-11-25
CASH_OUT,245363,Océane Boutin,329153,83790,Agence_moov_Abomey,300000,54637,2022-11-26
CASH_IN,1783,Agence_moov_Cotonou,300000,298217,Anastasie Louis,1158400,1160183,2022-11-12
CASH_OUT,692685,Guy Guyon,1169200,476515,Agence_moov_Cotonou,300000,-392685,2022-11-02
CASH_OUT,183743,Guy Guyon,476515,292772,Agence_moov_Abomey,300000,116257,2022-11-02
TRANSFER,60273,Guy Guyon,292772,232499,Caroline Monnier,995400,935127,2022-11-14
TRANSFER,278793,Susan de Fontaine,989800,711007,Vincent-Grégoire Brunet,1086300,807507,2022-11-12
TRANSFER,20431,Susan de Fontaine,711007,690576,Maryse Lebreton,1576300,1555869,2022-11-18
TRANSFER,71698,Richard Guibert,92900,21202,Léon Paris,713292,641594,2022-11-01
CASH_OUT,19992,Richard Guibert,21202,1210,Agence_moov_Cotonou,300000,280008,2022-11-02
CASH_IN,198857,Agence_moov_Ouidah,300000,101143,Richard Guibert,1210,200067,2022-11-06
TRANSFER,137912,Richard Guibert,200067,62155,Claudine Vallet,1037000,899088,2022-11-06
CASH_OUT,55944,Richard Guibert,62155,6211,Agence_moov_Ouidah,300000,244056,2022-11-07
CASH_IN,99407,Agence_moov_Cotonou,300000,200593,Richard Guibert,6211,105618,2022-11-08
CASH_OUT,1591,Richard Guibert,105618,104027,Agence_moov_Cotonou,300000,298409,2022-11-11
TRANSFER,88441,Richard Guibert,104027,15586,Vincent-Grégoire Brunet,807507,719066,2022-11-12
TRANSFER,1454358,Juliette Evrard Le Giraud,1987400,533042,Richard Guibert,15586,1469944,2022-11-12
TRANSFER,957103,Richard Guibert,1469944,512841,Marthe Pichon,1941000,983897,2022-11-13
TRANSFER,451188,Richard Guibert,512841,61653,Luc-Tristan Moreau,446900,-4288,2022-11-14
CASH_OUT,47588,Richard Guibert,61653,14065,Agence_moov_Ouidah,300000,252412,2022-11-14
TRANSFER,9642,Richard Guibert,14065,4423,Luc Camus,1761300,1751658,2022-11-15
CASH_OUT,4309,Richard Guibert,4423,114,Agence_moov_Ouidah,300000,295691,2022-11-16
CASH_OUT,112,Richard Guibert,114,2,Agence_moov_Cotonou,300000,299888,2022-11-16
CASH_IN,31277,Agence_moov_Abomey,300000,268723,Richard Guibert,2,31279,2022-11-19
CASH_OUT,26048,Richard Guibert,31279,5231,Agence_moov_Abomey,300000,273952,2022-11-20
TRANSFER,824189,Gabriel de Pineau,1376800,552611,Richard Guibert,5231,829420,2022-11-21
TRANSFER,272792,Richard Guibert,829420,556628,Nathalie-Chantal Jacques,1294900,1022108,2022-11-22
TRANSFER,432089,Richard Guibert,556628,124539,Maryse Lebreton,1555869,1123780,2022-11-23
CASH_OUT,23696,Richard Guibert,124539,100843,Agence_moov_Cotonou,300000,276304,2022-11-24
CASH_OUT,10126,Richard Guibert,100843,90717,Agence_moov_Ouidah,300000,289874,2022-11-25
CASH_OUT,73902,Richard Guibert,90717,16815,Agence_moov_Abomey,300000,226098,2022-11-27
CASH_IN,65748,Agence_moov_Ouidah,300000,234252,Richard Guibert,16815,82563,2022-11-27
CASH_IN,134941,Agence_moov_Ouidah,300000,165059,Maryse Lebreton,1123780,1258721,2022-11-03
CASH_OUT,580221,Maryse Lebreton,1258721,678500,Agence_moov_Cotonou,300000,-280221,2022-11-04
TRANSFER,680463,Emmanuel Bousquet,718800,38337,Maryse Lebreton,678500,1358963,2022-11-06
CASH_OUT,819106,Maryse Lebreton,1358963,539857,Agence_moov_Cotonou,300000,-519106,2022-11-08
TRANSFER,444165,Laurent Besson,753962,309797,Maryse Lebreton,539857,984022,2022-11-08
CASH_OUT,730901,Maryse Lebreton,984022,253121,Agence_moov_Abomey,300000,-430901,2022-11-08
CASH_OUT,27640,Maryse Lebreton,253121,225481,Agence_moov_Cotonou,300000,272360,2022-11-09
CASH_IN,90138,Agence_moov_Ouidah,300000,209862,Maryse Lebreton,225481,315619,2022-11-09
CASH_OUT,170655,Maryse Lebreton,315619,144964,Agence_moov_Cotonou,300000,129345,2022-11-10
TRANSFER,125421,Maryse Lebreton,144964,19543,Joseph de la Dubois,944200,818779,2022-11-13
TRANSFER,1244749,Agnès Chrétien-Sanchez,1565816,321067,Maryse Lebreton,19543,1264292,2022-11-13
CASH_OUT,1131923,Maryse Lebreton,1264292,132369,Agence_moov_Abomey,300000,-831923,2022-11-15
CASH_OUT,103590,Maryse Lebreton,132369,28779,Agence_moov_Abomey,300000,196410,2022-11-16
TRANSFER,581786,Léon Paris,641594,59808,Maryse Lebreton,28779,610565,2022-11-17
CASH_IN,39598,Agence_moov_Abomey,300000,260402,Maryse Lebreton,610565,650163,2022-11-18
CASH_OUT,404668,Maryse Lebreton,650163,245495,Agence_moov_Cotonou,300000,-104668,2022-11-19
TRANSFER,196990,Maryse Lebreton,245495,48505,Nathalie-Chantal Jacques,1022108,825118,2022-11-20
CASH_IN,264486,Agence_moov_Ouidah,300000,35514,Maryse Lebreton,48505,312991,2022-11-23
CASH_IN,238274,Agence_moov_Cotonou,300000,61726,Maryse Lebreton,312991,551265,2022-11-23
CASH_IN,131682,Agence_moov_Ouidah,300000,168318,Maryse Lebreton,551265,682947,2022-11-24
CASH_OUT,314445,Maryse Lebreton,682947,368502,Agence_moov_Ouidah,300000,-14445,2022-11-24
TRANSFER,48283,Sabine Imbert,301680,253397,Maryse Lebreton,368502,416785,2022-11-25
CASH_OUT,341551,Maryse Lebreton,416785,75234,Agence_moov_Ouidah,300000,-41551,2022-11-25
CASH_IN,240289,Agence_moov_Ouidah,300000,59711,Maryse Lebreton,75234,315523,2022-11-26
TRANSFER,10961,Maryse Lebreton,315523,304562,Roland Colin,958500,947539,2022-11-26
TRANSFER,311113,Marie Da Silva,429289,118176,Maryse Lebreton,304562,615675,2022-11-27
CASH_IN,93155,Agence_moov_Abomey,300000,206845,Caroline Monnier,935127,1028282,2022-11-01
TRANSFER,247955,Caroline Monnier,1028282,780327,Stéphanie Bonneau,1817300,1569345,2022-11-02
CASH_OUT,59141,Caroline Monnier,780327,721186,Agence_moov_Cotonou,300000,240859,2022-11-02
CASH_IN,189761,Agence_moov_Cotonou,300000,110239,Caroline Monnier,721186,910947,2022-11-03
CASH_IN,66754,Agence_moov_Ouidah,300000,233246,Caroline Monnier,910947,977701,2022-11-04
CASH_OUT,807242,Caroline Monnier,977701,170459,Agence_moov_Abomey,300000,-507242,2022-11-04
CASH_IN,142017,Agence_moov_Abomey,300000,157983,Caroline Monnier,170459,312476,2022-11-06
TRANSFER,433411,Luc Camus,1751658,1318247,Caroline Monnier,312476,745887,2022-11-06
TRANSFER,581784,Caroline Monnier,745887,164103,Théodore Bertin,831700,249916,2022-11-07
TRANSFER,84411,Caroline Monnier,164103,79692,Stéphane-Timothée Pineau,426000,341589,2022-11-08
TRANSFER,30828,Caroline Monnier,79692,48864,Caroline Monnier,79692,110520,2022-11-08
TRANSFER,35734,Caroline Monnier,48864,13130,Antoine Leroux,858800,823066,2022-11-09
CASH_OUT,12358,Caroline Monnier,13130,772,Agence_moov_Cotonou,300000,287642,2022-11-10
CASH_OUT,502,Caroline Monnier,772,270,Agence_moov_Ouidah,300000,299498,2022-11-11
TRANSFER,211,Caroline Monnier,270,59,Frédéric Moreau,14900,14689,2022-11-12
CASH_IN,25875,Agence_moov_Cotonou,300000,274125,Caroline Monnier,59,25934,2022-11-12
CASH_IN,48229,Agence_moov_Cotonou,300000,251771,Caroline Monnier,25934,74163,2022-11-13
CASH_IN,242822,Agence_moov_Abomey,300000,57178,Caroline Monnier,74163,316985,2022-11-14
TRANSFER,11727,Léon Paris,59808,48081,Caroline Monnier,316985,328712,2022-11-20
TRANSFER,12119,Emmanuel Bousquet,38337,26218,Caroline Monnier,328712,340831,2022-11-21
CASH_OUT,135305,Caroline Monnier,340831,205526,Agence_moov_Ouidah,300000,164695,2022-11-23
CASH_OUT,21683,Caroline Monnier,205526,183843,Agence_moov_Abomey,300000,278317,2022-11-24
CASH_IN,53991,Agence_moov_Cotonou,300000,246009,Caroline Monnier,183843,237834,2022-11-25
CASH_IN,284398,Agence_moov_Cotonou,300000,15602,Caroline Monnier,237834,522232,2022-11-25
TRANSFER,15895,Bernadette Fabre,39256,23361,Caroline Monnier,522232,538127,2022-11-25
CASH_OUT,116120,Caroline Monnier,538127,422007,Agence_moov_Abomey,300000,183880,2022-11-27
CASH_IN,41063,Agence_moov_Ouidah,300000,258937,Vincent-Grégoire Brunet,719066,760129,2022-11-01
CASH_IN,139227,Agence_moov_Abomey,300000,160773,Vincent-Grégoire Brunet,760129,899356,2022-11-02
CASH_OUT,406756,Vincent-Grégoire Brunet,899356,492600,Agence_moov_Abomey,300000,-106756,2022-11-03
CASH_OUT,217252,Vincent-Grégoire Brunet,492600,275348,Agence_moov_Ouidah,300000,82748,2022-11-04
TRANSFER,63678,Lucy Vaillant,1716900,1653222,Vincent-Grégoire Brunet,275348,339026,2022-11-04
CASH_OUT,142787,Vincent-Grégoire Brunet,339026,196239,Agence_moov_Cotonou,300000,157213,2022-11-05
CASH_OUT,169113,Vincent-Grégoire Brunet,196239,27126,Agence_moov_Ouidah,300000,130887,2022-11-06
CASH_OUT,3288,Vincent-Grégoire Brunet,27126,23838,Agence_moov_Ouidah,300000,296712,2022-11-06
CASH_OUT,1411,Vincent-Grégoire Brunet,23838,22427,Agence_moov_Cotonou,300000,298589,2022-11-06
CASH_OUT,10962,Vincent-Grégoire Brunet,22427,11465,Agence_moov_Cotonou,300000,289038,2022-11-06
CASH_OUT,6875,Vincent-Grégoire Brunet,11465,4590,Agence_moov_Ouidah,300000,293125,2022-11-07
CASH_IN,101071,Agence_moov_Abomey,300000,198929,Vincent-Grégoire Brunet,4590,105661,2022-11-09
CASH_OUT,31952,Vincent-Grégoire Brunet,105661,73709,Agence_moov_Cotonou,300000,268048,2022-11-09
CASH_IN,294188,Agence_moov_Cotonou,300000,5812,Vincent-Grégoire Brunet,73709,367897,2022-11-12
TRANSFER,361070,Vincent-Grégoire Brunet,367897,6827,Sébastien-Arthur Masse,550000,188930,2022-11-13
TRANSFER,120168,Julie Robin de Gros,162100,41932,Vincent-Grégoire Brunet,6827,126995,2022-11-15
TRANSFER,81965,Vincent-Philippe Rossi,83795,1830,Vincent-Grégoire Brunet,126995,208960,2022-11-17
CASH_OUT,180000,Vincent-Grégoire Brunet,208960,28960,Agence_moov_Cotonou,300000,120000,2022-11-19
TRANSFER,20067,Vincent-Grégoire Brunet,28960,8893,Marine-Clémence Ferreira,533400,513333,2022-11-20
TRANSFER,3196,Vincent-Grégoire Brunet,8893,5697,Marianne Descamps,399400,396204,2022-11-20
CASH_OUT,1880,Vincent-Grégoire Brunet,5697,3817,Agence_moov_Ouidah,300000,298120,2022-11-22
CASH_OUT,1066,Vincent-Grégoire Brunet,3817,2751,Agence_moov_Cotonou,300000,298934,2022-11-23
CASH_OUT,686,Vincent-Grégoire Brunet,2751,2065,Agence_moov_Ouidah,300000,299314,2022-11-25
CASH_OUT,1551,Vincent-Grégoire Brunet,2065,514,Agence_moov_Cotonou,300000,298449,2022-11-26
CASH_OUT,483,Vincent-Grégoire Brunet,514,31,Agence_moov_Cotonou,300000,299517,2022-11-27
CASH_IN,89434,Agence_moov_Cotonou,300000,210566,Vincent-Grégoire Brunet,31,89465,2022-11-27
CASH_IN,299066,Agence_moov_Abomey,300000,934,Gilbert Bazin Le Guillet,-170095,128971,2022-11-01
CASH_IN,299349,Agence_moov_Abomey,300000,651,Gilbert Bazin Le Guillet,128971,428320,2022-11-02
CASH_OUT,162085,Gilbert Bazin Le Guillet,428320,266235,Agence_moov_Cotonou,300000,137915,2022-11-02
TRANSFER,749890,Amélie de la Picard,1381900,632010,Gilbert Bazin Le Guillet,266235,1016125,2022-11-04
TRANSFER,28871,Matthieu Carpentier,51700,22829,Gilbert Bazin Le Guillet,1016125,1044996,2022-11-04
CASH_OUT,7775,Gilbert Bazin Le Guillet,1044996,1037221,Agence_moov_Ouidah,300000,292225,2022-11-06
TRANSFER,335902,Nathalie-Chantal Jacques,825118,489216,Gilbert Bazin Le Guillet,1037221,1373123,2022-11-06
CASH_OUT,636671,Gilbert Bazin Le Guillet,1373123,736452,Agence_moov_Ouidah,300000,-336671,2022-11-07
CASH_IN,18142,Agence_moov_Cotonou,300000,281858,Gilbert Bazin Le Guillet,736452,754594,2022-11-08
CASH_OUT,162444,Gilbert Bazin Le Guillet,754594,592150,Agence_moov_Cotonou,300000,137556,2022-11-08
CASH_OUT,90760,Gilbert Bazin Le Guillet,592150,501390,Agence_moov_Cotonou,300000,209240,2022-11-09
CASH_IN,64971,Agence_moov_Abomey,300000,235029,Gilbert Bazin Le Guillet,501390,566361,2022-11-12
CASH_OUT,204398,Gilbert Bazin Le Guillet,566361,361963,Agence_moov_Ouidah,300000,95602,2022-11-13
CASH_OUT,139778,Gilbert Bazin Le Guillet,361963,222185,Agence_moov_Cotonou,300000,160222,2022-11-14
CASH_IN,34344,Agence_moov_Ouidah,300000,265656,Gilbert Bazin Le Guillet,222185,256529,2022-11-16
CASH_OUT,965,Gilbert Bazin Le Guillet,256529,255564,Agence_moov_Ouidah,300000,299035,2022-11-16
CASH_IN,6585,Agence_moov_Ouidah,300000,293415,Gilbert Bazin Le Guillet,255564,262149,2022-11-17
CASH_OUT,148679,Gilbert Bazin Le Guillet,262149,113470,Agence_moov_Cotonou,300000,151321,2022-11-18
CASH_IN,159264,Agence_moov_Abomey,300000,140736,Gilbert Bazin Le Guillet,113470,272734,2022-11-18
CASH_OUT,93819,Gilbert Bazin Le Guillet,272734,178915,Agence_moov_Abomey,300000,206181,2022-11-18
CASH_OUT,70790,Gilbert Bazin Le Guillet,178915,108125,Agence_moov_Cotonou,300000,229210,2022-11-19
CASH_OUT,46885,Gilbert Bazin Le Guillet,108125,61240,Agence_moov_Ouidah,300000,253115,2022-11-22
CASH_IN,62651,Agence_moov_Abomey,300000,237349,Gilbert Bazin Le Guillet,61240,123891,2022-11-24
CASH_IN,107176,Agence_moov_Abomey,300000,192824,Gilbert Bazin Le Guillet,123891,231067,2022-11-25
TRANSFER,19693,Gilbert Bazin Le Guillet,231067,211374,Josette Guillon-Leclercq,1562700,1543007,2022-11-25
TRANSFER,548013,Laurence Carlier,1582400,1034387,Frédérique Robin,68500,616513,2022-11-03
CASH_OUT,446988,Frédérique Robin,616513,169525,Agence_moov_Abomey,300000,-146988,2022-11-03
TRANSFER,120327,Frédérique Robin,169525,49198,Léon Paris,48081,-72246,2022-11-05
CASH_OUT,16230,Frédérique Robin,49198,32968,Agence_moov_Ouidah,300000,283770,2022-11-06
CASH_IN,22820,Agence_moov_Cotonou,300000,277180,Frédérique Robin,32968,55788,2022-11-06
TRANSFER,3922,Maurice Seguin,169300,165378,Frédérique Robin,55788,59710,2022-11-07
CASH_IN,82083,Agence_moov_Cotonou,300000,217917,Frédérique Robin,59710,141793,2022-11-08
TRANSFER,217462,Marthe Guillet,888000,670538,Frédérique Robin,141793,359255,2022-11-08
CASH_IN,8640,Agence_moov_Abomey,300000,291360,Frédérique Robin,359255,367895,2022-11-10
CASH_OUT,164364,Frédérique Robin,367895,203531,Agence_moov_Abomey,300000,135636,2022-11-11
TRANSFER,80824,Frédérique Robin,203531,122707,Sébastien-Arthur Masse,188930,108106,2022-11-13
CASH_IN,123121,Agence_moov_Abomey,300000,176879,Frédérique Robin,122707,245828,2022-11-13
CASH_IN,836,Agence_moov_Cotonou,300000,299164,Frédérique Robin,245828,246664,2022-11-13
CASH_IN,262040,Agence_moov_Cotonou,300000,37960,Frédérique Robin,246664,508704,2022-11-13
CASH_IN,211119,Agence_moov_Cotonou,300000,88881,Frédérique Robin,508704,719823,2022-11-14
CASH_IN,189681,Agence_moov_Cotonou,300000,110319,Frédérique Robin,719823,909504,2022-11-15
CASH_IN,297701,Agence_moov_Cotonou,300000,2299,Frédérique Robin,909504,1207205,2022-11-15
CASH_IN,241877,Agence_moov_Abomey,300000,58123,Frédérique Robin,1207205,1449082,2022-11-17
CASH_IN,52553,Agence_moov_Abomey,300000,247447,Frédérique Robin,1449082,1501635,2022-11-18
CASH_IN,168664,Agence_moov_Abomey,300000,131336,Frédérique Robin,1501635,1670299,2022-11-19
TRANSFER,1191385,Frédérique Robin,1670299,478914,Frédéric Moreau,14689,-1176696,2022-11-21
TRANSFER,77750,Marie Da Silva,118176,40426,Frédérique Robin,478914,556664,2022-11-22
CASH_IN,209153,Agence_moov_Ouidah,300000,90847,Frédérique Robin,556664,765817,2022-11-24
TRANSFER,1519111,Josette Guillon-Leclercq,1543007,23896,Frédérique Robin,765817,2284928,2022-11-24
CASH_IN,112321,Agence_moov_Abomey,300000,187679,Frédérique Robin,2284928,2397249,2022-11-24
TRANSFER,2068673,Frédérique Robin,2397249,328576,Gabriel de Pineau,552611,-1516062,2022-11-24
TRANSFER,52815,Frédérique Robin,328576,275761,Stéphanie Bonneau,1569345,1516530,2022-11-25
TRANSFER,246002,Paul Pereira,1864100,1618098,Frédérique Robin,275761,521763,2022-11-26
CASH_IN,131967,Agence_moov_Cotonou,300000,168033,Frédérique Robin,521763,653730,2022-11-27
TRANSFER,297074,Théodore-Alfred Fournier,474237,177163,Michèle Vallée,1692200,1989274,2022-11-03
CASH_OUT,1919246,Michèle Vallée,1989274,70028,Agence_moov_Cotonou,300000,-1619246,2022-11-03
TRANSFER,9481,Michèle Vallée,70028,60547,Amélie de la Picard,632010,622529,2022-11-04
TRANSFER,136502,Matthieu Renard,258939,122437,Michèle Vallée,60547,197049,2022-11-06
TRANSFER,6132,Michèle Vallée,197049,190917,Marthe Pichon,983897,977765,2022-11-07
CASH_IN,239455,Agence_moov_Abomey,300000,60545,Michèle Vallée,190917,430372,2022-11-08
CASH_OUT,84445,Michèle Vallée,430372,345927,Agence_moov_Ouidah,300000,215555,2022-11-09
TRANSFER,218148,Marianne Descamps,396204,178056,Michèle Vallée,345927,564075,2022-11-10
TRANSFER,45015,Michèle Vallée,564075,519060,Valentine Traore,464500,419485,2022-11-11
CASH_IN,174890,Agence_moov_Abomey,300000,125110,Michèle Vallée,519060,693950,2022-11-14
TRANSFER,76312,Michèle Vallée,693950,617638,Augustin Benard,1856800,1780488,2022-11-15
CASH_OUT,14717,Michèle Vallée,617638,602921,Agence_moov_Cotonou,300000,285283,2022-11-15
TRANSFER,2090,Josette Guillon-Leclercq,23896,21806,Michèle Vallée,602921,605011,2022-11-15
TRANSFER,82622,Valentine Traore,419485,336863,Michèle Vallée,605011,687633,2022-11-15
CASH_IN,58959,Agence_moov_Abomey,300000,241041,Michèle Vallée,687633,746592,2022-11-15
TRANSFER,721037,Michèle Vallée,746592,25555,Matthieu Carpentier,22829,-698208,2022-11-17
CASH_IN,86575,Agence_moov_Ouidah,300000,213425,Michèle Vallée,25555,112130,2022-11-17
CASH_IN,213582,Agence_moov_Cotonou,300000,86418,Michèle Vallée,112130,325712,2022-11-18
TRANSFER,71468,Nicolas Hervé,390200,318732,Michèle Vallée,325712,397180,2022-11-21
CASH_IN,157403,Agence_moov_Abomey,300000,142597,Michèle Vallée,397180,554583,2022-11-23
TRANSFER,300747,Amélie de la Picard,622529,321782,Michèle Vallée,554583,855330,2022-11-25
CASH_OUT,473333,Michèle Vallée,855330,381997,Agence_moov_Abomey,300000,-173333,2022-11-25
CASH_IN,68450,Agence_moov_Ouidah,300000,231550,Michèle Vallée,381997,450447,2022-11-25
TRANSFER,328990,Noël Hamel,343200,14210,Michèle Vallée,450447,779437,2022-11-25
TRANSFER,222286,Sabine Imbert,253397,31111,Marthe Pichon,977765,755479,2022-11-01
CASH_IN,16745,Agence_moov_Cotonou,300000,283255,Sabine Imbert,31111,47856,2022-11-01
CASH_OUT,26827,Sabine Imbert,47856,21029,Agence_moov_Abomey,300000,273173,2022-11-02
TRANSFER,1229,Sabine Imbert,21029,19800,Josette Guillon-Leclercq,21806,20577,2022-11-03
CASH_OUT,14820,Sabine Imbert,19800,4980,Agence_moov_Abomey,300000,285180,2022-11-05
CASH_OUT,981,Sabine Imbert,4980,3999,Agence_moov_Ouidah,300000,299019,2022-11-06
CASH_OUT,2601,Sabine Imbert,3999,1398,Agence_moov_Cotonou,300000,297399,2022-11-07
CASH_IN,294296,Agence_moov_Cotonou,300000,5704,Sabine Imbert,1398,295694,2022-11-08
CASH_IN,147018,Agence_moov_Cotonou,300000,152982,Sabine Imbert,295694,442712,2022-11-08
TRANSFER,93143,Sabine Imbert,442712,349569,Xavier-Stéphane Ollivier,1760200,1667057,2022-11-08
CASH_IN,47205,Agence_moov_Cotonou,300000,252795,Sabine Imbert,349569,396774,2022-11-09
TRANSFER,802034,Laurence Carlier,1034387,232353,Sabine Imbert,396774,1198808,2022-11-09
CASH_IN,45913,Agence_moov_Ouidah,300000,254087,Sabine Imbert,1198808,1244721,2022-11-12
CASH_IN,161531,Agence_moov_Ouidah,300000,138469,Sabine Imbert,1244721,1406252,2022-11-12
CASH_IN,184787,Agence_moov_Ouidah,300000,115213,Sabine Imbert,1406252,1591039,2022-11-13
CASH_IN,200275,Agence_moov_Abomey,300000,99725,Sabine Imbert,1591039,1791314,2022-11-13
CASH_OUT,1519810,Sabine Imbert,1791314,271504,Agence_moov_Cotonou,300000,-1219810,2022-11-14
CASH_OUT,243745,Sabine Imbert,271504,27759,Agence_moov_Ouidah,300000,56255,2022-11-14
TRANSFER,134925,Théodore Bertin,249916,114991,Sabine Imbert,27759,162684,2022-11-14
TRANSFER,1528649,Paul Pereira,1618098,89449,Sabine Imbert,162684,1691333,2022-11-15
CASH_IN,222880,Agence_moov_Abomey,300000,77120,Sabine Imbert,1691333,1914213,2022-11-18
TRANSFER,70903,Maurice Seguin,165378,94475,Sabine Imbert,1914213,1985116,2022-11-21
TRANSFER,719660,Sabine Imbert,1985116,1265456,Laurent Perrot,1047200,327540,2022-11-23
TRANSFER,162435,Emmanuel-René Coulon,579400,416965,Sabine Imbert,1265456,1427891,2022-11-23
CASH_IN,207790,Agence_moov_Cotonou,300000,92210,Sabine Imbert,1427891,1635681,2022-11-25
TRANSFER,118293,Sabine Imbert,1635681,1517388,Marthe Pichon,755479,637186,2022-11-25
CASH_OUT,1512867,Sabine Imbert,1517388,4521,Agence_moov_Cotonou,300000,-1212867,2022-11-27
TRANSFER,204424,Marine-Clémence Ferreira,513333,308909,Laurent Perrot,327540,123116,2022-11-01
TRANSFER,32201,Théodore-Alfred Fournier,177163,144962,Marine-Clémence Ferreira,308909,341110,2022-11-01
CASH_OUT,191624,Marine-Clémence Ferreira,341110,149486,Agence_moov_Abomey,300000,108376,2022-11-03
CASH_OUT,48579,Marine-Clémence Ferreira,149486,100907,Agence_moov_Ouidah,300000,251421,2022-11-03
TRANSFER,24506,Marie Da Silva,40426,15920,Marine-Clémence Ferreira,100907,125413,2022-11-03
CASH_IN,228371,Agence_moov_Cotonou,300000,71629,Marine-Clémence Ferreira,125413,353784,2022-11-04
CASH_IN,286767,Agence_moov_Abomey,300000,13233,Marine-Clémence Ferreira,353784,640551,2022-11-05
CASH_OUT,335691,Marine-Clémence Ferreira,640551,304860,Agence_moov_Ouidah,300000,-35691,2022-11-10
TRANSFER,8114,Emmanuelle Gilbert,18800,10686,Marine-Clémence Ferreira,304860,312974,2022-11-11
TRANSFER,77450,Marine-Clémence Ferreira,312974,235524,Théodore Bertin,114991,37541,2022-11-12
CASH_OUT,187018,Marine-Clémence Ferreira,235524,48506,Agence_moov_Ouidah,300000,112982,2022-11-12
TRANSFER,1059690,Joséphine Weber du Bonnin,1202900,143210,Marine-Clémence Ferreira,48506,1108196,2022-11-14
CASH_OUT,836123,Marine-Clémence Ferreira,1108196,272073,Agence_moov_Abomey,300000,-536123,2022-11-15
CASH_OUT,161033,Marine-Clémence Ferreira,272073,111040,Agence_moov_Cotonou,300000,138967,2022-11-15
TRANSFER,72097,Marine-Clémence Ferreira,111040,38943,Juliette Evrard Le Giraud,533042,460945,2022-11-17
CASH_IN,192477,Agence_moov_Cotonou,300000,107523,Marine-Clémence Ferreira,38943,231420,2022-11-19
CASH_OUT,88939,Marine-Clémence Ferreira,231420,142481,Agence_moov_Abomey,300000,211061,2022-11-19
CASH_IN,198336,Agence_moov_Cotonou,300000,101664,Marine-Clémence Ferreira,142481,340817,2022-11-19
CASH_OUT,207006,Marine-Clémence Ferreira,340817,133811,Agence_moov_Ouidah,300000,92994,2022-11-20
CASH_IN,187559,Agence_moov_Ouidah,300000,112441,Marine-Clémence Ferreira,133811,321370,2022-11-22
TRANSFER,78562,Marine-Clémence Ferreira,321370,242808,Nathalie-Chantal Jacques,489216,410654,2022-11-22
TRANSFER,211518,Marine-Clémence Ferreira,242808,31290,Laurent Perrot,123116,-88402,2022-11-22
CASH_IN,272796,Agence_moov_Cotonou,300000,27204,Marine-Clémence Ferreira,31290,304086,2022-11-24
CASH_IN,119581,Agence_moov_Abomey,300000,180419,Marine-Clémence Ferreira,304086,423667,2022-11-25
CASH_OUT,70658,Marine-Clémence Ferreira,423667,353009,Agence_moov_Cotonou,300000,229342,2022-11-25
TRANSFER,10822,Bernadette Fabre,23361,12539,Marine-Clémence Ferreira,353009,363831,2022-11-26
CASH_IN,182947,Agence_moov_Abomey,300000,117053,Marine-Clémence Ferreira,363831,546778,2022-11-27
TRANSFER,384381,Constance Regnier,1035700,651319,Claudine Vallet,899088,1283469,2022-11-01
CASH_OUT,722622,Claudine Vallet,1283469,560847,Agence_moov_Cotonou,300000,-422622,2022-11-02
TRANSFER,484836,Claudine Vallet,560847,76011,Julie Robin de Gros,41932,-442904,2022-11-02
TRANSFER,5392,Claudine Vallet,76011,70619,Joséphine Weber du Bonnin,143210,137818,2022-11-03
CASH_OUT,16828,Claudine Vallet,70619,53791,Agence_moov_Cotonou,300000,283172,2022-11-04
CASH_IN,173351,Agence_moov_Ouidah,300000,126649,Claudine Vallet,53791,227142,2022-11-05
CASH_IN,93973,Agence_moov_Abomey,300000,206027,Claudine Vallet,227142,321115,2022-11-07
TRANSFER,238757,Claudine Vallet,321115,82358,Claudine Vallet,321115,82358,2022-11-10
CASH_OUT,44776,Claudine Vallet,82358,37582,Agence_moov_Cotonou,300000,255224,2022-11-14
TRANSFER,5653,Claudine Vallet,37582,31929,Caroline Peltier,1750300,1744647,2022-11-14
CASH_IN,110937,Agence_moov_Abomey,300000,189063,Claudine Vallet,31929,142866,2022-11-15
TRANSFER,45255,Laurent Besson,309797,264542,Claudine Vallet,142866,188121,2022-11-16
CASH_IN,188766,Agence_moov_Cotonou,300000,111234,Claudine Vallet,188121,376887,2022-11-16
CASH_IN,154756,Agence_moov_Cotonou,300000,145244,Claudine Vallet,376887,531643,2022-11-16
TRANSFER,241821,Laurent Besson,264542,22721,Claudine Vallet,531643,773464,2022-11-18
TRANSFER,33378,Claudine Vallet,773464,740086,Nathalie-Chantal Jacques,410654,377276,2022-11-19
CASH_OUT,351851,Claudine Vallet,740086,388235,Agence_moov_Cotonou,300000,-51851,2022-11-20
TRANSFER,330089,Claudine Vallet,388235,58146,Emmanuel Bousquet,26218,-303871,2022-11-20
CASH_IN,226867,Agence_moov_Ouidah,300000,73133,Claudine Vallet,58146,285013,2022-11-20
TRANSFER,6435,Maurice Seguin,94475,88040,Claudine Vallet,285013,291448,2022-11-21
CASH_IN,273162,Agence_moov_Abomey,300000,26838,Claudine Vallet,291448,564610,2022-11-21
TRANSFER,421159,Augustin Benard,1780488,1359329,Claudine Vallet,564610,985769,2022-11-24
TRANSFER,289569,Emmanuel-René Coulon,416965,127396,Claudine Vallet,985769,1275338,2022-11-24
TRANSFER,58345,Maryse Reynaud-Michaud,87600,29255,Claudine Vallet,1275338,1333683,2022-11-24
TRANSFER,138386,Claudine Vallet,1333683,1195297,Sébastien Jourdan,1109000,970614,2022-11-25
CASH_IN,104228,Agence_moov_Cotonou,300000,195772,Claudine Vallet,1195297,1299525,2022-11-26
CASH_IN,275120,Agence_moov_Abomey,300000,24880,Claudine Vallet,1299525,1574645,2022-11-27
TRANSFER,27127,Stéphanie Bonneau,1516530,1489403,Valentine Traore,336863,309736,2022-11-01
CASH_IN,90165,Agence_moov_Abomey,300000,209835,Stéphanie Bonneau,1489403,1579568,2022-11-02
CASH_IN,87560,Agence_moov_Abomey,300000,212440,Stéphanie Bonneau,1579568,1667128,2022-11-02
TRANSFER,81163,Adélaïde-Sophie Leclercq,1792800,1711637,Stéphanie Bonneau,1667128,1748291,2022-11-02
TRANSFER,9685,Théodore Bertin,37541,27856,Stéphanie Bonneau,1748291,1757976,2022-11-03
CASH_IN,96492,Agence_moov_Cotonou,300000,203508,Stéphanie Bonneau,1757976,1854468,2022-11-03
TRANSFER,26397,Paulette Dias,97100,70703,Stéphanie Bonneau,1854468,1880865,2022-11-03
CASH_OUT,587969,Stéphanie Bonneau,1880865,1292896,Agence_moov_Abomey,300000,-287969,2022-11-04
CASH_OUT,234355,Stéphanie Bonneau,1292896,1058541,Agence_moov_Abomey,300000,65645,2022-11-06
CASH_IN,234256,Agence_moov_Abomey,300000,65744,Stéphanie Bonneau,1058541,1292797,2022-11-07
CASH_OUT,1022154,Stéphanie Bonneau,1292797,270643,Agence_moov_Ouidah,300000,-722154,2022-11-07
TRANSFER,2723,Stéphanie Bonneau,270643,267920,Émilie Guillon de Duhamel,232400,229677,2022-11-09
TRANSFER,52150,Stéphanie Bonneau,267920,215770,Vincent-Philippe Rossi,1830,-50320,2022-11-09
CASH_IN,265993,Agence_moov_Cotonou,300000,34007,Stéphanie Bonneau,215770,481763,2022-11-11
CASH_OUT,276449,Stéphanie Bonneau,481763,205314,Agence_moov_Ouidah,300000,23551,2022-11-12
TRANSFER,450199,Roland Colin,947539,497340,Stéphanie Bonneau,205314,655513,2022-11-13
TRANSFER,197375,Nicolas Grondin de la Pinto,299300,101925,Stéphanie Bonneau,655513,852888,2022-11-15
TRANSFER,949284,Alfred Chrétien,1151900,202616,Stéphanie Bonneau,852888,1802172,2022-11-17
CASH_IN,284329,Agence_moov_Ouidah,300000,15671,Stéphanie Bonneau,1802172,2086501,2022-11-18
CASH_IN,167870,Agence_moov_Cotonou,300000,132130,Stéphanie Bonneau,2086501,2254371,2022-11-20
CASH_OUT,370639,Stéphanie Bonneau,2254371,1883732,Agence_moov_Abomey,300000,-70639,2022-11-20
CASH_IN,203223,Agence_moov_Abomey,300000,96777,Stéphanie Bonneau,1883732,2086955,2022-11-20
CASH_OUT,1316733,Stéphanie Bonneau,2086955,770222,Agence_moov_Cotonou,300000,-1016733,2022-11-22
CASH_IN,234718,Agence_moov_Cotonou,300000,65282,Stéphanie Bonneau,770222,1004940,2022-11-22
CASH_OUT,432716,Stéphanie Bonneau,1004940,572224,Agence_moov_Ouidah,300000,-132716,2022-11-23
TRANSFER,256148,Stéphanie Bonneau,572224,316076,Joséphine Weber du Bonnin,137818,-118330,2022-11-23
CASH_IN,193170,Agence_moov_Cotonou,300000,106830,Stéphanie Bonneau,316076,509246,2022-11-23
CASH_IN,189700,Agence_moov_Abomey,300000,110300,Stéphanie Bonneau,509246,698946,2022-11-25
TRANSFER,48522,Paulette Dias,70703,22181,Stéphanie Bonneau,698946,747468,2022-11-27
TRANSFER,259608,Nicolas Hervé,318732,59124,Luc Camus,1318247,1058639,2022-11-01
CASH_IN,94613,Agence_moov_Abomey,300000,205387,Nicolas Hervé,59124,153737,2022-11-01
TRANSFER,110016,Nicolas Hervé,153737,43721,Antoine Leroux,823066,713050,2022-11-02
TRANSFER,134949,Laurence Carlier,232353,97404,Nicolas Hervé,43721,178670,2022-11-03
CASH_OUT,38763,Nicolas Hervé,178670,139907,Agence_moov_Abomey,300000,261237,2022-11-06
TRANSFER,41696,Nicolas Hervé,139907,98211,Lucy Vaillant,1653222,1611526,2022-11-06
CASH_OUT,3640,Nicolas Hervé,98211,94571,Agence_moov_Cotonou,300000,296360,2022-11-08
TRANSFER,43862,Nicolas Hervé,94571,50709,Benoît Verdier,1947900,1904038,2022-11-08
TRANSFER,43659,Nicolas Hervé,50709,7050,Caroline Bonneau,534200,490541,2022-11-09
CASH_IN,193631,Agence_moov_Ouidah,300000,106369,Nicolas Hervé,7050,200681,2022-11-10
CASH_OUT,145956,Nicolas Hervé,200681,54725,Agence_moov_Ouidah,300000,154044,2022-11-12
CASH_IN,109342,Agence_moov_Ouidah,300000,190658,Nicolas Hervé,54725,164067,2022-11-13
CASH_IN,189371,Agence_moov_Cotonou,300000,110629,Nicolas Hervé,164067,353438,2022-11-13
CASH_IN,184492,Agence_moov_Abomey,300000,115508,Nicolas Hervé,353438,537930,2022-11-15
TRANSFER,15734,Sébastien-Arthur Masse,108106,92372,Nicolas Hervé,537930,553664,2022-11-16
TRANSFER,1733818,Benoît Verdier,1904038,170220,Nicolas Hervé,553664,2287482,2022-11-17
CASH_IN,6005,Agence_moov_Cotonou,300000,293995,Nicolas Hervé,2287482,2293487,2022-11-19
CASH_OUT,236439,Nicolas Hervé,2293487,2057048,Agence_moov_Cotonou,300000,63561,2022-11-20
CASH_IN,92062,Agence_moov_Cotonou,300000,207938,Nicolas Hervé,2057048,2149110,2022-11-20
CASH_OUT,582001,Nicolas Hervé,2149110,1567109,Agence_moov_Cotonou,300000,-282001,2022-11-21
TRANSFER,270765,Nicolas Hervé,1567109,1296344,Xavier-Stéphane Ollivier,1667057,1396292,2022-11-21
TRANSFER,1038135,Nicolas Hervé,1296344,258209,Paul Pereira,89449,-948686,2022-11-22
CASH_IN,111753,Agence_moov_Cotonou,300000,188247,Nicolas Hervé,258209,369962,2022-11-23
TRANSFER,203479,Nicolas Hervé,369962,166483,Agnès Baron,1236800,1033321,2022-11-23
TRANSFER,72008,Sébastien-Arthur Masse,92372,20364,Nicolas Hervé,166483,238491,2022-11-25
CASH_OUT,45824,Nicolas Hervé,238491,192667,Agence_moov_Cotonou,300000,254176,2022-11-25
TRANSFER,8056,Emmanuelle Gilbert,10686,2630,Nicolas Hervé,192667,200723,2022-11-27
CASH_IN,115,Agence_moov_Cotonou,300000,299885,Nicolas Hervé,200723,200838,2022-11-27
CASH_OUT,4168,Bernadette Fabre,12539,8371,Agence_moov_Abomey,300000,295832,2022-11-01
CASH_IN,25125,Agence_moov_Abomey,300000,274875,Bernadette Fabre,8371,33496,2022-11-04
TRANSFER,540989,Marthe Pichon,637186,96197,Bernadette Fabre,33496,574485,2022-11-05
CASH_IN,119362,Agence_moov_Abomey,300000,180638,Bernadette Fabre,574485,693847,2022-11-06
CASH_OUT,635120,Bernadette Fabre,693847,58727,Agence_moov_Ouidah,300000,-335120,2022-11-09
TRANSFER,4073,Bernadette Fabre,58727,54654,Emmanuel-René Coulon,127396,123323,2022-11-09
TRANSFER,3795,Bernadette Fabre,54654,50859,Paul De Sousa,397100,393305,2022-11-09
TRANSFER,527332,Agnès Baron,1033321,505989,Bernadette Fabre,50859,578191,2022-11-11
CASH_IN,228338,Agence_moov_Ouidah,300000,71662,Bernadette Fabre,578191,806529,2022-11-12
TRANSFER,1042743,Adélaïde-Sophie Leclercq,1711637,668894,Bernadette Fabre,806529,1849272,2022-11-13
CASH_OUT,1794481,Bernadette Fabre,1849272,54791,Agence_moov_Cotonou,300000,-1494481,2022-11-15
CASH_IN,159789,Agence_moov_Abomey,300000,140211,Bernadette Fabre,54791,214580,2022-11-16
CASH_OUT,203337,Bernadette Fabre,214580,11243,Agence_moov_Ouidah,300000,96663,2022-11-19
CASH_IN,22947,Agence_moov_Abomey,300000,277053,Bernadette Fabre,11243,34190,2022-11-19
CASH_OUT,14036,Bernadette Fabre,34190,20154,Agence_moov_Cotonou,300000,285964,2022-11-19
CASH_OUT,12877,Bernadette Fabre,20154,7277,Agence_moov_Ouidah,300000,287123,2022-11-20
TRANSFER,3821,Benoît Verdier,170220,166399,Bernadette Fabre,7277,11098,2022-11-21
CASH_OUT,9075,Bernadette Fabre,11098,2023,Agence_moov_Cotonou,300000,290925,2022-11-23
CASH_OUT,1630,Bernadette Fabre,2023,393,Agence_moov_Abomey,300000,298370,2022-11-24
CASH_IN,200686,Agence_moov_Ouidah,300000,99314,Bernadette Fabre,393,201079,2022-11-24
CASH_IN,131957,Agence_moov_Cotonou,300000,168043,Bernadette Fabre,201079,333036,2022-11-26
TRANSFER,209254,Bernadette Fabre,333036,123782,Sébastien-Arthur Masse,20364,-188890,2022-11-27
TRANSFER,90331,Bernadette Fabre,123782,33451,Laurence Carlier,97404,7073,2022-11-27
CASH_OUT,28412,Bernadette Fabre,33451,5039,Agence_moov_Cotonou,300000,271588,2022-11-27
TRANSFER,640,Matthieu Renard,122437,121797,Noémi de la Didier,224200,224840,2022-11-01
CASH_IN,52388,Agence_moov_Abomey,300000,247612,Noémi de la Didier,224840,277228,2022-11-03
CASH_OUT,53945,Noémi de la Didier,277228,223283,Agence_moov_Cotonou,300000,246055,2022-11-04
CASH_IN,49907,Agence_moov_Abomey,300000,250093,Noémi de la Didier,223283,273190,2022-11-04
CASH_OUT,235596,Noémi de la Didier,273190,37594,Agence_moov_Cotonou,300000,64404,2022-11-05
CASH_IN,37224,Agence_moov_Abomey,300000,262776,Noémi de la Didier,37594,74818,2022-11-05
CASH_OUT,34249,Noémi de la Didier,74818,40569,Agence_moov_Abomey,300000,265751,2022-11-06
CASH_OUT,20164,Noémi de la Didier,40569,20405,Agence_moov_Cotonou,300000,279836,2022-11-06
CASH_OUT,15604,Noémi de la Didier,20405,4801,Agence_moov_Abomey,300000,284396,2022-11-07
TRANSFER,1003344,Adrienne Arnaud,1636500,633156,Noémi de la Didier,4801,1008145,2022-11-09
CASH_OUT,522912,Noémi de la Didier,1008145,485233,Agence_moov_Abomey,300000,-222912,2022-11-09
CASH_IN,171524,Agence_moov_Ouidah,300000,128476,Noémi de la Didier,485233,656757,2022-11-10
CASH_IN,150112,Agence_moov_Cotonou,300000,149888,Noémi de la Didier,656757,806869,2022-11-10
CASH_OUT,209969,Noémi de la Didier,806869,596900,Agence_moov_Ouidah,300000,90031,2022-11-10
TRANSFER,5182,Emmanuel-René Coulon,123323,118141,Noémi de la Didier,596900,602082,2022-11-10
CASH_IN,166632,Agence_moov_Cotonou,300000,133368,Noémi de la Didier,602082,768714,2022-11-11
TRANSFER,345969,Marthe Guillet,670538,324569,Noémi de la Didier,768714,1114683,2022-11-13
TRANSFER,13681,Maryse Reynaud-Michaud,29255,15574,Noémi de la Didier,1114683,1128364,2022-11-13
CASH_IN,127774,Agence_moov_Cotonou,300000,172226,Noémi de la Didier,1128364,1256138,2022-11-13
CASH_IN,208418,Agence_moov_Cotonou,300000,91582,Noémi de la Didier,1256138,1464556,2022-11-16
CASH_IN,94375,Agence_moov_Ouidah,300000,205625,Noémi de la Didier,1464556,1558931,2022-11-17
TRANSFER,1034600,Noémi de la Didier,1558931,524331,Théodore-Alfred Fournier,144962,-889638,2022-11-17
CASH_IN,214832,Agence_moov_Abomey,300000,85168,Noémi de la Didier,524331,739163,2022-11-17
CASH_OUT,495159,Noémi de la Didier,739163,244004,Agence_moov_Abomey,300000,-195159,2022-11-22
TRANSFER,122975,Benoît Verdier,166399,43424,Noémi de la Didier,244004,366979,2022-11-23
CASH_OUT,32759,Noémi de la Didier,366979,334220,Agence_moov_Ouidah,300000,267241,2022-11-23
CASH_IN,120043,Agence_moov_Ouidah,300000,179957,Noémi de la Didier,334220,454263,2022-11-24
CASH_IN,200976,Agence_moov_Ouidah,300000,99024,Noémi de la Didier,454263,655239,2022-11-25
CASH_IN,266513,Agence_moov_Abomey,300000,33487,Noémi de la Didier,655239,921752,2022-11-26
CASH_OUT,188923,Noémi de la Didier,921752,732829,Agence_moov_Ouidah,300000,111077,2022-11-26
TRANSFER,634,Noël Hamel,14210,13576,Matthieu Renard,121797,121163,2022-11-01
CASH_IN,75997,Agence_moov_Ouidah,300000,224003,Noël Hamel,13576,89573,2022-11-02
TRANSFER,4513,Laurence Carlier,7073,2560,Noël Hamel,89573,94086,2022-11-04
CASH_IN,134253,Agence_moov_Ouidah,300000,165747,Noël Hamel,94086,228339,2022-11-04
CASH_IN,165326,Agence_moov_Cotonou,300000,134674,Noël Hamel,228339,393665,2022-11-06
CASH_OUT,289237,Noël Hamel,393665,104428,Agence_moov_Abomey,300000,10763,2022-11-07
CASH_OUT,41069,Noël Hamel,104428,63359,Agence_moov_Abomey,300000,258931,2022-11-08
CASH_IN,228208,Agence_moov_Cotonou,300000,71792,Noël Hamel,63359,291567,2022-11-09
CASH_OUT,59195,Noël Hamel,291567,232372,Agence_moov_Cotonou,300000,240805,2022-11-10
CASH_IN,8697,Agence_moov_Abomey,300000,291303,Noël Hamel,232372,241069,2022-11-12
CASH_OUT,51112,Noël Hamel,241069,189957,Agence_moov_Ouidah,300000,248888,2022-11-14
CASH_OUT,181729,Noël Hamel,189957,8228,Agence_moov_Cotonou,300000,118271,2022-11-16
TRANSFER,8714,Théodore Bertin,27856,19142,Noël Hamel,8228,16942,2022-11-18
CASH_OUT,9696,Noël Hamel,16942,7246,Agence_moov_Ouidah,300000,290304,2022-11-19
TRANSFER,74294,Marthe Pichon,96197,21903,Noël Hamel,7246,81540,2022-11-20
CASH_OUT,74390,Noël Hamel,81540,7150,Agence_moov_Cotonou,300000,225610,2022-11-21
TRANSFER,4036,Noël Hamel,7150,3114,Adélaïde-Sophie Leclercq,668894,664858,2022-11-21
TRANSFER,257706,Agnès Baron,505989,248283,Noël Hamel,3114,260820,2022-11-21
TRANSFER,13783,Agnès Chrétien-Sanchez,321067,307284,Noël Hamel,260820,274603,2022-11-22
CASH_IN,173054,Agence_moov_Abomey,300000,126946,Noël Hamel,274603,447657,2022-11-22
CASH_IN,92671,Agence_moov_Cotonou,300000,207329,Noël Hamel,447657,540328,2022-11-23
CASH_OUT,347217,Noël Hamel,540328,193111,Agence_moov_Cotonou,300000,-47217,2022-11-23
CASH_OUT,184409,Noël Hamel,193111,8702,Agence_moov_Cotonou,300000,115591,2022-11-23
CASH_IN,57395,Agence_moov_Cotonou,300000,242605,Noël Hamel,8702,66097,2022-11-27
CASH_IN,265369,Agence_moov_Ouidah,300000,34631,Vincent-Philippe Rossi,-50320,215049,2022-11-01
CASH_IN,132772,Agence_moov_Cotonou,300000,167228,Vincent-Philippe Rossi,215049,347821,2022-11-04
CASH_OUT,11562,Vincent-Philippe Rossi,347821,336259,Agence_moov_Cotonou,300000,288438,2022-11-04
CASH_OUT,255082,Vincent-Philippe Rossi,336259,81177,Agence_moov_Abomey,300000,44918,2022-11-07
TRANSFER,192993,Antoine Leroux,713050,520057,Vincent-Philippe Rossi,81177,274170,2022-11-10
TRANSFER,101392,Vincent-Philippe Rossi,274170,172778,Xavier-Stéphane Ollivier,1396292,1294900,2022-11-12
CASH_IN,52622,Agence_moov_Cotonou,300000,247378,Vincent-Philippe Rossi,172778,225400,2022-11-12
CASH_OUT,14420,Vincent-Philippe Rossi,225400,210980,Agence_moov_Cotonou,300000,285580,2022-11-12
CASH_OUT,178208,Vincent-Philippe Rossi,210980,32772,Agence_moov_Ouidah,300000,121792,2022-11-13
CASH_IN,15145,Agence_moov_Abomey,300000,284855,Vincent-Philippe Rossi,32772,47917,2022-11-14
CASH_IN,221603,Agence_moov_Cotonou,300000,78397,Vincent-Philippe Rossi,47917,269520,2022-11-14
CASH_OUT,99546,Vincent-Philippe Rossi,269520,169974,Agence_moov_Ouidah,300000,200454,2022-11-14
TRANSFER,206234,Thierry Dos Santos-Le Roux,928100,721866,Vincent-Philippe Rossi,169974,376208,2022-11-14
TRANSFER,368220,Vincent-Philippe Rossi,376208,7988,Benoît Verdier,43424,-324796,2022-11-15
CASH_IN,286156,Agence_moov_Ouidah,300000,13844,Vincent-Philippe Rossi,7988,294144,2022-11-16
CASH_OUT,147388,Vincent-Philippe Rossi,294144,146756,Agence_moov_Ouidah,300000,152612,2022-11-16
TRANSFER,27224,Vincent-Philippe Rossi,146756,119532,Constance Regnier,651319,624095,2022-11-17
CASH_OUT,89870,Vincent-Philippe Rossi,119532,29662,Agence_moov_Cotonou,300000,210130,2022-11-20
TRANSFER,17174,Vincent-Philippe Rossi,29662,12488,Sébastien Jourdan,970614,953440,2022-11-21
CASH_OUT,8259,Vincent-Philippe Rossi,12488,4229,Agence_moov_Ouidah,300000,291741,2022-11-21
TRANSFER,199777,Xavier-Stéphane Ollivier,1294900,1095123,Vincent-Philippe Rossi,4229,204006,2022-11-22
TRANSFER,49790,Vincent-Philippe Rossi,204006,154216,Marie Da Silva,15920,-33870,2022-11-22
TRANSFER,713586,Thierry Dos Santos-Le Roux,721866,8280,Vincent-Philippe Rossi,154216,867802,2022-11-23
TRANSFER,177400,Adélaïde-Sophie Leclercq,664858,487458,Vincent-Philippe Rossi,867802,1045202,2022-11-23
CASH_IN,162157,Agence_moov_Ouidah,300000,137843,Vincent-Philippe Rossi,1045202,1207359,2022-11-24
CASH_OUT,517957,Vincent-Philippe Rossi,1207359,689402,Agence_moov_Abomey,300000,-217957,2022-11-26
CASH_IN,59648,Agence_moov_Cotonou,300000,240352,Vincent-Philippe Rossi,689402,749050,2022-11-26
CASH_IN,171239,Agence_moov_Ouidah,300000,128761,Vincent-Philippe Rossi,749050,920289,2022-11-27
CASH_IN,197901,Agence_moov_Cotonou,300000,102099,Vincent-Philippe Rossi,920289,1118190,2022-11-27
TRANSFER,1159612,Margot Renaud de Lacombe,1255100,95488,Vincent-Philippe Rossi,1118190,2277802,2022-11-27
CASH_IN,52343,Agence_moov_Ouidah,300000,247657,Adrienne Arnaud,633156,685499,2022-11-02
CASH_OUT,497075,Adrienne Arnaud,685499,188424,Agence_moov_Abomey,300000,-197075,2022-11-03
TRANSFER,55304,Adrienne Arnaud,188424,133120,Paulette Dias,22181,-33123,2022-11-03
CASH_OUT,52366,Adrienne Arnaud,133120,80754,Agence_moov_Cotonou,300000,247634,2022-11-04
TRANSFER,51704,Adrienne Arnaud,80754,29050,Maryse Reynaud-Michaud,15574,-36130,2022-11-07
CASH_OUT,16176,Adrienne Arnaud,29050,12874,Agence_moov_Abomey,300000,283824,2022-11-08
TRANSFER,1176,Adrienne Arnaud,12874,11698,Antoine Leroux,520057,518881,2022-11-08
CASH_IN,42958,Agence_moov_Abomey,300000,257042,Adrienne Arnaud,11698,54656,2022-11-08
CASH_OUT,4752,Adrienne Arnaud,54656,49904,Agence_moov_Cotonou,300000,295248,2022-11-08
TRANSFER,50038,Margot Renaud de Lacombe,95488,45450,Adrienne Arnaud,49904,99942,2022-11-10
CASH_OUT,58843,Adrienne Arnaud,99942,41099,Agence_moov_Cotonou,300000,241157,2022-11-11
TRANSFER,28860,Adrienne Arnaud,41099,12239,Nicolas Grondin de la Pinto,101925,73065,2022-11-11
TRANSFER,387,Adrienne Arnaud,12239,11852,Alfred Chrétien,202616,202229,2022-11-12
CASH_IN,218012,Agence_moov_Ouidah,300000,81988,Adrienne Arnaud,11852,229864,2022-11-12
CASH_IN,135913,Agence_moov_Abomey,300000,164087,Adrienne Arnaud,229864,365777,2022-11-12
CASH_IN,215456,Agence_moov_Cotonou,300000,84544,Adrienne Arnaud,365777,581233,2022-11-12
CASH_OUT,197564,Adrienne Arnaud,581233,383669,Agence_moov_Abomey,300000,102436,2022-11-13
TRANSFER,424726,Lucy Vaillant,1611526,1186800,Adrienne Arnaud,383669,808395,2022-11-14
CASH_OUT,99399,Adrienne Arnaud,808395,708996,Agence_moov_Cotonou,300000,200601,2022-11-14
CASH_OUT,66509,Adrienne Arnaud,708996,642487,Agence_moov_Cotonou,300000,233491,2022-11-14
CASH_OUT,445334,Adrienne Arnaud,642487,197153,Agence_moov_Abomey,300000,-145334,2022-11-14
CASH_IN,95556,Agence_moov_Abomey,300000,204444,Adrienne Arnaud,197153,292709,2022-11-15
CASH_OUT,6457,Adrienne Arnaud,292709,286252,Agence_moov_Ouidah,300000,293543,2022-11-15
TRANSFER,185764,Adrienne Arnaud,286252,100488,Caroline Peltier,1744647,1558883,2022-11-19
TRANSFER,42608,Adrienne Arnaud,100488,57880,Adélaïde-Sophie Leclercq,487458,444850,2022-11-23
CASH_OUT,57029,Adrienne Arnaud,57880,851,Agence_moov_Cotonou,300000,242971,2022-11-24
TRANSFER,614056,Xavier-Stéphane Ollivier,1095123,481067,Adrienne Arnaud,851,614907,2022-11-24
CASH_OUT,441212,Adrienne Arnaud,614907,173695,Agence_moov_Ouidah,300000,-141212,2022-11-25
TRANSFER,50252,Adrienne Arnaud,173695,123443,Antoine Leroux,518881,468629,2022-11-26
CASH_IN,260412,Agence_moov_Abomey,300000,39588,Sébastien-Arthur Masse,-188890,71522,2022-11-01
CASH_OUT,21961,Sébastien-Arthur Masse,71522,49561,Agence_moov_Ouidah,300000,278039,2022-11-02
CASH_IN,184142,Agence_moov_Ouidah,300000,115858,Sébastien-Arthur Masse,49561,233703,2022-11-03
CASH_IN,156798,Agence_moov_Abomey,300000,143202,Sébastien-Arthur Masse,233703,390501,2022-11-08
CASH_OUT,197030,Sébastien-Arthur Masse,390501,193471,Agence_moov_Cotonou,300000,102970,2022-11-08
TRANSFER,43573,Valentine Traore,309736,266163,Sébastien-Arthur Masse,193471,237044,2022-11-08
CASH_IN,136643,Agence_moov_Ouidah,300000,163357,Sébastien-Arthur Masse,237044,373687,2022-11-08
CASH_IN,132882,Agence_moov_Ouidah,300000,167118,Sébastien-Arthur Masse,373687,506569,2022-11-08
CASH_OUT,294163,Sébastien-Arthur Masse,506569,212406,Agence_moov_Ouidah,300000,5837,2022-11-09
CASH_OUT,37608,Sébastien-Arthur Masse,212406,174798,Agence_moov_Cotonou,300000,262392,2022-11-09
TRANSFER,44681,Marianne Descamps,178056,133375,Sébastien-Arthur Masse,174798,219479,2022-11-11
CASH_OUT,156196,Sébastien-Arthur Masse,219479,63283,Agence_moov_Cotonou,300000,143804,2022-11-12
CASH_IN,196917,Agence_moov_Ouidah,300000,103083,Sébastien-Arthur Masse,63283,260200,2022-11-13
TRANSFER,168845,Sébastien-Arthur Masse,260200,91355,Caroline Bonneau,490541,321696,2022-11-15
CASH_OUT,50810,Sébastien-Arthur Masse,91355,40545,Agence_moov_Abomey,300000,249190,2022-11-15
CASH_OUT,18053,Sébastien-Arthur Masse,40545,22492,Agence_moov_Abomey,300000,281947,2022-11-16
CASH_OUT,20988,Sébastien-Arthur Masse,22492,1504,Agence_moov_Cotonou,300000,279012,2022-11-16
TRANSFER,4300,Thierry Dos Santos-Le Roux,8280,3980,Sébastien-Arthur Masse,1504,5804,2022-11-16
CASH_OUT,2382,Sébastien-Arthur Masse,5804,3422,Agence_moov_Ouidah,300000,297618,2022-11-17
CASH_IN,15780,Agence_moov_Cotonou,300000,284220,Sébastien-Arthur Masse,3422,19202,2022-11-18
CASH_OUT,14950,Sébastien-Arthur Masse,19202,4252,Agence_moov_Abomey,300000,285050,2022-11-18
TRANSFER,25171,Agnès Baron,248283,223112,Sébastien-Arthur Masse,4252,29423,2022-11-20
TRANSFER,93854,Agnès Baron,223112,129258,Sébastien-Arthur Masse,29423,123277,2022-11-20
CASH_IN,96863,Agence_moov_Ouidah,300000,203137,Sébastien-Arthur Masse,123277,220140,2022-11-21
CASH_IN,235291,Agence_moov_Abomey,300000,64709,Sébastien-Arthur Masse,220140,455431,2022-11-22
CASH_IN,131727,Agence_moov_Cotonou,300000,168273,Sébastien-Arthur Masse,455431,587158,2022-11-23
CASH_IN,34674,Agence_moov_Ouidah,300000,265326,Sébastien-Arthur Masse,587158,621832,2022-11-23
CASH_IN,266170,Agence_moov_Ouidah,300000,33830,Sébastien-Arthur Masse,621832,888002,2022-11-24
CASH_IN,41329,Agence_moov_Ouidah,300000,258671,Sébastien-Arthur Masse,888002,929331,2022-11-24
TRANSFER,247551,Sébastien-Arthur Masse,929331,681780,Marthe Guillet,324569,77018,2022-11-24
CASH_OUT,15452,Margot Renaud de Lacombe,45450,29998,Agence_moov_Ouidah,300000,284548,2022-11-01
TRANSFER,28245,Margot Renaud de Lacombe,29998,1753,Nicolas Grondin de la Pinto,73065,44820,2022-11-01
CASH_OUT,488,Margot Renaud de Lacombe,1753,1265,Agence_moov_Abomey,300000,299512,2022-11-02
TRANSFER,422749,Constance Regnier,624095,201346,Margot Renaud de Lacombe,1265,424014,2022-11-02
CASH_OUT,297814,Margot Renaud de Lacombe,424014,126200,Agence_moov_Abomey,300000,2186,2022-11-03
CASH_IN,14482,Agence_moov_Ouidah,300000,285518,Margot Renaud de Lacombe,126200,140682,2022-11-04
CASH_IN,125145,Agence_moov_Cotonou,300000,174855,Margot Renaud de Lacombe,140682,265827,2022-11-05
TRANSFER,143912,Margot Renaud de Lacombe,265827,121915,Maurice Seguin,88040,-55872,2022-11-08
TRANSFER,10693,Laurent Besson,22721,12028,Margot Renaud de Lacombe,121915,132608,2022-11-09
TRANSFER,96713,Agnès Baron,129258,32545,Margot Renaud de Lacombe,132608,229321,2022-11-09
TRANSFER,55677,Margot Renaud de Lacombe,229321,173644,Joseph de la Dubois,818779,763102,2022-11-10
CASH_IN,31835,Agence_moov_Abomey,300000,268165,Margot Renaud de Lacombe,173644,205479,2022-11-10
CASH_IN,52282,Agence_moov_Cotonou,300000,247718,Margot Renaud de Lacombe,205479,257761,2022-11-11
TRANSFER,40769,Margot Renaud de Lacombe,257761,216992,Adélaïde-Sophie Leclercq,444850,404081,2022-11-12
TRANSFER,270916,Paul De Sousa,393305,122389,Margot Renaud de Lacombe,216992,487908,2022-11-12
CASH_IN,230501,Agence_moov_Abomey,300000,69499,Margot Renaud de Lacombe,487908,718409,2022-11-15
TRANSFER,639062,Margot Renaud de Lacombe,718409,79347,Margot Renaud de Lacombe,718409,1357471,2022-11-16
CASH_IN,230405,Agence_moov_Ouidah,300000,69595,Margot Renaud de Lacombe,79347,309752,2022-11-17
CASH_IN,92321,Agence_moov_Ouidah,300000,207679,Margot Renaud de Lacombe,309752,402073,2022-11-17
CASH_OUT,24062,Margot Renaud de Lacombe,402073,378011,Agence_moov_Abomey,300000,275938,2022-11-18
CASH_OUT,311100,Margot Renaud de Lacombe,378011,66911,Agence_moov_Abomey,300000,-11100,2022-11-19
TRANSFER,23544,Margot Renaud de Lacombe,66911,43367,Stéphane-Timothée Pineau,341589,318045,2022-11-23
CASH_OUT,28829,Margot Renaud de Lacombe,43367,14538,Agence_moov_Ouidah,300000,271171,2022-11-25
TRANSFER,387513,Lucy Vaillant,1186800,799287,Margot Renaud de Lacombe,14538,402051,2022-11-26
CASH_IN,273787,Agence_moov_Abomey,300000,26213,Margot Renaud de Lacombe,402051,675838,2022-11-26
TRANSFER,104842,Xavier-Stéphane Ollivier,481067,376225,Margot Renaud de Lacombe,675838,780680,2022-11-26
CASH_OUT,646055,Margot Renaud de Lacombe,780680,134625,Agence_moov_Abomey,300000,-346055,2022-11-27
TRANSFER,2516,Laurent Besson,12028,9512,Paul De Sousa,122389,124905,2022-11-01
TRANSFER,111930,Paul De Sousa,124905,12975,Augustin Benard,1359329,1247399,2022-11-04
CASH_IN,259020,Agence_moov_Abomey,300000,40980,Paul De Sousa,12975,271995,2022-11-04
CASH_IN,284928,Agence_moov_Ouidah,300000,15072,Paul De Sousa,271995,556923,2022-11-04
CASH_OUT,33382,Paul De Sousa,556923,523541,Agence_moov_Ouidah,300000,266618,2022-11-05
CASH_IN,1543,Agence_moov_Ouidah,300000,298457,Paul De Sousa,523541,525084,2022-11-08
CASH_IN,96586,Agence_moov_Abomey,300000,203414,Paul De Sousa,525084,621670,2022-11-08
TRANSFER,16845,Matthieu Renard,121163,104318,Paul De Sousa,621670,638515,2022-11-08
TRANSFER,221494,Paul De Sousa,638515,417021,Augustin Benard,1247399,1025905,2022-11-11
CASH_IN,152957,Agence_moov_Ouidah,300000,147043,Paul De Sousa,417021,569978,2022-11-12
TRANSFER,103105,Paul De Sousa,569978,466873,Agnès Chrétien-Sanchez,307284,204179,2022-11-12
TRANSFER,133442,Paul De Sousa,466873,333431,Joseph de la Dubois,763102,629660,2022-11-12
CASH_IN,280247,Agence_moov_Abomey,300000,19753,Paul De Sousa,333431,613678,2022-11-14
CASH_OUT,591894,Paul De Sousa,613678,21784,Agence_moov_Ouidah,300000,-291894,2022-11-15
TRANSFER,38494,Nicolas Grondin de la Pinto,44820,6326,Paul De Sousa,21784,60278,2022-11-15
TRANSFER,219444,Amélie de la Picard,321782,102338,Paul De Sousa,60278,279722,2022-11-16
CASH_OUT,261178,Paul De Sousa,279722,18544,Agence_moov_Abomey,300000,38822,2022-11-17
CASH_IN,2121,Agence_moov_Abomey,300000,297879,Paul De Sousa,18544,20665,2022-11-17
CASH_IN,217943,Agence_moov_Abomey,300000,82057,Paul De Sousa,20665,238608,2022-11-17
CASH_OUT,82978,Paul De Sousa,238608,155630,Agence_moov_Ouidah,300000,217022,2022-11-18
CASH_OUT,1349,Paul De Sousa,155630,154281,Agence_moov_Cotonou,300000,298651,2022-11-20
TRANSFER,181588,Nathalie-Chantal Jacques,377276,195688,Paul De Sousa,154281,335869,2022-11-23
CASH_OUT,299186,Paul De Sousa,335869,36683,Agence_moov_Abomey,300000,814,2022-11-23
TRANSFER,19824,Paul De Sousa,36683,16859,Antoine Leroux,468629,448805,2022-11-23
CASH_IN,8271,Agence_moov_Cotonou,300000,291729,Paul De Sousa,16859,25130,2022-11-25
CASH_OUT,119791,Caroline Bonneau,321696,201905,Agence_moov_Abomey,300000,180209,2022-11-06
TRANSFER,8716,Caroline Bonneau,201905,193189,Juliette Evrard Le Giraud,460945,452229,2022-11-07
CASH_IN,204353,Agence_moov_Cotonou,300000,95647,Caroline Bonneau,193189,397542,2022-11-12
CASH_OUT,253698,Caroline Bonneau,397542,143844,Agence_moov_Cotonou,300000,46302,2022-11-16
CASH_IN,294640,Agence_moov_Cotonou,300000,5360,Caroline Bonneau,143844,438484,2022-11-18
CASH_IN,52243,Agence_moov_Abomey,300000,247757,Caroline Bonneau,438484,490727,2022-11-22
TRANSFER,439587,Caroline Bonneau,490727,51140,Caroline Peltier,1558883,1119296,2022-11-23
CASH_IN,171369,Agence_moov_Abomey,300000,128631,Caroline Bonneau,51140,222509,2022-11-23
CASH_OUT,64275,Caroline Bonneau,222509,158234,Agence_moov_Ouidah,300000,235725,2022-11-24
TRANSFER,2193,Caroline Bonneau,158234,156041,Alfred Chrétien,202229,200036,2022-11-26
TRANSFER,3653,Émilie Guillon de Duhamel,229677,226024,Joseph de la Dubois,629660,626007,2022-11-03
CASH_OUT,113797,Émilie Guillon de Duhamel,226024,112227,Agence_moov_Abomey,300000,186203,2022-11-04
TRANSFER,332771,Lucy Vaillant,799287,466516,Émilie Guillon de Duhamel,112227,444998,2022-11-05
CASH_OUT,42707,Émilie Guillon de Duhamel,444998,402291,Agence_moov_Abomey,300000,257293,2022-11-07
TRANSFER,1464,Constance Regnier,201346,199882,Émilie Guillon de Duhamel,402291,403755,2022-11-12
CASH_IN,235916,Agence_moov_Abomey,300000,64084,Émilie Guillon de Duhamel,403755,639671,2022-11-13
TRANSFER,2070,Emmanuelle Gilbert,2630,560,Émilie Guillon de Duhamel,639671,641741,2022-11-14
CASH_OUT,247634,Émilie Guillon de Duhamel,641741,394107,Agence_moov_Ouidah,300000,52366,2022-11-14
CASH_OUT,314679,Émilie Guillon de Duhamel,394107,79428,Agence_moov_Abomey,300000,-14679,2022-11-17
CASH_IN,174403,Agence_moov_Cotonou,300000,125597,Émilie Guillon de Duhamel,79428,253831,2022-11-22
CASH_OUT,134431,Émilie Guillon de Duhamel,253831,119400,Agence_moov_Cotonou,300000,165569,2022-11-22
CASH_IN,292428,Agence_moov_Ouidah,300000,7572,Antoine Leroux,448805,741233,2022-11-03
CASH_IN,231921,Agence_moov_Ouidah,300000,68079,Antoine Leroux,741233,973154,2022-11-04
CASH_IN,52321,Agence_moov_Cotonou,300000,247679,Antoine Leroux,973154,1025475,2022-11-04
TRANSFER,185180,Stéphane-Timothée Pineau,318045,132865,Antoine Leroux,1025475,1210655,2022-11-05
TRANSFER,1183495,Antoine Leroux,1210655,27160,Emmanuelle Gilbert,560,-1182935,2022-11-06
TRANSFER,21195,Antoine Leroux,27160,5965,Nathalie-Chantal Jacques,195688,174493,2022-11-06
CASH_OUT,5161,Antoine Leroux,5965,804,Agence_moov_Abomey,300000,294839,2022-11-07
TRANSFER,1036,Laurence Carlier,2560,1524,Antoine Leroux,804,1840,2022-11-08
CASH_OUT,396,Antoine Leroux,1840,1444,Agence_moov_Ouidah,300000,299604,2022-11-10
CASH_OUT,746,Antoine Leroux,1444,698,Agence_moov_Ouidah,300000,299254,2022-11-11
CASH_OUT,647,Antoine Leroux,698,51,Agence_moov_Ouidah,300000,299353,2022-11-13
CASH_IN,90419,Agence_moov_Abomey,300000,209581,Antoine Leroux,51,90470,2022-11-13
TRANSFER,38331,Antoine Leroux,90470,52139,Alfred Chrétien,200036,161705,2022-11-15
CASH_IN,114461,Agence_moov_Cotonou,300000,185539,Antoine Leroux,52139,166600,2022-11-18
CASH_IN,12851,Agence_moov_Ouidah,300000,287149,Antoine Leroux,166600,179451,2022-11-20
CASH_OUT,94798,Antoine Leroux,179451,84653,Agence_moov_Abomey,300000,205202,2022-11-23
CASH_IN,162188,Agence_moov_Cotonou,300000,137812,Laurence Carlier,1524,163712,2022-11-03
CASH_IN,115653,Agence_moov_Ouidah,300000,184347,Laurence Carlier,163712,279365,2022-11-04
CASH_OUT,261708,Laurence Carlier,279365,17657,Agence_moov_Cotonou,300000,38292,2022-11-07
TRANSFER,77210,Emmanuel-René Coulon,118141,40931,Laurence Carlier,17657,94867,2022-11-07
CASH_OUT,10717,Laurence Carlier,94867,84150,Agence_moov_Cotonou,300000,289283,2022-11-11
CASH_OUT,72788,Laurence Carlier,84150,11362,Agence_moov_Abomey,300000,227212,2022-11-12
TRANSFER,8647,Laurence Carlier,11362,2715,Thierry Dos Santos-Le Roux,3980,-4667,2022-11-13
TRANSFER,634,Laurence Carlier,2715,2081,Xavier-Stéphane Ollivier,376225,375591,2022-11-14
CASH_OUT,1939,Laurence Carlier,2081,142,Agence_moov_Cotonou,300000,298061,2022-11-23
TRANSFER,130,Laurence Carlier,142,12,Agnès Chrétien-Sanchez,204179,204049,2022-11-23
CASH_IN,38144,Agence_moov_Ouidah,300000,261856,Laurence Carlier,12,38156,2022-11-24
CASH_OUT,6742,Laurence Carlier,38156,31414,Agence_moov_Cotonou,300000,293258,2022-11-27
CASH_IN,177631,Agence_moov_Cotonou,300000,122369,Maryse Reynaud-Michaud,-36130,141501,2022-11-01
TRANSFER,135659,Agnès Chrétien-Sanchez,204049,68390,Maryse Reynaud-Michaud,141501,277160,2022-11-01
CASH_IN,202331,Agence_moov_Abomey,300000,97669,Maryse Reynaud-Michaud,277160,479491,2022-11-03
CASH_IN,149313,Agence_moov_Ouidah,300000,150687,Maryse Reynaud-Michaud,479491,628804,2022-11-06
CASH_OUT,577878,Maryse Reynaud-Michaud,628804,50926,Agence_moov_Ouidah,300000,-277878,2022-11-09
TRANSFER,336817,Adélaïde-Sophie Leclercq,404081,67264,Maryse Reynaud-Michaud,50926,387743,2022-11-09
CASH_IN,166227,Agence_moov_Ouidah,300000,133773,Maryse Reynaud-Michaud,387743,553970,2022-11-09
CASH_OUT,96527,Maryse Reynaud-Michaud,553970,457443,Agence_moov_Abomey,300000,203473,2022-11-09
TRANSFER,299966,Maryse Reynaud-Michaud,457443,157477,Valentine Traore,266163,-33803,2022-11-10
CASH_IN,163909,Agence_moov_Abomey,300000,136091,Maryse Reynaud-Michaud,157477,321386,2022-11-13
CASH_IN,182049,Agence_moov_Cotonou,300000,117951,Maryse Reynaud-Michaud,321386,503435,2022-11-13
CASH_OUT,329984,Maryse Reynaud-Michaud,503435,173451,Agence_moov_Cotonou,300000,-29984,2022-11-13
TRANSFER,71763,Marthe Guillet,77018,5255,Maryse Reynaud-Michaud,173451,245214,2022-11-13
CASH_OUT,150559,Maryse Reynaud-Michaud,245214,94655,Agence_moov_Ouidah,300000,149441,2022-11-16
CASH_OUT,11684,Maryse Reynaud-Michaud,94655,82971,Agence_moov_Cotonou,300000,288316,2022-11-16
CASH_IN,9640,Agence_moov_Abomey,300000,290360,Maryse Reynaud-Michaud,82971,92611,2022-11-18
TRANSFER,39676,Maryse Reynaud-Michaud,92611,52935,Nathalie-Chantal Jacques,174493,134817,2022-11-24
CASH_OUT,7017,Maryse Reynaud-Michaud,52935,45918,Agence_moov_Cotonou,300000,292983,2022-11-27
CASH_OUT,25131,Maryse Reynaud-Michaud,45918,20787,Agence_moov_Abomey,300000,274869,2022-11-27
CASH_OUT,283,Laurent Besson,9512,9229,Agence_moov_Ouidah,300000,299717,2022-11-05
TRANSFER,1843,Laurent Besson,9229,7386,Augustin Benard,1025905,1024062,2022-11-06
CASH_IN,55596,Agence_moov_Abomey,300000,244404,Laurent Besson,7386,62982,2022-11-06
TRANSFER,27813,Laurent Besson,62982,35169,Juliette Evrard Le Giraud,452229,424416,2022-11-07
CASH_OUT,15418,Laurent Besson,35169,19751,Agence_moov_Abomey,300000,284582,2022-11-07
CASH_IN,120176,Agence_moov_Ouidah,300000,179824,Laurent Besson,19751,139927,2022-11-09
CASH_OUT,18099,Laurent Besson,139927,121828,Agence_moov_Ouidah,300000,281901,2022-11-12
TRANSFER,12716,Josette Guillon-Leclercq,20577,7861,Laurent Besson,121828,134544,2022-11-12
CASH_IN,239211,Agence_moov_Abomey,300000,60789,Laurent Besson,134544,373755,2022-11-13
CASH_OUT,319822,Laurent Besson,373755,53933,Agence_moov_Cotonou,300000,-19822,2022-11-13
CASH_IN,167800,Agence_moov_Ouidah,300000,132200,Laurent Besson,53933,221733,2022-11-14
TRANSFER,176759,Laurent Besson,221733,44974,Josette Guillon-Leclercq,7861,-168898,2022-11-15
CASH_OUT,30607,Laurent Besson,44974,14367,Agence_moov_Ouidah,300000,269393,2022-11-16
CASH_OUT,4318,Laurent Besson,14367,10049,Agence_moov_Ouidah,300000,295682,2022-11-19
CASH_OUT,5573,Laurent Besson,10049,4476,Agence_moov_Ouidah,300000,294427,2022-11-21
CASH_IN,95100,Agence_moov_Cotonou,300000,204900,Laurent Besson,4476,99576,2022-11-23
CASH_IN,189576,Agence_moov_Cotonou,300000,110424,Laurent Besson,99576,289152,2022-11-24
CASH_IN,149936,Agence_moov_Ouidah,300000,150064,Laurent Besson,289152,439088,2022-11-26
TRANSFER,157614,Laurent Besson,439088,281474,Roland Colin,497340,339726,2022-11-27
TRANSFER,134735,Juliette Evrard Le Giraud,424416,289681,Agnès Chrétien-Sanchez,68390,-66345,2022-11-02
CASH_OUT,14788,Juliette Evrard Le Giraud,289681,274893,Agence_moov_Ouidah,300000,285212,2022-11-02
CASH_OUT,175926,Juliette Evrard Le Giraud,274893,98967,Agence_moov_Ouidah,300000,124074,2022-11-06
TRANSFER,543813,Augustin Benard,1024062,480249,Juliette Evrard Le Giraud,98967,642780,2022-11-07
TRANSFER,11311,Juliette Evrard Le Giraud,642780,631469,Joseph de la Dubois,626007,614696,2022-11-15
CASH_IN,179609,Agence_moov_Cotonou,300000,120391,Juliette Evrard Le Giraud,631469,811078,2022-11-19
CASH_OUT,369756,Juliette Evrard Le Giraud,811078,441322,Agence_moov_Ouidah,300000,-69756,2022-11-24
CASH_OUT,210206,Juliette Evrard Le Giraud,441322,231116,Agence_moov_Cotonou,300000,89794,2022-11-26
TRANSFER,88723,Alfred Chrétien,161705,72982,Marthe Guillet,5255,93978,2022-11-02
CASH_IN,21078,Agence_moov_Cotonou,300000,278922,Marthe Guillet,93978,115056,2022-11-05
CASH_OUT,26795,Marthe Guillet,115056,88261,Agence_moov_Ouidah,300000,273205,2022-11-05
TRANSFER,23936,Marthe Guillet,88261,64325,Marthe Guillet,88261,64325,2022-11-06
CASH_IN,177184,Agence_moov_Abomey,300000,122816,Marthe Guillet,64325,241509,2022-11-08
TRANSFER,35035,Nathalie-Chantal Jacques,134817,99782,Marthe Guillet,241509,276544,2022-11-10
TRANSFER,173197,Marthe Guillet,276544,103347,Théodore Bertin,19142,-154055,2022-11-11
CASH_IN,21430,Agence_moov_Abomey,300000,278570,Marthe Guillet,103347,124777,2022-11-12
TRANSFER,115916,Marthe Guillet,124777,8861,Xavier-Stéphane Ollivier,375591,259675,2022-11-15
CASH_OUT,4084,Marthe Guillet,8861,4777,Agence_moov_Cotonou,300000,295916,2022-11-15
TRANSFER,2919,Marthe Guillet,4777,1858,Emmanuel-René Coulon,40931,38012,2022-11-16
CASH_OUT,1409,Marthe Guillet,1858,449,Agence_moov_Abomey,300000,298591,2022-11-20
CASH_IN,10070,Agence_moov_Cotonou,300000,289930,Marthe Guillet,449,10519,2022-11-24
CASH_IN,50697,Agence_moov_Cotonou,300000,249303,Marthe Guillet,10519,61216,2022-11-25
TRANSFER,367596,Joseph de la Dubois,614696,247100,Marthe Guillet,61216,428812,2022-11-25
TRANSFER,97537,Matthieu Renard,104318,6781,Marthe Guillet,428812,526349,2022-11-25
TRANSFER,271119,Marthe Guillet,526349,255230,Xavier-Stéphane Ollivier,259675,-11444,2022-11-26
CASH_IN,276888,Agence_moov_Cotonou,300000,23112,Marthe Guillet,255230,532118,2022-11-27
CASH_IN,220196,Agence_moov_Ouidah,300000,79804,Marthe Guillet,532118,752314,2022-11-27
TRANSFER,111741,Stéphane-Timothée Pineau,132865,21124,Agnès Baron,32545,-79196,2022-11-06
CASH_IN,50608,Agence_moov_Cotonou,300000,249392,Stéphane-Timothée Pineau,21124,71732,2022-11-07
TRANSFER,51017,Stéphane-Timothée Pineau,71732,20715,Matthieu Renard,6781,-44236,2022-11-07
CASH_OUT,17372,Stéphane-Timothée Pineau,20715,3343,Agence_moov_Ouidah,300000,282628,2022-11-07
CASH_OUT,2035,Stéphane-Timothée Pineau,3343,1308,Agence_moov_Abomey,300000,297965,2022-11-09
TRANSFER,147,Stéphane-Timothée Pineau,1308,1161,Stéphane-Timothée Pineau,1308,1455,2022-11-10
TRANSFER,568,Stéphane-Timothée Pineau,1161,593,Luc Camus,1058639,1058071,2022-11-13
CASH_IN,227940,Agence_moov_Cotonou,300000,72060,Stéphane-Timothée Pineau,593,228533,2022-11-15
CASH_IN,139092,Agence_moov_Cotonou,300000,160908,Stéphane-Timothée Pineau,228533,367625,2022-11-17
CASH_OUT,89308,Stéphane-Timothée Pineau,367625,278317,Agence_moov_Cotonou,300000,210692,2022-11-19
CASH_IN,16170,Agence_moov_Ouidah,300000,283830,Stéphane-Timothée Pineau,278317,294487,2022-11-19
TRANSFER,58274,Stéphane-Timothée Pineau,294487,236213,Amélie de la Picard,102338,44064,2022-11-23
CASH_IN,91932,Agence_moov_Abomey,300000,208068,Stéphane-Timothée Pineau,236213,328145,2022-11-24
CASH_OUT,4503,Stéphane-Timothée Pineau,328145,323642,Agence_moov_Ouidah,300000,295497,2022-11-24
TRANSFER,35622,Adélaïde-Sophie Leclercq,67264,31642,Stéphane-Timothée Pineau,323642,359264,2022-11-25
CASH_OUT,102044,Stéphane-Timothée Pineau,359264,257220,Agence_moov_Cotonou,300000,197956,2022-11-25
TRANSFER,7176,Stéphane-Timothée Pineau,257220,250044,Roland Colin,339726,332550,2022-11-26
TRANSFER,56696,Stéphane-Timothée Pineau,250044,193348,Lucy Vaillant,466516,409820,2022-11-27
CASH_IN,169890,Agence_moov_Cotonou,300000,130110,Emmanuel Bousquet,-303871,-133981,2022-11-03
CASH_IN,43945,Agence_moov_Cotonou,300000,256055,Emmanuel Bousquet,-133981,-90036,2022-11-06
CASH_IN,20786,Agence_moov_Abomey,300000,279214,Emmanuel Bousquet,-90036,-69250,2022-11-07
CASH_IN,287320,Agence_moov_Cotonou,300000,12680,Emmanuel Bousquet,-69250,218070,2022-11-11
TRANSFER,2901,Emmanuel-René Coulon,38012,35111,Emmanuel Bousquet,218070,220971,2022-11-11
CASH_OUT,1139,Emmanuel Bousquet,220971,219832,Agence_moov_Ouidah,300000,298861,2022-11-13
CASH_OUT,29982,Emmanuel Bousquet,219832,189850,Agence_moov_Abomey,300000,270018,2022-11-13
TRANSFER,35246,Emmanuel Bousquet,189850,154604,Augustin Benard,480249,445003,2022-11-15
CASH_IN,184528,Agence_moov_Abomey,300000,115472,Emmanuel Bousquet,154604,339132,2022-11-15
TRANSFER,77325,Nathalie-Chantal Jacques,99782,22457,Emmanuel Bousquet,339132,416457,2022-11-17
CASH_OUT,201788,Emmanuel Bousquet,416457,214669,Agence_moov_Cotonou,300000,98212,2022-11-18
TRANSFER,86300,Roland Colin,332550,246250,Emmanuel Bousquet,214669,300969,2022-11-19
CASH_OUT,180676,Emmanuel Bousquet,300969,120293,Agence_moov_Cotonou,300000,119324,2022-11-20
CASH_IN,125846,Agence_moov_Cotonou,300000,174154,Emmanuel Bousquet,120293,246139,2022-11-21
CASH_IN,104160,Agence_moov_Ouidah,300000,195840,Emmanuel Bousquet,246139,350299,2022-11-21
TRANSFER,699125,Sébastien Jourdan,953440,254315,Emmanuel Bousquet,350299,1049424,2022-11-21
CASH_IN,54908,Agence_moov_Cotonou,300000,245092,Emmanuel Bousquet,1049424,1104332,2022-11-25
CASH_IN,176370,Agence_moov_Abomey,300000,123630,Thierry Dos Santos-Le Roux,-4667,171703,2022-11-06
TRANSFER,128362,Thierry Dos Santos-Le Roux,171703,43341,Emmanuel-René Coulon,35111,-93251,2022-11-08
TRANSFER,27133,Alfred Chrétien,72982,45849,Thierry Dos Santos-Le Roux,43341,70474,2022-11-09
CASH_OUT,5955,Thierry Dos Santos-Le Roux,70474,64519,Agence_moov_Cotonou,300000,294045,2022-11-09
TRANSFER,27027,Thierry Dos Santos-Le Roux,64519,37492,Nathalie-Chantal Jacques,22457,-4570,2022-11-10
CASH_IN,142530,Agence_moov_Ouidah,300000,157470,Thierry Dos Santos-Le Roux,37492,180022,2022-11-10
TRANSFER,97463,Constance Regnier,199882,102419,Thierry Dos Santos-Le Roux,180022,277485,2022-11-13
CASH_OUT,264110,Thierry Dos Santos-Le Roux,277485,13375,Agence_moov_Abomey,300000,35890,2022-11-14
TRANSFER,10318,Thierry Dos Santos-Le Roux,13375,3057,Amélie de la Picard,44064,33746,2022-11-16
TRANSFER,2751,Thierry Dos Santos-Le Roux,3057,306,Adélaïde-Sophie Leclercq,31642,28891,2022-11-19
CASH_IN,165924,Agence_moov_Ouidah,300000,134076,Thierry Dos Santos-Le Roux,306,166230,2022-11-20
CASH_IN,231413,Agence_moov_Ouidah,300000,68587,Thierry Dos Santos-Le Roux,166230,397643,2022-11-21
CASH_OUT,12213,Thierry Dos Santos-Le Roux,397643,385430,Agence_moov_Cotonou,300000,287787,2022-11-25
TRANSFER,74007,Marianne Descamps,133375,59368,Thierry Dos Santos-Le Roux,385430,459437,2022-11-26
TRANSFER,4136,Amélie de la Picard,33746,29610,Thierry Dos Santos-Le Roux,459437,463573,2022-11-26
CASH_IN,207091,Agence_moov_Cotonou,300000,92909,Emmanuel-René Coulon,-93251,113840,2022-11-05
CASH_OUT,108077,Emmanuel-René Coulon,113840,5763,Agence_moov_Cotonou,300000,191923,2022-11-11
TRANSFER,5346,Emmanuel-René Coulon,5763,417,Constance Regnier,102419,97073,2022-11-13
CASH_OUT,396,Emmanuel-René Coulon,417,21,Agence_moov_Abomey,300000,299604,2022-11-14
CASH_IN,64716,Agence_moov_Abomey,300000,235284,Emmanuel-René Coulon,21,64737,2022-11-14
CASH_OUT,51852,Emmanuel-René Coulon,64737,12885,Agence_moov_Cotonou,300000,248148,2022-11-14
TRANSFER,2643,Emmanuel-René Coulon,12885,10242,Sébastien Jourdan,254315,251672,2022-11-15
CASH_IN,222238,Agence_moov_Cotonou,300000,77762,Emmanuel-René Coulon,10242,232480,2022-11-15
CASH_OUT,182195,Emmanuel-René Coulon,232480,50285,Agence_moov_Ouidah,300000,117805,2022-11-16
TRANSFER,6518,Adélaïde-Sophie Leclercq,28891,22373,Emmanuel-René Coulon,50285,56803,2022-11-17
TRANSFER,239,Nicolas Grondin de la Pinto,6326,6087,Emmanuel-René Coulon,56803,57042,2022-11-17
CASH_IN,148518,Agence_moov_Ouidah,300000,151482,Emmanuel-René Coulon,57042,205560,2022-11-20
CASH_IN,151076,Agence_moov_Cotonou,300000,148924,Emmanuel-René Coulon,205560,356636,2022-11-25
TRANSFER,53868,Marianne Descamps,59368,5500,Emmanuel-René Coulon,356636,410504,2022-11-27
TRANSFER,473011,Caroline Peltier,1119296,646285,Marianne Descamps,5500,478511,2022-11-02
CASH_OUT,24838,Marianne Descamps,478511,453673,Agence_moov_Ouidah,300000,275162,2022-11-04
TRANSFER,150934,Marianne Descamps,453673,302739,Amélie de la Picard,29610,-121324,2022-11-07
CASH_IN,248631,Agence_moov_Abomey,300000,51369,Marianne Descamps,302739,551370,2022-11-08
TRANSFER,34149,Alfred Chrétien,45849,11700,Marianne Descamps,551370,585519,2022-11-11
CASH_OUT,132476,Marianne Descamps,585519,453043,Agence_moov_Abomey,300000,167524,2022-11-13
CASH_OUT,125786,Marianne Descamps,453043,327257,Agence_moov_Cotonou,300000,174214,2022-11-14
CASH_OUT,61920,Marianne Descamps,327257,265337,Agence_moov_Abomey,300000,238080,2022-11-14
TRANSFER,85014,Marianne Descamps,265337,180323,Nicolas Grondin de la Pinto,6087,-78927,2022-11-16
TRANSFER,2944,Marianne Descamps,180323,177379,Alfred Chrétien,11700,8756,2022-11-16
CASH_OUT,129801,Marianne Descamps,177379,47578,Agence_moov_Abomey,300000,170199,2022-11-19
CASH_IN,288977,Agence_moov_Ouidah,300000,11023,Marianne Descamps,47578,336555,2022-11-22
CASH_OUT,215446,Marianne Descamps,336555,121109,Agence_moov_Ouidah,300000,84554,2022-11-24
CASH_OUT,21482,Marianne Descamps,121109,99627,Agence_moov_Ouidah,300000,278518,2022-11-25
CASH_IN,106203,Agence_moov_Cotonou,300000,193797,Joseph de la Dubois,247100,353303,2022-11-01
CASH_IN,984,Agence_moov_Cotonou,300000,299016,Joseph de la Dubois,353303,354287,2022-11-02
TRANSFER,249988,Joseph de la Dubois,354287,104299,Joseph de la Dubois,354287,604275,2022-11-04
TRANSFER,4873,Joseph de la Dubois,104299,99426,Caroline Peltier,646285,641412,2022-11-05
CASH_OUT,8577,Joseph de la Dubois,99426,90849,Agence_moov_Ouidah,300000,291423,2022-11-05
CASH_IN,253350,Agence_moov_Ouidah,300000,46650,Joseph de la Dubois,90849,344199,2022-11-05
TRANSFER,333270,Luc Camus,1058071,724801,Joseph de la Dubois,344199,677469,2022-11-09
TRANSFER,78345,Sébastien Jourdan,251672,173327,Joseph de la Dubois,677469,755814,2022-11-10
CASH_OUT,605769,Joseph de la Dubois,755814,150045,Agence_moov_Ouidah,300000,-305769,2022-11-10
CASH_OUT,18648,Joseph de la Dubois,150045,131397,Agence_moov_Abomey,300000,281352,2022-11-12
TRANSFER,130814,Joseph de la Dubois,131397,583,Caroline Peltier,641412,510598,2022-11-15
CASH_OUT,160,Joseph de la Dubois,583,423,Agence_moov_Cotonou,300000,299840,2022-11-15
TRANSFER,81031,Constance Regnier,97073,16042,Joseph de la Dubois,423,81454,2022-11-15
CASH_IN,224632,Agence_moov_Ouidah,300000,75368,Joseph de la Dubois,81454,306086,2022-11-21
CASH_OUT,82903,Joseph de la Dubois,306086,223183,Agence_moov_Abomey,300000,217097,2022-11-21
CASH_OUT,209274,Joseph de la Dubois,223183,13909,Agence_moov_Ouidah,300000,90726,2022-11-25
CASH_OUT,7630,Joseph de la Dubois,13909,6279,Agence_moov_Ouidah,300000,292370,2022-11-26
CASH_OUT,6218,Joseph de la Dubois,6279,61,Agence_moov_Cotonou,300000,293782,2022-11-27
CASH_IN,137656,Agence_moov_Ouidah,300000,162344,Julie Robin de Gros,-442904,-305248,2022-11-01
CASH_IN,162788,Agence_moov_Cotonou,300000,137212,Julie Robin de Gros,-305248,-142460,2022-11-03
CASH_IN,78192,Agence_moov_Cotonou,300000,221808,Julie Robin de Gros,-142460,-64268,2022-11-05
CASH_IN,146565,Agence_moov_Abomey,300000,153435,Julie Robin de Gros,-64268,82297,2022-11-07
CASH_OUT,32025,Julie Robin de Gros,82297,50272,Agence_moov_Abomey,300000,267975,2022-11-08
TRANSFER,45185,Julie Robin de Gros,50272,5087,Luc Camus,724801,679616,2022-11-09
CASH_IN,25082,Agence_moov_Abomey,300000,274918,Julie Robin de Gros,5087,30169,2022-11-10
CASH_IN,276734,Agence_moov_Cotonou,300000,23266,Julie Robin de Gros,30169,306903,2022-11-12
TRANSFER,144562,Julie Robin de Gros,306903,162341,Caroline Peltier,510598,366036,2022-11-14
TRANSFER,255026,Caroline Peltier,366036,111010,Julie Robin de Gros,162341,417367,2022-11-15
TRANSFER,19806,Adélaïde-Sophie Leclercq,22373,2567,Julie Robin de Gros,417367,437173,2022-11-15
CASH_IN,25328,Agence_moov_Ouidah,300000,274672,Julie Robin de Gros,437173,462501,2022-11-17
CASH_IN,212815,Agence_moov_Abomey,300000,87185,Julie Robin de Gros,462501,675316,2022-11-17
TRANSFER,17894,Caroline Peltier,111010,93116,Julie Robin de Gros,675316,693210,2022-11-18
CASH_OUT,657380,Julie Robin de Gros,693210,35830,Agence_moov_Abomey,300000,-357380,2022-11-20
CASH_IN,34677,Agence_moov_Abomey,300000,265323,Julie Robin de Gros,35830,70507,2022-11-22
CASH_IN,76957,Agence_moov_Abomey,300000,223043,Julie Robin de Gros,70507,147464,2022-11-23
CASH_OUT,118002,Julie Robin de Gros,147464,29462,Agence_moov_Cotonou,300000,181998,2022-11-26
CASH_IN,23061,Agence_moov_Cotonou,300000,276939,Julie Robin de Gros,29462,52523,2022-11-27
CASH_OUT,151470,Roland Colin,246250,94780,Agence_moov_Abomey,300000,148530,2022-11-02
CASH_IN,235395,Agence_moov_Abomey,300000,64605,Roland Colin,94780,330175,2022-11-05
CASH_IN,55062,Agence_moov_Abomey,300000,244938,Roland Colin,330175,385237,2022-11-05
CASH_OUT,70247,Roland Colin,385237,314990,Agence_moov_Cotonou,300000,229753,2022-11-08
CASH_IN,109774,Agence_moov_Cotonou,300000,190226,Roland Colin,314990,424764,2022-11-09
TRANSFER,358283,Roland Colin,424764,66481,Constance Regnier,16042,-342241,2022-11-11
CASH_IN,35531,Agence_moov_Abomey,300000,264469,Roland Colin,66481,102012,2022-11-12
CASH_OUT,31761,Roland Colin,102012,70251,Agence_moov_Cotonou,300000,268239,2022-11-14
CASH_OUT,12209,Roland Colin,70251,58042,Agence_moov_Abomey,300000,287791,2022-11-17
CASH_IN,130082,Agence_moov_Abomey,300000,169918,Roland Colin,58042,188124,2022-11-19
CASH_OUT,66629,Roland Colin,188124,121495,Agence_moov_Abomey,300000,233371,2022-11-20
TRANSFER,14811,Augustin Benard,445003,430192,Caroline Peltier,93116,78305,2022-11-04
CASH_IN,77727,Agence_moov_Ouidah,300000,222273,Augustin Benard,430192,507919,2022-11-04
TRANSFER,319464,Augustin Benard,507919,188455,Augustin Benard,507919,827383,2022-11-07
CASH_IN,42314,Agence_moov_Ouidah,300000,257686,Augustin Benard,188455,230769,2022-11-08
TRANSFER,69844,Augustin Benard,230769,160925,Caroline Peltier,78305,8461,2022-11-09
CASH_IN,60160,Agence_moov_Ouidah,300000,239840,Augustin Benard,160925,221085,2022-11-10
CASH_IN,256611,Agence_moov_Abomey,300000,43389,Augustin Benard,221085,477696,2022-11-15
CASH_IN,146753,Agence_moov_Ouidah,300000,153247,Augustin Benard,477696,624449,2022-11-16
CASH_OUT,219700,Augustin Benard,624449,404749,Agence_moov_Abomey,300000,80300,2022-11-17
CASH_OUT,241902,Augustin Benard,404749,162847,Agence_moov_Abomey,300000,58098,2022-11-18
TRANSFER,35906,Augustin Benard,162847,126941,Luc Camus,679616,643710,2022-11-18
CASH_IN,123993,Agence_moov_Abomey,300000,176007,Augustin Benard,126941,250934,2022-11-18
TRANSFER,184842,Luc Camus,643710,458868,Augustin Benard,250934,435776,2022-11-20
TRANSFER,3343,Caroline Peltier,8461,5118,Augustin Benard,435776,439119,2022-11-24
CASH_IN,271813,Agence_moov_Ouidah,300000,28187,Augustin Benard,439119,710932,2022-11-24
CASH_OUT,341536,Augustin Benard,710932,369396,Agence_moov_Cotonou,300000,-41536,2022-11-25
CASH_IN,148823,Agence_moov_Ouidah,300000,151177,Augustin Benard,369396,518219,2022-11-27
CASH_IN,226854,Agence_moov_Cotonou,300000,73146,Luc-Tristan Moreau,-4288,222566,2022-11-02
TRANSFER,6282,Luc-Tristan Moreau,222566,216284,Sébastien Jourdan,173327,167045,2022-11-06
CASH_IN,238338,Agence_moov_Ouidah,300000,61662,Luc-Tristan Moreau,216284,454622,2022-11-11
CASH_IN,196117,Agence_moov_Ouidah,300000,103883,Luc-Tristan Moreau,454622,650739,2022-11-12
TRANSFER,1636,Alfred Chrétien,8756,7120,Luc-Tristan Moreau,650739,652375,2022-11-16
CASH_IN,190991,Agence_moov_Ouidah,300000,109009,Luc-Tristan Moreau,652375,843366,2022-11-19
CASH_IN,4321,Agence_moov_Ouidah,300000,295679,Luc-Tristan Moreau,843366,847687,2022-11-20
TRANSFER,542971,Luc-Tristan Moreau,847687,304716,Sébastien Jourdan,167045,-375926,2022-11-21
CASH_IN,125395,Agence_moov_Cotonou,300000,174605,Laurent Perrot,-88402,36993,2022-11-05
TRANSFER,28928,Laurent Perrot,36993,8065,Alfred Chrétien,7120,-21808,2022-11-08
CASH_IN,110205,Agence_moov_Abomey,300000,189795,Laurent Perrot,8065,118270,2022-11-09
CASH_OUT,4598,Laurent Perrot,118270,113672,Agence_moov_Cotonou,300000,295402,2022-11-18
CASH_IN,288317,Agence_moov_Abomey,300000,11683,Laurent Perrot,113672,401989,2022-11-23
CASH_IN,237080,Agence_moov_Abomey,300000,62920,Laurent Perrot,401989,639069,2022-11-26
CASH_IN,291946,Agence_moov_Abomey,300000,8054,Emmanuelle Gilbert,-1182935,-890989,2022-11-01
CASH_IN,53207,Agence_moov_Ouidah,300000,246793,Emmanuelle Gilbert,-890989,-837782,2022-11-02
CASH_IN,10407,Agence_moov_Cotonou,300000,289593,Emmanuelle Gilbert,-837782,-827375,2022-11-03
CASH_IN,232280,Agence_moov_Cotonou,300000,67720,Emmanuelle Gilbert,-827375,-595095,2022-11-08
CASH_IN,297,Agence_moov_Cotonou,300000,299703,Emmanuelle Gilbert,-595095,-594798,2022-11-11
CASH_IN,25755,Agence_moov_Ouidah,300000,274245,Emmanuelle Gilbert,-594798,-569043,2022-11-12
CASH_IN,243966,Agence_moov_Abomey,300000,56034,Emmanuelle Gilbert,-569043,-325077,2022-11-14
CASH_IN,53433,Agence_moov_Ouidah,300000,246567,Emmanuelle Gilbert,-325077,-271644,2022-11-15
CASH_IN,222200,Agence_moov_Cotonou,300000,77800,Emmanuelle Gilbert,-271644,-49444,2022-11-16
CASH_IN,111094,Agence_moov_Ouidah,300000,188906,Emmanuelle Gilbert,-49444,61650,2022-11-16
CASH_OUT,8386,Emmanuelle Gilbert,61650,53264,Agence_moov_Cotonou,300000,291614,2022-11-19
CASH_IN,245160,Agence_moov_Abomey,300000,54840,Emmanuelle Gilbert,53264,298424,2022-11-20
CASH_OUT,268300,Emmanuelle Gilbert,298424,30124,Agence_moov_Ouidah,300000,31700,2022-11-20
CASH_IN,62326,Agence_moov_Abomey,300000,237674,Emmanuelle Gilbert,30124,92450,2022-11-24
CASH_OUT,36660,Emmanuelle Gilbert,92450,55790,Agence_moov_Ouidah,300000,263340,2022-11-25
CASH_IN,294271,Agence_moov_Ouidah,300000,5729,Emmanuelle Gilbert,55790,350061,2022-11-25
TRANSFER,181048,Luc Camus,458868,277820,Emmanuelle Gilbert,350061,531109,2022-11-27
CASH_OUT,474653,Emmanuelle Gilbert,531109,56456,Agence_moov_Cotonou,300000,-174653,2022-11-27
CASH_IN,223054,Agence_moov_Cotonou,300000,76946,Théodore-Alfred Fournier,-889638,-666584,2022-11-01
CASH_IN,105331,Agence_moov_Abomey,300000,194669,Théodore-Alfred Fournier,-666584,-561253,2022-11-07
CASH_IN,17284,Agence_moov_Cotonou,300000,282716,Théodore-Alfred Fournier,-561253,-543969,2022-11-08
CASH_IN,184869,Agence_moov_Ouidah,300000,115131,Théodore-Alfred Fournier,-543969,-359100,2022-11-14
CASH_IN,98663,Agence_moov_Cotonou,300000,201337,Théodore-Alfred Fournier,-359100,-260437,2022-11-14
CASH_IN,23583,Agence_moov_Abomey,300000,276417,Théodore-Alfred Fournier,-260437,-236854,2022-11-15
CASH_IN,185141,Agence_moov_Ouidah,300000,114859,Théodore-Alfred Fournier,-236854,-51713,2022-11-17
CASH_IN,16238,Agence_moov_Abomey,300000,283762,Théodore-Alfred Fournier,-51713,-35475,2022-11-18
CASH_IN,219771,Agence_moov_Abomey,300000,80229,Théodore-Alfred Fournier,-35475,184296,2022-11-18
CASH_OUT,181783,Théodore-Alfred Fournier,184296,2513,Agence_moov_Cotonou,300000,118217,2022-11-19
CASH_IN,101216,Agence_moov_Abomey,300000,198784,Théodore-Alfred Fournier,2513,103729,2022-11-20
CASH_OUT,35027,Théodore-Alfred Fournier,103729,68702,Agence_moov_Cotonou,300000,264973,2022-11-23
CASH_OUT,5345,Théodore-Alfred Fournier,68702,63357,Agence_moov_Abomey,300000,294655,2022-11-24
CASH_IN,120929,Agence_moov_Ouidah,300000,179071,Théodore-Alfred Fournier,63357,184286,2022-11-26
CASH_IN,1452,Agence_moov_Cotonou,300000,298548,Amélie de la Picard,-121324,-119872,2022-11-04
CASH_IN,93960,Agence_moov_Cotonou,300000,206040,Amélie de la Picard,-119872,-25912,2022-11-04
CASH_IN,61471,Agence_moov_Cotonou,300000,238529,Amélie de la Picard,-25912,35559,2022-11-05
CASH_IN,33659,Agence_moov_Abomey,300000,266341,Amélie de la Picard,35559,69218,2022-11-06
CASH_OUT,53940,Amélie de la Picard,69218,15278,Agence_moov_Cotonou,300000,246060,2022-11-06
TRANSFER,88070,Luc Camus,277820,189750,Amélie de la Picard,15278,103348,2022-11-07
CASH_OUT,94202,Amélie de la Picard,103348,9146,Agence_moov_Abomey,300000,205798,2022-11-08
TRANSFER,151406,Luc Camus,189750,38344,Amélie de la Picard,9146,160552,2022-11-08
CASH_IN,206046,Agence_moov_Ouidah,300000,93954,Amélie de la Picard,160552,366598,2022-11-09
CASH_IN,271698,Agence_moov_Abomey,300000,28302,Amélie de la Picard,366598,638296,2022-11-09
CASH_IN,224760,Agence_moov_Cotonou,300000,75240,Amélie de la Picard,638296,863056,2022-11-09
CASH_IN,253514,Agence_moov_Cotonou,300000,46486,Amélie de la Picard,863056,1116570,2022-11-09
CASH_IN,73682,Agence_moov_Abomey,300000,226318,Amélie de la Picard,1116570,1190252,2022-11-11
CASH_IN,99406,Agence_moov_Abomey,300000,200594,Amélie de la Picard,1190252,1289658,2022-11-12
CASH_IN,93231,Agence_moov_Abomey,300000,206769,Amélie de la Picard,1289658,1382889,2022-11-16
CASH_IN,269319,Agence_moov_Abomey,300000,30681,Amélie de la Picard,1382889,1652208,2022-11-18
CASH_OUT,203617,Amélie de la Picard,1652208,1448591,Agence_moov_Abomey,300000,96383,2022-11-21
CASH_IN,76816,Agence_moov_Ouidah,300000,223184,Léon Paris,-72246,4570,2022-11-14
CASH_IN,150236,Agence_moov_Cotonou,300000,149764,Léon Paris,4570,154806,2022-11-23
CASH_IN,139868,Agence_moov_Abomey,300000,160132,Léon Paris,154806,294674,2022-11-23
CASH_IN,43800,Agence_moov_Cotonou,300000,256200,Xavier-Stéphane Ollivier,-11444,32356,2022-11-03
CASH_OUT,4376,Xavier-Stéphane Ollivier,32356,27980,Agence_moov_Abomey,300000,295624,2022-11-03
CASH_OUT,22559,Xavier-Stéphane Ollivier,27980,5421,Agence_moov_Ouidah,300000,277441,2022-11-06
TRANSFER,5258,Xavier-Stéphane Ollivier,5421,163,Xavier-Stéphane Ollivier,5421,10679,2022-11-08
TRANSFER,132,Xavier-Stéphane Ollivier,163,31,Xavier-Stéphane Ollivier,163,295,2022-11-08
CASH_IN,145770,Agence_moov_Cotonou,300000,154230,Xavier-Stéphane Ollivier,31,145801,2022-11-08
TRANSFER,145179,Xavier-Stéphane Ollivier,145801,622,Xavier-Stéphane Ollivier,145801,290980,2022-11-10
CASH_OUT,101,Xavier-Stéphane Ollivier,622,521,Agence_moov_Cotonou,300000,299899,2022-11-10
CASH_IN,58797,Agence_moov_Cotonou,300000,241203,Xavier-Stéphane Ollivier,521,59318,2022-11-13
CASH_IN,273797,Agence_moov_Ouidah,300000,26203,Xavier-Stéphane Ollivier,59318,333115,2022-11-15
CASH_IN,258363,Agence_moov_Cotonou,300000,41637,Xavier-Stéphane Ollivier,333115,591478,2022-11-17
CASH_OUT,224330,Xavier-Stéphane Ollivier,591478,367148,Agence_moov_Cotonou,300000,75670,2022-11-18
CASH_OUT,239789,Xavier-Stéphane Ollivier,367148,127359,Agence_moov_Abomey,300000,60211,2022-11-19
CASH_OUT,100481,Xavier-Stéphane Ollivier,127359,26878,Agence_moov_Ouidah,300000,199519,2022-11-19
CASH_IN,148530,Agence_moov_Abomey,300000,151470,Xavier-Stéphane Ollivier,26878,175408,2022-11-21
CASH_IN,52005,Agence_moov_Cotonou,300000,247995,Nicolas Grondin de la Pinto,-78927,-26922,2022-11-01
CASH_IN,7161,Agence_moov_Ouidah,300000,292839,Nicolas Grondin de la Pinto,-26922,-19761,2022-11-02
CASH_IN,139271,Agence_moov_Ouidah,300000,160729,Nicolas Grondin de la Pinto,-19761,119510,2022-11-03
CASH_OUT,10770,Nicolas Grondin de la Pinto,119510,108740,Agence_moov_Abomey,300000,289230,2022-11-05
CASH_OUT,3584,Nicolas Grondin de la Pinto,108740,105156,Agence_moov_Abomey,300000,296416,2022-11-09
CASH_IN,82993,Agence_moov_Abomey,300000,217007,Nicolas Grondin de la Pinto,105156,188149,2022-11-09
CASH_IN,250691,Agence_moov_Cotonou,300000,49309,Nicolas Grondin de la Pinto,188149,438840,2022-11-12
CASH_OUT,104722,Nicolas Grondin de la Pinto,438840,334118,Agence_moov_Ouidah,300000,195278,2022-11-13
TRANSFER,140821,Nicolas Grondin de la Pinto,334118,193297,Nicolas Grondin de la Pinto,334118,193297,2022-11-15
CASH_OUT,52987,Nicolas Grondin de la Pinto,193297,140310,Agence_moov_Cotonou,300000,247013,2022-11-17
CASH_OUT,81458,Nicolas Grondin de la Pinto,140310,58852,Agence_moov_Ouidah,300000,218542,2022-11-24
CASH_IN,200421,Agence_moov_Ouidah,300000,99579,Nicolas Grondin de la Pinto,58852,259273,2022-11-25
CASH_IN,115640,Agence_moov_Abomey,300000,184360,Nicolas Grondin de la Pinto,259273,374913,2022-11-27
CASH_OUT,140856,Nicolas Grondin de la Pinto,374913,234057,Agence_moov_Ouidah,300000,159144,2022-11-27
CASH_IN,269995,Agence_moov_Ouidah,300000,30005,Maurice Seguin,-55872,214123,2022-11-03
CASH_OUT,184506,Maurice Seguin,214123,29617,Agence_moov_Abomey,300000,115494,2022-11-05
CASH_IN,12839,Agence_moov_Abomey,300000,287161,Maurice Seguin,29617,42456,2022-11-07
TRANSFER,20427,Maurice Seguin,42456,22029,Maurice Seguin,42456,22029,2022-11-07
TRANSFER,9990,Maurice Seguin,22029,12039,Maurice Seguin,22029,32019,2022-11-08
TRANSFER,11353,Maurice Seguin,12039,686,Maurice Seguin,12039,23392,2022-11-09
CASH_IN,72194,Agence_moov_Ouidah,300000,227806,Maurice Seguin,686,72880,2022-11-12
CASH_IN,6580,Agence_moov_Cotonou,300000,293420,Maurice Seguin,72880,79460,2022-11-13
CASH_IN,238359,Agence_moov_Abomey,300000,61641,Maurice Seguin,79460,317819,2022-11-18
CASH_IN,236314,Agence_moov_Ouidah,300000,63686,Maurice Seguin,317819,554133,2022-11-22
CASH_OUT,484860,Maurice Seguin,554133,69273,Agence_moov_Ouidah,300000,-184860,2022-11-24
CASH_IN,4890,Agence_moov_Ouidah,300000,295110,Valentine Traore,-33803,-28913,2022-11-02
CASH_IN,257396,Agence_moov_Ouidah,300000,42604,Valentine Traore,-28913,228483,2022-11-06
TRANSFER,157090,Valentine Traore,228483,71393,Valentine Traore,228483,385573,2022-11-06
TRANSFER,44027,Valentine Traore,71393,27366,Valentine Traore,71393,27366,2022-11-07
TRANSFER,303,Valentine Traore,27366,27063,Valentine Traore,27366,27063,2022-11-10
CASH_IN,64924,Agence_moov_Ouidah,300000,235076,Valentine Traore,27063,91987,2022-11-11
TRANSFER,89295,Valentine Traore,91987,2692,Valentine Traore,91987,2692,2022-11-12
TRANSFER,2006,Valentine Traore,2692,686,Valentine Traore,2692,686,2022-11-12
CASH_IN,266904,Agence_moov_Abomey,300000,33096,Valentine Traore,686,267590,2022-11-15
CASH_OUT,54612,Valentine Traore,267590,212978,Agence_moov_Ouidah,300000,245388,2022-11-16
CASH_OUT,77601,Valentine Traore,212978,135377,Agence_moov_Abomey,300000,222399,2022-11-17
CASH_IN,101273,Agence_moov_Cotonou,300000,198727,Valentine Traore,135377,236650,2022-11-18
CASH_OUT,14113,Valentine Traore,236650,222537,Agence_moov_Cotonou,300000,285887,2022-11-19
CASH_IN,228508,Agence_moov_Ouidah,300000,71492,Valentine Traore,222537,451045,2022-11-19
CASH_IN,77437,Agence_moov_Abomey,300000,222563,Valentine Traore,451045,528482,2022-11-21
CASH_OUT,517903,Valentine Traore,528482,10579,Agence_moov_Ouidah,300000,-217903,2022-11-21
CASH_OUT,848,Valentine Traore,10579,9731,Agence_moov_Cotonou,300000,299152,2022-11-23
CASH_IN,222952,Agence_moov_Cotonou,300000,77048,Valentine Traore,9731,232683,2022-11-24
CASH_OUT,29189,Valentine Traore,232683,203494,Agence_moov_Cotonou,300000,270811,2022-11-25
CASH_IN,200016,Agence_moov_Abomey,300000,99984,Valentine Traore,203494,403510,2022-11-26
CASH_IN,153860,Agence_moov_Abomey,300000,146140,Nathalie-Chantal Jacques,-4570,149290,2022-11-01
TRANSFER,106701,Nathalie-Chantal Jacques,149290,42589,Nathalie-Chantal Jacques,149290,42589,2022-11-02
CASH_IN,208832,Agence_moov_Abomey,300000,91168,Nathalie-Chantal Jacques,42589,251421,2022-11-04
TRANSFER,148834,Nathalie-Chantal Jacques,251421,102587,Nathalie-Chantal Jacques,251421,102587,2022-11-05
CASH_OUT,28908,Nathalie-Chantal Jacques,102587,73679,Agence_moov_Ouidah,300000,271092,2022-11-06
CASH_OUT,4480,Nathalie-Chantal Jacques,73679,69199,Agence_moov_Ouidah,300000,295520,2022-11-07
CASH_OUT,49140,Nathalie-Chantal Jacques,69199,20059,Agence_moov_Abomey,300000,250860,2022-11-07
CASH_OUT,199,Nathalie-Chantal Jacques,20059,19860,Agence_moov_Abomey,300000,299801,2022-11-10
CASH_OUT,3950,Nathalie-Chantal Jacques,19860,15910,Agence_moov_Ouidah,300000,296050,2022-11-10
CASH_OUT,1350,Nathalie-Chantal Jacques,15910,14560,Agence_moov_Cotonou,300000,298650,2022-11-11
CASH_IN,92413,Agence_moov_Abomey,300000,207587,Nathalie-Chantal Jacques,14560,106973,2022-11-12
CASH_IN,271758,Agence_moov_Abomey,300000,28242,Nathalie-Chantal Jacques,106973,378731,2022-11-24
CASH_OUT,272195,Nathalie-Chantal Jacques,378731,106536,Agence_moov_Abomey,300000,27805,2022-11-25
CASH_IN,78615,Agence_moov_Ouidah,300000,221385,Nathalie-Chantal Jacques,106536,185151,2022-11-26
CASH_OUT,55846,Nathalie-Chantal Jacques,185151,129305,Agence_moov_Abomey,300000,244154,2022-11-27
CASH_IN,151637,Agence_moov_Abomey,300000,148363,Frédéric Moreau,-1176696,-1025059,2022-11-02
CASH_IN,283160,Agence_moov_Ouidah,300000,16840,Frédéric Moreau,-1025059,-741899,2022-11-02
CASH_IN,296815,Agence_moov_Cotonou,300000,3185,Frédéric Moreau,-741899,-445084,2022-11-09
CASH_IN,90015,Agence_moov_Cotonou,300000,209985,Frédéric Moreau,-445084,-355069,2022-11-10
CASH_IN,209344,Agence_moov_Cotonou,300000,90656,Frédéric Moreau,-355069,-145725,2022-11-14
CASH_IN,152849,Agence_moov_Abomey,300000,147151,Frédéric Moreau,-145725,7124,2022-11-14
CASH_IN,13964,Agence_moov_Ouidah,300000,286036,Frédéric Moreau,7124,21088,2022-11-14
CASH_IN,59605,Agence_moov_Abomey,300000,240395,Frédéric Moreau,21088,80693,2022-11-15
TRANSFER,6999,Frédéric Moreau,80693,73694,Frédéric Moreau,80693,73694,2022-11-15
CASH_OUT,57680,Frédéric Moreau,73694,16014,Agence_moov_Ouidah,300000,242320,2022-11-17
CASH_OUT,8268,Frédéric Moreau,16014,7746,Agence_moov_Cotonou,300000,291732,2022-11-17
CASH_OUT,7476,Frédéric Moreau,7746,270,Agence_moov_Abomey,300000,292524,2022-11-18
CASH_OUT,237,Frédéric Moreau,270,33,Agence_moov_Cotonou,300000,299763,2022-11-20
CASH_IN,215602,Agence_moov_Ouidah,300000,84398,Frédéric Moreau,33,215635,2022-11-22
CASH_IN,290480,Agence_moov_Cotonou,300000,9520,Frédéric Moreau,215635,506115,2022-11-23
TRANSFER,461164,Frédéric Moreau,506115,44951,Frédéric Moreau,506115,967279,2022-11-23
CASH_OUT,587,Frédéric Moreau,44951,44364,Agence_moov_Abomey,300000,299413,2022-11-24
CASH_OUT,28031,Frédéric Moreau,44364,16333,Agence_moov_Abomey,300000,271969,2022-11-25
CASH_IN,49140,Agence_moov_Abomey,300000,250860,Matthieu Renard,-44236,4904,2022-11-01
TRANSFER,1726,Matthieu Renard,4904,3178,Matthieu Renard,4904,3178,2022-11-03
CASH_IN,193619,Agence_moov_Abomey,300000,106381,Matthieu Renard,3178,196797,2022-11-03
CASH_IN,26264,Agence_moov_Abomey,300000,273736,Matthieu Renard,196797,223061,2022-11-03
CASH_IN,223360,Agence_moov_Abomey,300000,76640,Matthieu Renard,223061,446421,2022-11-05
CASH_IN,167006,Agence_moov_Abomey,300000,132994,Matthieu Renard,446421,613427,2022-11-05
CASH_OUT,563034,Matthieu Renard,613427,50393,Agence_moov_Cotonou,300000,-263034,2022-11-06
CASH_IN,180472,Agence_moov_Abomey,300000,119528,Matthieu Renard,50393,230865,2022-11-10
CASH_OUT,136030,Matthieu Renard,230865,94835,Agence_moov_Ouidah,300000,163970,2022-11-13
TRANSFER,19370,Matthieu Renard,94835,75465,Matthieu Renard,94835,75465,2022-11-15
CASH_IN,191106,Agence_moov_Cotonou,300000,108894,Matthieu Renard,75465,266571,2022-11-16
CASH_IN,54952,Agence_moov_Ouidah,300000,245048,Matthieu Renard,266571,321523,2022-11-19
CASH_IN,179814,Agence_moov_Cotonou,300000,120186,Matthieu Renard,321523,501337,2022-11-26
CASH_IN,154793,Agence_moov_Ouidah,300000,145207,Benoît Verdier,-324796,-170003,2022-11-02
CASH_IN,115171,Agence_moov_Abomey,300000,184829,Benoît Verdier,-170003,-54832,2022-11-05
CASH_IN,41848,Agence_moov_Ouidah,300000,258152,Benoît Verdier,-54832,-12984,2022-11-06
CASH_IN,285074,Agence_moov_Ouidah,300000,14926,Benoît Verdier,-12984,272090,2022-11-12
CASH_IN,160737,Agence_moov_Cotonou,300000,139263,Benoît Verdier,272090,432827,2022-11-13
CASH_OUT,325585,Benoît Verdier,432827,107242,Agence_moov_Ouidah,300000,-25585,2022-11-14
TRANSFER,93044,Benoît Verdier,107242,14198,Benoît Verdier,107242,14198,2022-11-15
CASH_OUT,5914,Benoît Verdier,14198,8284,Agence_moov_Ouidah,300000,294086,2022-11-16
CASH_OUT,1188,Benoît Verdier,8284,7096,Agence_moov_Ouidah,300000,298812,2022-11-17
TRANSFER,5460,Benoît Verdier,7096,1636,Benoît Verdier,7096,1636,2022-11-17
CASH_IN,85507,Agence_moov_Cotonou,300000,214493,Benoît Verdier,1636,87143,2022-11-17
CASH_IN,148129,Agence_moov_Ouidah,300000,151871,Benoît Verdier,87143,235272,2022-11-19
CASH_OUT,149546,Benoît Verdier,235272,85726,Agence_moov_Cotonou,300000,150454,2022-11-22
CASH_IN,194326,Agence_moov_Abomey,300000,105674,Benoît Verdier,85726,280052,2022-11-22
CASH_OUT,199094,Benoît Verdier,280052,80958,Agence_moov_Abomey,300000,100906,2022-11-22
CASH_OUT,56765,Benoît Verdier,80958,24193,Agence_moov_Abomey,300000,243235,2022-11-23
CASH_OUT,13207,Benoît Verdier,24193,10986,Agence_moov_Ouidah,300000,286793,2022-11-24
CASH_IN,22022,Agence_moov_Abomey,300000,277978,Matthieu Carpentier,-698208,-676186,2022-11-03
CASH_IN,247389,Agence_moov_Abomey,300000,52611,Matthieu Carpentier,-676186,-428797,2022-11-05
CASH_IN,270042,Agence_moov_Ouidah,300000,29958,Matthieu Carpentier,-428797,-158755,2022-11-06
CASH_IN,21110,Agence_moov_Cotonou,300000,278890,Matthieu Carpentier,-158755,-137645,2022-11-07
CASH_IN,278299,Agence_moov_Ouidah,300000,21701,Matthieu Carpentier,-137645,140654,2022-11-08
TRANSFER,6995,Matthieu Carpentier,140654,133659,Matthieu Carpentier,140654,133659,2022-11-09
TRANSFER,91875,Matthieu Carpentier,133659,41784,Matthieu Carpentier,133659,41784,2022-11-10
CASH_OUT,5117,Matthieu Carpentier,41784,36667,Agence_moov_Abomey,300000,294883,2022-11-10
TRANSFER,25460,Matthieu Carpentier,36667,11207,Matthieu Carpentier,36667,62127,2022-11-13
CASH_IN,288256,Agence_moov_Cotonou,300000,11744,Matthieu Carpentier,11207,299463,2022-11-17
TRANSFER,152508,Matthieu Carpentier,299463,146955,Matthieu Carpentier,299463,451971,2022-11-21
CASH_OUT,108731,Matthieu Carpentier,146955,38224,Agence_moov_Cotonou,300000,191269,2022-11-25
CASH_OUT,9519,Matthieu Carpentier,38224,28705,Agence_moov_Cotonou,300000,290481,2022-11-26
CASH_IN,68739,Agence_moov_Cotonou,300000,231261,Matthieu Carpentier,28705,97444,2022-11-27
CASH_OUT,89218,Matthieu Carpentier,97444,8226,Agence_moov_Ouidah,300000,210782,2022-11-27
CASH_OUT,1426,Matthieu Carpentier,8226,6800,Agence_moov_Ouidah,300000,298574,2022-11-27
CASH_IN,160824,Agence_moov_Ouidah,300000,139176,Gabriel de Pineau,-1516062,-1355238,2022-11-01
CASH_IN,277663,Agence_moov_Abomey,300000,22337,Gabriel de Pineau,-1355238,-1077575,2022-11-02
CASH_IN,113175,Agence_moov_Abomey,300000,186825,Gabriel de Pineau,-1077575,-964400,2022-11-02
CASH_IN,59763,Agence_moov_Ouidah,300000,240237,Gabriel de Pineau,-964400,-904637,2022-11-05
CASH_IN,288425,Agence_moov_Ouidah,300000,11575,Gabriel de Pineau,-904637,-616212,2022-11-08
CASH_IN,235688,Agence_moov_Ouidah,300000,64312,Gabriel de Pineau,-616212,-380524,2022-11-09
CASH_IN,252912,Agence_moov_Abomey,300000,47088,Gabriel de Pineau,-380524,-127612,2022-11-09
CASH_IN,174804,Agence_moov_Abomey,300000,125196,Gabriel de Pineau,-127612,47192,2022-11-10
TRANSFER,9926,Gabriel de Pineau,47192,37266,Gabriel de Pineau,47192,37266,2022-11-14
CASH_IN,165306,Agence_moov_Cotonou,300000,134694,Gabriel de Pineau,37266,202572,2022-11-20
CASH_IN,11130,Agence_moov_Cotonou,300000,288870,Constance Regnier,-342241,-331111,2022-11-04
CASH_IN,117109,Agence_moov_Abomey,300000,182891,Constance Regnier,-331111,-214002,2022-11-04
CASH_IN,198176,Agence_moov_Cotonou,300000,101824,Constance Regnier,-214002,-15826,2022-11-06
CASH_IN,62680,Agence_moov_Ouidah,300000,237320,Constance Regnier,-15826,46854,2022-11-08
CASH_OUT,26669,Constance Regnier,46854,20185,Agence_moov_Abomey,300000,273331,2022-11-11
CASH_IN,37110,Agence_moov_Abomey,300000,262890,Constance Regnier,20185,57295,2022-11-17
CASH_OUT,6947,Constance Regnier,57295,50348,Agence_moov_Abomey,300000,293053,2022-11-17
CASH_OUT,46806,Constance Regnier,50348,3542,Agence_moov_Ouidah,300000,253194,2022-11-24
CASH_OUT,2417,Constance Regnier,3542,1125,Agence_moov_Cotonou,300000,297583,2022-11-27
CASH_IN,296906,Agence_moov_Ouidah,300000,3094,Marie Da Silva,-33870,263036,2022-11-03
CASH_IN,185031,Agence_moov_Abomey,300000,114969,Marie Da Silva,263036,448067,2022-11-05
CASH_IN,188009,Agence_moov_Abomey,300000,111991,Marie Da Silva,448067,636076,2022-11-07
CASH_OUT,579665,Marie Da Silva,636076,56411,Agence_moov_Abomey,300000,-279665,2022-11-10
CASH_IN,47262,Agence_moov_Cotonou,300000,252738,Marie Da Silva,56411,103673,2022-11-16
CASH_IN,270460,Agence_moov_Abomey,300000,29540,Marie Da Silva,103673,374133,2022-11-19
CASH_IN,153095,Agence_moov_Cotonou,300000,146905,Sébastien Jourdan,-375926,-222831,2022-11-01
CASH_IN,268424,Agence_moov_Cotonou,300000,31576,Sébastien Jourdan,-222831,45593,2022-11-02
CASH_IN,187161,Agence_moov_Ouidah,300000,112839,Sébastien Jourdan,45593,232754,2022-11-04
CASH_IN,285215,Agence_moov_Abomey,300000,14785,Sébastien Jourdan,232754,517969,2022-11-05
CASH_OUT,374284,Sébastien Jourdan,517969,143685,Agence_moov_Abomey,300000,-74284,2022-11-05
TRANSFER,138724,Sébastien Jourdan,143685,4961,Sébastien Jourdan,143685,4961,2022-11-06
CASH_OUT,1226,Sébastien Jourdan,4961,3735,Agence_moov_Ouidah,300000,298774,2022-11-06
CASH_OUT,3671,Sébastien Jourdan,3735,64,Agence_moov_Ouidah,300000,296329,2022-11-07
CASH_IN,29081,Agence_moov_Cotonou,300000,270919,Sébastien Jourdan,64,29145,2022-11-09
CASH_IN,33637,Agence_moov_Cotonou,300000,266363,Sébastien Jourdan,29145,62782,2022-11-10
CASH_IN,160702,Agence_moov_Cotonou,300000,139298,Sébastien Jourdan,62782,223484,2022-11-10
CASH_OUT,195381,Sébastien Jourdan,223484,28103,Agence_moov_Ouidah,300000,104619,2022-11-15
CASH_IN,74580,Agence_moov_Abomey,300000,225420,Sébastien Jourdan,28103,102683,2022-11-17
CASH_IN,66859,Agence_moov_Abomey,300000,233141,Sébastien Jourdan,102683,169542,2022-11-20
CASH_OUT,107858,Sébastien Jourdan,169542,61684,Agence_moov_Ouidah,300000,192142,2022-11-21
CASH_OUT,18383,Sébastien Jourdan,61684,43301,Agence_moov_Ouidah,300000,281617,2022-11-23
CASH_IN,86819,Agence_moov_Cotonou,300000,213181,Sébastien Jourdan,43301,130120,2022-11-27
CASH_IN,196923,Agence_moov_Ouidah,300000,103077,Auguste Bousquet,-20899,176024,2022-11-01
CASH_OUT,104486,Auguste Bousquet,176024,71538,Agence_moov_Ouidah,300000,195514,2022-11-05
CASH_OUT,331,Auguste Bousquet,71538,71207,Agence_moov_Ouidah,300000,299669,2022-11-05
CASH_IN,129670,Agence_moov_Cotonou,300000,170330,Auguste Bousquet,71207,200877,2022-11-08
CASH_IN,238160,Agence_moov_Cotonou,300000,61840,Auguste Bousquet,200877,439037,2022-11-11
TRANSFER,362968,Auguste Bousquet,439037,76069,Auguste Bousquet,439037,802005,2022-11-12
TRANSFER,55965,Auguste Bousquet,76069,20104,Auguste Bousquet,76069,132034,2022-11-14
CASH_IN,141370,Agence_moov_Ouidah,300000,158630,Auguste Bousquet,20104,161474,2022-11-14
TRANSFER,120946,Auguste Bousquet,161474,40528,Auguste Bousquet,161474,282420,2022-11-15
CASH_OUT,1749,Auguste Bousquet,40528,38779,Agence_moov_Ouidah,300000,298251,2022-11-17
CASH_OUT,14044,Auguste Bousquet,38779,24735,Agence_moov_Ouidah,300000,285956,2022-11-27
CASH_IN,84317,Agence_moov_Abomey,300000,215683,Auguste Bousquet,24735,109052,2022-11-27
CASH_IN,259017,Agence_moov_Cotonou,300000,40983,Théodore Bertin,-154055,104962,2022-11-02
CASH_OUT,70140,Théodore Bertin,104962,34822,Agence_moov_Ouidah,300000,229860,2022-11-05
CASH_IN,48374,Agence_moov_Ouidah,300000,251626,Théodore Bertin,34822,83196,2022-11-06
CASH_IN,127313,Agence_moov_Ouidah,300000,172687,Théodore Bertin,83196,210509,2022-11-11
CASH_IN,10510,Agence_moov_Ouidah,300000,289490,Théodore Bertin,210509,221019,2022-11-11
CASH_IN,86000,Agence_moov_Abomey,300000,214000,Théodore Bertin,221019,307019,2022-11-11
CASH_IN,109917,Agence_moov_Cotonou,300000,190083,Théodore Bertin,307019,416936,2022-11-13
CASH_OUT,10761,Théodore Bertin,416936,406175,Agence_moov_Cotonou,300000,289239,2022-11-16
CASH_OUT,187585,Théodore Bertin,406175,218590,Agence_moov_Abomey,300000,112415,2022-11-17
CASH_IN,182752,Agence_moov_Cotonou,300000,117248,Théodore Bertin,218590,401342,2022-11-18
CASH_OUT,219366,Théodore Bertin,401342,181976,Agence_moov_Cotonou,300000,80634,2022-11-23
CASH_OUT,125136,Théodore Bertin,181976,56840,Agence_moov_Ouidah,300000,174864,2022-11-24
CASH_OUT,46844,Théodore Bertin,56840,9996,Agence_moov_Abomey,300000,253156,2022-11-24
CASH_OUT,7454,Théodore Bertin,9996,2542,Agence_moov_Abomey,300000,292546,2022-11-25
CASH_IN,224664,Agence_moov_Abomey,300000,75336,Théodore Bertin,2542,227206,2022-11-26
CASH_IN,296915,Agence_moov_Ouidah,300000,3085,Paul Pereira,-948686,-651771,2022-11-01
CASH_IN,220554,Agence_moov_Cotonou,300000,79446,Paul Pereira,-651771,-431217,2022-11-06
CASH_IN,47942,Agence_moov_Ouidah,300000,252058,Paul Pereira,-431217,-383275,2022-11-09
CASH_IN,230762,Agence_moov_Abomey,300000,69238,Paul Pereira,-383275,-152513,2022-11-10
CASH_IN,102592,Agence_moov_Abomey,300000,197408,Paul Pereira,-152513,-49921,2022-11-10
CASH_IN,135732,Agence_moov_Cotonou,300000,164268,Paul Pereira,-49921,85811,2022-11-11
CASH_IN,7688,Agence_moov_Cotonou,300000,292312,Paul Pereira,85811,93499,2022-11-12
CASH_OUT,57929,Paul Pereira,93499,35570,Agence_moov_Abomey,300000,242071,2022-11-12
CASH_OUT,34117,Paul Pereira,35570,1453,Agence_moov_Cotonou,300000,265883,2022-11-14
TRANSFER,527,Paul Pereira,1453,926,Paul Pereira,1453,926,2022-11-15
CASH_IN,190968,Agence_moov_Cotonou,300000,109032,Paul Pereira,926,191894,2022-11-16
CASH_IN,65105,Agence_moov_Cotonou,300000,234895,Paul Pereira,191894,256999,2022-11-17
TRANSFER,179591,Paul Pereira,256999,77408,Paul Pereira,256999,436590,2022-11-17
CASH_OUT,42438,Paul Pereira,77408,34970,Agence_moov_Abomey,300000,257562,2022-11-18
CASH_OUT,7286,Paul Pereira,34970,27684,Agence_moov_Abomey,300000,292714,2022-11-20
CASH_IN,95641,Agence_moov_Cotonou,300000,204359,Paul Pereira,27684,123325,2022-11-22
CASH_IN,264340,Agence_moov_Abomey,300000,35660,Paul Pereira,123325,387665,2022-11-23
CASH_IN,108397,Agence_moov_Cotonou,300000,191603,Agnès Baron,-79196,29201,2022-11-01
TRANSFER,27116,Agnès Baron,29201,2085,Agnès Baron,29201,2085,2022-11-01
CASH_IN,86956,Agence_moov_Abomey,300000,213044,Agnès Baron,2085,89041,2022-11-05
CASH_IN,237269,Agence_moov_Abomey,300000,62731,Agnès Baron,89041,326310,2022-11-05
TRANSFER,38883,Agnès Baron,326310,287427,Agnès Baron,326310,287427,2022-11-06
CASH_OUT,163950,Agnès Baron,287427,123477,Agence_moov_Abomey,300000,136050,2022-11-06
TRANSFER,6286,Agnès Baron,123477,117191,Agnès Baron,123477,117191,2022-11-06
CASH_IN,66201,Agence_moov_Cotonou,300000,233799,Agnès Baron,117191,183392,2022-11-08
TRANSFER,81410,Agnès Baron,183392,101982,Agnès Baron,183392,264802,2022-11-10
CASH_OUT,81454,Agnès Baron,101982,20528,Agence_moov_Abomey,300000,218546,2022-11-11
CASH_OUT,11991,Agnès Baron,20528,8537,Agence_moov_Cotonou,300000,288009,2022-11-12
CASH_IN,151533,Agence_moov_Abomey,300000,148467,Agnès Baron,8537,160070,2022-11-16
CASH_IN,62685,Agence_moov_Ouidah,300000,237315,Agnès Baron,160070,222755,2022-11-17
CASH_IN,246115,Agence_moov_Abomey,300000,53885,Agnès Baron,222755,468870,2022-11-18
CASH_OUT,250105,Agnès Baron,468870,218765,Agence_moov_Cotonou,300000,49895,2022-11-19
CASH_IN,146813,Agence_moov_Ouidah,300000,153187,Agnès Baron,218765,365578,2022-11-20
CASH_OUT,296910,Agnès Baron,365578,68668,Agence_moov_Ouidah,300000,3090,2022-11-24
CASH_IN,111226,Agence_moov_Cotonou,300000,188774,Josette Guillon-Leclercq,-168898,-57672,2022-11-02
CASH_IN,133012,Agence_moov_Cotonou,300000,166988,Josette Guillon-Leclercq,-57672,75340,2022-11-08
CASH_OUT,29534,Josette Guillon-Leclercq,75340,45806,Agence_moov_Ouidah,300000,270466,2022-11-09
CASH_OUT,26407,Josette Guillon-Leclercq,45806,19399,Agence_moov_Abomey,300000,273593,2022-11-14
CASH_OUT,17924,Josette Guillon-Leclercq,19399,1475,Agence_moov_Cotonou,300000,282076,2022-11-14
CASH_IN,53492,Agence_moov_Abomey,300000,246508,Paulette Dias,-33123,20369,2022-11-07
CASH_OUT,9241,Paulette Dias,20369,11128,Agence_moov_Ouidah,300000,290759,2022-11-07
CASH_IN,104667,Agence_moov_Abomey,300000,195333,Paulette Dias,11128,115795,2022-11-08
CASH_OUT,12247,Paulette Dias,115795,103548,Agence_moov_Abomey,300000,287753,2022-11-12
TRANSFER,70668,Paulette Dias,103548,32880,Paulette Dias,103548,32880,2022-11-15
CASH_OUT,3488,Paulette Dias,32880,29392,Agence_moov_Ouidah,300000,296512,2022-11-15
TRANSFER,8130,Paulette Dias,29392,21262,Paulette Dias,29392,21262,2022-11-19
CASH_IN,63704,Agence_moov_Ouidah,300000,236296,Paulette Dias,21262,84966,2022-11-27
CASH_IN,270573,Agence_moov_Abomey,300000,29427,Joséphine Weber du Bonnin,-118330,152243,2022-11-01
CASH_OUT,31936,Joséphine Weber du Bonnin,152243,120307,Agence_moov_Ouidah,300000,268064,2022-11-02
CASH_IN,232083,Agence_moov_Cotonou,300000,67917,Joséphine Weber du Bonnin,120307,352390,2022-11-03
CASH_IN,298522,Agence_moov_Cotonou,300000,1478,Joséphine Weber du Bonnin,352390,650912,2022-11-03
CASH_IN,118392,Agence_moov_Abomey,300000,181608,Joséphine Weber du Bonnin,650912,769304,2022-11-03
CASH_OUT,610322,Joséphine Weber du Bonnin,769304,158982,Agence_moov_Ouidah,300000,-310322,2022-11-23
TRANSFER,25643,Frédéric Moreau,388700,363057,Élodie Gérard,1892900,1918543,2022-12-08
TRANSFER,55766,Amélie de la Picard,812500,756734,Élodie Gérard,1918543,1974309,2022-12-26
CASH_IN,151290,Agence_moov_Ouidah,300000,148710,Émile Hebert,840000,991290,2022-12-04
CASH_OUT,768206,Laurent Perrot,1909000,1140794,Agence_moov_Ouidah,300000,-468206,2022-12-01
CASH_OUT,382373,Laurent Perrot,1140794,758421,Agence_moov_Ouidah,300000,-82373,2022-12-09
TRANSFER,339714,Frédéric Moreau,363057,23343,Laurent Perrot,758421,1098135,2022-12-14
CASH_IN,82694,Agence_moov_Ouidah,300000,217306,Christine-Constance Gauthier,1573500,1656194,2022-12-01
CASH_OUT,240305,Christine-Constance Gauthier,1656194,1415889,Agence_moov_Abomey,300000,59695,2022-12-19
TRANSFER,699190,Antoine Bourdon de Auger,1416300,717110,Christine-Constance Gauthier,1415889,2115079,2022-12-22
CASH_OUT,20045,Sébastien-Arthur Masse,235400,215355,Agence_moov_Ouidah,300000,279955,2022-12-17
CASH_OUT,89169,Sébastien-Arthur Masse,215355,126186,Agence_moov_Ouidah,300000,210831,2022-12-26
CASH_OUT,68672,Sébastien-Arthur Masse,126186,57514,Agence_moov_Cotonou,300000,231328,2022-12-27
CASH_OUT,1687504,Laurence Dumont de Laroche,1884100,196596,Agence_moov_Ouidah,300000,-1387504,2022-12-04
CASH_OUT,354,Jacques-Antoine Gros,28600,28246,Agence_moov_Cotonou,300000,299646,2022-12-06
CASH_OUT,9765,Jacques-Antoine Gros,28246,18481,Agence_moov_Abomey,300000,290235,2022-12-09
CASH_OUT,2256,Jacques-Antoine Gros,18481,16225,Agence_moov_Abomey,300000,297744,2022-12-23
CASH_IN,42999,Agence_moov_Ouidah,300000,257001,Jacques-Antoine Gros,16225,59224,2022-12-27
CASH_IN,39013,Agence_moov_Cotonou,300000,260987,Jacques-Antoine Gros,59224,98237,2022-12-27
TRANSFER,95365,Christophe Guilbert,201400,106035,Agnès Chrétien-Sanchez,1255000,1159635,2022-12-08
CASH_IN,118252,Agence_moov_Cotonou,300000,181748,Christophe Guilbert,106035,224287,2022-12-21
TRANSFER,53101,Susan de Fontaine,711500,658399,Juliette Evrard Le Giraud,1132600,1185701,2022-12-15
CASH_IN,293536,Agence_moov_Cotonou,300000,6464,Juliette Evrard Le Giraud,1185701,1479237,2022-12-21
CASH_OUT,1410266,Antoine Leroux,1649900,239634,Agence_moov_Abomey,300000,-1110266,2022-12-06
CASH_OUT,155806,Antoine Leroux,239634,83828,Agence_moov_Abomey,300000,144194,2022-12-22
TRANSFER,990247,Théodore-Alfred Fournier,1141800,151553,Antoine Leroux,83828,1074075,2022-12-24
TRANSFER,159735,Agnès Baron,505600,345865,Caroline Bonneau,1823700,1663965,2022-12-09
CASH_IN,237606,Agence_moov_Ouidah,300000,62394,Nath Léger,1032500,1270106,2022-12-10
CASH_OUT,1081283,Nath Léger,1270106,188823,Agence_moov_Ouidah,300000,-781283,2022-12-18
TRANSFER,91059,Nath Léger,188823,97764,Stéphane-Timothée Pineau,1693600,1602541,2022-12-25
TRANSFER,52668,Diane-Françoise Raynaud,63900,11232,Maurice Alves,1348500,1401168,2022-12-09
CASH_IN,267874,Agence_moov_Abomey,300000,32126,Adrienne Arnaud,1665100,1932974,2022-12-20
TRANSFER,238534,Joseph de la Dubois,1986500,1747966,Vincent-Philippe Rossi,1453700,1215166,2022-12-05
CASH_IN,56637,Agence_moov_Abomey,300000,243363,Joseph de la Dubois,1747966,1804603,2022-12-08
CASH_OUT,1369610,Joseph de la Dubois,1804603,434993,Agence_moov_Ouidah,300000,-1069610,2022-12-11
CASH_IN,256496,Agence_moov_Abomey,300000,43504,Joseph de la Dubois,434993,691489,2022-12-18
CASH_OUT,387444,Joseph de la Dubois,691489,304045,Agence_moov_Cotonou,300000,-87444,2022-12-27
TRANSFER,1054693,Grégoire Delmas de Blanchard,1533700,479007,Grégoire Delmas de Blanchard,1533700,2588393,2022-12-03
CASH_OUT,258497,Grégoire Delmas de Blanchard,479007,220510,Agence_moov_Abomey,300000,41503,2022-12-11
CASH_IN,292910,Agence_moov_Ouidah,300000,7090,Aimé Allain,907300,1200210,2022-12-11
TRANSFER,535614,Aimé Allain,1200210,664596,Guy Guyon,313000,-222614,2022-12-20
CASH_OUT,784137,Stéphanie Bonneau,1103700,319563,Agence_moov_Ouidah,300000,-484137,2022-12-07
CASH_IN,294667,Agence_moov_Cotonou,300000,5333,Stéphanie Bonneau,319563,614230,2022-12-14
CASH_IN,207301,Agence_moov_Ouidah,300000,92699,Stéphanie Bonneau,614230,821531,2022-12-20
CASH_OUT,152231,Stéphanie Bonneau,821531,669300,Agence_moov_Cotonou,300000,147769,2022-12-20
CASH_IN,89743,Agence_moov_Abomey,300000,210257,Paul Pereira,1217500,1307243,2022-12-10
CASH_IN,207868,Agence_moov_Ouidah,300000,92132,Paul Pereira,1307243,1515111,2022-12-11
TRANSFER,22261,Paul Pereira,1515111,1492850,Alphonse Dupont-Petit,719400,697139,2022-12-15
TRANSFER,1064783,Paul Pereira,1492850,428067,Marine-Clémence Ferreira,1803700,738917,2022-12-18
TRANSFER,157269,Paul Pereira,428067,270798,Émilie Guillon de Duhamel,885400,728131,2022-12-23
CASH_IN,43798,Agence_moov_Cotonou,300000,256202,Josette Guillon-Leclercq,775200,818998,2022-12-12
CASH_OUT,686514,Josette Guillon-Leclercq,818998,132484,Agence_moov_Ouidah,300000,-386514,2022-12-18
TRANSFER,10316,Marine-Clémence Ferreira,738917,728601,Frédéric Moreau,23343,13027,2022-12-12
TRANSFER,497121,Gabriel de Pineau,791800,294679,Marine-Clémence Ferreira,728601,1225722,2022-12-17
CASH_IN,159837,Agence_moov_Ouidah,300000,140163,Marine-Clémence Ferreira,1225722,1385559,2022-12-19
CASH_IN,183182,Agence_moov_Cotonou,300000,116818,Hugues Gay,1109600,1292782,2022-12-22
CASH_OUT,105530,Joséphine Weber du Bonnin,867300,761770,Agence_moov_Ouidah,300000,194470,2022-12-03
TRANSFER,38946,Alex Salmon,229300,190354,Arnaude Gaillard,850800,811854,2022-12-03
TRANSFER,18411,Alex Salmon,190354,171943,Marthe Guillet,298800,280389,2022-12-05
TRANSFER,142317,Alex Salmon,171943,29626,Vincent-Philippe Rossi,1215166,1072849,2022-12-23
TRANSFER,11068,Alex Salmon,29626,18558,Margot Renaud de Lacombe,1530300,1519232,2022-12-25
CASH_IN,104767,Agence_moov_Abomey,300000,195233,Alex Salmon,18558,123325,2022-12-27
TRANSFER,48889,Nathalie-Chantal Jacques,90700,41811,Amélie Gros-Riou,137400,186289,2022-12-24
CASH_IN,117013,Agence_moov_Ouidah,300000,182987,Constance Regnier,1217600,1334613,2022-12-02
CASH_OUT,849979,Constance Regnier,1334613,484634,Agence_moov_Cotonou,300000,-549979,2022-12-02
CASH_OUT,198008,Constance Regnier,484634,286626,Agence_moov_Abomey,300000,101992,2022-12-02
CASH_OUT,200934,Constance Regnier,286626,85692,Agence_moov_Abomey,300000,99066,2022-12-03
TRANSFER,33477,Constance Regnier,85692,52215,Caroline Bonneau,1663965,1630488,2022-12-04
CASH_IN,190527,Agence_moov_Cotonou,300000,109473,Constance Regnier,52215,242742,2022-12-05
CASH_OUT,102979,Constance Regnier,242742,139763,Agence_moov_Cotonou,300000,197021,2022-12-05
CASH_IN,200482,Agence_moov_Abomey,300000,99518,Constance Regnier,139763,340245,2022-12-06
CASH_IN,191398,Agence_moov_Ouidah,300000,108602,Constance Regnier,340245,531643,2022-12-06
CASH_IN,283633,Agence_moov_Cotonou,300000,16367,Constance Regnier,531643,815276,2022-12-07
CASH_OUT,69681,Constance Regnier,815276,745595,Agence_moov_Cotonou,300000,230319,2022-12-07
TRANSFER,71329,Constance Regnier,745595,674266,Arnaude Gaillard,811854,740525,2022-12-07
CASH_IN,159430,Agence_moov_Abomey,300000,140570,Constance Regnier,674266,833696,2022-12-07
CASH_OUT,146180,Constance Regnier,833696,687516,Agence_moov_Ouidah,300000,153820,2022-12-07
CASH_OUT,259832,Constance Regnier,687516,427684,Agence_moov_Cotonou,300000,40168,2022-12-09
CASH_OUT,185324,Constance Regnier,427684,242360,Agence_moov_Cotonou,300000,114676,2022-12-11
TRANSFER,87039,Constance Regnier,242360,155321,Matthieu Renard,1186900,1099861,2022-12-11
TRANSFER,47132,Clémence Bertin,139300,92168,Constance Regnier,155321,202453,2022-12-12
CASH_IN,128617,Agence_moov_Cotonou,300000,171383,Constance Regnier,202453,331070,2022-12-14
CASH_IN,46654,Agence_moov_Cotonou,300000,253346,Constance Regnier,331070,377724,2022-12-15
CASH_IN,153583,Agence_moov_Cotonou,300000,146417,Constance Regnier,377724,531307,2022-12-16
CASH_OUT,493706,Constance Regnier,531307,37601,Agence_moov_Abomey,300000,-193706,2022-12-16
TRANSFER,20174,Constance Regnier,37601,17427,Susan de Fontaine,658399,638225,2022-12-20
TRANSFER,3482,Constance Regnier,17427,13945,Matthieu Renard,1099861,1096379,2022-12-24
TRANSFER,6748,Constance Regnier,13945,7197,Richard Guibert,30600,23852,2022-12-25
CASH_OUT,420,Constance Regnier,7197,6777,Agence_moov_Cotonou,300000,299580,2022-12-26
CASH_OUT,1605,Constance Regnier,6777,5172,Agence_moov_Cotonou,300000,298395,2022-12-26
TRANSFER,749838,Alexandre Poirier,1243200,493362,Auguste Bousquet,760500,10662,2022-12-02
CASH_OUT,43706,Alexandre Poirier,493362,449656,Agence_moov_Ouidah,300000,256294,2022-12-03
TRANSFER,772756,Paulette Dias,1972800,1200044,Alexandre Poirier,449656,1222412,2022-12-04
CASH_IN,180938,Agence_moov_Cotonou,300000,119062,Alexandre Poirier,1222412,1403350,2022-12-07
CASH_IN,25475,Agence_moov_Ouidah,300000,274525,Alexandre Poirier,1403350,1428825,2022-12-07
CASH_OUT,1310288,Alexandre Poirier,1428825,118537,Agence_moov_Cotonou,300000,-1010288,2022-12-07
TRANSFER,395051,Roland Colin,1440200,1045149,Alexandre Poirier,118537,513588,2022-12-09
TRANSFER,29590,Alexandre Poirier,513588,483998,Paul De Sousa,898700,869110,2022-12-09
TRANSFER,280550,Alexandre Poirier,483998,203448,Caroline Peltier,729600,449050,2022-12-09
CASH_OUT,164882,Alexandre Poirier,203448,38566,Agence_moov_Cotonou,300000,135118,2022-12-09
CASH_IN,222716,Agence_moov_Abomey,300000,77284,Alexandre Poirier,38566,261282,2022-12-09
CASH_IN,167083,Agence_moov_Ouidah,300000,132917,Alexandre Poirier,261282,428365,2022-12-10
CASH_IN,136895,Agence_moov_Cotonou,300000,163105,Alexandre Poirier,428365,565260,2022-12-13
CASH_OUT,325238,Alexandre Poirier,565260,240022,Agence_moov_Cotonou,300000,-25238,2022-12-16
CASH_IN,63083,Agence_moov_Cotonou,300000,236917,Alexandre Poirier,240022,303105,2022-12-16
CASH_IN,32427,Agence_moov_Cotonou,300000,267573,Alexandre Poirier,303105,335532,2022-12-16
TRANSFER,310964,Alexandre Poirier,335532,24568,Sabine Imbert,1728400,1417436,2022-12-20
CASH_IN,76192,Agence_moov_Ouidah,300000,223808,Alexandre Poirier,24568,100760,2022-12-22
CASH_OUT,22245,Alexandre Poirier,100760,78515,Agence_moov_Cotonou,300000,277755,2022-12-23
TRANSFER,162243,Isaac Le Pinto,226400,64157,Alexandre Poirier,78515,240758,2022-12-24
CASH_OUT,234802,Alexandre Poirier,240758,5956,Agence_moov_Cotonou,300000,65198,2022-12-26
TRANSFER,2834,Alexandre Poirier,5956,3122,Laurent Besson,1874400,1871566,2022-12-26
CASH_IN,41712,Agence_moov_Cotonou,300000,258288,Maryse Reynaud-Michaud,318300,360012,2022-12-01
TRANSFER,1189234,Margot Renaud de Lacombe,1519232,329998,Maryse Reynaud-Michaud,360012,1549246,2022-12-02
TRANSFER,1301615,Maryse Reynaud-Michaud,1549246,247631,Caroline Bonneau,1630488,328873,2022-12-03
CASH_IN,51637,Agence_moov_Abomey,300000,248363,Maryse Reynaud-Michaud,247631,299268,2022-12-04
CASH_IN,172894,Agence_moov_Abomey,300000,127106,Maryse Reynaud-Michaud,299268,472162,2022-12-04
TRANSFER,66827,Vincent-Grégoire Brunet,1192900,1126073,Maryse Reynaud-Michaud,472162,538989,2022-12-04
TRANSFER,26564,Théodore-Alfred Fournier,151553,124989,Maryse Reynaud-Michaud,538989,565553,2022-12-05
TRANSFER,9348,Maryse Reynaud-Michaud,565553,556205,Marthe Guillet,280389,271041,2022-12-06
CASH_IN,80510,Agence_moov_Cotonou,300000,219490,Maryse Reynaud-Michaud,556205,636715,2022-12-07
TRANSFER,183925,Gilbert Bazin Le Guillet,385100,201175,Maryse Reynaud-Michaud,636715,820640,2022-12-09
TRANSFER,344691,Amélie de la Picard,756734,412043,Maryse Reynaud-Michaud,820640,1165331,2022-12-12
CASH_IN,293417,Agence_moov_Abomey,300000,6583,Maryse Reynaud-Michaud,1165331,1458748,2022-12-12
CASH_OUT,734682,Maryse Reynaud-Michaud,1458748,724066,Agence_moov_Abomey,300000,-434682,2022-12-13
CASH_OUT,633357,Maryse Reynaud-Michaud,724066,90709,Agence_moov_Ouidah,300000,-333357,2022-12-13
CASH_OUT,39905,Maryse Reynaud-Michaud,90709,50804,Agence_moov_Cotonou,300000,260095,2022-12-17
CASH_IN,121194,Agence_moov_Ouidah,300000,178806,Maryse Reynaud-Michaud,50804,171998,2022-12-17
CASH_OUT,135698,Maryse Reynaud-Michaud,171998,36300,Agence_moov_Cotonou,300000,164302,2022-12-19
CASH_IN,87644,Agence_moov_Abomey,300000,212356,Maryse Reynaud-Michaud,36300,123944,2022-12-19
TRANSFER,1091,Maryse Reynaud-Michaud,123944,122853,Théodore-Alfred Fournier,124989,123898,2022-12-20
CASH_OUT,37382,Maryse Reynaud-Michaud,122853,85471,Agence_moov_Ouidah,300000,262618,2022-12-21
CASH_IN,285746,Agence_moov_Cotonou,300000,14254,Maryse Reynaud-Michaud,85471,371217,2022-12-21
CASH_OUT,221621,Maryse Reynaud-Michaud,371217,149596,Agence_moov_Ouidah,300000,78379,2022-12-22
CASH_OUT,122677,Maryse Reynaud-Michaud,149596,26919,Agence_moov_Ouidah,300000,177323,2022-12-23
TRANSFER,20551,Maryse Reynaud-Michaud,26919,6368,Luc Camus,1508700,1488149,2022-12-26
TRANSFER,3221,Maryse Reynaud-Michaud,6368,3147,Sabine Imbert,1417436,1414215,2022-12-26
TRANSFER,88913,Thierry Dos Santos-Le Roux,174900,85987,Maryse Reynaud-Michaud,3147,92060,2022-12-27
CASH_OUT,83714,Maryse Reynaud-Michaud,92060,8346,Agence_moov_Ouidah,300000,216286,2022-12-27
CASH_OUT,1129613,Marc Gilbert,1655800,526187,Agence_moov_Cotonou,300000,-829613,2022-12-01
CASH_IN,262313,Agence_moov_Abomey,300000,37687,Marc Gilbert,526187,788500,2022-12-02
CASH_OUT,414938,Marc Gilbert,788500,373562,Agence_moov_Cotonou,300000,-114938,2022-12-02
TRANSFER,988205,Adélaïde-Sophie Leclercq,1930300,942095,Marc Gilbert,373562,1361767,2022-12-05
CASH_IN,40990,Agence_moov_Abomey,300000,259010,Marc Gilbert,1361767,1402757,2022-12-05
CASH_OUT,1188299,Marc Gilbert,1402757,214458,Agence_moov_Cotonou,300000,-888299,2022-12-05
CASH_OUT,27309,Marc Gilbert,214458,187149,Agence_moov_Ouidah,300000,272691,2022-12-06
CASH_OUT,170826,Marc Gilbert,187149,16323,Agence_moov_Abomey,300000,129174,2022-12-07
TRANSFER,1288493,Augustin Benard,1705300,416807,Marc Gilbert,16323,1304816,2022-12-09
TRANSFER,423551,Marc Gilbert,1304816,881265,Emmanuel-René Coulon,1678000,1254449,2022-12-09
TRANSFER,883075,Valentine Traore,1042800,159725,Marc Gilbert,881265,1764340,2022-12-10
TRANSFER,330687,Marc Gilbert,1764340,1433653,Marie Da Silva,5600,-325087,2022-12-11
TRANSFER,1181938,Marc Gilbert,1433653,251715,Julie Robin de Gros,1812200,630262,2022-12-14
TRANSFER,232833,Marc Gilbert,251715,18882,Vincent-Philippe Rossi,1072849,840016,2022-12-15
CASH_OUT,14839,Marc Gilbert,18882,4043,Agence_moov_Cotonou,300000,285161,2022-12-16
CASH_IN,372,Agence_moov_Ouidah,300000,299628,Marc Gilbert,4043,4415,2022-12-18
CASH_OUT,3699,Marc Gilbert,4415,716,Agence_moov_Ouidah,300000,296301,2022-12-18
TRANSFER,440401,Vincent-Philippe Rossi,840016,399615,Marc Gilbert,716,441117,2022-12-21
CASH_OUT,202547,Marc Gilbert,441117,238570,Agence_moov_Abomey,300000,97453,2022-12-21
TRANSFER,132819,Marc Gilbert,238570,105751,Gilbert Bazin Le Guillet,201175,68356,2022-12-22
CASH_OUT,90613,Marc Gilbert,105751,15138,Agence_moov_Abomey,300000,209387,2022-12-25
CASH_OUT,1889421,David-Théodore Diaz,1926900,37479,Agence_moov_Abomey,300000,-1589421,2022-12-02
CASH_IN,261345,Agence_moov_Abomey,300000,38655,David-Théodore Diaz,37479,298824,2022-12-03
CASH_OUT,177146,David-Théodore Diaz,298824,121678,Agence_moov_Cotonou,300000,122854,2022-12-05
TRANSFER,21054,David-Théodore Diaz,121678,100624,Maryse Lebreton,1473700,1452646,2022-12-05
CASH_IN,260753,Agence_moov_Cotonou,300000,39247,David-Théodore Diaz,100624,361377,2022-12-07
CASH_OUT,43267,David-Théodore Diaz,361377,318110,Agence_moov_Ouidah,300000,256733,2022-12-09
CASH_OUT,119252,David-Théodore Diaz,318110,198858,Agence_moov_Cotonou,300000,180748,2022-12-10
TRANSFER,51744,David-Théodore Diaz,198858,147114,Paulette Dias,1200044,1148300,2022-12-10
CASH_IN,215806,Agence_moov_Cotonou,300000,84194,David-Théodore Diaz,147114,362920,2022-12-11
TRANSFER,320181,David-Théodore Diaz,362920,42739,Maurice Seguin,1685400,1365219,2022-12-12
CASH_OUT,17426,David-Théodore Diaz,42739,25313,Agence_moov_Abomey,300000,282574,2022-12-12
CASH_OUT,19165,David-Théodore Diaz,25313,6148,Agence_moov_Cotonou,300000,280835,2022-12-13
CASH_OUT,5296,David-Théodore Diaz,6148,852,Agence_moov_Cotonou,300000,294704,2022-12-15
CASH_OUT,124,David-Théodore Diaz,852,728,Agence_moov_Abomey,300000,299876,2022-12-16
TRANSFER,645,David-Théodore Diaz,728,83,Léon Paris,632600,631955,2022-12-19
CASH_IN,175757,Agence_moov_Abomey,300000,124243,David-Théodore Diaz,83,175840,2022-12-19
TRANSFER,25275,David-Théodore Diaz,175840,150565,Caroline Bonneau,328873,303598,2022-12-19
CASH_IN,40252,Agence_moov_Cotonou,300000,259748,David-Théodore Diaz,150565,190817,2022-12-19
TRANSFER,184641,David-Théodore Diaz,190817,6176,Laurent Besson,1871566,1686925,2022-12-19
CASH_OUT,4436,David-Théodore Diaz,6176,1740,Agence_moov_Cotonou,300000,295564,2022-12-20
CASH_OUT,866,David-Théodore Diaz,1740,874,Agence_moov_Cotonou,300000,299134,2022-12-20
CASH_OUT,373,David-Théodore Diaz,874,501,Agence_moov_Abomey,300000,299627,2022-12-21
CASH_IN,95151,Agence_moov_Abomey,300000,204849,David-Théodore Diaz,501,95652,2022-12-23
TRANSFER,69280,David-Théodore Diaz,95652,26372,Agnès Chrétien-Sanchez,1159635,1090355,2022-12-23
TRANSFER,7677,David-Théodore Diaz,26372,18695,Noël Hamel,692800,685123,2022-12-23
TRANSFER,1393649,Stéphane-Timothée Pineau,1602541,208892,David-Théodore Diaz,18695,1412344,2022-12-24
TRANSFER,16517,Julie Robin de Gros,630262,613745,David-Théodore Diaz,1412344,1428861,2022-12-25
CASH_OUT,898913,David-Théodore Diaz,1428861,529948,Agence_moov_Ouidah,300000,-598913,2022-12-25
CASH_IN,15369,Agence_moov_Abomey,300000,284631,Arnaude Gaillard,740525,755894,2022-12-01
CASH_OUT,17462,Arnaude Gaillard,755894,738432,Agence_moov_Cotonou,300000,282538,2022-12-01
TRANSFER,254907,Arnaude Gaillard,738432,483525,Marthe Guillet,271041,16134,2022-12-01
TRANSFER,135419,Stéphane-Timothée Pineau,208892,73473,Arnaude Gaillard,483525,618944,2022-12-01
CASH_OUT,134622,Arnaude Gaillard,618944,484322,Agence_moov_Cotonou,300000,165378,2022-12-01
TRANSFER,423318,Arnaude Gaillard,484322,61004,Gabriel de Pineau,294679,-128639,2022-12-01
TRANSFER,7740,Richard Guibert,23852,16112,Arnaude Gaillard,61004,68744,2022-12-04
TRANSFER,68353,Arnaude Gaillard,68744,391,Nathalie-Chantal Jacques,41811,-26542,2022-12-04
TRANSFER,104,Arnaude Gaillard,391,287,Emmanuel-René Coulon,1254449,1254345,2022-12-05
CASH_IN,101668,Agence_moov_Ouidah,300000,198332,Arnaude Gaillard,287,101955,2022-12-05
CASH_OUT,73945,Arnaude Gaillard,101955,28010,Agence_moov_Cotonou,300000,226055,2022-12-05
TRANSFER,12152,Arnaude Gaillard,28010,15858,Clémence Bertin,92168,80016,2022-12-06
CASH_OUT,2475,Arnaude Gaillard,15858,13383,Agence_moov_Abomey,300000,297525,2022-12-07
CASH_OUT,1488,Arnaude Gaillard,13383,11895,Agence_moov_Ouidah,300000,298512,2022-12-08
CASH_OUT,10045,Arnaude Gaillard,11895,1850,Agence_moov_Abomey,300000,289955,2022-12-10
CASH_OUT,975,Arnaude Gaillard,1850,875,Agence_moov_Ouidah,300000,299025,2022-12-10
TRANSFER,369,Arnaude Gaillard,875,506,Lucy Vaillant,925600,925231,2022-12-10
CASH_IN,123698,Agence_moov_Ouidah,300000,176302,Arnaude Gaillard,506,124204,2022-12-11
TRANSFER,4863,Arnaude Gaillard,124204,119341,Gilbert Bazin Le Guillet,68356,63493,2022-12-11
CASH_OUT,93112,Arnaude Gaillard,119341,26229,Agence_moov_Cotonou,300000,206888,2022-12-13
TRANSFER,691702,Matthieu Renard,1096379,404677,Arnaude Gaillard,26229,717931,2022-12-14
CASH_IN,250811,Agence_moov_Abomey,300000,49189,Arnaude Gaillard,717931,968742,2022-12-17
TRANSFER,235441,Arnaude Gaillard,968742,733301,Alphonse Dupont-Petit,697139,461698,2022-12-17
CASH_OUT,441927,Arnaude Gaillard,733301,291374,Agence_moov_Abomey,300000,-141927,2022-12-19
CASH_IN,85078,Agence_moov_Cotonou,300000,214922,Arnaude Gaillard,291374,376452,2022-12-23
TRANSFER,236710,Arnaude Gaillard,376452,139742,Marianne Descamps,1876200,1639490,2022-12-24
TRANSFER,75110,Arnaude Gaillard,139742,64632,Maurice Seguin,1365219,1290109,2022-12-25
CASH_OUT,42613,Arnaude Gaillard,64632,22019,Agence_moov_Cotonou,300000,257387,2022-12-25
CASH_OUT,6951,Arnaude Gaillard,22019,15068,Agence_moov_Cotonou,300000,293049,2022-12-27
CASH_OUT,9838,Arnaude Gaillard,15068,5230,Agence_moov_Abomey,300000,290162,2022-12-27
CASH_IN,36878,Agence_moov_Ouidah,300000,263122,Susan de Fontaine,638225,675103,2022-12-01
TRANSFER,1015812,Alfred Chrétien,1021300,5488,Susan de Fontaine,675103,1690915,2022-12-04
CASH_OUT,6470,Susan de Fontaine,1690915,1684445,Agence_moov_Cotonou,300000,293530,2022-12-07
CASH_IN,236616,Agence_moov_Abomey,300000,63384,Susan de Fontaine,1684445,1921061,2022-12-08
CASH_OUT,431090,Susan de Fontaine,1921061,1489971,Agence_moov_Ouidah,300000,-131090,2022-12-08
TRANSFER,224974,Susan de Fontaine,1489971,1264997,Valentine Traore,159725,-65249,2022-12-12
CASH_OUT,100942,Susan de Fontaine,1264997,1164055,Agence_moov_Ouidah,300000,199058,2022-12-12
CASH_OUT,484849,Susan de Fontaine,1164055,679206,Agence_moov_Cotonou,300000,-184849,2022-12-12
CASH_OUT,628944,Susan de Fontaine,679206,50262,Agence_moov_Abomey,300000,-328944,2022-12-12
TRANSFER,43820,Susan de Fontaine,50262,6442,Marthe Pichon,490000,446180,2022-12-13
CASH_OUT,5082,Susan de Fontaine,6442,1360,Agence_moov_Cotonou,300000,294918,2022-12-13
CASH_IN,23668,Agence_moov_Ouidah,300000,276332,Susan de Fontaine,1360,25028,2022-12-16
CASH_IN,121190,Agence_moov_Abomey,300000,178810,Susan de Fontaine,25028,146218,2022-12-17
CASH_OUT,69934,Susan de Fontaine,146218,76284,Agence_moov_Abomey,300000,230066,2022-12-17
CASH_OUT,43781,Susan de Fontaine,76284,32503,Agence_moov_Cotonou,300000,256219,2022-12-17
CASH_OUT,13704,Susan de Fontaine,32503,18799,Agence_moov_Abomey,300000,286296,2022-12-19
TRANSFER,1181863,Marianne Descamps,1639490,457627,Susan de Fontaine,18799,1200662,2022-12-21
CASH_IN,45803,Agence_moov_Abomey,300000,254197,Susan de Fontaine,1200662,1246465,2022-12-21
CASH_IN,129833,Agence_moov_Abomey,300000,170167,Susan de Fontaine,1246465,1376298,2022-12-21
TRANSFER,379931,Susan de Fontaine,1376298,996367,Sébastien Jourdan,1350800,970869,2022-12-23
TRANSFER,226108,Margot Renaud de Lacombe,329998,103890,Susan de Fontaine,996367,1222475,2022-12-24
CASH_IN,161066,Agence_moov_Ouidah,300000,138934,Nicolas Grondin de la Pinto,865000,1026066,2022-12-03
CASH_OUT,654423,Nicolas Grondin de la Pinto,1026066,371643,Agence_moov_Abomey,300000,-354423,2022-12-03
CASH_OUT,85651,Nicolas Grondin de la Pinto,371643,285992,Agence_moov_Cotonou,300000,214349,2022-12-03
CASH_OUT,197964,Nicolas Grondin de la Pinto,285992,88028,Agence_moov_Ouidah,300000,102036,2022-12-04
CASH_IN,13613,Agence_moov_Cotonou,300000,286387,Nicolas Grondin de la Pinto,88028,101641,2022-12-05
CASH_OUT,53595,Nicolas Grondin de la Pinto,101641,48046,Agence_moov_Cotonou,300000,246405,2022-12-05
TRANSFER,3833,Richard Guibert,16112,12279,Nicolas Grondin de la Pinto,48046,51879,2022-12-05
CASH_OUT,24972,Nicolas Grondin de la Pinto,51879,26907,Agence_moov_Ouidah,300000,275028,2022-12-06
CASH_IN,76473,Agence_moov_Abomey,300000,223527,Nicolas Grondin de la Pinto,26907,103380,2022-12-06
TRANSFER,43304,Nicolas Grondin de la Pinto,103380,60076,Adélaïde-Sophie Leclercq,942095,898791,2022-12-08
CASH_OUT,10254,Nicolas Grondin de la Pinto,60076,49822,Agence_moov_Cotonou,300000,289746,2022-12-12
CASH_IN,158693,Agence_moov_Abomey,300000,141307,Nicolas Grondin de la Pinto,49822,208515,2022-12-14
CASH_OUT,33207,Nicolas Grondin de la Pinto,208515,175308,Agence_moov_Ouidah,300000,266793,2022-12-15
TRANSFER,344534,Marianne Descamps,457627,113093,Nicolas Grondin de la Pinto,175308,519842,2022-12-16
TRANSFER,276772,Nicolas Grondin de la Pinto,519842,243070,Adélaïde-Sophie Leclercq,898791,622019,2022-12-17
CASH_IN,233549,Agence_moov_Cotonou,300000,66451,Nicolas Grondin de la Pinto,243070,476619,2022-12-17
TRANSFER,203280,Alphonse Dupont-Petit,461698,258418,Nicolas Grondin de la Pinto,476619,679899,2022-12-17
CASH_IN,238788,Agence_moov_Cotonou,300000,61212,Nicolas Grondin de la Pinto,679899,918687,2022-12-17
TRANSFER,798487,Lucy Vaillant,925231,126744,Nicolas Grondin de la Pinto,918687,1717174,2022-12-21
CASH_OUT,428319,Nicolas Grondin de la Pinto,1717174,1288855,Agence_moov_Cotonou,300000,-128319,2022-12-21
CASH_OUT,855496,Nicolas Grondin de la Pinto,1288855,433359,Agence_moov_Cotonou,300000,-555496,2022-12-21
CASH_OUT,267763,Nicolas Grondin de la Pinto,433359,165596,Agence_moov_Abomey,300000,32237,2022-12-21
CASH_IN,202069,Agence_moov_Abomey,300000,97931,Nicolas Grondin de la Pinto,165596,367665,2022-12-22
CASH_IN,278396,Agence_moov_Abomey,300000,21604,Nicolas Grondin de la Pinto,367665,646061,2022-12-25
CASH_IN,116115,Agence_moov_Cotonou,300000,183885,Nicolas Grondin de la Pinto,646061,762176,2022-12-26
CASH_IN,125574,Agence_moov_Cotonou,300000,174426,Nicolas Grondin de la Pinto,762176,887750,2022-12-27
CASH_OUT,140403,Nicolas Grondin de la Pinto,887750,747347,Agence_moov_Cotonou,300000,159597,2022-12-27
CASH_IN,246882,Agence_moov_Ouidah,300000,53118,Émilie Guillon de Duhamel,728131,975013,2022-12-01
CASH_IN,290990,Agence_moov_Abomey,300000,9010,Émilie Guillon de Duhamel,975013,1266003,2022-12-02
CASH_OUT,1117934,Émilie Guillon de Duhamel,1266003,148069,Agence_moov_Abomey,300000,-817934,2022-12-02
CASH_IN,177331,Agence_moov_Ouidah,300000,122669,Émilie Guillon de Duhamel,148069,325400,2022-12-03
CASH_OUT,91801,Émilie Guillon de Duhamel,325400,233599,Agence_moov_Abomey,300000,208199,2022-12-04
CASH_IN,5192,Agence_moov_Ouidah,300000,294808,Émilie Guillon de Duhamel,233599,238791,2022-12-05
CASH_OUT,211940,Émilie Guillon de Duhamel,238791,26851,Agence_moov_Abomey,300000,88060,2022-12-06
TRANSFER,275535,Xavier-Stéphane Ollivier,1171000,895465,Émilie Guillon de Duhamel,26851,302386,2022-12-07
CASH_OUT,263707,Émilie Guillon de Duhamel,302386,38679,Agence_moov_Ouidah,300000,36293,2022-12-07
CASH_IN,183259,Agence_moov_Abomey,300000,116741,Émilie Guillon de Duhamel,38679,221938,2022-12-10
CASH_OUT,7187,Émilie Guillon de Duhamel,221938,214751,Agence_moov_Cotonou,300000,292813,2022-12-11
CASH_OUT,197000,Émilie Guillon de Duhamel,214751,17751,Agence_moov_Ouidah,300000,103000,2022-12-11
TRANSFER,7830,Émilie Guillon de Duhamel,17751,9921,Margot Renaud de Lacombe,103890,96060,2022-12-11
CASH_IN,114524,Agence_moov_Ouidah,300000,185476,Émilie Guillon de Duhamel,9921,124445,2022-12-16
CASH_OUT,79655,Émilie Guillon de Duhamel,124445,44790,Agence_moov_Abomey,300000,220345,2022-12-18
CASH_IN,247065,Agence_moov_Ouidah,300000,52935,Émilie Guillon de Duhamel,44790,291855,2022-12-19
CASH_OUT,191847,Émilie Guillon de Duhamel,291855,100008,Agence_moov_Abomey,300000,108153,2022-12-20
CASH_OUT,76979,Émilie Guillon de Duhamel,100008,23029,Agence_moov_Cotonou,300000,223021,2022-12-20
CASH_IN,275242,Agence_moov_Abomey,300000,24758,Émilie Guillon de Duhamel,23029,298271,2022-12-22
CASH_OUT,157078,Émilie Guillon de Duhamel,298271,141193,Agence_moov_Cotonou,300000,142922,2022-12-23
CASH_OUT,59619,Émilie Guillon de Duhamel,141193,81574,Agence_moov_Abomey,300000,240381,2022-12-25
TRANSFER,45598,Émilie Guillon de Duhamel,81574,35976,Matthieu Renard,404677,359079,2022-12-26
CASH_IN,106159,Agence_moov_Abomey,300000,193841,Emmanuel-René Coulon,1254345,1360504,2022-12-01
TRANSFER,776926,Emmanuel-René Coulon,1360504,583578,Clémence Bertin,80016,-696910,2022-12-04
CASH_IN,231552,Agence_moov_Abomey,300000,68448,Emmanuel-René Coulon,583578,815130,2022-12-05
CASH_IN,199347,Agence_moov_Cotonou,300000,100653,Emmanuel-René Coulon,815130,1014477,2022-12-05
CASH_IN,58326,Agence_moov_Abomey,300000,241674,Emmanuel-René Coulon,1014477,1072803,2022-12-05
CASH_OUT,475243,Emmanuel-René Coulon,1072803,597560,Agence_moov_Ouidah,300000,-175243,2022-12-06
TRANSFER,164127,Emmanuel-René Coulon,597560,433433,Frédéric Moreau,13027,-151100,2022-12-12
TRANSFER,118238,Emmanuel-René Coulon,433433,315195,Maryse Lebreton,1452646,1334408,2022-12-12
TRANSFER,299226,Emmanuel-René Coulon,315195,15969,Luc Camus,1488149,1188923,2022-12-13
CASH_OUT,3840,Emmanuel-René Coulon,15969,12129,Agence_moov_Cotonou,300000,296160,2022-12-16
CASH_IN,71551,Agence_moov_Cotonou,300000,228449,Emmanuel-René Coulon,12129,83680,2022-12-16
TRANSFER,25069,Emmanuel-René Coulon,83680,58611,Vincent-Philippe Rossi,399615,374546,2022-12-17
TRANSFER,4139,Emmanuel-René Coulon,58611,54472,Matthieu Carpentier,1856400,1852261,2022-12-18
TRANSFER,239379,Augustin Benard,416807,177428,Emmanuel-René Coulon,54472,293851,2022-12-18
CASH_IN,293430,Agence_moov_Cotonou,300000,6570,Emmanuel-René Coulon,293851,587281,2022-12-18
TRANSFER,83326,Margot Renaud de Lacombe,96060,12734,Emmanuel-René Coulon,587281,670607,2022-12-18
CASH_OUT,41889,Emmanuel-René Coulon,670607,628718,Agence_moov_Ouidah,300000,258111,2022-12-19
CASH_IN,103881,Agence_moov_Abomey,300000,196119,Emmanuel-René Coulon,628718,732599,2022-12-19
TRANSFER,193239,Emmanuel-René Coulon,732599,539360,Théodore Bertin,1789000,1595761,2022-12-19
CASH_IN,20036,Agence_moov_Ouidah,300000,279964,Emmanuel-René Coulon,539360,559396,2022-12-19
TRANSFER,546478,Emmanuel-René Coulon,559396,12918,Théodore-Alfred Fournier,123898,-422580,2022-12-20
CASH_OUT,9341,Emmanuel-René Coulon,12918,3577,Agence_moov_Cotonou,300000,290659,2022-12-24
CASH_OUT,2630,Emmanuel-René Coulon,3577,947,Agence_moov_Abomey,300000,297370,2022-12-26
CASH_OUT,1535462,Anastasie Louis,1651200,115738,Agence_moov_Abomey,300000,-1235462,2022-12-01
CASH_OUT,3148,Anastasie Louis,115738,112590,Agence_moov_Ouidah,300000,296852,2022-12-01
TRANSFER,249159,Paulette Dias,1148300,899141,Anastasie Louis,112590,361749,2022-12-03
CASH_OUT,42968,Anastasie Louis,361749,318781,Agence_moov_Ouidah,300000,257032,2022-12-06
TRANSFER,108976,Anastasie Louis,318781,209805,Noël Hamel,685123,576147,2022-12-06
TRANSFER,304655,Nicolas Hervé,605600,300945,Anastasie Louis,209805,514460,2022-12-07
CASH_OUT,337764,Anastasie Louis,514460,176696,Agence_moov_Ouidah,300000,-37764,2022-12-09
TRANSFER,904468,Matthieu Carpentier,1852261,947793,Anastasie Louis,176696,1081164,2022-12-09
CASH_IN,166428,Agence_moov_Cotonou,300000,133572,Anastasie Louis,1081164,1247592,2022-12-10
CASH_OUT,22058,Anastasie Louis,1247592,1225534,Agence_moov_Cotonou,300000,277942,2022-12-11
CASH_OUT,661978,Anastasie Louis,1225534,563556,Agence_moov_Cotonou,300000,-361978,2022-12-12
CASH_OUT,181462,Anastasie Louis,563556,382094,Agence_moov_Abomey,300000,118538,2022-12-13
CASH_OUT,78055,Anastasie Louis,382094,304039,Agence_moov_Abomey,300000,221945,2022-12-13
CASH_OUT,201591,Anastasie Louis,304039,102448,Agence_moov_Ouidah,300000,98409,2022-12-13
CASH_IN,185734,Agence_moov_Ouidah,300000,114266,Anastasie Louis,102448,288182,2022-12-14
CASH_IN,158974,Agence_moov_Ouidah,300000,141026,Anastasie Louis,288182,447156,2022-12-15
CASH_OUT,165441,Anastasie Louis,447156,281715,Agence_moov_Ouidah,300000,134559,2022-12-15
CASH_OUT,48871,Anastasie Louis,281715,232844,Agence_moov_Ouidah,300000,251129,2022-12-15
CASH_OUT,46119,Anastasie Louis,232844,186725,Agence_moov_Ouidah,300000,253881,2022-12-16
CASH_IN,88591,Agence_moov_Ouidah,300000,211409,Anastasie Louis,186725,275316,2022-12-18
CASH_IN,23033,Agence_moov_Abomey,300000,276967,Anastasie Louis,275316,298349,2022-12-18
TRANSFER,174369,Anastasie Louis,298349,123980,Alphonse Dupont-Petit,258418,84049,2022-12-20
CASH_IN,174618,Agence_moov_Abomey,300000,125382,Anastasie Louis,123980,298598,2022-12-21
CASH_OUT,231341,Anastasie Louis,298598,67257,Agence_moov_Cotonou,300000,68659,2022-12-24
TRANSFER,53729,Anastasie Louis,67257,13528,Michèle Vallée,188400,134671,2022-12-25
CASH_OUT,10287,Anastasie Louis,13528,3241,Agence_moov_Abomey,300000,289713,2022-12-26
TRANSFER,1447125,Laurent Besson,1686925,239800,Anastasie Louis,3241,1450366,2022-12-27
CASH_OUT,151182,Théophile Mendès,167800,16618,Agence_moov_Abomey,300000,148818,2022-12-01
CASH_OUT,14622,Théophile Mendès,16618,1996,Agence_moov_Abomey,300000,285378,2022-12-01
TRANSFER,2020,Alfred Chrétien,5488,3468,Théophile Mendès,1996,4016,2022-12-01
CASH_OUT,1704,Théophile Mendès,4016,2312,Agence_moov_Cotonou,300000,298296,2022-12-03
TRANSFER,293938,Marthe Pichon,446180,152242,Théophile Mendès,2312,296250,2022-12-04
CASH_OUT,13341,Théophile Mendès,296250,282909,Agence_moov_Cotonou,300000,286659,2022-12-06
CASH_IN,244174,Agence_moov_Abomey,300000,55826,Théophile Mendès,282909,527083,2022-12-07
CASH_OUT,381509,Théophile Mendès,527083,145574,Agence_moov_Ouidah,300000,-81509,2022-12-07
TRANSFER,51714,Théophile Mendès,145574,93860,Sébastien Jourdan,970869,919155,2022-12-07
CASH_OUT,3153,Théophile Mendès,93860,90707,Agence_moov_Cotonou,300000,296847,2022-12-10
CASH_IN,84347,Agence_moov_Ouidah,300000,215653,Théophile Mendès,90707,175054,2022-12-11
TRANSFER,281217,Benoît Verdier,316800,35583,Théophile Mendès,175054,456271,2022-12-11
CASH_OUT,397000,Théophile Mendès,456271,59271,Agence_moov_Cotonou,300000,-97000,2022-12-12
TRANSFER,400,Théophile Mendès,59271,58871,Maryse Lebreton,1334408,1334008,2022-12-15
TRANSFER,21240,Marianne Descamps,113093,91853,Théophile Mendès,58871,80111,2022-12-15
CASH_OUT,52077,Théophile Mendès,80111,28034,Agence_moov_Ouidah,300000,247923,2022-12-16
TRANSFER,58043,Laurent Besson,239800,181757,Théophile Mendès,28034,86077,2022-12-17
CASH_IN,51569,Agence_moov_Cotonou,300000,248431,Théophile Mendès,86077,137646,2022-12-18
CASH_IN,129179,Agence_moov_Abomey,300000,170821,Théophile Mendès,137646,266825,2022-12-20
TRANSFER,240850,Matthieu Renard,359079,118229,Théophile Mendès,266825,507675,2022-12-21
TRANSFER,912985,Agnès Chrétien-Sanchez,1090355,177370,Théophile Mendès,507675,1420660,2022-12-21
CASH_IN,148616,Agence_moov_Abomey,300000,151384,Théophile Mendès,1420660,1569276,2022-12-22
CASH_IN,73573,Agence_moov_Abomey,300000,226427,Théophile Mendès,1569276,1642849,2022-12-22
CASH_OUT,1486522,Théophile Mendès,1642849,156327,Agence_moov_Abomey,300000,-1186522,2022-12-23
TRANSFER,65413,Théophile Mendès,156327,90914,Stéphane-Timothée Pineau,73473,8060,2022-12-23
CASH_IN,238104,Agence_moov_Abomey,300000,61896,Théophile Mendès,90914,329018,2022-12-25
TRANSFER,296121,Théophile Mendès,329018,32897,Marianne Descamps,91853,-204268,2022-12-25
CASH_IN,53591,Agence_moov_Abomey,300000,246409,Théophile Mendès,32897,86488,2022-12-25
CASH_OUT,988635,Emmanuelle Gilbert,1417200,428565,Agence_moov_Ouidah,300000,-688635,2022-12-01
TRANSFER,44877,Matthieu Renard,118229,73352,Emmanuelle Gilbert,428565,473442,2022-12-01
CASH_IN,6069,Agence_moov_Ouidah,300000,293931,Emmanuelle Gilbert,473442,479511,2022-12-01
CASH_IN,77417,Agence_moov_Ouidah,300000,222583,Emmanuelle Gilbert,479511,556928,2022-12-01
TRANSFER,257891,Emmanuelle Gilbert,556928,299037,Stéphane-Timothée Pineau,8060,-249831,2022-12-02
CASH_IN,133963,Agence_moov_Abomey,300000,166037,Emmanuelle Gilbert,299037,433000,2022-12-03
TRANSFER,419149,Emmanuelle Gilbert,433000,13851,Benoît Verdier,35583,-383566,2022-12-03
CASH_IN,43896,Agence_moov_Cotonou,300000,256104,Emmanuelle Gilbert,13851,57747,2022-12-04
TRANSFER,23006,Emmanuelle Gilbert,57747,34741,Gilbert Bazin Le Guillet,63493,40487,2022-12-04
CASH_OUT,17964,Emmanuelle Gilbert,34741,16777,Agence_moov_Abomey,300000,282036,2022-12-04
CASH_IN,45836,Agence_moov_Cotonou,300000,254164,Emmanuelle Gilbert,16777,62613,2022-12-05
CASH_OUT,36784,Emmanuelle Gilbert,62613,25829,Agence_moov_Abomey,300000,263216,2022-12-05
CASH_OUT,10758,Emmanuelle Gilbert,25829,15071,Agence_moov_Ouidah,300000,289242,2022-12-06
TRANSFER,73740,Laurent Besson,181757,108017,Emmanuelle Gilbert,15071,88811,2022-12-10
CASH_OUT,45263,Emmanuelle Gilbert,88811,43548,Agence_moov_Cotonou,300000,254737,2022-12-10
CASH_OUT,38295,Emmanuelle Gilbert,43548,5253,Agence_moov_Ouidah,300000,261705,2022-12-10
CASH_IN,270979,Agence_moov_Abomey,300000,29021,Emmanuelle Gilbert,5253,276232,2022-12-11
CASH_IN,265316,Agence_moov_Abomey,300000,34684,Emmanuelle Gilbert,276232,541548,2022-12-11
TRANSFER,214946,Emmanuelle Gilbert,541548,326602,Caroline Peltier,449050,234104,2022-12-14
CASH_IN,109172,Agence_moov_Cotonou,300000,190828,Emmanuelle Gilbert,326602,435774,2022-12-16
CASH_IN,266201,Agence_moov_Abomey,300000,33799,Emmanuelle Gilbert,435774,701975,2022-12-18
CASH_OUT,121068,Emmanuelle Gilbert,701975,580907,Agence_moov_Abomey,300000,178932,2022-12-18
TRANSFER,494248,Emmanuelle Gilbert,580907,86659,Frédérique Robin,1053800,559552,2022-12-19
CASH_IN,95520,Agence_moov_Cotonou,300000,204480,Emmanuelle Gilbert,86659,182179,2022-12-21
CASH_IN,214789,Agence_moov_Cotonou,300000,85211,Emmanuelle Gilbert,182179,396968,2022-12-23
CASH_OUT,282687,Emmanuelle Gilbert,396968,114281,Agence_moov_Ouidah,300000,17313,2022-12-24
CASH_OUT,51360,Thierry Dos Santos-Le Roux,85987,34627,Agence_moov_Abomey,300000,248640,2022-12-01
TRANSFER,5448,Margot Renaud de Lacombe,12734,7286,Thierry Dos Santos-Le Roux,34627,40075,2022-12-02
CASH_IN,288456,Agence_moov_Cotonou,300000,11544,Thierry Dos Santos-Le Roux,40075,328531,2022-12-04
TRANSFER,144099,Thierry Dos Santos-Le Roux,328531,184432,Vincent-Grégoire Brunet,1126073,981974,2022-12-04
CASH_IN,245116,Agence_moov_Abomey,300000,54884,Thierry Dos Santos-Le Roux,184432,429548,2022-12-04
CASH_IN,230491,Agence_moov_Cotonou,300000,69509,Thierry Dos Santos-Le Roux,429548,660039,2022-12-06
CASH_IN,192996,Agence_moov_Abomey,300000,107004,Thierry Dos Santos-Le Roux,660039,853035,2022-12-07
CASH_IN,22302,Agence_moov_Abomey,300000,277698,Thierry Dos Santos-Le Roux,853035,875337,2022-12-07
CASH_IN,47630,Agence_moov_Cotonou,300000,252370,Thierry Dos Santos-Le Roux,875337,922967,2022-12-07
CASH_IN,183285,Agence_moov_Ouidah,300000,116715,Thierry Dos Santos-Le Roux,922967,1106252,2022-12-08
CASH_IN,69652,Agence_moov_Abomey,300000,230348,Thierry Dos Santos-Le Roux,1106252,1175904,2022-12-09
CASH_OUT,377299,Thierry Dos Santos-Le Roux,1175904,798605,Agence_moov_Cotonou,300000,-77299,2022-12-11
CASH_IN,146250,Agence_moov_Cotonou,300000,153750,Thierry Dos Santos-Le Roux,798605,944855,2022-12-12
TRANSFER,404280,Thierry Dos Santos-Le Roux,944855,540575,Caroline Bonneau,303598,-100682,2022-12-12
TRANSFER,57646,Thierry Dos Santos-Le Roux,540575,482929,Alfred Chrétien,3468,-54178,2022-12-13
CASH_OUT,184795,Thierry Dos Santos-Le Roux,482929,298134,Agence_moov_Ouidah,300000,115205,2022-12-14
CASH_IN,38369,Agence_moov_Ouidah,300000,261631,Thierry Dos Santos-Le Roux,298134,336503,2022-12-15
CASH_IN,164909,Agence_moov_Ouidah,300000,135091,Thierry Dos Santos-Le Roux,336503,501412,2022-12-16
CASH_IN,292034,Agence_moov_Abomey,300000,7966,Thierry Dos Santos-Le Roux,501412,793446,2022-12-18
CASH_IN,187949,Agence_moov_Abomey,300000,112051,Thierry Dos Santos-Le Roux,793446,981395,2022-12-18
CASH_IN,225438,Agence_moov_Abomey,300000,74562,Thierry Dos Santos-Le Roux,981395,1206833,2022-12-19
TRANSFER,567969,Thierry Dos Santos-Le Roux,1206833,638864,Margot Renaud de Lacombe,7286,-560683,2022-12-20
CASH_OUT,383576,Thierry Dos Santos-Le Roux,638864,255288,Agence_moov_Ouidah,300000,-83576,2022-12-20
CASH_IN,50102,Agence_moov_Ouidah,300000,249898,Thierry Dos Santos-Le Roux,255288,305390,2022-12-21
CASH_IN,50554,Agence_moov_Ouidah,300000,249446,Thierry Dos Santos-Le Roux,305390,355944,2022-12-22
CASH_IN,250016,Agence_moov_Ouidah,300000,49984,Thierry Dos Santos-Le Roux,355944,605960,2022-12-23
TRANSFER,192124,Paul De Sousa,869110,676986,Thierry Dos Santos-Le Roux,605960,798084,2022-12-25
CASH_IN,278758,Agence_moov_Abomey,300000,21242,Thierry Dos Santos-Le Roux,798084,1076842,2022-12-27
CASH_IN,276931,Agence_moov_Cotonou,300000,23069,Nathalie-Chantal Jacques,-26542,250389,2022-12-01
CASH_IN,74110,Agence_moov_Cotonou,300000,225890,Nathalie-Chantal Jacques,250389,324499,2022-12-02
CASH_OUT,279657,Nathalie-Chantal Jacques,324499,44842,Agence_moov_Cotonou,300000,20343,2022-12-02
TRANSFER,13488,Nathalie-Chantal Jacques,44842,31354,Paul De Sousa,676986,663498,2022-12-05
CASH_IN,129566,Agence_moov_Cotonou,300000,170434,Nathalie-Chantal Jacques,31354,160920,2022-12-07
TRANSFER,60695,Nathalie-Chantal Jacques,160920,100225,Marthe Guillet,16134,-44561,2022-12-08
TRANSFER,71682,Nathalie-Chantal Jacques,100225,28543,Nicolas Hervé,300945,229263,2022-12-09
TRANSFER,3726,Nathalie-Chantal Jacques,28543,24817,Frédérique Robin,559552,555826,2022-12-09
CASH_IN,217750,Agence_moov_Abomey,300000,82250,Nathalie-Chantal Jacques,24817,242567,2022-12-10
CASH_OUT,37896,Nathalie-Chantal Jacques,242567,204671,Agence_moov_Abomey,300000,262104,2022-12-11
CASH_OUT,132474,Nathalie-Chantal Jacques,204671,72197,Agence_moov_Cotonou,300000,167526,2022-12-12
CASH_IN,20312,Agence_moov_Abomey,300000,279688,Nathalie-Chantal Jacques,72197,92509,2022-12-12
CASH_IN,184473,Agence_moov_Abomey,300000,115527,Nathalie-Chantal Jacques,92509,276982,2022-12-14
CASH_IN,283459,Agence_moov_Cotonou,300000,16541,Nathalie-Chantal Jacques,276982,560441,2022-12-17
TRANSFER,79074,Alphonse Dupont-Petit,84049,4975,Nathalie-Chantal Jacques,560441,639515,2022-12-20
TRANSFER,259978,Luc Camus,1188923,928945,Nathalie-Chantal Jacques,639515,899493,2022-12-21
CASH_OUT,320797,Nathalie-Chantal Jacques,899493,578696,Agence_moov_Abomey,300000,-20797,2022-12-22
TRANSFER,543439,Nathalie-Chantal Jacques,578696,35257,Antoine Bourdon de Auger,717110,173671,2022-12-22
CASH_IN,189657,Agence_moov_Cotonou,300000,110343,Nathalie-Chantal Jacques,35257,224914,2022-12-26
CASH_IN,153883,Agence_moov_Ouidah,300000,146117,Nathalie-Chantal Jacques,224914,378797,2022-12-27
TRANSFER,495002,Matthieu Carpentier,947793,452791,Nathalie-Chantal Jacques,378797,873799,2022-12-27
TRANSFER,600606,Luc-Tristan Moreau,699800,99194,Nathalie-Chantal Jacques,873799,1474405,2022-12-27
CASH_OUT,1010793,Nathalie-Chantal Jacques,1474405,463612,Agence_moov_Abomey,300000,-710793,2022-12-27
TRANSFER,384501,Nathalie-Chantal Jacques,463612,79111,Luc Camus,928945,544444,2022-12-27
CASH_IN,30761,Agence_moov_Ouidah,300000,269239,Vincent-Philippe Rossi,374546,405307,2022-12-01
CASH_OUT,103544,Vincent-Philippe Rossi,405307,301763,Agence_moov_Ouidah,300000,196456,2022-12-01
CASH_OUT,123546,Vincent-Philippe Rossi,301763,178217,Agence_moov_Ouidah,300000,176454,2022-12-02
CASH_OUT,11091,Vincent-Philippe Rossi,178217,167126,Agence_moov_Cotonou,300000,288909,2022-12-03
TRANSFER,71022,Vincent-Philippe Rossi,167126,96104,Léon Paris,631955,560933,2022-12-03
CASH_OUT,46848,Vincent-Philippe Rossi,96104,49256,Agence_moov_Ouidah,300000,253152,2022-12-03
CASH_OUT,45409,Vincent-Philippe Rossi,49256,3847,Agence_moov_Ouidah,300000,254591,2022-12-05
CASH_IN,131029,Agence_moov_Abomey,300000,168971,Vincent-Philippe Rossi,3847,134876,2022-12-06
TRANSFER,132395,Vincent-Philippe Rossi,134876,2481,Isaac Le Pinto,64157,-68238,2022-12-11
CASH_IN,173960,Agence_moov_Cotonou,300000,126040,Vincent-Philippe Rossi,2481,176441,2022-12-12
CASH_OUT,16331,Vincent-Philippe Rossi,176441,160110,Agence_moov_Ouidah,300000,283669,2022-12-13
CASH_OUT,133712,Vincent-Philippe Rossi,160110,26398,Agence_moov_Cotonou,300000,166288,2022-12-14
CASH_IN,264963,Agence_moov_Ouidah,300000,35037,Vincent-Philippe Rossi,26398,291361,2022-12-16
CASH_OUT,90011,Vincent-Philippe Rossi,291361,201350,Agence_moov_Abomey,300000,209989,2022-12-17
CASH_OUT,113040,Vincent-Philippe Rossi,201350,88310,Agence_moov_Abomey,300000,186960,2022-12-18
TRANSFER,73442,Vincent-Philippe Rossi,88310,14868,Vincent-Philippe Rossi,88310,161752,2022-12-19
CASH_OUT,12715,Vincent-Philippe Rossi,14868,2153,Agence_moov_Ouidah,300000,287285,2022-12-19
CASH_IN,207406,Agence_moov_Cotonou,300000,92594,Vincent-Philippe Rossi,2153,209559,2022-12-20
CASH_IN,129994,Agence_moov_Ouidah,300000,170006,Vincent-Philippe Rossi,209559,339553,2022-12-21
CASH_OUT,239792,Vincent-Philippe Rossi,339553,99761,Agence_moov_Cotonou,300000,60208,2022-12-26
CASH_IN,297573,Agence_moov_Abomey,300000,2427,Vincent-Philippe Rossi,99761,397334,2022-12-27
CASH_OUT,151540,Vincent-Philippe Rossi,397334,245794,Agence_moov_Cotonou,300000,148460,2022-12-27
CASH_OUT,20748,Caroline Monnier,436100,415352,Agence_moov_Cotonou,300000,279252,2022-12-02
CASH_OUT,332363,Caroline Monnier,415352,82989,Agence_moov_Abomey,300000,-32363,2022-12-04
CASH_OUT,25779,Caroline Monnier,82989,57210,Agence_moov_Cotonou,300000,274221,2022-12-04
TRANSFER,498491,Maryse Lebreton,1334008,835517,Caroline Monnier,57210,555701,2022-12-05
CASH_IN,261187,Agence_moov_Abomey,300000,38813,Caroline Monnier,555701,816888,2022-12-05
CASH_IN,85834,Agence_moov_Cotonou,300000,214166,Caroline Monnier,816888,902722,2022-12-07
CASH_IN,26944,Agence_moov_Ouidah,300000,273056,Caroline Monnier,902722,929666,2022-12-07
CASH_OUT,126364,Caroline Monnier,929666,803302,Agence_moov_Ouidah,300000,173636,2022-12-08
CASH_IN,244312,Agence_moov_Cotonou,300000,55688,Caroline Monnier,803302,1047614,2022-12-08
CASH_IN,126935,Agence_moov_Abomey,300000,173065,Caroline Monnier,1047614,1174549,2022-12-09
TRANSFER,8803,Diane-Françoise Raynaud,11232,2429,Caroline Monnier,1174549,1183352,2022-12-09
TRANSFER,881891,Caroline Monnier,1183352,301461,Augustin Benard,177428,-704463,2022-12-10
TRANSFER,72739,Matthieu Renard,73352,613,Caroline Monnier,301461,374200,2022-12-11
TRANSFER,322835,Caroline Monnier,374200,51365,Luc Camus,544444,221609,2022-12-11
CASH_IN,290401,Agence_moov_Cotonou,300000,9599,Caroline Monnier,51365,341766,2022-12-12
CASH_IN,203335,Agence_moov_Abomey,300000,96665,Caroline Monnier,341766,545101,2022-12-12
TRANSFER,51667,Caroline Monnier,545101,493434,Antoine Bourdon de Auger,173671,122004,2022-12-13
TRANSFER,548168,Adélaïde-Sophie Leclercq,622019,73851,Caroline Monnier,493434,1041602,2022-12-13
CASH_OUT,310787,Caroline Monnier,1041602,730815,Agence_moov_Ouidah,300000,-10787,2022-12-13
TRANSFER,576288,Caroline Monnier,730815,154527,Laurent Besson,108017,-468271,2022-12-14
CASH_OUT,114317,Caroline Monnier,154527,40210,Agence_moov_Cotonou,300000,185683,2022-12-15
CASH_OUT,19292,Caroline Monnier,40210,20918,Agence_moov_Abomey,300000,280708,2022-12-15
CASH_OUT,3103,Caroline Monnier,20918,17815,Agence_moov_Cotonou,300000,296897,2022-12-19
CASH_OUT,2807,Caroline Monnier,17815,15008,Agence_moov_Abomey,300000,297193,2022-12-19
CASH_IN,167536,Agence_moov_Cotonou,300000,132464,Caroline Monnier,15008,182544,2022-12-22
CASH_IN,66027,Agence_moov_Cotonou,300000,233973,Caroline Monnier,182544,248571,2022-12-24
CASH_IN,232163,Agence_moov_Abomey,300000,67837,Caroline Monnier,248571,480734,2022-12-25
TRANSFER,414332,Matthieu Carpentier,452791,38459,Caroline Monnier,480734,895066,2022-12-27
CASH_IN,45572,Agence_moov_Abomey,300000,254428,Caroline Monnier,895066,940638,2022-12-27
TRANSFER,44409,Nicolas Hervé,229263,184854,Xavier-Stéphane Ollivier,895465,851056,2022-12-01
TRANSFER,3794,Auguste Bousquet,10662,6868,Nicolas Hervé,184854,188648,2022-12-01
CASH_IN,175811,Agence_moov_Abomey,300000,124189,Nicolas Hervé,188648,364459,2022-12-03
CASH_IN,180007,Agence_moov_Cotonou,300000,119993,Nicolas Hervé,364459,544466,2022-12-03
TRANSFER,59104,Antoine Bourdon de Auger,122004,62900,Nicolas Hervé,544466,603570,2022-12-03
CASH_IN,172925,Agence_moov_Ouidah,300000,127075,Nicolas Hervé,603570,776495,2022-12-04
CASH_OUT,639609,Nicolas Hervé,776495,136886,Agence_moov_Abomey,300000,-339609,2022-12-04
TRANSFER,211,Matthieu Renard,613,402,Nicolas Hervé,136886,137097,2022-12-05
CASH_OUT,22665,Nicolas Hervé,137097,114432,Agence_moov_Ouidah,300000,277335,2022-12-08
CASH_OUT,108728,Nicolas Hervé,114432,5704,Agence_moov_Abomey,300000,191272,2022-12-11
CASH_OUT,1044,Nicolas Hervé,5704,4660,Agence_moov_Abomey,300000,298956,2022-12-13
CASH_IN,268217,Agence_moov_Ouidah,300000,31783,Nicolas Hervé,4660,272877,2022-12-14
CASH_OUT,137777,Nicolas Hervé,272877,135100,Agence_moov_Cotonou,300000,162223,2022-12-14
CASH_IN,138929,Agence_moov_Cotonou,300000,161071,Nicolas Hervé,135100,274029,2022-12-17
TRANSFER,400825,Vincent-Grégoire Brunet,981974,581149,Nicolas Hervé,274029,674854,2022-12-17
TRANSFER,548227,Nicolas Hervé,674854,126627,Agnès Chrétien-Sanchez,177370,-370857,2022-12-18
CASH_IN,139113,Agence_moov_Abomey,300000,160887,Nicolas Hervé,126627,265740,2022-12-20
CASH_OUT,52696,Nicolas Hervé,265740,213044,Agence_moov_Abomey,300000,247304,2022-12-21
TRANSFER,130678,Nicolas Hervé,213044,82366,Marthe Pichon,152242,21564,2022-12-23
CASH_OUT,50166,Nicolas Hervé,82366,32200,Agence_moov_Abomey,300000,249834,2022-12-23
CASH_IN,105938,Agence_moov_Cotonou,300000,194062,Nicolas Hervé,32200,138138,2022-12-24
TRANSFER,107094,Nicolas Hervé,138138,31044,Noémi de la Didier,417500,310406,2022-12-26
TRANSFER,307233,Léon Paris,560933,253700,Amélie de la Picard,412043,104810,2022-12-03
CASH_OUT,242389,Léon Paris,253700,11311,Agence_moov_Ouidah,300000,57611,2022-12-03
CASH_IN,35294,Agence_moov_Cotonou,300000,264706,Léon Paris,11311,46605,2022-12-03
TRANSFER,9715,Léon Paris,46605,36890,Matthieu Renard,402,-9313,2022-12-04
CASH_OUT,18654,Léon Paris,36890,18236,Agence_moov_Abomey,300000,281346,2022-12-05
CASH_IN,285010,Agence_moov_Abomey,300000,14990,Léon Paris,18236,303246,2022-12-07
CASH_IN,263039,Agence_moov_Ouidah,300000,36961,Léon Paris,303246,566285,2022-12-07
CASH_IN,202462,Agence_moov_Abomey,300000,97538,Léon Paris,566285,768747,2022-12-08
CASH_OUT,582118,Léon Paris,768747,186629,Agence_moov_Cotonou,300000,-282118,2022-12-10
CASH_OUT,172069,Léon Paris,186629,14560,Agence_moov_Ouidah,300000,127931,2022-12-10
CASH_IN,162054,Agence_moov_Ouidah,300000,137946,Léon Paris,14560,176614,2022-12-10
CASH_IN,86979,Agence_moov_Ouidah,300000,213021,Léon Paris,176614,263593,2022-12-14
CASH_OUT,199490,Léon Paris,263593,64103,Agence_moov_Abomey,300000,100510,2022-12-15
CASH_OUT,10301,Léon Paris,64103,53802,Agence_moov_Abomey,300000,289699,2022-12-17
CASH_OUT,27123,Léon Paris,53802,26679,Agence_moov_Cotonou,300000,272877,2022-12-17
CASH_OUT,22608,Léon Paris,26679,4071,Agence_moov_Ouidah,300000,277392,2022-12-20
CASH_IN,145274,Agence_moov_Cotonou,300000,154726,Léon Paris,4071,149345,2022-12-20
TRANSFER,59318,Antoine Bourdon de Auger,62900,3582,Léon Paris,149345,208663,2022-12-20
CASH_IN,117194,Agence_moov_Cotonou,300000,182806,Léon Paris,208663,325857,2022-12-20
TRANSFER,316055,Léon Paris,325857,9802,Sabine Imbert,1414215,1098160,2022-12-21
CASH_IN,20432,Agence_moov_Cotonou,300000,279568,Léon Paris,9802,30234,2022-12-22
TRANSFER,3891,Matthieu Carpentier,38459,34568,Léon Paris,30234,34125,2022-12-23
CASH_IN,205961,Agence_moov_Abomey,300000,94039,Léon Paris,34125,240086,2022-12-23
CASH_OUT,35663,Léon Paris,240086,204423,Agence_moov_Ouidah,300000,264337,2022-12-24
CASH_OUT,189611,Léon Paris,204423,14812,Agence_moov_Ouidah,300000,110389,2022-12-25
CASH_OUT,7696,Léon Paris,14812,7116,Agence_moov_Cotonou,300000,292304,2022-12-25
CASH_IN,86245,Agence_moov_Cotonou,300000,213755,Léon Paris,7116,93361,2022-12-27
TRANSFER,338878,Xavier-Stéphane Ollivier,851056,512178,Paul De Sousa,663498,1002376,2022-12-01
CASH_IN,205227,Agence_moov_Cotonou,300000,94773,Paul De Sousa,1002376,1207603,2022-12-04
TRANSFER,452531,Paul De Sousa,1207603,755072,Noël Hamel,576147,123616,2022-12-05
CASH_OUT,82240,Paul De Sousa,755072,672832,Agence_moov_Abomey,300000,217760,2022-12-05
CASH_OUT,565880,Paul De Sousa,672832,106952,Agence_moov_Cotonou,300000,-265880,2022-12-07
CASH_IN,187018,Agence_moov_Ouidah,300000,112982,Paul De Sousa,106952,293970,2022-12-08
CASH_OUT,160011,Paul De Sousa,293970,133959,Agence_moov_Ouidah,300000,139989,2022-12-09
TRANSFER,48753,Paul De Sousa,133959,85206,Caroline Peltier,234104,185351,2022-12-09
CASH_IN,237574,Agence_moov_Ouidah,300000,62426,Paul De Sousa,85206,322780,2022-12-10
CASH_OUT,12084,Paul De Sousa,322780,310696,Agence_moov_Cotonou,300000,287916,2022-12-10
CASH_OUT,25530,Paul De Sousa,310696,285166,Agence_moov_Abomey,300000,274470,2022-12-12
CASH_IN,5287,Agence_moov_Abomey,300000,294713,Paul De Sousa,285166,290453,2022-12-12
CASH_IN,243966,Agence_moov_Abomey,300000,56034,Paul De Sousa,290453,534419,2022-12-14
CASH_IN,294053,Agence_moov_Cotonou,300000,5947,Paul De Sousa,534419,828472,2022-12-15
CASH_IN,63417,Agence_moov_Ouidah,300000,236583,Paul De Sousa,828472,891889,2022-12-15
TRANSFER,186038,Paul De Sousa,891889,705851,Luc Camus,221609,35571,2022-12-17
CASH_IN,44485,Agence_moov_Ouidah,300000,255515,Paul De Sousa,705851,750336,2022-12-18
CASH_OUT,261263,Paul De Sousa,750336,489073,Agence_moov_Cotonou,300000,38737,2022-12-18
TRANSFER,236585,Paul De Sousa,489073,252488,Antoine Bourdon de Auger,3582,-233003,2022-12-20
CASH_OUT,185264,Paul De Sousa,252488,67224,Agence_moov_Abomey,300000,114736,2022-12-22
CASH_IN,109252,Agence_moov_Abomey,300000,190748,Paul De Sousa,67224,176476,2022-12-22
TRANSFER,688,Auguste Bousquet,6868,6180,Paul De Sousa,176476,177164,2022-12-25
TRANSFER,86529,Paul De Sousa,177164,90635,Maurice Seguin,1290109,1203580,2022-12-26
CASH_IN,166686,Agence_moov_Ouidah,300000,133314,Paul De Sousa,90635,257321,2022-12-26
CASH_OUT,195653,Paul De Sousa,257321,61668,Agence_moov_Abomey,300000,104347,2022-12-27
TRANSFER,649700,Paulette Dias,899141,249441,Marthe Pichon,21564,-628136,2022-12-02
CASH_IN,142344,Agence_moov_Abomey,300000,157656,Paulette Dias,249441,391785,2022-12-07
CASH_OUT,75375,Paulette Dias,391785,316410,Agence_moov_Cotonou,300000,224625,2022-12-08
CASH_OUT,12575,Paulette Dias,316410,303835,Agence_moov_Abomey,300000,287425,2022-12-08
TRANSFER,364106,Xavier-Stéphane Ollivier,512178,148072,Paulette Dias,303835,667941,2022-12-10
CASH_OUT,477400,Paulette Dias,667941,190541,Agence_moov_Cotonou,300000,-177400,2022-12-11
TRANSFER,35603,Paulette Dias,190541,154938,Paulette Dias,190541,154938,2022-12-11
CASH_OUT,133787,Paulette Dias,154938,21151,Agence_moov_Cotonou,300000,166213,2022-12-16
TRANSFER,17088,Luc Camus,35571,18483,Paulette Dias,21151,38239,2022-12-18
TRANSFER,37913,Paulette Dias,38239,326,Gilbert Bazin Le Guillet,40487,2574,2022-12-19
CASH_IN,235741,Agence_moov_Abomey,300000,64259,Paulette Dias,326,236067,2022-12-22
CASH_OUT,153680,Paulette Dias,236067,82387,Agence_moov_Abomey,300000,146320,2022-12-25
CASH_IN,264454,Agence_moov_Abomey,300000,35546,Théodore-Alfred Fournier,-422580,-158126,2022-12-04
CASH_IN,293686,Agence_moov_Ouidah,300000,6314,Théodore-Alfred Fournier,-158126,135560,2022-12-05
CASH_OUT,86172,Théodore-Alfred Fournier,135560,49388,Agence_moov_Cotonou,300000,213828,2022-12-06
CASH_IN,79558,Agence_moov_Cotonou,300000,220442,Théodore-Alfred Fournier,49388,128946,2022-12-07
TRANSFER,6701,Théodore-Alfred Fournier,128946,122245,David Diallo,99900,93199,2022-12-11
TRANSFER,2771,Théodore-Alfred Fournier,122245,119474,David Diallo,93199,90428,2022-12-12
CASH_IN,219007,Agence_moov_Ouidah,300000,80993,Théodore-Alfred Fournier,119474,338481,2022-12-12
TRANSFER,128116,Théodore-Alfred Fournier,338481,210365,Luc Camus,18483,-109633,2022-12-14
TRANSFER,116550,Théodore-Alfred Fournier,210365,93815,Vincent-Grégoire Brunet,581149,464599,2022-12-16
CASH_IN,77823,Agence_moov_Ouidah,300000,222177,Théodore-Alfred Fournier,93815,171638,2022-12-18
CASH_IN,278618,Agence_moov_Ouidah,300000,21382,Théodore-Alfred Fournier,171638,450256,2022-12-20
TRANSFER,413223,Théodore-Alfred Fournier,450256,37033,Caroline Peltier,185351,-227872,2022-12-21
CASH_OUT,13379,Théodore-Alfred Fournier,37033,23654,Agence_moov_Ouidah,300000,286621,2022-12-22
CASH_IN,237311,Agence_moov_Abomey,300000,62689,Clémence Bertin,-696910,-459599,2022-12-01
CASH_IN,42883,Agence_moov_Abomey,300000,257117,Clémence Bertin,-459599,-416716,2022-12-02
CASH_IN,263388,Agence_moov_Abomey,300000,36612,Clémence Bertin,-416716,-153328,2022-12-04
CASH_IN,187229,Agence_moov_Ouidah,300000,112771,Clémence Bertin,-153328,33901,2022-12-06
CASH_IN,211034,Agence_moov_Ouidah,300000,88966,Clémence Bertin,33901,244935,2022-12-06
TRANSFER,15355,David Diallo,90428,75073,Clémence Bertin,244935,260290,2022-12-09
CASH_OUT,171894,Clémence Bertin,260290,88396,Agence_moov_Ouidah,300000,128106,2022-12-13
CASH_IN,182475,Agence_moov_Ouidah,300000,117525,Clémence Bertin,88396,270871,2022-12-13
CASH_IN,209367,Agence_moov_Cotonou,300000,90633,Clémence Bertin,270871,480238,2022-12-14
TRANSFER,338177,Clémence Bertin,480238,142061,Adélaïde-Sophie Leclercq,73851,-264326,2022-12-15
CASH_OUT,28820,Clémence Bertin,142061,113241,Agence_moov_Abomey,300000,271180,2022-12-19
CASH_IN,72023,Agence_moov_Ouidah,300000,227977,Clémence Bertin,113241,185264,2022-12-21
TRANSFER,84679,Noël Hamel,123616,38937,Clémence Bertin,185264,269943,2022-12-22
CASH_OUT,135293,Clémence Bertin,269943,134650,Agence_moov_Ouidah,300000,164707,2022-12-24
CASH_IN,186512,Agence_moov_Abomey,300000,113488,Clémence Bertin,134650,321162,2022-12-24
TRANSFER,1070204,Théodore Bertin,1595761,525557,Clémence Bertin,321162,1391366,2022-12-25
TRANSFER,36954,Noël Hamel,38937,1983,Clémence Bertin,1391366,1428320,2022-12-26
TRANSFER,365369,Clémence Bertin,1428320,1062951,Amélie de la Picard,104810,-260559,2022-12-27
CASH_OUT,466983,Clémence Bertin,1062951,595968,Agence_moov_Abomey,300000,-166983,2022-12-27
CASH_IN,265597,Agence_moov_Cotonou,300000,34403,Luc Camus,-109633,155964,2022-12-02
CASH_IN,159375,Agence_moov_Ouidah,300000,140625,Luc Camus,155964,315339,2022-12-02
CASH_OUT,32032,Luc Camus,315339,283307,Agence_moov_Cotonou,300000,267968,2022-12-02
TRANSFER,365364,Frédérique Robin,555826,190462,Luc Camus,283307,648671,2022-12-11
CASH_IN,11430,Agence_moov_Ouidah,300000,288570,Luc Camus,648671,660101,2022-12-15
TRANSFER,2286,Auguste Bousquet,6180,3894,Luc Camus,660101,662387,2022-12-15
CASH_IN,175436,Agence_moov_Cotonou,300000,124564,Luc Camus,662387,837823,2022-12-17
CASH_OUT,762896,Luc Camus,837823,74927,Agence_moov_Cotonou,300000,-462896,2022-12-17
TRANSFER,40490,Luc Camus,74927,34437,Auguste Bousquet,3894,-36596,2022-12-22
CASH_IN,55397,Agence_moov_Cotonou,300000,244603,Luc Camus,34437,89834,2022-12-22
TRANSFER,3459,Claudine Vallet,29700,26241,Luc Camus,89834,93293,2022-12-23
CASH_OUT,59956,Luc Camus,93293,33337,Agence_moov_Cotonou,300000,240044,2022-12-24
TRANSFER,346461,Vincent-Grégoire Brunet,464599,118138,Luc Camus,33337,379798,2022-12-27
CASH_IN,23208,Agence_moov_Cotonou,300000,276792,Adélaïde-Sophie Leclercq,-264326,-241118,2022-12-01
CASH_IN,104565,Agence_moov_Cotonou,300000,195435,Adélaïde-Sophie Leclercq,-241118,-136553,2022-12-02
CASH_IN,65798,Agence_moov_Ouidah,300000,234202,Adélaïde-Sophie Leclercq,-136553,-70755,2022-12-03
CASH_IN,31785,Agence_moov_Abomey,300000,268215,Adélaïde-Sophie Leclercq,-70755,-38970,2022-12-04
CASH_IN,49197,Agence_moov_Ouidah,300000,250803,Adélaïde-Sophie Leclercq,-38970,10227,2022-12-06
CASH_IN,108798,Agence_moov_Abomey,300000,191202,Adélaïde-Sophie Leclercq,10227,119025,2022-12-07
TRANSFER,588746,Maryse Lebreton,835517,246771,Adélaïde-Sophie Leclercq,119025,707771,2022-12-09
CASH_IN,206283,Agence_moov_Ouidah,300000,93717,Adélaïde-Sophie Leclercq,707771,914054,2022-12-09
CASH_OUT,114107,Adélaïde-Sophie Leclercq,914054,799947,Agence_moov_Cotonou,300000,185893,2022-12-10
TRANSFER,619732,Sabine Imbert,1098160,478428,Adélaïde-Sophie Leclercq,799947,1419679,2022-12-10
CASH_IN,173833,Agence_moov_Ouidah,300000,126167,Adélaïde-Sophie Leclercq,1419679,1593512,2022-12-10
TRANSFER,1359419,Adélaïde-Sophie Leclercq,1593512,234093,Noémi de la Didier,310406,-1049013,2022-12-11
CASH_IN,262261,Agence_moov_Cotonou,300000,37739,Adélaïde-Sophie Leclercq,234093,496354,2022-12-11
CASH_IN,92226,Agence_moov_Ouidah,300000,207774,Adélaïde-Sophie Leclercq,496354,588580,2022-12-12
CASH_IN,55529,Agence_moov_Ouidah,300000,244471,Adélaïde-Sophie Leclercq,588580,644109,2022-12-18
TRANSFER,9825,Frédérique Robin,190462,180637,Adélaïde-Sophie Leclercq,644109,653934,2022-12-20
CASH_IN,205081,Agence_moov_Abomey,300000,94919,Adélaïde-Sophie Leclercq,653934,859015,2022-12-21
CASH_OUT,535770,Adélaïde-Sophie Leclercq,859015,323245,Agence_moov_Abomey,300000,-235770,2022-12-22
CASH_OUT,162775,Adélaïde-Sophie Leclercq,323245,160470,Agence_moov_Abomey,300000,137225,2022-12-24
CASH_IN,108172,Agence_moov_Abomey,300000,191828,Adélaïde-Sophie Leclercq,160470,268642,2022-12-26
CASH_IN,273105,Agence_moov_Ouidah,300000,26895,Isaac Le Pinto,-68238,204867,2022-12-02
CASH_OUT,13537,Isaac Le Pinto,204867,191330,Agence_moov_Ouidah,300000,286463,2022-12-03
TRANSFER,122704,Isaac Le Pinto,191330,68626,Luc-Tristan Moreau,99194,-23510,2022-12-05
CASH_OUT,40290,Isaac Le Pinto,68626,28336,Agence_moov_Cotonou,300000,259710,2022-12-05
CASH_OUT,11727,Isaac Le Pinto,28336,16609,Agence_moov_Cotonou,300000,288273,2022-12-06
TRANSFER,7565,Isaac Le Pinto,16609,9044,Noël Hamel,1983,-5582,2022-12-07
TRANSFER,8810,Richard Guibert,12279,3469,Isaac Le Pinto,9044,17854,2022-12-11
TRANSFER,115653,Xavier-Stéphane Ollivier,148072,32419,Isaac Le Pinto,17854,133507,2022-12-12
TRANSFER,517723,Sébastien Jourdan,919155,401432,Isaac Le Pinto,133507,651230,2022-12-13
TRANSFER,49169,Isaac Le Pinto,651230,602061,Gilbert Bazin Le Guillet,2574,-46595,2022-12-16
CASH_IN,59824,Agence_moov_Cotonou,300000,240176,Isaac Le Pinto,602061,661885,2022-12-21
TRANSFER,91095,Isaac Le Pinto,661885,570790,Roland Colin,1045149,954054,2022-12-22
TRANSFER,123886,Frédérique Robin,180637,56751,Isaac Le Pinto,570790,694676,2022-12-24
CASH_OUT,585258,Isaac Le Pinto,694676,109418,Agence_moov_Ouidah,300000,-285258,2022-12-25
TRANSFER,84852,Isaac Le Pinto,109418,24566,Richard Guibert,3469,-81383,2022-12-25
CASH_IN,4051,Agence_moov_Cotonou,300000,295949,Marthe Guillet,-44561,-40510,2022-12-07
CASH_IN,123645,Agence_moov_Cotonou,300000,176355,Marthe Guillet,-40510,83135,2022-12-10
TRANSFER,371923,Maurice Seguin,1203580,831657,Marthe Guillet,83135,455058,2022-12-11
CASH_IN,24096,Agence_moov_Cotonou,300000,275904,Marthe Guillet,455058,479154,2022-12-12
CASH_OUT,322499,Marthe Guillet,479154,156655,Agence_moov_Abomey,300000,-22499,2022-12-13
CASH_IN,10808,Agence_moov_Ouidah,300000,289192,Marthe Guillet,156655,167463,2022-12-14
CASH_OUT,35299,Marthe Guillet,167463,132164,Agence_moov_Ouidah,300000,264701,2022-12-14
TRANSFER,110729,Marthe Guillet,132164,21435,Marthe Guillet,132164,21435,2022-12-17
TRANSFER,14988,Marthe Guillet,21435,6447,Alphonse Dupont-Petit,4975,-10013,2022-12-17
CASH_IN,34046,Agence_moov_Abomey,300000,265954,Marthe Guillet,6447,40493,2022-12-20
TRANSFER,14250,Marthe Guillet,40493,26243,Sébastien Jourdan,401432,387182,2022-12-20
CASH_IN,140282,Agence_moov_Cotonou,300000,159718,Marthe Guillet,26243,166525,2022-12-21
TRANSFER,581439,Océane Boutin,874700,293261,Marthe Guillet,166525,747964,2022-12-23
CASH_OUT,529143,Marthe Guillet,747964,218821,Agence_moov_Cotonou,300000,-229143,2022-12-26
TRANSFER,33799,Frédérique Robin,56751,22952,Marthe Guillet,218821,252620,2022-12-26
CASH_IN,69287,Agence_moov_Ouidah,300000,230713,Marthe Guillet,252620,321907,2022-12-27
CASH_IN,118597,Agence_moov_Abomey,300000,181403,Gilbert Bazin Le Guillet,-46595,72002,2022-12-02
TRANSFER,10789,Matthieu Carpentier,34568,23779,Gilbert Bazin Le Guillet,72002,82791,2022-12-03
TRANSFER,39299,Gilbert Bazin Le Guillet,82791,43492,Xavier-Stéphane Ollivier,32419,-6880,2022-12-04
TRANSFER,18151,Gilbert Bazin Le Guillet,43492,25341,Claudine Vallet,26241,8090,2022-12-11
CASH_IN,24322,Agence_moov_Abomey,300000,275678,Gilbert Bazin Le Guillet,25341,49663,2022-12-12
CASH_OUT,18872,Gilbert Bazin Le Guillet,49663,30791,Agence_moov_Abomey,300000,281128,2022-12-15
CASH_OUT,10059,Gilbert Bazin Le Guillet,30791,20732,Agence_moov_Cotonou,300000,289941,2022-12-18
TRANSFER,14509,Gilbert Bazin Le Guillet,20732,6223,Lucy Vaillant,126744,112235,2022-12-18
CASH_IN,208044,Agence_moov_Ouidah,300000,91956,Gilbert Bazin Le Guillet,6223,214267,2022-12-19
CASH_OUT,35962,Gilbert Bazin Le Guillet,214267,178305,Agence_moov_Cotonou,300000,264038,2022-12-19
TRANSFER,16988,Gilbert Bazin Le Guillet,178305,161317,Lucy Vaillant,112235,95247,2022-12-20
CASH_IN,271105,Agence_moov_Cotonou,300000,28895,Gilbert Bazin Le Guillet,161317,432422,2022-12-20
CASH_OUT,17541,Gilbert Bazin Le Guillet,432422,414881,Agence_moov_Cotonou,300000,282459,2022-12-21
TRANSFER,287643,Gilbert Bazin Le Guillet,414881,127238,Lucy Vaillant,95247,-192396,2022-12-21
CASH_IN,34487,Agence_moov_Cotonou,300000,265513,Gilbert Bazin Le Guillet,127238,161725,2022-12-24
TRANSFER,99468,Gilbert Bazin Le Guillet,161725,62257,Sébastien Jourdan,387182,287714,2022-12-24
CASH_IN,122612,Agence_moov_Cotonou,300000,177388,Gilbert Bazin Le Guillet,62257,184869,2022-12-24
CASH_OUT,153978,Gilbert Bazin Le Guillet,184869,30891,Agence_moov_Cotonou,300000,146022,2022-12-25
CASH_OUT,10852,Gilbert Bazin Le Guillet,30891,20039,Agence_moov_Abomey,300000,289148,2022-12-25
CASH_OUT,3643,Gilbert Bazin Le Guillet,20039,16396,Agence_moov_Cotonou,300000,296357,2022-12-27
CASH_IN,283540,Agence_moov_Ouidah,300000,16460,Richard Guibert,-81383,202157,2022-12-01
CASH_IN,235378,Agence_moov_Cotonou,300000,64622,Richard Guibert,202157,437535,2022-12-01
CASH_IN,214477,Agence_moov_Abomey,300000,85523,Richard Guibert,437535,652012,2022-12-02
CASH_OUT,228176,Richard Guibert,652012,423836,Agence_moov_Abomey,300000,71824,2022-12-07
CASH_IN,52576,Agence_moov_Cotonou,300000,247424,Richard Guibert,423836,476412,2022-12-07
CASH_OUT,410111,Richard Guibert,476412,66301,Agence_moov_Ouidah,300000,-110111,2022-12-07
CASH_IN,118775,Agence_moov_Cotonou,300000,181225,Richard Guibert,66301,185076,2022-12-11
TRANSFER,47987,Richard Guibert,185076,137089,Claudine Vallet,8090,-39897,2022-12-11
CASH_OUT,37985,Richard Guibert,137089,99104,Agence_moov_Cotonou,300000,262015,2022-12-12
CASH_OUT,17347,Richard Guibert,99104,81757,Agence_moov_Abomey,300000,282653,2022-12-13
CASH_OUT,74453,Richard Guibert,81757,7304,Agence_moov_Cotonou,300000,225547,2022-12-14
TRANSFER,384,Richard Guibert,7304,6920,Vincent-Grégoire Brunet,118138,117754,2022-12-18
CASH_OUT,6906,Richard Guibert,6920,14,Agence_moov_Ouidah,300000,293094,2022-12-18
CASH_IN,160707,Agence_moov_Cotonou,300000,139293,Richard Guibert,14,160721,2022-12-20
CASH_OUT,64968,Richard Guibert,160721,95753,Agence_moov_Ouidah,300000,235032,2022-12-21
TRANSFER,5344,Matthieu Carpentier,23779,18435,Richard Guibert,95753,101097,2022-12-23
TRANSFER,2027,Matthieu Carpentier,18435,16408,Richard Guibert,101097,103124,2022-12-23
TRANSFER,27527,Michèle Vallée,134671,107144,Richard Guibert,103124,130651,2022-12-25
CASH_OUT,116817,Richard Guibert,130651,13834,Agence_moov_Cotonou,300000,183183,2022-12-27
CASH_IN,286994,Agence_moov_Ouidah,300000,13006,Marie Da Silva,-325087,-38093,2022-12-02
CASH_IN,139192,Agence_moov_Cotonou,300000,160808,Marie Da Silva,-38093,101099,2022-12-07
CASH_OUT,54337,Marie Da Silva,101099,46762,Agence_moov_Cotonou,300000,245663,2022-12-09
CASH_OUT,16967,Marie Da Silva,46762,29795,Agence_moov_Cotonou,300000,283033,2022-12-22
CASH_OUT,4738,Marie Da Silva,29795,25057,Agence_moov_Cotonou,300000,295262,2022-12-23
CASH_IN,160011,Agence_moov_Cotonou,300000,139989,Marie Da Silva,25057,185068,2022-12-23
CASH_IN,203246,Agence_moov_Abomey,300000,96754,Marie Da Silva,185068,388314,2022-12-23
CASH_IN,168988,Agence_moov_Cotonou,300000,131012,Agnès Chrétien-Sanchez,-370857,-201869,2022-12-03
CASH_IN,71663,Agence_moov_Abomey,300000,228337,Agnès Chrétien-Sanchez,-201869,-130206,2022-12-06
CASH_IN,278595,Agence_moov_Abomey,300000,21405,Agnès Chrétien-Sanchez,-130206,148389,2022-12-09
TRANSFER,6417,Océane Boutin,293261,286844,Agnès Chrétien-Sanchez,148389,154806,2022-12-10
CASH_OUT,58899,Agnès Chrétien-Sanchez,154806,95907,Agence_moov_Abomey,300000,241101,2022-12-11
CASH_IN,64921,Agence_moov_Cotonou,300000,235079,Agnès Chrétien-Sanchez,95907,160828,2022-12-11
CASH_IN,131672,Agence_moov_Cotonou,300000,168328,Agnès Chrétien-Sanchez,160828,292500,2022-12-13
CASH_OUT,67110,Agnès Chrétien-Sanchez,292500,225390,Agence_moov_Ouidah,300000,232890,2022-12-20
CASH_OUT,38341,Agnès Chrétien-Sanchez,225390,187049,Agence_moov_Abomey,300000,261659,2022-12-21
CASH_OUT,169025,Agnès Chrétien-Sanchez,187049,18024,Agence_moov_Cotonou,300000,130975,2022-12-22
CASH_IN,54010,Agence_moov_Cotonou,300000,245990,Agnès Chrétien-Sanchez,18024,72034,2022-12-25
TRANSFER,67670,Vincent-Grégoire Brunet,117754,50084,Agnès Chrétien-Sanchez,72034,139704,2022-12-26
CASH_OUT,110298,Agnès Chrétien-Sanchez,139704,29406,Agence_moov_Cotonou,300000,189702,2022-12-27
CASH_IN,154094,Agence_moov_Abomey,300000,145906,Frédéric Moreau,-151100,2994,2022-12-02
CASH_IN,103187,Agence_moov_Abomey,300000,196813,Frédéric Moreau,2994,106181,2022-12-06
TRANSFER,1392,Matthieu Carpentier,16408,15016,Frédéric Moreau,106181,107573,2022-12-06
TRANSFER,1839,Diane-Françoise Raynaud,2429,590,Frédéric Moreau,107573,109412,2022-12-12
TRANSFER,19772,Frédéric Moreau,109412,89640,Michèle Vallée,107144,87372,2022-12-12
CASH_OUT,61803,Frédéric Moreau,89640,27837,Agence_moov_Cotonou,300000,238197,2022-12-19
CASH_OUT,23706,Frédéric Moreau,27837,4131,Agence_moov_Abomey,300000,276294,2022-12-21
CASH_OUT,2374,Frédéric Moreau,4131,1757,Agence_moov_Ouidah,300000,297626,2022-12-25
CASH_OUT,1337,Frédéric Moreau,1757,420,Agence_moov_Abomey,300000,298663,2022-12-26
CASH_IN,142270,Agence_moov_Ouidah,300000,157730,Augustin Benard,-704463,-562193,2022-12-01
CASH_IN,169675,Agence_moov_Abomey,300000,130325,Augustin Benard,-562193,-392518,2022-12-02
CASH_IN,124933,Agence_moov_Abomey,300000,175067,Augustin Benard,-392518,-267585,2022-12-02
CASH_IN,196226,Agence_moov_Ouidah,300000,103774,Augustin Benard,-267585,-71359,2022-12-04
CASH_IN,60946,Agence_moov_Abomey,300000,239054,Augustin Benard,-71359,-10413,2022-12-16
CASH_IN,167461,Agence_moov_Ouidah,300000,132539,Augustin Benard,-10413,157048,2022-12-21
CASH_IN,285470,Agence_moov_Ouidah,300000,14530,Augustin Benard,157048,442518,2022-12-26
CASH_IN,44155,Agence_moov_Abomey,300000,255845,Noël Hamel,-5582,38573,2022-12-07
CASH_OUT,32634,Noël Hamel,38573,5939,Agence_moov_Abomey,300000,267366,2022-12-09
CASH_OUT,942,Noël Hamel,5939,4997,Agence_moov_Ouidah,300000,299058,2022-12-13
CASH_IN,60594,Agence_moov_Ouidah,300000,239406,Noël Hamel,4997,65591,2022-12-14
TRANSFER,457867,Julie Robin de Gros,613745,155878,Noël Hamel,65591,523458,2022-12-16
CASH_OUT,404591,Noël Hamel,523458,118867,Agence_moov_Cotonou,300000,-104591,2022-12-17
TRANSFER,158654,Océane Boutin,286844,128190,Noël Hamel,118867,277521,2022-12-18
TRANSFER,27496,Maurice Seguin,831657,804161,Noël Hamel,277521,305017,2022-12-20
CASH_OUT,13361,Noël Hamel,305017,291656,Agence_moov_Abomey,300000,286639,2022-12-24
TRANSFER,155373,Julie Robin de Gros,155878,505,Noël Hamel,291656,447029,2022-12-27
CASH_OUT,630057,Maurice Seguin,804161,174104,Agence_moov_Abomey,300000,-330057,2022-12-01
CASH_OUT,95968,Maurice Seguin,174104,78136,Agence_moov_Abomey,300000,204032,2022-12-02
TRANSFER,32846,Maurice Seguin,78136,45290,Frédérique Robin,22952,-9894,2022-12-03
CASH_IN,237392,Agence_moov_Abomey,300000,62608,Maurice Seguin,45290,282682,2022-12-03
CASH_OUT,208600,Maurice Seguin,282682,74082,Agence_moov_Cotonou,300000,91400,2022-12-10
TRANSFER,185313,Sébastien Jourdan,287714,102401,Maurice Seguin,74082,259395,2022-12-16
CASH_IN,134523,Agence_moov_Ouidah,300000,165477,Maurice Seguin,259395,393918,2022-12-16
TRANSFER,602772,Roland Colin,954054,351282,Maurice Seguin,393918,996690,2022-12-18
CASH_OUT,762799,Maurice Seguin,996690,233891,Agence_moov_Cotonou,300000,-462799,2022-12-19
TRANSFER,14546,Théodore Bertin,525557,511011,Maurice Seguin,233891,248437,2022-12-21
CASH_IN,242302,Agence_moov_Ouidah,300000,57698,Amélie de la Picard,-260559,-18257,2022-12-05
CASH_IN,83529,Agence_moov_Ouidah,300000,216471,Amélie de la Picard,-18257,65272,2022-12-06
CASH_OUT,6539,Amélie de la Picard,65272,58733,Agence_moov_Ouidah,300000,293461,2022-12-09
CASH_OUT,14660,Amélie de la Picard,58733,44073,Agence_moov_Abomey,300000,285340,2022-12-09
CASH_IN,50905,Agence_moov_Ouidah,300000,249095,Amélie de la Picard,44073,94978,2022-12-10
TRANSFER,49364,Amélie de la Picard,94978,45614,Théodore Bertin,511011,461647,2022-12-15
CASH_OUT,14384,Amélie de la Picard,45614,31230,Agence_moov_Abomey,300000,285616,2022-12-15
TRANSFER,10122,Amélie de la Picard,31230,21108,Amélie de la Picard,31230,21108,2022-12-15
CASH_IN,291834,Agence_moov_Abomey,300000,8166,Amélie de la Picard,21108,312942,2022-12-16
CASH_OUT,17618,Amélie de la Picard,312942,295324,Agence_moov_Cotonou,300000,282382,2022-12-16
CASH_OUT,280530,Amélie de la Picard,295324,14794,Agence_moov_Abomey,300000,19470,2022-12-18
TRANSFER,3990,Amélie de la Picard,14794,10804,Sabine Imbert,478428,474438,2022-12-18
TRANSFER,8667,Amélie de la Picard,10804,2137,Sabine Imbert,474438,465771,2022-12-18
CASH_IN,92275,Agence_moov_Abomey,300000,207725,Amélie de la Picard,2137,94412,2022-12-21
CASH_IN,120869,Agence_moov_Cotonou,300000,179131,Amélie de la Picard,94412,215281,2022-12-27
CASH_IN,192427,Agence_moov_Ouidah,300000,107573,Marianne Descamps,-204268,-11841,2022-12-02
CASH_IN,239932,Agence_moov_Cotonou,300000,60068,Marianne Descamps,-11841,228091,2022-12-06
CASH_OUT,182187,Marianne Descamps,228091,45904,Agence_moov_Abomey,300000,117813,2022-12-10
TRANSFER,36081,Marianne Descamps,45904,9823,Marianne Descamps,45904,81985,2022-12-16
CASH_OUT,1324,Marianne Descamps,9823,8499,Agence_moov_Cotonou,300000,298676,2022-12-20
CASH_IN,14604,Agence_moov_Ouidah,300000,285396,Marianne Descamps,8499,23103,2022-12-20
CASH_OUT,12094,Marianne Descamps,23103,11009,Agence_moov_Cotonou,300000,287906,2022-12-26
CASH_OUT,7239,Marianne Descamps,11009,3770,Agence_moov_Ouidah,300000,292761,2022-12-27
CASH_IN,121702,Agence_moov_Cotonou,300000,178298,Marianne Descamps,3770,125472,2022-12-27
TRANSFER,59570,Michèle Vallée,87372,27802,Diane-Françoise Raynaud,590,60160,2022-12-07
CASH_OUT,5015,Diane-Françoise Raynaud,60160,55145,Agence_moov_Ouidah,300000,294985,2022-12-10
TRANSFER,9814,Diane-Françoise Raynaud,55145,45331,Michèle Vallée,27802,17988,2022-12-11
CASH_IN,116576,Agence_moov_Cotonou,300000,183424,Diane-Françoise Raynaud,45331,161907,2022-12-14
TRANSFER,70352,Théodore Bertin,461647,391295,Diane-Françoise Raynaud,161907,232259,2022-12-16
TRANSFER,172386,Diane-Françoise Raynaud,232259,59873,Sabine Imbert,465771,293385,2022-12-16
CASH_IN,58351,Agence_moov_Abomey,300000,241649,Diane-Françoise Raynaud,59873,118224,2022-12-18
CASH_OUT,112870,Diane-Françoise Raynaud,118224,5354,Agence_moov_Abomey,300000,187130,2022-12-18
CASH_IN,166515,Agence_moov_Ouidah,300000,133485,Diane-Françoise Raynaud,5354,171869,2022-12-19
CASH_OUT,141752,Diane-Françoise Raynaud,171869,30117,Agence_moov_Ouidah,300000,158248,2022-12-20
CASH_OUT,19062,Diane-Françoise Raynaud,30117,11055,Agence_moov_Abomey,300000,280938,2022-12-21
CASH_OUT,5319,Diane-Françoise Raynaud,11055,5736,Agence_moov_Cotonou,300000,294681,2022-12-23
TRANSFER,365,Julie Robin de Gros,505,140,Diane-Françoise Raynaud,5736,6101,2022-12-23
CASH_IN,145632,Agence_moov_Abomey,300000,154368,Alphonse Dupont-Petit,-10013,135619,2022-12-06
TRANSFER,177687,Maryse Lebreton,246771,69084,Alphonse Dupont-Petit,135619,313306,2022-12-06
CASH_IN,236578,Agence_moov_Abomey,300000,63422,Alphonse Dupont-Petit,313306,549884,2022-12-08
CASH_IN,222978,Agence_moov_Ouidah,300000,77022,Alphonse Dupont-Petit,549884,772862,2022-12-09
CASH_OUT,645406,Alphonse Dupont-Petit,772862,127456,Agence_moov_Cotonou,300000,-345406,2022-12-10
TRANSFER,135,Julie Robin de Gros,140,5,Alphonse Dupont-Petit,127456,127591,2022-12-15
CASH_IN,87424,Agence_moov_Ouidah,300000,212576,Alphonse Dupont-Petit,127591,215015,2022-12-16
TRANSFER,84864,Alphonse Dupont-Petit,215015,130151,Michèle Vallée,17988,-66876,2022-12-18
CASH_IN,53587,Agence_moov_Abomey,300000,246413,Alphonse Dupont-Petit,130151,183738,2022-12-19
TRANSFER,66205,Maryse Lebreton,69084,2879,Alphonse Dupont-Petit,183738,249943,2022-12-20
TRANSFER,213548,Alphonse Dupont-Petit,249943,36395,Maryse Lebreton,2879,-210669,2022-12-25
CASH_OUT,20457,Alphonse Dupont-Petit,36395,15938,Agence_moov_Abomey,300000,279543,2022-12-26
CASH_IN,177852,Agence_moov_Cotonou,300000,122148,Roland Colin,351282,529134,2022-12-01
CASH_IN,153008,Agence_moov_Ouidah,300000,146992,Roland Colin,529134,682142,2022-12-04
CASH_OUT,634067,Roland Colin,682142,48075,Agence_moov_Cotonou,300000,-334067,2022-12-06
CASH_OUT,25341,Roland Colin,48075,22734,Agence_moov_Ouidah,300000,274659,2022-12-07
CASH_IN,58900,Agence_moov_Abomey,300000,241100,Roland Colin,22734,81634,2022-12-07
CASH_OUT,18764,Roland Colin,81634,62870,Agence_moov_Abomey,300000,281236,2022-12-13
CASH_OUT,47343,Roland Colin,62870,15527,Agence_moov_Cotonou,300000,252657,2022-12-17
CASH_IN,182158,Agence_moov_Ouidah,300000,117842,Roland Colin,15527,197685,2022-12-17
TRANSFER,42880,Roland Colin,197685,154805,David Diallo,75073,32193,2022-12-17
CASH_OUT,142193,Roland Colin,154805,12612,Agence_moov_Cotonou,300000,157807,2022-12-19
CASH_OUT,1815,Roland Colin,12612,10797,Agence_moov_Ouidah,300000,298185,2022-12-20
TRANSFER,8815,Roland Colin,10797,1982,Roland Colin,10797,1982,2022-12-23
TRANSFER,407,Roland Colin,1982,1575,Théodore Bertin,391295,390888,2022-12-26
CASH_IN,155316,Agence_moov_Abomey,300000,144684,Roland Colin,1575,156891,2022-12-27
TRANSFER,51825,Roland Colin,156891,105066,David Diallo,32193,-19632,2022-12-27
CASH_IN,42872,Agence_moov_Abomey,300000,257128,Alfred Chrétien,-54178,-11306,2022-12-04
CASH_IN,39733,Agence_moov_Abomey,300000,260267,Alfred Chrétien,-11306,28427,2022-12-04
CASH_IN,5724,Agence_moov_Abomey,300000,294276,Alfred Chrétien,28427,34151,2022-12-06
CASH_OUT,23723,Alfred Chrétien,34151,10428,Agence_moov_Abomey,300000,276277,2022-12-06
CASH_IN,279538,Agence_moov_Ouidah,300000,20462,Alfred Chrétien,10428,289966,2022-12-06
CASH_OUT,261665,Alfred Chrétien,289966,28301,Agence_moov_Cotonou,300000,38335,2022-12-08
CASH_OUT,13100,Alfred Chrétien,28301,15201,Agence_moov_Ouidah,300000,286900,2022-12-12
CASH_IN,184122,Agence_moov_Abomey,300000,115878,Alfred Chrétien,15201,199323,2022-12-15
CASH_IN,221921,Agence_moov_Ouidah,300000,78079,Alfred Chrétien,199323,421244,2022-12-16
TRANSFER,56970,Alfred Chrétien,421244,364274,Sabine Imbert,293385,236415,2022-12-18
TRANSFER,125157,Alfred Chrétien,364274,239117,Alfred Chrétien,364274,489431,2022-12-18
TRANSFER,165319,Alfred Chrétien,239117,73798,Océane Boutin,128190,-37129,2022-12-19
CASH_IN,223113,Agence_moov_Cotonou,300000,76887,Alfred Chrétien,73798,296911,2022-12-23
CASH_IN,116339,Agence_moov_Cotonou,300000,183661,Alfred Chrétien,296911,413250,2022-12-23
CASH_IN,222586,Agence_moov_Cotonou,300000,77414,Alfred Chrétien,413250,635836,2022-12-24
CASH_OUT,327030,Alfred Chrétien,635836,308806,Agence_moov_Abomey,300000,-27030,2022-12-27
CASH_IN,59867,Agence_moov_Cotonou,300000,240133,Gabriel de Pineau,-128639,-68772,2022-12-02
CASH_IN,259521,Agence_moov_Ouidah,300000,40479,Gabriel de Pineau,-68772,190749,2022-12-03
TRANSFER,235059,Sabine Imbert,236415,1356,Gabriel de Pineau,190749,425808,2022-12-03
TRANSFER,33683,Vincent-Grégoire Brunet,50084,16401,Gabriel de Pineau,425808,459491,2022-12-08
TRANSFER,371850,Gabriel de Pineau,459491,87641,Gabriel de Pineau,459491,87641,2022-12-12
TRANSFER,9995,Gabriel de Pineau,87641,77646,Sabine Imbert,1356,-8639,2022-12-13
CASH_OUT,20911,Gabriel de Pineau,77646,56735,Agence_moov_Cotonou,300000,279089,2022-12-16
CASH_IN,99156,Agence_moov_Cotonou,300000,200844,Gabriel de Pineau,56735,155891,2022-12-16
CASH_IN,30274,Agence_moov_Abomey,300000,269726,Gabriel de Pineau,155891,186165,2022-12-22
CASH_IN,111471,Agence_moov_Cotonou,300000,188529,Sabine Imbert,-8639,102832,2022-12-02
CASH_IN,152643,Agence_moov_Cotonou,300000,147357,Sabine Imbert,102832,255475,2022-12-03
CASH_OUT,131084,Sabine Imbert,255475,124391,Agence_moov_Cotonou,300000,168916,2022-12-06
CASH_OUT,121027,Sabine Imbert,124391,3364,Agence_moov_Abomey,300000,178973,2022-12-07
TRANSFER,2106,Sabine Imbert,3364,1258,Vincent-Grégoire Brunet,16401,14295,2022-12-09
TRANSFER,228,Sabine Imbert,1258,1030,Vincent-Grégoire Brunet,14295,14067,2022-12-12
TRANSFER,8388,Vincent-Grégoire Brunet,14067,5679,Sabine Imbert,1030,9418,2022-12-12
CASH_IN,67146,Agence_moov_Abomey,300000,232854,Sabine Imbert,9418,76564,2022-12-13
CASH_OUT,73949,Sabine Imbert,76564,2615,Agence_moov_Ouidah,300000,226051,2022-12-14
CASH_IN,148227,Agence_moov_Ouidah,300000,151773,Sabine Imbert,2615,150842,2022-12-15
CASH_OUT,127477,Sabine Imbert,150842,23365,Agence_moov_Cotonou,300000,172523,2022-12-17
TRANSFER,236937,Théodore Bertin,390888,153951,Sabine Imbert,23365,260302,2022-12-18
TRANSFER,5479,Sabine Imbert,260302,254823,Vincent-Grégoire Brunet,5679,200,2022-12-18
TRANSFER,86172,Théodore Bertin,153951,67779,Sabine Imbert,254823,340995,2022-12-20
CASH_IN,118210,Agence_moov_Abomey,300000,181790,Sabine Imbert,340995,459205,2022-12-21
CASH_IN,277784,Agence_moov_Ouidah,300000,22216,Sabine Imbert,459205,736989,2022-12-23
TRANSFER,8322,Théodore Bertin,67779,59457,Sabine Imbert,736989,745311,2022-12-25
TRANSFER,183,Vincent-Grégoire Brunet,200,17,Sabine Imbert,745311,745494,2022-12-25
CASH_OUT,305042,Sabine Imbert,745494,440452,Agence_moov_Ouidah,300000,-5042,2022-12-26
CASH_IN,68344,Agence_moov_Abomey,300000,231656,Sabine Imbert,440452,508796,2022-12-27
CASH_IN,71804,Agence_moov_Cotonou,300000,228196,Michèle Vallée,-66876,4928,2022-12-02
CASH_OUT,2551,Michèle Vallée,4928,2377,Agence_moov_Cotonou,300000,297449,2022-12-04
CASH_OUT,1162,Michèle Vallée,2377,1215,Agence_moov_Ouidah,300000,298838,2022-12-06
TRANSFER,18676,Théodore Bertin,59457,40781,Michèle Vallée,1215,19891,2022-12-06
CASH_OUT,17631,Michèle Vallée,19891,2260,Agence_moov_Cotonou,300000,282369,2022-12-06
CASH_OUT,225,Michèle Vallée,2260,2035,Agence_moov_Abomey,300000,299775,2022-12-15
CASH_OUT,759,Michèle Vallée,2035,1276,Agence_moov_Cotonou,300000,299241,2022-12-16
CASH_IN,175586,Agence_moov_Cotonou,300000,124414,Caroline Peltier,-227872,-52286,2022-12-01
CASH_IN,212813,Agence_moov_Abomey,300000,87187,Caroline Peltier,-52286,160527,2022-12-02
CASH_OUT,33380,Caroline Peltier,160527,127147,Agence_moov_Abomey,300000,266620,2022-12-03
CASH_OUT,19658,Caroline Peltier,127147,107489,Agence_moov_Cotonou,300000,280342,2022-12-05
CASH_OUT,12090,Caroline Peltier,107489,95399,Agence_moov_Ouidah,300000,287910,2022-12-11
TRANSFER,23171,Théodore Bertin,40781,17610,Caroline Peltier,95399,118570,2022-12-12
TRANSFER,866,Théodore Bertin,17610,16744,Caroline Peltier,118570,119436,2022-12-17
TRANSFER,5827,Théodore Bertin,16744,10917,Caroline Peltier,119436,125263,2022-12-19
CASH_IN,2477,Agence_moov_Abomey,300000,297523,Caroline Peltier,125263,127740,2022-12-23
TRANSFER,112345,Caroline Peltier,127740,15395,Théodore Bertin,10917,-101428,2022-12-25
CASH_IN,288595,Agence_moov_Cotonou,300000,11405,Noémi de la Didier,-1049013,-760418,2022-12-04
CASH_IN,15985,Agence_moov_Abomey,300000,284015,Noémi de la Didier,-760418,-744433,2022-12-04
CASH_IN,173799,Agence_moov_Ouidah,300000,126201,Noémi de la Didier,-744433,-570634,2022-12-05
CASH_IN,47285,Agence_moov_Abomey,300000,252715,Noémi de la Didier,-570634,-523349,2022-12-07
CASH_IN,166369,Agence_moov_Ouidah,300000,133631,Noémi de la Didier,-523349,-356980,2022-12-19
CASH_IN,148925,Agence_moov_Abomey,300000,151075,Noémi de la Didier,-356980,-208055,2022-12-23
CASH_IN,224744,Agence_moov_Abomey,300000,75256,Noémi de la Didier,-208055,16689,2022-12-24
CASH_IN,84848,Agence_moov_Abomey,300000,215152,Noémi de la Didier,16689,101537,2022-12-24
CASH_OUT,37473,Noémi de la Didier,101537,64064,Agence_moov_Abomey,300000,262527,2022-12-25
CASH_IN,23119,Agence_moov_Ouidah,300000,276881,Margot Renaud de Lacombe,-560683,-537564,2022-12-05
CASH_IN,170781,Agence_moov_Cotonou,300000,129219,Margot Renaud de Lacombe,-537564,-366783,2022-12-06
CASH_IN,228530,Agence_moov_Abomey,300000,71470,Margot Renaud de Lacombe,-366783,-138253,2022-12-10
CASH_IN,224798,Agence_moov_Cotonou,300000,75202,Margot Renaud de Lacombe,-138253,86545,2022-12-11
TRANSFER,20670,Margot Renaud de Lacombe,86545,65875,Margot Renaud de Lacombe,86545,65875,2022-12-12
CASH_OUT,7889,Margot Renaud de Lacombe,65875,57986,Agence_moov_Ouidah,300000,292111,2022-12-19
CASH_OUT,11971,Margot Renaud de Lacombe,57986,46015,Agence_moov_Cotonou,300000,288029,2022-12-20
CASH_OUT,8227,Margot Renaud de Lacombe,46015,37788,Agence_moov_Cotonou,300000,291773,2022-12-20
CASH_IN,124974,Agence_moov_Cotonou,300000,175026,Margot Renaud de Lacombe,37788,162762,2022-12-21
CASH_OUT,41995,Margot Renaud de Lacombe,162762,120767,Agence_moov_Abomey,300000,258005,2022-12-22
CASH_IN,74389,Agence_moov_Ouidah,300000,225611,Margot Renaud de Lacombe,120767,195156,2022-12-24
CASH_OUT,63122,Margot Renaud de Lacombe,195156,132034,Agence_moov_Abomey,300000,236878,2022-12-24
CASH_IN,225520,Agence_moov_Ouidah,300000,74480,Claudine Vallet,-39897,185623,2022-12-02
CASH_IN,139097,Agence_moov_Cotonou,300000,160903,Claudine Vallet,185623,324720,2022-12-03
CASH_OUT,117187,Claudine Vallet,324720,207533,Agence_moov_Abomey,300000,182813,2022-12-04
CASH_OUT,178104,Claudine Vallet,207533,29429,Agence_moov_Ouidah,300000,121896,2022-12-06
CASH_OUT,12583,Claudine Vallet,29429,16846,Agence_moov_Ouidah,300000,287417,2022-12-12
TRANSFER,2381,Claudine Vallet,16846,14465,Claudine Vallet,16846,19227,2022-12-13
CASH_OUT,1355,Claudine Vallet,14465,13110,Agence_moov_Ouidah,300000,298645,2022-12-14
CASH_IN,256744,Agence_moov_Abomey,300000,43256,Claudine Vallet,13110,269854,2022-12-16
CASH_IN,179844,Agence_moov_Cotonou,300000,120156,Claudine Vallet,269854,449698,2022-12-18
CASH_IN,220318,Agence_moov_Abomey,300000,79682,Claudine Vallet,449698,670016,2022-12-19
TRANSFER,478910,Claudine Vallet,670016,191106,Claudine Vallet,670016,1148926,2022-12-22
CASH_IN,117691,Agence_moov_Ouidah,300000,182309,Claudine Vallet,191106,308797,2022-12-22
CASH_IN,144511,Agence_moov_Abomey,300000,155489,Claudine Vallet,308797,453308,2022-12-25
CASH_IN,205633,Agence_moov_Abomey,300000,94367,Stéphane-Timothée Pineau,-249831,-44198,2022-12-04
CASH_IN,168181,Agence_moov_Cotonou,300000,131819,Stéphane-Timothée Pineau,-44198,123983,2022-12-04
CASH_OUT,30214,Stéphane-Timothée Pineau,123983,93769,Agence_moov_Abomey,300000,269786,2022-12-09
TRANSFER,19404,Stéphane-Timothée Pineau,93769,74365,Stéphane-Timothée Pineau,93769,113173,2022-12-09
CASH_OUT,38219,Stéphane-Timothée Pineau,74365,36146,Agence_moov_Abomey,300000,261781,2022-12-10
CASH_OUT,28338,Stéphane-Timothée Pineau,36146,7808,Agence_moov_Abomey,300000,271662,2022-12-11
CASH_IN,136582,Agence_moov_Ouidah,300000,163418,Stéphane-Timothée Pineau,7808,144390,2022-12-11
CASH_OUT,91915,Stéphane-Timothée Pineau,144390,52475,Agence_moov_Abomey,300000,208085,2022-12-12
CASH_OUT,12687,Stéphane-Timothée Pineau,52475,39788,Agence_moov_Abomey,300000,287313,2022-12-13
CASH_OUT,30260,Stéphane-Timothée Pineau,39788,9528,Agence_moov_Ouidah,300000,269740,2022-12-13
TRANSFER,3046,Stéphane-Timothée Pineau,9528,6482,Stéphane-Timothée Pineau,9528,12574,2022-12-14
CASH_IN,55101,Agence_moov_Ouidah,300000,244899,Stéphane-Timothée Pineau,6482,61583,2022-12-19
CASH_IN,44417,Agence_moov_Abomey,300000,255583,Stéphane-Timothée Pineau,61583,106000,2022-12-21
CASH_OUT,53557,Stéphane-Timothée Pineau,106000,52443,Agence_moov_Cotonou,300000,246443,2022-12-22
CASH_IN,89223,Agence_moov_Ouidah,300000,210777,Stéphane-Timothée Pineau,52443,141666,2022-12-23
CASH_IN,266568,Agence_moov_Ouidah,300000,33432,Antoine Bourdon de Auger,-233003,33565,2022-12-02
CASH_OUT,13256,Antoine Bourdon de Auger,33565,20309,Agence_moov_Cotonou,300000,286744,2022-12-02
TRANSFER,11997,Antoine Bourdon de Auger,20309,8312,Antoine Bourdon de Auger,20309,32306,2022-12-05
CASH_IN,162819,Agence_moov_Cotonou,300000,137181,Antoine Bourdon de Auger,8312,171131,2022-12-09
CASH_IN,258,Agence_moov_Ouidah,300000,299742,Antoine Bourdon de Auger,171131,171389,2022-12-10
CASH_IN,235856,Agence_moov_Cotonou,300000,64144,Antoine Bourdon de Auger,171389,407245,2022-12-12
CASH_IN,93332,Agence_moov_Abomey,300000,206668,Antoine Bourdon de Auger,407245,500577,2022-12-12
CASH_IN,63558,Agence_moov_Ouidah,300000,236442,Antoine Bourdon de Auger,500577,564135,2022-12-17
CASH_OUT,138077,Antoine Bourdon de Auger,564135,426058,Agence_moov_Cotonou,300000,161923,2022-12-17
CASH_IN,299624,Agence_moov_Ouidah,300000,376,Antoine Bourdon de Auger,426058,725682,2022-12-20
CASH_OUT,315007,Antoine Bourdon de Auger,725682,410675,Agence_moov_Cotonou,300000,-15007,2022-12-21
CASH_OUT,295473,Antoine Bourdon de Auger,410675,115202,Agence_moov_Cotonou,300000,4527,2022-12-22
CASH_OUT,69548,Antoine Bourdon de Auger,115202,45654,Agence_moov_Cotonou,300000,230452,2022-12-27
CASH_IN,1846,Agence_moov_Cotonou,300000,298154,Théodore Bertin,-101428,-99582,2022-12-06
CASH_IN,48382,Agence_moov_Cotonou,300000,251618,Théodore Bertin,-99582,-51200,2022-12-06
CASH_IN,245190,Agence_moov_Cotonou,300000,54810,Théodore Bertin,-51200,193990,2022-12-08
CASH_IN,153741,Agence_moov_Cotonou,300000,146259,Théodore Bertin,193990,347731,2022-12-12
CASH_OUT,61911,Théodore Bertin,347731,285820,Agence_moov_Abomey,300000,238089,2022-12-13
CASH_OUT,12967,Théodore Bertin,285820,272853,Agence_moov_Cotonou,300000,287033,2022-12-15
CASH_OUT,70580,Théodore Bertin,272853,202273,Agence_moov_Abomey,300000,229420,2022-12-16
CASH_OUT,79711,Théodore Bertin,202273,122562,Agence_moov_Ouidah,300000,220289,2022-12-19
CASH_OUT,12887,Théodore Bertin,122562,109675,Agence_moov_Abomey,300000,287113,2022-12-26
CASH_IN,217982,Agence_moov_Ouidah,300000,82018,Lucy Vaillant,-192396,25586,2022-12-01
CASH_IN,59952,Agence_moov_Ouidah,300000,240048,Lucy Vaillant,25586,85538,2022-12-01
CASH_OUT,15500,Lucy Vaillant,85538,70038,Agence_moov_Cotonou,300000,284500,2022-12-07
CASH_OUT,62652,Lucy Vaillant,70038,7386,Agence_moov_Cotonou,300000,237348,2022-12-18
CASH_IN,236121,Agence_moov_Ouidah,300000,63879,Lucy Vaillant,7386,243507,2022-12-24
CASH_IN,15742,Agence_moov_Abomey,300000,284258,Marthe Pichon,-628136,-612394,2022-12-05
CASH_IN,100244,Agence_moov_Ouidah,300000,199756,Marthe Pichon,-612394,-512150,2022-12-09
CASH_IN,222289,Agence_moov_Ouidah,300000,77711,Marthe Pichon,-512150,-289861,2022-12-09
CASH_IN,31220,Agence_moov_Abomey,300000,268780,Marthe Pichon,-289861,-258641,2022-12-10
CASH_IN,136220,Agence_moov_Abomey,300000,163780,Marthe Pichon,-258641,-122421,2022-12-18
CASH_IN,122365,Agence_moov_Ouidah,300000,177635,Marthe Pichon,-122421,-56,2022-12-19
CASH_IN,62131,Agence_moov_Cotonou,300000,237869,Marthe Pichon,-56,62075,2022-12-24
CASH_IN,7054,Agence_moov_Ouidah,300000,292946,Marthe Pichon,62075,69129,2022-12-24
CASH_IN,145974,Agence_moov_Ouidah,300000,154026,Marthe Pichon,69129,215103,2022-12-25
CASH_IN,176947,Agence_moov_Cotonou,300000,123053,Frédérique Robin,-9894,167053,2022-12-02
TRANSFER,114246,Frédérique Robin,167053,52807,Frédérique Robin,167053,52807,2022-12-04
TRANSFER,39802,Frédérique Robin,52807,13005,Frédérique Robin,52807,13005,2022-12-08
CASH_OUT,10073,Frédérique Robin,13005,2932,Agence_moov_Ouidah,300000,289927,2022-12-09
CASH_IN,221235,Agence_moov_Ouidah,300000,78765,Frédérique Robin,2932,224167,2022-12-11
CASH_IN,85716,Agence_moov_Cotonou,300000,214284,Frédérique Robin,224167,309883,2022-12-12
CASH_OUT,166412,Frédérique Robin,309883,143471,Agence_moov_Ouidah,300000,133588,2022-12-15
CASH_OUT,137532,Frédérique Robin,143471,5939,Agence_moov_Cotonou,300000,162468,2022-12-19
CASH_IN,139627,Agence_moov_Abomey,300000,160373,Frédérique Robin,5939,145566,2022-12-22
CASH_IN,88296,Agence_moov_Abomey,300000,211704,Laurent Besson,-468271,-379975,2022-12-01
CASH_IN,102144,Agence_moov_Abomey,300000,197856,Laurent Besson,-379975,-277831,2022-12-03
CASH_IN,258247,Agence_moov_Ouidah,300000,41753,Laurent Besson,-277831,-19584,2022-12-08
CASH_IN,125837,Agence_moov_Cotonou,300000,174163,Laurent Besson,-19584,106253,2022-12-12
TRANSFER,10210,Laurent Besson,106253,96043,Laurent Besson,106253,116463,2022-12-14
CASH_IN,49275,Agence_moov_Cotonou,300000,250725,Laurent Besson,96043,145318,2022-12-15
CASH_OUT,77868,Laurent Besson,145318,67450,Agence_moov_Ouidah,300000,222132,2022-12-18
TRANSFER,18174,Laurent Besson,67450,49276,Laurent Besson,67450,49276,2022-12-19
CASH_IN,89751,Agence_moov_Ouidah,300000,210249,Laurent Besson,49276,139027,2022-12-20
CASH_OUT,124063,Laurent Besson,139027,14964,Agence_moov_Ouidah,300000,175937,2022-12-20
CASH_IN,78329,Agence_moov_Ouidah,300000,221671,Laurent Besson,14964,93293,2022-12-21
CASH_IN,178153,Agence_moov_Abomey,300000,121847,Laurent Besson,93293,271446,2022-12-21
CASH_IN,19324,Agence_moov_Ouidah,300000,280676,Laurent Besson,271446,290770,2022-12-25
CASH_OUT,162929,Laurent Besson,290770,127841,Agence_moov_Ouidah,300000,137071,2022-12-27
CASH_IN,259586,Agence_moov_Abomey,300000,40414,Océane Boutin,-37129,222457,2022-12-05
CASH_IN,290166,Agence_moov_Cotonou,300000,9834,Océane Boutin,222457,512623,2022-12-07
TRANSFER,229038,Océane Boutin,512623,283585,Océane Boutin,512623,283585,2022-12-11
CASH_OUT,230807,Océane Boutin,283585,52778,Agence_moov_Abomey,300000,69193,2022-12-14
CASH_IN,266817,Agence_moov_Ouidah,300000,33183,Océane Boutin,52778,319595,2022-12-18
CASH_IN,186904,Agence_moov_Cotonou,300000,113096,Océane Boutin,319595,506499,2022-12-19
CASH_IN,128571,Agence_moov_Ouidah,300000,171429,Benoît Verdier,-383566,-254995,2022-12-02
CASH_IN,82225,Agence_moov_Abomey,300000,217775,Benoît Verdier,-254995,-172770,2022-12-04
CASH_IN,13538,Agence_moov_Cotonou,300000,286462,Benoît Verdier,-172770,-159232,2022-12-08
CASH_IN,207543,Agence_moov_Cotonou,300000,92457,Benoît Verdier,-159232,48311,2022-12-11
TRANSFER,18044,Benoît Verdier,48311,30267,Benoît Verdier,48311,30267,2022-12-13
CASH_OUT,14972,Benoît Verdier,30267,15295,Agence_moov_Abomey,300000,285028,2022-12-18
CASH_IN,103587,Agence_moov_Ouidah,300000,196413,David Diallo,-19632,83955,2022-12-02
CASH_OUT,78115,David Diallo,83955,5840,Agence_moov_Cotonou,300000,221885,2022-12-06
CASH_IN,114866,Agence_moov_Ouidah,300000,185134,David Diallo,5840,120706,2022-12-08
CASH_OUT,36133,David Diallo,120706,84573,Agence_moov_Abomey,300000,263867,2022-12-11
CASH_OUT,28108,David Diallo,84573,56465,Agence_moov_Cotonou,300000,271892,2022-12-14
CASH_IN,239539,Agence_moov_Cotonou,300000,60461,David Diallo,56465,296004,2022-12-18
CASH_IN,199654,Agence_moov_Abomey,300000,100346,Caroline Bonneau,-100682,98972,2022-12-01
TRANSFER,7205,Caroline Bonneau,98972,91767,Caroline Bonneau,98972,106177,2022-12-02
TRANSFER,42297,Caroline Bonneau,91767,49470,Caroline Bonneau,91767,49470,2022-12-02
TRANSFER,7629,Caroline Bonneau,49470,41841,Caroline Bonneau,49470,57099,2022-12-03
CASH_OUT,9432,Caroline Bonneau,41841,32409,Agence_moov_Abomey,300000,290568,2022-12-04
CASH_OUT,7308,Caroline Bonneau,32409,25101,Agence_moov_Abomey,300000,292692,2022-12-06
CASH_OUT,4873,Caroline Bonneau,25101,20228,Agence_moov_Cotonou,300000,295127,2022-12-06
TRANSFER,12406,Caroline Bonneau,20228,7822,Caroline Bonneau,20228,7822,2022-12-06
TRANSFER,1154,Caroline Bonneau,7822,6668,Caroline Bonneau,7822,8976,2022-12-07
CASH_IN,178491,Agence_moov_Abomey,300000,121509,Caroline Bonneau,6668,185159,2022-12-08
CASH_OUT,178919,Caroline Bonneau,185159,6240,Agence_moov_Ouidah,300000,121081,2022-12-12
CASH_OUT,2315,Caroline Bonneau,6240,3925,Agence_moov_Abomey,300000,297685,2022-12-15
CASH_IN,18153,Agence_moov_Cotonou,300000,281847,Caroline Bonneau,3925,22078,2022-12-22
CASH_IN,290349,Agence_moov_Cotonou,300000,9651,Caroline Bonneau,22078,312427,2022-12-25
CASH_OUT,164242,Caroline Bonneau,312427,148185,Agence_moov_Cotonou,300000,135758,2022-12-26
CASH_IN,184744,Agence_moov_Ouidah,300000,115256,Maryse Lebreton,-210669,-25925,2022-12-05
CASH_IN,105965,Agence_moov_Abomey,300000,194035,Maryse Lebreton,-25925,80040,2022-12-06
CASH_IN,98596,Agence_moov_Abomey,300000,201404,Maryse Lebreton,80040,178636,2022-12-07
CASH_IN,229513,Agence_moov_Cotonou,300000,70487,Maryse Lebreton,178636,408149,2022-12-09
CASH_OUT,123367,Maryse Lebreton,408149,284782,Agence_moov_Abomey,300000,176633,2022-12-10
CASH_IN,94898,Agence_moov_Abomey,300000,205102,Maryse Lebreton,284782,379680,2022-12-21
CASH_IN,255809,Agence_moov_Cotonou,300000,44191,Maryse Lebreton,379680,635489,2022-12-22
CASH_IN,224738,Agence_moov_Abomey,300000,75262,Maryse Lebreton,635489,860227,2022-12-27
CASH_IN,241618,Agence_moov_Ouidah,300000,58382,Auguste Bousquet,-36596,205022,2022-12-01
CASH_OUT,69087,Auguste Bousquet,205022,135935,Agence_moov_Ouidah,300000,230913,2022-12-03
CASH_IN,44767,Agence_moov_Ouidah,300000,255233,Auguste Bousquet,135935,180702,2022-12-04
TRANSFER,37309,Auguste Bousquet,180702,143393,Auguste Bousquet,180702,143393,2022-12-04
TRANSFER,24786,Auguste Bousquet,143393,118607,Auguste Bousquet,143393,168179,2022-12-04
CASH_OUT,32366,Auguste Bousquet,118607,86241,Agence_moov_Ouidah,300000,267634,2022-12-06
CASH_OUT,81734,Auguste Bousquet,86241,4507,Agence_moov_Ouidah,300000,218266,2022-12-07
CASH_OUT,3749,Auguste Bousquet,4507,758,Agence_moov_Cotonou,300000,296251,2022-12-09
CASH_IN,168716,Agence_moov_Ouidah,300000,131284,Auguste Bousquet,758,169474,2022-12-09
TRANSFER,5565,Auguste Bousquet,169474,163909,Auguste Bousquet,169474,163909,2022-12-10
CASH_IN,152630,Agence_moov_Cotonou,300000,147370,Auguste Bousquet,163909,316539,2022-12-13
CASH_OUT,258207,Auguste Bousquet,316539,58332,Agence_moov_Ouidah,300000,41793,2022-12-20
CASH_IN,290221,Agence_moov_Cotonou,300000,9779,Auguste Bousquet,58332,348553,2022-12-22
CASH_IN,254268,Agence_moov_Ouidah,300000,45732,Auguste Bousquet,348553,602821,2022-12-26
CASH_OUT,237563,Auguste Bousquet,602821,365258,Agence_moov_Ouidah,300000,62437,2022-12-27
CASH_IN,3880,Agence_moov_Cotonou,300000,296120,Matthieu Renard,-9313,-5433,2022-12-04
CASH_IN,109324,Agence_moov_Ouidah,300000,190676,Matthieu Renard,-5433,103891,2022-12-04
TRANSFER,28105,Matthieu Renard,103891,75786,Matthieu Renard,103891,75786,2022-12-06
TRANSFER,43297,Matthieu Renard,75786,32489,Matthieu Renard,75786,32489,2022-12-06
CASH_OUT,14288,Matthieu Renard,32489,18201,Agence_moov_Ouidah,300000,285712,2022-12-07
CASH_IN,60133,Agence_moov_Cotonou,300000,239867,Matthieu Renard,18201,78334,2022-12-07
CASH_OUT,19669,Matthieu Renard,78334,58665,Agence_moov_Ouidah,300000,280331,2022-12-07
TRANSFER,21182,Matthieu Renard,58665,37483,Matthieu Renard,58665,79847,2022-12-07
CASH_IN,187198,Agence_moov_Abomey,300000,112802,Matthieu Renard,37483,224681,2022-12-10
CASH_OUT,160062,Matthieu Renard,224681,64619,Agence_moov_Ouidah,300000,139938,2022-12-11
CASH_IN,183968,Agence_moov_Ouidah,300000,116032,Matthieu Renard,64619,248587,2022-12-13
CASH_IN,31252,Agence_moov_Ouidah,300000,268748,Matthieu Renard,248587,279839,2022-12-13
CASH_OUT,99025,Matthieu Renard,279839,180814,Agence_moov_Ouidah,300000,200975,2022-12-14
CASH_IN,24520,Agence_moov_Ouidah,300000,275480,Matthieu Renard,180814,205334,2022-12-15
CASH_OUT,65256,Matthieu Renard,205334,140078,Agence_moov_Ouidah,300000,234744,2022-12-22
CASH_OUT,43002,Matthieu Renard,140078,97076,Agence_moov_Abomey,300000,256998,2022-12-24
CASH_OUT,13536,Matthieu Renard,97076,83540,Agence_moov_Ouidah,300000,286464,2022-12-24
CASH_OUT,40993,Matthieu Renard,83540,42547,Agence_moov_Cotonou,300000,259007,2022-12-25
CASH_IN,292402,Agence_moov_Cotonou,300000,7598,Julie Robin de Gros,5,292407,2022-12-02
TRANSFER,187402,Julie Robin de Gros,292407,105005,Julie Robin de Gros,292407,105005,2022-12-03
CASH_OUT,7746,Julie Robin de Gros,105005,97259,Agence_moov_Ouidah,300000,292254,2022-12-04
CASH_OUT,66222,Julie Robin de Gros,97259,31037,Agence_moov_Cotonou,300000,233778,2022-12-04
CASH_OUT,22040,Julie Robin de Gros,31037,8997,Agence_moov_Ouidah,300000,277960,2022-12-05
CASH_OUT,6606,Julie Robin de Gros,8997,2391,Agence_moov_Cotonou,300000,293394,2022-12-11
CASH_OUT,102,Julie Robin de Gros,2391,2289,Agence_moov_Cotonou,300000,299898,2022-12-23
CASH_IN,220537,Agence_moov_Cotonou,300000,79463,Vincent-Grégoire Brunet,17,220554,2022-12-01
CASH_IN,14191,Agence_moov_Abomey,300000,285809,Vincent-Grégoire Brunet,220554,234745,2022-12-08
CASH_IN,125044,Agence_moov_Abomey,300000,174956,Vincent-Grégoire Brunet,234745,359789,2022-12-08
CASH_OUT,221880,Vincent-Grégoire Brunet,359789,137909,Agence_moov_Abomey,300000,78120,2022-12-08
CASH_OUT,114418,Vincent-Grégoire Brunet,137909,23491,Agence_moov_Cotonou,300000,185582,2022-12-09
CASH_OUT,22282,Vincent-Grégoire Brunet,23491,1209,Agence_moov_Cotonou,300000,277718,2022-12-10
CASH_OUT,308,Vincent-Grégoire Brunet,1209,901,Agence_moov_Abomey,300000,299692,2022-12-13
CASH_IN,4255,Agence_moov_Cotonou,300000,295745,Vincent-Grégoire Brunet,901,5156,2022-12-17
CASH_IN,225864,Agence_moov_Cotonou,300000,74136,Vincent-Grégoire Brunet,5156,231020,2022-12-19
CASH_IN,30295,Agence_moov_Ouidah,300000,269705,Vincent-Grégoire Brunet,231020,261315,2022-12-24
CASH_OUT,67278,Vincent-Grégoire Brunet,261315,194037,Agence_moov_Cotonou,300000,232722,2022-12-24
CASH_OUT,28761,Vincent-Grégoire Brunet,194037,165276,Agence_moov_Cotonou,300000,271239,2022-12-27
CASH_IN,10909,Agence_moov_Cotonou,300000,289091,Valentine Traore,-65249,-54340,2022-12-01
CASH_IN,62896,Agence_moov_Abomey,300000,237104,Valentine Traore,-54340,8556,2022-12-01
CASH_OUT,1017,Valentine Traore,8556,7539,Agence_moov_Abomey,300000,298983,2022-12-02
CASH_OUT,408,Valentine Traore,7539,7131,Agence_moov_Abomey,300000,299592,2022-12-07
CASH_OUT,949,Valentine Traore,7131,6182,Agence_moov_Cotonou,300000,299051,2022-12-08
CASH_OUT,1754,Valentine Traore,6182,4428,Agence_moov_Abomey,300000,298246,2022-12-09
TRANSFER,3474,Valentine Traore,4428,954,Valentine Traore,4428,7902,2022-12-15
CASH_OUT,559,Valentine Traore,954,395,Agence_moov_Ouidah,300000,299441,2022-12-21
CASH_IN,131285,Agence_moov_Cotonou,300000,168715,Valentine Traore,395,131680,2022-12-27
CASH_IN,262617,Agence_moov_Cotonou,300000,37383,Guy Guyon,-222614,40003,2022-12-05
CASH_OUT,21825,Guy Guyon,40003,18178,Agence_moov_Ouidah,300000,278175,2022-12-07
TRANSFER,17383,Guy Guyon,18178,795,Guy Guyon,18178,795,2022-12-10
TRANSFER,442,Guy Guyon,795,353,Guy Guyon,795,1237,2022-12-11
CASH_OUT,148,Guy Guyon,353,205,Agence_moov_Abomey,300000,299852,2022-12-12
TRANSFER,116,Guy Guyon,205,89,Guy Guyon,205,321,2022-12-12
CASH_IN,288071,Agence_moov_Ouidah,300000,11929,Guy Guyon,89,288160,2022-12-15
CASH_OUT,167224,Guy Guyon,288160,120936,Agence_moov_Abomey,300000,132776,2022-12-15
TRANSFER,104880,Guy Guyon,120936,16056,Guy Guyon,120936,225816,2022-12-16
CASH_IN,261432,Agence_moov_Ouidah,300000,38568,Guy Guyon,16056,277488,2022-12-16
TRANSFER,134435,Guy Guyon,277488,143053,Guy Guyon,277488,143053,2022-12-19
TRANSFER,5490,Guy Guyon,143053,137563,Guy Guyon,143053,137563,2022-12-20
CASH_OUT,110118,Guy Guyon,137563,27445,Agence_moov_Ouidah,300000,189882,2022-12-20
CASH_OUT,4528,Guy Guyon,27445,22917,Agence_moov_Ouidah,300000,295472,2022-12-21
CASH_IN,247990,Agence_moov_Cotonou,300000,52010,Guy Guyon,22917,270907,2022-12-25
CASH_IN,297243,Agence_moov_Ouidah,300000,2757,Guy Guyon,270907,568150,2022-12-25
CASH_IN,206151,Agence_moov_Ouidah,300000,93849,Xavier-Stéphane Ollivier,-6880,199271,2022-12-08
CASH_OUT,34140,Xavier-Stéphane Ollivier,199271,165131,Agence_moov_Cotonou,300000,265860,2022-12-09
CASH_IN,76751,Agence_moov_Ouidah,300000,223249,Xavier-Stéphane Ollivier,165131,241882,2022-12-15
CASH_OUT,172213,Xavier-Stéphane Ollivier,241882,69669,Agence_moov_Abomey,300000,127787,2022-12-15
CASH_OUT,955,Xavier-Stéphane Ollivier,69669,68714,Agence_moov_Ouidah,300000,299045,2022-12-19
CASH_IN,1785,Agence_moov_Cotonou,300000,298215,Xavier-Stéphane Ollivier,68714,70499,2022-12-21
CASH_IN,189225,Agence_moov_Ouidah,300000,110775,Luc-Tristan Moreau,-23510,165715,2022-12-01
CASH_IN,177990,Agence_moov_Abomey,300000,122010,Luc-Tristan Moreau,165715,343705,2022-12-07
CASH_IN,82516,Agence_moov_Abomey,300000,217484,Luc-Tristan Moreau,343705,426221,2022-12-13
CASH_IN,153026,Agence_moov_Cotonou,300000,146974,Luc-Tristan Moreau,426221,579247,2022-12-15
CASH_OUT,492609,Luc-Tristan Moreau,579247,86638,Agence_moov_Abomey,300000,-192609,2022-12-18
CASH_OUT,20757,Luc-Tristan Moreau,86638,65881,Agence_moov_Cotonou,300000,279243,2022-12-24
CASH_IN,215894,Agence_moov_Cotonou,300000,84106,Luc-Tristan Moreau,65881,281775,2022-12-25
CASH_IN,47257,Agence_moov_Cotonou,300000,252743,Luc-Tristan Moreau,281775,329032,2022-12-25
