Type,Montant,Nom_src,Ancien_solde_src,Nouveau_solde_src,Nom_dest,Ancien_solde_dest,Nouveau_solde_dest,Date
CASH_IN,106774,Agence_mtn_Cotonou,300000,193226,Nathalie Da Silva,881800,988574,2022-01-02
TRANSFER,124997,Nathalie Da Silva,988574,863577,Anouk Delahaye-Gimenez,1529300,1404303,2022-01-04
TRANSFER,398788,Nathalie Da Silva,863577,464789,Maryse Delorme,1885200,1486412,2022-01-05
CASH_OUT,152150,Nathalie Da Silva,464789,312639,Agence_mtn_Ouidah,300000,147850,2022-01-12
CASH_OUT,210488,Nathalie Da Silva,312639,102151,Agence_mtn_Cotonou,300000,89512,2022-01-13
CASH_OUT,1753357,Alfred Paris,1931800,178443,Agence_mtn_Abomey,300000,-1453357,2022-01-03
TRANSFER,24834,Alfred Paris,178443,153609,Henri de Didier,1962000,1937166,2022-01-10
TRANSFER,466128,Jacques Le Marion,610000,143872,Alfred Paris,153609,619737,2022-01-12
CASH_IN,266525,Agence_mtn_Abomey,300000,33475,Alfred Paris,619737,886262,2022-01-16
CASH_OUT,879684,Alfred Paris,886262,6578,Agence_mtn_Abomey,300000,-579684,2022-01-21
TRANSFER,1781963,Christophe Teixeira,1840300,58337,Océane Faure,1350400,-431563,2022-01-01
CASH_IN,2795,Agence_mtn_Ouidah,300000,297205,Christophe Teixeira,58337,61132,2022-01-11
CASH_OUT,41594,Christophe Teixeira,61132,19538,Agence_mtn_Abomey,300000,258406,2022-01-15
CASH_IN,85325,Agence_mtn_Cotonou,300000,214675,Marcel de la Buisson,1369400,1454725,2022-01-02
CASH_OUT,29787,Marcel de la Buisson,1454725,1424938,Agence_mtn_Abomey,300000,270213,2022-01-03
TRANSFER,381626,Marcel de la Buisson,1424938,1043312,Élisabeth Blot-Bruneau,1517400,1135774,2022-01-05
TRANSFER,16137,Marcel de la Buisson,1043312,1027175,Françoise Denis de Allard,1819500,1803363,2022-01-16
CASH_IN,245883,Agence_mtn_Ouidah,300000,54117,Océane Faure,-431563,-185680,2022-01-13
CASH_IN,9261,Agence_mtn_Cotonou,300000,290739,Océane Faure,-185680,-176419,2022-01-19
CASH_IN,139433,Agence_mtn_Cotonou,300000,160567,Océane Faure,-176419,-36986,2022-01-20
CASH_OUT,189828,Martin Moreau,1551100,1361272,Agence_mtn_Cotonou,300000,110172,2022-01-05
CASH_IN,14079,Agence_mtn_Cotonou,300000,285921,Martin Moreau,1361272,1375351,2022-01-07
CASH_IN,129089,Agence_mtn_Cotonou,300000,170911,Martin Moreau,1375351,1504440,2022-01-08
TRANSFER,48907,Valérie-Claudine Marin,567400,518493,Martin Moreau,1504440,1553347,2022-01-10
CASH_IN,97464,Agence_mtn_Cotonou,300000,202536,Martin Moreau,1553347,1650811,2022-01-25
TRANSFER,1153433,Louis du Boyer,1949200,795767,Gérard Cordier,1451500,2604933,2022-01-06
CASH_OUT,1970586,Gérard Cordier,2604933,634347,Agence_mtn_Ouidah,300000,-1670586,2022-01-09
CASH_IN,250820,Agence_mtn_Cotonou,300000,49180,Gérard Cordier,634347,885167,2022-01-15
CASH_OUT,279315,Gérard Cordier,885167,605852,Agence_mtn_Cotonou,300000,20685,2022-01-16
CASH_IN,175412,Agence_mtn_Abomey,300000,124588,Gérard Cordier,605852,781264,2022-01-26
CASH_OUT,1649854,Françoise Denis de Allard,1803363,153509,Agence_mtn_Abomey,300000,-1349854,2022-01-03
TRANSFER,906631,Alexandre Delaunay,1441000,534369,Françoise Denis de Allard,153509,1060140,2022-01-04
TRANSFER,769284,Maryse Delorme,1486412,717128,Françoise Denis de Allard,1060140,1829424,2022-01-06
CASH_IN,117561,Agence_mtn_Cotonou,300000,182439,Françoise Denis de Allard,1829424,1946985,2022-01-08
TRANSFER,586615,Françoise Denis de Allard,1946985,1360370,Josette du Hamon,424700,-161915,2022-01-27
CASH_IN,149325,Agence_mtn_Abomey,300000,150675,Madeleine Hardy,1400700,1550025,2022-01-04
CASH_IN,281188,Agence_mtn_Cotonou,300000,18812,Madeleine Hardy,1550025,1831213,2022-01-13
CASH_IN,262503,Agence_mtn_Ouidah,300000,37497,Madeleine Hardy,1831213,2093716,2022-01-17
CASH_OUT,2033928,Madeleine Hardy,2093716,59788,Agence_mtn_Cotonou,300000,-1733928,2022-01-26
CASH_OUT,1142153,Sylvie Dupré,1335000,192847,Agence_mtn_Cotonou,300000,-842153,2022-01-02
TRANSFER,144824,Sylvie Dupré,192847,48023,Raymond-Yves Boulanger,814800,669976,2022-01-05
TRANSFER,502836,Zacharie Fabre,1491100,988264,Sylvie Dupré,48023,550859,2022-01-13
CASH_OUT,470569,Sylvie Dupré,550859,80290,Agence_mtn_Abomey,300000,-170569,2022-01-20
TRANSFER,20270,Valérie-Claudine Marin,518493,498223,Hélène Blanchard-Renault,1377500,1357230,2022-01-02
CASH_OUT,280489,Valérie-Claudine Marin,498223,217734,Agence_mtn_Abomey,300000,19511,2022-01-24
CASH_OUT,126695,Valérie-Claudine Marin,217734,91039,Agence_mtn_Ouidah,300000,173305,2022-01-27
CASH_IN,126266,Agence_mtn_Cotonou,300000,173734,Édouard Grondin du Fleury,1243700,1369966,2022-01-19
CASH_OUT,163930,Astrid Aubert-Thierry,1374600,1210670,Agence_mtn_Cotonou,300000,136070,2022-01-08
CASH_IN,99432,Agence_mtn_Cotonou,300000,200568,Astrid Aubert-Thierry,1210670,1310102,2022-01-13
TRANSFER,182431,Astrid Aubert-Thierry,1310102,1127671,Thibault Martin,480700,298269,2022-01-14
TRANSFER,680519,Jacques Laporte de Blanchet,1606400,925881,Astrid Aubert-Thierry,1127671,1808190,2022-01-15
TRANSFER,1569924,Astrid Aubert-Thierry,1808190,238266,François Vaillant,258900,-1311024,2022-01-27
TRANSFER,68549,Éléonore Marin Le Morel,132200,63651,Anouk Delahaye-Gimenez,1404303,1335754,2022-01-06
CASH_OUT,36064,Éléonore Marin Le Morel,63651,27587,Agence_mtn_Abomey,300000,263936,2022-01-13
TRANSFER,61127,Guy-Augustin Pinto,386100,324973,Éléonore Marin Le Morel,27587,88714,2022-01-25
CASH_OUT,1333068,Charles Guérin,1417000,83932,Agence_mtn_Ouidah,300000,-1033068,2022-01-09
CASH_IN,50080,Agence_mtn_Abomey,300000,249920,Charles Guérin,83932,134012,2022-01-23
CASH_IN,228661,Agence_mtn_Abomey,300000,71339,Charles Guérin,134012,362673,2022-01-27
CASH_OUT,78125,Zacharie Fabre,988264,910139,Agence_mtn_Abomey,300000,221875,2022-01-07
CASH_IN,152694,Agence_mtn_Abomey,300000,147306,Zacharie Fabre,910139,1062833,2022-01-16
TRANSFER,11848,Nicole Huet,72100,60252,Zacharie Fabre,1062833,1074681,2022-01-19
CASH_IN,48823,Agence_mtn_Cotonou,300000,251177,Zacharie Fabre,1074681,1123504,2022-01-27
CASH_IN,210713,Agence_mtn_Ouidah,300000,89287,Zacharie Fabre,1123504,1334217,2022-01-27
TRANSFER,631612,Maurice de Brunet,1028500,396888,Nathalie-Claire De Oliveira,663700,32088,2022-01-25
CASH_IN,238019,Agence_mtn_Abomey,300000,61981,Élise Monnier,1141200,1379219,2022-01-20
CASH_OUT,846719,Julien Devaux,1253800,407081,Agence_mtn_Cotonou,300000,-546719,2022-01-16
CASH_IN,105075,Agence_mtn_Ouidah,300000,194925,Julien Devaux,407081,512156,2022-01-23
CASH_IN,116175,Agence_mtn_Cotonou,300000,183825,Nathalie-Claire De Oliveira,32088,148263,2022-01-06
CASH_OUT,140999,Nathalie-Claire De Oliveira,148263,7264,Agence_mtn_Cotonou,300000,159001,2022-01-07
TRANSFER,1503539,Sophie-Anouk Boulanger,1609300,105761,Nathalie-Claire De Oliveira,7264,1510803,2022-01-22
CASH_OUT,162380,Nathalie-Claire De Oliveira,1510803,1348423,Agence_mtn_Ouidah,300000,137620,2022-01-23
CASH_OUT,987615,Corinne Roussel,1749000,761385,Agence_mtn_Ouidah,300000,-687615,2022-01-01
CASH_OUT,541139,Corinne Roussel,761385,220246,Agence_mtn_Ouidah,300000,-241139,2022-01-03
CASH_OUT,77039,Corinne Roussel,220246,143207,Agence_mtn_Cotonou,300000,222961,2022-01-03
CASH_OUT,62390,Corinne Roussel,143207,80817,Agence_mtn_Cotonou,300000,237610,2022-01-04
TRANSFER,53687,Corinne Roussel,80817,27130,Olivier Benard,652300,598613,2022-01-06
TRANSFER,3404,Corinne Roussel,27130,23726,Marine Labbé,757500,754096,2022-01-09
CASH_IN,24249,Agence_mtn_Abomey,300000,275751,Corinne Roussel,23726,47975,2022-01-09
CASH_IN,36393,Agence_mtn_Ouidah,300000,263607,Corinne Roussel,47975,84368,2022-01-09
CASH_OUT,46686,Corinne Roussel,84368,37682,Agence_mtn_Abomey,300000,253314,2022-01-10
CASH_OUT,34768,Corinne Roussel,37682,2914,Agence_mtn_Ouidah,300000,265232,2022-01-13
TRANSFER,1013,Corinne Roussel,2914,1901,Marc Costa-Daniel,233300,232287,2022-01-13
TRANSFER,420650,Marine Labbé,754096,333446,Corinne Roussel,1901,422551,2022-01-13
CASH_IN,231339,Agence_mtn_Ouidah,300000,68661,Corinne Roussel,422551,653890,2022-01-14
CASH_OUT,437157,Corinne Roussel,653890,216733,Agence_mtn_Cotonou,300000,-137157,2022-01-15
TRANSFER,115585,Corinne Roussel,216733,101148,Margaud-Michelle Briand,981600,866015,2022-01-15
CASH_OUT,8896,Corinne Roussel,101148,92252,Agence_mtn_Abomey,300000,291104,2022-01-16
TRANSFER,22962,Alexandre Blanchard,28600,5638,Corinne Roussel,92252,115214,2022-01-18
CASH_OUT,6251,Corinne Roussel,115214,108963,Agence_mtn_Abomey,300000,293749,2022-01-18
TRANSFER,7591,Aurélie Maury,35700,28109,Corinne Roussel,108963,116554,2022-01-18
CASH_OUT,104577,Corinne Roussel,116554,11977,Agence_mtn_Ouidah,300000,195423,2022-01-19
CASH_OUT,10517,Corinne Roussel,11977,1460,Agence_mtn_Cotonou,300000,289483,2022-01-19
CASH_IN,155872,Agence_mtn_Cotonou,300000,144128,Corinne Roussel,1460,157332,2022-01-19
TRANSFER,746242,Madeleine Philippe-Grondin,1323300,577058,Corinne Roussel,157332,903574,2022-01-20
CASH_OUT,474022,Corinne Roussel,903574,429552,Agence_mtn_Ouidah,300000,-174022,2022-01-20
CASH_IN,46115,Agence_mtn_Cotonou,300000,253885,Corinne Roussel,429552,475667,2022-01-21
CASH_IN,16295,Agence_mtn_Cotonou,300000,283705,Corinne Roussel,475667,491962,2022-01-23
CASH_OUT,169562,Corinne Roussel,491962,322400,Agence_mtn_Abomey,300000,130438,2022-01-24
TRANSFER,58216,Corinne Roussel,322400,264184,Augustin-Jérôme Merle,112000,53784,2022-01-26
CASH_IN,169055,Agence_mtn_Ouidah,300000,130945,Corinne Roussel,264184,433239,2022-01-27
TRANSFER,28280,Guillaume de la Nguyen,48300,20020,Madeleine Philippe-Grondin,577058,548778,2022-01-01
CASH_OUT,12817,Guillaume de la Nguyen,20020,7203,Agence_mtn_Cotonou,300000,287183,2022-01-03
CASH_OUT,5206,Guillaume de la Nguyen,7203,1997,Agence_mtn_Abomey,300000,294794,2022-01-04
CASH_IN,61405,Agence_mtn_Abomey,300000,238595,Guillaume de la Nguyen,1997,63402,2022-01-04
CASH_OUT,36560,Guillaume de la Nguyen,63402,26842,Agence_mtn_Ouidah,300000,263440,2022-01-05
CASH_OUT,3550,Guillaume de la Nguyen,26842,23292,Agence_mtn_Abomey,300000,296450,2022-01-05
CASH_IN,12301,Agence_mtn_Cotonou,300000,287699,Guillaume de la Nguyen,23292,35593,2022-01-05
CASH_IN,182256,Agence_mtn_Cotonou,300000,117744,Guillaume de la Nguyen,35593,217849,2022-01-06
TRANSFER,32950,Guillaume de la Nguyen,217849,184899,Julie Germain Le Vaillant,1510500,1477550,2022-01-08
CASH_OUT,86930,Guillaume de la Nguyen,184899,97969,Agence_mtn_Abomey,300000,213070,2022-01-09
CASH_IN,162778,Agence_mtn_Ouidah,300000,137222,Guillaume de la Nguyen,97969,260747,2022-01-10
TRANSFER,196087,Clémence-Alice Ruiz,438600,242513,Guillaume de la Nguyen,260747,456834,2022-01-12
CASH_IN,63607,Agence_mtn_Abomey,300000,236393,Guillaume de la Nguyen,456834,520441,2022-01-13
TRANSFER,1428293,Emmanuelle Le Allain,1455000,26707,Guillaume de la Nguyen,520441,1948734,2022-01-14
CASH_OUT,1756549,Guillaume de la Nguyen,1948734,192185,Agence_mtn_Abomey,300000,-1456549,2022-01-14
CASH_OUT,75250,Guillaume de la Nguyen,192185,116935,Agence_mtn_Abomey,300000,224750,2022-01-16
TRANSFER,108750,Guillaume de la Nguyen,116935,8185,Céline-Inès Meunier,197500,88750,2022-01-16
CASH_OUT,3602,Guillaume de la Nguyen,8185,4583,Agence_mtn_Abomey,300000,296398,2022-01-16
TRANSFER,484754,Margot Julien,1885300,1400546,Guillaume de la Nguyen,4583,489337,2022-01-18
CASH_OUT,73812,Guillaume de la Nguyen,489337,415525,Agence_mtn_Cotonou,300000,226188,2022-01-19
CASH_IN,252732,Agence_mtn_Abomey,300000,47268,Guillaume de la Nguyen,415525,668257,2022-01-23
CASH_OUT,632353,Guillaume de la Nguyen,668257,35904,Agence_mtn_Abomey,300000,-332353,2022-01-24
CASH_IN,235668,Agence_mtn_Cotonou,300000,64332,Guillaume de la Nguyen,35904,271572,2022-01-25
TRANSFER,116180,Guillaume de la Nguyen,271572,155392,Matthieu Cousin,1974100,1857920,2022-01-25
CASH_OUT,8060,Guillaume de la Nguyen,155392,147332,Agence_mtn_Abomey,300000,291940,2022-01-25
TRANSFER,321269,Élisabeth Delattre,1089600,768331,Guillaume de la Nguyen,147332,468601,2022-01-25
CASH_IN,138777,Agence_mtn_Cotonou,300000,161223,Marc Costa-Daniel,232287,371064,2022-01-01
CASH_OUT,76199,Marc Costa-Daniel,371064,294865,Agence_mtn_Ouidah,300000,223801,2022-01-04
CASH_OUT,189255,Marc Costa-Daniel,294865,105610,Agence_mtn_Ouidah,300000,110745,2022-01-05
CASH_IN,211128,Agence_mtn_Cotonou,300000,88872,Marc Costa-Daniel,105610,316738,2022-01-06
CASH_IN,143073,Agence_mtn_Abomey,300000,156927,Marc Costa-Daniel,316738,459811,2022-01-06
TRANSFER,199452,Marc Costa-Daniel,459811,260359,Gilbert Moulin,532200,332748,2022-01-09
CASH_OUT,49429,Marc Costa-Daniel,260359,210930,Agence_mtn_Abomey,300000,250571,2022-01-10
CASH_IN,143374,Agence_mtn_Abomey,300000,156626,Marc Costa-Daniel,210930,354304,2022-01-12
CASH_IN,278811,Agence_mtn_Cotonou,300000,21189,Marc Costa-Daniel,354304,633115,2022-01-13
CASH_IN,229983,Agence_mtn_Ouidah,300000,70017,Marc Costa-Daniel,633115,863098,2022-01-13
TRANSFER,219070,Marc Costa-Daniel,863098,644028,Thibault Martin,298269,79199,2022-01-14
CASH_IN,202015,Agence_mtn_Ouidah,300000,97985,Marc Costa-Daniel,644028,846043,2022-01-16
CASH_OUT,695704,Marc Costa-Daniel,846043,150339,Agence_mtn_Ouidah,300000,-395704,2022-01-18
CASH_IN,204053,Agence_mtn_Cotonou,300000,95947,Marc Costa-Daniel,150339,354392,2022-01-19
CASH_IN,55628,Agence_mtn_Cotonou,300000,244372,Marc Costa-Daniel,354392,410020,2022-01-20
CASH_OUT,355833,Marc Costa-Daniel,410020,54187,Agence_mtn_Ouidah,300000,-55833,2022-01-20
CASH_OUT,11009,Marc Costa-Daniel,54187,43178,Agence_mtn_Abomey,300000,288991,2022-01-21
TRANSFER,344055,Madeleine Philippe-Grondin,548778,204723,Marc Costa-Daniel,43178,387233,2022-01-21
CASH_OUT,4535,Marc Costa-Daniel,387233,382698,Agence_mtn_Cotonou,300000,295465,2022-01-22
TRANSFER,39141,Augustin-Jérôme Merle,53784,14643,Marc Costa-Daniel,382698,421839,2022-01-22
CASH_IN,1651,Agence_mtn_Ouidah,300000,298349,Marc Costa-Daniel,421839,423490,2022-01-23
CASH_IN,91771,Agence_mtn_Ouidah,300000,208229,Marc Costa-Daniel,423490,515261,2022-01-24
CASH_OUT,74565,Marc Costa-Daniel,515261,440696,Agence_mtn_Cotonou,300000,225435,2022-01-24
TRANSFER,359911,Marc Costa-Daniel,440696,80785,Charlotte Perrier,1633900,1273989,2022-01-24
CASH_OUT,60951,Marc Costa-Daniel,80785,19834,Agence_mtn_Cotonou,300000,239049,2022-01-25
CASH_IN,199343,Agence_mtn_Ouidah,300000,100657,Marc Costa-Daniel,19834,219177,2022-01-26
CASH_IN,281309,Agence_mtn_Cotonou,300000,18691,Marine Labbé,333446,614755,2022-01-02
CASH_IN,183715,Agence_mtn_Cotonou,300000,116285,Marine Labbé,614755,798470,2022-01-03
TRANSFER,649456,Pénélope Boulay,1307300,657844,Marine Labbé,798470,1447926,2022-01-03
CASH_OUT,1410610,Marine Labbé,1447926,37316,Agence_mtn_Cotonou,300000,-1110610,2022-01-04
TRANSFER,925209,Matthieu Cousin,1857920,932711,Marine Labbé,37316,962525,2022-01-04
CASH_IN,225696,Agence_mtn_Cotonou,300000,74304,Marine Labbé,962525,1188221,2022-01-04
TRANSFER,71245,Danielle-Henriette Tessier,148800,77555,Marine Labbé,1188221,1259466,2022-01-04
CASH_IN,78048,Agence_mtn_Abomey,300000,221952,Marine Labbé,1259466,1337514,2022-01-04
CASH_IN,65001,Agence_mtn_Abomey,300000,234999,Marine Labbé,1337514,1402515,2022-01-05
CASH_IN,4271,Agence_mtn_Cotonou,300000,295729,Marine Labbé,1402515,1406786,2022-01-06
TRANSFER,1050992,Marine Labbé,1406786,355794,Roger-Roger Delmas,997800,-53192,2022-01-08
CASH_IN,232119,Agence_mtn_Ouidah,300000,67881,Marine Labbé,355794,587913,2022-01-08
CASH_IN,252336,Agence_mtn_Cotonou,300000,47664,Marine Labbé,587913,840249,2022-01-10
CASH_IN,296293,Agence_mtn_Ouidah,300000,3707,Marine Labbé,840249,1136542,2022-01-11
TRANSFER,165309,Marine Labbé,1136542,971233,Aurélie Maury,28109,-137200,2022-01-12
CASH_IN,107832,Agence_mtn_Abomey,300000,192168,Marine Labbé,971233,1079065,2022-01-12
CASH_OUT,398328,Marine Labbé,1079065,680737,Agence_mtn_Cotonou,300000,-98328,2022-01-13
CASH_OUT,452551,Marine Labbé,680737,228186,Agence_mtn_Ouidah,300000,-152551,2022-01-16
CASH_OUT,72253,Marine Labbé,228186,155933,Agence_mtn_Ouidah,300000,227747,2022-01-22
TRANSFER,144534,Marine Labbé,155933,11399,Alexandre Delaunay,534369,389835,2022-01-22
TRANSFER,3414,Alexandre Blanchard,5638,2224,Marine Labbé,11399,14813,2022-01-23
CASH_IN,262292,Agence_mtn_Ouidah,300000,37708,Marine Labbé,14813,277105,2022-01-24
CASH_OUT,273651,Marine Labbé,277105,3454,Agence_mtn_Cotonou,300000,26349,2022-01-24
TRANSFER,108227,Olivier Benard,598613,490386,Marine Labbé,3454,111681,2022-01-27
TRANSFER,577423,Jacques Laporte de Blanchet,925881,348458,Augustin-Jérôme Merle,14643,-562780,2022-01-02
CASH_OUT,58097,Jacques Laporte de Blanchet,348458,290361,Agence_mtn_Cotonou,300000,241903,2022-01-03
CASH_IN,198741,Agence_mtn_Cotonou,300000,101259,Jacques Laporte de Blanchet,290361,489102,2022-01-04
CASH_IN,49893,Agence_mtn_Ouidah,300000,250107,Jacques Laporte de Blanchet,489102,538995,2022-01-04
CASH_OUT,448220,Jacques Laporte de Blanchet,538995,90775,Agence_mtn_Ouidah,300000,-148220,2022-01-04
TRANSFER,81689,Jacques Laporte de Blanchet,90775,9086,Matthieu Cousin,932711,851022,2022-01-04
CASH_OUT,3065,Jacques Laporte de Blanchet,9086,6021,Agence_mtn_Ouidah,300000,296935,2022-01-05
TRANSFER,176,Matthieu Cousin,851022,850846,Jacques Laporte de Blanchet,6021,6197,2022-01-07
CASH_OUT,2588,Jacques Laporte de Blanchet,6197,3609,Agence_mtn_Ouidah,300000,297412,2022-01-08
CASH_IN,237165,Agence_mtn_Ouidah,300000,62835,Jacques Laporte de Blanchet,3609,240774,2022-01-08
TRANSFER,57166,Gabrielle Hamon,232300,175134,Jacques Laporte de Blanchet,240774,297940,2022-01-09
CASH_IN,225965,Agence_mtn_Cotonou,300000,74035,Jacques Laporte de Blanchet,297940,523905,2022-01-11
CASH_OUT,269714,Jacques Laporte de Blanchet,523905,254191,Agence_mtn_Cotonou,300000,30286,2022-01-13
CASH_IN,55765,Agence_mtn_Abomey,300000,244235,Jacques Laporte de Blanchet,254191,309956,2022-01-13
CASH_IN,287997,Agence_mtn_Ouidah,300000,12003,Jacques Laporte de Blanchet,309956,597953,2022-01-16
CASH_IN,6873,Agence_mtn_Cotonou,300000,293127,Jacques Laporte de Blanchet,597953,604826,2022-01-17
CASH_IN,206147,Agence_mtn_Ouidah,300000,93853,Jacques Laporte de Blanchet,604826,810973,2022-01-17
CASH_IN,177042,Agence_mtn_Abomey,300000,122958,Jacques Laporte de Blanchet,810973,988015,2022-01-18
TRANSFER,321988,Raymond de Le Roux,1659900,1337912,Jacques Laporte de Blanchet,988015,1310003,2022-01-20
CASH_IN,73314,Agence_mtn_Cotonou,300000,226686,Jacques Laporte de Blanchet,1310003,1383317,2022-01-20
CASH_IN,11774,Agence_mtn_Abomey,300000,288226,Jacques Laporte de Blanchet,1383317,1395091,2022-01-20
CASH_OUT,502235,Jacques Laporte de Blanchet,1395091,892856,Agence_mtn_Cotonou,300000,-202235,2022-01-23
TRANSFER,501060,Jacques Laporte de Blanchet,892856,391796,Maryse Delorme,717128,216068,2022-01-25
CASH_IN,7008,Agence_mtn_Abomey,300000,292992,Jacques Laporte de Blanchet,391796,398804,2022-01-25
CASH_IN,270082,Agence_mtn_Ouidah,300000,29918,Jacques Laporte de Blanchet,398804,668886,2022-01-26
TRANSFER,108432,Jacques Laporte de Blanchet,668886,560454,Jérôme Laporte Le Gauthier,910700,802268,2022-01-26
TRANSFER,140869,Jacques Laporte de Blanchet,560454,419585,Georges Muller,1510400,1369531,2022-01-27
CASH_IN,136169,Agence_mtn_Ouidah,300000,163831,Maggie Barbier,58600,194769,2022-01-01
CASH_OUT,112868,Maggie Barbier,194769,81901,Agence_mtn_Cotonou,300000,187132,2022-01-01
CASH_OUT,81129,Maggie Barbier,81901,772,Agence_mtn_Abomey,300000,218871,2022-01-03
CASH_IN,25192,Agence_mtn_Abomey,300000,274808,Maggie Barbier,772,25964,2022-01-03
CASH_IN,273494,Agence_mtn_Abomey,300000,26506,Maggie Barbier,25964,299458,2022-01-03
CASH_IN,150541,Agence_mtn_Ouidah,300000,149459,Maggie Barbier,299458,449999,2022-01-03
CASH_OUT,167153,Maggie Barbier,449999,282846,Agence_mtn_Abomey,300000,132847,2022-01-03
CASH_OUT,104969,Maggie Barbier,282846,177877,Agence_mtn_Abomey,300000,195031,2022-01-05
TRANSFER,33620,Maggie Barbier,177877,144257,Henri de Didier,1937166,1903546,2022-01-06
TRANSFER,62108,Maggie Barbier,144257,82149,Margot Julien,1400546,1338438,2022-01-08
CASH_IN,275043,Agence_mtn_Abomey,300000,24957,Maggie Barbier,82149,357192,2022-01-09
CASH_OUT,235133,Maggie Barbier,357192,122059,Agence_mtn_Cotonou,300000,64867,2022-01-13
TRANSFER,1084703,Thibault-Julien Chevallier,1732000,647297,Maggie Barbier,122059,1206762,2022-01-13
CASH_OUT,225198,Maggie Barbier,1206762,981564,Agence_mtn_Abomey,300000,74802,2022-01-13
TRANSFER,950481,Maggie Barbier,981564,31083,Margaud-Michelle Briand,866015,-84466,2022-01-14
TRANSFER,1351,Maggie Barbier,31083,29732,Michèle Faivre,560000,558649,2022-01-16
CASH_OUT,20886,Maggie Barbier,29732,8846,Agence_mtn_Abomey,300000,279114,2022-01-17
TRANSFER,249,Maggie Barbier,8846,8597,Jacques Le Marion,143872,143623,2022-01-17
CASH_OUT,6374,Maggie Barbier,8597,2223,Agence_mtn_Abomey,300000,293626,2022-01-17
CASH_IN,230586,Agence_mtn_Ouidah,300000,69414,Maggie Barbier,2223,232809,2022-01-19
CASH_IN,107748,Agence_mtn_Cotonou,300000,192252,Maggie Barbier,232809,340557,2022-01-19
CASH_IN,139416,Agence_mtn_Ouidah,300000,160584,Maggie Barbier,340557,479973,2022-01-19
CASH_OUT,29517,Maggie Barbier,479973,450456,Agence_mtn_Cotonou,300000,270483,2022-01-21
TRANSFER,23922,Maggie Barbier,450456,426534,Georges-Alfred Pruvost,1422100,1398178,2022-01-21
CASH_IN,66878,Agence_mtn_Abomey,300000,233122,Maggie Barbier,426534,493412,2022-01-22
CASH_OUT,457694,Maggie Barbier,493412,35718,Agence_mtn_Ouidah,300000,-157694,2022-01-22
CASH_IN,168606,Agence_mtn_Ouidah,300000,131394,Maggie Barbier,35718,204324,2022-01-23
CASH_IN,95105,Agence_mtn_Ouidah,300000,204895,Maggie Barbier,204324,299429,2022-01-24
TRANSFER,170421,Maggie Barbier,299429,129008,Christophe Besnard-Diaz,1829400,1658979,2022-01-27
TRANSFER,296340,Christine Rossi,1094000,797660,Maggie Barbier,129008,425348,2022-01-27
CASH_IN,40492,Agence_mtn_Abomey,300000,259508,Josette du Hamon,-161915,-121423,2022-01-01
CASH_IN,107284,Agence_mtn_Cotonou,300000,192716,Josette du Hamon,-121423,-14139,2022-01-02
CASH_IN,100947,Agence_mtn_Ouidah,300000,199053,Josette du Hamon,-14139,86808,2022-01-05
TRANSFER,26628,Josette du Hamon,86808,60180,Guy-Augustin Pinto,324973,298345,2022-01-06
TRANSFER,45911,Josette du Hamon,60180,14269,Christophe Besnard-Diaz,1658979,1613068,2022-01-07
TRANSFER,222189,Gilbert Moulin,332748,110559,Josette du Hamon,14269,236458,2022-01-09
TRANSFER,18830,Josette du Hamon,236458,217628,Hélène Blanchard-Renault,1357230,1338400,2022-01-09
CASH_OUT,60890,Josette du Hamon,217628,156738,Agence_mtn_Ouidah,300000,239110,2022-01-10
CASH_IN,133233,Agence_mtn_Ouidah,300000,166767,Josette du Hamon,156738,289971,2022-01-10
CASH_IN,191795,Agence_mtn_Cotonou,300000,108205,Josette du Hamon,289971,481766,2022-01-11
CASH_OUT,367406,Josette du Hamon,481766,114360,Agence_mtn_Ouidah,300000,-67406,2022-01-12
CASH_OUT,61510,Josette du Hamon,114360,52850,Agence_mtn_Cotonou,300000,238490,2022-01-13
CASH_OUT,4823,Josette du Hamon,52850,48027,Agence_mtn_Cotonou,300000,295177,2022-01-14
CASH_OUT,43469,Josette du Hamon,48027,4558,Agence_mtn_Abomey,300000,256531,2022-01-14
CASH_IN,295836,Agence_mtn_Cotonou,300000,4164,Josette du Hamon,4558,300394,2022-01-15
TRANSFER,186108,Josette du Hamon,300394,114286,Raymond-Yves Boulanger,669976,483868,2022-01-16
CASH_OUT,38803,Josette du Hamon,114286,75483,Agence_mtn_Abomey,300000,261197,2022-01-16
CASH_IN,289305,Agence_mtn_Cotonou,300000,10695,Josette du Hamon,75483,364788,2022-01-16
CASH_IN,100384,Agence_mtn_Cotonou,300000,199616,Josette du Hamon,364788,465172,2022-01-17
CASH_OUT,371368,Josette du Hamon,465172,93804,Agence_mtn_Cotonou,300000,-71368,2022-01-18
CASH_IN,254607,Agence_mtn_Abomey,300000,45393,Josette du Hamon,93804,348411,2022-01-18
TRANSFER,44419,Thibault Martin,79199,34780,Josette du Hamon,348411,392830,2022-01-19
CASH_OUT,297078,Josette du Hamon,392830,95752,Agence_mtn_Abomey,300000,2922,2022-01-21
CASH_OUT,51447,Josette du Hamon,95752,44305,Agence_mtn_Abomey,300000,248553,2022-01-23
CASH_OUT,12826,Josette du Hamon,44305,31479,Agence_mtn_Ouidah,300000,287174,2022-01-24
CASH_IN,151535,Agence_mtn_Abomey,300000,148465,Josette du Hamon,31479,183014,2022-01-25
TRANSFER,817994,Jules-Marc Chauvet,1074800,256806,Josette du Hamon,183014,1001008,2022-01-25
CASH_OUT,998888,Josette du Hamon,1001008,2120,Agence_mtn_Ouidah,300000,-698888,2022-01-26
TRANSFER,343,Josette du Hamon,2120,1777,Élisabeth Delattre,768331,767988,2022-01-27
CASH_OUT,6412,Thibault Martin,34780,28368,Agence_mtn_Abomey,300000,293588,2022-01-02
CASH_IN,234771,Agence_mtn_Abomey,300000,65229,Thibault Martin,28368,263139,2022-01-06
CASH_OUT,40620,Thibault Martin,263139,222519,Agence_mtn_Abomey,300000,259380,2022-01-07
CASH_OUT,150487,Thibault Martin,222519,72032,Agence_mtn_Ouidah,300000,149513,2022-01-07
CASH_OUT,70084,Thibault Martin,72032,1948,Agence_mtn_Abomey,300000,229916,2022-01-07
TRANSFER,198618,Matthieu Cousin,850846,652228,Thibault Martin,1948,200566,2022-01-09
CASH_OUT,186262,Thibault Martin,200566,14304,Agence_mtn_Ouidah,300000,113738,2022-01-09
CASH_IN,228001,Agence_mtn_Ouidah,300000,71999,Thibault Martin,14304,242305,2022-01-09
TRANSFER,130075,Thibault Martin,242305,112230,Stéphanie Guichard,985400,855325,2022-01-09
CASH_IN,267151,Agence_mtn_Ouidah,300000,32849,Thibault Martin,112230,379381,2022-01-10
CASH_IN,168127,Agence_mtn_Cotonou,300000,131873,Thibault Martin,379381,547508,2022-01-11
TRANSFER,287117,Raymond-Yves Boulanger,483868,196751,Thibault Martin,547508,834625,2022-01-12
CASH_IN,131111,Agence_mtn_Ouidah,300000,168889,Thibault Martin,834625,965736,2022-01-13
CASH_IN,184704,Agence_mtn_Cotonou,300000,115296,Thibault Martin,965736,1150440,2022-01-13
CASH_IN,257112,Agence_mtn_Ouidah,300000,42888,Thibault Martin,1150440,1407552,2022-01-13
TRANSFER,1174205,Thibault Martin,1407552,233347,Élisabeth Delattre,767988,-406217,2022-01-14
CASH_IN,133877,Agence_mtn_Abomey,300000,166123,Thibault Martin,233347,367224,2022-01-15
TRANSFER,26103,Thibault Martin,367224,341121,Sébastien Coste,1194600,1168497,2022-01-15
CASH_OUT,247591,Thibault Martin,341121,93530,Agence_mtn_Abomey,300000,52409,2022-01-18
CASH_OUT,92287,Thibault Martin,93530,1243,Agence_mtn_Abomey,300000,207713,2022-01-18
TRANSFER,248362,Gérard Blot de Blanc,1331700,1083338,Thibault Martin,1243,249605,2022-01-19
CASH_IN,141640,Agence_mtn_Cotonou,300000,158360,Thibault Martin,249605,391245,2022-01-22
CASH_IN,290003,Agence_mtn_Ouidah,300000,9997,Thibault Martin,391245,681248,2022-01-23
TRANSFER,339111,Thibault Martin,681248,342137,Thibault Martin,681248,1020359,2022-01-25
CASH_OUT,112662,Thibault Martin,342137,229475,Agence_mtn_Ouidah,300000,187338,2022-01-26
CASH_IN,3699,Agence_mtn_Ouidah,300000,296301,Thibault Martin,229475,233174,2022-01-26
TRANSFER,136735,Thibault Martin,233174,96439,Laurent Marion,635000,498265,2022-01-27
CASH_IN,265240,Agence_mtn_Abomey,300000,34760,Emmanuel Vallée,1343400,1608640,2022-01-01
CASH_OUT,534005,Emmanuel Vallée,1608640,1074635,Agence_mtn_Abomey,300000,-234005,2022-01-01
TRANSFER,88373,Céline-Inès Meunier,88750,377,Emmanuel Vallée,1074635,1163008,2022-01-06
CASH_IN,116146,Agence_mtn_Abomey,300000,183854,Emmanuel Vallée,1163008,1279154,2022-01-06
CASH_OUT,1043487,Emmanuel Vallée,1279154,235667,Agence_mtn_Abomey,300000,-743487,2022-01-06
TRANSFER,3967,Emmanuel Vallée,235667,231700,Christine Rossi,797660,793693,2022-01-08
TRANSFER,83148,Emmanuel Vallée,231700,148552,Nicolas Blin,213900,130752,2022-01-09
CASH_IN,78230,Agence_mtn_Abomey,300000,221770,Emmanuel Vallée,148552,226782,2022-01-13
CASH_OUT,66743,Emmanuel Vallée,226782,160039,Agence_mtn_Cotonou,300000,233257,2022-01-15
TRANSFER,10644,Clémence-Alice Ruiz,242513,231869,Emmanuel Vallée,160039,170683,2022-01-17
TRANSFER,617062,Thibault-Julien Chevallier,647297,30235,Emmanuel Vallée,170683,787745,2022-01-18
CASH_OUT,687741,Emmanuel Vallée,787745,100004,Agence_mtn_Abomey,300000,-387741,2022-01-20
CASH_OUT,94316,Emmanuel Vallée,100004,5688,Agence_mtn_Abomey,300000,205684,2022-01-20
TRANSFER,965249,Christophe Besnard-Diaz,1613068,647819,Emmanuel Vallée,5688,970937,2022-01-21
CASH_IN,202221,Agence_mtn_Cotonou,300000,97779,Emmanuel Vallée,970937,1173158,2022-01-21
CASH_IN,161692,Agence_mtn_Abomey,300000,138308,Emmanuel Vallée,1173158,1334850,2022-01-21
CASH_OUT,1058401,Emmanuel Vallée,1334850,276449,Agence_mtn_Abomey,300000,-758401,2022-01-22
CASH_OUT,44515,Emmanuel Vallée,276449,231934,Agence_mtn_Ouidah,300000,255485,2022-01-22
CASH_IN,52904,Agence_mtn_Cotonou,300000,247096,Emmanuel Vallée,231934,284838,2022-01-23
TRANSFER,23308,Nicole Huet,60252,36944,Emmanuel Vallée,284838,308146,2022-01-23
TRANSFER,690274,Julie Germain Le Vaillant,1477550,787276,Emmanuel Vallée,308146,998420,2022-01-27
CASH_IN,205835,Agence_mtn_Ouidah,300000,94165,Emmanuel Vallée,998420,1204255,2022-01-27
CASH_IN,98972,Agence_mtn_Cotonou,300000,201028,Margaud-Michelle Briand,-84466,14506,2022-01-01
CASH_OUT,12981,Margaud-Michelle Briand,14506,1525,Agence_mtn_Abomey,300000,287019,2022-01-02
TRANSFER,672146,Jérôme Laporte Le Gauthier,802268,130122,Margaud-Michelle Briand,1525,673671,2022-01-02
CASH_OUT,533022,Margaud-Michelle Briand,673671,140649,Agence_mtn_Cotonou,300000,-233022,2022-01-07
CASH_IN,259230,Agence_mtn_Abomey,300000,40770,Margaud-Michelle Briand,140649,399879,2022-01-07
CASH_IN,269719,Agence_mtn_Cotonou,300000,30281,Margaud-Michelle Briand,399879,669598,2022-01-08
CASH_IN,288766,Agence_mtn_Cotonou,300000,11234,Margaud-Michelle Briand,669598,958364,2022-01-09
TRANSFER,743743,Margaud-Michelle Briand,958364,214621,Margot Julien,1338438,594695,2022-01-10
TRANSFER,7781,Margaud-Michelle Briand,214621,206840,Michèle Faivre,558649,550868,2022-01-10
CASH_IN,87690,Agence_mtn_Cotonou,300000,212310,Margaud-Michelle Briand,206840,294530,2022-01-12
TRANSFER,87405,Margaud-Michelle Briand,294530,207125,Matthieu Cousin,652228,564823,2022-01-12
TRANSFER,122343,Margaud-Michelle Briand,207125,84782,Michèle Faivre,550868,428525,2022-01-13
CASH_OUT,59309,Margaud-Michelle Briand,84782,25473,Agence_mtn_Ouidah,300000,240691,2022-01-15
CASH_IN,196580,Agence_mtn_Ouidah,300000,103420,Margaud-Michelle Briand,25473,222053,2022-01-15
CASH_IN,132319,Agence_mtn_Ouidah,300000,167681,Margaud-Michelle Briand,222053,354372,2022-01-16
CASH_IN,269102,Agence_mtn_Cotonou,300000,30898,Margaud-Michelle Briand,354372,623474,2022-01-16
TRANSFER,547873,Margaud-Michelle Briand,623474,75601,Laurent Marion,498265,-49608,2022-01-19
CASH_OUT,74978,Margaud-Michelle Briand,75601,623,Agence_mtn_Cotonou,300000,225022,2022-01-20
CASH_OUT,226,Margaud-Michelle Briand,623,397,Agence_mtn_Cotonou,300000,299774,2022-01-20
CASH_IN,89810,Agence_mtn_Ouidah,300000,210190,Margaud-Michelle Briand,397,90207,2022-01-20
CASH_OUT,6238,Margaud-Michelle Briand,90207,83969,Agence_mtn_Ouidah,300000,293762,2022-01-20
CASH_IN,174868,Agence_mtn_Abomey,300000,125132,Margaud-Michelle Briand,83969,258837,2022-01-21
TRANSFER,5049,Sophie-Anouk Boulanger,105761,100712,Margaud-Michelle Briand,258837,263886,2022-01-21
CASH_IN,249435,Agence_mtn_Abomey,300000,50565,Margaud-Michelle Briand,263886,513321,2022-01-21
CASH_IN,9431,Agence_mtn_Abomey,300000,290569,Margaud-Michelle Briand,513321,522752,2022-01-27
CASH_OUT,1202313,Charlotte Perrier,1273989,71676,Agence_mtn_Cotonou,300000,-902313,2022-01-01
CASH_IN,61480,Agence_mtn_Cotonou,300000,238520,Charlotte Perrier,71676,133156,2022-01-01
TRANSFER,42777,Charlotte Perrier,133156,90379,Christine Rossi,793693,750916,2022-01-01
CASH_OUT,56973,Charlotte Perrier,90379,33406,Agence_mtn_Cotonou,300000,243027,2022-01-03
TRANSFER,977,Emmanuelle Le Allain,26707,25730,Charlotte Perrier,33406,34383,2022-01-11
TRANSFER,177607,Olivier Benard,490386,312779,Charlotte Perrier,34383,211990,2022-01-11
CASH_OUT,112968,Charlotte Perrier,211990,99022,Agence_mtn_Abomey,300000,187032,2022-01-11
CASH_IN,153806,Agence_mtn_Abomey,300000,146194,Charlotte Perrier,99022,252828,2022-01-12
TRANSFER,131283,Charlotte Perrier,252828,121545,Gérard Blot de Blanc,1083338,952055,2022-01-12
CASH_IN,261744,Agence_mtn_Cotonou,300000,38256,Charlotte Perrier,121545,383289,2022-01-12
TRANSFER,382860,Charlotte Perrier,383289,429,Thibault-Julien Chevallier,30235,-352625,2022-01-12
TRANSFER,491531,Julie Germain Le Vaillant,787276,295745,Charlotte Perrier,429,491960,2022-01-12
TRANSFER,275782,Guy-Augustin Pinto,298345,22563,Charlotte Perrier,491960,767742,2022-01-14
CASH_IN,267302,Agence_mtn_Abomey,300000,32698,Charlotte Perrier,767742,1035044,2022-01-17
TRANSFER,291190,Pénélope Boulay,657844,366654,Charlotte Perrier,1035044,1326234,2022-01-17
TRANSFER,10745,Louise-Aurore Payet,109900,99155,Charlotte Perrier,1326234,1336979,2022-01-18
CASH_IN,156158,Agence_mtn_Abomey,300000,143842,Charlotte Perrier,1336979,1493137,2022-01-20
CASH_IN,94117,Agence_mtn_Cotonou,300000,205883,Charlotte Perrier,1493137,1587254,2022-01-21
CASH_OUT,666119,Charlotte Perrier,1587254,921135,Agence_mtn_Ouidah,300000,-366119,2022-01-23
TRANSFER,625210,Christine Rossi,750916,125706,Charlotte Perrier,921135,1546345,2022-01-24
CASH_OUT,207819,Charlotte Perrier,1546345,1338526,Agence_mtn_Abomey,300000,92181,2022-01-27
CASH_OUT,23530,Sophie-Anouk Boulanger,100712,77182,Agence_mtn_Abomey,300000,276470,2022-01-01
CASH_OUT,11276,Sophie-Anouk Boulanger,77182,65906,Agence_mtn_Ouidah,300000,288724,2022-01-02
CASH_IN,178030,Agence_mtn_Cotonou,300000,121970,Sophie-Anouk Boulanger,65906,243936,2022-01-02
TRANSFER,171389,Sophie-Anouk Boulanger,243936,72547,Clémence Dufour,1929800,1758411,2022-01-03
CASH_IN,282254,Agence_mtn_Ouidah,300000,17746,Sophie-Anouk Boulanger,72547,354801,2022-01-04
TRANSFER,982419,Élisabeth Blot-Bruneau,1135774,153355,Sophie-Anouk Boulanger,354801,1337220,2022-01-04
TRANSFER,550543,Gérard Blot de Blanc,952055,401512,Sophie-Anouk Boulanger,1337220,1887763,2022-01-04
TRANSFER,684557,Sophie-Anouk Boulanger,1887763,1203206,Jacques Marchand,1457900,773343,2022-01-08
TRANSFER,132418,Madeleine Philippe-Grondin,204723,72305,Sophie-Anouk Boulanger,1203206,1335624,2022-01-09
CASH_OUT,2551,Sophie-Anouk Boulanger,1335624,1333073,Agence_mtn_Cotonou,300000,297449,2022-01-09
TRANSFER,341989,Sophie-Anouk Boulanger,1333073,991084,Gilbert Moulin,110559,-231430,2022-01-09
CASH_IN,277487,Agence_mtn_Ouidah,300000,22513,Sophie-Anouk Boulanger,991084,1268571,2022-01-10
CASH_OUT,190083,Sophie-Anouk Boulanger,1268571,1078488,Agence_mtn_Cotonou,300000,109917,2022-01-10
TRANSFER,28638,Nicole Huet,36944,8306,Sophie-Anouk Boulanger,1078488,1107126,2022-01-12
CASH_IN,163856,Agence_mtn_Abomey,300000,136144,Sophie-Anouk Boulanger,1107126,1270982,2022-01-12
TRANSFER,1267496,Sophie-Anouk Boulanger,1270982,3486,Julie Germain Le Vaillant,295745,-971751,2022-01-14
CASH_OUT,1925,Sophie-Anouk Boulanger,3486,1561,Agence_mtn_Abomey,300000,298075,2022-01-16
CASH_OUT,421,Sophie-Anouk Boulanger,1561,1140,Agence_mtn_Abomey,300000,299579,2022-01-17
CASH_IN,55119,Agence_mtn_Abomey,300000,244881,Sophie-Anouk Boulanger,1140,56259,2022-01-17
CASH_OUT,37599,Sophie-Anouk Boulanger,56259,18660,Agence_mtn_Cotonou,300000,262401,2022-01-18
TRANSFER,991,Guy-Augustin Pinto,22563,21572,Sophie-Anouk Boulanger,18660,19651,2022-01-21
TRANSFER,10926,Nicolas Blin,130752,119826,Sophie-Anouk Boulanger,19651,30577,2022-01-22
CASH_IN,129691,Agence_mtn_Abomey,300000,170309,Sophie-Anouk Boulanger,30577,160268,2022-01-23
CASH_OUT,83418,Sophie-Anouk Boulanger,160268,76850,Agence_mtn_Ouidah,300000,216582,2022-01-24
TRANSFER,10390,Sophie-Anouk Boulanger,76850,66460,Margot Julien,594695,584305,2022-01-24
CASH_IN,23187,Agence_mtn_Abomey,300000,276813,Sophie-Anouk Boulanger,66460,89647,2022-01-24
TRANSFER,48401,Jean Guilbert-Lenoir,1747600,1699199,Sophie-Anouk Boulanger,89647,138048,2022-01-25
CASH_OUT,89275,Sophie-Anouk Boulanger,138048,48773,Agence_mtn_Ouidah,300000,210725,2022-01-25
CASH_IN,134711,Agence_mtn_Ouidah,300000,165289,Sophie-Anouk Boulanger,48773,183484,2022-01-25
CASH_IN,256107,Agence_mtn_Cotonou,300000,43893,Sophie-Anouk Boulanger,183484,439591,2022-01-27
CASH_OUT,6662,Nicole Huet,8306,1644,Agence_mtn_Cotonou,300000,293338,2022-01-02
CASH_OUT,1012,Nicole Huet,1644,632,Agence_mtn_Abomey,300000,298988,2022-01-03
TRANSFER,6257,Louise-Aurore Payet,99155,92898,Nicole Huet,632,6889,2022-01-04
CASH_OUT,6291,Nicole Huet,6889,598,Agence_mtn_Cotonou,300000,293709,2022-01-04
TRANSFER,101840,Pénélope Boulay,366654,264814,Nicole Huet,598,102438,2022-01-05
CASH_IN,40365,Agence_mtn_Abomey,300000,259635,Nicole Huet,102438,142803,2022-01-06
CASH_OUT,66902,Nicole Huet,142803,75901,Agence_mtn_Ouidah,300000,233098,2022-01-07
TRANSFER,641,Guy-Augustin Pinto,21572,20931,Nicole Huet,75901,76542,2022-01-08
TRANSFER,50069,Nicole Huet,76542,26473,Nicolas Blin,119826,69757,2022-01-08
TRANSFER,18435,Olivier Benard,312779,294344,Nicole Huet,26473,44908,2022-01-10
CASH_IN,183009,Agence_mtn_Cotonou,300000,116991,Nicole Huet,44908,227917,2022-01-10
TRANSFER,75416,Raymond-Yves Boulanger,196751,121335,Nicole Huet,227917,303333,2022-01-12
CASH_OUT,61658,Nicole Huet,303333,241675,Agence_mtn_Abomey,300000,238342,2022-01-12
CASH_OUT,25441,Nicole Huet,241675,216234,Agence_mtn_Ouidah,300000,274559,2022-01-13
CASH_IN,241174,Agence_mtn_Abomey,300000,58826,Nicole Huet,216234,457408,2022-01-13
TRANSFER,263922,Nicole Huet,457408,193486,Pénélope Boulay,264814,892,2022-01-15
CASH_IN,92880,Agence_mtn_Cotonou,300000,207120,Nicole Huet,193486,286366,2022-01-15
TRANSFER,12975,Louis du Boyer,795767,782792,Nicole Huet,286366,299341,2022-01-16
CASH_OUT,30353,Nicole Huet,299341,268988,Agence_mtn_Abomey,300000,269647,2022-01-19
CASH_IN,12324,Agence_mtn_Ouidah,300000,287676,Nicole Huet,268988,281312,2022-01-20
TRANSFER,230621,Nicole Huet,281312,50691,Maryse Delorme,216068,-14553,2022-01-21
TRANSFER,766361,Raymond de Le Roux,1337912,571551,Nicole Huet,50691,817052,2022-01-22
CASH_IN,76565,Agence_mtn_Abomey,300000,223435,Nicole Huet,817052,893617,2022-01-22
TRANSFER,567407,Nicole Huet,893617,326210,Raymond Simon,1260000,692593,2022-01-23
CASH_IN,53705,Agence_mtn_Ouidah,300000,246295,Nicole Huet,326210,379915,2022-01-23
TRANSFER,1049638,Sébastien Coste,1168497,118859,Nicole Huet,379915,1429553,2022-01-23
CASH_IN,76066,Agence_mtn_Ouidah,300000,223934,Nicole Huet,1429553,1505619,2022-01-25
TRANSFER,581792,Nicole Huet,1505619,923827,Raymond Simon,692593,110801,2022-01-26
TRANSFER,42187,Olivier Benard,294344,252157,Nicole Huet,923827,966014,2022-01-26
CASH_IN,186340,Agence_mtn_Cotonou,300000,113660,Nicole Huet,966014,1152354,2022-01-27
TRANSFER,621104,Jacques Marchand,773343,152239,Sébastien Coste,118859,739963,2022-01-01
CASH_OUT,678303,Sébastien Coste,739963,61660,Agence_mtn_Abomey,300000,-378303,2022-01-02
CASH_OUT,39680,Sébastien Coste,61660,21980,Agence_mtn_Cotonou,300000,260320,2022-01-03
CASH_OUT,5701,Sébastien Coste,21980,16279,Agence_mtn_Ouidah,300000,294299,2022-01-04
CASH_IN,155641,Agence_mtn_Abomey,300000,144359,Sébastien Coste,16279,171920,2022-01-04
CASH_IN,260075,Agence_mtn_Ouidah,300000,39925,Sébastien Coste,171920,431995,2022-01-05
CASH_IN,235585,Agence_mtn_Abomey,300000,64415,Sébastien Coste,431995,667580,2022-01-09
CASH_OUT,488591,Sébastien Coste,667580,178989,Agence_mtn_Ouidah,300000,-188591,2022-01-09
CASH_IN,20879,Agence_mtn_Ouidah,300000,279121,Sébastien Coste,178989,199868,2022-01-11
CASH_IN,269093,Agence_mtn_Ouidah,300000,30907,Sébastien Coste,199868,468961,2022-01-12
CASH_OUT,432780,Sébastien Coste,468961,36181,Agence_mtn_Abomey,300000,-132780,2022-01-13
CASH_OUT,25645,Sébastien Coste,36181,10536,Agence_mtn_Ouidah,300000,274355,2022-01-13
CASH_IN,234097,Agence_mtn_Ouidah,300000,65903,Sébastien Coste,10536,244633,2022-01-14
CASH_OUT,84598,Sébastien Coste,244633,160035,Agence_mtn_Ouidah,300000,215402,2022-01-17
CASH_OUT,41755,Sébastien Coste,160035,118280,Agence_mtn_Cotonou,300000,258245,2022-01-17
CASH_OUT,59537,Sébastien Coste,118280,58743,Agence_mtn_Ouidah,300000,240463,2022-01-20
TRANSFER,119667,Raymond-Yves Boulanger,121335,1668,Sébastien Coste,58743,178410,2022-01-20
CASH_IN,236760,Agence_mtn_Cotonou,300000,63240,Sébastien Coste,178410,415170,2022-01-21
TRANSFER,289235,Sébastien Coste,415170,125935,Guy-Augustin Pinto,20931,-268304,2022-01-23
TRANSFER,1231210,Valérie de Pottier,1451200,219990,Sébastien Coste,125935,1357145,2022-01-25
TRANSFER,342605,Sébastien Coste,1357145,1014540,Georges-Alfred Pruvost,1398178,1055573,2022-01-26
TRANSFER,44946,Sébastien Coste,1014540,969594,Gérard Blot de Blanc,401512,356566,2022-01-26
CASH_OUT,49913,Sébastien Coste,969594,919681,Agence_mtn_Abomey,300000,250087,2022-01-27
CASH_IN,41055,Agence_mtn_Cotonou,300000,258945,Sébastien Coste,919681,960736,2022-01-27
CASH_IN,251908,Agence_mtn_Abomey,300000,48092,Stéphanie Guichard,855325,1107233,2022-01-01
CASH_OUT,79736,Stéphanie Guichard,1107233,1027497,Agence_mtn_Ouidah,300000,220264,2022-01-02
CASH_OUT,170960,Stéphanie Guichard,1027497,856537,Agence_mtn_Ouidah,300000,129040,2022-01-04
CASH_OUT,593526,Stéphanie Guichard,856537,263011,Agence_mtn_Cotonou,300000,-293526,2022-01-04
CASH_OUT,54207,Stéphanie Guichard,263011,208804,Agence_mtn_Cotonou,300000,245793,2022-01-06
TRANSFER,157,Céline-Inès Meunier,377,220,Stéphanie Guichard,208804,208961,2022-01-08
TRANSFER,98075,Stéphanie Guichard,208961,110886,Pénélope Boulay,892,-97183,2022-01-10
CASH_OUT,85674,Stéphanie Guichard,110886,25212,Agence_mtn_Ouidah,300000,214326,2022-01-10
CASH_IN,140882,Agence_mtn_Ouidah,300000,159118,Stéphanie Guichard,25212,166094,2022-01-15
CASH_OUT,131637,Stéphanie Guichard,166094,34457,Agence_mtn_Cotonou,300000,168363,2022-01-15
CASH_OUT,6707,Stéphanie Guichard,34457,27750,Agence_mtn_Cotonou,300000,293293,2022-01-17
CASH_OUT,22581,Stéphanie Guichard,27750,5169,Agence_mtn_Cotonou,300000,277419,2022-01-17
CASH_IN,285750,Agence_mtn_Abomey,300000,14250,Stéphanie Guichard,5169,290919,2022-01-18
CASH_IN,154064,Agence_mtn_Ouidah,300000,145936,Stéphanie Guichard,290919,444983,2022-01-19
CASH_IN,146291,Agence_mtn_Cotonou,300000,153709,Stéphanie Guichard,444983,591274,2022-01-20
CASH_IN,201208,Agence_mtn_Ouidah,300000,98792,Stéphanie Guichard,591274,792482,2022-01-21
TRANSFER,38955,Danielle-Henriette Tessier,77555,38600,Stéphanie Guichard,792482,831437,2022-01-23
CASH_IN,17343,Agence_mtn_Ouidah,300000,282657,Stéphanie Guichard,831437,848780,2022-01-24
CASH_OUT,152342,Stéphanie Guichard,848780,696438,Agence_mtn_Abomey,300000,147658,2022-01-25
CASH_OUT,601711,Stéphanie Guichard,696438,94727,Agence_mtn_Abomey,300000,-301711,2022-01-27
CASH_OUT,77211,Stéphanie Guichard,94727,17516,Agence_mtn_Ouidah,300000,222789,2022-01-27
CASH_IN,92564,Agence_mtn_Cotonou,300000,207436,Clémence-Alice Ruiz,231869,324433,2022-01-01
CASH_IN,89591,Agence_mtn_Abomey,300000,210409,Clémence-Alice Ruiz,324433,414024,2022-01-01
CASH_IN,180214,Agence_mtn_Ouidah,300000,119786,Clémence-Alice Ruiz,414024,594238,2022-01-01
CASH_OUT,23491,Clémence-Alice Ruiz,594238,570747,Agence_mtn_Abomey,300000,276509,2022-01-02
CASH_IN,263892,Agence_mtn_Abomey,300000,36108,Clémence-Alice Ruiz,570747,834639,2022-01-04
TRANSFER,572837,Clémence-Alice Ruiz,834639,261802,Jacques Marchand,152239,-420598,2022-01-05
TRANSFER,292939,Sabine Perrier,416200,123261,Clémence-Alice Ruiz,261802,554741,2022-01-05
CASH_OUT,108027,Clémence-Alice Ruiz,554741,446714,Agence_mtn_Ouidah,300000,191973,2022-01-07
TRANSFER,243083,Jules-Marc Chauvet,256806,13723,Clémence-Alice Ruiz,446714,689797,2022-01-08
TRANSFER,109521,Jérôme Laporte Le Gauthier,130122,20601,Clémence-Alice Ruiz,689797,799318,2022-01-10
CASH_IN,45727,Agence_mtn_Abomey,300000,254273,Clémence-Alice Ruiz,799318,845045,2022-01-12
CASH_OUT,541586,Clémence-Alice Ruiz,845045,303459,Agence_mtn_Ouidah,300000,-241586,2022-01-12
TRANSFER,9785,Clémence-Alice Ruiz,303459,293674,Nicolas Blin,69757,59972,2022-01-13
TRANSFER,14376,Clémence-Alice Ruiz,293674,279298,Matthieu Cousin,564823,550447,2022-01-14
CASH_OUT,40054,Clémence-Alice Ruiz,279298,239244,Agence_mtn_Ouidah,300000,259946,2022-01-14
TRANSFER,23315,Danielle-Henriette Tessier,38600,15285,Clémence-Alice Ruiz,239244,262559,2022-01-16
CASH_IN,292616,Agence_mtn_Ouidah,300000,7384,Clémence-Alice Ruiz,262559,555175,2022-01-16
TRANSFER,50789,Clémence-Alice Ruiz,555175,504386,Christophe Besnard-Diaz,647819,597030,2022-01-17
CASH_OUT,447162,Clémence-Alice Ruiz,504386,57224,Agence_mtn_Abomey,300000,-147162,2022-01-17
CASH_OUT,7770,Clémence-Alice Ruiz,57224,49454,Agence_mtn_Cotonou,300000,292230,2022-01-20
TRANSFER,1908,Clémence-Alice Ruiz,49454,47546,Gabrielle Hamon,175134,173226,2022-01-20
CASH_IN,151631,Agence_mtn_Cotonou,300000,148369,Clémence-Alice Ruiz,47546,199177,2022-01-20
TRANSFER,2126,Alexandre Blanchard,2224,98,Clémence-Alice Ruiz,199177,201303,2022-01-20
CASH_IN,486,Agence_mtn_Cotonou,300000,299514,François Vaillant,-1311024,-1310538,2022-01-01
CASH_IN,270383,Agence_mtn_Abomey,300000,29617,François Vaillant,-1310538,-1040155,2022-01-01
CASH_IN,109174,Agence_mtn_Ouidah,300000,190826,François Vaillant,-1040155,-930981,2022-01-04
CASH_IN,64205,Agence_mtn_Ouidah,300000,235795,François Vaillant,-930981,-866776,2022-01-04
CASH_IN,282001,Agence_mtn_Cotonou,300000,17999,François Vaillant,-866776,-584775,2022-01-06
CASH_IN,281985,Agence_mtn_Ouidah,300000,18015,François Vaillant,-584775,-302790,2022-01-07
CASH_IN,255822,Agence_mtn_Abomey,300000,44178,François Vaillant,-302790,-46968,2022-01-08
CASH_IN,90858,Agence_mtn_Abomey,300000,209142,François Vaillant,-46968,43890,2022-01-09
TRANSFER,259165,Christophe Besnard-Diaz,597030,337865,François Vaillant,43890,303055,2022-01-10
CASH_OUT,249109,François Vaillant,303055,53946,Agence_mtn_Cotonou,300000,50891,2022-01-11
CASH_IN,7665,Agence_mtn_Abomey,300000,292335,François Vaillant,53946,61611,2022-01-11
CASH_IN,75705,Agence_mtn_Cotonou,300000,224295,François Vaillant,61611,137316,2022-01-14
CASH_OUT,135032,François Vaillant,137316,2284,Agence_mtn_Cotonou,300000,164968,2022-01-14
TRANSFER,1024,François Vaillant,2284,1260,Thérèse-Juliette Camus,823400,822376,2022-01-15
CASH_IN,223659,Agence_mtn_Ouidah,300000,76341,François Vaillant,1260,224919,2022-01-16
TRANSFER,370409,Georges-Alfred Pruvost,1055573,685164,François Vaillant,224919,595328,2022-01-17
TRANSFER,499799,François Vaillant,595328,95529,Raymond Simon,110801,-388998,2022-01-18
CASH_IN,103886,Agence_mtn_Abomey,300000,196114,François Vaillant,95529,199415,2022-01-20
CASH_IN,218847,Agence_mtn_Abomey,300000,81153,François Vaillant,199415,418262,2022-01-23
CASH_IN,142425,Agence_mtn_Abomey,300000,157575,François Vaillant,418262,560687,2022-01-25
CASH_OUT,320741,François Vaillant,560687,239946,Agence_mtn_Cotonou,300000,-20741,2022-01-27
CASH_OUT,51568,François Vaillant,239946,188378,Agence_mtn_Abomey,300000,248432,2022-01-27
TRANSFER,125070,Olivier Benard,252157,127087,François Vaillant,188378,313448,2022-01-27
CASH_IN,43036,Agence_mtn_Cotonou,300000,256964,Jacques Marchand,-420598,-377562,2022-01-01
CASH_IN,288464,Agence_mtn_Abomey,300000,11536,Jacques Marchand,-377562,-89098,2022-01-01
CASH_IN,146776,Agence_mtn_Ouidah,300000,153224,Jacques Marchand,-89098,57678,2022-01-02
CASH_OUT,42308,Jacques Marchand,57678,15370,Agence_mtn_Cotonou,300000,257692,2022-01-06
CASH_OUT,13420,Jacques Marchand,15370,1950,Agence_mtn_Abomey,300000,286580,2022-01-08
CASH_IN,192367,Agence_mtn_Ouidah,300000,107633,Jacques Marchand,1950,194317,2022-01-09
CASH_OUT,23404,Jacques Marchand,194317,170913,Agence_mtn_Ouidah,300000,276596,2022-01-09
TRANSFER,119144,Jacques Le Marion,143623,24479,Jacques Marchand,170913,290057,2022-01-13
CASH_IN,158189,Agence_mtn_Abomey,300000,141811,Jacques Marchand,290057,448246,2022-01-15
TRANSFER,227621,Alexandre Delaunay,389835,162214,Jacques Marchand,448246,675867,2022-01-16
CASH_OUT,127873,Jacques Marchand,675867,547994,Agence_mtn_Cotonou,300000,172127,2022-01-17
TRANSFER,489469,Jacques Marchand,547994,58525,Emmanuelle Le Allain,25730,-463739,2022-01-17
TRANSFER,242,Louise-Aurore Payet,92898,92656,Jacques Marchand,58525,58767,2022-01-19
TRANSFER,37168,Jacques Marchand,58767,21599,Nicolas Blin,59972,22804,2022-01-19
CASH_OUT,7431,Jacques Marchand,21599,14168,Agence_mtn_Abomey,300000,292569,2022-01-21
CASH_IN,26169,Agence_mtn_Abomey,300000,273831,Jacques Marchand,14168,40337,2022-01-21
CASH_IN,191885,Agence_mtn_Ouidah,300000,108115,Jacques Marchand,40337,232222,2022-01-22
TRANSFER,4864,Madeleine Philippe-Grondin,72305,67441,Jacques Marchand,232222,237086,2022-01-22
CASH_OUT,118056,Jacques Marchand,237086,119030,Agence_mtn_Ouidah,300000,181944,2022-01-23
CASH_OUT,52948,Jacques Marchand,119030,66082,Agence_mtn_Cotonou,300000,247052,2022-01-24
TRANSFER,136784,Alexandre Delaunay,162214,25430,Jacques Marchand,66082,202866,2022-01-25
CASH_IN,102184,Agence_mtn_Cotonou,300000,197816,Jacques Marchand,202866,305050,2022-01-25
CASH_OUT,6849,Jacques Marchand,305050,298201,Agence_mtn_Cotonou,300000,293151,2022-01-26
CASH_IN,150122,Agence_mtn_Cotonou,300000,149878,Jacques Marchand,298201,448323,2022-01-27
CASH_IN,29995,Agence_mtn_Ouidah,300000,270005,Gilbert Moulin,-231430,-201435,2022-01-01
CASH_IN,278815,Agence_mtn_Cotonou,300000,21185,Gilbert Moulin,-201435,77380,2022-01-03
CASH_IN,277773,Agence_mtn_Abomey,300000,22227,Gilbert Moulin,77380,355153,2022-01-03
CASH_IN,146856,Agence_mtn_Ouidah,300000,153144,Gilbert Moulin,355153,502009,2022-01-04
CASH_IN,902,Agence_mtn_Cotonou,300000,299098,Gilbert Moulin,502009,502911,2022-01-05
TRANSFER,318843,Georges-Alfred Pruvost,685164,366321,Gilbert Moulin,502911,821754,2022-01-09
TRANSFER,440496,Gilbert Moulin,821754,381258,Simone du Allard,1889200,1448704,2022-01-09
TRANSFER,752898,Henri de Didier,1903546,1150648,Gilbert Moulin,381258,1134156,2022-01-09
CASH_IN,200865,Agence_mtn_Cotonou,300000,99135,Gilbert Moulin,1134156,1335021,2022-01-10
TRANSFER,1886751,Nicole-Renée Gay,1955500,68749,Gilbert Moulin,1335021,3221772,2022-01-10
CASH_IN,206455,Agence_mtn_Cotonou,300000,93545,Gilbert Moulin,3221772,3428227,2022-01-11
CASH_OUT,1773208,Gilbert Moulin,3428227,1655019,Agence_mtn_Abomey,300000,-1473208,2022-01-11
TRANSFER,440569,Gilbert Moulin,1655019,1214450,Gilbert Moulin,1655019,2095588,2022-01-11
TRANSFER,1053535,Gilbert Moulin,1214450,160915,Raymond de Le Roux,571551,-481984,2022-01-13
CASH_OUT,22690,Gilbert Moulin,160915,138225,Agence_mtn_Cotonou,300000,277310,2022-01-14
CASH_IN,84890,Agence_mtn_Ouidah,300000,215110,Gilbert Moulin,138225,223115,2022-01-15
CASH_IN,90319,Agence_mtn_Cotonou,300000,209681,Gilbert Moulin,223115,313434,2022-01-15
TRANSFER,684,Raymond-Yves Boulanger,1668,984,Gilbert Moulin,313434,314118,2022-01-21
CASH_OUT,100067,Gilbert Moulin,314118,214051,Agence_mtn_Abomey,300000,199933,2022-01-22
CASH_OUT,80794,Gilbert Moulin,214051,133257,Agence_mtn_Abomey,300000,219206,2022-01-22
CASH_OUT,13962,Gilbert Moulin,133257,119295,Agence_mtn_Cotonou,300000,286038,2022-01-23
CASH_IN,269214,Agence_mtn_Abomey,300000,30786,Gilbert Moulin,119295,388509,2022-01-26
TRANSFER,308367,Simone du Allard,1448704,1140337,Gilbert Moulin,388509,696876,2022-01-27
CASH_IN,37007,Agence_mtn_Abomey,300000,262993,Céline-Inès Meunier,220,37227,2022-01-01
CASH_OUT,10589,Céline-Inès Meunier,37227,26638,Agence_mtn_Ouidah,300000,289411,2022-01-02
TRANSFER,8642,Céline-Inès Meunier,26638,17996,Aimé Bernier,1755900,1747258,2022-01-04
CASH_OUT,9682,Céline-Inès Meunier,17996,8314,Agence_mtn_Ouidah,300000,290318,2022-01-04
CASH_OUT,5288,Céline-Inès Meunier,8314,3026,Agence_mtn_Ouidah,300000,294712,2022-01-05
CASH_IN,78898,Agence_mtn_Abomey,300000,221102,Céline-Inès Meunier,3026,81924,2022-01-05
CASH_OUT,32256,Céline-Inès Meunier,81924,49668,Agence_mtn_Cotonou,300000,267744,2022-01-06
CASH_OUT,4631,Céline-Inès Meunier,49668,45037,Agence_mtn_Cotonou,300000,295369,2022-01-07
TRANSFER,119669,Sabine Perrier,123261,3592,Céline-Inès Meunier,45037,164706,2022-01-07
CASH_OUT,164577,Céline-Inès Meunier,164706,129,Agence_mtn_Ouidah,300000,135423,2022-01-08
CASH_OUT,120,Céline-Inès Meunier,129,9,Agence_mtn_Ouidah,300000,299880,2022-01-09
CASH_IN,268912,Agence_mtn_Cotonou,300000,31088,Céline-Inès Meunier,9,268921,2022-01-10
TRANSFER,160000,Céline-Inès Meunier,268921,108921,Jean Guilbert-Lenoir,1699199,1539199,2022-01-11
CASH_IN,154373,Agence_mtn_Ouidah,300000,145627,Céline-Inès Meunier,108921,263294,2022-01-13
CASH_IN,31144,Agence_mtn_Cotonou,300000,268856,Céline-Inès Meunier,263294,294438,2022-01-14
TRANSFER,112915,Céline-Inès Meunier,294438,181523,Gabrielle Hamon,173226,60311,2022-01-15
CASH_OUT,8484,Céline-Inès Meunier,181523,173039,Agence_mtn_Ouidah,300000,291516,2022-01-16
CASH_OUT,14156,Céline-Inès Meunier,173039,158883,Agence_mtn_Ouidah,300000,285844,2022-01-16
CASH_OUT,38123,Céline-Inès Meunier,158883,120760,Agence_mtn_Abomey,300000,261877,2022-01-16
CASH_OUT,41443,Céline-Inès Meunier,120760,79317,Agence_mtn_Ouidah,300000,258557,2022-01-17
CASH_IN,53675,Agence_mtn_Cotonou,300000,246325,Céline-Inès Meunier,79317,132992,2022-01-17
CASH_OUT,103237,Céline-Inès Meunier,132992,29755,Agence_mtn_Ouidah,300000,196763,2022-01-21
CASH_IN,35804,Agence_mtn_Ouidah,300000,264196,Céline-Inès Meunier,29755,65559,2022-01-22
CASH_IN,86960,Agence_mtn_Abomey,300000,213040,Céline-Inès Meunier,65559,152519,2022-01-23
CASH_IN,31802,Agence_mtn_Abomey,300000,268198,Céline-Inès Meunier,152519,184321,2022-01-25
CASH_OUT,36019,Céline-Inès Meunier,184321,148302,Agence_mtn_Cotonou,300000,263981,2022-01-25
CASH_OUT,5648,Céline-Inès Meunier,148302,142654,Agence_mtn_Abomey,300000,294352,2022-01-27
CASH_IN,109201,Agence_mtn_Ouidah,300000,190799,Céline-Inès Meunier,142654,251855,2022-01-27
CASH_OUT,54361,Céline-Inès Meunier,251855,197494,Agence_mtn_Abomey,300000,245639,2022-01-27
CASH_IN,6226,Agence_mtn_Abomey,300000,293774,Pénélope Boulay,-97183,-90957,2022-01-01
CASH_IN,87937,Agence_mtn_Ouidah,300000,212063,Pénélope Boulay,-90957,-3020,2022-01-05
CASH_IN,93190,Agence_mtn_Cotonou,300000,206810,Pénélope Boulay,-3020,90170,2022-01-08
CASH_IN,50024,Agence_mtn_Cotonou,300000,249976,Pénélope Boulay,90170,140194,2022-01-09
CASH_OUT,122907,Pénélope Boulay,140194,17287,Agence_mtn_Abomey,300000,177093,2022-01-11
CASH_OUT,3441,Pénélope Boulay,17287,13846,Agence_mtn_Ouidah,300000,296559,2022-01-13
TRANSFER,560515,Georges Muller,1369531,809016,Pénélope Boulay,13846,574361,2022-01-14
TRANSFER,47083,Élisabeth Blot-Bruneau,153355,106272,Pénélope Boulay,574361,621444,2022-01-16
TRANSFER,65068,Georges-Alfred Pruvost,366321,301253,Pénélope Boulay,621444,686512,2022-01-16
CASH_IN,186115,Agence_mtn_Abomey,300000,113885,Pénélope Boulay,686512,872627,2022-01-17
TRANSFER,1218494,Aimé Bernier,1747258,528764,Pénélope Boulay,872627,2091121,2022-01-17
TRANSFER,2027225,Pénélope Boulay,2091121,63896,Georges Muller,809016,-1218209,2022-01-20
CASH_IN,280899,Agence_mtn_Abomey,300000,19101,Pénélope Boulay,63896,344795,2022-01-22
CASH_IN,108728,Agence_mtn_Abomey,300000,191272,Pénélope Boulay,344795,453523,2022-01-23
CASH_OUT,939,Pénélope Boulay,453523,452584,Agence_mtn_Cotonou,300000,299061,2022-01-23
CASH_IN,56262,Agence_mtn_Abomey,300000,243738,Pénélope Boulay,452584,508846,2022-01-24
CASH_IN,27195,Agence_mtn_Ouidah,300000,272805,Pénélope Boulay,508846,536041,2022-01-25
TRANSFER,442879,Pénélope Boulay,536041,93162,Nicolas Blin,22804,-420075,2022-01-26
CASH_IN,65751,Agence_mtn_Ouidah,300000,234249,Pénélope Boulay,93162,158913,2022-01-26
CASH_IN,109038,Agence_mtn_Ouidah,300000,190962,Pénélope Boulay,158913,267951,2022-01-27
CASH_IN,280651,Agence_mtn_Abomey,300000,19349,Emmanuelle Le Allain,-463739,-183088,2022-01-04
CASH_IN,75653,Agence_mtn_Cotonou,300000,224347,Emmanuelle Le Allain,-183088,-107435,2022-01-05
CASH_IN,208090,Agence_mtn_Cotonou,300000,91910,Emmanuelle Le Allain,-107435,100655,2022-01-06
CASH_OUT,95647,Emmanuelle Le Allain,100655,5008,Agence_mtn_Cotonou,300000,204353,2022-01-09
CASH_OUT,304,Emmanuelle Le Allain,5008,4704,Agence_mtn_Ouidah,300000,299696,2022-01-11
CASH_OUT,128,Emmanuelle Le Allain,4704,4576,Agence_mtn_Ouidah,300000,299872,2022-01-12
CASH_OUT,2379,Emmanuelle Le Allain,4576,2197,Agence_mtn_Cotonou,300000,297621,2022-01-14
CASH_OUT,1266,Emmanuelle Le Allain,2197,931,Agence_mtn_Abomey,300000,298734,2022-01-15
CASH_IN,50104,Agence_mtn_Cotonou,300000,249896,Emmanuelle Le Allain,931,51035,2022-01-16
CASH_IN,38941,Agence_mtn_Ouidah,300000,261059,Emmanuelle Le Allain,51035,89976,2022-01-19
CASH_OUT,78767,Emmanuelle Le Allain,89976,11209,Agence_mtn_Ouidah,300000,221233,2022-01-20
TRANSFER,151634,Christophe Besnard-Diaz,337865,186231,Emmanuelle Le Allain,11209,162843,2022-01-21
TRANSFER,75874,Emmanuelle Le Allain,162843,86969,Robert Henry-Poulain,29200,-46674,2022-01-22
CASH_IN,84408,Agence_mtn_Ouidah,300000,215592,Emmanuelle Le Allain,86969,171377,2022-01-23
CASH_IN,187039,Agence_mtn_Abomey,300000,112961,Emmanuelle Le Allain,171377,358416,2022-01-23
CASH_OUT,299645,Emmanuelle Le Allain,358416,58771,Agence_mtn_Ouidah,300000,355,2022-01-23
CASH_OUT,103204,Simone du Allard,1140337,1037133,Agence_mtn_Abomey,300000,196796,2022-01-02
TRANSFER,244572,Simone du Allard,1037133,792561,Margot Julien,584305,339733,2022-01-04
TRANSFER,40024,Nicole-Renée Gay,68749,28725,Simone du Allard,792561,832585,2022-01-05
CASH_OUT,665000,Simone du Allard,832585,167585,Agence_mtn_Abomey,300000,-365000,2022-01-05
TRANSFER,77369,Simone du Allard,167585,90216,Madeleine Philippe-Grondin,67441,-9928,2022-01-06
CASH_OUT,64788,Simone du Allard,90216,25428,Agence_mtn_Ouidah,300000,235212,2022-01-07
TRANSFER,246180,Louis du Boyer,782792,536612,Simone du Allard,25428,271608,2022-01-10
TRANSFER,164117,Simone du Allard,271608,107491,Simone du Allard,271608,435725,2022-01-13
TRANSFER,12506,Simone du Allard,107491,94985,Henri de Didier,1150648,1138142,2022-01-13
TRANSFER,43274,Valérie de Pottier,219990,176716,Simone du Allard,94985,138259,2022-01-15
CASH_IN,14066,Agence_mtn_Cotonou,300000,285934,Simone du Allard,138259,152325,2022-01-17
TRANSFER,66701,Louise-Aurore Payet,92656,25955,Simone du Allard,152325,219026,2022-01-18
CASH_IN,254566,Agence_mtn_Abomey,300000,45434,Simone du Allard,219026,473592,2022-01-23
TRANSFER,3591,Sabine Perrier,3592,1,Simone du Allard,473592,477183,2022-01-25
CASH_IN,268568,Agence_mtn_Cotonou,300000,31432,Simone du Allard,477183,745751,2022-01-25
CASH_OUT,436872,Simone du Allard,745751,308879,Agence_mtn_Abomey,300000,-136872,2022-01-25
CASH_OUT,272989,Simone du Allard,308879,35890,Agence_mtn_Ouidah,300000,27011,2022-01-26
CASH_OUT,13666,Simone du Allard,35890,22224,Agence_mtn_Cotonou,300000,286334,2022-01-26
CASH_OUT,20533,Simone du Allard,22224,1691,Agence_mtn_Ouidah,300000,279467,2022-01-26
CASH_OUT,475,Simone du Allard,1691,1216,Agence_mtn_Cotonou,300000,299525,2022-01-27
TRANSFER,10721,Alexandre Delaunay,25430,14709,Roland Huet,1530600,1541321,2022-01-03
CASH_IN,51063,Agence_mtn_Ouidah,300000,248937,Roland Huet,1541321,1592384,2022-01-07
CASH_IN,482,Agence_mtn_Abomey,300000,299518,Roland Huet,1592384,1592866,2022-01-10
CASH_IN,106052,Agence_mtn_Ouidah,300000,193948,Roland Huet,1592866,1698918,2022-01-13
CASH_IN,280491,Agence_mtn_Cotonou,300000,19509,Roland Huet,1698918,1979409,2022-01-17
CASH_IN,212885,Agence_mtn_Abomey,300000,87115,Roland Huet,1979409,2192294,2022-01-24
TRANSFER,1864254,Roland Huet,2192294,328040,Clémence Dufour,1758411,-105843,2022-01-27
CASH_IN,137805,Agence_mtn_Ouidah,300000,162195,Roland Huet,328040,465845,2022-01-27
CASH_OUT,414777,Thérèse-Juliette Camus,822376,407599,Agence_mtn_Abomey,300000,-114777,2022-01-01
CASH_OUT,286704,Thérèse-Juliette Camus,407599,120895,Agence_mtn_Abomey,300000,13296,2022-01-02
CASH_OUT,34687,Thérèse-Juliette Camus,120895,86208,Agence_mtn_Ouidah,300000,265313,2022-01-03
TRANSFER,33096,Louis du Boyer,536612,503516,Thérèse-Juliette Camus,86208,119304,2022-01-05
CASH_IN,85930,Agence_mtn_Ouidah,300000,214070,Thérèse-Juliette Camus,119304,205234,2022-01-06
CASH_IN,261768,Agence_mtn_Abomey,300000,38232,Thérèse-Juliette Camus,205234,467002,2022-01-08
CASH_OUT,359423,Thérèse-Juliette Camus,467002,107579,Agence_mtn_Cotonou,300000,-59423,2022-01-09
CASH_IN,141459,Agence_mtn_Cotonou,300000,158541,Thérèse-Juliette Camus,107579,249038,2022-01-10
CASH_OUT,234606,Thérèse-Juliette Camus,249038,14432,Agence_mtn_Cotonou,300000,65394,2022-01-11
CASH_OUT,4063,Thérèse-Juliette Camus,14432,10369,Agence_mtn_Abomey,300000,295937,2022-01-12
CASH_OUT,8879,Thérèse-Juliette Camus,10369,1490,Agence_mtn_Cotonou,300000,291121,2022-01-15
CASH_OUT,728,Thérèse-Juliette Camus,1490,762,Agence_mtn_Cotonou,300000,299272,2022-01-15
CASH_IN,152456,Agence_mtn_Cotonou,300000,147544,Thérèse-Juliette Camus,762,153218,2022-01-17
CASH_OUT,132830,Thérèse-Juliette Camus,153218,20388,Agence_mtn_Abomey,300000,167170,2022-01-20
CASH_OUT,14757,Thérèse-Juliette Camus,20388,5631,Agence_mtn_Ouidah,300000,285243,2022-01-21
CASH_OUT,348,Thérèse-Juliette Camus,5631,5283,Agence_mtn_Ouidah,300000,299652,2022-01-27
CASH_OUT,104946,Élisabeth Blot-Bruneau,106272,1326,Agence_mtn_Abomey,300000,195054,2022-01-03
CASH_OUT,1113,Élisabeth Blot-Bruneau,1326,213,Agence_mtn_Ouidah,300000,298887,2022-01-05
TRANSFER,101,Élisabeth Blot-Bruneau,213,112,Élisabeth Blot-Bruneau,213,314,2022-01-07
TRANSFER,100,Élisabeth Blot-Bruneau,112,12,Emmanuel Legrand,1418900,1418800,2022-01-07
CASH_IN,195496,Agence_mtn_Cotonou,300000,104504,Élisabeth Blot-Bruneau,12,195508,2022-01-08
TRANSFER,3822,Jules-Marc Chauvet,13723,9901,Élisabeth Blot-Bruneau,195508,199330,2022-01-08
TRANSFER,23986,Élisabeth Blot-Bruneau,199330,175344,Louise-Aurore Payet,25955,1969,2022-01-08
CASH_IN,70639,Agence_mtn_Ouidah,300000,229361,Élisabeth Blot-Bruneau,175344,245983,2022-01-12
CASH_IN,258350,Agence_mtn_Ouidah,300000,41650,Élisabeth Blot-Bruneau,245983,504333,2022-01-14
CASH_IN,299664,Agence_mtn_Abomey,300000,336,Élisabeth Blot-Bruneau,504333,803997,2022-01-16
TRANSFER,16889,Jérôme Laporte Le Gauthier,20601,3712,Élisabeth Blot-Bruneau,803997,820886,2022-01-18
TRANSFER,662201,Élisabeth Blot-Bruneau,820886,158685,Élisabeth Blot-Bruneau,820886,158685,2022-01-19
TRANSFER,395763,Louis du Boyer,503516,107753,Élisabeth Blot-Bruneau,158685,554448,2022-01-20
TRANSFER,21880,Michèle Faivre,428525,406645,Élisabeth Blot-Bruneau,554448,576328,2022-01-22
CASH_OUT,555801,Élisabeth Blot-Bruneau,576328,20527,Agence_mtn_Cotonou,300000,-255801,2022-01-25
CASH_IN,9948,Agence_mtn_Cotonou,300000,290052,Élisabeth Blot-Bruneau,20527,30475,2022-01-27
CASH_IN,205980,Agence_mtn_Ouidah,300000,94020,Robert Henry-Poulain,-46674,159306,2022-01-01
CASH_OUT,40704,Robert Henry-Poulain,159306,118602,Agence_mtn_Ouidah,300000,259296,2022-01-03
TRANSFER,676528,Jean Guilbert-Lenoir,1539199,862671,Robert Henry-Poulain,118602,795130,2022-01-04
CASH_IN,124492,Agence_mtn_Abomey,300000,175508,Robert Henry-Poulain,795130,919622,2022-01-06
CASH_OUT,825857,Robert Henry-Poulain,919622,93765,Agence_mtn_Abomey,300000,-525857,2022-01-06
CASH_OUT,60738,Robert Henry-Poulain,93765,33027,Agence_mtn_Ouidah,300000,239262,2022-01-09
TRANSFER,19929,Nicole-Renée Gay,28725,8796,Robert Henry-Poulain,33027,52956,2022-01-12
CASH_IN,211571,Agence_mtn_Abomey,300000,88429,Robert Henry-Poulain,52956,264527,2022-01-13
CASH_OUT,166566,Robert Henry-Poulain,264527,97961,Agence_mtn_Ouidah,300000,133434,2022-01-16
CASH_IN,185828,Agence_mtn_Ouidah,300000,114172,Robert Henry-Poulain,97961,283789,2022-01-16
CASH_OUT,252299,Robert Henry-Poulain,283789,31490,Agence_mtn_Abomey,300000,47701,2022-01-22
TRANSFER,39641,Louis du Boyer,107753,68112,Robert Henry-Poulain,31490,71131,2022-01-26
TRANSFER,14218,Jacques Le Marion,24479,10261,Robert Henry-Poulain,71131,85349,2022-01-27
CASH_IN,174958,Agence_mtn_Ouidah,300000,125042,Aurélie Maury,-137200,37758,2022-01-03
TRANSFER,35854,Aurélie Maury,37758,1904,Nicole-Renée Gay,8796,-27058,2022-01-09
CASH_OUT,841,Aurélie Maury,1904,1063,Agence_mtn_Abomey,300000,299159,2022-01-09
TRANSFER,26032,Christine Rossi,125706,99674,Aurélie Maury,1063,27095,2022-01-09
CASH_IN,210815,Agence_mtn_Cotonou,300000,89185,Aurélie Maury,27095,237910,2022-01-10
CASH_OUT,168923,Aurélie Maury,237910,68987,Agence_mtn_Cotonou,300000,131077,2022-01-11
CASH_IN,187769,Agence_mtn_Cotonou,300000,112231,Aurélie Maury,68987,256756,2022-01-15
TRANSFER,504445,Jean Guilbert-Lenoir,862671,358226,Aurélie Maury,256756,761201,2022-01-22
TRANSFER,428828,Aurélie Maury,761201,332373,Louise-Aurore Payet,1969,-426859,2022-01-23
CASH_OUT,165306,Aurélie Maury,332373,167067,Agence_mtn_Ouidah,300000,134694,2022-01-23
CASH_IN,2729,Agence_mtn_Ouidah,300000,297271,Olivier Benard,127087,129816,2022-01-02
CASH_IN,52462,Agence_mtn_Cotonou,300000,247538,Olivier Benard,129816,182278,2022-01-02
CASH_IN,100982,Agence_mtn_Cotonou,300000,199018,Olivier Benard,182278,283260,2022-01-07
CASH_OUT,22871,Olivier Benard,283260,260389,Agence_mtn_Cotonou,300000,277129,2022-01-15
TRANSFER,480116,Véronique Hardy,883000,402884,Olivier Benard,260389,740505,2022-01-20
TRANSFER,68470,Christine Rossi,99674,31204,Olivier Benard,740505,808975,2022-01-22
CASH_OUT,803237,Olivier Benard,808975,5738,Agence_mtn_Abomey,300000,-503237,2022-01-22
CASH_IN,104096,Agence_mtn_Cotonou,300000,195904,Sabine Perrier,1,104097,2022-01-06
CASH_OUT,35520,Sabine Perrier,104097,68577,Agence_mtn_Ouidah,300000,264480,2022-01-07
CASH_IN,261383,Agence_mtn_Abomey,300000,38617,Sabine Perrier,68577,329960,2022-01-09
CASH_OUT,235576,Sabine Perrier,329960,94384,Agence_mtn_Cotonou,300000,64424,2022-01-09
CASH_OUT,16560,Sabine Perrier,94384,77824,Agence_mtn_Ouidah,300000,283440,2022-01-13
CASH_OUT,15128,Sabine Perrier,77824,62696,Agence_mtn_Abomey,300000,284872,2022-01-16
CASH_IN,106089,Agence_mtn_Abomey,300000,193911,Sabine Perrier,62696,168785,2022-01-18
CASH_IN,75229,Agence_mtn_Cotonou,300000,224771,Sabine Perrier,168785,244014,2022-01-20
CASH_OUT,12526,Sabine Perrier,244014,231488,Agence_mtn_Ouidah,300000,287474,2022-01-24
CASH_OUT,42403,Sabine Perrier,231488,189085,Agence_mtn_Ouidah,300000,257597,2022-01-25
CASH_IN,273212,Agence_mtn_Ouidah,300000,26788,Madeleine Philippe-Grondin,-9928,263284,2022-01-03
CASH_OUT,146055,Madeleine Philippe-Grondin,263284,117229,Agence_mtn_Abomey,300000,153945,2022-01-04
TRANSFER,29168,Madeleine Philippe-Grondin,117229,88061,Christophe Besnard-Diaz,186231,157063,2022-01-04
CASH_IN,165796,Agence_mtn_Abomey,300000,134204,Madeleine Philippe-Grondin,88061,253857,2022-01-07
CASH_IN,119202,Agence_mtn_Ouidah,300000,180798,Madeleine Philippe-Grondin,253857,373059,2022-01-07
CASH_OUT,318727,Madeleine Philippe-Grondin,373059,54332,Agence_mtn_Abomey,300000,-18727,2022-01-08
CASH_OUT,13434,Madeleine Philippe-Grondin,54332,40898,Agence_mtn_Ouidah,300000,286566,2022-01-10
CASH_OUT,7170,Madeleine Philippe-Grondin,40898,33728,Agence_mtn_Abomey,300000,292830,2022-01-12
CASH_IN,78363,Agence_mtn_Cotonou,300000,221637,Madeleine Philippe-Grondin,33728,112091,2022-01-15
TRANSFER,38862,Madeleine Philippe-Grondin,112091,73229,Hélène Blanchard-Renault,1338400,1299538,2022-01-16
TRANSFER,58183,Madeleine Philippe-Grondin,73229,15046,Jean Guilbert-Lenoir,358226,300043,2022-01-19
TRANSFER,31588,Christophe Besnard-Diaz,157063,125475,Madeleine Philippe-Grondin,15046,46634,2022-01-22
CASH_IN,45472,Agence_mtn_Ouidah,300000,254528,Madeleine Philippe-Grondin,46634,92106,2022-01-24
CASH_OUT,14016,Madeleine Philippe-Grondin,92106,78090,Agence_mtn_Cotonou,300000,285984,2022-01-24
CASH_OUT,47063,Madeleine Philippe-Grondin,78090,31027,Agence_mtn_Ouidah,300000,252937,2022-01-25
CASH_OUT,7559,Madeleine Philippe-Grondin,31027,23468,Agence_mtn_Ouidah,300000,292441,2022-01-26
CASH_IN,112890,Agence_mtn_Cotonou,300000,187110,Henri de Didier,1138142,1251032,2022-01-05
CASH_IN,131027,Agence_mtn_Cotonou,300000,168973,Henri de Didier,1251032,1382059,2022-01-06
CASH_IN,22218,Agence_mtn_Abomey,300000,277782,Henri de Didier,1382059,1404277,2022-01-07
TRANSFER,12887,Astrid de Pascal,137300,124413,Henri de Didier,1404277,1417164,2022-01-11
CASH_IN,92780,Agence_mtn_Ouidah,300000,207220,Henri de Didier,1417164,1509944,2022-01-11
TRANSFER,1313007,Henri de Didier,1509944,196937,Margot Julien,339733,-973274,2022-01-12
TRANSFER,33111,Henri de Didier,196937,163826,Henri de Didier,196937,163826,2022-01-13
CASH_OUT,26317,Henri de Didier,163826,137509,Agence_mtn_Ouidah,300000,273683,2022-01-14
TRANSFER,131964,Henri de Didier,137509,5545,Christophe Besnard-Diaz,125475,-6489,2022-01-17
CASH_OUT,139,Henri de Didier,5545,5406,Agence_mtn_Ouidah,300000,299861,2022-01-18
TRANSFER,3547,Jérôme Laporte Le Gauthier,3712,165,Henri de Didier,5406,8953,2022-01-21
CASH_IN,295623,Agence_mtn_Cotonou,300000,4377,Henri de Didier,8953,304576,2022-01-23
CASH_IN,5295,Agence_mtn_Ouidah,300000,294705,Henri de Didier,304576,309871,2022-01-24
CASH_IN,124469,Agence_mtn_Abomey,300000,175531,Henri de Didier,309871,434340,2022-01-26
CASH_IN,2421,Agence_mtn_Ouidah,300000,297579,Henri de Didier,434340,436761,2022-01-27
CASH_OUT,283695,Henri de Didier,436761,153066,Agence_mtn_Cotonou,300000,16305,2022-01-27
TRANSFER,119334,Astrid de Pascal,124413,5079,Jean Guilbert-Lenoir,300043,180709,2022-01-01
CASH_IN,151680,Agence_mtn_Ouidah,300000,148320,Astrid de Pascal,5079,156759,2022-01-02
TRANSFER,401200,Véronique Hardy,402884,1684,Astrid de Pascal,156759,557959,2022-01-02
CASH_OUT,82584,Astrid de Pascal,557959,475375,Agence_mtn_Cotonou,300000,217416,2022-01-03
CASH_IN,88435,Agence_mtn_Abomey,300000,211565,Astrid de Pascal,475375,563810,2022-01-04
TRANSFER,26124,Christine Rossi,31204,5080,Astrid de Pascal,563810,589934,2022-01-05
CASH_IN,250389,Agence_mtn_Cotonou,300000,49611,Astrid de Pascal,589934,840323,2022-01-06
TRANSFER,738962,Hélène Blanchard-Renault,1299538,560576,Astrid de Pascal,840323,1579285,2022-01-10
TRANSFER,336363,Astrid de Pascal,1579285,1242922,Danielle-Henriette Tessier,15285,-321078,2022-01-10
CASH_OUT,368619,Astrid de Pascal,1242922,874303,Agence_mtn_Cotonou,300000,-68619,2022-01-10
CASH_OUT,167927,Astrid de Pascal,874303,706376,Agence_mtn_Cotonou,300000,132073,2022-01-10
CASH_IN,125940,Agence_mtn_Abomey,300000,174060,Astrid de Pascal,706376,832316,2022-01-11
TRANSFER,261097,Astrid de Pascal,832316,571219,Louis du Boyer,68112,-192985,2022-01-17
TRANSFER,479748,Astrid de Pascal,571219,91471,Hélène Blanchard-Renault,560576,80828,2022-01-20
TRANSFER,10088,Astrid de Pascal,91471,81383,Jacques Le Marion,10261,173,2022-01-23
CASH_OUT,42453,Astrid de Pascal,81383,38930,Agence_mtn_Ouidah,300000,257547,2022-01-24
CASH_IN,250356,Agence_mtn_Cotonou,300000,49644,Thibault-Julien Chevallier,-352625,-102269,2022-01-01
CASH_IN,139491,Agence_mtn_Abomey,300000,160509,Thibault-Julien Chevallier,-102269,37222,2022-01-01
CASH_IN,169371,Agence_mtn_Ouidah,300000,130629,Thibault-Julien Chevallier,37222,206593,2022-01-02
CASH_IN,87868,Agence_mtn_Cotonou,300000,212132,Thibault-Julien Chevallier,206593,294461,2022-01-04
TRANSFER,35991,Gérard Blot de Blanc,356566,320575,Thibault-Julien Chevallier,294461,330452,2022-01-05
CASH_IN,242239,Agence_mtn_Abomey,300000,57761,Thibault-Julien Chevallier,330452,572691,2022-01-07
CASH_OUT,486609,Thibault-Julien Chevallier,572691,86082,Agence_mtn_Abomey,300000,-186609,2022-01-07
TRANSFER,85402,Thibault-Julien Chevallier,86082,680,Valérie de Pottier,176716,91314,2022-01-11
CASH_IN,98034,Agence_mtn_Abomey,300000,201966,Thibault-Julien Chevallier,680,98714,2022-01-14
CASH_OUT,6334,Thibault-Julien Chevallier,98714,92380,Agence_mtn_Ouidah,300000,293666,2022-01-25
TRANSFER,8135,Jules-Marc Chauvet,9901,1766,Thibault-Julien Chevallier,92380,100515,2022-01-27
CASH_OUT,88258,Thibault-Julien Chevallier,100515,12257,Agence_mtn_Cotonou,300000,211742,2022-01-27
CASH_IN,280199,Agence_mtn_Abomey,300000,19801,Élisabeth Delattre,-406217,-126018,2022-01-01
CASH_IN,52721,Agence_mtn_Abomey,300000,247279,Élisabeth Delattre,-126018,-73297,2022-01-03
CASH_IN,93134,Agence_mtn_Abomey,300000,206866,Élisabeth Delattre,-73297,19837,2022-01-03
CASH_IN,200835,Agence_mtn_Abomey,300000,99165,Élisabeth Delattre,19837,220672,2022-01-04
TRANSFER,156058,Élisabeth Delattre,220672,64614,Emmanuel Legrand,1418800,1262742,2022-01-06
CASH_IN,44893,Agence_mtn_Ouidah,300000,255107,Élisabeth Delattre,64614,109507,2022-01-10
CASH_OUT,38122,Élisabeth Delattre,109507,71385,Agence_mtn_Ouidah,300000,261878,2022-01-14
CASH_OUT,42658,Élisabeth Delattre,71385,28727,Agence_mtn_Abomey,300000,257342,2022-01-16
CASH_IN,189348,Agence_mtn_Abomey,300000,110652,Élisabeth Delattre,28727,218075,2022-01-20
CASH_IN,56851,Agence_mtn_Ouidah,300000,243149,Élisabeth Delattre,218075,274926,2022-01-21
TRANSFER,77682,Élisabeth Delattre,274926,197244,Jacques Le Marion,173,-77509,2022-01-21
CASH_IN,268066,Agence_mtn_Abomey,300000,31934,Élisabeth Delattre,197244,465310,2022-01-26
TRANSFER,429781,Élisabeth Delattre,465310,35529,Jérôme Laporte Le Gauthier,165,-429616,2022-01-26
CASH_IN,180667,Agence_mtn_Cotonou,300000,119333,Jacques Le Marion,-77509,103158,2022-01-02
CASH_IN,123868,Agence_mtn_Cotonou,300000,176132,Jacques Le Marion,103158,227026,2022-01-04
CASH_IN,99502,Agence_mtn_Abomey,300000,200498,Jacques Le Marion,227026,326528,2022-01-05
CASH_OUT,91715,Jacques Le Marion,326528,234813,Agence_mtn_Ouidah,300000,208285,2022-01-09
CASH_OUT,98057,Jacques Le Marion,234813,136756,Agence_mtn_Ouidah,300000,201943,2022-01-09
CASH_IN,31390,Agence_mtn_Ouidah,300000,268610,Jacques Le Marion,136756,168146,2022-01-09
CASH_IN,58569,Agence_mtn_Ouidah,300000,241431,Jacques Le Marion,168146,226715,2022-01-14
TRANSFER,203017,Jacques Le Marion,226715,23698,Jean Guilbert-Lenoir,180709,-22308,2022-01-20
TRANSFER,20244,Jacques Le Marion,23698,3454,Aimé Bernier,528764,508520,2022-01-21
CASH_IN,276511,Agence_mtn_Cotonou,300000,23489,Jacques Le Marion,3454,279965,2022-01-22
TRANSFER,152893,Jacques Le Marion,279965,127072,Emmanuel Legrand,1262742,1109849,2022-01-24
CASH_IN,22271,Agence_mtn_Abomey,300000,277729,Roger-Roger Delmas,-53192,-30921,2022-01-03
CASH_IN,62849,Agence_mtn_Cotonou,300000,237151,Roger-Roger Delmas,-30921,31928,2022-01-03
TRANSFER,2983,Alexandre Delaunay,14709,11726,Roger-Roger Delmas,31928,34911,2022-01-03
CASH_OUT,18335,Roger-Roger Delmas,34911,16576,Agence_mtn_Ouidah,300000,281665,2022-01-03
TRANSFER,229569,Michèle Faivre,406645,177076,Roger-Roger Delmas,16576,246145,2022-01-04
CASH_IN,13102,Agence_mtn_Ouidah,300000,286898,Roger-Roger Delmas,246145,259247,2022-01-04
CASH_IN,276123,Agence_mtn_Abomey,300000,23877,Roger-Roger Delmas,259247,535370,2022-01-04
CASH_IN,68066,Agence_mtn_Abomey,300000,231934,Roger-Roger Delmas,535370,603436,2022-01-05
TRANSFER,496,Jules-Marc Chauvet,1766,1270,Roger-Roger Delmas,603436,603932,2022-01-11
CASH_IN,211889,Agence_mtn_Abomey,300000,88111,Roger-Roger Delmas,603932,815821,2022-01-11
CASH_IN,280594,Agence_mtn_Abomey,300000,19406,Roger-Roger Delmas,815821,1096415,2022-01-13
TRANSFER,518434,Roger-Roger Delmas,1096415,577981,Jules-Marc Chauvet,1270,-517164,2022-01-15
CASH_OUT,200071,Roger-Roger Delmas,577981,377910,Agence_mtn_Cotonou,300000,99929,2022-01-15
CASH_IN,91724,Agence_mtn_Abomey,300000,208276,Roger-Roger Delmas,377910,469634,2022-01-20
TRANSFER,122214,Gérard Blot de Blanc,320575,198361,Roger-Roger Delmas,469634,591848,2022-01-21
CASH_OUT,308700,Roger-Roger Delmas,591848,283148,Agence_mtn_Cotonou,300000,-8700,2022-01-22
TRANSFER,264261,Roger-Roger Delmas,283148,18887,Aimé Bernier,508520,244259,2022-01-22
TRANSFER,1205,Véronique Hardy,1684,479,Roger-Roger Delmas,18887,20092,2022-01-24
TRANSFER,12798,Roger-Roger Delmas,20092,7294,Hélène Blanchard-Renault,80828,68030,2022-01-26
CASH_IN,274720,Agence_mtn_Abomey,300000,25280,Georges Muller,-1218209,-943489,2022-01-01
CASH_IN,267702,Agence_mtn_Abomey,300000,32298,Georges Muller,-943489,-675787,2022-01-03
CASH_IN,115264,Agence_mtn_Cotonou,300000,184736,Georges Muller,-675787,-560523,2022-01-06
CASH_IN,22513,Agence_mtn_Abomey,300000,277487,Georges Muller,-560523,-538010,2022-01-07
CASH_IN,123149,Agence_mtn_Abomey,300000,176851,Georges Muller,-538010,-414861,2022-01-09
CASH_IN,277252,Agence_mtn_Abomey,300000,22748,Georges Muller,-414861,-137609,2022-01-10
CASH_IN,15151,Agence_mtn_Abomey,300000,284849,Georges Muller,-137609,-122458,2022-01-11
CASH_IN,243892,Agence_mtn_Abomey,300000,56108,Georges Muller,-122458,121434,2022-01-14
CASH_IN,707,Agence_mtn_Cotonou,300000,299293,Georges Muller,121434,122141,2022-01-14
CASH_OUT,72779,Georges Muller,122141,49362,Agence_mtn_Abomey,300000,227221,2022-01-14
CASH_OUT,8947,Georges Muller,49362,40415,Agence_mtn_Abomey,300000,291053,2022-01-17
CASH_IN,45577,Agence_mtn_Cotonou,300000,254423,Georges Muller,40415,85992,2022-01-19
CASH_OUT,43601,Georges Muller,85992,42391,Agence_mtn_Abomey,300000,256399,2022-01-21
CASH_OUT,27825,Georges Muller,42391,14566,Agence_mtn_Ouidah,300000,272175,2022-01-25
TRANSFER,2896,Valérie de Pottier,91314,88418,Georges Muller,14566,17462,2022-01-27
CASH_IN,38485,Agence_mtn_Cotonou,300000,261515,Danielle-Henriette Tessier,-321078,-282593,2022-01-01
CASH_IN,28060,Agence_mtn_Cotonou,300000,271940,Danielle-Henriette Tessier,-282593,-254533,2022-01-03
CASH_IN,287469,Agence_mtn_Abomey,300000,12531,Danielle-Henriette Tessier,-254533,32936,2022-01-04
CASH_IN,50693,Agence_mtn_Cotonou,300000,249307,Danielle-Henriette Tessier,32936,83629,2022-01-05
TRANSFER,87002,Aimé Bernier,244259,157257,Danielle-Henriette Tessier,83629,170631,2022-01-08
TRANSFER,797779,Emmanuel Legrand,1109849,312070,Danielle-Henriette Tessier,170631,968410,2022-01-10
CASH_IN,106317,Agence_mtn_Ouidah,300000,193683,Danielle-Henriette Tessier,968410,1074727,2022-01-13
TRANSFER,430481,Danielle-Henriette Tessier,1074727,644246,Georges-Alfred Pruvost,301253,-129228,2022-01-13
CASH_OUT,466024,Danielle-Henriette Tessier,644246,178222,Agence_mtn_Ouidah,300000,-166024,2022-01-15
CASH_OUT,171835,Danielle-Henriette Tessier,178222,6387,Agence_mtn_Abomey,300000,128165,2022-01-16
TRANSFER,3741,Christine Rossi,5080,1339,Danielle-Henriette Tessier,6387,10128,2022-01-17
CASH_IN,209350,Agence_mtn_Cotonou,300000,90650,Danielle-Henriette Tessier,10128,219478,2022-01-18
CASH_IN,68324,Agence_mtn_Cotonou,300000,231676,Danielle-Henriette Tessier,219478,287802,2022-01-22
CASH_IN,283809,Agence_mtn_Ouidah,300000,16191,Danielle-Henriette Tessier,287802,571611,2022-01-24
TRANSFER,991,Christine Rossi,1339,348,Danielle-Henriette Tessier,571611,572602,2022-01-27
CASH_OUT,240555,Danielle-Henriette Tessier,572602,332047,Agence_mtn_Ouidah,300000,59445,2022-01-27
CASH_IN,219269,Agence_mtn_Abomey,300000,80731,Louise-Aurore Payet,-426859,-207590,2022-01-01
CASH_IN,140056,Agence_mtn_Cotonou,300000,159944,Louise-Aurore Payet,-207590,-67534,2022-01-03
CASH_IN,293564,Agence_mtn_Ouidah,300000,6436,Louise-Aurore Payet,-67534,226030,2022-01-03
CASH_IN,255732,Agence_mtn_Ouidah,300000,44268,Louise-Aurore Payet,226030,481762,2022-01-03
CASH_IN,276803,Agence_mtn_Abomey,300000,23197,Louise-Aurore Payet,481762,758565,2022-01-06
CASH_IN,72488,Agence_mtn_Ouidah,300000,227512,Louise-Aurore Payet,758565,831053,2022-01-09
TRANSFER,6932,Gérard Blot de Blanc,198361,191429,Louise-Aurore Payet,831053,837985,2022-01-10
CASH_IN,94860,Agence_mtn_Cotonou,300000,205140,Louise-Aurore Payet,837985,932845,2022-01-11
CASH_IN,298126,Agence_mtn_Cotonou,300000,1874,Louise-Aurore Payet,932845,1230971,2022-01-12
CASH_OUT,911180,Louise-Aurore Payet,1230971,319791,Agence_mtn_Ouidah,300000,-611180,2022-01-12
TRANSFER,313103,Louise-Aurore Payet,319791,6688,Alexandre Delaunay,11726,-301377,2022-01-13
CASH_IN,146162,Agence_mtn_Ouidah,300000,153838,Louise-Aurore Payet,6688,152850,2022-01-14
TRANSFER,61655,Louise-Aurore Payet,152850,91195,Valérie de Pottier,88418,26763,2022-01-14
CASH_OUT,15753,Louise-Aurore Payet,91195,75442,Agence_mtn_Cotonou,300000,284247,2022-01-16
CASH_OUT,40332,Louise-Aurore Payet,75442,35110,Agence_mtn_Cotonou,300000,259668,2022-01-19
CASH_OUT,3562,Louise-Aurore Payet,35110,31548,Agence_mtn_Abomey,300000,296438,2022-01-20
TRANSFER,159096,Gérard Blot de Blanc,191429,32333,Louise-Aurore Payet,31548,190644,2022-01-20
CASH_OUT,58643,Louise-Aurore Payet,190644,132001,Agence_mtn_Cotonou,300000,241357,2022-01-20
TRANSFER,100957,Louise-Aurore Payet,132001,31044,Emmanuel Legrand,312070,211113,2022-01-24
TRANSFER,177708,Emmanuel Legrand,211113,33405,Louise-Aurore Payet,31044,208752,2022-01-27
TRANSFER,163927,Michèle Faivre,177076,13149,Gérard Blot de Blanc,32333,-131594,2022-01-01
TRANSFER,5022,Michèle Faivre,13149,8127,Gabrielle Hamon,60311,55289,2022-01-10
CASH_IN,137170,Agence_mtn_Ouidah,300000,162830,Michèle Faivre,8127,145297,2022-01-10
CASH_OUT,135778,Michèle Faivre,145297,9519,Agence_mtn_Ouidah,300000,164222,2022-01-11
CASH_IN,206642,Agence_mtn_Abomey,300000,93358,Michèle Faivre,9519,216161,2022-01-19
CASH_OUT,209960,Michèle Faivre,216161,6201,Agence_mtn_Ouidah,300000,90040,2022-01-22
CASH_IN,119993,Agence_mtn_Ouidah,300000,180007,Clémence Dufour,-105843,14150,2022-01-01
CASH_OUT,3454,Clémence Dufour,14150,10696,Agence_mtn_Abomey,300000,296546,2022-01-03
CASH_OUT,6238,Clémence Dufour,10696,4458,Agence_mtn_Ouidah,300000,293762,2022-01-03
CASH_IN,118508,Agence_mtn_Abomey,300000,181492,Clémence Dufour,4458,122966,2022-01-04
TRANSFER,10941,Clémence Dufour,122966,112025,Emmanuel Legrand,33405,22464,2022-01-06
CASH_IN,200328,Agence_mtn_Ouidah,300000,99672,Clémence Dufour,112025,312353,2022-01-07
TRANSFER,299,Christine Rossi,348,49,Clémence Dufour,312353,312652,2022-01-07
CASH_OUT,229696,Clémence Dufour,312652,82956,Agence_mtn_Ouidah,300000,70304,2022-01-08
TRANSFER,80911,Clémence Dufour,82956,2045,Clémence Dufour,82956,163867,2022-01-09
TRANSFER,415,Clémence Dufour,2045,1630,Clémence Dufour,2045,2460,2022-01-10
CASH_OUT,113,Clémence Dufour,1630,1517,Agence_mtn_Abomey,300000,299887,2022-01-12
CASH_IN,200390,Agence_mtn_Cotonou,300000,99610,Clémence Dufour,1517,201907,2022-01-13
TRANSFER,152,Véronique Hardy,479,327,Clémence Dufour,201907,202059,2022-01-14
CASH_IN,223497,Agence_mtn_Abomey,300000,76503,Clémence Dufour,202059,425556,2022-01-16
CASH_OUT,176466,Clémence Dufour,425556,249090,Agence_mtn_Cotonou,300000,123534,2022-01-17
CASH_OUT,78463,Clémence Dufour,249090,170627,Agence_mtn_Abomey,300000,221537,2022-01-21
CASH_OUT,140235,Clémence Dufour,170627,30392,Agence_mtn_Abomey,300000,159765,2022-01-22
CASH_OUT,10025,Clémence Dufour,30392,20367,Agence_mtn_Cotonou,300000,289975,2022-01-22
TRANSFER,19107,Clémence Dufour,20367,1260,Emmanuel Legrand,22464,3357,2022-01-24
TRANSFER,626,Clémence Dufour,1260,634,Véronique Hardy,327,-299,2022-01-24
CASH_IN,257565,Agence_mtn_Ouidah,300000,42435,Louis du Boyer,-192985,64580,2022-01-07
CASH_OUT,6934,Louis du Boyer,64580,57646,Agence_mtn_Abomey,300000,293066,2022-01-11
CASH_IN,45762,Agence_mtn_Ouidah,300000,254238,Louis du Boyer,57646,103408,2022-01-12
CASH_OUT,102845,Louis du Boyer,103408,563,Agence_mtn_Ouidah,300000,197155,2022-01-12
TRANSFER,297,Louis du Boyer,563,266,Gabrielle Hamon,55289,54992,2022-01-16
CASH_OUT,262,Louis du Boyer,266,4,Agence_mtn_Cotonou,300000,299738,2022-01-19
CASH_IN,12359,Agence_mtn_Abomey,300000,287641,Louis du Boyer,4,12363,2022-01-25
TRANSFER,2357,Louis du Boyer,12363,10006,Valérie de Pottier,26763,24406,2022-01-25
CASH_IN,166452,Agence_mtn_Ouidah,300000,133548,Laurent Marion,-49608,116844,2022-01-01
CASH_OUT,31499,Laurent Marion,116844,85345,Agence_mtn_Cotonou,300000,268501,2022-01-01
CASH_OUT,41004,Laurent Marion,85345,44341,Agence_mtn_Abomey,300000,258996,2022-01-03
CASH_IN,148456,Agence_mtn_Cotonou,300000,151544,Laurent Marion,44341,192797,2022-01-05
CASH_IN,171718,Agence_mtn_Abomey,300000,128282,Laurent Marion,192797,364515,2022-01-05
CASH_IN,9550,Agence_mtn_Cotonou,300000,290450,Laurent Marion,364515,374065,2022-01-12
CASH_IN,132740,Agence_mtn_Cotonou,300000,167260,Laurent Marion,374065,506805,2022-01-14
CASH_IN,284858,Agence_mtn_Ouidah,300000,15142,Laurent Marion,506805,791663,2022-01-15
TRANSFER,610784,Laurent Marion,791663,180879,Aimé Bernier,157257,-453527,2022-01-19
CASH_OUT,137198,Laurent Marion,180879,43681,Agence_mtn_Ouidah,300000,162802,2022-01-20
CASH_IN,36063,Agence_mtn_Ouidah,300000,263937,Laurent Marion,43681,79744,2022-01-20
TRANSFER,31956,Gabrielle Hamon,54992,23036,Laurent Marion,79744,111700,2022-01-20
TRANSFER,75513,Laurent Marion,111700,36187,Valérie de Pottier,24406,-51107,2022-01-23
CASH_OUT,15884,Laurent Marion,36187,20303,Agence_mtn_Abomey,300000,284116,2022-01-26
CASH_IN,184235,Agence_mtn_Cotonou,300000,115765,Laurent Marion,20303,204538,2022-01-26
TRANSFER,527,Emmanuel Legrand,3357,2830,Gabrielle Hamon,23036,22509,2022-01-09
TRANSFER,1634,Emmanuel Legrand,2830,1196,Emmanuel Legrand,2830,4464,2022-01-10
CASH_OUT,655,Emmanuel Legrand,1196,541,Agence_mtn_Cotonou,300000,299345,2022-01-11
CASH_OUT,165,Emmanuel Legrand,541,376,Agence_mtn_Ouidah,300000,299835,2022-01-14
CASH_IN,137751,Agence_mtn_Ouidah,300000,162249,Emmanuel Legrand,376,138127,2022-01-14
CASH_IN,90452,Agence_mtn_Cotonou,300000,209548,Emmanuel Legrand,138127,228579,2022-01-17
CASH_IN,138112,Agence_mtn_Cotonou,300000,161888,Emmanuel Legrand,228579,366691,2022-01-18
TRANSFER,21294,Gabrielle Hamon,22509,1215,Emmanuel Legrand,366691,387985,2022-01-18
TRANSFER,715,Gabrielle Hamon,1215,500,Emmanuel Legrand,387985,388700,2022-01-20
TRANSFER,215178,Emmanuel Legrand,388700,173522,Gabrielle Hamon,500,-214678,2022-01-26
CASH_IN,139193,Agence_mtn_Cotonou,300000,160807,Alexandre Delaunay,-301377,-162184,2022-01-03
CASH_IN,219629,Agence_mtn_Cotonou,300000,80371,Alexandre Delaunay,-162184,57445,2022-01-05
CASH_IN,199676,Agence_mtn_Abomey,300000,100324,Alexandre Delaunay,57445,257121,2022-01-06
TRANSFER,93644,Alexandre Delaunay,257121,163477,Alexandre Delaunay,257121,163477,2022-01-08
CASH_IN,117306,Agence_mtn_Cotonou,300000,182694,Alexandre Delaunay,163477,280783,2022-01-09
CASH_OUT,123550,Alexandre Delaunay,280783,157233,Agence_mtn_Abomey,300000,176450,2022-01-11
CASH_IN,64953,Agence_mtn_Abomey,300000,235047,Alexandre Delaunay,157233,222186,2022-01-12
TRANSFER,88430,Alexandre Delaunay,222186,133756,Alexandre Delaunay,222186,133756,2022-01-12
CASH_OUT,67840,Alexandre Delaunay,133756,65916,Agence_mtn_Abomey,300000,232160,2022-01-13
CASH_OUT,55666,Alexandre Delaunay,65916,10250,Agence_mtn_Cotonou,300000,244334,2022-01-19
CASH_IN,88119,Agence_mtn_Cotonou,300000,211881,Alexandre Delaunay,10250,98369,2022-01-21
CASH_IN,6218,Agence_mtn_Abomey,300000,293782,Alexandre Delaunay,98369,104587,2022-01-26
CASH_IN,217033,Agence_mtn_Ouidah,300000,82967,Alexandre Delaunay,104587,321620,2022-01-26
CASH_OUT,83470,Alexandre Delaunay,321620,238150,Agence_mtn_Ouidah,300000,216530,2022-01-27
CASH_IN,130986,Agence_mtn_Cotonou,300000,169014,Nicole-Renée Gay,-27058,103928,2022-01-04
TRANSFER,60427,Nicole-Renée Gay,103928,43501,Nicole-Renée Gay,103928,43501,2022-01-08
TRANSFER,3226,Nicole-Renée Gay,43501,40275,Nicole-Renée Gay,43501,40275,2022-01-10
CASH_OUT,22927,Nicole-Renée Gay,40275,17348,Agence_mtn_Abomey,300000,277073,2022-01-11
CASH_OUT,5157,Nicole-Renée Gay,17348,12191,Agence_mtn_Cotonou,300000,294843,2022-01-15
CASH_OUT,3536,Nicole-Renée Gay,12191,8655,Agence_mtn_Ouidah,300000,296464,2022-01-17
CASH_OUT,5878,Nicole-Renée Gay,8655,2777,Agence_mtn_Cotonou,300000,294122,2022-01-18
CASH_IN,297429,Agence_mtn_Ouidah,300000,2571,Nicole-Renée Gay,2777,300206,2022-01-19
CASH_OUT,180087,Nicole-Renée Gay,300206,120119,Agence_mtn_Abomey,300000,119913,2022-01-22
CASH_IN,5345,Agence_mtn_Cotonou,300000,294655,Véronique Hardy,-299,5046,2022-01-01
CASH_IN,294892,Agence_mtn_Cotonou,300000,5108,Véronique Hardy,5046,299938,2022-01-01
CASH_OUT,926,Véronique Hardy,299938,299012,Agence_mtn_Abomey,300000,299074,2022-01-02
TRANSFER,61402,Véronique Hardy,299012,237610,Véronique Hardy,299012,237610,2022-01-03
TRANSFER,99100,Véronique Hardy,237610,138510,Véronique Hardy,237610,138510,2022-01-05
CASH_OUT,137183,Véronique Hardy,138510,1327,Agence_mtn_Cotonou,300000,162817,2022-01-08
TRANSFER,965,Véronique Hardy,1327,362,Véronique Hardy,1327,2292,2022-01-12
CASH_OUT,171,Véronique Hardy,362,191,Agence_mtn_Abomey,300000,299829,2022-01-13
CASH_IN,241874,Agence_mtn_Ouidah,300000,58126,Véronique Hardy,191,242065,2022-01-16
CASH_IN,294648,Agence_mtn_Ouidah,300000,5352,Véronique Hardy,242065,536713,2022-01-18
CASH_OUT,352870,Véronique Hardy,536713,183843,Agence_mtn_Abomey,300000,-52870,2022-01-19
CASH_IN,105048,Agence_mtn_Abomey,300000,194952,Véronique Hardy,183843,288891,2022-01-20
CASH_OUT,96359,Véronique Hardy,288891,192532,Agence_mtn_Cotonou,300000,203641,2022-01-24
CASH_IN,47899,Agence_mtn_Cotonou,300000,252101,Julie Germain Le Vaillant,-971751,-923852,2022-01-01
CASH_IN,3358,Agence_mtn_Ouidah,300000,296642,Julie Germain Le Vaillant,-923852,-920494,2022-01-03
CASH_IN,253461,Agence_mtn_Cotonou,300000,46539,Julie Germain Le Vaillant,-920494,-667033,2022-01-05
CASH_IN,148310,Agence_mtn_Ouidah,300000,151690,Julie Germain Le Vaillant,-667033,-518723,2022-01-05
CASH_IN,271910,Agence_mtn_Ouidah,300000,28090,Julie Germain Le Vaillant,-518723,-246813,2022-01-05
CASH_IN,41345,Agence_mtn_Cotonou,300000,258655,Julie Germain Le Vaillant,-246813,-205468,2022-01-11
CASH_IN,297019,Agence_mtn_Cotonou,300000,2981,Julie Germain Le Vaillant,-205468,91551,2022-01-15
CASH_OUT,34276,Julie Germain Le Vaillant,91551,57275,Agence_mtn_Abomey,300000,265724,2022-01-15
CASH_IN,254327,Agence_mtn_Abomey,300000,45673,Julie Germain Le Vaillant,57275,311602,2022-01-15
TRANSFER,88737,Julie Germain Le Vaillant,311602,222865,Julie Germain Le Vaillant,311602,400339,2022-01-16
TRANSFER,102425,Julie Germain Le Vaillant,222865,120440,Julie Germain Le Vaillant,222865,325290,2022-01-18
CASH_IN,253127,Agence_mtn_Abomey,300000,46873,Julie Germain Le Vaillant,120440,373567,2022-01-18
CASH_OUT,199681,Julie Germain Le Vaillant,373567,173886,Agence_mtn_Cotonou,300000,100319,2022-01-18
CASH_IN,168022,Agence_mtn_Cotonou,300000,131978,Julie Germain Le Vaillant,173886,341908,2022-01-23
CASH_OUT,9658,Julie Germain Le Vaillant,341908,332250,Agence_mtn_Cotonou,300000,290342,2022-01-25
CASH_OUT,217429,Julie Germain Le Vaillant,332250,114821,Agence_mtn_Cotonou,300000,82571,2022-01-27
CASH_IN,122266,Agence_mtn_Ouidah,300000,177734,Raymond de Le Roux,-481984,-359718,2022-01-06
CASH_IN,235437,Agence_mtn_Abomey,300000,64563,Raymond de Le Roux,-359718,-124281,2022-01-09
CASH_IN,226542,Agence_mtn_Cotonou,300000,73458,Raymond de Le Roux,-124281,102261,2022-01-10
CASH_IN,113696,Agence_mtn_Cotonou,300000,186304,Raymond de Le Roux,102261,215957,2022-01-12
CASH_IN,73090,Agence_mtn_Ouidah,300000,226910,Raymond de Le Roux,215957,289047,2022-01-14
CASH_OUT,36398,Raymond de Le Roux,289047,252649,Agence_mtn_Abomey,300000,263602,2022-01-19
CASH_OUT,20021,Raymond de Le Roux,252649,232628,Agence_mtn_Abomey,300000,279979,2022-01-22
CASH_OUT,124605,Raymond de Le Roux,232628,108023,Agence_mtn_Abomey,300000,175395,2022-01-23
CASH_OUT,35248,Raymond de Le Roux,108023,72775,Agence_mtn_Cotonou,300000,264752,2022-01-23
CASH_IN,160576,Agence_mtn_Abomey,300000,139424,Margot Julien,-973274,-812698,2022-01-06
CASH_IN,153326,Agence_mtn_Cotonou,300000,146674,Margot Julien,-812698,-659372,2022-01-08
CASH_IN,280780,Agence_mtn_Cotonou,300000,19220,Margot Julien,-659372,-378592,2022-01-08
CASH_IN,191460,Agence_mtn_Abomey,300000,108540,Margot Julien,-378592,-187132,2022-01-09
CASH_IN,52074,Agence_mtn_Abomey,300000,247926,Margot Julien,-187132,-135058,2022-01-10
CASH_IN,288071,Agence_mtn_Cotonou,300000,11929,Margot Julien,-135058,153013,2022-01-11
TRANSFER,120020,Margot Julien,153013,32993,Margot Julien,153013,273033,2022-01-16
CASH_OUT,3762,Margot Julien,32993,29231,Agence_mtn_Abomey,300000,296238,2022-01-18
TRANSFER,26523,Margot Julien,29231,2708,Margot Julien,29231,2708,2022-01-18
CASH_OUT,2618,Margot Julien,2708,90,Agence_mtn_Ouidah,300000,297382,2022-01-20
CASH_IN,298052,Agence_mtn_Abomey,300000,1948,Margot Julien,90,298142,2022-01-20
CASH_IN,203123,Agence_mtn_Abomey,300000,96877,Margot Julien,298142,501265,2022-01-21
CASH_OUT,436619,Margot Julien,501265,64646,Agence_mtn_Abomey,300000,-136619,2022-01-22
CASH_OUT,47739,Margot Julien,64646,16907,Agence_mtn_Abomey,300000,252261,2022-01-26
CASH_IN,106588,Agence_mtn_Ouidah,300000,193412,Margot Julien,16907,123495,2022-01-26
CASH_OUT,107365,Margot Julien,123495,16130,Agence_mtn_Ouidah,300000,192635,2022-01-27
CASH_IN,25369,Agence_mtn_Cotonou,300000,274631,Margot Julien,16130,41499,2022-01-27
CASH_IN,74481,Agence_mtn_Ouidah,300000,225519,Augustin-Jérôme Merle,-562780,-488299,2022-01-01
CASH_IN,281041,Agence_mtn_Ouidah,300000,18959,Augustin-Jérôme Merle,-488299,-207258,2022-01-01
CASH_IN,65221,Agence_mtn_Cotonou,300000,234779,Augustin-Jérôme Merle,-207258,-142037,2022-01-02
CASH_IN,289008,Agence_mtn_Cotonou,300000,10992,Augustin-Jérôme Merle,-142037,146971,2022-01-02
CASH_OUT,71587,Augustin-Jérôme Merle,146971,75384,Agence_mtn_Abomey,300000,228413,2022-01-04
TRANSFER,33726,Augustin-Jérôme Merle,75384,41658,Augustin-Jérôme Merle,75384,41658,2022-01-04
CASH_IN,131247,Agence_mtn_Abomey,300000,168753,Augustin-Jérôme Merle,41658,172905,2022-01-09
TRANSFER,169923,Augustin-Jérôme Merle,172905,2982,Augustin-Jérôme Merle,172905,2982,2022-01-13
CASH_OUT,675,Augustin-Jérôme Merle,2982,2307,Agence_mtn_Ouidah,300000,299325,2022-01-16
CASH_IN,224792,Agence_mtn_Abomey,300000,75208,Augustin-Jérôme Merle,2307,227099,2022-01-21
CASH_OUT,183294,Augustin-Jérôme Merle,227099,43805,Agence_mtn_Abomey,300000,116706,2022-01-24
CASH_IN,286873,Agence_mtn_Ouidah,300000,13127,Jules-Marc Chauvet,-517164,-230291,2022-01-03
CASH_IN,1968,Agence_mtn_Ouidah,300000,298032,Jules-Marc Chauvet,-230291,-228323,2022-01-03
CASH_IN,148737,Agence_mtn_Abomey,300000,151263,Jules-Marc Chauvet,-228323,-79586,2022-01-04
CASH_IN,27033,Agence_mtn_Abomey,300000,272967,Jules-Marc Chauvet,-79586,-52553,2022-01-08
CASH_IN,179497,Agence_mtn_Ouidah,300000,120503,Jules-Marc Chauvet,-52553,126944,2022-01-11
TRANSFER,101435,Jules-Marc Chauvet,126944,25509,Jules-Marc Chauvet,126944,228379,2022-01-18
CASH_OUT,9181,Jules-Marc Chauvet,25509,16328,Agence_mtn_Abomey,300000,290819,2022-01-21
CASH_OUT,16022,Jules-Marc Chauvet,16328,306,Agence_mtn_Ouidah,300000,283978,2022-01-22
CASH_IN,76057,Agence_mtn_Ouidah,300000,223943,Jules-Marc Chauvet,306,76363,2022-01-25
CASH_IN,282925,Agence_mtn_Abomey,300000,17075,Jérôme Laporte Le Gauthier,-429616,-146691,2022-01-01
CASH_IN,206280,Agence_mtn_Abomey,300000,93720,Jérôme Laporte Le Gauthier,-146691,59589,2022-01-02
TRANSFER,17978,Jérôme Laporte Le Gauthier,59589,41611,Jérôme Laporte Le Gauthier,59589,77567,2022-01-03
TRANSFER,17622,Jérôme Laporte Le Gauthier,41611,23989,Jérôme Laporte Le Gauthier,41611,59233,2022-01-03
CASH_IN,201715,Agence_mtn_Abomey,300000,98285,Jérôme Laporte Le Gauthier,23989,225704,2022-01-05
TRANSFER,195541,Jérôme Laporte Le Gauthier,225704,30163,Jérôme Laporte Le Gauthier,225704,30163,2022-01-07
CASH_IN,167807,Agence_mtn_Cotonou,300000,132193,Jérôme Laporte Le Gauthier,30163,197970,2022-01-07
TRANSFER,177871,Jérôme Laporte Le Gauthier,197970,20099,Jérôme Laporte Le Gauthier,197970,20099,2022-01-08
CASH_OUT,7115,Jérôme Laporte Le Gauthier,20099,12984,Agence_mtn_Abomey,300000,292885,2022-01-10
CASH_IN,263416,Agence_mtn_Cotonou,300000,36584,Jérôme Laporte Le Gauthier,12984,276400,2022-01-11
CASH_OUT,264697,Jérôme Laporte Le Gauthier,276400,11703,Agence_mtn_Cotonou,300000,35303,2022-01-13
CASH_OUT,6716,Jérôme Laporte Le Gauthier,11703,4987,Agence_mtn_Cotonou,300000,293284,2022-01-14
CASH_OUT,625,Jérôme Laporte Le Gauthier,4987,4362,Agence_mtn_Ouidah,300000,299375,2022-01-19
CASH_IN,102673,Agence_mtn_Abomey,300000,197327,Jérôme Laporte Le Gauthier,4362,107035,2022-01-23
CASH_IN,51830,Agence_mtn_Cotonou,300000,248170,Jérôme Laporte Le Gauthier,107035,158865,2022-01-24
CASH_OUT,61115,Jérôme Laporte Le Gauthier,158865,97750,Agence_mtn_Cotonou,300000,238885,2022-01-24
CASH_OUT,37059,Jérôme Laporte Le Gauthier,97750,60691,Agence_mtn_Cotonou,300000,262941,2022-01-27
CASH_IN,268020,Agence_mtn_Ouidah,300000,31980,Christine Rossi,49,268069,2022-01-01
TRANSFER,209207,Christine Rossi,268069,58862,Christine Rossi,268069,58862,2022-01-07
TRANSFER,11458,Christine Rossi,58862,47404,Christine Rossi,58862,70320,2022-01-08
CASH_IN,102568,Agence_mtn_Abomey,300000,197432,Christine Rossi,47404,149972,2022-01-10
CASH_OUT,22689,Christine Rossi,149972,127283,Agence_mtn_Abomey,300000,277311,2022-01-15
CASH_OUT,98800,Christine Rossi,127283,28483,Agence_mtn_Cotonou,300000,201200,2022-01-16
CASH_IN,138301,Agence_mtn_Abomey,300000,161699,Christine Rossi,28483,166784,2022-01-17
CASH_OUT,110963,Christine Rossi,166784,55821,Agence_mtn_Ouidah,300000,189037,2022-01-23
CASH_OUT,12588,Christine Rossi,55821,43233,Agence_mtn_Abomey,300000,287412,2022-01-25
CASH_IN,43412,Agence_mtn_Cotonou,300000,256588,Christophe Besnard-Diaz,-6489,36923,2022-01-02
CASH_OUT,6474,Christophe Besnard-Diaz,36923,30449,Agence_mtn_Abomey,300000,293526,2022-01-03
TRANSFER,23072,Christophe Besnard-Diaz,30449,7377,Christophe Besnard-Diaz,30449,53521,2022-01-04
TRANSFER,6889,Christophe Besnard-Diaz,7377,488,Christophe Besnard-Diaz,7377,488,2022-01-04
CASH_IN,69878,Agence_mtn_Cotonou,300000,230122,Christophe Besnard-Diaz,488,70366,2022-01-09
CASH_OUT,17238,Christophe Besnard-Diaz,70366,53128,Agence_mtn_Ouidah,300000,282762,2022-01-10
CASH_IN,146463,Agence_mtn_Cotonou,300000,153537,Christophe Besnard-Diaz,53128,199591,2022-01-11
CASH_IN,168701,Agence_mtn_Ouidah,300000,131299,Christophe Besnard-Diaz,199591,368292,2022-01-14
CASH_OUT,229965,Christophe Besnard-Diaz,368292,138327,Agence_mtn_Cotonou,300000,70035,2022-01-14
CASH_IN,273490,Agence_mtn_Cotonou,300000,26510,Christophe Besnard-Diaz,138327,411817,2022-01-15
CASH_OUT,108396,Christophe Besnard-Diaz,411817,303421,Agence_mtn_Cotonou,300000,191604,2022-01-16
CASH_OUT,29042,Christophe Besnard-Diaz,303421,274379,Agence_mtn_Ouidah,300000,270958,2022-01-17
CASH_OUT,259174,Christophe Besnard-Diaz,274379,15205,Agence_mtn_Cotonou,300000,40826,2022-01-17
CASH_IN,25438,Agence_mtn_Ouidah,300000,274562,Christophe Besnard-Diaz,15205,40643,2022-01-22
CASH_IN,96355,Agence_mtn_Abomey,300000,203645,Christophe Besnard-Diaz,40643,136998,2022-01-25
CASH_IN,209366,Agence_mtn_Cotonou,300000,90634,Raymond Simon,-388998,-179632,2022-01-08
CASH_IN,27099,Agence_mtn_Cotonou,300000,272901,Raymond Simon,-179632,-152533,2022-01-12
CASH_IN,3587,Agence_mtn_Abomey,300000,296413,Raymond Simon,-152533,-148946,2022-01-14
CASH_IN,234984,Agence_mtn_Abomey,300000,65016,Raymond Simon,-148946,86038,2022-01-14
CASH_OUT,80947,Raymond Simon,86038,5091,Agence_mtn_Ouidah,300000,219053,2022-01-14
CASH_IN,15768,Agence_mtn_Cotonou,300000,284232,Raymond Simon,5091,20859,2022-01-25
CASH_OUT,19446,Raymond Simon,20859,1413,Agence_mtn_Abomey,300000,280554,2022-01-27
CASH_IN,183605,Agence_mtn_Ouidah,300000,116395,Alexandre Blanchard,98,183703,2022-01-01
TRANSFER,155131,Alexandre Blanchard,183703,28572,Alexandre Blanchard,183703,338834,2022-01-02
TRANSFER,2861,Alexandre Blanchard,28572,25711,Alexandre Blanchard,28572,25711,2022-01-03
CASH_IN,6242,Agence_mtn_Ouidah,300000,293758,Alexandre Blanchard,25711,31953,2022-01-04
CASH_OUT,9927,Alexandre Blanchard,31953,22026,Agence_mtn_Ouidah,300000,290073,2022-01-06
CASH_IN,133612,Agence_mtn_Ouidah,300000,166388,Alexandre Blanchard,22026,155638,2022-01-08
CASH_OUT,4664,Alexandre Blanchard,155638,150974,Agence_mtn_Abomey,300000,295336,2022-01-12
CASH_OUT,13979,Alexandre Blanchard,150974,136995,Agence_mtn_Abomey,300000,286021,2022-01-12
CASH_OUT,18115,Alexandre Blanchard,136995,118880,Agence_mtn_Ouidah,300000,281885,2022-01-13
CASH_OUT,2562,Alexandre Blanchard,118880,116318,Agence_mtn_Abomey,300000,297438,2022-01-15
CASH_OUT,109409,Alexandre Blanchard,116318,6909,Agence_mtn_Cotonou,300000,190591,2022-01-17
CASH_IN,83240,Agence_mtn_Abomey,300000,216760,Alexandre Blanchard,6909,90149,2022-01-17
TRANSFER,44096,Alexandre Blanchard,90149,46053,Alexandre Blanchard,90149,46053,2022-01-17
CASH_IN,24647,Agence_mtn_Cotonou,300000,275353,Alexandre Blanchard,46053,70700,2022-01-18
CASH_IN,230106,Agence_mtn_Cotonou,300000,69894,Alexandre Blanchard,70700,300806,2022-01-21
CASH_OUT,281762,Alexandre Blanchard,300806,19044,Agence_mtn_Cotonou,300000,18238,2022-01-23
CASH_IN,146602,Agence_mtn_Cotonou,300000,153398,Alexandre Blanchard,19044,165646,2022-01-27
CASH_IN,12962,Agence_mtn_Ouidah,300000,287038,Georges-Alfred Pruvost,-129228,-116266,2022-01-02
CASH_IN,258256,Agence_mtn_Cotonou,300000,41744,Georges-Alfred Pruvost,-116266,141990,2022-01-02
CASH_OUT,80476,Georges-Alfred Pruvost,141990,61514,Agence_mtn_Abomey,300000,219524,2022-01-03
TRANSFER,54081,Georges-Alfred Pruvost,61514,7433,Georges-Alfred Pruvost,61514,7433,2022-01-05
CASH_OUT,2751,Georges-Alfred Pruvost,7433,4682,Agence_mtn_Abomey,300000,297249,2022-01-14
CASH_IN,20724,Agence_mtn_Abomey,300000,279276,Georges-Alfred Pruvost,4682,25406,2022-01-15
CASH_IN,4040,Agence_mtn_Cotonou,300000,295960,Georges-Alfred Pruvost,25406,29446,2022-01-19
CASH_OUT,21268,Georges-Alfred Pruvost,29446,8178,Agence_mtn_Ouidah,300000,278732,2022-01-21
CASH_OUT,2360,Georges-Alfred Pruvost,8178,5818,Agence_mtn_Abomey,300000,297640,2022-01-21
CASH_IN,204525,Agence_mtn_Ouidah,300000,95475,Georges-Alfred Pruvost,5818,210343,2022-01-21
CASH_IN,79552,Agence_mtn_Ouidah,300000,220448,Georges-Alfred Pruvost,210343,289895,2022-01-24
CASH_IN,46529,Agence_mtn_Ouidah,300000,253471,Georges-Alfred Pruvost,289895,336424,2022-01-24
CASH_IN,198699,Agence_mtn_Cotonou,300000,101301,Georges-Alfred Pruvost,336424,535123,2022-01-26
CASH_IN,152075,Agence_mtn_Cotonou,300000,147925,Guy-Augustin Pinto,-268304,-116229,2022-01-01
CASH_IN,291257,Agence_mtn_Cotonou,300000,8743,Guy-Augustin Pinto,-116229,175028,2022-01-05
CASH_OUT,146134,Guy-Augustin Pinto,175028,28894,Agence_mtn_Cotonou,300000,153866,2022-01-06
CASH_OUT,20870,Guy-Augustin Pinto,28894,8024,Agence_mtn_Abomey,300000,279130,2022-01-14
CASH_IN,151034,Agence_mtn_Cotonou,300000,148966,Guy-Augustin Pinto,8024,159058,2022-01-20
CASH_OUT,120943,Guy-Augustin Pinto,159058,38115,Agence_mtn_Abomey,300000,179057,2022-01-20
CASH_IN,277668,Agence_mtn_Cotonou,300000,22332,Aimé Bernier,-453527,-175859,2022-01-03
CASH_IN,162583,Agence_mtn_Abomey,300000,137417,Aimé Bernier,-175859,-13276,2022-01-04
CASH_IN,278974,Agence_mtn_Ouidah,300000,21026,Aimé Bernier,-13276,265698,2022-01-06
CASH_IN,257067,Agence_mtn_Cotonou,300000,42933,Aimé Bernier,265698,522765,2022-01-07
CASH_OUT,341933,Aimé Bernier,522765,180832,Agence_mtn_Cotonou,300000,-41933,2022-01-07
CASH_IN,78014,Agence_mtn_Ouidah,300000,221986,Aimé Bernier,180832,258846,2022-01-13
TRANSFER,1869,Aimé Bernier,258846,256977,Aimé Bernier,258846,256977,2022-01-14
TRANSFER,43723,Aimé Bernier,256977,213254,Aimé Bernier,256977,300700,2022-01-14
CASH_IN,7033,Agence_mtn_Ouidah,300000,292967,Aimé Bernier,213254,220287,2022-01-17
CASH_OUT,97003,Aimé Bernier,220287,123284,Agence_mtn_Ouidah,300000,202997,2022-01-18
CASH_OUT,39511,Aimé Bernier,123284,83773,Agence_mtn_Abomey,300000,260489,2022-01-20
CASH_OUT,47686,Aimé Bernier,83773,36087,Agence_mtn_Cotonou,300000,252314,2022-01-23
CASH_OUT,22599,Aimé Bernier,36087,13488,Agence_mtn_Cotonou,300000,277401,2022-01-25
CASH_IN,209981,Agence_mtn_Cotonou,300000,90019,Gabrielle Hamon,-214678,-4697,2022-01-01
CASH_IN,54559,Agence_mtn_Cotonou,300000,245441,Gabrielle Hamon,-4697,49862,2022-01-03
TRANSFER,40803,Gabrielle Hamon,49862,9059,Gabrielle Hamon,49862,9059,2022-01-04
TRANSFER,1636,Gabrielle Hamon,9059,7423,Gabrielle Hamon,9059,7423,2022-01-05
CASH_OUT,748,Gabrielle Hamon,7423,6675,Agence_mtn_Cotonou,300000,299252,2022-01-06
CASH_IN,134157,Agence_mtn_Ouidah,300000,165843,Gabrielle Hamon,6675,140832,2022-01-12
CASH_OUT,26841,Gabrielle Hamon,140832,113991,Agence_mtn_Cotonou,300000,273159,2022-01-12
CASH_OUT,16154,Gabrielle Hamon,113991,97837,Agence_mtn_Abomey,300000,283846,2022-01-12
CASH_IN,281282,Agence_mtn_Cotonou,300000,18718,Gabrielle Hamon,97837,379119,2022-01-13
CASH_OUT,6564,Gabrielle Hamon,379119,372555,Agence_mtn_Abomey,300000,293436,2022-01-16
CASH_OUT,127003,Gabrielle Hamon,372555,245552,Agence_mtn_Ouidah,300000,172997,2022-01-16
CASH_IN,15153,Agence_mtn_Cotonou,300000,284847,Gabrielle Hamon,245552,260705,2022-01-19
CASH_IN,77903,Agence_mtn_Cotonou,300000,222097,Gabrielle Hamon,260705,338608,2022-01-21
CASH_IN,124592,Agence_mtn_Ouidah,300000,175408,Gabrielle Hamon,338608,463200,2022-01-22
CASH_OUT,167225,Gabrielle Hamon,463200,295975,Agence_mtn_Abomey,300000,132775,2022-01-24
CASH_IN,267454,Agence_mtn_Cotonou,300000,32546,Gabrielle Hamon,295975,563429,2022-01-25
CASH_IN,276248,Agence_mtn_Abomey,300000,23752,Gabrielle Hamon,563429,839677,2022-01-27
CASH_IN,237224,Agence_mtn_Ouidah,300000,62776,Maryse Delorme,-14553,222671,2022-01-01
TRANSFER,137776,Maryse Delorme,222671,84895,Maryse Delorme,222671,84895,2022-01-05
CASH_IN,264971,Agence_mtn_Abomey,300000,35029,Maryse Delorme,84895,349866,2022-01-11
CASH_OUT,226312,Maryse Delorme,349866,123554,Agence_mtn_Ouidah,300000,73688,2022-01-13
CASH_OUT,114771,Maryse Delorme,123554,8783,Agence_mtn_Ouidah,300000,185229,2022-01-13
CASH_OUT,2125,Maryse Delorme,8783,6658,Agence_mtn_Cotonou,300000,297875,2022-01-14
TRANSFER,2949,Maryse Delorme,6658,3709,Maryse Delorme,6658,9607,2022-01-20
CASH_OUT,2070,Maryse Delorme,3709,1639,Agence_mtn_Abomey,300000,297930,2022-01-20
CASH_OUT,1524,Maryse Delorme,1639,115,Agence_mtn_Cotonou,300000,298476,2022-01-21
CASH_OUT,107,Maryse Delorme,115,8,Agence_mtn_Abomey,300000,299893,2022-01-21
CASH_IN,192272,Agence_mtn_Ouidah,300000,107728,Maryse Delorme,8,192280,2022-01-22
CASH_IN,269856,Agence_mtn_Cotonou,300000,30144,Valérie de Pottier,-51107,218749,2022-01-04
TRANSFER,116292,Valérie de Pottier,218749,102457,Valérie de Pottier,218749,335041,2022-01-05
CASH_OUT,49080,Valérie de Pottier,102457,53377,Agence_mtn_Ouidah,300000,250920,2022-01-05
CASH_IN,84759,Agence_mtn_Cotonou,300000,215241,Valérie de Pottier,53377,138136,2022-01-10
CASH_OUT,21235,Valérie de Pottier,138136,116901,Agence_mtn_Cotonou,300000,278765,2022-01-10
CASH_IN,25187,Agence_mtn_Cotonou,300000,274813,Valérie de Pottier,116901,142088,2022-01-13
CASH_OUT,134232,Valérie de Pottier,142088,7856,Agence_mtn_Cotonou,300000,165768,2022-01-14
CASH_OUT,5713,Valérie de Pottier,7856,2143,Agence_mtn_Abomey,300000,294287,2022-01-17
CASH_IN,139271,Agence_mtn_Cotonou,300000,160729,Valérie de Pottier,2143,141414,2022-01-18
CASH_OUT,103467,Valérie de Pottier,141414,37947,Agence_mtn_Cotonou,300000,196533,2022-01-18
CASH_OUT,20157,Valérie de Pottier,37947,17790,Agence_mtn_Abomey,300000,279843,2022-01-22
CASH_OUT,6891,Valérie de Pottier,17790,10899,Agence_mtn_Abomey,300000,293109,2022-01-22
CASH_IN,109548,Agence_mtn_Ouidah,300000,190452,Gérard Blot de Blanc,-131594,-22046,2022-01-02
CASH_IN,106738,Agence_mtn_Ouidah,300000,193262,Gérard Blot de Blanc,-22046,84692,2022-01-03
CASH_IN,274810,Agence_mtn_Cotonou,300000,25190,Gérard Blot de Blanc,84692,359502,2022-01-04
CASH_OUT,216662,Gérard Blot de Blanc,359502,142840,Agence_mtn_Abomey,300000,83338,2022-01-06
CASH_IN,291074,Agence_mtn_Ouidah,300000,8926,Gérard Blot de Blanc,142840,433914,2022-01-10
CASH_OUT,70862,Gérard Blot de Blanc,433914,363052,Agence_mtn_Abomey,300000,229138,2022-01-17
CASH_OUT,260460,Gérard Blot de Blanc,363052,102592,Agence_mtn_Abomey,300000,39540,2022-01-19
CASH_IN,198553,Agence_mtn_Ouidah,300000,101447,Gérard Blot de Blanc,102592,301145,2022-01-24
CASH_OUT,70973,Gérard Blot de Blanc,301145,230172,Agence_mtn_Abomey,300000,229027,2022-01-24
CASH_OUT,17021,Gérard Blot de Blanc,230172,213151,Agence_mtn_Cotonou,300000,282979,2022-01-27
TRANSFER,416620,Valérie de Pottier,565000,148380,François Vaillant,1738500,2155120,2022-02-09
TRANSFER,773117,Marcel de la Buisson,952300,179183,François Vaillant,2155120,2928237,2022-02-22
CASH_IN,234222,Agence_mtn_Abomey,300000,65778,Christophe Teixeira,1686700,1920922,2022-02-02
CASH_OUT,1101027,Danielle-Henriette Tessier,1487100,386073,Agence_mtn_Abomey,300000,-801027,2022-02-04
CASH_OUT,71086,Danielle-Henriette Tessier,386073,314987,Agence_mtn_Cotonou,300000,228914,2022-02-07
TRANSFER,203603,Danielle-Henriette Tessier,314987,111384,Julien Devaux,706400,502797,2022-02-13
CASH_IN,122759,Agence_mtn_Ouidah,300000,177241,Danielle-Henriette Tessier,111384,234143,2022-02-19
TRANSFER,12220,Danielle-Henriette Tessier,234143,221923,Raymond de Le Roux,266200,253980,2022-02-25
CASH_OUT,1940059,Élisabeth Delattre,1955300,15241,Agence_mtn_Abomey,300000,-1640059,2022-02-08
TRANSFER,6151,Élisabeth Delattre,15241,9090,Marc Costa-Daniel,343200,337049,2022-02-09
CASH_OUT,3323,Élisabeth Delattre,9090,5767,Agence_mtn_Abomey,300000,296677,2022-02-11
CASH_IN,199129,Agence_mtn_Ouidah,300000,100871,Élisabeth Delattre,5767,204896,2022-02-24
CASH_IN,12086,Agence_mtn_Ouidah,300000,287914,Roland Huet,415400,427486,2022-02-18
CASH_IN,138528,Agence_mtn_Abomey,300000,161472,Roland Huet,427486,566014,2022-02-20
CASH_IN,151546,Agence_mtn_Cotonou,300000,148454,Nathalie Da Silva,1372900,1524446,2022-02-03
CASH_OUT,149493,Nathalie Da Silva,1524446,1374953,Agence_mtn_Cotonou,300000,150507,2022-02-12
CASH_OUT,120057,Nathalie Da Silva,1374953,1254896,Agence_mtn_Abomey,300000,179943,2022-02-20
TRANSFER,722947,Françoise Denis de Allard,1119800,396853,Nathalie Da Silva,1254896,1977843,2022-02-21
TRANSFER,647368,Michelle de la Daniel,1410300,762932,Emmanuelle Le Allain,662800,15432,2022-02-04
CASH_IN,265716,Agence_mtn_Abomey,300000,34284,Michelle de la Daniel,762932,1028648,2022-02-20
CASH_IN,60739,Agence_mtn_Abomey,300000,239261,Michelle de la Daniel,1028648,1089387,2022-02-26
CASH_IN,21826,Agence_mtn_Cotonou,300000,278174,Michelle de la Daniel,1089387,1111213,2022-02-26
CASH_IN,223138,Agence_mtn_Ouidah,300000,76862,Jean Guilbert-Lenoir,1217200,1440338,2022-02-05
CASH_OUT,868043,Jean Guilbert-Lenoir,1440338,572295,Agence_mtn_Cotonou,300000,-568043,2022-02-08
TRANSFER,142263,Jean Guilbert-Lenoir,572295,430032,Clémence-Alice Ruiz,1482500,1340237,2022-02-14
CASH_IN,194076,Agence_mtn_Cotonou,300000,105924,Jean Guilbert-Lenoir,430032,624108,2022-02-18
TRANSFER,75259,Emmanuel Legrand,206600,131341,Emmanuelle Le Allain,15432,-59827,2022-02-14
TRANSFER,1169458,Julie Germain Le Vaillant,1280000,110542,Emmanuel Legrand,131341,1300799,2022-02-21
CASH_IN,77436,Agence_mtn_Cotonou,300000,222564,Emmanuel Legrand,1300799,1378235,2022-02-27
TRANSFER,10942,Gilbert Moulin,13000,2058,Julie Germain Le Vaillant,110542,121484,2022-02-10
CASH_IN,129705,Agence_mtn_Cotonou,300000,170295,Julie Germain Le Vaillant,121484,251189,2022-02-10
TRANSFER,80818,Julie Germain Le Vaillant,251189,170371,Madeleine Philippe-Grondin,1611000,1530182,2022-02-12
TRANSFER,27786,Julie Germain Le Vaillant,170371,142585,Nicole-Renée Gay,1420500,1392714,2022-02-21
TRANSFER,52345,Julie Germain Le Vaillant,142585,90240,Nicole Huet,1520700,1468355,2022-02-23
TRANSFER,648228,Hélène Blanchard-Renault,986600,338372,Margot Julien,563200,1211428,2022-02-04
CASH_IN,79675,Agence_mtn_Abomey,300000,220325,Margot Julien,1211428,1291103,2022-02-09
CASH_OUT,907347,Margot Julien,1291103,383756,Agence_mtn_Cotonou,300000,-607347,2022-02-11
CASH_OUT,88153,Margot Julien,383756,295603,Agence_mtn_Ouidah,300000,211847,2022-02-17
TRANSFER,56862,Margot Julien,295603,238741,Clémence Dufour,1449300,1392438,2022-02-25
CASH_OUT,510384,Simone du Allard,1420200,909816,Agence_mtn_Abomey,300000,-210384,2022-02-06
TRANSFER,99607,Simone du Allard,909816,810209,Sophie-Anouk Boulanger,966900,867293,2022-02-06
CASH_IN,256118,Agence_mtn_Ouidah,300000,43882,Simone du Allard,810209,1066327,2022-02-07
CASH_OUT,398126,Aimé Bernier,700300,302174,Agence_mtn_Ouidah,300000,-98126,2022-02-01
CASH_IN,151491,Agence_mtn_Cotonou,300000,148509,Aimé Bernier,302174,453665,2022-02-01
CASH_IN,167638,Agence_mtn_Abomey,300000,132362,Aimé Bernier,453665,621303,2022-02-11
CASH_OUT,145593,Aimé Bernier,621303,475710,Agence_mtn_Abomey,300000,154407,2022-02-21
TRANSFER,1511502,Henri de Didier,1610300,98798,Raymond-Yves Boulanger,875200,2386702,2022-02-03
TRANSFER,99219,Marcel de la Buisson,179183,79964,Raymond-Yves Boulanger,2386702,2485921,2022-02-27
TRANSFER,883001,Hélène Alexandre de la Samson,1486200,603199,Nicole-Renée Gay,1392714,509713,2022-02-08
CASH_IN,43802,Agence_mtn_Ouidah,300000,256198,Hélène Alexandre de la Samson,603199,647001,2022-02-16
TRANSFER,117339,Emmanuel Vallée,413100,295761,Hélène Alexandre de la Samson,647001,764340,2022-02-20
TRANSFER,1768222,Michèle Faivre,1969400,201178,Hélène Alexandre de la Samson,764340,2532562,2022-02-26
CASH_IN,5189,Agence_mtn_Abomey,300000,294811,Hélène Alexandre de la Samson,2532562,2537751,2022-02-27
CASH_IN,28432,Agence_mtn_Cotonou,300000,271568,Jacques Le Marion,1219900,1248332,2022-02-10
TRANSFER,1092457,Margaud-Michelle Briand,1456100,363643,Jacques Le Marion,1248332,2340789,2022-02-15
CASH_OUT,1230914,Jacques Le Marion,2340789,1109875,Agence_mtn_Ouidah,300000,-930914,2022-02-18
CASH_IN,92297,Agence_mtn_Cotonou,300000,207703,Jacques Le Marion,1109875,1202172,2022-02-19
TRANSFER,239868,Marc Baudry,1172200,932332,Jacques Le Marion,1202172,1442040,2022-02-22
CASH_IN,120987,Agence_mtn_Ouidah,300000,179013,Josette du Hamon,496000,616987,2022-02-01
CASH_IN,194200,Agence_mtn_Cotonou,300000,105800,Josette du Hamon,616987,811187,2022-02-03
CASH_IN,217937,Agence_mtn_Cotonou,300000,82063,Sylvie Dupré,1999300,2217237,2022-02-21
TRANSFER,1325390,Alexandre Blanchard,1497600,172210,Océane Faure,1613000,2938390,2022-02-03
CASH_OUT,1572664,Océane Faure,2938390,1365726,Agence_mtn_Cotonou,300000,-1272664,2022-02-06
CASH_IN,160471,Agence_mtn_Cotonou,300000,139529,Océane Faure,1365726,1526197,2022-02-08
CASH_OUT,516374,Océane Faure,1526197,1009823,Agence_mtn_Abomey,300000,-216374,2022-02-23
TRANSFER,585457,Océane Faure,1009823,424366,Alfred Paris,343300,-242157,2022-02-25
TRANSFER,427449,Gabrielle Hamon,1470800,1043351,Éléonore Marin Le Morel,1758100,1330651,2022-02-10
CASH_IN,49832,Agence_mtn_Abomey,300000,250168,Gabrielle Hamon,1043351,1093183,2022-02-25
CASH_OUT,333314,Thibault Martin,1199800,866486,Agence_mtn_Abomey,300000,-33314,2022-02-08
CASH_OUT,323970,Thibault Martin,866486,542516,Agence_mtn_Abomey,300000,-23970,2022-02-10
CASH_OUT,298056,Thibault Martin,542516,244460,Agence_mtn_Abomey,300000,1944,2022-02-15
CASH_IN,193319,Agence_mtn_Cotonou,300000,106681,Thibault Martin,244460,437779,2022-02-19
CASH_IN,181899,Agence_mtn_Ouidah,300000,118101,Thibault Martin,437779,619678,2022-02-20
CASH_OUT,173900,Honoré de la Prévost,669000,495100,Agence_mtn_Cotonou,300000,126100,2022-02-04
CASH_OUT,278834,Honoré de la Prévost,495100,216266,Agence_mtn_Ouidah,300000,21166,2022-02-06
CASH_OUT,115737,Honoré de la Prévost,216266,100529,Agence_mtn_Abomey,300000,184263,2022-02-09
CASH_IN,106737,Agence_mtn_Ouidah,300000,193263,Honoré de la Prévost,100529,207266,2022-02-24
CASH_OUT,292647,Nicolas Blin,1113500,820853,Agence_mtn_Cotonou,300000,7353,2022-02-01
CASH_OUT,237258,Nicolas Blin,820853,583595,Agence_mtn_Cotonou,300000,62742,2022-02-02
CASH_IN,44190,Agence_mtn_Abomey,300000,255810,Nicolas Blin,583595,627785,2022-02-03
CASH_OUT,2633,Nicolas Blin,627785,625152,Agence_mtn_Cotonou,300000,297367,2022-02-04
CASH_OUT,164420,Nicolas Blin,625152,460732,Agence_mtn_Ouidah,300000,135580,2022-02-04
CASH_IN,292917,Agence_mtn_Cotonou,300000,7083,Nicolas Blin,460732,753649,2022-02-05
TRANSFER,142406,Nicolas Blin,753649,611243,Thibault-Julien Chevallier,460100,317694,2022-02-05
CASH_OUT,150747,Nicolas Blin,611243,460496,Agence_mtn_Abomey,300000,149253,2022-02-06
CASH_OUT,101821,Nicolas Blin,460496,358675,Agence_mtn_Ouidah,300000,198179,2022-02-07
TRANSFER,340653,Nicolas Blin,358675,18022,Margaud-Michelle Briand,363643,22990,2022-02-07
CASH_OUT,14855,Nicolas Blin,18022,3167,Agence_mtn_Cotonou,300000,285145,2022-02-08
CASH_OUT,2200,Nicolas Blin,3167,967,Agence_mtn_Ouidah,300000,297800,2022-02-09
CASH_IN,159596,Agence_mtn_Ouidah,300000,140404,Nicolas Blin,967,160563,2022-02-11
CASH_IN,36716,Agence_mtn_Abomey,300000,263284,Nicolas Blin,160563,197279,2022-02-13
TRANSFER,368905,Françoise Denis de Allard,396853,27948,Nicolas Blin,197279,566184,2022-02-15
TRANSFER,24510,Michèle Faivre,201178,176668,Nicolas Blin,566184,590694,2022-02-16
TRANSFER,14937,Robert Henry-Poulain,54400,39463,Nicolas Blin,590694,605631,2022-02-16
TRANSFER,50621,Emmanuel Vallée,295761,245140,Nicolas Blin,605631,656252,2022-02-16
TRANSFER,89551,Nicolas Blin,656252,566701,Julien Devaux,502797,413246,2022-02-18
CASH_OUT,560588,Nicolas Blin,566701,6113,Agence_mtn_Ouidah,300000,-260588,2022-02-18
TRANSFER,3401,Nicolas Blin,6113,2712,Maurice de Brunet,1955900,1952499,2022-02-19
CASH_OUT,1496,Nicolas Blin,2712,1216,Agence_mtn_Abomey,300000,298504,2022-02-19
CASH_OUT,1180,Nicolas Blin,1216,36,Agence_mtn_Ouidah,300000,298820,2022-02-20
CASH_IN,54063,Agence_mtn_Abomey,300000,245937,Nicolas Blin,36,54099,2022-02-20
TRANSFER,5791,Nicolas Blin,54099,48308,Louise-Aurore Payet,830300,824509,2022-02-21
CASH_IN,296458,Agence_mtn_Abomey,300000,3542,Nicolas Blin,48308,344766,2022-02-22
CASH_OUT,105222,Nicolas Blin,344766,239544,Agence_mtn_Abomey,300000,194778,2022-02-24
CASH_OUT,210018,Nicolas Blin,239544,29526,Agence_mtn_Abomey,300000,89982,2022-02-25
TRANSFER,573787,Louise-Aurore Payet,824509,250722,Nicolas Blin,29526,603313,2022-02-25
CASH_OUT,456910,Nicolas Blin,603313,146403,Agence_mtn_Ouidah,300000,-156910,2022-02-26
CASH_IN,281652,Agence_mtn_Ouidah,300000,18348,Gérard Cordier,27300,308952,2022-02-01
CASH_IN,182801,Agence_mtn_Ouidah,300000,117199,Gérard Cordier,308952,491753,2022-02-02
TRANSFER,277658,Gérard Cordier,491753,214095,Gérard Cordier,491753,214095,2022-02-03
CASH_IN,123651,Agence_mtn_Ouidah,300000,176349,Gérard Cordier,214095,337746,2022-02-04
TRANSFER,200147,Sophie-Anouk Boulanger,867293,667146,Gérard Cordier,337746,537893,2022-02-04
TRANSFER,473051,Gérard Cordier,537893,64842,Matthieu Cousin,1233000,759949,2022-02-05
TRANSFER,10818,Gérard Cordier,64842,54024,Augustin-Jérôme Merle,1366200,1355382,2022-02-05
TRANSFER,535453,Sabine Perrier,1283400,747947,Gérard Cordier,54024,589477,2022-02-06
TRANSFER,311664,Nathalie-Claire De Oliveira,444700,133036,Gérard Cordier,589477,901141,2022-02-10
CASH_IN,222657,Agence_mtn_Cotonou,300000,77343,Gérard Cordier,901141,1123798,2022-02-10
CASH_IN,31465,Agence_mtn_Ouidah,300000,268535,Gérard Cordier,1123798,1155263,2022-02-14
CASH_IN,288850,Agence_mtn_Abomey,300000,11150,Gérard Cordier,1155263,1444113,2022-02-16
TRANSFER,1413590,Gérard Cordier,1444113,30523,Louis du Boyer,1120100,-293490,2022-02-19
CASH_IN,178783,Agence_mtn_Ouidah,300000,121217,Gérard Cordier,30523,209306,2022-02-20
CASH_OUT,105633,Gérard Cordier,209306,103673,Agence_mtn_Cotonou,300000,194367,2022-02-22
CASH_OUT,55491,Gérard Cordier,103673,48182,Agence_mtn_Ouidah,300000,244509,2022-02-23
CASH_IN,51111,Agence_mtn_Ouidah,300000,248889,Gérard Cordier,48182,99293,2022-02-23
TRANSFER,848606,Martin Moreau,1276400,427794,Gérard Cordier,99293,947899,2022-02-23
TRANSFER,474,Gilbert Moulin,2058,1584,Gérard Cordier,947899,948373,2022-02-24
CASH_OUT,900246,Gérard Cordier,948373,48127,Agence_mtn_Cotonou,300000,-600246,2022-02-25
TRANSFER,30637,Gérard Cordier,48127,17490,Nicole Huet,1468355,1437718,2022-02-25
TRANSFER,462674,Astrid Aubert-Thierry,1419200,956526,Gérard Cordier,17490,480164,2022-02-26
TRANSFER,204712,Alexandre Delaunay,284400,79688,Marc Costa-Daniel,337049,541761,2022-02-05
TRANSFER,1107739,Guillaume de la Nguyen,1173300,65561,Marc Costa-Daniel,541761,1649500,2022-02-07
CASH_IN,232752,Agence_mtn_Abomey,300000,67248,Marc Costa-Daniel,1649500,1882252,2022-02-09
CASH_OUT,1309588,Marc Costa-Daniel,1882252,572664,Agence_mtn_Cotonou,300000,-1009588,2022-02-11
CASH_OUT,494500,Marc Costa-Daniel,572664,78164,Agence_mtn_Cotonou,300000,-194500,2022-02-11
CASH_OUT,3977,Marc Costa-Daniel,78164,74187,Agence_mtn_Abomey,300000,296023,2022-02-12
TRANSFER,926019,Éléonore Marin Le Morel,1330651,404632,Marc Costa-Daniel,74187,1000206,2022-02-12
CASH_OUT,410124,Marc Costa-Daniel,1000206,590082,Agence_mtn_Abomey,300000,-110124,2022-02-13
CASH_IN,192483,Agence_mtn_Cotonou,300000,107517,Marc Costa-Daniel,590082,782565,2022-02-13
TRANSFER,534710,Marc Costa-Daniel,782565,247855,Julien Devaux,413246,-121464,2022-02-15
CASH_OUT,105142,Marc Costa-Daniel,247855,142713,Agence_mtn_Cotonou,300000,194858,2022-02-16
CASH_IN,129435,Agence_mtn_Abomey,300000,170565,Marc Costa-Daniel,142713,272148,2022-02-16
CASH_IN,253309,Agence_mtn_Ouidah,300000,46691,Marc Costa-Daniel,272148,525457,2022-02-18
CASH_IN,199190,Agence_mtn_Ouidah,300000,100810,Marc Costa-Daniel,525457,724647,2022-02-19
CASH_OUT,572262,Marc Costa-Daniel,724647,152385,Agence_mtn_Cotonou,300000,-272262,2022-02-19
CASH_IN,89710,Agence_mtn_Cotonou,300000,210290,Marc Costa-Daniel,152385,242095,2022-02-20
TRANSFER,57559,Martin Moreau,427794,370235,Marc Costa-Daniel,242095,299654,2022-02-20
CASH_IN,72450,Agence_mtn_Abomey,300000,227550,Marc Costa-Daniel,299654,372104,2022-02-22
CASH_IN,291405,Agence_mtn_Ouidah,300000,8595,Marc Costa-Daniel,372104,663509,2022-02-23
CASH_OUT,581807,Marc Costa-Daniel,663509,81702,Agence_mtn_Ouidah,300000,-281807,2022-02-24
CASH_OUT,51132,Marc Costa-Daniel,81702,30570,Agence_mtn_Abomey,300000,248868,2022-02-27
CASH_OUT,14178,Louise-Aurore Payet,250722,236544,Agence_mtn_Ouidah,300000,285822,2022-02-01
CASH_IN,32902,Agence_mtn_Cotonou,300000,267098,Louise-Aurore Payet,236544,269446,2022-02-01
CASH_IN,186079,Agence_mtn_Cotonou,300000,113921,Louise-Aurore Payet,269446,455525,2022-02-02
CASH_IN,237133,Agence_mtn_Abomey,300000,62867,Louise-Aurore Payet,455525,692658,2022-02-03
CASH_IN,29288,Agence_mtn_Abomey,300000,270712,Louise-Aurore Payet,692658,721946,2022-02-03
CASH_OUT,301116,Louise-Aurore Payet,721946,420830,Agence_mtn_Abomey,300000,-1116,2022-02-06
CASH_OUT,70455,Louise-Aurore Payet,420830,350375,Agence_mtn_Ouidah,300000,229545,2022-02-07
CASH_OUT,221882,Louise-Aurore Payet,350375,128493,Agence_mtn_Abomey,300000,78118,2022-02-09
CASH_IN,69393,Agence_mtn_Cotonou,300000,230607,Louise-Aurore Payet,128493,197886,2022-02-10
TRANSFER,116557,Louise-Aurore Payet,197886,81329,Henri de Didier,98798,-17759,2022-02-10
TRANSFER,130870,Roger-Roger Delmas,148000,17130,Louise-Aurore Payet,81329,212199,2022-02-10
CASH_OUT,26992,Louise-Aurore Payet,212199,185207,Agence_mtn_Ouidah,300000,273008,2022-02-11
TRANSFER,123290,Louise-Aurore Payet,185207,61917,Valérie-Claudine Marin,1478100,1354810,2022-02-11
TRANSFER,27346,Louise-Aurore Payet,61917,34571,Céline-Inès Meunier,1144600,1117254,2022-02-13
CASH_IN,15077,Agence_mtn_Cotonou,300000,284923,Louise-Aurore Payet,34571,49648,2022-02-13
CASH_IN,28052,Agence_mtn_Ouidah,300000,271948,Louise-Aurore Payet,49648,77700,2022-02-15
CASH_OUT,23465,Louise-Aurore Payet,77700,54235,Agence_mtn_Cotonou,300000,276535,2022-02-16
CASH_IN,8230,Agence_mtn_Abomey,300000,291770,Louise-Aurore Payet,54235,62465,2022-02-16
TRANSFER,4000,Robert Henry-Poulain,39463,35463,Louise-Aurore Payet,62465,66465,2022-02-17
CASH_IN,278667,Agence_mtn_Abomey,300000,21333,Louise-Aurore Payet,66465,345132,2022-02-18
TRANSFER,679105,Céline-Inès Meunier,1117254,438149,Louise-Aurore Payet,345132,1024237,2022-02-20
CASH_IN,101523,Agence_mtn_Abomey,300000,198477,Louise-Aurore Payet,1024237,1125760,2022-02-20
CASH_OUT,229695,Louise-Aurore Payet,1125760,896065,Agence_mtn_Abomey,300000,70305,2022-02-20
CASH_IN,168461,Agence_mtn_Cotonou,300000,131539,Louise-Aurore Payet,896065,1064526,2022-02-22
TRANSFER,615442,Louise-Aurore Payet,1064526,449084,Augustin-Jérôme Merle,1355382,739940,2022-02-22
CASH_OUT,207487,Louise-Aurore Payet,449084,241597,Agence_mtn_Cotonou,300000,92513,2022-02-22
CASH_OUT,2185,Louise-Aurore Payet,241597,239412,Agence_mtn_Ouidah,300000,297815,2022-02-22
CASH_OUT,141681,Louise-Aurore Payet,239412,97731,Agence_mtn_Abomey,300000,158319,2022-02-24
TRANSFER,7450,Louise-Aurore Payet,97731,90281,Jérôme Laporte Le Gauthier,1600000,1592550,2022-02-24
CASH_IN,100674,Agence_mtn_Cotonou,300000,199326,Louise-Aurore Payet,90281,190955,2022-02-26
TRANSFER,418331,Clémence-Alice Ruiz,1340237,921906,Anouk Delahaye-Gimenez,779900,361569,2022-02-03
CASH_OUT,20855,Clémence-Alice Ruiz,921906,901051,Agence_mtn_Ouidah,300000,279145,2022-02-04
CASH_IN,20221,Agence_mtn_Abomey,300000,279779,Clémence-Alice Ruiz,901051,921272,2022-02-04
CASH_IN,27955,Agence_mtn_Ouidah,300000,272045,Clémence-Alice Ruiz,921272,949227,2022-02-05
CASH_OUT,137827,Clémence-Alice Ruiz,949227,811400,Agence_mtn_Ouidah,300000,162173,2022-02-06
TRANSFER,676319,Marc Baudry,932332,256013,Clémence-Alice Ruiz,811400,1487719,2022-02-07
CASH_IN,269602,Agence_mtn_Ouidah,300000,30398,Clémence-Alice Ruiz,1487719,1757321,2022-02-08
CASH_OUT,629701,Clémence-Alice Ruiz,1757321,1127620,Agence_mtn_Ouidah,300000,-329701,2022-02-08
CASH_OUT,425584,Clémence-Alice Ruiz,1127620,702036,Agence_mtn_Cotonou,300000,-125584,2022-02-09
TRANSFER,278871,Élise Monnier,1419700,1140829,Clémence-Alice Ruiz,702036,980907,2022-02-11
TRANSFER,224456,Charlotte Perrier,845300,620844,Clémence-Alice Ruiz,980907,1205363,2022-02-11
TRANSFER,148633,Clémence-Alice Ruiz,1205363,1056730,Robert Henry-Poulain,35463,-113170,2022-02-11
CASH_IN,204064,Agence_mtn_Abomey,300000,95936,Clémence-Alice Ruiz,1056730,1260794,2022-02-12
CASH_OUT,557142,Clémence-Alice Ruiz,1260794,703652,Agence_mtn_Abomey,300000,-257142,2022-02-13
CASH_IN,289215,Agence_mtn_Abomey,300000,10785,Clémence-Alice Ruiz,703652,992867,2022-02-14
TRANSFER,67253,Christine Rossi,92500,25247,Clémence-Alice Ruiz,992867,1060120,2022-02-17
TRANSFER,350415,Aurélie Maury,1084300,733885,Clémence-Alice Ruiz,1060120,1410535,2022-02-18
TRANSFER,1082924,Clémence-Alice Ruiz,1410535,327611,Maurice de Brunet,1952499,869575,2022-02-19
CASH_IN,123603,Agence_mtn_Ouidah,300000,176397,Clémence-Alice Ruiz,327611,451214,2022-02-19
TRANSFER,587926,Maggie Barbier,1378600,790674,Clémence-Alice Ruiz,451214,1039140,2022-02-20
CASH_IN,299785,Agence_mtn_Ouidah,300000,215,Clémence-Alice Ruiz,1039140,1338925,2022-02-20
CASH_OUT,527769,Clémence-Alice Ruiz,1338925,811156,Agence_mtn_Ouidah,300000,-227769,2022-02-22
CASH_OUT,569517,Clémence-Alice Ruiz,811156,241639,Agence_mtn_Ouidah,300000,-269517,2022-02-23
CASH_OUT,172079,Clémence-Alice Ruiz,241639,69560,Agence_mtn_Abomey,300000,127921,2022-02-23
CASH_IN,68413,Agence_mtn_Cotonou,300000,231587,Clémence-Alice Ruiz,69560,137973,2022-02-23
CASH_IN,236366,Agence_mtn_Abomey,300000,63634,Clémence-Alice Ruiz,137973,374339,2022-02-26
CASH_OUT,154949,Clémence-Alice Ruiz,374339,219390,Agence_mtn_Ouidah,300000,145051,2022-02-26
CASH_IN,20267,Agence_mtn_Ouidah,300000,279733,Jacques Marchand,433000,453267,2022-02-01
CASH_OUT,301248,Jacques Marchand,453267,152019,Agence_mtn_Ouidah,300000,-1248,2022-02-01
CASH_OUT,35406,Jacques Marchand,152019,116613,Agence_mtn_Cotonou,300000,264594,2022-02-01
TRANSFER,13000,Jacques Marchand,116613,103613,Jérôme Laporte Le Gauthier,1592550,1579550,2022-02-02
CASH_IN,235993,Agence_mtn_Cotonou,300000,64007,Jacques Marchand,103613,339606,2022-02-02
TRANSFER,293345,Jacques Marchand,339606,46261,Matthieu Cousin,759949,466604,2022-02-04
CASH_IN,98565,Agence_mtn_Ouidah,300000,201435,Jacques Marchand,46261,144826,2022-02-04
CASH_OUT,49753,Jacques Marchand,144826,95073,Agence_mtn_Abomey,300000,250247,2022-02-05
CASH_OUT,85479,Jacques Marchand,95073,9594,Agence_mtn_Ouidah,300000,214521,2022-02-05
TRANSFER,3510,Jacques Marchand,9594,6084,Céline-Inès Meunier,438149,434639,2022-02-08
TRANSFER,3665,Jacques Marchand,6084,2419,Jacques Laporte de Blanchet,850000,846335,2022-02-10
CASH_OUT,1031,Jacques Marchand,2419,1388,Agence_mtn_Abomey,300000,298969,2022-02-14
CASH_OUT,682,Jacques Marchand,1388,706,Agence_mtn_Abomey,300000,299318,2022-02-14
CASH_OUT,296,Jacques Marchand,706,410,Agence_mtn_Cotonou,300000,299704,2022-02-15
CASH_OUT,121,Jacques Marchand,410,289,Agence_mtn_Cotonou,300000,299879,2022-02-15
CASH_IN,213998,Agence_mtn_Cotonou,300000,86002,Jacques Marchand,289,214287,2022-02-16
CASH_OUT,33139,Jacques Marchand,214287,181148,Agence_mtn_Abomey,300000,266861,2022-02-17
CASH_IN,118984,Agence_mtn_Abomey,300000,181016,Jacques Marchand,181148,300132,2022-02-20
TRANSFER,74355,Olivier Benard,176300,101945,Jacques Marchand,300132,374487,2022-02-20
CASH_IN,144010,Agence_mtn_Abomey,300000,155990,Jacques Marchand,374487,518497,2022-02-20
TRANSFER,381433,Jacques Marchand,518497,137064,Christine Rossi,25247,-356186,2022-02-21
CASH_OUT,82061,Jacques Marchand,137064,55003,Agence_mtn_Abomey,300000,217939,2022-02-21
CASH_IN,59204,Agence_mtn_Abomey,300000,240796,Jacques Marchand,55003,114207,2022-02-21
CASH_IN,247792,Agence_mtn_Cotonou,300000,52208,Jacques Marchand,114207,361999,2022-02-24
CASH_IN,293021,Agence_mtn_Abomey,300000,6979,Jacques Marchand,361999,655020,2022-02-25
CASH_OUT,649015,Jacques Marchand,655020,6005,Agence_mtn_Cotonou,300000,-349015,2022-02-27
CASH_IN,257691,Agence_mtn_Ouidah,300000,42309,Jacques Marchand,6005,263696,2022-02-27
TRANSFER,2009,Roger-Roger Delmas,17130,15121,Matthieu Cousin,466604,468613,2022-02-01
TRANSFER,433264,Matthieu Cousin,468613,35349,Raymond Simon,1791000,1357736,2022-02-02
CASH_OUT,7647,Matthieu Cousin,35349,27702,Agence_mtn_Abomey,300000,292353,2022-02-03
TRANSFER,7245,Matthieu Cousin,27702,20457,Céline-Inès Meunier,434639,427394,2022-02-04
TRANSFER,510408,Maggie Barbier,790674,280266,Matthieu Cousin,20457,530865,2022-02-05
TRANSFER,305818,Matthieu Cousin,530865,225047,Charlotte Perrier,620844,315026,2022-02-08
CASH_OUT,2489,Matthieu Cousin,225047,222558,Agence_mtn_Abomey,300000,297511,2022-02-08
CASH_OUT,58724,Matthieu Cousin,222558,163834,Agence_mtn_Ouidah,300000,241276,2022-02-11
CASH_OUT,14624,Matthieu Cousin,163834,149210,Agence_mtn_Abomey,300000,285376,2022-02-12
CASH_IN,229913,Agence_mtn_Cotonou,300000,70087,Matthieu Cousin,149210,379123,2022-02-14
CASH_IN,216682,Agence_mtn_Ouidah,300000,83318,Matthieu Cousin,379123,595805,2022-02-15
CASH_OUT,125668,Matthieu Cousin,595805,470137,Agence_mtn_Cotonou,300000,174332,2022-02-16
TRANSFER,18120,Louis de la Imbert,118400,100280,Matthieu Cousin,470137,488257,2022-02-16
CASH_OUT,79197,Matthieu Cousin,488257,409060,Agence_mtn_Ouidah,300000,220803,2022-02-16
CASH_IN,100436,Agence_mtn_Abomey,300000,199564,Matthieu Cousin,409060,509496,2022-02-18
CASH_OUT,183307,Matthieu Cousin,509496,326189,Agence_mtn_Ouidah,300000,116693,2022-02-18
CASH_OUT,196536,Matthieu Cousin,326189,129653,Agence_mtn_Ouidah,300000,103464,2022-02-18
TRANSFER,865683,Maurice de Brunet,869575,3892,Matthieu Cousin,129653,995336,2022-02-18
CASH_IN,170093,Agence_mtn_Ouidah,300000,129907,Matthieu Cousin,995336,1165429,2022-02-19
CASH_OUT,761021,Matthieu Cousin,1165429,404408,Agence_mtn_Cotonou,300000,-461021,2022-02-20
CASH_IN,102720,Agence_mtn_Ouidah,300000,197280,Matthieu Cousin,404408,507128,2022-02-22
TRANSFER,126523,Matthieu Cousin,507128,380605,Jules-Marc Chauvet,1913600,1787077,2022-02-23
CASH_OUT,108417,Matthieu Cousin,380605,272188,Agence_mtn_Cotonou,300000,191583,2022-02-24
TRANSFER,94655,Matthieu Cousin,272188,177533,Anouk Delahaye-Gimenez,361569,266914,2022-02-24
CASH_OUT,84091,Matthieu Cousin,177533,93442,Agence_mtn_Ouidah,300000,215909,2022-02-26
TRANSFER,40497,Matthieu Cousin,93442,52945,Éléonore Marin Le Morel,404632,364135,2022-02-26
CASH_OUT,124067,René de la Delaunay,179600,55533,Agence_mtn_Cotonou,300000,175933,2022-02-01
TRANSFER,2747,René de la Delaunay,55533,52786,Raymond de Le Roux,253980,251233,2022-02-02
CASH_OUT,47184,René de la Delaunay,52786,5602,Agence_mtn_Cotonou,300000,252816,2022-02-03
CASH_OUT,916,René de la Delaunay,5602,4686,Agence_mtn_Abomey,300000,299084,2022-02-04
TRANSFER,3064,René de la Delaunay,4686,1622,Maurice de Brunet,3892,828,2022-02-05
CASH_IN,102207,Agence_mtn_Abomey,300000,197793,René de la Delaunay,1622,103829,2022-02-07
CASH_IN,103511,Agence_mtn_Ouidah,300000,196489,René de la Delaunay,103829,207340,2022-02-07
TRANSFER,44575,René de la Delaunay,207340,162765,Élise Monnier,1140829,1096254,2022-02-08
CASH_OUT,99140,René de la Delaunay,162765,63625,Agence_mtn_Cotonou,300000,200860,2022-02-09
TRANSFER,128241,Valérie de Pottier,148380,20139,René de la Delaunay,63625,191866,2022-02-09
CASH_IN,192307,Agence_mtn_Abomey,300000,107693,René de la Delaunay,191866,384173,2022-02-10
CASH_IN,282893,Agence_mtn_Cotonou,300000,17107,René de la Delaunay,384173,667066,2022-02-11
CASH_IN,241028,Agence_mtn_Ouidah,300000,58972,René de la Delaunay,667066,908094,2022-02-11
CASH_IN,102645,Agence_mtn_Cotonou,300000,197355,René de la Delaunay,908094,1010739,2022-02-13
CASH_IN,33331,Agence_mtn_Abomey,300000,266669,René de la Delaunay,1010739,1044070,2022-02-16
CASH_OUT,770507,René de la Delaunay,1044070,273563,Agence_mtn_Cotonou,300000,-470507,2022-02-16
TRANSFER,1456,René de la Delaunay,273563,272107,Charles Guérin,669300,667844,2022-02-16
TRANSFER,1094479,Jérôme Laporte Le Gauthier,1579550,485071,René de la Delaunay,272107,1366586,2022-02-17
TRANSFER,1188402,René de la Delaunay,1366586,178184,Éléonore Marin Le Morel,364135,-824267,2022-02-18
TRANSFER,50057,Alexandre Blanchard,172210,122153,René de la Delaunay,178184,228241,2022-02-18
CASH_OUT,178586,René de la Delaunay,228241,49655,Agence_mtn_Cotonou,300000,121414,2022-02-20
CASH_OUT,8639,René de la Delaunay,49655,41016,Agence_mtn_Ouidah,300000,291361,2022-02-20
TRANSFER,522881,Laurent Marion,1557500,1034619,René de la Delaunay,41016,563897,2022-02-21
CASH_OUT,136363,René de la Delaunay,563897,427534,Agence_mtn_Cotonou,300000,163637,2022-02-22
CASH_IN,49384,Agence_mtn_Cotonou,300000,250616,René de la Delaunay,427534,476918,2022-02-24
TRANSFER,471367,René de la Delaunay,476918,5551,Jérôme Laporte Le Gauthier,485071,13704,2022-02-25
TRANSFER,415959,Honoré Grégoire-Breton,1022100,606141,Marc Baudry,256013,671972,2022-02-01
CASH_IN,116127,Agence_mtn_Ouidah,300000,183873,Marc Baudry,671972,788099,2022-02-02
CASH_OUT,290562,Marc Baudry,788099,497537,Agence_mtn_Abomey,300000,9438,2022-02-03
TRANSFER,244525,Nicole-Renée Gay,509713,265188,Marc Baudry,497537,742062,2022-02-06
TRANSFER,597369,Marc Baudry,742062,144693,Emmanuel Vallée,245140,-352229,2022-02-07
CASH_OUT,91335,Marc Baudry,144693,53358,Agence_mtn_Ouidah,300000,208665,2022-02-07
TRANSFER,109288,Maggie Barbier,280266,170978,Marc Baudry,53358,162646,2022-02-11
CASH_IN,212320,Agence_mtn_Cotonou,300000,87680,Marc Baudry,162646,374966,2022-02-12
CASH_OUT,243228,Marc Baudry,374966,131738,Agence_mtn_Abomey,300000,56772,2022-02-14
CASH_OUT,54847,Marc Baudry,131738,76891,Agence_mtn_Abomey,300000,245153,2022-02-15
TRANSFER,8913,Jérôme Laporte Le Gauthier,13704,4791,Marc Baudry,76891,85804,2022-02-15
CASH_OUT,74799,Marc Baudry,85804,11005,Agence_mtn_Ouidah,300000,225201,2022-02-15
TRANSFER,3051,Jérôme Laporte Le Gauthier,4791,1740,Marc Baudry,11005,14056,2022-02-16
TRANSFER,2406,Marc Baudry,14056,11650,Gilbert Moulin,1584,-822,2022-02-17
TRANSFER,7732,Marc Baudry,11650,3918,Roger-Roger Delmas,15121,7389,2022-02-18
CASH_OUT,3654,Marc Baudry,3918,264,Agence_mtn_Abomey,300000,296346,2022-02-19
CASH_IN,54117,Agence_mtn_Abomey,300000,245883,Marc Baudry,264,54381,2022-02-21
CASH_OUT,14376,Marc Baudry,54381,40005,Agence_mtn_Ouidah,300000,285624,2022-02-22
TRANSFER,208847,Aurélie Maury,733885,525038,Marc Baudry,40005,248852,2022-02-23
TRANSFER,234583,Véronique Hardy,1157700,923117,Marc Baudry,248852,483435,2022-02-24
CASH_OUT,480890,Marc Baudry,483435,2545,Agence_mtn_Cotonou,300000,-180890,2022-02-24
CASH_IN,238521,Agence_mtn_Abomey,300000,61479,Marc Baudry,2545,241066,2022-02-25
CASH_IN,116514,Agence_mtn_Cotonou,300000,183486,Marc Baudry,241066,357580,2022-02-27
CASH_OUT,745507,Laurent Marion,1034619,289112,Agence_mtn_Ouidah,300000,-445507,2022-02-04
TRANSFER,192425,Laurent Marion,289112,96687,Jérôme Laporte Le Gauthier,1740,-190685,2022-02-05
CASH_OUT,14393,Laurent Marion,96687,82294,Agence_mtn_Cotonou,300000,285607,2022-02-05
CASH_OUT,29765,Laurent Marion,82294,52529,Agence_mtn_Ouidah,300000,270235,2022-02-06
TRANSFER,969,Laurent Marion,52529,51560,Alexandre Blanchard,122153,121184,2022-02-07
CASH_IN,269875,Agence_mtn_Cotonou,300000,30125,Laurent Marion,51560,321435,2022-02-08
CASH_IN,286254,Agence_mtn_Cotonou,300000,13746,Laurent Marion,321435,607689,2022-02-08
CASH_IN,115414,Agence_mtn_Cotonou,300000,184586,Laurent Marion,607689,723103,2022-02-09
TRANSFER,337962,Sabine Perrier,747947,409985,Laurent Marion,723103,1061065,2022-02-10
TRANSFER,86347,Laurent Marion,1061065,974718,Margaud-Michelle Briand,22990,-63357,2022-02-10
TRANSFER,92470,Laurent Marion,974718,882248,Stéphanie Guichard,424600,332130,2022-02-10
CASH_OUT,294221,Laurent Marion,882248,588027,Agence_mtn_Ouidah,300000,5779,2022-02-11
CASH_IN,86689,Agence_mtn_Abomey,300000,213311,Laurent Marion,588027,674716,2022-02-13
CASH_IN,29332,Agence_mtn_Ouidah,300000,270668,Laurent Marion,674716,704048,2022-02-13
CASH_OUT,316119,Laurent Marion,704048,387929,Agence_mtn_Abomey,300000,-16119,2022-02-15
CASH_IN,145903,Agence_mtn_Ouidah,300000,154097,Laurent Marion,387929,533832,2022-02-15
CASH_IN,173963,Agence_mtn_Cotonou,300000,126037,Laurent Marion,533832,707795,2022-02-21
CASH_IN,267351,Agence_mtn_Cotonou,300000,32649,Laurent Marion,707795,975146,2022-02-21
CASH_OUT,883772,Laurent Marion,975146,91374,Agence_mtn_Abomey,300000,-583772,2022-02-22
TRANSFER,11520,Laurent Marion,91374,79854,Jacques Laporte de Blanchet,846335,834815,2022-02-22
TRANSFER,64753,Laurent Marion,79854,15101,Nicole-Renée Gay,265188,200435,2022-02-22
CASH_IN,145263,Agence_mtn_Ouidah,300000,154737,Laurent Marion,15101,160364,2022-02-22
CASH_OUT,67248,Laurent Marion,160364,93116,Agence_mtn_Ouidah,300000,232752,2022-02-22
CASH_OUT,10575,Laurent Marion,93116,82541,Agence_mtn_Ouidah,300000,289425,2022-02-22
TRANSFER,24413,Laurent Marion,82541,58128,Maggie Barbier,170978,146565,2022-02-24
TRANSFER,17019,Laurent Marion,58128,41109,Édouard Grondin du Fleury,456700,439681,2022-02-24
CASH_OUT,33875,Laurent Marion,41109,7234,Agence_mtn_Ouidah,300000,266125,2022-02-24
CASH_IN,198910,Agence_mtn_Abomey,300000,101090,Laurent Marion,7234,206144,2022-02-25
CASH_OUT,140618,Laurent Marion,206144,65526,Agence_mtn_Cotonou,300000,159382,2022-02-26
CASH_IN,56967,Agence_mtn_Cotonou,300000,243033,Robert Henry-Poulain,-113170,-56203,2022-02-01
CASH_IN,172953,Agence_mtn_Ouidah,300000,127047,Robert Henry-Poulain,-56203,116750,2022-02-03
CASH_IN,286209,Agence_mtn_Ouidah,300000,13791,Robert Henry-Poulain,116750,402959,2022-02-04
CASH_OUT,249038,Robert Henry-Poulain,402959,153921,Agence_mtn_Abomey,300000,50962,2022-02-05
CASH_OUT,101369,Robert Henry-Poulain,153921,52552,Agence_mtn_Ouidah,300000,198631,2022-02-05
CASH_IN,257991,Agence_mtn_Abomey,300000,42009,Robert Henry-Poulain,52552,310543,2022-02-05
CASH_IN,198204,Agence_mtn_Ouidah,300000,101796,Robert Henry-Poulain,310543,508747,2022-02-05
CASH_IN,99223,Agence_mtn_Ouidah,300000,200777,Robert Henry-Poulain,508747,607970,2022-02-06
CASH_OUT,264764,Robert Henry-Poulain,607970,343206,Agence_mtn_Ouidah,300000,35236,2022-02-06
CASH_IN,287695,Agence_mtn_Cotonou,300000,12305,Robert Henry-Poulain,343206,630901,2022-02-07
CASH_IN,93459,Agence_mtn_Ouidah,300000,206541,Robert Henry-Poulain,630901,724360,2022-02-08
CASH_IN,281108,Agence_mtn_Ouidah,300000,18892,Robert Henry-Poulain,724360,1005468,2022-02-08
CASH_IN,24160,Agence_mtn_Ouidah,300000,275840,Robert Henry-Poulain,1005468,1029628,2022-02-09
CASH_OUT,176993,Robert Henry-Poulain,1029628,852635,Agence_mtn_Abomey,300000,123007,2022-02-09
CASH_OUT,490511,Robert Henry-Poulain,852635,362124,Agence_mtn_Cotonou,300000,-190511,2022-02-12
CASH_IN,204564,Agence_mtn_Abomey,300000,95436,Robert Henry-Poulain,362124,566688,2022-02-12
TRANSFER,97633,Michèle Faivre,176668,79035,Robert Henry-Poulain,566688,664321,2022-02-14
CASH_OUT,109433,Robert Henry-Poulain,664321,554888,Agence_mtn_Abomey,300000,190567,2022-02-16
CASH_IN,220292,Agence_mtn_Abomey,300000,79708,Robert Henry-Poulain,554888,775180,2022-02-17
CASH_OUT,91517,Robert Henry-Poulain,775180,683663,Agence_mtn_Ouidah,300000,208483,2022-02-17
TRANSFER,676197,Robert Henry-Poulain,683663,7466,Sophie-Anouk Boulanger,667146,-9051,2022-02-19
CASH_IN,24358,Agence_mtn_Ouidah,300000,275642,Robert Henry-Poulain,7466,31824,2022-02-19
CASH_IN,113502,Agence_mtn_Abomey,300000,186498,Robert Henry-Poulain,31824,145326,2022-02-19
TRANSFER,1461129,Corinne Roussel,1841200,380071,Robert Henry-Poulain,145326,1606455,2022-02-20
CASH_OUT,844046,Robert Henry-Poulain,1606455,762409,Agence_mtn_Ouidah,300000,-544046,2022-02-22
TRANSFER,517050,Robert Henry-Poulain,762409,245359,Maggie Barbier,146565,-370485,2022-02-22
CASH_IN,259064,Agence_mtn_Ouidah,300000,40936,Robert Henry-Poulain,245359,504423,2022-02-25
CASH_IN,289455,Agence_mtn_Ouidah,300000,10545,Robert Henry-Poulain,504423,793878,2022-02-26
TRANSFER,634,Maurice de Brunet,828,194,Robert Henry-Poulain,793878,794512,2022-02-27
TRANSFER,176643,Sébastien Coste,699000,522357,Robert Henry-Poulain,794512,971155,2022-02-27
CASH_IN,161830,Agence_mtn_Cotonou,300000,138170,Henri de Didier,-17759,144071,2022-02-01
CASH_IN,119991,Agence_mtn_Ouidah,300000,180009,Henri de Didier,144071,264062,2022-02-02
TRANSFER,5458,Henri de Didier,264062,258604,Martin Moreau,370235,364777,2022-02-03
TRANSFER,356468,Aurélie Maury,525038,168570,Henri de Didier,258604,615072,2022-02-03
CASH_OUT,536063,Henri de Didier,615072,79009,Agence_mtn_Abomey,300000,-236063,2022-02-04
CASH_OUT,37145,Henri de Didier,79009,41864,Agence_mtn_Abomey,300000,262855,2022-02-05
TRANSFER,1243309,Maryse Delorme,1293500,50191,Henri de Didier,41864,1285173,2022-02-06
CASH_IN,286180,Agence_mtn_Cotonou,300000,13820,Henri de Didier,1285173,1571353,2022-02-08
TRANSFER,1117025,Jules-Marc Chauvet,1787077,670052,Henri de Didier,1571353,2688378,2022-02-08
CASH_OUT,2124925,Henri de Didier,2688378,563453,Agence_mtn_Ouidah,300000,-1824925,2022-02-08
CASH_IN,65621,Agence_mtn_Abomey,300000,234379,Henri de Didier,563453,629074,2022-02-08
TRANSFER,479661,Sébastien Coste,522357,42696,Henri de Didier,629074,1108735,2022-02-11
TRANSFER,176535,Marine Chevallier,215900,39365,Henri de Didier,1108735,1285270,2022-02-11
CASH_IN,113041,Agence_mtn_Cotonou,300000,186959,Henri de Didier,1285270,1398311,2022-02-11
CASH_OUT,436239,Henri de Didier,1398311,962072,Agence_mtn_Ouidah,300000,-136239,2022-02-16
CASH_IN,102426,Agence_mtn_Abomey,300000,197574,Henri de Didier,962072,1064498,2022-02-16
CASH_IN,159926,Agence_mtn_Cotonou,300000,140074,Henri de Didier,1064498,1224424,2022-02-19
CASH_IN,77885,Agence_mtn_Abomey,300000,222115,Henri de Didier,1224424,1302309,2022-02-21
CASH_IN,224367,Agence_mtn_Ouidah,300000,75633,Henri de Didier,1302309,1526676,2022-02-21
CASH_IN,259883,Agence_mtn_Abomey,300000,40117,Henri de Didier,1526676,1786559,2022-02-22
CASH_IN,244151,Agence_mtn_Cotonou,300000,55849,Henri de Didier,1786559,2030710,2022-02-23
TRANSFER,565009,Henri de Didier,2030710,1465701,Thérèse-Juliette Camus,1037700,472691,2022-02-23
TRANSFER,44883,Henri de Didier,1465701,1420818,Valérie de Pottier,20139,-24744,2022-02-25
TRANSFER,159498,Zacharie Fabre,1246000,1086502,Henri de Didier,1420818,1580316,2022-02-25
CASH_OUT,860211,Henri de Didier,1580316,720105,Agence_mtn_Ouidah,300000,-560211,2022-02-26
CASH_OUT,467301,Honoré Grégoire-Breton,606141,138840,Agence_mtn_Abomey,300000,-167301,2022-02-01
TRANSFER,527037,Zacharie Fabre,1086502,559465,Honoré Grégoire-Breton,138840,665877,2022-02-01
CASH_OUT,61516,Honoré Grégoire-Breton,665877,604361,Agence_mtn_Abomey,300000,238484,2022-02-02
TRANSFER,380491,Honoré Grégoire-Breton,604361,223870,Anouk Delahaye-Gimenez,266914,-113577,2022-02-03
TRANSFER,118090,Honoré Grégoire-Breton,223870,105780,Maurice de Brunet,194,-117896,2022-02-06
TRANSFER,246896,Raymond de Le Roux,251233,4337,Honoré Grégoire-Breton,105780,352676,2022-02-06
CASH_IN,160340,Agence_mtn_Abomey,300000,139660,Honoré Grégoire-Breton,352676,513016,2022-02-06
CASH_IN,146872,Agence_mtn_Ouidah,300000,153128,Honoré Grégoire-Breton,513016,659888,2022-02-07
TRANSFER,622353,Honoré Grégoire-Breton,659888,37535,Céline-Inès Meunier,427394,-194959,2022-02-08
CASH_IN,49338,Agence_mtn_Cotonou,300000,250662,Honoré Grégoire-Breton,37535,86873,2022-02-09
CASH_OUT,14396,Honoré Grégoire-Breton,86873,72477,Agence_mtn_Ouidah,300000,285604,2022-02-11
CASH_IN,192741,Agence_mtn_Ouidah,300000,107259,Honoré Grégoire-Breton,72477,265218,2022-02-11
TRANSFER,59067,Honoré Grégoire-Breton,265218,206151,Augustin-Jérôme Merle,739940,680873,2022-02-11
CASH_OUT,5474,Honoré Grégoire-Breton,206151,200677,Agence_mtn_Abomey,300000,294526,2022-02-12
TRANSFER,123755,Honoré Grégoire-Breton,200677,76922,Corinne Roussel,380071,256316,2022-02-15
CASH_IN,229930,Agence_mtn_Ouidah,300000,70070,Honoré Grégoire-Breton,76922,306852,2022-02-17
CASH_OUT,275606,Honoré Grégoire-Breton,306852,31246,Agence_mtn_Cotonou,300000,24394,2022-02-17
TRANSFER,399276,Élise Monnier,1096254,696978,Honoré Grégoire-Breton,31246,430522,2022-02-18
CASH_IN,82363,Agence_mtn_Ouidah,300000,217637,Honoré Grégoire-Breton,430522,512885,2022-02-18
TRANSFER,151934,Thibault-Julien Chevallier,317694,165760,Honoré Grégoire-Breton,512885,664819,2022-02-19
CASH_OUT,303906,Honoré Grégoire-Breton,664819,360913,Agence_mtn_Abomey,300000,-3906,2022-02-20
TRANSFER,1814,Raymond de Le Roux,4337,2523,Honoré Grégoire-Breton,360913,362727,2022-02-21
TRANSFER,2982,Honoré Grégoire-Breton,362727,359745,Jules-Marc Chauvet,670052,667070,2022-02-21
TRANSFER,295166,Honoré Grégoire-Breton,359745,64579,Valérie-Claudine Marin,1354810,1059644,2022-02-23
CASH_OUT,10235,Honoré Grégoire-Breton,64579,54344,Agence_mtn_Abomey,300000,289765,2022-02-23
CASH_IN,13322,Agence_mtn_Abomey,300000,286678,Honoré Grégoire-Breton,54344,67666,2022-02-23
CASH_IN,243242,Agence_mtn_Ouidah,300000,56758,Honoré Grégoire-Breton,67666,310908,2022-02-24
CASH_IN,183244,Agence_mtn_Abomey,300000,116756,Honoré Grégoire-Breton,310908,494152,2022-02-25
CASH_IN,289109,Agence_mtn_Ouidah,300000,10891,Honoré Grégoire-Breton,494152,783261,2022-02-27
CASH_IN,255438,Agence_mtn_Cotonou,300000,44562,Honoré Grégoire-Breton,783261,1038699,2022-02-27
CASH_IN,67810,Agence_mtn_Abomey,300000,232190,Nicole Huet,1437718,1505528,2022-02-01
CASH_IN,207839,Agence_mtn_Abomey,300000,92161,Nicole Huet,1505528,1713367,2022-02-04
TRANSFER,459009,Nicole Huet,1713367,1254358,Thérèse-Juliette Camus,472691,13682,2022-02-05
CASH_OUT,800523,Nicole Huet,1254358,453835,Agence_mtn_Cotonou,300000,-500523,2022-02-06
CASH_OUT,270418,Nicole Huet,453835,183417,Agence_mtn_Abomey,300000,29582,2022-02-08
CASH_IN,204445,Agence_mtn_Cotonou,300000,95555,Nicole Huet,183417,387862,2022-02-08
TRANSFER,19573,Élise Monnier,696978,677405,Nicole Huet,387862,407435,2022-02-09
TRANSFER,46124,Nathalie-Claire De Oliveira,133036,86912,Nicole Huet,407435,453559,2022-02-09
CASH_IN,270782,Agence_mtn_Cotonou,300000,29218,Nicole Huet,453559,724341,2022-02-10
CASH_OUT,379190,Nicole Huet,724341,345151,Agence_mtn_Abomey,300000,-79190,2022-02-11
CASH_OUT,303872,Nicole Huet,345151,41279,Agence_mtn_Cotonou,300000,-3872,2022-02-12
CASH_IN,269664,Agence_mtn_Abomey,300000,30336,Nicole Huet,41279,310943,2022-02-14
TRANSFER,1238357,Raymond Simon,1357736,119379,Nicole Huet,310943,1549300,2022-02-14
CASH_OUT,586925,Nicole Huet,1549300,962375,Agence_mtn_Cotonou,300000,-286925,2022-02-14
CASH_IN,162996,Agence_mtn_Abomey,300000,137004,Nicole Huet,962375,1125371,2022-02-15
CASH_OUT,390541,Nicole Huet,1125371,734830,Agence_mtn_Cotonou,300000,-90541,2022-02-15
CASH_OUT,577396,Nicole Huet,734830,157434,Agence_mtn_Cotonou,300000,-277396,2022-02-15
TRANSFER,260508,Élise Monnier,677405,416897,Nicole Huet,157434,417942,2022-02-17
TRANSFER,65222,Olivier Benard,101945,36723,Nicole Huet,417942,483164,2022-02-18
TRANSFER,305500,Nicole Huet,483164,177664,Charlotte Perrier,315026,9526,2022-02-20
CASH_IN,671,Agence_mtn_Ouidah,300000,299329,Nicole Huet,177664,178335,2022-02-21
TRANSFER,59379,Marcel de la Buisson,79964,20585,Nicole Huet,178335,237714,2022-02-21
TRANSFER,17542,Nicole Huet,237714,220172,Jacques Laporte de Blanchet,834815,817273,2022-02-22
TRANSFER,198628,Nicole Huet,220172,21544,Louis de la Imbert,100280,-98348,2022-02-24
CASH_IN,227418,Agence_mtn_Ouidah,300000,72582,Nicole Huet,21544,248962,2022-02-25
CASH_IN,208890,Agence_mtn_Ouidah,300000,91110,Nicole Huet,248962,457852,2022-02-27
CASH_OUT,478791,Georges Muller,1881200,1402409,Agence_mtn_Cotonou,300000,-178791,2022-02-01
CASH_OUT,1356438,Georges Muller,1402409,45971,Agence_mtn_Abomey,300000,-1056438,2022-02-02
CASH_IN,5560,Agence_mtn_Ouidah,300000,294440,Georges Muller,45971,51531,2022-02-03
CASH_IN,201076,Agence_mtn_Abomey,300000,98924,Georges Muller,51531,252607,2022-02-04
CASH_OUT,111504,Georges Muller,252607,141103,Agence_mtn_Cotonou,300000,188496,2022-02-06
TRANSFER,98975,Georges Muller,141103,42128,Édouard Grondin du Fleury,439681,340706,2022-02-11
CASH_OUT,20065,Georges Muller,42128,22063,Agence_mtn_Abomey,300000,279935,2022-02-11
CASH_IN,261043,Agence_mtn_Ouidah,300000,38957,Georges Muller,22063,283106,2022-02-13
TRANSFER,171891,Georges Muller,283106,111215,Georges Muller,283106,111215,2022-02-13
CASH_OUT,28132,Georges Muller,111215,83083,Agence_mtn_Abomey,300000,271868,2022-02-16
CASH_OUT,4175,Georges Muller,83083,78908,Agence_mtn_Ouidah,300000,295825,2022-02-17
CASH_OUT,51827,Georges Muller,78908,27081,Agence_mtn_Ouidah,300000,248173,2022-02-18
CASH_OUT,14300,Georges Muller,27081,12781,Agence_mtn_Abomey,300000,285700,2022-02-19
CASH_IN,275651,Agence_mtn_Ouidah,300000,24349,Georges Muller,12781,288432,2022-02-19
CASH_OUT,257762,Georges Muller,288432,30670,Agence_mtn_Cotonou,300000,42238,2022-02-20
CASH_IN,284464,Agence_mtn_Abomey,300000,15536,Georges Muller,30670,315134,2022-02-22
CASH_IN,74001,Agence_mtn_Abomey,300000,225999,Georges Muller,315134,389135,2022-02-22
CASH_IN,125369,Agence_mtn_Abomey,300000,174631,Georges Muller,389135,514504,2022-02-23
TRANSFER,11961,Georges Muller,514504,502543,Guillaume de la Nguyen,65561,53600,2022-02-23
CASH_IN,170515,Agence_mtn_Abomey,300000,129485,Georges Muller,502543,673058,2022-02-25
TRANSFER,453184,Georges Muller,673058,219874,Charles Guérin,667844,214660,2022-02-26
CASH_IN,11608,Agence_mtn_Cotonou,300000,288392,Jacques Laporte de Blanchet,817273,828881,2022-02-01
CASH_OUT,519976,Jacques Laporte de Blanchet,828881,308905,Agence_mtn_Abomey,300000,-219976,2022-02-01
CASH_IN,12690,Agence_mtn_Cotonou,300000,287310,Jacques Laporte de Blanchet,308905,321595,2022-02-04
TRANSFER,199885,Jacques Laporte de Blanchet,321595,121710,Charles Guérin,214660,14775,2022-02-04
CASH_OUT,27664,Jacques Laporte de Blanchet,121710,94046,Agence_mtn_Ouidah,300000,272336,2022-02-07
CASH_OUT,44077,Jacques Laporte de Blanchet,94046,49969,Agence_mtn_Cotonou,300000,255923,2022-02-08
TRANSFER,18245,Maryse Delorme,50191,31946,Jacques Laporte de Blanchet,49969,68214,2022-02-08
CASH_OUT,16145,Jacques Laporte de Blanchet,68214,52069,Agence_mtn_Cotonou,300000,283855,2022-02-09
CASH_OUT,41667,Jacques Laporte de Blanchet,52069,10402,Agence_mtn_Cotonou,300000,258333,2022-02-09
CASH_IN,144022,Agence_mtn_Cotonou,300000,155978,Jacques Laporte de Blanchet,10402,154424,2022-02-09
CASH_IN,27594,Agence_mtn_Abomey,300000,272406,Jacques Laporte de Blanchet,154424,182018,2022-02-09
TRANSFER,56436,Jacques Laporte de Blanchet,182018,125582,Édouard Grondin du Fleury,340706,284270,2022-02-10
CASH_OUT,16990,Jacques Laporte de Blanchet,125582,108592,Agence_mtn_Cotonou,300000,283010,2022-02-10
CASH_OUT,60006,Jacques Laporte de Blanchet,108592,48586,Agence_mtn_Cotonou,300000,239994,2022-02-11
CASH_OUT,37030,Jacques Laporte de Blanchet,48586,11556,Agence_mtn_Cotonou,300000,262970,2022-02-12
TRANSFER,1977,Jacques Laporte de Blanchet,11556,9579,Pénélope Boulay,1375500,1373523,2022-02-15
CASH_OUT,8491,Jacques Laporte de Blanchet,9579,1088,Agence_mtn_Abomey,300000,291509,2022-02-16
CASH_OUT,982,Jacques Laporte de Blanchet,1088,106,Agence_mtn_Ouidah,300000,299018,2022-02-18
CASH_OUT,103,Jacques Laporte de Blanchet,106,3,Agence_mtn_Ouidah,300000,299897,2022-02-22
CASH_IN,119970,Agence_mtn_Cotonou,300000,180030,Jacques Laporte de Blanchet,3,119973,2022-02-24
CASH_IN,185622,Agence_mtn_Cotonou,300000,114378,Jacques Laporte de Blanchet,119973,305595,2022-02-25
CASH_IN,55484,Agence_mtn_Abomey,300000,244516,Jacques Laporte de Blanchet,305595,361079,2022-02-25
CASH_OUT,8576,Jacques Laporte de Blanchet,361079,352503,Agence_mtn_Cotonou,300000,291424,2022-02-26
CASH_IN,15562,Agence_mtn_Abomey,300000,284438,Édouard Grondin du Fleury,284270,299832,2022-02-02
CASH_IN,22292,Agence_mtn_Abomey,300000,277708,Édouard Grondin du Fleury,299832,322124,2022-02-06
TRANSFER,1158,Raymond de Le Roux,2523,1365,Édouard Grondin du Fleury,322124,323282,2022-02-07
TRANSFER,236800,Édouard Grondin du Fleury,323282,86482,Édouard Grondin du Fleury,323282,560082,2022-02-08
CASH_IN,116511,Agence_mtn_Cotonou,300000,183489,Édouard Grondin du Fleury,86482,202993,2022-02-08
TRANSFER,34523,Édouard Grondin du Fleury,202993,168470,Olivier Benard,36723,2200,2022-02-08
TRANSFER,122416,Édouard Grondin du Fleury,168470,46054,Pénélope Boulay,1373523,1251107,2022-02-10
CASH_OUT,44289,Édouard Grondin du Fleury,46054,1765,Agence_mtn_Ouidah,300000,255711,2022-02-10
CASH_OUT,1066,Édouard Grondin du Fleury,1765,699,Agence_mtn_Ouidah,300000,298934,2022-02-10
CASH_OUT,650,Édouard Grondin du Fleury,699,49,Agence_mtn_Abomey,300000,299350,2022-02-11
CASH_IN,94954,Agence_mtn_Ouidah,300000,205046,Édouard Grondin du Fleury,49,95003,2022-02-12
TRANSFER,3013,Édouard Grondin du Fleury,95003,91990,Thérèse-Juliette Camus,13682,10669,2022-02-13
CASH_OUT,9685,Édouard Grondin du Fleury,91990,82305,Agence_mtn_Abomey,300000,290315,2022-02-15
TRANSFER,3237,Charles Guérin,14775,11538,Édouard Grondin du Fleury,82305,85542,2022-02-15
CASH_IN,10340,Agence_mtn_Ouidah,300000,289660,Édouard Grondin du Fleury,85542,95882,2022-02-15
CASH_IN,169998,Agence_mtn_Cotonou,300000,130002,Édouard Grondin du Fleury,95882,265880,2022-02-16
TRANSFER,176332,Édouard Grondin du Fleury,265880,89548,Marine Chevallier,39365,-136967,2022-02-16
CASH_IN,232602,Agence_mtn_Ouidah,300000,67398,Édouard Grondin du Fleury,89548,322150,2022-02-16
CASH_IN,202357,Agence_mtn_Ouidah,300000,97643,Édouard Grondin du Fleury,322150,524507,2022-02-17
TRANSFER,657128,Augustin-Jérôme Merle,680873,23745,Édouard Grondin du Fleury,524507,1181635,2022-02-17
TRANSFER,105643,Aurélie Maury,168570,62927,Édouard Grondin du Fleury,1181635,1287278,2022-02-18
TRANSFER,811358,Édouard Grondin du Fleury,1287278,475920,Michèle Faivre,79035,-732323,2022-02-21
CASH_IN,269764,Agence_mtn_Ouidah,300000,30236,Édouard Grondin du Fleury,475920,745684,2022-02-22
CASH_IN,206133,Agence_mtn_Cotonou,300000,93867,Édouard Grondin du Fleury,745684,951817,2022-02-22
CASH_IN,180845,Agence_mtn_Cotonou,300000,119155,Édouard Grondin du Fleury,951817,1132662,2022-02-23
TRANSFER,997633,Édouard Grondin du Fleury,1132662,135029,Élise Monnier,416897,-580736,2022-02-24
CASH_OUT,131659,Édouard Grondin du Fleury,135029,3370,Agence_mtn_Cotonou,300000,168341,2022-02-24
CASH_IN,192171,Agence_mtn_Cotonou,300000,107829,Édouard Grondin du Fleury,3370,195541,2022-02-24
CASH_IN,172138,Agence_mtn_Cotonou,300000,127862,Christophe Besnard-Diaz,303700,475838,2022-02-01
TRANSFER,3641,Thérèse-Juliette Camus,10669,7028,Christophe Besnard-Diaz,475838,479479,2022-02-02
TRANSFER,133968,Christophe Besnard-Diaz,479479,345511,Augustin-Jérôme Merle,23745,-110223,2022-02-02
TRANSFER,258148,Christophe Besnard-Diaz,345511,87363,Sabine Perrier,409985,151837,2022-02-03
TRANSFER,75498,Alexandre Delaunay,79688,4190,Christophe Besnard-Diaz,87363,162861,2022-02-04
CASH_OUT,118335,Christophe Besnard-Diaz,162861,44526,Agence_mtn_Ouidah,300000,181665,2022-02-05
TRANSFER,14317,Françoise Denis de Allard,27948,13631,Christophe Besnard-Diaz,44526,58843,2022-02-05
CASH_OUT,21498,Christophe Besnard-Diaz,58843,37345,Agence_mtn_Cotonou,300000,278502,2022-02-06
TRANSFER,477012,Zacharie Fabre,559465,82453,Christophe Besnard-Diaz,37345,514357,2022-02-06
CASH_IN,171037,Agence_mtn_Abomey,300000,128963,Christophe Besnard-Diaz,514357,685394,2022-02-09
TRANSFER,14389,Marcel de la Buisson,20585,6196,Christophe Besnard-Diaz,685394,699783,2022-02-10
CASH_OUT,178621,Christophe Besnard-Diaz,699783,521162,Agence_mtn_Abomey,300000,121379,2022-02-10
CASH_IN,38420,Agence_mtn_Abomey,300000,261580,Christophe Besnard-Diaz,521162,559582,2022-02-14
TRANSFER,8095,Charlotte Perrier,9526,1431,Christophe Besnard-Diaz,559582,567677,2022-02-14
CASH_OUT,134087,Christophe Besnard-Diaz,567677,433590,Agence_mtn_Ouidah,300000,165913,2022-02-15
CASH_IN,134628,Agence_mtn_Abomey,300000,165372,Christophe Besnard-Diaz,433590,568218,2022-02-17
CASH_OUT,539405,Christophe Besnard-Diaz,568218,28813,Agence_mtn_Cotonou,300000,-239405,2022-02-17
CASH_OUT,13777,Christophe Besnard-Diaz,28813,15036,Agence_mtn_Ouidah,300000,286223,2022-02-17
TRANSFER,105639,Madeleine Hardy,114600,8961,Christophe Besnard-Diaz,15036,120675,2022-02-21
TRANSFER,1572,Olivier Benard,2200,628,Christophe Besnard-Diaz,120675,122247,2022-02-21
TRANSFER,271,Olivier Benard,628,357,Christophe Besnard-Diaz,122247,122518,2022-02-21
TRANSFER,51866,Alexandre Blanchard,121184,69318,Christophe Besnard-Diaz,122518,174384,2022-02-21
CASH_IN,26684,Agence_mtn_Abomey,300000,273316,Christophe Besnard-Diaz,174384,201068,2022-02-22
TRANSFER,43948,Alexandre Blanchard,69318,25370,Christophe Besnard-Diaz,201068,245016,2022-02-22
CASH_IN,134988,Agence_mtn_Cotonou,300000,165012,Christophe Besnard-Diaz,245016,380004,2022-02-23
CASH_IN,113876,Agence_mtn_Ouidah,300000,186124,Christophe Besnard-Diaz,380004,493880,2022-02-25
CASH_OUT,425560,Christophe Besnard-Diaz,493880,68320,Agence_mtn_Ouidah,300000,-125560,2022-02-25
TRANSFER,7739,Christophe Besnard-Diaz,68320,60581,Nathalie-Claire De Oliveira,86912,79173,2022-02-26
CASH_IN,17858,Agence_mtn_Cotonou,300000,282142,Christophe Besnard-Diaz,60581,78439,2022-02-26
CASH_IN,101347,Agence_mtn_Cotonou,300000,198653,Sophie-Anouk Boulanger,-9051,92296,2022-02-02
CASH_OUT,46448,Sophie-Anouk Boulanger,92296,45848,Agence_mtn_Cotonou,300000,253552,2022-02-04
CASH_OUT,3528,Sophie-Anouk Boulanger,45848,42320,Agence_mtn_Abomey,300000,296472,2022-02-07
TRANSFER,857331,Astrid Aubert-Thierry,956526,99195,Sophie-Anouk Boulanger,42320,899651,2022-02-07
TRANSFER,6814,Nathalie-Claire De Oliveira,79173,72359,Sophie-Anouk Boulanger,899651,906465,2022-02-07
CASH_OUT,721112,Sophie-Anouk Boulanger,906465,185353,Agence_mtn_Cotonou,300000,-421112,2022-02-08
CASH_OUT,86202,Sophie-Anouk Boulanger,185353,99151,Agence_mtn_Ouidah,300000,213798,2022-02-12
CASH_IN,173507,Agence_mtn_Cotonou,300000,126493,Sophie-Anouk Boulanger,99151,272658,2022-02-12
CASH_IN,183338,Agence_mtn_Ouidah,300000,116662,Sophie-Anouk Boulanger,272658,455996,2022-02-12
TRANSFER,255824,Sophie-Anouk Boulanger,455996,200172,Marcel de la Buisson,6196,-249628,2022-02-14
CASH_OUT,178779,Sophie-Anouk Boulanger,200172,21393,Agence_mtn_Cotonou,300000,121221,2022-02-14
TRANSFER,969,Raymond de Le Roux,1365,396,Sophie-Anouk Boulanger,21393,22362,2022-02-14
TRANSFER,6232,Astrid Aubert-Thierry,99195,92963,Sophie-Anouk Boulanger,22362,28594,2022-02-15
CASH_IN,221175,Agence_mtn_Abomey,300000,78825,Sophie-Anouk Boulanger,28594,249769,2022-02-16
CASH_OUT,121489,Sophie-Anouk Boulanger,249769,128280,Agence_mtn_Abomey,300000,178511,2022-02-16
CASH_IN,72544,Agence_mtn_Cotonou,300000,227456,Sophie-Anouk Boulanger,128280,200824,2022-02-16
CASH_IN,31805,Agence_mtn_Cotonou,300000,268195,Sophie-Anouk Boulanger,200824,232629,2022-02-16
TRANSFER,208244,Sophie-Anouk Boulanger,232629,24385,Astrid de Pascal,458000,249756,2022-02-19
CASH_OUT,21891,Sophie-Anouk Boulanger,24385,2494,Agence_mtn_Cotonou,300000,278109,2022-02-20
CASH_IN,292300,Agence_mtn_Ouidah,300000,7700,Sophie-Anouk Boulanger,2494,294794,2022-02-21
CASH_OUT,164266,Sophie-Anouk Boulanger,294794,130528,Agence_mtn_Abomey,300000,135734,2022-02-22
TRANSFER,4027,Madeleine Hardy,8961,4934,Sophie-Anouk Boulanger,130528,134555,2022-02-24
CASH_OUT,17740,Sophie-Anouk Boulanger,134555,116815,Agence_mtn_Cotonou,300000,282260,2022-02-26
TRANSFER,229,Olivier Benard,357,128,Sophie-Anouk Boulanger,116815,117044,2022-02-26
TRANSFER,22040,Guillaume de la Nguyen,53600,31560,Sophie-Anouk Boulanger,117044,139084,2022-02-27
TRANSFER,57492,Hélène Blanchard-Renault,338372,280880,Sophie-Anouk Boulanger,139084,196576,2022-02-27
CASH_IN,194900,Agence_mtn_Ouidah,300000,105100,Sophie-Anouk Boulanger,196576,391476,2022-02-27
CASH_OUT,620916,Valérie-Claudine Marin,1059644,438728,Agence_mtn_Ouidah,300000,-320916,2022-02-01
CASH_IN,240366,Agence_mtn_Abomey,300000,59634,Valérie-Claudine Marin,438728,679094,2022-02-01
TRANSFER,459867,Valérie-Claudine Marin,679094,219227,Olivier Benard,128,-459739,2022-02-02
TRANSFER,2029,Alexandre Blanchard,25370,23341,Valérie-Claudine Marin,219227,221256,2022-02-03
CASH_OUT,10799,Valérie-Claudine Marin,221256,210457,Agence_mtn_Ouidah,300000,289201,2022-02-03
CASH_IN,293528,Agence_mtn_Abomey,300000,6472,Valérie-Claudine Marin,210457,503985,2022-02-05
CASH_IN,57171,Agence_mtn_Cotonou,300000,242829,Valérie-Claudine Marin,503985,561156,2022-02-05
CASH_OUT,246705,Valérie-Claudine Marin,561156,314451,Agence_mtn_Cotonou,300000,53295,2022-02-07
CASH_IN,249324,Agence_mtn_Cotonou,300000,50676,Valérie-Claudine Marin,314451,563775,2022-02-07
CASH_IN,229181,Agence_mtn_Ouidah,300000,70819,Valérie-Claudine Marin,563775,792956,2022-02-10
CASH_OUT,265457,Valérie-Claudine Marin,792956,527499,Agence_mtn_Ouidah,300000,34543,2022-02-11
CASH_OUT,366886,Valérie-Claudine Marin,527499,160613,Agence_mtn_Abomey,300000,-66886,2022-02-12
CASH_IN,178144,Agence_mtn_Ouidah,300000,121856,Valérie-Claudine Marin,160613,338757,2022-02-13
CASH_OUT,56800,Valérie-Claudine Marin,338757,281957,Agence_mtn_Cotonou,300000,243200,2022-02-14
TRANSFER,62231,Nathalie-Claire De Oliveira,72359,10128,Valérie-Claudine Marin,281957,344188,2022-02-14
TRANSFER,24221,Guillaume de la Nguyen,31560,7339,Valérie-Claudine Marin,344188,368409,2022-02-15
CASH_OUT,196004,Valérie-Claudine Marin,368409,172405,Agence_mtn_Ouidah,300000,103996,2022-02-17
CASH_OUT,35420,Valérie-Claudine Marin,172405,136985,Agence_mtn_Ouidah,300000,264580,2022-02-18
TRANSFER,97888,Valérie-Claudine Marin,136985,39097,Sébastien Coste,42696,-55192,2022-02-18
CASH_OUT,17544,Valérie-Claudine Marin,39097,21553,Agence_mtn_Ouidah,300000,282456,2022-02-18
CASH_OUT,7825,Valérie-Claudine Marin,21553,13728,Agence_mtn_Abomey,300000,292175,2022-02-21
CASH_IN,84811,Agence_mtn_Ouidah,300000,215189,Valérie-Claudine Marin,13728,98539,2022-02-25
CASH_IN,61607,Agence_mtn_Ouidah,300000,238393,Valérie-Claudine Marin,98539,160146,2022-02-25
CASH_IN,17862,Agence_mtn_Cotonou,300000,282138,Valérie-Claudine Marin,160146,178008,2022-02-25
CASH_IN,280156,Agence_mtn_Cotonou,300000,19844,Valérie-Claudine Marin,178008,458164,2022-02-25
CASH_IN,254217,Agence_mtn_Cotonou,300000,45783,Valérie-Claudine Marin,458164,712381,2022-02-26
CASH_IN,266201,Agence_mtn_Cotonou,300000,33799,Marine Chevallier,-136967,129234,2022-02-02
CASH_OUT,24180,Marine Chevallier,129234,105054,Agence_mtn_Abomey,300000,275820,2022-02-05
CASH_OUT,33663,Marine Chevallier,105054,71391,Agence_mtn_Cotonou,300000,266337,2022-02-11
CASH_IN,170466,Agence_mtn_Ouidah,300000,129534,Marine Chevallier,71391,241857,2022-02-15
CASH_IN,164557,Agence_mtn_Ouidah,300000,135443,Marine Chevallier,241857,406414,2022-02-19
TRANSFER,10547,Raymond Simon,119379,108832,Marine Chevallier,406414,416961,2022-02-20
TRANSFER,8555,Charles Guérin,11538,2983,Alexandre Blanchard,23341,14786,2022-02-02
TRANSFER,4861,Astrid de Pascal,249756,244895,Charles Guérin,2983,7844,2022-02-04
CASH_OUT,1476,Charles Guérin,7844,6368,Agence_mtn_Abomey,300000,298524,2022-02-04
CASH_OUT,6242,Charles Guérin,6368,126,Agence_mtn_Abomey,300000,293758,2022-02-05
TRANSFER,111,Charles Guérin,126,15,Pénélope Boulay,1251107,1250996,2022-02-07
CASH_IN,26064,Agence_mtn_Cotonou,300000,273936,Charles Guérin,15,26079,2022-02-11
CASH_OUT,22071,Charles Guérin,26079,4008,Agence_mtn_Cotonou,300000,277929,2022-02-12
CASH_OUT,2526,Charles Guérin,4008,1482,Agence_mtn_Ouidah,300000,297474,2022-02-16
CASH_IN,101846,Agence_mtn_Ouidah,300000,198154,Charles Guérin,1482,103328,2022-02-19
CASH_IN,299245,Agence_mtn_Ouidah,300000,755,Charles Guérin,103328,402573,2022-02-23
CASH_IN,101670,Agence_mtn_Cotonou,300000,198330,Charles Guérin,402573,504243,2022-02-24
CASH_OUT,1232,Charles Guérin,504243,503011,Agence_mtn_Cotonou,300000,298768,2022-02-26
CASH_OUT,2582,Jules-Marc Chauvet,667070,664488,Agence_mtn_Abomey,300000,297418,2022-02-02
CASH_IN,231830,Agence_mtn_Ouidah,300000,68170,Jules-Marc Chauvet,664488,896318,2022-02-04
CASH_IN,142594,Agence_mtn_Ouidah,300000,157406,Jules-Marc Chauvet,896318,1038912,2022-02-05
CASH_OUT,946876,Jules-Marc Chauvet,1038912,92036,Agence_mtn_Ouidah,300000,-646876,2022-02-08
TRANSFER,24245,Raymond Simon,108832,84587,Jules-Marc Chauvet,92036,116281,2022-02-13
TRANSFER,50591,Jules-Marc Chauvet,116281,65690,Raymond Simon,84587,33996,2022-02-15
CASH_IN,290976,Agence_mtn_Abomey,300000,9024,Jules-Marc Chauvet,65690,356666,2022-02-18
TRANSFER,238725,Corinne Roussel,256316,17591,Jules-Marc Chauvet,356666,595391,2022-02-18
TRANSFER,84439,Astrid de Pascal,244895,160456,Jules-Marc Chauvet,595391,679830,2022-02-19
TRANSFER,87625,Jules-Marc Chauvet,679830,592205,Alexandre Blanchard,14786,-72839,2022-02-21
CASH_OUT,89540,Jules-Marc Chauvet,592205,502665,Agence_mtn_Ouidah,300000,210460,2022-02-23
TRANSFER,2471,Alexandre Delaunay,4190,1719,Nathalie-Claire De Oliveira,10128,12599,2022-02-01
TRANSFER,1059,Madeleine Hardy,4934,3875,Nathalie-Claire De Oliveira,12599,13658,2022-02-05
CASH_IN,182895,Agence_mtn_Abomey,300000,117105,Nathalie-Claire De Oliveira,13658,196553,2022-02-08
CASH_IN,36584,Agence_mtn_Ouidah,300000,263416,Nathalie-Claire De Oliveira,196553,233137,2022-02-09
CASH_OUT,218417,Nathalie-Claire De Oliveira,233137,14720,Agence_mtn_Cotonou,300000,81583,2022-02-10
TRANSFER,5234,Nathalie-Claire De Oliveira,14720,9486,Françoise Denis de Allard,13631,8397,2022-02-15
CASH_OUT,7906,Nathalie-Claire De Oliveira,9486,1580,Agence_mtn_Ouidah,300000,292094,2022-02-17
CASH_IN,113107,Agence_mtn_Cotonou,300000,186893,Nathalie-Claire De Oliveira,1580,114687,2022-02-18
CASH_IN,152386,Agence_mtn_Cotonou,300000,147614,Nathalie-Claire De Oliveira,114687,267073,2022-02-20
TRANSFER,241090,Nathalie-Claire De Oliveira,267073,25983,Aurélie Maury,62927,-178163,2022-02-21
TRANSFER,1426,Charlotte Perrier,1431,5,Nathalie-Claire De Oliveira,25983,27409,2022-02-23
CASH_OUT,22185,Nathalie-Claire De Oliveira,27409,5224,Agence_mtn_Abomey,300000,277815,2022-02-24
CASH_OUT,3431,Nathalie-Claire De Oliveira,5224,1793,Agence_mtn_Cotonou,300000,296569,2022-02-25
CASH_OUT,1219,Nathalie-Claire De Oliveira,1793,574,Agence_mtn_Ouidah,300000,298781,2022-02-27
CASH_IN,189732,Agence_mtn_Abomey,300000,110268,Valérie de Pottier,-24744,164988,2022-02-07
TRANSFER,207,Alexandre Delaunay,1719,1512,Valérie de Pottier,164988,165195,2022-02-07
CASH_IN,175940,Agence_mtn_Ouidah,300000,124060,Valérie de Pottier,165195,341135,2022-02-08
CASH_IN,246085,Agence_mtn_Ouidah,300000,53915,Valérie de Pottier,341135,587220,2022-02-09
TRANSFER,4160,Roger-Roger Delmas,7389,3229,Valérie de Pottier,587220,591380,2022-02-09
CASH_OUT,494873,Valérie de Pottier,591380,96507,Agence_mtn_Ouidah,300000,-194873,2022-02-11
TRANSFER,20962,Valérie de Pottier,96507,75545,Astrid de Pascal,160456,139494,2022-02-20
TRANSFER,69339,Valérie de Pottier,75545,6206,Véronique Hardy,923117,853778,2022-02-21
CASH_OUT,4606,Valérie de Pottier,6206,1600,Agence_mtn_Ouidah,300000,295394,2022-02-21
TRANSFER,108,Valérie de Pottier,1600,1492,Hélène Blanchard-Renault,280880,280772,2022-02-22
CASH_IN,42613,Agence_mtn_Abomey,300000,257387,Valérie de Pottier,1492,44105,2022-02-24
CASH_OUT,25567,Valérie de Pottier,44105,18538,Agence_mtn_Abomey,300000,274433,2022-02-26
TRANSFER,737,Alexandre Delaunay,1512,775,Valérie de Pottier,18538,19275,2022-02-27
CASH_IN,73541,Agence_mtn_Cotonou,300000,226459,Maurice de Brunet,-117896,-44355,2022-02-07
CASH_IN,209212,Agence_mtn_Ouidah,300000,90788,Maurice de Brunet,-44355,164857,2022-02-08
TRANSFER,3832,Corinne Roussel,17591,13759,Maurice de Brunet,164857,168689,2022-02-12
CASH_OUT,101856,Maurice de Brunet,168689,66833,Agence_mtn_Cotonou,300000,198144,2022-02-15
TRANSFER,21985,Maurice de Brunet,66833,44848,Zacharie Fabre,82453,60468,2022-02-20
CASH_OUT,8127,Maurice de Brunet,44848,36721,Agence_mtn_Ouidah,300000,291873,2022-02-20
CASH_OUT,16043,Maurice de Brunet,36721,20678,Agence_mtn_Cotonou,300000,283957,2022-02-25
CASH_IN,277065,Agence_mtn_Ouidah,300000,22935,Éléonore Marin Le Morel,-824267,-547202,2022-02-06
CASH_IN,213984,Agence_mtn_Cotonou,300000,86016,Éléonore Marin Le Morel,-547202,-333218,2022-02-07
CASH_IN,92362,Agence_mtn_Ouidah,300000,207638,Éléonore Marin Le Morel,-333218,-240856,2022-02-10
CASH_IN,31287,Agence_mtn_Ouidah,300000,268713,Éléonore Marin Le Morel,-240856,-209569,2022-02-11
CASH_IN,161078,Agence_mtn_Ouidah,300000,138922,Éléonore Marin Le Morel,-209569,-48491,2022-02-12
CASH_IN,154745,Agence_mtn_Abomey,300000,145255,Éléonore Marin Le Morel,-48491,106254,2022-02-14
TRANSFER,1373,Madeleine Hardy,3875,2502,Éléonore Marin Le Morel,106254,107627,2022-02-15
CASH_OUT,67617,Éléonore Marin Le Morel,107627,40010,Agence_mtn_Cotonou,300000,232383,2022-02-15
CASH_OUT,18447,Éléonore Marin Le Morel,40010,21563,Agence_mtn_Ouidah,300000,281553,2022-02-17
CASH_OUT,17314,Éléonore Marin Le Morel,21563,4249,Agence_mtn_Abomey,300000,282686,2022-02-20
TRANSFER,2565,Éléonore Marin Le Morel,4249,1684,Martin Moreau,364777,362212,2022-02-20
CASH_IN,181278,Agence_mtn_Abomey,300000,118722,Éléonore Marin Le Morel,1684,182962,2022-02-21
CASH_IN,188084,Agence_mtn_Cotonou,300000,111916,Éléonore Marin Le Morel,182962,371046,2022-02-21
CASH_OUT,296990,Éléonore Marin Le Morel,371046,74056,Agence_mtn_Cotonou,300000,3010,2022-02-22
CASH_OUT,36174,Éléonore Marin Le Morel,74056,37882,Agence_mtn_Abomey,300000,263826,2022-02-22
TRANSFER,6108,Thérèse-Juliette Camus,7028,920,Éléonore Marin Le Morel,37882,43990,2022-02-23
CASH_OUT,30365,Éléonore Marin Le Morel,43990,13625,Agence_mtn_Abomey,300000,269635,2022-02-27
CASH_IN,227477,Agence_mtn_Abomey,300000,72523,Corinne Roussel,13759,241236,2022-02-04
CASH_OUT,69838,Corinne Roussel,241236,171398,Agence_mtn_Abomey,300000,230162,2022-02-08
TRANSFER,29823,Corinne Roussel,171398,141575,Roger-Roger Delmas,3229,-26594,2022-02-09
CASH_OUT,114569,Corinne Roussel,141575,27006,Agence_mtn_Cotonou,300000,185431,2022-02-22
TRANSFER,23168,Corinne Roussel,27006,3838,Astrid Aubert-Thierry,92963,69795,2022-02-24
CASH_IN,191525,Agence_mtn_Ouidah,300000,108475,Corinne Roussel,3838,195363,2022-02-26
TRANSFER,239807,Stéphanie Guichard,332130,92323,Sabine Perrier,151837,-87970,2022-02-05
CASH_OUT,42070,Stéphanie Guichard,92323,50253,Agence_mtn_Cotonou,300000,257930,2022-02-09
CASH_IN,126750,Agence_mtn_Cotonou,300000,173250,Stéphanie Guichard,50253,177003,2022-02-15
CASH_OUT,80337,Stéphanie Guichard,177003,96666,Agence_mtn_Abomey,300000,219663,2022-02-16
CASH_IN,100639,Agence_mtn_Abomey,300000,199361,Stéphanie Guichard,96666,197305,2022-02-16
CASH_IN,155125,Agence_mtn_Abomey,300000,144875,Stéphanie Guichard,197305,352430,2022-02-16
TRANSFER,170102,Stéphanie Guichard,352430,182328,Stéphanie Guichard,352430,522532,2022-02-17
TRANSFER,171570,Stéphanie Guichard,182328,10758,Nicole-Renée Gay,200435,28865,2022-02-18
CASH_IN,72584,Agence_mtn_Ouidah,300000,227416,Stéphanie Guichard,10758,83342,2022-02-18
TRANSFER,767,Stéphanie Guichard,83342,82575,Thibault-Julien Chevallier,165760,164993,2022-02-22
CASH_IN,130883,Agence_mtn_Ouidah,300000,169117,Alfred Paris,-242157,-111274,2022-02-04
CASH_IN,218982,Agence_mtn_Abomey,300000,81018,Alfred Paris,-111274,107708,2022-02-05
CASH_OUT,71824,Alfred Paris,107708,35884,Agence_mtn_Ouidah,300000,228176,2022-02-07
CASH_OUT,15633,Alfred Paris,35884,20251,Agence_mtn_Abomey,300000,284367,2022-02-10
CASH_OUT,11959,Alfred Paris,20251,8292,Agence_mtn_Cotonou,300000,288041,2022-02-12
TRANSFER,4542,Alfred Paris,8292,3750,Thibault-Julien Chevallier,164993,160451,2022-02-13
TRANSFER,5066,Françoise Denis de Allard,8397,3331,Alfred Paris,3750,8816,2022-02-13
CASH_IN,108583,Agence_mtn_Ouidah,300000,191417,Alfred Paris,8816,117399,2022-02-14
CASH_IN,266372,Agence_mtn_Ouidah,300000,33628,Alfred Paris,117399,383771,2022-02-14
CASH_IN,75541,Agence_mtn_Ouidah,300000,224459,Alfred Paris,383771,459312,2022-02-14
CASH_IN,264884,Agence_mtn_Cotonou,300000,35116,Alfred Paris,459312,724196,2022-02-16
TRANSFER,18360,Raymond Simon,33996,15636,Alfred Paris,724196,742556,2022-02-19
CASH_OUT,333518,Alfred Paris,742556,409038,Agence_mtn_Cotonou,300000,-33518,2022-02-19
CASH_OUT,40526,Alfred Paris,409038,368512,Agence_mtn_Ouidah,300000,259474,2022-02-21
CASH_IN,58794,Agence_mtn_Ouidah,300000,241206,Alfred Paris,368512,427306,2022-02-21
TRANSFER,292626,Alfred Paris,427306,134680,Astrid de Pascal,139494,-153132,2022-02-22
CASH_OUT,61799,Alfred Paris,134680,72881,Agence_mtn_Abomey,300000,238201,2022-02-23
TRANSFER,30520,Alfred Paris,72881,42361,Thérèse-Juliette Camus,920,-29600,2022-02-27
CASH_IN,153087,Agence_mtn_Cotonou,300000,146913,Michèle Faivre,-732323,-579236,2022-02-02
CASH_IN,19204,Agence_mtn_Ouidah,300000,280796,Michèle Faivre,-579236,-560032,2022-02-07
CASH_IN,185784,Agence_mtn_Ouidah,300000,114216,Michèle Faivre,-560032,-374248,2022-02-11
CASH_IN,231205,Agence_mtn_Cotonou,300000,68795,Michèle Faivre,-374248,-143043,2022-02-12
CASH_IN,6677,Agence_mtn_Cotonou,300000,293323,Michèle Faivre,-143043,-136366,2022-02-13
CASH_IN,248807,Agence_mtn_Cotonou,300000,51193,Michèle Faivre,-136366,112441,2022-02-13
TRANSFER,54849,Michèle Faivre,112441,57592,Madeleine Hardy,2502,-52347,2022-02-16
CASH_IN,291387,Agence_mtn_Abomey,300000,8613,Michèle Faivre,57592,348979,2022-02-16
TRANSFER,161059,Michèle Faivre,348979,187920,Hélène Blanchard-Renault,280772,119713,2022-02-22
CASH_OUT,168356,Michèle Faivre,187920,19564,Agence_mtn_Cotonou,300000,131644,2022-02-25
TRANSFER,23352,Astrid Aubert-Thierry,69795,46443,Michèle Faivre,19564,42916,2022-02-25
TRANSFER,452599,Véronique Hardy,853778,401179,Guillaume de la Nguyen,7339,459938,2022-02-06
TRANSFER,169506,Guillaume de la Nguyen,459938,290432,Alexandre Delaunay,775,-168731,2022-02-09
CASH_OUT,229297,Guillaume de la Nguyen,290432,61135,Agence_mtn_Cotonou,300000,70703,2022-02-09
TRANSFER,289679,Martin Moreau,362212,72533,Guillaume de la Nguyen,61135,350814,2022-02-15
CASH_OUT,235465,Guillaume de la Nguyen,350814,115349,Agence_mtn_Ouidah,300000,64535,2022-02-15
CASH_OUT,29172,Guillaume de la Nguyen,115349,86177,Agence_mtn_Ouidah,300000,270828,2022-02-15
CASH_OUT,2807,Guillaume de la Nguyen,86177,83370,Agence_mtn_Cotonou,300000,297193,2022-02-17
CASH_OUT,56828,Guillaume de la Nguyen,83370,26542,Agence_mtn_Abomey,300000,243172,2022-02-18
CASH_IN,115131,Agence_mtn_Abomey,300000,184869,Guillaume de la Nguyen,26542,141673,2022-02-21
CASH_OUT,49565,Guillaume de la Nguyen,141673,92108,Agence_mtn_Ouidah,300000,250435,2022-02-24
CASH_IN,69379,Agence_mtn_Abomey,300000,230621,Sabine Perrier,-87970,-18591,2022-02-01
CASH_IN,44387,Agence_mtn_Ouidah,300000,255613,Sabine Perrier,-18591,25796,2022-02-02
CASH_IN,113046,Agence_mtn_Cotonou,300000,186954,Sabine Perrier,25796,138842,2022-02-03
CASH_IN,208427,Agence_mtn_Cotonou,300000,91573,Sabine Perrier,138842,347269,2022-02-03
CASH_OUT,104635,Sabine Perrier,347269,242634,Agence_mtn_Cotonou,300000,195365,2022-02-06
CASH_OUT,117519,Sabine Perrier,242634,125115,Agence_mtn_Cotonou,300000,182481,2022-02-08
CASH_OUT,34797,Sabine Perrier,125115,90318,Agence_mtn_Ouidah,300000,265203,2022-02-09
CASH_OUT,90213,Sabine Perrier,90318,105,Agence_mtn_Ouidah,300000,209787,2022-02-11
CASH_IN,151061,Agence_mtn_Cotonou,300000,148939,Sabine Perrier,105,151166,2022-02-14
TRANSFER,130558,Thibault-Julien Chevallier,160451,29893,Sabine Perrier,151166,281724,2022-02-14
CASH_IN,124593,Agence_mtn_Abomey,300000,175407,Sabine Perrier,281724,406317,2022-02-20
CASH_IN,189030,Agence_mtn_Cotonou,300000,110970,Sabine Perrier,406317,595347,2022-02-20
CASH_OUT,516602,Sabine Perrier,595347,78745,Agence_mtn_Abomey,300000,-216602,2022-02-21
TRANSFER,22251,Sabine Perrier,78745,56494,Pénélope Boulay,1250996,1228745,2022-02-22
CASH_IN,40825,Agence_mtn_Abomey,300000,259175,Sabine Perrier,56494,97319,2022-02-22
CASH_OUT,43104,Sabine Perrier,97319,54215,Agence_mtn_Abomey,300000,256896,2022-02-25
CASH_OUT,29968,Sabine Perrier,54215,24247,Agence_mtn_Cotonou,300000,270032,2022-02-26
CASH_IN,8806,Agence_mtn_Ouidah,300000,291194,Sabine Perrier,24247,33053,2022-02-26
CASH_IN,136227,Agence_mtn_Cotonou,300000,163773,Aurélie Maury,-178163,-41936,2022-02-03
CASH_IN,224989,Agence_mtn_Abomey,300000,75011,Aurélie Maury,-41936,183053,2022-02-05
CASH_IN,82028,Agence_mtn_Ouidah,300000,217972,Aurélie Maury,183053,265081,2022-02-05
CASH_IN,23248,Agence_mtn_Ouidah,300000,276752,Aurélie Maury,265081,288329,2022-02-07
TRANSFER,3133,Hélène Blanchard-Renault,119713,116580,Aurélie Maury,288329,291462,2022-02-16
TRANSFER,138852,Aurélie Maury,291462,152610,Maryse Delorme,31946,-106906,2022-02-17
TRANSFER,24100,Nicole-Renée Gay,28865,4765,Aurélie Maury,152610,176710,2022-02-19
CASH_IN,66723,Agence_mtn_Cotonou,300000,233277,Aurélie Maury,176710,243433,2022-02-20
TRANSFER,2082,Françoise Denis de Allard,3331,1249,Aurélie Maury,243433,245515,2022-02-20
CASH_OUT,165858,Aurélie Maury,245515,79657,Agence_mtn_Abomey,300000,134142,2022-02-25
CASH_OUT,30820,Aurélie Maury,79657,48837,Agence_mtn_Ouidah,300000,269180,2022-02-26
CASH_IN,35038,Agence_mtn_Cotonou,300000,264962,Pénélope Boulay,1228745,1263783,2022-02-02
TRANSFER,1329,Raymond Simon,15636,14307,Pénélope Boulay,1263783,1265112,2022-02-03
CASH_OUT,305706,Pénélope Boulay,1265112,959406,Agence_mtn_Ouidah,300000,-5706,2022-02-03
CASH_IN,112725,Agence_mtn_Cotonou,300000,187275,Pénélope Boulay,959406,1072131,2022-02-04
TRANSFER,628,Thibault-Julien Chevallier,29893,29265,Pénélope Boulay,1072131,1072759,2022-02-07
CASH_IN,17785,Agence_mtn_Cotonou,300000,282215,Pénélope Boulay,1072759,1090544,2022-02-07
TRANSFER,954831,Pénélope Boulay,1090544,135713,Astrid Aubert-Thierry,46443,-908388,2022-02-08
CASH_IN,120914,Agence_mtn_Abomey,300000,179086,Pénélope Boulay,135713,256627,2022-02-09
CASH_IN,258568,Agence_mtn_Cotonou,300000,41432,Pénélope Boulay,256627,515195,2022-02-13
CASH_OUT,376100,Pénélope Boulay,515195,139095,Agence_mtn_Abomey,300000,-76100,2022-02-14
CASH_IN,43647,Agence_mtn_Ouidah,300000,256353,Pénélope Boulay,139095,182742,2022-02-14
CASH_OUT,142291,Pénélope Boulay,182742,40451,Agence_mtn_Abomey,300000,157709,2022-02-15
CASH_OUT,15729,Pénélope Boulay,40451,24722,Agence_mtn_Ouidah,300000,284271,2022-02-19
TRANSFER,13931,Pénélope Boulay,24722,10791,Véronique Hardy,401179,387248,2022-02-20
CASH_IN,38600,Agence_mtn_Cotonou,300000,261400,Pénélope Boulay,10791,49391,2022-02-21
TRANSFER,39849,Pénélope Boulay,49391,9542,Véronique Hardy,387248,347399,2022-02-22
CASH_IN,11493,Agence_mtn_Cotonou,300000,288507,Pénélope Boulay,9542,21035,2022-02-24
CASH_OUT,5847,Pénélope Boulay,21035,15188,Agence_mtn_Abomey,300000,294153,2022-02-24
CASH_IN,203288,Agence_mtn_Abomey,300000,96712,Astrid de Pascal,-153132,50156,2022-02-05
CASH_IN,33857,Agence_mtn_Cotonou,300000,266143,Astrid de Pascal,50156,84013,2022-02-09
TRANSFER,71965,Astrid de Pascal,84013,12048,Véronique Hardy,347399,275434,2022-02-11
CASH_OUT,11975,Astrid de Pascal,12048,73,Agence_mtn_Ouidah,300000,288025,2022-02-12
CASH_IN,160763,Agence_mtn_Abomey,300000,139237,Astrid de Pascal,73,160836,2022-02-14
CASH_OUT,84915,Astrid de Pascal,160836,75921,Agence_mtn_Cotonou,300000,215085,2022-02-19
CASH_OUT,4818,Astrid de Pascal,75921,71103,Agence_mtn_Ouidah,300000,295182,2022-02-21
CASH_OUT,41765,Astrid de Pascal,71103,29338,Agence_mtn_Ouidah,300000,258235,2022-02-22
CASH_IN,207835,Agence_mtn_Ouidah,300000,92165,Astrid de Pascal,29338,237173,2022-02-25
CASH_IN,32511,Agence_mtn_Abomey,300000,267489,Julien Devaux,-121464,-88953,2022-02-01
CASH_IN,65334,Agence_mtn_Abomey,300000,234666,Julien Devaux,-88953,-23619,2022-02-17
CASH_IN,182193,Agence_mtn_Abomey,300000,117807,Julien Devaux,-23619,158574,2022-02-18
CASH_IN,296468,Agence_mtn_Abomey,300000,3532,Julien Devaux,158574,455042,2022-02-22
CASH_OUT,284875,Julien Devaux,455042,170167,Agence_mtn_Abomey,300000,15125,2022-02-23
CASH_IN,174489,Agence_mtn_Abomey,300000,125511,Julien Devaux,170167,344656,2022-02-23
TRANSFER,116667,Julien Devaux,344656,227989,Hélène Blanchard-Renault,116580,-87,2022-02-24
CASH_IN,217370,Agence_mtn_Abomey,300000,82630,Julien Devaux,227989,445359,2022-02-24
CASH_OUT,61272,Julien Devaux,445359,384087,Agence_mtn_Cotonou,300000,238728,2022-02-26
CASH_OUT,142173,Julien Devaux,384087,241914,Agence_mtn_Ouidah,300000,157827,2022-02-27
TRANSFER,391,Françoise Denis de Allard,1249,858,Zacharie Fabre,60468,60077,2022-02-01
CASH_IN,49248,Agence_mtn_Ouidah,300000,250752,Françoise Denis de Allard,858,50106,2022-02-05
CASH_OUT,3193,Françoise Denis de Allard,50106,46913,Agence_mtn_Cotonou,300000,296807,2022-02-06
TRANSFER,90671,Véronique Hardy,275434,184763,Françoise Denis de Allard,46913,137584,2022-02-06
CASH_IN,149469,Agence_mtn_Ouidah,300000,150531,Françoise Denis de Allard,137584,287053,2022-02-07
CASH_IN,136582,Agence_mtn_Abomey,300000,163418,Françoise Denis de Allard,287053,423635,2022-02-08
CASH_IN,181625,Agence_mtn_Abomey,300000,118375,Françoise Denis de Allard,423635,605260,2022-02-17
CASH_IN,145767,Agence_mtn_Ouidah,300000,154233,Françoise Denis de Allard,605260,751027,2022-02-17
CASH_OUT,213404,Françoise Denis de Allard,751027,537623,Agence_mtn_Ouidah,300000,86596,2022-02-17
CASH_OUT,389831,Françoise Denis de Allard,537623,147792,Agence_mtn_Abomey,300000,-89831,2022-02-21
CASH_OUT,2761,Françoise Denis de Allard,147792,145031,Agence_mtn_Abomey,300000,297239,2022-02-22
CASH_OUT,118871,Françoise Denis de Allard,145031,26160,Agence_mtn_Abomey,300000,181129,2022-02-25
TRANSFER,10507,Raymond Simon,14307,3800,Françoise Denis de Allard,26160,36667,2022-02-27
CASH_IN,177900,Agence_mtn_Cotonou,300000,122100,Louis de la Imbert,-98348,79552,2022-02-01
CASH_IN,246581,Agence_mtn_Abomey,300000,53419,Louis de la Imbert,79552,326133,2022-02-02
TRANSFER,1184,Raymond Simon,3800,2616,Louis de la Imbert,326133,327317,2022-02-04
CASH_OUT,178786,Louis de la Imbert,327317,148531,Agence_mtn_Abomey,300000,121214,2022-02-06
TRANSFER,1980,Raymond Simon,2616,636,Louis de la Imbert,148531,150511,2022-02-08
TRANSFER,43801,Louis de la Imbert,150511,106710,Louis de la Imbert,150511,106710,2022-02-12
CASH_IN,36742,Agence_mtn_Ouidah,300000,263258,Louis de la Imbert,106710,143452,2022-02-18
TRANSFER,63057,Louis de la Imbert,143452,80395,Raymond Simon,636,-62421,2022-02-18
CASH_OUT,68934,Louis de la Imbert,80395,11461,Agence_mtn_Abomey,300000,231066,2022-02-23
CASH_IN,196017,Agence_mtn_Ouidah,300000,103983,Louis de la Imbert,11461,207478,2022-02-24
TRANSFER,18064,Louis de la Imbert,207478,189414,Zacharie Fabre,60077,42013,2022-02-24
CASH_OUT,55151,Louis de la Imbert,189414,134263,Agence_mtn_Abomey,300000,244849,2022-02-27
TRANSFER,33276,Louis de la Imbert,134263,100987,Martin Moreau,72533,39257,2022-02-27
CASH_IN,264684,Agence_mtn_Ouidah,300000,35316,Margaud-Michelle Briand,-63357,201327,2022-02-02
CASH_OUT,74392,Margaud-Michelle Briand,201327,126935,Agence_mtn_Cotonou,300000,225608,2022-02-04
TRANSFER,62462,Margaud-Michelle Briand,126935,64473,Margaud-Michelle Briand,126935,189397,2022-02-04
CASH_IN,114657,Agence_mtn_Abomey,300000,185343,Margaud-Michelle Briand,64473,179130,2022-02-05
TRANSFER,7496,Margaud-Michelle Briand,179130,171634,Margaud-Michelle Briand,179130,171634,2022-02-07
CASH_OUT,160701,Margaud-Michelle Briand,171634,10933,Agence_mtn_Abomey,300000,139299,2022-02-07
TRANSFER,145418,Véronique Hardy,184763,39345,Margaud-Michelle Briand,10933,156351,2022-02-08
TRANSFER,2433,Véronique Hardy,39345,36912,Margaud-Michelle Briand,156351,158784,2022-02-16
TRANSFER,114751,Margaud-Michelle Briand,158784,44033,Véronique Hardy,36912,-77839,2022-02-20
CASH_IN,166023,Agence_mtn_Ouidah,300000,133977,Margaud-Michelle Briand,44033,210056,2022-02-23
TRANSFER,17162,Zacharie Fabre,42013,24851,Margaud-Michelle Briand,210056,227218,2022-02-24
TRANSFER,18310,Zacharie Fabre,24851,6541,Margaud-Michelle Briand,227218,245528,2022-02-27
CASH_IN,48462,Agence_mtn_Ouidah,300000,251538,Alexandre Delaunay,-168731,-120269,2022-02-01
CASH_IN,236550,Agence_mtn_Cotonou,300000,63450,Alexandre Delaunay,-120269,116281,2022-02-04
CASH_IN,95235,Agence_mtn_Abomey,300000,204765,Alexandre Delaunay,116281,211516,2022-02-06
TRANSFER,136937,Alexandre Delaunay,211516,74579,Zacharie Fabre,6541,-130396,2022-02-07
CASH_OUT,5347,Alexandre Delaunay,74579,69232,Agence_mtn_Abomey,300000,294653,2022-02-08
CASH_IN,136542,Agence_mtn_Abomey,300000,163458,Alexandre Delaunay,69232,205774,2022-02-12
TRANSFER,61571,Alexandre Delaunay,205774,144203,Alexandre Delaunay,205774,144203,2022-02-14
TRANSFER,9043,Alexandre Delaunay,144203,135160,Alexandre Delaunay,144203,153246,2022-02-15
CASH_IN,280399,Agence_mtn_Ouidah,300000,19601,Alexandre Delaunay,135160,415559,2022-02-20
CASH_IN,99558,Agence_mtn_Abomey,300000,200442,Alexandre Delaunay,415559,515117,2022-02-21
CASH_OUT,169140,Alexandre Delaunay,515117,345977,Agence_mtn_Ouidah,300000,130860,2022-02-26
CASH_IN,81907,Agence_mtn_Abomey,300000,218093,Roger-Roger Delmas,-26594,55313,2022-02-01
CASH_OUT,11326,Roger-Roger Delmas,55313,43987,Agence_mtn_Ouidah,300000,288674,2022-02-13
CASH_OUT,31330,Roger-Roger Delmas,43987,12657,Agence_mtn_Cotonou,300000,268670,2022-02-13
TRANSFER,6732,Roger-Roger Delmas,12657,5925,Roger-Roger Delmas,12657,5925,2022-02-13
CASH_OUT,2150,Roger-Roger Delmas,5925,3775,Agence_mtn_Abomey,300000,297850,2022-02-14
CASH_OUT,3363,Roger-Roger Delmas,3775,412,Agence_mtn_Cotonou,300000,296637,2022-02-18
CASH_OUT,163,Roger-Roger Delmas,412,249,Agence_mtn_Cotonou,300000,299837,2022-02-22
CASH_IN,240316,Agence_mtn_Ouidah,300000,59684,Zacharie Fabre,-130396,109920,2022-02-01
CASH_IN,250569,Agence_mtn_Cotonou,300000,49431,Zacharie Fabre,109920,360489,2022-02-03
TRANSFER,356264,Zacharie Fabre,360489,4225,Zacharie Fabre,360489,716753,2022-02-05
CASH_IN,197386,Agence_mtn_Cotonou,300000,102614,Zacharie Fabre,4225,201611,2022-02-09
CASH_IN,13803,Agence_mtn_Abomey,300000,286197,Zacharie Fabre,201611,215414,2022-02-18
CASH_OUT,24726,Zacharie Fabre,215414,190688,Agence_mtn_Ouidah,300000,275274,2022-02-20
CASH_IN,32626,Agence_mtn_Ouidah,300000,267374,Zacharie Fabre,190688,223314,2022-02-20
CASH_IN,18413,Agence_mtn_Ouidah,300000,281587,Zacharie Fabre,223314,241727,2022-02-22
CASH_OUT,35491,Zacharie Fabre,241727,206236,Agence_mtn_Abomey,300000,264509,2022-02-23
CASH_IN,155240,Agence_mtn_Abomey,300000,144760,Maryse Delorme,-106906,48334,2022-02-01
CASH_IN,49197,Agence_mtn_Ouidah,300000,250803,Maryse Delorme,48334,97531,2022-02-02
CASH_IN,247288,Agence_mtn_Cotonou,300000,52712,Maryse Delorme,97531,344819,2022-02-04
CASH_OUT,168224,Maryse Delorme,344819,176595,Agence_mtn_Ouidah,300000,131776,2022-02-05
CASH_IN,199846,Agence_mtn_Abomey,300000,100154,Maryse Delorme,176595,376441,2022-02-06
TRANSFER,214533,Maryse Delorme,376441,161908,Maryse Delorme,376441,590974,2022-02-09
CASH_IN,138424,Agence_mtn_Cotonou,300000,161576,Maryse Delorme,161908,300332,2022-02-11
CASH_OUT,139496,Maryse Delorme,300332,160836,Agence_mtn_Abomey,300000,160504,2022-02-13
CASH_IN,237421,Agence_mtn_Ouidah,300000,62579,Maryse Delorme,160836,398257,2022-02-23
CASH_IN,297179,Agence_mtn_Cotonou,300000,2821,Gilbert Moulin,-822,296357,2022-02-02
TRANSFER,138760,Gilbert Moulin,296357,157597,Gilbert Moulin,296357,157597,2022-02-03
CASH_OUT,95773,Gilbert Moulin,157597,61824,Agence_mtn_Cotonou,300000,204227,2022-02-07
CASH_OUT,24285,Gilbert Moulin,61824,37539,Agence_mtn_Abomey,300000,275715,2022-02-07
CASH_IN,150290,Agence_mtn_Cotonou,300000,149710,Gilbert Moulin,37539,187829,2022-02-08
TRANSFER,169944,Gilbert Moulin,187829,17885,Gilbert Moulin,187829,17885,2022-02-12
TRANSFER,3911,Gilbert Moulin,17885,13974,Gilbert Moulin,17885,21796,2022-02-13
CASH_OUT,9498,Gilbert Moulin,13974,4476,Agence_mtn_Abomey,300000,290502,2022-02-14
CASH_IN,9222,Agence_mtn_Abomey,300000,290778,Gilbert Moulin,4476,13698,2022-02-14
TRANSFER,422,Gilbert Moulin,13698,13276,Gilbert Moulin,13698,14120,2022-02-14
CASH_IN,242689,Agence_mtn_Abomey,300000,57311,Gilbert Moulin,13276,255965,2022-02-14
TRANSFER,212250,Gilbert Moulin,255965,43715,Gilbert Moulin,255965,43715,2022-02-15
CASH_IN,69873,Agence_mtn_Abomey,300000,230127,Gilbert Moulin,43715,113588,2022-02-16
CASH_IN,32839,Agence_mtn_Abomey,300000,267161,Gilbert Moulin,113588,146427,2022-02-16
CASH_OUT,94863,Gilbert Moulin,146427,51564,Agence_mtn_Abomey,300000,205137,2022-02-18
CASH_OUT,40428,Gilbert Moulin,51564,11136,Agence_mtn_Cotonou,300000,259572,2022-02-26
CASH_IN,163647,Agence_mtn_Cotonou,300000,136353,Anouk Delahaye-Gimenez,-113577,50070,2022-02-03
CASH_IN,134859,Agence_mtn_Abomey,300000,165141,Anouk Delahaye-Gimenez,50070,184929,2022-02-04
CASH_OUT,29412,Anouk Delahaye-Gimenez,184929,155517,Agence_mtn_Cotonou,300000,270588,2022-02-09
CASH_OUT,134866,Anouk Delahaye-Gimenez,155517,20651,Agence_mtn_Cotonou,300000,165134,2022-02-11
TRANSFER,20131,Anouk Delahaye-Gimenez,20651,520,Anouk Delahaye-Gimenez,20651,40782,2022-02-12
CASH_IN,273998,Agence_mtn_Ouidah,300000,26002,Anouk Delahaye-Gimenez,520,274518,2022-02-14
TRANSFER,105427,Anouk Delahaye-Gimenez,274518,169091,Anouk Delahaye-Gimenez,274518,379945,2022-02-18
CASH_IN,154291,Agence_mtn_Abomey,300000,145709,Anouk Delahaye-Gimenez,169091,323382,2022-02-19
CASH_OUT,178,Anouk Delahaye-Gimenez,323382,323204,Agence_mtn_Abomey,300000,299822,2022-02-20
CASH_IN,50950,Agence_mtn_Abomey,300000,249050,Anouk Delahaye-Gimenez,323204,374154,2022-02-21
CASH_OUT,266564,Anouk Delahaye-Gimenez,374154,107590,Agence_mtn_Abomey,300000,33436,2022-02-21
CASH_IN,44943,Agence_mtn_Cotonou,300000,255057,Anouk Delahaye-Gimenez,107590,152533,2022-02-23
CASH_OUT,33736,Anouk Delahaye-Gimenez,152533,118797,Agence_mtn_Abomey,300000,266264,2022-02-27
CASH_IN,234257,Agence_mtn_Abomey,300000,65743,Anouk Delahaye-Gimenez,118797,353054,2022-02-27
CASH_IN,5949,Agence_mtn_Cotonou,300000,294051,Augustin-Jérôme Merle,-110223,-104274,2022-02-03
CASH_IN,167761,Agence_mtn_Ouidah,300000,132239,Augustin-Jérôme Merle,-104274,63487,2022-02-08
CASH_OUT,51089,Augustin-Jérôme Merle,63487,12398,Agence_mtn_Ouidah,300000,248911,2022-02-13
CASH_IN,293145,Agence_mtn_Cotonou,300000,6855,Augustin-Jérôme Merle,12398,305543,2022-02-15
CASH_OUT,16121,Augustin-Jérôme Merle,305543,289422,Agence_mtn_Abomey,300000,283879,2022-02-17
CASH_OUT,260610,Augustin-Jérôme Merle,289422,28812,Agence_mtn_Ouidah,300000,39390,2022-02-22
CASH_IN,196632,Agence_mtn_Cotonou,300000,103368,Louis du Boyer,-293490,-96858,2022-02-03
CASH_IN,32019,Agence_mtn_Abomey,300000,267981,Louis du Boyer,-96858,-64839,2022-02-03
CASH_IN,295581,Agence_mtn_Cotonou,300000,4419,Louis du Boyer,-64839,230742,2022-02-09
TRANSFER,158078,Louis du Boyer,230742,72664,Louis du Boyer,230742,388820,2022-02-10
CASH_OUT,57302,Louis du Boyer,72664,15362,Agence_mtn_Abomey,300000,242698,2022-02-13
CASH_IN,65802,Agence_mtn_Abomey,300000,234198,Louis du Boyer,15362,81164,2022-02-15
CASH_IN,31207,Agence_mtn_Ouidah,300000,268793,Olivier Benard,-459739,-428532,2022-02-01
CASH_IN,180565,Agence_mtn_Cotonou,300000,119435,Olivier Benard,-428532,-247967,2022-02-01
CASH_IN,66790,Agence_mtn_Cotonou,300000,233210,Olivier Benard,-247967,-181177,2022-02-02
CASH_IN,85609,Agence_mtn_Abomey,300000,214391,Olivier Benard,-181177,-95568,2022-02-02
CASH_IN,203250,Agence_mtn_Abomey,300000,96750,Olivier Benard,-95568,107682,2022-02-03
CASH_OUT,53264,Olivier Benard,107682,54418,Agence_mtn_Cotonou,300000,246736,2022-02-05
CASH_IN,35345,Agence_mtn_Cotonou,300000,264655,Olivier Benard,54418,89763,2022-02-12
CASH_OUT,200,Olivier Benard,89763,89563,Agence_mtn_Abomey,300000,299800,2022-02-17
CASH_IN,282783,Agence_mtn_Ouidah,300000,17217,Olivier Benard,89563,372346,2022-02-22
CASH_OUT,47730,Olivier Benard,372346,324616,Agence_mtn_Cotonou,300000,252270,2022-02-24
CASH_OUT,178300,Olivier Benard,324616,146316,Agence_mtn_Abomey,300000,121700,2022-02-24
CASH_IN,21697,Agence_mtn_Cotonou,300000,278303,Véronique Hardy,-77839,-56142,2022-02-08
CASH_IN,270929,Agence_mtn_Abomey,300000,29071,Véronique Hardy,-56142,214787,2022-02-08
CASH_OUT,115429,Véronique Hardy,214787,99358,Agence_mtn_Ouidah,300000,184571,2022-02-10
TRANSFER,40446,Véronique Hardy,99358,58912,Véronique Hardy,99358,139804,2022-02-10
CASH_OUT,21786,Véronique Hardy,58912,37126,Agence_mtn_Abomey,300000,278214,2022-02-10
CASH_IN,237920,Agence_mtn_Cotonou,300000,62080,Véronique Hardy,37126,275046,2022-02-13
CASH_IN,263032,Agence_mtn_Abomey,300000,36968,Véronique Hardy,275046,538078,2022-02-16
CASH_OUT,313408,Véronique Hardy,538078,224670,Agence_mtn_Cotonou,300000,-13408,2022-02-17
CASH_IN,217210,Agence_mtn_Abomey,300000,82790,Véronique Hardy,224670,441880,2022-02-17
CASH_OUT,83079,Véronique Hardy,441880,358801,Agence_mtn_Abomey,300000,216921,2022-02-22
CASH_OUT,341919,Véronique Hardy,358801,16882,Agence_mtn_Abomey,300000,-41919,2022-02-23
CASH_IN,299363,Agence_mtn_Ouidah,300000,637,Sébastien Coste,-55192,244171,2022-02-02
TRANSFER,135947,Sébastien Coste,244171,108224,Sébastien Coste,244171,108224,2022-02-03
CASH_IN,108381,Agence_mtn_Ouidah,300000,191619,Sébastien Coste,108224,216605,2022-02-04
TRANSFER,208576,Sébastien Coste,216605,8029,Sébastien Coste,216605,8029,2022-02-08
CASH_OUT,5281,Sébastien Coste,8029,2748,Agence_mtn_Ouidah,300000,294719,2022-02-08
CASH_IN,105102,Agence_mtn_Cotonou,300000,194898,Sébastien Coste,2748,107850,2022-02-10
CASH_IN,271820,Agence_mtn_Ouidah,300000,28180,Sébastien Coste,107850,379670,2022-02-11
TRANSFER,2946,Sébastien Coste,379670,376724,Sébastien Coste,379670,382616,2022-02-12
CASH_OUT,208327,Sébastien Coste,376724,168397,Agence_mtn_Ouidah,300000,91673,2022-02-16
CASH_OUT,141504,Sébastien Coste,168397,26893,Agence_mtn_Abomey,300000,158496,2022-02-18
CASH_OUT,5314,Sébastien Coste,26893,21579,Agence_mtn_Cotonou,300000,294686,2022-02-19
CASH_IN,161978,Agence_mtn_Abomey,300000,138022,Sébastien Coste,21579,183557,2022-02-20
CASH_IN,295227,Agence_mtn_Abomey,300000,4773,Alexandre Blanchard,-72839,222388,2022-02-01
CASH_OUT,148616,Alexandre Blanchard,222388,73772,Agence_mtn_Cotonou,300000,151384,2022-02-12
CASH_OUT,8139,Alexandre Blanchard,73772,65633,Agence_mtn_Abomey,300000,291861,2022-02-13
TRANSFER,9390,Alexandre Blanchard,65633,56243,Alexandre Blanchard,65633,75023,2022-02-14
CASH_IN,185097,Agence_mtn_Abomey,300000,114903,Alexandre Blanchard,56243,241340,2022-02-15
CASH_IN,147233,Agence_mtn_Ouidah,300000,152767,Alexandre Blanchard,241340,388573,2022-02-17
CASH_IN,93205,Agence_mtn_Cotonou,300000,206795,Alexandre Blanchard,388573,481778,2022-02-23
CASH_OUT,137676,Alexandre Blanchard,481778,344102,Agence_mtn_Cotonou,300000,162324,2022-02-25
CASH_OUT,221346,Alexandre Blanchard,344102,122756,Agence_mtn_Ouidah,300000,78654,2022-02-26
CASH_OUT,49307,Alexandre Blanchard,122756,73449,Agence_mtn_Ouidah,300000,250693,2022-02-26
CASH_IN,227795,Agence_mtn_Cotonou,300000,72205,Emmanuelle Le Allain,-59827,167968,2022-02-03
CASH_OUT,76068,Emmanuelle Le Allain,167968,91900,Agence_mtn_Abomey,300000,223932,2022-02-06
CASH_OUT,5862,Emmanuelle Le Allain,91900,86038,Agence_mtn_Cotonou,300000,294138,2022-02-06
CASH_IN,179528,Agence_mtn_Ouidah,300000,120472,Emmanuelle Le Allain,86038,265566,2022-02-12
TRANSFER,147954,Emmanuelle Le Allain,265566,117612,Emmanuelle Le Allain,265566,413520,2022-02-12
CASH_OUT,24408,Emmanuelle Le Allain,117612,93204,Agence_mtn_Ouidah,300000,275592,2022-02-16
CASH_IN,236030,Agence_mtn_Abomey,300000,63970,Emmanuelle Le Allain,93204,329234,2022-02-16
CASH_OUT,257931,Emmanuelle Le Allain,329234,71303,Agence_mtn_Abomey,300000,42069,2022-02-22
TRANSFER,40251,Emmanuelle Le Allain,71303,31052,Emmanuelle Le Allain,71303,111554,2022-02-23
CASH_OUT,22466,Emmanuelle Le Allain,31052,8586,Agence_mtn_Abomey,300000,277534,2022-02-27
CASH_IN,246619,Agence_mtn_Cotonou,300000,53381,Thérèse-Juliette Camus,-29600,217019,2022-02-01
TRANSFER,133961,Thérèse-Juliette Camus,217019,83058,Thérèse-Juliette Camus,217019,83058,2022-02-01
CASH_IN,192232,Agence_mtn_Cotonou,300000,107768,Thérèse-Juliette Camus,83058,275290,2022-02-01
CASH_IN,177597,Agence_mtn_Cotonou,300000,122403,Thérèse-Juliette Camus,275290,452887,2022-02-03
CASH_OUT,325788,Thérèse-Juliette Camus,452887,127099,Agence_mtn_Ouidah,300000,-25788,2022-02-03
CASH_OUT,8541,Thérèse-Juliette Camus,127099,118558,Agence_mtn_Ouidah,300000,291459,2022-02-03
CASH_OUT,79067,Thérèse-Juliette Camus,118558,39491,Agence_mtn_Ouidah,300000,220933,2022-02-05
CASH_OUT,8058,Thérèse-Juliette Camus,39491,31433,Agence_mtn_Abomey,300000,291942,2022-02-09
CASH_IN,196700,Agence_mtn_Abomey,300000,103300,Thérèse-Juliette Camus,31433,228133,2022-02-19
CASH_OUT,132159,Thérèse-Juliette Camus,228133,95974,Agence_mtn_Ouidah,300000,167841,2022-02-26
CASH_IN,24818,Agence_mtn_Cotonou,300000,275182,Maggie Barbier,-370485,-345667,2022-02-10
CASH_IN,90485,Agence_mtn_Cotonou,300000,209515,Maggie Barbier,-345667,-255182,2022-02-13
CASH_IN,74292,Agence_mtn_Cotonou,300000,225708,Maggie Barbier,-255182,-180890,2022-02-14
CASH_IN,137383,Agence_mtn_Cotonou,300000,162617,Maggie Barbier,-180890,-43507,2022-02-17
CASH_IN,5911,Agence_mtn_Cotonou,300000,294089,Maggie Barbier,-43507,-37596,2022-02-20
CASH_IN,218110,Agence_mtn_Abomey,300000,81890,Maggie Barbier,-37596,180514,2022-02-22
CASH_IN,53656,Agence_mtn_Abomey,300000,246344,Élise Monnier,-580736,-527080,2022-02-01
CASH_IN,295801,Agence_mtn_Cotonou,300000,4199,Élise Monnier,-527080,-231279,2022-02-01
CASH_IN,139705,Agence_mtn_Cotonou,300000,160295,Élise Monnier,-231279,-91574,2022-02-02
CASH_IN,221188,Agence_mtn_Cotonou,300000,78812,Élise Monnier,-91574,129614,2022-02-05
CASH_IN,219951,Agence_mtn_Cotonou,300000,80049,Élise Monnier,129614,349565,2022-02-06
CASH_IN,156296,Agence_mtn_Ouidah,300000,143704,Élise Monnier,349565,505861,2022-02-12
TRANSFER,306435,Élise Monnier,505861,199426,Élise Monnier,505861,812296,2022-02-14
TRANSFER,188290,Élise Monnier,199426,11136,Élise Monnier,199426,387716,2022-02-15
CASH_OUT,4990,Élise Monnier,11136,6146,Agence_mtn_Cotonou,300000,295010,2022-02-16
CASH_OUT,2758,Élise Monnier,6146,3388,Agence_mtn_Cotonou,300000,297242,2022-02-16
CASH_IN,155437,Agence_mtn_Abomey,300000,144563,Élise Monnier,3388,158825,2022-02-16
CASH_IN,115011,Agence_mtn_Ouidah,300000,184989,Élise Monnier,158825,273836,2022-02-19
CASH_IN,257634,Agence_mtn_Cotonou,300000,42366,Élise Monnier,273836,531470,2022-02-19
CASH_IN,235468,Agence_mtn_Cotonou,300000,64532,Élise Monnier,531470,766938,2022-02-21
CASH_OUT,560018,Élise Monnier,766938,206920,Agence_mtn_Abomey,300000,-260018,2022-02-26
CASH_IN,216787,Agence_mtn_Cotonou,300000,83213,Madeleine Hardy,-52347,164440,2022-02-01
CASH_IN,291141,Agence_mtn_Cotonou,300000,8859,Madeleine Hardy,164440,455581,2022-02-02
TRANSFER,151694,Madeleine Hardy,455581,303887,Madeleine Hardy,455581,303887,2022-02-02
CASH_IN,634,Agence_mtn_Cotonou,300000,299366,Madeleine Hardy,303887,304521,2022-02-02
CASH_OUT,303492,Madeleine Hardy,304521,1029,Agence_mtn_Cotonou,300000,-3492,2022-02-04
TRANSFER,806,Madeleine Hardy,1029,223,Madeleine Hardy,1029,223,2022-02-05
TRANSFER,192,Madeleine Hardy,223,31,Madeleine Hardy,223,415,2022-02-06
CASH_IN,117995,Agence_mtn_Abomey,300000,182005,Madeleine Hardy,31,118026,2022-02-12
TRANSFER,19445,Madeleine Hardy,118026,98581,Madeleine Hardy,118026,98581,2022-02-13
TRANSFER,69143,Madeleine Hardy,98581,29438,Madeleine Hardy,98581,167724,2022-02-14
CASH_IN,83135,Agence_mtn_Ouidah,300000,216865,Madeleine Hardy,29438,112573,2022-02-15
CASH_OUT,1409,Madeleine Hardy,112573,111164,Agence_mtn_Cotonou,300000,298591,2022-02-17
CASH_IN,274420,Agence_mtn_Abomey,300000,25580,Madeleine Hardy,111164,385584,2022-02-17
CASH_OUT,368138,Madeleine Hardy,385584,17446,Agence_mtn_Cotonou,300000,-68138,2022-02-17
CASH_OUT,7116,Madeleine Hardy,17446,10330,Agence_mtn_Ouidah,300000,292884,2022-02-17
CASH_OUT,715,Madeleine Hardy,10330,9615,Agence_mtn_Cotonou,300000,299285,2022-02-19
CASH_IN,113351,Agence_mtn_Ouidah,300000,186649,Madeleine Hardy,9615,122966,2022-02-19
CASH_OUT,118197,Madeleine Hardy,122966,4769,Agence_mtn_Ouidah,300000,181803,2022-02-27
CASH_IN,238957,Agence_mtn_Ouidah,300000,61043,Christine Rossi,-356186,-117229,2022-02-01
CASH_IN,97910,Agence_mtn_Cotonou,300000,202090,Christine Rossi,-117229,-19319,2022-02-08
CASH_IN,112833,Agence_mtn_Abomey,300000,187167,Christine Rossi,-19319,93514,2022-02-09
CASH_OUT,75820,Christine Rossi,93514,17694,Agence_mtn_Cotonou,300000,224180,2022-02-10
CASH_OUT,16577,Christine Rossi,17694,1117,Agence_mtn_Ouidah,300000,283423,2022-02-11
CASH_IN,211663,Agence_mtn_Abomey,300000,88337,Christine Rossi,1117,212780,2022-02-13
CASH_OUT,68234,Christine Rossi,212780,144546,Agence_mtn_Ouidah,300000,231766,2022-02-14
CASH_OUT,42552,Christine Rossi,144546,101994,Agence_mtn_Ouidah,300000,257448,2022-02-14
CASH_IN,236717,Agence_mtn_Cotonou,300000,63283,Christine Rossi,101994,338711,2022-02-15
CASH_OUT,119230,Christine Rossi,338711,219481,Agence_mtn_Cotonou,300000,180770,2022-02-16
CASH_IN,208967,Agence_mtn_Ouidah,300000,91033,Christine Rossi,219481,428448,2022-02-16
CASH_IN,83012,Agence_mtn_Cotonou,300000,216988,Christine Rossi,428448,511460,2022-02-17
CASH_OUT,185564,Christine Rossi,511460,325896,Agence_mtn_Ouidah,300000,114436,2022-02-19
CASH_OUT,167279,Christine Rossi,325896,158617,Agence_mtn_Cotonou,300000,132721,2022-02-19
TRANSFER,4855,Christine Rossi,158617,153762,Christine Rossi,158617,163472,2022-02-20
CASH_OUT,27408,Christine Rossi,153762,126354,Agence_mtn_Ouidah,300000,272592,2022-02-23
CASH_IN,95659,Agence_mtn_Cotonou,300000,204341,Christine Rossi,126354,222013,2022-02-27
CASH_IN,199303,Agence_mtn_Abomey,300000,100697,Astrid Aubert-Thierry,-908388,-709085,2022-02-01
CASH_IN,150874,Agence_mtn_Ouidah,300000,149126,Astrid Aubert-Thierry,-709085,-558211,2022-02-04
CASH_IN,8719,Agence_mtn_Ouidah,300000,291281,Astrid Aubert-Thierry,-558211,-549492,2022-02-06
CASH_IN,196963,Agence_mtn_Ouidah,300000,103037,Astrid Aubert-Thierry,-549492,-352529,2022-02-09
CASH_IN,27357,Agence_mtn_Abomey,300000,272643,Astrid Aubert-Thierry,-352529,-325172,2022-02-10
CASH_IN,30569,Agence_mtn_Ouidah,300000,269431,Astrid Aubert-Thierry,-325172,-294603,2022-02-10
CASH_IN,80984,Agence_mtn_Abomey,300000,219016,Astrid Aubert-Thierry,-294603,-213619,2022-02-13
CASH_IN,4969,Agence_mtn_Cotonou,300000,295031,Astrid Aubert-Thierry,-213619,-208650,2022-02-13
CASH_IN,146552,Agence_mtn_Cotonou,300000,153448,Astrid Aubert-Thierry,-208650,-62098,2022-02-20
CASH_IN,182605,Agence_mtn_Cotonou,300000,117395,Astrid Aubert-Thierry,-62098,120507,2022-02-22
CASH_IN,131709,Agence_mtn_Abomey,300000,168291,Hélène Blanchard-Renault,-87,131622,2022-02-02
TRANSFER,14384,Hélène Blanchard-Renault,131622,117238,Hélène Blanchard-Renault,131622,117238,2022-02-04
TRANSFER,60968,Hélène Blanchard-Renault,117238,56270,Hélène Blanchard-Renault,117238,178206,2022-02-06
CASH_IN,102025,Agence_mtn_Ouidah,300000,197975,Hélène Blanchard-Renault,56270,158295,2022-02-10
TRANSFER,147406,Hélène Blanchard-Renault,158295,10889,Hélène Blanchard-Renault,158295,10889,2022-02-10
CASH_OUT,1457,Hélène Blanchard-Renault,10889,9432,Agence_mtn_Cotonou,300000,298543,2022-02-19
CASH_IN,287044,Agence_mtn_Abomey,300000,12956,Hélène Blanchard-Renault,9432,296476,2022-02-20
CASH_IN,4030,Agence_mtn_Abomey,300000,295970,Hélène Blanchard-Renault,296476,300506,2022-02-20
CASH_IN,169635,Agence_mtn_Cotonou,300000,130365,Hélène Blanchard-Renault,300506,470141,2022-02-20
CASH_IN,58152,Agence_mtn_Ouidah,300000,241848,Hélène Blanchard-Renault,470141,528293,2022-02-22
CASH_OUT,267270,Hélène Blanchard-Renault,528293,261023,Agence_mtn_Ouidah,300000,32730,2022-02-23
CASH_OUT,3600,Hélène Blanchard-Renault,261023,257423,Agence_mtn_Abomey,300000,296400,2022-02-24
CASH_IN,253551,Agence_mtn_Ouidah,300000,46449,Hélène Blanchard-Renault,257423,510974,2022-02-26
CASH_IN,251301,Agence_mtn_Ouidah,300000,48699,Charlotte Perrier,5,251306,2022-02-01
TRANSFER,124507,Charlotte Perrier,251306,126799,Charlotte Perrier,251306,126799,2022-02-02
CASH_IN,21285,Agence_mtn_Abomey,300000,278715,Charlotte Perrier,126799,148084,2022-02-03
CASH_OUT,125684,Charlotte Perrier,148084,22400,Agence_mtn_Abomey,300000,174316,2022-02-05
CASH_OUT,5969,Charlotte Perrier,22400,16431,Agence_mtn_Ouidah,300000,294031,2022-02-08
CASH_IN,172122,Agence_mtn_Cotonou,300000,127878,Charlotte Perrier,16431,188553,2022-02-09
CASH_IN,185563,Agence_mtn_Abomey,300000,114437,Charlotte Perrier,188553,374116,2022-02-09
TRANSFER,124273,Charlotte Perrier,374116,249843,Charlotte Perrier,374116,249843,2022-02-12
CASH_OUT,201902,Charlotte Perrier,249843,47941,Agence_mtn_Abomey,300000,98098,2022-02-15
CASH_IN,54719,Agence_mtn_Ouidah,300000,245281,Charlotte Perrier,47941,102660,2022-02-18
CASH_IN,113889,Agence_mtn_Cotonou,300000,186111,Charlotte Perrier,102660,216549,2022-02-23
CASH_OUT,70591,Charlotte Perrier,216549,145958,Agence_mtn_Abomey,300000,229409,2022-02-24
CASH_OUT,46304,Charlotte Perrier,145958,99654,Agence_mtn_Ouidah,300000,253696,2022-02-25
CASH_OUT,48988,Charlotte Perrier,99654,50666,Agence_mtn_Abomey,300000,251012,2022-02-26
CASH_IN,172345,Agence_mtn_Ouidah,300000,127655,Charlotte Perrier,50666,223011,2022-02-26
CASH_IN,265179,Agence_mtn_Cotonou,300000,34821,Jérôme Laporte Le Gauthier,-190685,74494,2022-02-06
CASH_OUT,68039,Jérôme Laporte Le Gauthier,74494,6455,Agence_mtn_Abomey,300000,231961,2022-02-06
CASH_IN,142346,Agence_mtn_Ouidah,300000,157654,Jérôme Laporte Le Gauthier,6455,148801,2022-02-11
TRANSFER,132039,Jérôme Laporte Le Gauthier,148801,16762,Jérôme Laporte Le Gauthier,148801,16762,2022-02-15
CASH_IN,122077,Agence_mtn_Ouidah,300000,177923,Jérôme Laporte Le Gauthier,16762,138839,2022-02-17
TRANSFER,41545,Jérôme Laporte Le Gauthier,138839,97294,Jérôme Laporte Le Gauthier,138839,180384,2022-02-17
CASH_IN,250171,Agence_mtn_Ouidah,300000,49829,Jérôme Laporte Le Gauthier,97294,347465,2022-02-18
CASH_IN,122095,Agence_mtn_Cotonou,300000,177905,Jérôme Laporte Le Gauthier,347465,469560,2022-02-19
CASH_OUT,281594,Jérôme Laporte Le Gauthier,469560,187966,Agence_mtn_Ouidah,300000,18406,2022-02-20
CASH_IN,90755,Agence_mtn_Abomey,300000,209245,Jérôme Laporte Le Gauthier,187966,278721,2022-02-20
CASH_IN,242995,Agence_mtn_Abomey,300000,57005,Jérôme Laporte Le Gauthier,278721,521716,2022-02-22
CASH_OUT,182729,Jérôme Laporte Le Gauthier,521716,338987,Agence_mtn_Cotonou,300000,117271,2022-02-22
CASH_OUT,72175,Jérôme Laporte Le Gauthier,338987,266812,Agence_mtn_Cotonou,300000,227825,2022-02-22
CASH_OUT,262828,Jérôme Laporte Le Gauthier,266812,3984,Agence_mtn_Abomey,300000,37172,2022-02-26
CASH_IN,53737,Agence_mtn_Abomey,300000,246263,Jérôme Laporte Le Gauthier,3984,57721,2022-02-27
CASH_IN,101536,Agence_mtn_Ouidah,300000,198464,Céline-Inès Meunier,-194959,-93423,2022-02-02
CASH_IN,210866,Agence_mtn_Abomey,300000,89134,Céline-Inès Meunier,-93423,117443,2022-02-06
CASH_IN,44375,Agence_mtn_Ouidah,300000,255625,Céline-Inès Meunier,117443,161818,2022-02-07
TRANSFER,6615,Céline-Inès Meunier,161818,155203,Céline-Inès Meunier,161818,168433,2022-02-10
CASH_OUT,102916,Céline-Inès Meunier,155203,52287,Agence_mtn_Abomey,300000,197084,2022-02-16
TRANSFER,5322,Céline-Inès Meunier,52287,46965,Céline-Inès Meunier,52287,46965,2022-02-19
CASH_IN,245527,Agence_mtn_Ouidah,300000,54473,Céline-Inès Meunier,46965,292492,2022-02-19
CASH_OUT,32339,Céline-Inès Meunier,292492,260153,Agence_mtn_Cotonou,300000,267661,2022-02-22
CASH_IN,288744,Agence_mtn_Abomey,300000,11256,Céline-Inès Meunier,260153,548897,2022-02-23
CASH_OUT,182354,Céline-Inès Meunier,548897,366543,Agence_mtn_Abomey,300000,117646,2022-02-23
CASH_OUT,177926,Céline-Inès Meunier,366543,188617,Agence_mtn_Ouidah,300000,122074,2022-02-26
CASH_IN,37792,Agence_mtn_Cotonou,300000,262208,Marcel de la Buisson,-249628,-211836,2022-02-01
CASH_IN,44592,Agence_mtn_Abomey,300000,255408,Marcel de la Buisson,-211836,-167244,2022-02-05
CASH_IN,144479,Agence_mtn_Abomey,300000,155521,Marcel de la Buisson,-167244,-22765,2022-02-08
CASH_IN,287293,Agence_mtn_Cotonou,300000,12707,Marcel de la Buisson,-22765,264528,2022-02-10
CASH_OUT,99178,Marcel de la Buisson,264528,165350,Agence_mtn_Ouidah,300000,200822,2022-02-14
CASH_IN,34258,Agence_mtn_Ouidah,300000,265742,Emmanuel Vallée,-352229,-317971,2022-02-02
CASH_IN,52433,Agence_mtn_Ouidah,300000,247567,Emmanuel Vallée,-317971,-265538,2022-02-04
CASH_IN,270326,Agence_mtn_Ouidah,300000,29674,Emmanuel Vallée,-265538,4788,2022-02-05
CASH_OUT,4145,Emmanuel Vallée,4788,643,Agence_mtn_Ouidah,300000,295855,2022-02-06
TRANSFER,522,Emmanuel Vallée,643,121,Emmanuel Vallée,643,1165,2022-02-09
CASH_OUT,103,Emmanuel Vallée,121,18,Agence_mtn_Cotonou,300000,299897,2022-02-10
CASH_IN,42432,Agence_mtn_Ouidah,300000,257568,Emmanuel Vallée,18,42450,2022-02-10
TRANSFER,9150,Emmanuel Vallée,42450,33300,Emmanuel Vallée,42450,33300,2022-02-12
TRANSFER,32139,Emmanuel Vallée,33300,1161,Emmanuel Vallée,33300,65439,2022-02-13
CASH_IN,89613,Agence_mtn_Abomey,300000,210387,Emmanuel Vallée,1161,90774,2022-02-14
CASH_IN,83119,Agence_mtn_Cotonou,300000,216881,Emmanuel Vallée,90774,173893,2022-02-15
CASH_OUT,45538,Emmanuel Vallée,173893,128355,Agence_mtn_Abomey,300000,254462,2022-02-16
CASH_IN,108798,Agence_mtn_Ouidah,300000,191202,Emmanuel Vallée,128355,237153,2022-02-16
CASH_OUT,74445,Emmanuel Vallée,237153,162708,Agence_mtn_Cotonou,300000,225555,2022-02-19
CASH_IN,223612,Agence_mtn_Ouidah,300000,76388,Emmanuel Vallée,162708,386320,2022-02-24
CASH_IN,43323,Agence_mtn_Ouidah,300000,256677,Emmanuel Vallée,386320,429643,2022-02-25
TRANSFER,1062973,Roger-Roger Delmas,1438700,375727,Louis du Boyer,1540700,477727,2022-03-08
TRANSFER,39787,Roger-Roger Delmas,375727,335940,Emmanuelle Le Allain,1424800,1385013,2022-03-19
TRANSFER,77204,Gabrielle Hamon,613900,536696,Marine Chevallier,1512800,1435596,2022-03-05
TRANSFER,1551647,Margot Julien,1688700,137053,Gabrielle Hamon,536696,2088343,2022-03-11
TRANSFER,1014184,Clémence-Alice Ruiz,1030500,16316,Gabrielle Hamon,2088343,3102527,2022-03-13
CASH_IN,267281,Agence_mtn_Ouidah,300000,32719,Gabrielle Hamon,3102527,3369808,2022-03-18
CASH_OUT,251267,Marc Costa-Daniel,770700,519433,Agence_mtn_Cotonou,300000,48733,2022-03-05
CASH_IN,121903,Agence_mtn_Cotonou,300000,178097,Marc Costa-Daniel,519433,641336,2022-03-08
CASH_IN,49381,Agence_mtn_Ouidah,300000,250619,Marc Costa-Daniel,641336,690717,2022-03-09
CASH_IN,20316,Agence_mtn_Abomey,300000,279684,Marc Costa-Daniel,690717,711033,2022-03-10
CASH_OUT,302013,Marc Costa-Daniel,711033,409020,Agence_mtn_Abomey,300000,-2013,2022-03-14
CASH_IN,123785,Agence_mtn_Abomey,300000,176215,Nathalie Da Silva,1198500,1322285,2022-03-05
CASH_OUT,902275,Nathalie Da Silva,1322285,420010,Agence_mtn_Ouidah,300000,-602275,2022-03-06
CASH_OUT,307459,Nathalie Da Silva,420010,112551,Agence_mtn_Ouidah,300000,-7459,2022-03-07
CASH_OUT,796881,Georges Muller,1361200,564319,Agence_mtn_Cotonou,300000,-496881,2022-03-25
CASH_OUT,1567118,Océane Faure,1835500,268382,Agence_mtn_Cotonou,300000,-1267118,2022-03-01
TRANSFER,92212,Océane Faure,268382,176170,Robert Henry-Poulain,1251900,1159688,2022-03-11
CASH_OUT,163,Océane Faure,176170,176007,Agence_mtn_Abomey,300000,299837,2022-03-20
TRANSFER,33456,Michèle Faivre,34400,944,Sébastien Coste,1283200,1249744,2022-03-02
CASH_OUT,103,Michèle Faivre,944,841,Agence_mtn_Cotonou,300000,299897,2022-03-06
CASH_OUT,794,Michèle Faivre,841,47,Agence_mtn_Ouidah,300000,299206,2022-03-09
CASH_IN,29584,Agence_mtn_Ouidah,300000,270416,Michèle Faivre,47,29631,2022-03-10
CASH_OUT,7966,Michèle Faivre,29631,21665,Agence_mtn_Cotonou,300000,292034,2022-03-23
CASH_OUT,986574,Hélène Alexandre de la Samson,993800,7226,Agence_mtn_Abomey,300000,-686574,2022-03-11
CASH_IN,8289,Agence_mtn_Abomey,300000,291711,Hélène Alexandre de la Samson,7226,15515,2022-03-13
CASH_IN,212436,Agence_mtn_Abomey,300000,87564,Hélène Alexandre de la Samson,15515,227951,2022-03-20
CASH_OUT,77761,Hélène Alexandre de la Samson,227951,150190,Agence_mtn_Cotonou,300000,222239,2022-03-25
CASH_IN,206460,Agence_mtn_Ouidah,300000,93540,Hélène Alexandre de la Samson,150190,356650,2022-03-26
CASH_IN,94503,Agence_mtn_Cotonou,300000,205497,Thérèse-Juliette Camus,970800,1065303,2022-03-07
TRANSFER,759528,Clémence Dufour,935900,176372,Thérèse-Juliette Camus,1065303,1824831,2022-03-09
CASH_IN,55820,Agence_mtn_Ouidah,300000,244180,Thérèse-Juliette Camus,1824831,1880651,2022-03-16
CASH_IN,39923,Agence_mtn_Abomey,300000,260077,Thérèse-Juliette Camus,1880651,1920574,2022-03-20
TRANSFER,40368,Thérèse-Juliette Camus,1920574,1880206,Valérie de Pottier,1954400,1914032,2022-03-26
TRANSFER,200723,Sébastien Coste,1249744,1049021,Margot Julien,137053,-63670,2022-03-05
TRANSFER,171938,Sébastien Coste,1049021,877083,Christophe Teixeira,1407100,1235162,2022-03-13
CASH_IN,17884,Agence_mtn_Ouidah,300000,282116,Danielle-Henriette Tessier,802500,820384,2022-03-25
TRANSFER,1578644,Laurent Marion,1623500,44856,Marc Baudry,1247900,-330744,2022-03-06
TRANSFER,9862,Christophe Besnard-Diaz,10300,438,Laurent Marion,44856,54718,2022-03-15
CASH_IN,113183,Agence_mtn_Cotonou,300000,186817,Laurent Marion,54718,167901,2022-03-19
CASH_OUT,73404,Laurent Marion,167901,94497,Agence_mtn_Cotonou,300000,226596,2022-03-26
CASH_IN,68145,Agence_mtn_Ouidah,300000,231855,Céline-Inès Meunier,1118900,1187045,2022-03-07
CASH_IN,131822,Agence_mtn_Abomey,300000,168178,Céline-Inès Meunier,1187045,1318867,2022-03-21
CASH_OUT,726271,Céline-Inès Meunier,1318867,592596,Agence_mtn_Cotonou,300000,-426271,2022-03-22
TRANSFER,580710,Christine Rossi,1024600,443890,François Vaillant,1318900,738190,2022-03-18
CASH_OUT,204236,Christine Rossi,443890,239654,Agence_mtn_Cotonou,300000,95764,2022-03-24
CASH_IN,139776,Agence_mtn_Abomey,300000,160224,Nicole Huet,394600,534376,2022-03-01
CASH_IN,177565,Agence_mtn_Abomey,300000,122435,Nicole Huet,534376,711941,2022-03-10
CASH_IN,34243,Agence_mtn_Abomey,300000,265757,Nicole Huet,711941,746184,2022-03-22
TRANSFER,191078,Nicole Huet,746184,555106,Sophie-Anouk Boulanger,1428200,1237122,2022-03-23
TRANSFER,329138,Raymond-Yves Boulanger,429000,99862,Jean Guilbert-Lenoir,1468500,1139362,2022-03-01
TRANSFER,5576,Raymond-Yves Boulanger,99862,94286,Astrid de Pascal,378100,372524,2022-03-07
CASH_OUT,12117,Raymond-Yves Boulanger,94286,82169,Agence_mtn_Abomey,300000,287883,2022-03-24
CASH_OUT,967832,Julie Germain Le Vaillant,1984700,1016868,Agence_mtn_Cotonou,300000,-667832,2022-03-19
TRANSFER,723061,Maurice de Brunet,998000,274939,Julie Germain Le Vaillant,1016868,1739929,2022-03-21
CASH_OUT,682273,Julie Germain Le Vaillant,1739929,1057656,Agence_mtn_Abomey,300000,-382273,2022-03-23
CASH_IN,252184,Agence_mtn_Ouidah,300000,47816,Julie Germain Le Vaillant,1057656,1309840,2022-03-25
CASH_OUT,1006297,Henri de Didier,1972300,966003,Agence_mtn_Ouidah,300000,-706297,2022-03-03
CASH_IN,59499,Agence_mtn_Cotonou,300000,240501,Henri de Didier,966003,1025502,2022-03-08
CASH_OUT,254895,Henri de Didier,1025502,770607,Agence_mtn_Abomey,300000,45105,2022-03-27
CASH_OUT,301781,Jérôme Laporte Le Gauthier,1014600,712819,Agence_mtn_Cotonou,300000,-1781,2022-03-22
CASH_IN,251793,Agence_mtn_Ouidah,300000,48207,Jules-Marc Chauvet,1960400,2212193,2022-03-14
TRANSFER,729238,Georges-Alfred Pruvost,1912500,1183262,Jules-Marc Chauvet,2212193,2941431,2022-03-18
CASH_OUT,2821901,Jules-Marc Chauvet,2941431,119530,Agence_mtn_Ouidah,300000,-2521901,2022-03-19
TRANSFER,644878,René de la Delaunay,1606000,961122,Jules-Marc Chauvet,119530,764408,2022-03-20
CASH_IN,55347,Agence_mtn_Abomey,300000,244653,Jules-Marc Chauvet,764408,819755,2022-03-24
CASH_OUT,474937,Emmanuel Legrand,691700,216763,Agence_mtn_Cotonou,300000,-174937,2022-03-07
TRANSFER,81537,Emmanuel Legrand,216763,135226,Anouk Delahaye-Gimenez,1125600,1044063,2022-03-11
CASH_OUT,84460,Emmanuel Legrand,135226,50766,Agence_mtn_Ouidah,300000,215540,2022-03-11
CASH_IN,70815,Agence_mtn_Cotonou,300000,229185,Emmanuel Legrand,50766,121581,2022-03-24
CASH_IN,26337,Agence_mtn_Ouidah,300000,273663,Augustin-Jérôme Merle,1140000,1166337,2022-03-05
CASH_OUT,593342,Augustin-Jérôme Merle,1166337,572995,Agence_mtn_Ouidah,300000,-293342,2022-03-06
CASH_IN,159964,Agence_mtn_Abomey,300000,140036,Augustin-Jérôme Merle,572995,732959,2022-03-19
CASH_IN,262274,Agence_mtn_Cotonou,300000,37726,Olivier Benard,1532500,1794774,2022-03-08
TRANSFER,1341614,Olivier Benard,1794774,453160,Pénélope Boulay,19800,-1321814,2022-03-10
CASH_IN,296108,Agence_mtn_Cotonou,300000,3892,Olivier Benard,453160,749268,2022-03-18
CASH_OUT,1575998,Emmanuel Vallée,1964000,388002,Agence_mtn_Cotonou,300000,-1275998,2022-03-01
CASH_OUT,272614,Emmanuel Vallée,388002,115388,Agence_mtn_Cotonou,300000,27386,2022-03-01
CASH_IN,13118,Agence_mtn_Cotonou,300000,286882,Emmanuel Vallée,115388,128506,2022-03-02
CASH_IN,221306,Agence_mtn_Cotonou,300000,78694,Emmanuel Vallée,128506,349812,2022-03-03
TRANSFER,1738,Robert Henry-Poulain,1159688,1157950,Emmanuel Vallée,349812,351550,2022-03-05
CASH_IN,261138,Agence_mtn_Ouidah,300000,38862,Emmanuel Vallée,351550,612688,2022-03-06
CASH_OUT,432309,Emmanuel Vallée,612688,180379,Agence_mtn_Ouidah,300000,-132309,2022-03-07
CASH_OUT,172815,Emmanuel Vallée,180379,7564,Agence_mtn_Ouidah,300000,127185,2022-03-08
CASH_IN,151864,Agence_mtn_Abomey,300000,148136,Emmanuel Vallée,7564,159428,2022-03-09
CASH_OUT,4344,Emmanuel Vallée,159428,155084,Agence_mtn_Cotonou,300000,295656,2022-03-11
CASH_OUT,106841,Emmanuel Vallée,155084,48243,Agence_mtn_Ouidah,300000,193159,2022-03-11
CASH_OUT,34667,Emmanuel Vallée,48243,13576,Agence_mtn_Abomey,300000,265333,2022-03-12
TRANSFER,874781,Élise Monnier,1726000,851219,Emmanuel Vallée,13576,888357,2022-03-13
CASH_OUT,285575,Emmanuel Vallée,888357,602782,Agence_mtn_Abomey,300000,14425,2022-03-15
CASH_IN,256392,Agence_mtn_Abomey,300000,43608,Emmanuel Vallée,602782,859174,2022-03-17
CASH_IN,51202,Agence_mtn_Abomey,300000,248798,Emmanuel Vallée,859174,910376,2022-03-19
CASH_OUT,98730,Emmanuel Vallée,910376,811646,Agence_mtn_Abomey,300000,201270,2022-03-19
CASH_OUT,31300,Emmanuel Vallée,811646,780346,Agence_mtn_Ouidah,300000,268700,2022-03-21
CASH_OUT,108902,Emmanuel Vallée,780346,671444,Agence_mtn_Cotonou,300000,191098,2022-03-22
CASH_IN,88582,Agence_mtn_Abomey,300000,211418,Emmanuel Vallée,671444,760026,2022-03-22
CASH_IN,40907,Agence_mtn_Cotonou,300000,259093,Emmanuel Vallée,760026,800933,2022-03-23
TRANSFER,53790,Raymond Simon,1341600,1287810,Emmanuel Vallée,800933,854723,2022-03-24
TRANSFER,784831,Raymond Simon,1287810,502979,Emmanuel Vallée,854723,1639554,2022-03-24
TRANSFER,1033714,Jean Guilbert-Lenoir,1139362,105648,Emmanuel Vallée,1639554,2673268,2022-03-27
TRANSFER,57933,Jean Guilbert-Lenoir,105648,47715,Madeleine Hardy,516500,458567,2022-03-01
CASH_OUT,7857,Jean Guilbert-Lenoir,47715,39858,Agence_mtn_Abomey,300000,292143,2022-03-02
TRANSFER,380333,Éléonore Marin Le Morel,561100,180767,Jean Guilbert-Lenoir,39858,420191,2022-03-02
CASH_IN,207706,Agence_mtn_Ouidah,300000,92294,Jean Guilbert-Lenoir,420191,627897,2022-03-03
TRANSFER,386357,Jean Guilbert-Lenoir,627897,241540,Nathalie-Claire De Oliveira,355100,-31257,2022-03-03
CASH_IN,233746,Agence_mtn_Cotonou,300000,66254,Jean Guilbert-Lenoir,241540,475286,2022-03-04
CASH_IN,156500,Agence_mtn_Abomey,300000,143500,Jean Guilbert-Lenoir,475286,631786,2022-03-06
CASH_IN,108978,Agence_mtn_Ouidah,300000,191022,Jean Guilbert-Lenoir,631786,740764,2022-03-06
CASH_OUT,259763,Jean Guilbert-Lenoir,740764,481001,Agence_mtn_Abomey,300000,40237,2022-03-07
TRANSFER,514626,Honoré de la Prévost,897700,383074,Jean Guilbert-Lenoir,481001,995627,2022-03-09
CASH_OUT,870530,Jean Guilbert-Lenoir,995627,125097,Agence_mtn_Cotonou,300000,-570530,2022-03-10
TRANSFER,463395,Georges-Alfred Pruvost,1183262,719867,Jean Guilbert-Lenoir,125097,588492,2022-03-11
CASH_IN,253779,Agence_mtn_Abomey,300000,46221,Jean Guilbert-Lenoir,588492,842271,2022-03-14
CASH_IN,132569,Agence_mtn_Abomey,300000,167431,Jean Guilbert-Lenoir,842271,974840,2022-03-14
TRANSFER,227052,Charles Guérin,772700,545648,Jean Guilbert-Lenoir,974840,1201892,2022-03-17
CASH_OUT,218695,Jean Guilbert-Lenoir,1201892,983197,Agence_mtn_Ouidah,300000,81305,2022-03-17
TRANSFER,25282,Michelle de la Daniel,163100,137818,Jean Guilbert-Lenoir,983197,1008479,2022-03-18
CASH_IN,44618,Agence_mtn_Abomey,300000,255382,Jean Guilbert-Lenoir,1008479,1053097,2022-03-19
TRANSFER,470327,Jean Guilbert-Lenoir,1053097,582770,Christophe Besnard-Diaz,438,-469889,2022-03-20
CASH_IN,159046,Agence_mtn_Ouidah,300000,140954,Jean Guilbert-Lenoir,582770,741816,2022-03-21
TRANSFER,179068,Jean Guilbert-Lenoir,741816,562748,Élisabeth Delattre,819100,640032,2022-03-21
TRANSFER,514871,Jean Guilbert-Lenoir,562748,47877,René de la Delaunay,961122,446251,2022-03-22
TRANSFER,28315,Jean Guilbert-Lenoir,47877,19562,Marthe Perrin,1448100,1419785,2022-03-23
CASH_IN,233592,Agence_mtn_Cotonou,300000,66408,Jean Guilbert-Lenoir,19562,253154,2022-03-24
CASH_IN,75293,Agence_mtn_Abomey,300000,224707,Jean Guilbert-Lenoir,253154,328447,2022-03-25
TRANSFER,1258372,Stéphanie Guichard,1578000,319628,Jean Guilbert-Lenoir,328447,1586819,2022-03-25
CASH_OUT,171902,Jean Guilbert-Lenoir,1586819,1414917,Agence_mtn_Cotonou,300000,128098,2022-03-25
TRANSFER,1401368,Jean Guilbert-Lenoir,1414917,13549,Élisabeth Delattre,640032,-761336,2022-03-27
TRANSFER,155470,Thibault Martin,178900,23430,Jean Guilbert-Lenoir,13549,169019,2022-03-27
CASH_OUT,237654,Julien Devaux,1999300,1761646,Agence_mtn_Abomey,300000,62346,2022-03-01
CASH_IN,251273,Agence_mtn_Cotonou,300000,48727,Julien Devaux,1761646,2012919,2022-03-03
TRANSFER,673588,Julien Devaux,2012919,1339331,Valérie-Claudine Marin,1055800,382212,2022-03-04
CASH_OUT,237665,Julien Devaux,1339331,1101666,Agence_mtn_Ouidah,300000,62335,2022-03-04
CASH_OUT,749156,Julien Devaux,1101666,352510,Agence_mtn_Cotonou,300000,-449156,2022-03-05
CASH_OUT,46742,Julien Devaux,352510,305768,Agence_mtn_Abomey,300000,253258,2022-03-07
TRANSFER,119420,Julien Devaux,305768,186348,Élisabeth Blot-Bruneau,996900,877480,2022-03-07
CASH_OUT,4148,Julien Devaux,186348,182200,Agence_mtn_Ouidah,300000,295852,2022-03-08
TRANSFER,138637,Julien Devaux,182200,43563,Matthieu Cousin,1625000,1486363,2022-03-11
TRANSFER,11870,Julien Devaux,43563,31693,Clémence-Alice Ruiz,16316,4446,2022-03-12
CASH_OUT,31535,Julien Devaux,31693,158,Agence_mtn_Ouidah,300000,268465,2022-03-12
TRANSFER,158,Julien Devaux,158,0,Louise-Aurore Payet,114900,114742,2022-03-13
CASH_IN,130028,Agence_mtn_Ouidah,300000,169972,Julien Devaux,0,130028,2022-03-14
TRANSFER,126068,Julien Devaux,130028,3960,Astrid de Pascal,372524,246456,2022-03-19
TRANSFER,2171,Julien Devaux,3960,1789,Julien Devaux,3960,1789,2022-03-19
TRANSFER,1315,Julien Devaux,1789,474,Jacques Laporte de Blanchet,1142200,1140885,2022-03-20
CASH_OUT,231,Julien Devaux,474,243,Agence_mtn_Cotonou,300000,299769,2022-03-20
CASH_IN,74181,Agence_mtn_Abomey,300000,225819,Julien Devaux,243,74424,2022-03-20
TRANSFER,52141,Julien Devaux,74424,22283,Édouard Grondin du Fleury,1069500,1017359,2022-03-22
TRANSFER,604471,Emmanuelle Le Allain,1385013,780542,Julien Devaux,22283,626754,2022-03-22
CASH_OUT,39522,Julien Devaux,626754,587232,Agence_mtn_Cotonou,300000,260478,2022-03-22
CASH_OUT,157221,Julien Devaux,587232,430011,Agence_mtn_Cotonou,300000,142779,2022-03-22
TRANSFER,1596042,Nicole-Renée Gay,1939300,343258,Julien Devaux,430011,2026053,2022-03-24
CASH_OUT,1682722,Julien Devaux,2026053,343331,Agence_mtn_Abomey,300000,-1382722,2022-03-25
CASH_IN,261195,Agence_mtn_Cotonou,300000,38805,Julien Devaux,343331,604526,2022-03-26
CASH_OUT,220089,Julien Devaux,604526,384437,Agence_mtn_Ouidah,300000,79911,2022-03-26
CASH_IN,252857,Agence_mtn_Cotonou,300000,47143,Julien Devaux,384437,637294,2022-03-26
CASH_IN,113306,Agence_mtn_Cotonou,300000,186694,Julien Devaux,637294,750600,2022-03-27
CASH_OUT,108605,Louise-Aurore Payet,114742,6137,Agence_mtn_Ouidah,300000,191395,2022-03-01
CASH_IN,224397,Agence_mtn_Cotonou,300000,75603,Louise-Aurore Payet,6137,230534,2022-03-01
TRANSFER,400021,Louis du Boyer,477727,77706,Louise-Aurore Payet,230534,630555,2022-03-02
CASH_OUT,294911,Louise-Aurore Payet,630555,335644,Agence_mtn_Ouidah,300000,5089,2022-03-02
CASH_IN,154231,Agence_mtn_Abomey,300000,145769,Louise-Aurore Payet,335644,489875,2022-03-04
TRANSFER,897390,Thibault-Julien Chevallier,1779700,882310,Louise-Aurore Payet,489875,1387265,2022-03-06
TRANSFER,697900,Louise-Aurore Payet,1387265,689365,Nicolas Blin,1923500,1225600,2022-03-07
CASH_IN,211168,Agence_mtn_Cotonou,300000,88832,Louise-Aurore Payet,689365,900533,2022-03-07
CASH_OUT,143668,Louise-Aurore Payet,900533,756865,Agence_mtn_Cotonou,300000,156332,2022-03-07
CASH_IN,53104,Agence_mtn_Abomey,300000,246896,Louise-Aurore Payet,756865,809969,2022-03-10
CASH_OUT,172310,Louise-Aurore Payet,809969,637659,Agence_mtn_Cotonou,300000,127690,2022-03-11
CASH_IN,89169,Agence_mtn_Cotonou,300000,210831,Louise-Aurore Payet,637659,726828,2022-03-13
TRANSFER,324799,Louise-Aurore Payet,726828,402029,Véronique Hardy,987200,662401,2022-03-16
CASH_OUT,270398,Louise-Aurore Payet,402029,131631,Agence_mtn_Abomey,300000,29602,2022-03-16
CASH_IN,10624,Agence_mtn_Ouidah,300000,289376,Louise-Aurore Payet,131631,142255,2022-03-19
TRANSFER,31579,Sabine Perrier,1172700,1141121,Louise-Aurore Payet,142255,173834,2022-03-21
TRANSFER,573828,Guy-Augustin Pinto,1333700,759872,Louise-Aurore Payet,173834,747662,2022-03-22
CASH_IN,105060,Agence_mtn_Cotonou,300000,194940,Louise-Aurore Payet,747662,852722,2022-03-24
TRANSFER,26628,Astrid de Pascal,246456,219828,Louise-Aurore Payet,852722,879350,2022-03-26
CASH_IN,14723,Agence_mtn_Cotonou,300000,285277,Louise-Aurore Payet,879350,894073,2022-03-27
CASH_IN,11099,Agence_mtn_Abomey,300000,288901,Louise-Aurore Payet,894073,905172,2022-03-27
TRANSFER,111335,Emmanuelle Le Allain,780542,669207,Madeleine Hardy,458567,347232,2022-03-01
CASH_IN,190694,Agence_mtn_Cotonou,300000,109306,Emmanuelle Le Allain,669207,859901,2022-03-04
CASH_IN,104827,Agence_mtn_Abomey,300000,195173,Emmanuelle Le Allain,859901,964728,2022-03-06
TRANSFER,1490885,Valérie de Pottier,1914032,423147,Emmanuelle Le Allain,964728,2455613,2022-03-06
CASH_IN,233199,Agence_mtn_Abomey,300000,66801,Emmanuelle Le Allain,2455613,2688812,2022-03-08
TRANSFER,1013050,Astrid Aubert-Thierry,1473400,460350,Emmanuelle Le Allain,2688812,3701862,2022-03-10
CASH_IN,179186,Agence_mtn_Abomey,300000,120814,Emmanuelle Le Allain,3701862,3881048,2022-03-10
CASH_OUT,2574274,Emmanuelle Le Allain,3881048,1306774,Agence_mtn_Abomey,300000,-2274274,2022-03-11
CASH_OUT,378342,Emmanuelle Le Allain,1306774,928432,Agence_mtn_Ouidah,300000,-78342,2022-03-15
CASH_OUT,903000,Emmanuelle Le Allain,928432,25432,Agence_mtn_Cotonou,300000,-603000,2022-03-15
CASH_IN,74647,Agence_mtn_Cotonou,300000,225353,Emmanuelle Le Allain,25432,100079,2022-03-15
CASH_IN,145255,Agence_mtn_Cotonou,300000,154745,Emmanuelle Le Allain,100079,245334,2022-03-16
CASH_IN,189955,Agence_mtn_Abomey,300000,110045,Emmanuelle Le Allain,245334,435289,2022-03-16
TRANSFER,313566,Thibault-Julien Chevallier,882310,568744,Emmanuelle Le Allain,435289,748855,2022-03-16
CASH_IN,268033,Agence_mtn_Ouidah,300000,31967,Emmanuelle Le Allain,748855,1016888,2022-03-17
CASH_IN,189994,Agence_mtn_Abomey,300000,110006,Emmanuelle Le Allain,1016888,1206882,2022-03-17
CASH_OUT,201153,Emmanuelle Le Allain,1206882,1005729,Agence_mtn_Cotonou,300000,98847,2022-03-18
CASH_OUT,699473,Emmanuelle Le Allain,1005729,306256,Agence_mtn_Cotonou,300000,-399473,2022-03-18
TRANSFER,1285,Clémence-Alice Ruiz,4446,3161,Emmanuelle Le Allain,306256,307541,2022-03-19
CASH_OUT,241125,Emmanuelle Le Allain,307541,66416,Agence_mtn_Abomey,300000,58875,2022-03-19
CASH_IN,265411,Agence_mtn_Ouidah,300000,34589,Emmanuelle Le Allain,66416,331827,2022-03-19
CASH_IN,178970,Agence_mtn_Abomey,300000,121030,Emmanuelle Le Allain,331827,510797,2022-03-20
TRANSFER,450471,Emmanuelle Le Allain,510797,60326,Gérard Blot de Blanc,1843800,1393329,2022-03-20
TRANSFER,331639,Robert Henry-Poulain,1157950,826311,Emmanuelle Le Allain,60326,391965,2022-03-22
CASH_IN,40654,Agence_mtn_Cotonou,300000,259346,Emmanuelle Le Allain,391965,432619,2022-03-23
CASH_OUT,251620,Emmanuelle Le Allain,432619,180999,Agence_mtn_Ouidah,300000,48380,2022-03-23
TRANSFER,696968,Margaud-Michelle Briand,833100,136132,Emmanuelle Le Allain,180999,877967,2022-03-23
CASH_OUT,786180,Emmanuelle Le Allain,877967,91787,Agence_mtn_Ouidah,300000,-486180,2022-03-23
CASH_OUT,39815,Emmanuelle Le Allain,91787,51972,Agence_mtn_Abomey,300000,260185,2022-03-23
CASH_IN,123702,Agence_mtn_Abomey,300000,176298,Emmanuelle Le Allain,51972,175674,2022-03-24
CASH_OUT,61535,Clémence Dufour,176372,114837,Agence_mtn_Cotonou,300000,238465,2022-03-01
CASH_OUT,37965,Clémence Dufour,114837,76872,Agence_mtn_Abomey,300000,262035,2022-03-03
CASH_OUT,76431,Clémence Dufour,76872,441,Agence_mtn_Ouidah,300000,223569,2022-03-04
TRANSFER,267438,Robert Henry-Poulain,826311,558873,Clémence Dufour,441,267879,2022-03-06
CASH_OUT,160691,Clémence Dufour,267879,107188,Agence_mtn_Abomey,300000,139309,2022-03-08
CASH_OUT,72585,Clémence Dufour,107188,34603,Agence_mtn_Cotonou,300000,227415,2022-03-09
TRANSFER,706444,Josette du Hamon,1138600,432156,Clémence Dufour,34603,741047,2022-03-09
CASH_OUT,57003,Clémence Dufour,741047,684044,Agence_mtn_Abomey,300000,242997,2022-03-09
TRANSFER,177723,Clémence Dufour,684044,506321,Aurélie Maury,33300,-144423,2022-03-09
CASH_OUT,355784,Clémence Dufour,506321,150537,Agence_mtn_Ouidah,300000,-55784,2022-03-11
CASH_IN,200181,Agence_mtn_Ouidah,300000,99819,Clémence Dufour,150537,350718,2022-03-11
CASH_IN,293016,Agence_mtn_Cotonou,300000,6984,Clémence Dufour,350718,643734,2022-03-11
CASH_IN,174169,Agence_mtn_Abomey,300000,125831,Clémence Dufour,643734,817903,2022-03-13
CASH_IN,123793,Agence_mtn_Cotonou,300000,176207,Clémence Dufour,817903,941696,2022-03-13
TRANSFER,818859,Jacques Le Marion,982200,163341,Clémence Dufour,941696,1760555,2022-03-13
TRANSFER,71657,Guy-Augustin Pinto,759872,688215,Clémence Dufour,1760555,1832212,2022-03-15
TRANSFER,60848,Clémence Dufour,1832212,1771364,Maryse Delorme,1209400,1148552,2022-03-16
CASH_OUT,1600645,Clémence Dufour,1771364,170719,Agence_mtn_Cotonou,300000,-1300645,2022-03-17
TRANSFER,187,Jacques Marchand,2000,1813,Clémence Dufour,170719,170906,2022-03-18
CASH_OUT,28093,Clémence Dufour,170906,142813,Agence_mtn_Abomey,300000,271907,2022-03-18
TRANSFER,65741,Clémence Dufour,142813,77072,Clémence Dufour,142813,208554,2022-03-20
CASH_IN,272166,Agence_mtn_Ouidah,300000,27834,Clémence Dufour,77072,349238,2022-03-23
CASH_IN,138813,Agence_mtn_Ouidah,300000,161187,Clémence Dufour,349238,488051,2022-03-23
CASH_OUT,442025,Clémence Dufour,488051,46026,Agence_mtn_Abomey,300000,-142025,2022-03-24
CASH_IN,129503,Agence_mtn_Abomey,300000,170497,Clémence Dufour,46026,175529,2022-03-27
CASH_OUT,253343,Maurice de Brunet,274939,21596,Agence_mtn_Ouidah,300000,46657,2022-03-02
CASH_IN,48413,Agence_mtn_Abomey,300000,251587,Maurice de Brunet,21596,70009,2022-03-03
CASH_IN,201087,Agence_mtn_Cotonou,300000,98913,Maurice de Brunet,70009,271096,2022-03-04
CASH_OUT,35286,Maurice de Brunet,271096,235810,Agence_mtn_Abomey,300000,264714,2022-03-05
TRANSFER,421723,Roland Huet,650000,228277,Maurice de Brunet,235810,657533,2022-03-05
CASH_IN,54433,Agence_mtn_Ouidah,300000,245567,Maurice de Brunet,657533,711966,2022-03-10
TRANSFER,1094,Simone du Allard,19700,18606,Maurice de Brunet,711966,713060,2022-03-11
TRANSFER,447164,Thibault-Julien Chevallier,568744,121580,Maurice de Brunet,713060,1160224,2022-03-11
TRANSFER,887629,Madeleine Philippe-Grondin,1110000,222371,Maurice de Brunet,1160224,2047853,2022-03-13
CASH_OUT,1396419,Maurice de Brunet,2047853,651434,Agence_mtn_Cotonou,300000,-1096419,2022-03-13
CASH_OUT,65256,Maurice de Brunet,651434,586178,Agence_mtn_Cotonou,300000,234744,2022-03-13
CASH_OUT,300199,Maurice de Brunet,586178,285979,Agence_mtn_Abomey,300000,-199,2022-03-16
TRANSFER,124019,Maurice de Brunet,285979,161960,René de la Delaunay,446251,322232,2022-03-18
CASH_IN,777,Agence_mtn_Cotonou,300000,299223,Maurice de Brunet,161960,162737,2022-03-19
TRANSFER,54486,Maurice de Brunet,162737,108251,Louis du Boyer,77706,23220,2022-03-20
CASH_IN,259951,Agence_mtn_Abomey,300000,40049,Maurice de Brunet,108251,368202,2022-03-20
CASH_OUT,158736,Maurice de Brunet,368202,209466,Agence_mtn_Ouidah,300000,141264,2022-03-21
CASH_IN,54286,Agence_mtn_Cotonou,300000,245714,Maurice de Brunet,209466,263752,2022-03-23
CASH_OUT,110027,Maurice de Brunet,263752,153725,Agence_mtn_Cotonou,300000,189973,2022-03-24
CASH_IN,270163,Agence_mtn_Ouidah,300000,29837,Maurice de Brunet,153725,423888,2022-03-25
TRANSFER,851855,Guillaume de la Nguyen,1845300,993445,Maurice de Brunet,423888,1275743,2022-03-25
CASH_IN,299601,Agence_mtn_Ouidah,300000,399,Maurice de Brunet,1275743,1575344,2022-03-26
CASH_IN,249766,Agence_mtn_Abomey,300000,50234,Maurice de Brunet,1575344,1825110,2022-03-27
TRANSFER,23244,Margaud-Michelle Briand,136132,112888,Maurice de Brunet,1825110,1848354,2022-03-27
TRANSFER,117194,Michelle de la Daniel,137818,20624,Josette du Hamon,432156,549350,2022-03-01
CASH_OUT,416852,Josette du Hamon,549350,132498,Agence_mtn_Cotonou,300000,-116852,2022-03-04
CASH_IN,176557,Agence_mtn_Ouidah,300000,123443,Josette du Hamon,132498,309055,2022-03-05
TRANSFER,227509,Josette du Hamon,309055,81546,Alfred Paris,1469500,1241991,2022-03-07
TRANSFER,75733,Josette du Hamon,81546,5813,Marcel de la Buisson,1631500,1555767,2022-03-08
TRANSFER,691258,Hélène Blanchard-Renault,1073900,382642,Josette du Hamon,5813,697071,2022-03-08
TRANSFER,7046,Michelle de la Daniel,20624,13578,Josette du Hamon,697071,704117,2022-03-09
TRANSFER,19693,Jacques Le Marion,163341,143648,Josette du Hamon,704117,723810,2022-03-10
CASH_OUT,305697,Josette du Hamon,723810,418113,Agence_mtn_Abomey,300000,-5697,2022-03-14
TRANSFER,128201,Josette du Hamon,418113,289912,Alexandre Blanchard,1870000,1741799,2022-03-14
TRANSFER,227090,Josette du Hamon,289912,62822,Alexandre Blanchard,1741799,1514709,2022-03-14
CASH_OUT,813,Josette du Hamon,62822,62009,Agence_mtn_Ouidah,300000,299187,2022-03-15
CASH_OUT,45946,Josette du Hamon,62009,16063,Agence_mtn_Abomey,300000,254054,2022-03-16
CASH_OUT,13657,Josette du Hamon,16063,2406,Agence_mtn_Abomey,300000,286343,2022-03-16
CASH_IN,191854,Agence_mtn_Abomey,300000,108146,Josette du Hamon,2406,194260,2022-03-17
TRANSFER,52020,Josette du Hamon,194260,142240,Alexandre Delaunay,1468900,1416880,2022-03-18
CASH_OUT,79183,Josette du Hamon,142240,63057,Agence_mtn_Abomey,300000,220817,2022-03-18
CASH_IN,5703,Agence_mtn_Cotonou,300000,294297,Josette du Hamon,63057,68760,2022-03-19
TRANSFER,44671,Josette du Hamon,68760,24089,Guy-Augustin Pinto,688215,643544,2022-03-19
TRANSFER,2689,Clémence-Alice Ruiz,3161,472,Josette du Hamon,24089,26778,2022-03-21
CASH_OUT,14532,Josette du Hamon,26778,12246,Agence_mtn_Ouidah,300000,285468,2022-03-23
CASH_IN,288280,Agence_mtn_Abomey,300000,11720,Josette du Hamon,12246,300526,2022-03-24
CASH_IN,22164,Agence_mtn_Cotonou,300000,277836,Josette du Hamon,300526,322690,2022-03-25
CASH_IN,146121,Agence_mtn_Abomey,300000,153879,Josette du Hamon,322690,468811,2022-03-26
CASH_OUT,91927,Josette du Hamon,468811,376884,Agence_mtn_Abomey,300000,208073,2022-03-27
CASH_IN,8555,Agence_mtn_Cotonou,300000,291445,Jacques Laporte de Blanchet,1140885,1149440,2022-03-01
TRANSFER,453641,Jacques Laporte de Blanchet,1149440,695799,Hélène Blanchard-Renault,382642,-70999,2022-03-03
TRANSFER,17531,Simone du Allard,18606,1075,Jacques Laporte de Blanchet,695799,713330,2022-03-03
TRANSFER,567778,Jacques Laporte de Blanchet,713330,145552,Françoise Denis de Allard,1028200,460422,2022-03-03
CASH_IN,65156,Agence_mtn_Cotonou,300000,234844,Jacques Laporte de Blanchet,145552,210708,2022-03-04
CASH_IN,179340,Agence_mtn_Abomey,300000,120660,Jacques Laporte de Blanchet,210708,390048,2022-03-04
CASH_IN,105774,Agence_mtn_Ouidah,300000,194226,Jacques Laporte de Blanchet,390048,495822,2022-03-06
CASH_OUT,102203,Jacques Laporte de Blanchet,495822,393619,Agence_mtn_Abomey,300000,197797,2022-03-06
CASH_IN,13333,Agence_mtn_Abomey,300000,286667,Jacques Laporte de Blanchet,393619,406952,2022-03-07
TRANSFER,353309,Jacques Laporte de Blanchet,406952,53643,Gilbert Moulin,690500,337191,2022-03-07
CASH_IN,240072,Agence_mtn_Cotonou,300000,59928,Jacques Laporte de Blanchet,53643,293715,2022-03-12
TRANSFER,168878,Jacques Laporte de Blanchet,293715,124837,Thibault-Julien Chevallier,121580,-47298,2022-03-12
CASH_OUT,116303,Jacques Laporte de Blanchet,124837,8534,Agence_mtn_Cotonou,300000,183697,2022-03-12
TRANSFER,710946,Raymond de Le Roux,1722100,1011154,Jacques Laporte de Blanchet,8534,719480,2022-03-15
CASH_OUT,716713,Jacques Laporte de Blanchet,719480,2767,Agence_mtn_Ouidah,300000,-416713,2022-03-15
CASH_OUT,525,Jacques Laporte de Blanchet,2767,2242,Agence_mtn_Cotonou,300000,299475,2022-03-15
CASH_IN,280090,Agence_mtn_Abomey,300000,19910,Jacques Laporte de Blanchet,2242,282332,2022-03-15
CASH_OUT,175521,Jacques Laporte de Blanchet,282332,106811,Agence_mtn_Abomey,300000,124479,2022-03-16
CASH_OUT,2271,Jacques Laporte de Blanchet,106811,104540,Agence_mtn_Ouidah,300000,297729,2022-03-16
CASH_OUT,4249,Jacques Laporte de Blanchet,104540,100291,Agence_mtn_Cotonou,300000,295751,2022-03-20
TRANSFER,91279,Jacques Laporte de Blanchet,100291,9012,Stéphanie Guichard,319628,228349,2022-03-20
TRANSFER,1989,Jacques Laporte de Blanchet,9012,7023,Stéphanie Guichard,228349,226360,2022-03-21
CASH_OUT,6401,Jacques Laporte de Blanchet,7023,622,Agence_mtn_Abomey,300000,293599,2022-03-22
TRANSFER,294562,Madeleine Hardy,347232,52670,Jacques Laporte de Blanchet,622,295184,2022-03-23
CASH_OUT,82498,Jacques Laporte de Blanchet,295184,212686,Agence_mtn_Cotonou,300000,217502,2022-03-24
TRANSFER,88790,Jacques Laporte de Blanchet,212686,123896,Honoré Grégoire-Breton,322300,233510,2022-03-26
CASH_IN,148233,Agence_mtn_Cotonou,300000,151767,Jacques Laporte de Blanchet,123896,272129,2022-03-27
TRANSFER,11623,Louis du Boyer,23220,11597,Honoré de la Prévost,383074,394697,2022-03-01
CASH_OUT,227979,Honoré de la Prévost,394697,166718,Agence_mtn_Abomey,300000,72021,2022-03-05
TRANSFER,92303,Honoré de la Prévost,166718,74415,Gilbert Moulin,337191,244888,2022-03-07
CASH_OUT,54144,Honoré de la Prévost,74415,20271,Agence_mtn_Cotonou,300000,245856,2022-03-07
CASH_OUT,17869,Honoré de la Prévost,20271,2402,Agence_mtn_Abomey,300000,282131,2022-03-07
TRANSFER,435,Honoré de la Prévost,2402,1967,Édouard Grondin du Fleury,1017359,1016924,2022-03-08
CASH_OUT,667,Honoré de la Prévost,1967,1300,Agence_mtn_Cotonou,300000,299333,2022-03-08
CASH_OUT,247,Honoré de la Prévost,1300,1053,Agence_mtn_Ouidah,300000,299753,2022-03-09
CASH_IN,111531,Agence_mtn_Abomey,300000,188469,Honoré de la Prévost,1053,112584,2022-03-09
TRANSFER,83727,Honoré de la Prévost,112584,28857,Alexandre Blanchard,1514709,1430982,2022-03-10
TRANSFER,9409,Honoré de la Prévost,28857,19448,Maryse Delorme,1148552,1139143,2022-03-10
TRANSFER,450265,Raymond Simon,502979,52714,Honoré de la Prévost,19448,469713,2022-03-15
CASH_OUT,121701,Honoré de la Prévost,469713,348012,Agence_mtn_Ouidah,300000,178299,2022-03-15
CASH_OUT,170765,Honoré de la Prévost,348012,177247,Agence_mtn_Ouidah,300000,129235,2022-03-16
TRANSFER,157411,Honoré de la Prévost,177247,19836,Alexandre Delaunay,1416880,1259469,2022-03-20
CASH_OUT,2382,Honoré de la Prévost,19836,17454,Agence_mtn_Abomey,300000,297618,2022-03-21
CASH_IN,275428,Agence_mtn_Abomey,300000,24572,Honoré de la Prévost,17454,292882,2022-03-21
CASH_OUT,272635,Honoré de la Prévost,292882,20247,Agence_mtn_Ouidah,300000,27365,2022-03-23
TRANSFER,9040,Honoré de la Prévost,20247,11207,Georges-Alfred Pruvost,719867,710827,2022-03-23
TRANSFER,77395,Stéphanie Guichard,226360,148965,Honoré de la Prévost,11207,88602,2022-03-24
CASH_IN,51143,Agence_mtn_Cotonou,300000,248857,Honoré de la Prévost,88602,139745,2022-03-26
CASH_IN,47749,Agence_mtn_Ouidah,300000,252251,Georges-Alfred Pruvost,710827,758576,2022-03-01
TRANSFER,740647,Georges-Alfred Pruvost,758576,17929,Valérie-Claudine Marin,382212,-358435,2022-03-02
TRANSFER,14696,Georges-Alfred Pruvost,17929,3233,Christophe Teixeira,1235162,1220466,2022-03-06
CASH_OUT,1501,Georges-Alfred Pruvost,3233,1732,Agence_mtn_Abomey,300000,298499,2022-03-07
CASH_IN,228033,Agence_mtn_Ouidah,300000,71967,Georges-Alfred Pruvost,1732,229765,2022-03-07
TRANSFER,392976,Sabine Perrier,1141121,748145,Georges-Alfred Pruvost,229765,622741,2022-03-08
CASH_IN,84214,Agence_mtn_Cotonou,300000,215786,Georges-Alfred Pruvost,622741,706955,2022-03-09
CASH_OUT,233613,Georges-Alfred Pruvost,706955,473342,Agence_mtn_Abomey,300000,66387,2022-03-09
CASH_IN,232707,Agence_mtn_Ouidah,300000,67293,Georges-Alfred Pruvost,473342,706049,2022-03-10
CASH_OUT,649693,Georges-Alfred Pruvost,706049,56356,Agence_mtn_Cotonou,300000,-349693,2022-03-10
TRANSFER,5109,Georges-Alfred Pruvost,56356,51247,Robert Henry-Poulain,558873,553764,2022-03-11
CASH_IN,87004,Agence_mtn_Cotonou,300000,212996,Georges-Alfred Pruvost,51247,138251,2022-03-12
CASH_OUT,107165,Georges-Alfred Pruvost,138251,31086,Agence_mtn_Abomey,300000,192835,2022-03-13
CASH_OUT,6636,Georges-Alfred Pruvost,31086,24450,Agence_mtn_Cotonou,300000,293364,2022-03-13
CASH_OUT,18256,Georges-Alfred Pruvost,24450,6194,Agence_mtn_Cotonou,300000,281744,2022-03-14
CASH_OUT,5954,Georges-Alfred Pruvost,6194,240,Agence_mtn_Ouidah,300000,294046,2022-03-14
TRANSFER,201,Georges-Alfred Pruvost,240,39,Alfred Paris,1241991,1241790,2022-03-15
CASH_IN,270276,Agence_mtn_Ouidah,300000,29724,Georges-Alfred Pruvost,39,270315,2022-03-15
CASH_OUT,247890,Georges-Alfred Pruvost,270315,22425,Agence_mtn_Cotonou,300000,52110,2022-03-16
CASH_IN,255195,Agence_mtn_Abomey,300000,44805,Georges-Alfred Pruvost,22425,277620,2022-03-16
CASH_IN,200836,Agence_mtn_Ouidah,300000,99164,Georges-Alfred Pruvost,277620,478456,2022-03-21
TRANSFER,476,Simone du Allard,1075,599,Georges-Alfred Pruvost,478456,478932,2022-03-21
CASH_OUT,144498,Georges-Alfred Pruvost,478932,334434,Agence_mtn_Ouidah,300000,155502,2022-03-23
TRANSFER,303875,Georges-Alfred Pruvost,334434,30559,Sophie-Anouk Boulanger,1237122,933247,2022-03-23
CASH_IN,88978,Agence_mtn_Cotonou,300000,211022,Georges-Alfred Pruvost,30559,119537,2022-03-24
TRANSFER,314656,Françoise Denis de Allard,460422,145766,Georges-Alfred Pruvost,119537,434193,2022-03-25
CASH_IN,21990,Agence_mtn_Cotonou,300000,278010,Georges-Alfred Pruvost,434193,456183,2022-03-25
CASH_OUT,367068,Georges-Alfred Pruvost,456183,89115,Agence_mtn_Cotonou,300000,-67068,2022-03-25
TRANSFER,45938,Georges-Alfred Pruvost,89115,43177,Guillaume de la Nguyen,993445,947507,2022-03-26
TRANSFER,264217,Corinne Roussel,390900,126683,Stéphanie Guichard,148965,413182,2022-03-01
CASH_OUT,65446,Stéphanie Guichard,413182,347736,Agence_mtn_Abomey,300000,234554,2022-03-01
CASH_IN,283665,Agence_mtn_Abomey,300000,16335,Stéphanie Guichard,347736,631401,2022-03-02
CASH_OUT,19148,Stéphanie Guichard,631401,612253,Agence_mtn_Abomey,300000,280852,2022-03-02
CASH_IN,55467,Agence_mtn_Abomey,300000,244533,Stéphanie Guichard,612253,667720,2022-03-04
CASH_IN,179632,Agence_mtn_Ouidah,300000,120368,Stéphanie Guichard,667720,847352,2022-03-04
CASH_IN,48897,Agence_mtn_Abomey,300000,251103,Stéphanie Guichard,847352,896249,2022-03-05
CASH_OUT,524133,Stéphanie Guichard,896249,372116,Agence_mtn_Cotonou,300000,-224133,2022-03-05
CASH_IN,181917,Agence_mtn_Ouidah,300000,118083,Stéphanie Guichard,372116,554033,2022-03-06
TRANSFER,156387,Robert Henry-Poulain,553764,397377,Stéphanie Guichard,554033,710420,2022-03-08
TRANSFER,23951,Corinne Roussel,126683,102732,Stéphanie Guichard,710420,734371,2022-03-09
CASH_IN,195338,Agence_mtn_Abomey,300000,104662,Stéphanie Guichard,734371,929709,2022-03-09
CASH_OUT,341550,Stéphanie Guichard,929709,588159,Agence_mtn_Cotonou,300000,-41550,2022-03-11
TRANSFER,181060,Stéphanie Guichard,588159,407099,Clémence-Alice Ruiz,472,-180588,2022-03-14
CASH_IN,46757,Agence_mtn_Abomey,300000,253243,Stéphanie Guichard,407099,453856,2022-03-15
TRANSFER,131325,Stéphanie Guichard,453856,322531,Valérie de Pottier,423147,291822,2022-03-15
TRANSFER,962205,Raymond de Le Roux,1011154,48949,Stéphanie Guichard,322531,1284736,2022-03-18
CASH_IN,23664,Agence_mtn_Abomey,300000,276336,Stéphanie Guichard,1284736,1308400,2022-03-19
CASH_OUT,516981,Stéphanie Guichard,1308400,791419,Agence_mtn_Cotonou,300000,-216981,2022-03-21
TRANSFER,201121,Stéphanie Guichard,791419,590298,Anouk Delahaye-Gimenez,1044063,842942,2022-03-22
CASH_OUT,494640,Stéphanie Guichard,590298,95658,Agence_mtn_Ouidah,300000,-194640,2022-03-22
CASH_OUT,32742,Stéphanie Guichard,95658,62916,Agence_mtn_Abomey,300000,267258,2022-03-23
TRANSFER,44187,Stéphanie Guichard,62916,18729,Nicolas Blin,1225600,1181413,2022-03-24
TRANSFER,7235,Stéphanie Guichard,18729,11494,Guillaume de la Nguyen,947507,940272,2022-03-24
CASH_OUT,10951,Stéphanie Guichard,11494,543,Agence_mtn_Ouidah,300000,289049,2022-03-25
CASH_OUT,381,Stéphanie Guichard,543,162,Agence_mtn_Cotonou,300000,299619,2022-03-26
CASH_OUT,101,Stéphanie Guichard,162,61,Agence_mtn_Abomey,300000,299899,2022-03-26
CASH_IN,63447,Agence_mtn_Abomey,300000,236553,Stéphanie Guichard,61,63508,2022-03-27
CASH_IN,283238,Agence_mtn_Cotonou,300000,16762,Aimé Bernier,1646000,1929238,2022-03-02
CASH_IN,131760,Agence_mtn_Abomey,300000,168240,Aimé Bernier,1929238,2060998,2022-03-03
TRANSFER,890150,Aimé Bernier,2060998,1170848,Éléonore Marin Le Morel,180767,-709383,2022-03-03
CASH_OUT,82473,Aimé Bernier,1170848,1088375,Agence_mtn_Ouidah,300000,217527,2022-03-04
CASH_IN,286404,Agence_mtn_Ouidah,300000,13596,Aimé Bernier,1088375,1374779,2022-03-05
CASH_IN,23516,Agence_mtn_Cotonou,300000,276484,Aimé Bernier,1374779,1398295,2022-03-07
CASH_IN,193424,Agence_mtn_Ouidah,300000,106576,Aimé Bernier,1398295,1591719,2022-03-07
CASH_IN,292137,Agence_mtn_Ouidah,300000,7863,Aimé Bernier,1591719,1883856,2022-03-08
CASH_OUT,1002411,Aimé Bernier,1883856,881445,Agence_mtn_Cotonou,300000,-702411,2022-03-08
CASH_IN,274668,Agence_mtn_Abomey,300000,25332,Aimé Bernier,881445,1156113,2022-03-09
CASH_OUT,634700,Aimé Bernier,1156113,521413,Agence_mtn_Abomey,300000,-334700,2022-03-09
CASH_OUT,188831,Aimé Bernier,521413,332582,Agence_mtn_Ouidah,300000,111169,2022-03-10
CASH_OUT,199734,Aimé Bernier,332582,132848,Agence_mtn_Ouidah,300000,100266,2022-03-12
CASH_IN,175468,Agence_mtn_Cotonou,300000,124532,Aimé Bernier,132848,308316,2022-03-14
CASH_OUT,247026,Aimé Bernier,308316,61290,Agence_mtn_Ouidah,300000,52974,2022-03-14
CASH_IN,290198,Agence_mtn_Cotonou,300000,9802,Aimé Bernier,61290,351488,2022-03-15
CASH_IN,296595,Agence_mtn_Ouidah,300000,3405,Aimé Bernier,351488,648083,2022-03-16
CASH_OUT,385400,Aimé Bernier,648083,262683,Agence_mtn_Cotonou,300000,-85400,2022-03-17
CASH_IN,131490,Agence_mtn_Abomey,300000,168510,Aimé Bernier,262683,394173,2022-03-19
CASH_IN,34338,Agence_mtn_Abomey,300000,265662,Aimé Bernier,394173,428511,2022-03-23
CASH_OUT,148834,Aimé Bernier,428511,279677,Agence_mtn_Abomey,300000,151166,2022-03-24
TRANSFER,81005,Aimé Bernier,279677,198672,Édouard Grondin du Fleury,1016924,935919,2022-03-24
CASH_IN,59531,Agence_mtn_Cotonou,300000,240469,Aimé Bernier,198672,258203,2022-03-24
CASH_IN,95082,Agence_mtn_Abomey,300000,204918,Aimé Bernier,258203,353285,2022-03-27
CASH_OUT,126093,Véronique Hardy,662401,536308,Agence_mtn_Abomey,300000,173907,2022-03-03
CASH_IN,90720,Agence_mtn_Cotonou,300000,209280,Véronique Hardy,536308,627028,2022-03-03
CASH_IN,254151,Agence_mtn_Ouidah,300000,45849,Véronique Hardy,627028,881179,2022-03-04
TRANSFER,403835,Véronique Hardy,881179,477344,Corinne Roussel,102732,-301103,2022-03-06
CASH_OUT,401667,Véronique Hardy,477344,75677,Agence_mtn_Ouidah,300000,-101667,2022-03-07
TRANSFER,70049,Véronique Hardy,75677,5628,Guy-Augustin Pinto,643544,573495,2022-03-08
CASH_OUT,1946,Véronique Hardy,5628,3682,Agence_mtn_Cotonou,300000,298054,2022-03-10
CASH_OUT,2350,Véronique Hardy,3682,1332,Agence_mtn_Ouidah,300000,297650,2022-03-11
CASH_OUT,368,Véronique Hardy,1332,964,Agence_mtn_Cotonou,300000,299632,2022-03-12
TRANSFER,805,Véronique Hardy,964,159,Anouk Delahaye-Gimenez,842942,842137,2022-03-15
CASH_IN,250532,Agence_mtn_Cotonou,300000,49468,Véronique Hardy,159,250691,2022-03-15
TRANSFER,171651,Véronique Hardy,250691,79040,Madeleine Philippe-Grondin,222371,50720,2022-03-17
CASH_IN,159732,Agence_mtn_Cotonou,300000,140268,Véronique Hardy,79040,238772,2022-03-18
CASH_IN,128370,Agence_mtn_Ouidah,300000,171630,Véronique Hardy,238772,367142,2022-03-18
TRANSFER,264267,Véronique Hardy,367142,102875,Guillaume de la Nguyen,940272,676005,2022-03-19
CASH_OUT,51348,Véronique Hardy,102875,51527,Agence_mtn_Ouidah,300000,248652,2022-03-20
CASH_OUT,4111,Véronique Hardy,51527,47416,Agence_mtn_Cotonou,300000,295889,2022-03-20
CASH_OUT,21020,Véronique Hardy,47416,26396,Agence_mtn_Cotonou,300000,278980,2022-03-21
TRANSFER,5243,Véronique Hardy,26396,21153,Christophe Teixeira,1220466,1215223,2022-03-21
CASH_OUT,946,Véronique Hardy,21153,20207,Agence_mtn_Ouidah,300000,299054,2022-03-22
CASH_OUT,17497,Véronique Hardy,20207,2710,Agence_mtn_Cotonou,300000,282503,2022-03-23
CASH_OUT,1131,Véronique Hardy,2710,1579,Agence_mtn_Ouidah,300000,298869,2022-03-24
TRANSFER,832,Véronique Hardy,1579,747,Élisabeth Blot-Bruneau,877480,876648,2022-03-25
CASH_OUT,189,Véronique Hardy,747,558,Agence_mtn_Cotonou,300000,299811,2022-03-26
TRANSFER,282,Véronique Hardy,558,276,Gérard Blot de Blanc,1393329,1393047,2022-03-27
CASH_OUT,174,Véronique Hardy,276,102,Agence_mtn_Ouidah,300000,299826,2022-03-27
CASH_OUT,431556,Marthe Perrin,1419785,988229,Agence_mtn_Cotonou,300000,-131556,2022-03-04
CASH_OUT,637339,Marthe Perrin,988229,350890,Agence_mtn_Ouidah,300000,-337339,2022-03-07
CASH_IN,227731,Agence_mtn_Cotonou,300000,72269,Marthe Perrin,350890,578621,2022-03-08
TRANSFER,35941,Honoré Grégoire-Breton,233510,197569,Marthe Perrin,578621,614562,2022-03-09
CASH_OUT,450507,Marthe Perrin,614562,164055,Agence_mtn_Cotonou,300000,-150507,2022-03-09
TRANSFER,36248,Marthe Perrin,164055,127807,Louis du Boyer,11597,-24651,2022-03-10
CASH_OUT,9812,Marthe Perrin,127807,117995,Agence_mtn_Ouidah,300000,290188,2022-03-10
TRANSFER,85090,Marthe Perrin,117995,32905,Guy-Augustin Pinto,573495,488405,2022-03-14
CASH_IN,260309,Agence_mtn_Abomey,300000,39691,Marthe Perrin,32905,293214,2022-03-14
CASH_OUT,186914,Marthe Perrin,293214,106300,Agence_mtn_Abomey,300000,113086,2022-03-16
CASH_OUT,77586,Marthe Perrin,106300,28714,Agence_mtn_Cotonou,300000,222414,2022-03-16
CASH_IN,43872,Agence_mtn_Abomey,300000,256128,Marthe Perrin,28714,72586,2022-03-17
TRANSFER,59267,Marthe Perrin,72586,13319,Alfred Paris,1241790,1182523,2022-03-17
CASH_OUT,6335,Marthe Perrin,13319,6984,Agence_mtn_Cotonou,300000,293665,2022-03-18
CASH_IN,171642,Agence_mtn_Ouidah,300000,128358,Marthe Perrin,6984,178626,2022-03-19
CASH_OUT,104950,Marthe Perrin,178626,73676,Agence_mtn_Abomey,300000,195050,2022-03-19
CASH_IN,279333,Agence_mtn_Abomey,300000,20667,Marthe Perrin,73676,353009,2022-03-19
CASH_OUT,61169,Marthe Perrin,353009,291840,Agence_mtn_Abomey,300000,238831,2022-03-21
CASH_OUT,39613,Marthe Perrin,291840,252227,Agence_mtn_Abomey,300000,260387,2022-03-22
TRANSFER,1252411,Alexandre Blanchard,1430982,178571,Marthe Perrin,252227,1504638,2022-03-22
CASH_IN,174287,Agence_mtn_Abomey,300000,125713,Marthe Perrin,1504638,1678925,2022-03-23
CASH_IN,165185,Agence_mtn_Cotonou,300000,134815,Marthe Perrin,1678925,1844110,2022-03-23
CASH_OUT,858773,Marthe Perrin,1844110,985337,Agence_mtn_Ouidah,300000,-558773,2022-03-25
CASH_OUT,839739,Marthe Perrin,985337,145598,Agence_mtn_Ouidah,300000,-539739,2022-03-25
TRANSFER,114967,Marthe Perrin,145598,30631,Astrid de Pascal,219828,104861,2022-03-25
TRANSFER,7803,Marthe Perrin,30631,22828,Charlotte Perrier,75800,67997,2022-03-25
CASH_IN,46791,Agence_mtn_Abomey,300000,253209,Marthe Perrin,22828,69619,2022-03-26
TRANSFER,7474,Marthe Perrin,69619,62145,Madeleine Philippe-Grondin,50720,43246,2022-03-27
CASH_IN,135337,Agence_mtn_Cotonou,300000,164663,Marthe Perrin,62145,197482,2022-03-27
TRANSFER,1436624,Matthieu Cousin,1486363,49739,Alexandre Blanchard,178571,-1258053,2022-03-02
TRANSFER,24736,Matthieu Cousin,49739,25003,Simone du Allard,599,-24137,2022-03-02
CASH_OUT,20857,Matthieu Cousin,25003,4146,Agence_mtn_Ouidah,300000,279143,2022-03-03
TRANSFER,1872,Matthieu Cousin,4146,2274,Valérie de Pottier,291822,289950,2022-03-04
TRANSFER,109803,Margaud-Michelle Briand,112888,3085,Matthieu Cousin,2274,112077,2022-03-05
TRANSFER,609806,Anouk Delahaye-Gimenez,842137,232331,Matthieu Cousin,112077,721883,2022-03-06
CASH_IN,262624,Agence_mtn_Cotonou,300000,37376,Matthieu Cousin,721883,984507,2022-03-07
CASH_OUT,956876,Matthieu Cousin,984507,27631,Agence_mtn_Cotonou,300000,-656876,2022-03-08
CASH_OUT,12196,Matthieu Cousin,27631,15435,Agence_mtn_Abomey,300000,287804,2022-03-08
CASH_OUT,14832,Matthieu Cousin,15435,603,Agence_mtn_Ouidah,300000,285168,2022-03-10
CASH_OUT,393,Matthieu Cousin,603,210,Agence_mtn_Abomey,300000,299607,2022-03-10
CASH_IN,249955,Agence_mtn_Abomey,300000,50045,Matthieu Cousin,210,250165,2022-03-11
CASH_OUT,2844,Matthieu Cousin,250165,247321,Agence_mtn_Ouidah,300000,297156,2022-03-11
CASH_IN,128888,Agence_mtn_Abomey,300000,171112,Matthieu Cousin,247321,376209,2022-03-13
CASH_IN,18366,Agence_mtn_Ouidah,300000,281634,Matthieu Cousin,376209,394575,2022-03-16
CASH_IN,287246,Agence_mtn_Cotonou,300000,12754,Matthieu Cousin,394575,681821,2022-03-17
CASH_OUT,362546,Matthieu Cousin,681821,319275,Agence_mtn_Cotonou,300000,-62546,2022-03-20
CASH_IN,140767,Agence_mtn_Cotonou,300000,159233,Matthieu Cousin,319275,460042,2022-03-21
CASH_IN,50739,Agence_mtn_Ouidah,300000,249261,Matthieu Cousin,460042,510781,2022-03-22
TRANSFER,253465,Nicole-Renée Gay,343258,89793,Matthieu Cousin,510781,764246,2022-03-23
CASH_OUT,376177,Matthieu Cousin,764246,388069,Agence_mtn_Cotonou,300000,-76177,2022-03-25
CASH_IN,236146,Agence_mtn_Abomey,300000,63854,Matthieu Cousin,388069,624215,2022-03-25
CASH_IN,2127,Agence_mtn_Abomey,300000,297873,Matthieu Cousin,624215,626342,2022-03-26
CASH_OUT,442750,Matthieu Cousin,626342,183592,Agence_mtn_Abomey,300000,-142750,2022-03-26
TRANSFER,85259,Astrid de Pascal,104861,19602,Matthieu Cousin,183592,268851,2022-03-26
CASH_IN,179990,Agence_mtn_Abomey,300000,120010,Matthieu Cousin,268851,448841,2022-03-26
TRANSFER,214913,Matthieu Cousin,448841,233928,Michelle de la Daniel,13578,-201335,2022-03-27
CASH_IN,118094,Agence_mtn_Ouidah,300000,181906,Aurélie Maury,-144423,-26329,2022-03-01
CASH_IN,152752,Agence_mtn_Cotonou,300000,147248,Aurélie Maury,-26329,126423,2022-03-03
CASH_OUT,25371,Aurélie Maury,126423,101052,Agence_mtn_Ouidah,300000,274629,2022-03-04
CASH_IN,196818,Agence_mtn_Ouidah,300000,103182,Aurélie Maury,101052,297870,2022-03-06
CASH_IN,246013,Agence_mtn_Cotonou,300000,53987,Aurélie Maury,297870,543883,2022-03-07
CASH_IN,227449,Agence_mtn_Cotonou,300000,72551,Aurélie Maury,543883,771332,2022-03-07
CASH_IN,85955,Agence_mtn_Ouidah,300000,214045,Aurélie Maury,771332,857287,2022-03-07
CASH_IN,43810,Agence_mtn_Ouidah,300000,256190,Aurélie Maury,857287,901097,2022-03-07
CASH_OUT,776228,Aurélie Maury,901097,124869,Agence_mtn_Cotonou,300000,-476228,2022-03-08
TRANSFER,4526,Aurélie Maury,124869,120343,Sophie-Anouk Boulanger,933247,928721,2022-03-09
TRANSFER,18151,Aurélie Maury,120343,102192,Robert Henry-Poulain,397377,379226,2022-03-10
TRANSFER,31787,Aurélie Maury,102192,70405,Astrid de Pascal,19602,-12185,2022-03-11
CASH_OUT,65304,Aurélie Maury,70405,5101,Agence_mtn_Ouidah,300000,234696,2022-03-11
CASH_IN,183418,Agence_mtn_Cotonou,300000,116582,Aurélie Maury,5101,188519,2022-03-12
CASH_OUT,95217,Aurélie Maury,188519,93302,Agence_mtn_Abomey,300000,204783,2022-03-12
TRANSFER,89533,Nicole-Renée Gay,89793,260,Aurélie Maury,93302,182835,2022-03-14
CASH_OUT,53620,Aurélie Maury,182835,129215,Agence_mtn_Cotonou,300000,246380,2022-03-15
CASH_IN,168815,Agence_mtn_Ouidah,300000,131185,Aurélie Maury,129215,298030,2022-03-16
CASH_OUT,9936,Aurélie Maury,298030,288094,Agence_mtn_Abomey,300000,290064,2022-03-16
CASH_OUT,210970,Aurélie Maury,288094,77124,Agence_mtn_Ouidah,300000,89030,2022-03-17
TRANSFER,14913,Thibault Martin,23430,8517,Aurélie Maury,77124,92037,2022-03-20
CASH_IN,144427,Agence_mtn_Ouidah,300000,155573,Aurélie Maury,92037,236464,2022-03-20
CASH_OUT,27489,Aurélie Maury,236464,208975,Agence_mtn_Cotonou,300000,272511,2022-03-21
CASH_OUT,190388,Aurélie Maury,208975,18587,Agence_mtn_Abomey,300000,109612,2022-03-23
TRANSFER,542649,Nicolas Blin,1181413,638764,Aurélie Maury,18587,561236,2022-03-25
TRANSFER,7101,Aurélie Maury,561236,554135,Aurélie Maury,561236,554135,2022-03-26
CASH_OUT,292485,Aurélie Maury,554135,261650,Agence_mtn_Abomey,300000,7515,2022-03-27
TRANSFER,123671,Aurélie Maury,261650,137979,Honoré Grégoire-Breton,197569,73898,2022-03-27
CASH_IN,113108,Agence_mtn_Cotonou,300000,186892,Margot Julien,-63670,49438,2022-03-01
CASH_IN,233236,Agence_mtn_Cotonou,300000,66764,Margot Julien,49438,282674,2022-03-02
CASH_OUT,111728,Margot Julien,282674,170946,Agence_mtn_Ouidah,300000,188272,2022-03-04
TRANSFER,19165,Margot Julien,170946,151781,Charlotte Perrier,67997,48832,2022-03-05
CASH_OUT,13511,Margot Julien,151781,138270,Agence_mtn_Cotonou,300000,286489,2022-03-05
CASH_OUT,101471,Margot Julien,138270,36799,Agence_mtn_Cotonou,300000,198529,2022-03-05
CASH_OUT,4601,Margot Julien,36799,32198,Agence_mtn_Cotonou,300000,295399,2022-03-05
CASH_OUT,7525,Margot Julien,32198,24673,Agence_mtn_Cotonou,300000,292475,2022-03-07
CASH_IN,286702,Agence_mtn_Cotonou,300000,13298,Margot Julien,24673,311375,2022-03-08
CASH_OUT,66141,Margot Julien,311375,245234,Agence_mtn_Abomey,300000,233859,2022-03-09
CASH_IN,114822,Agence_mtn_Abomey,300000,185178,Margot Julien,245234,360056,2022-03-10
CASH_OUT,164402,Margot Julien,360056,195654,Agence_mtn_Abomey,300000,135598,2022-03-10
CASH_OUT,75920,Margot Julien,195654,119734,Agence_mtn_Abomey,300000,224080,2022-03-11
CASH_IN,164901,Agence_mtn_Ouidah,300000,135099,Margot Julien,119734,284635,2022-03-14
CASH_IN,273111,Agence_mtn_Ouidah,300000,26889,Margot Julien,284635,557746,2022-03-14
TRANSFER,261120,Margot Julien,557746,296626,Raymond de Le Roux,48949,-212171,2022-03-14
CASH_OUT,228752,Margot Julien,296626,67874,Agence_mtn_Ouidah,300000,71248,2022-03-15
CASH_IN,183701,Agence_mtn_Cotonou,300000,116299,Margot Julien,67874,251575,2022-03-15
CASH_IN,27203,Agence_mtn_Cotonou,300000,272797,Margot Julien,251575,278778,2022-03-17
CASH_OUT,85891,Margot Julien,278778,192887,Agence_mtn_Cotonou,300000,214109,2022-03-19
CASH_IN,52421,Agence_mtn_Cotonou,300000,247579,Margot Julien,192887,245308,2022-03-20
TRANSFER,16213,Madeleine Hardy,52670,36457,Margot Julien,245308,261521,2022-03-22
TRANSFER,256021,Margot Julien,261521,5500,Raymond Simon,52714,-203307,2022-03-23
CASH_IN,18808,Agence_mtn_Ouidah,300000,281192,Margot Julien,5500,24308,2022-03-23
TRANSFER,469702,Élisabeth Blot-Bruneau,876648,406946,Margot Julien,24308,494010,2022-03-25
CASH_OUT,216139,Margot Julien,494010,277871,Agence_mtn_Abomey,300000,83861,2022-03-26
CASH_IN,11051,Agence_mtn_Cotonou,300000,288949,Margot Julien,277871,288922,2022-03-27
CASH_IN,86887,Agence_mtn_Cotonou,300000,213113,Sophie-Anouk Boulanger,928721,1015608,2022-03-01
CASH_OUT,263068,Sophie-Anouk Boulanger,1015608,752540,Agence_mtn_Abomey,300000,36932,2022-03-02
TRANSFER,181111,Sophie-Anouk Boulanger,752540,571429,René de la Delaunay,322232,141121,2022-03-06
CASH_IN,119733,Agence_mtn_Abomey,300000,180267,Sophie-Anouk Boulanger,571429,691162,2022-03-06
TRANSFER,491567,Sophie-Anouk Boulanger,691162,199595,François Vaillant,738190,246623,2022-03-07
CASH_IN,264240,Agence_mtn_Abomey,300000,35760,Sophie-Anouk Boulanger,199595,463835,2022-03-07
CASH_OUT,319101,Sophie-Anouk Boulanger,463835,144734,Agence_mtn_Ouidah,300000,-19101,2022-03-09
CASH_IN,85068,Agence_mtn_Abomey,300000,214932,Sophie-Anouk Boulanger,144734,229802,2022-03-09
CASH_OUT,33859,Sophie-Anouk Boulanger,229802,195943,Agence_mtn_Cotonou,300000,266141,2022-03-11
CASH_OUT,122941,Sophie-Anouk Boulanger,195943,73002,Agence_mtn_Abomey,300000,177059,2022-03-11
TRANSFER,960764,Alfred Paris,1182523,221759,Sophie-Anouk Boulanger,73002,1033766,2022-03-11
CASH_OUT,757215,Sophie-Anouk Boulanger,1033766,276551,Agence_mtn_Abomey,300000,-457215,2022-03-11
CASH_IN,101545,Agence_mtn_Cotonou,300000,198455,Sophie-Anouk Boulanger,276551,378096,2022-03-12
CASH_OUT,293079,Sophie-Anouk Boulanger,378096,85017,Agence_mtn_Cotonou,300000,6921,2022-03-13
CASH_OUT,26360,Sophie-Anouk Boulanger,85017,58657,Agence_mtn_Cotonou,300000,273640,2022-03-15
CASH_OUT,49787,Sophie-Anouk Boulanger,58657,8870,Agence_mtn_Abomey,300000,250213,2022-03-17
TRANSFER,4142,Sophie-Anouk Boulanger,8870,4728,Madeleine Hardy,36457,32315,2022-03-17
TRANSFER,36451,René de la Delaunay,141121,104670,Sophie-Anouk Boulanger,4728,41179,2022-03-19
CASH_IN,270235,Agence_mtn_Cotonou,300000,29765,Sophie-Anouk Boulanger,41179,311414,2022-03-21
CASH_IN,196094,Agence_mtn_Ouidah,300000,103906,Sophie-Anouk Boulanger,311414,507508,2022-03-22
CASH_IN,34728,Agence_mtn_Ouidah,300000,265272,Sophie-Anouk Boulanger,507508,542236,2022-03-23
TRANSFER,103387,Sophie-Anouk Boulanger,542236,438849,René de la Delaunay,104670,1283,2022-03-23
CASH_OUT,283113,Sophie-Anouk Boulanger,438849,155736,Agence_mtn_Cotonou,300000,16887,2022-03-24
CASH_IN,258566,Agence_mtn_Ouidah,300000,41434,Sophie-Anouk Boulanger,155736,414302,2022-03-24
CASH_IN,177394,Agence_mtn_Ouidah,300000,122606,Sophie-Anouk Boulanger,414302,591696,2022-03-26
TRANSFER,158285,Sophie-Anouk Boulanger,591696,433411,Roland Huet,228277,69992,2022-03-27
CASH_IN,3557,Agence_mtn_Ouidah,300000,296443,Jacques Le Marion,143648,147205,2022-03-01
TRANSFER,130301,Alfred Paris,221759,91458,Jacques Le Marion,147205,277506,2022-03-01
CASH_OUT,133723,Jacques Le Marion,277506,143783,Agence_mtn_Abomey,300000,166277,2022-03-02
TRANSFER,226642,Sabine Perrier,748145,521503,Jacques Le Marion,143783,370425,2022-03-02
CASH_IN,178625,Agence_mtn_Abomey,300000,121375,Jacques Le Marion,370425,549050,2022-03-03
TRANSFER,496864,Jacques Le Marion,549050,52186,Élise Monnier,851219,354355,2022-03-07
CASH_OUT,44905,Jacques Le Marion,52186,7281,Agence_mtn_Ouidah,300000,255095,2022-03-08
CASH_IN,277791,Agence_mtn_Ouidah,300000,22209,Jacques Le Marion,7281,285072,2022-03-10
CASH_IN,6280,Agence_mtn_Ouidah,300000,293720,Jacques Le Marion,285072,291352,2022-03-10
CASH_IN,217893,Agence_mtn_Abomey,300000,82107,Jacques Le Marion,291352,509245,2022-03-12
CASH_IN,243915,Agence_mtn_Abomey,300000,56085,Jacques Le Marion,509245,753160,2022-03-14
CASH_OUT,361895,Jacques Le Marion,753160,391265,Agence_mtn_Cotonou,300000,-61895,2022-03-15
CASH_OUT,104444,Jacques Le Marion,391265,286821,Agence_mtn_Abomey,300000,195556,2022-03-15
TRANSFER,168304,Jacques Le Marion,286821,118517,Madeleine Hardy,32315,-135989,2022-03-17
CASH_OUT,68947,Jacques Le Marion,118517,49570,Agence_mtn_Abomey,300000,231053,2022-03-17
TRANSFER,11055,Jacques Le Marion,49570,38515,François Vaillant,246623,235568,2022-03-18
CASH_OUT,8360,Jacques Le Marion,38515,30155,Agence_mtn_Ouidah,300000,291640,2022-03-18
TRANSFER,25120,Jacques Le Marion,30155,5035,Maryse Delorme,1139143,1114023,2022-03-24
CASH_IN,32333,Agence_mtn_Abomey,300000,267667,Jacques Le Marion,5035,37368,2022-03-25
CASH_OUT,36545,Jacques Le Marion,37368,823,Agence_mtn_Abomey,300000,263455,2022-03-26
TRANSFER,596,Jacques Le Marion,823,227,Astrid Aubert-Thierry,460350,459754,2022-03-26
TRANSFER,22608,Maryse Delorme,1114023,1091415,Jacques Le Marion,227,22835,2022-03-27
TRANSFER,917343,Marcel de la Buisson,1555767,638424,Jacques Le Marion,22835,940178,2022-03-27
TRANSFER,843940,Marine Labbé,1749000,905060,Édouard Grondin du Fleury,935919,91979,2022-03-02
CASH_IN,83687,Agence_mtn_Abomey,300000,216313,Marine Labbé,905060,988747,2022-03-05
CASH_OUT,912612,Marine Labbé,988747,76135,Agence_mtn_Abomey,300000,-612612,2022-03-06
CASH_OUT,15551,Marine Labbé,76135,60584,Agence_mtn_Ouidah,300000,284449,2022-03-08
CASH_IN,277897,Agence_mtn_Abomey,300000,22103,Marine Labbé,60584,338481,2022-03-11
CASH_OUT,337505,Marine Labbé,338481,976,Agence_mtn_Cotonou,300000,-37505,2022-03-23
CASH_OUT,1073112,Maryse Delorme,1091415,18303,Agence_mtn_Abomey,300000,-773112,2022-03-01
CASH_OUT,6222,Maryse Delorme,18303,12081,Agence_mtn_Cotonou,300000,293778,2022-03-04
TRANSFER,10790,Maryse Delorme,12081,1291,Margaud-Michelle Briand,3085,-7705,2022-03-05
TRANSFER,255,Thibault Martin,8517,8262,Maryse Delorme,1291,1546,2022-03-07
CASH_IN,90739,Agence_mtn_Cotonou,300000,209261,Maryse Delorme,1546,92285,2022-03-13
TRANSFER,12018,Maryse Delorme,92285,80267,Sabine Perrier,521503,509485,2022-03-14
CASH_OUT,25765,Maryse Delorme,80267,54502,Agence_mtn_Abomey,300000,274235,2022-03-14
TRANSFER,28389,Maryse Delorme,54502,26113,Élise Monnier,354355,325966,2022-03-16
TRANSFER,6424,Maryse Delorme,26113,19689,Guy-Augustin Pinto,488405,481981,2022-03-17
TRANSFER,12598,Maryse Delorme,19689,7091,Élise Monnier,325966,313368,2022-03-22
CASH_OUT,6925,Maryse Delorme,7091,166,Agence_mtn_Abomey,300000,293075,2022-03-27
CASH_OUT,63793,Gérard Blot de Blanc,1393047,1329254,Agence_mtn_Abomey,300000,236207,2022-03-01
CASH_IN,265169,Agence_mtn_Cotonou,300000,34831,Gérard Blot de Blanc,1329254,1594423,2022-03-03
TRANSFER,480578,Sabine Perrier,509485,28907,Gérard Blot de Blanc,1594423,2075001,2022-03-06
CASH_OUT,1635621,Gérard Blot de Blanc,2075001,439380,Agence_mtn_Cotonou,300000,-1335621,2022-03-23
CASH_OUT,423883,Gérard Blot de Blanc,439380,15497,Agence_mtn_Cotonou,300000,-123883,2022-03-24
CASH_IN,287963,Agence_mtn_Cotonou,300000,12037,Gérard Blot de Blanc,15497,303460,2022-03-26
CASH_OUT,199334,Gérard Blot de Blanc,303460,104126,Agence_mtn_Cotonou,300000,100666,2022-03-27
CASH_OUT,2934,Roland Huet,69992,67058,Agence_mtn_Abomey,300000,297066,2022-03-02
CASH_IN,59027,Agence_mtn_Ouidah,300000,240973,Roland Huet,67058,126085,2022-03-12
CASH_IN,81544,Agence_mtn_Abomey,300000,218456,Roland Huet,126085,207629,2022-03-15
CASH_OUT,87557,Roland Huet,207629,120072,Agence_mtn_Abomey,300000,212443,2022-03-18
CASH_OUT,30307,Roland Huet,120072,89765,Agence_mtn_Abomey,300000,269693,2022-03-18
TRANSFER,48806,Roland Huet,89765,40959,Sabine Perrier,28907,-19899,2022-03-18
CASH_OUT,34812,Roland Huet,40959,6147,Agence_mtn_Cotonou,300000,265188,2022-03-23
CASH_OUT,46766,Honoré Grégoire-Breton,73898,27132,Agence_mtn_Abomey,300000,253234,2022-03-03
CASH_OUT,22602,Honoré Grégoire-Breton,27132,4530,Agence_mtn_Ouidah,300000,277398,2022-03-04
CASH_IN,68857,Agence_mtn_Ouidah,300000,231143,Honoré Grégoire-Breton,4530,73387,2022-03-06
CASH_IN,46892,Agence_mtn_Abomey,300000,253108,Honoré Grégoire-Breton,73387,120279,2022-03-07
CASH_OUT,49998,Honoré Grégoire-Breton,120279,70281,Agence_mtn_Ouidah,300000,250002,2022-03-10
TRANSFER,59067,Honoré Grégoire-Breton,70281,11214,Charles Guérin,545648,486581,2022-03-13
TRANSFER,416802,Charles Guérin,486581,69779,Honoré Grégoire-Breton,11214,428016,2022-03-22
CASH_IN,229231,Agence_mtn_Ouidah,300000,70769,Honoré Grégoire-Breton,428016,657247,2022-03-24
TRANSFER,34371,Honoré Grégoire-Breton,657247,622876,Nicole-Renée Gay,260,-34111,2022-03-27
CASH_IN,88504,Agence_mtn_Cotonou,300000,211496,Élise Monnier,313368,401872,2022-03-03
CASH_OUT,397127,Élise Monnier,401872,4745,Agence_mtn_Cotonou,300000,-97127,2022-03-04
CASH_OUT,1716,Élise Monnier,4745,3029,Agence_mtn_Cotonou,300000,298284,2022-03-05
TRANSFER,2438,Élise Monnier,3029,591,Nicolas Blin,638764,636326,2022-03-06
TRANSFER,475,Élise Monnier,591,116,Marcel de la Buisson,638424,637949,2022-03-08
CASH_IN,193131,Agence_mtn_Abomey,300000,106869,Élise Monnier,116,193247,2022-03-09
CASH_OUT,159507,Élise Monnier,193247,33740,Agence_mtn_Cotonou,300000,140493,2022-03-14
CASH_IN,250856,Agence_mtn_Abomey,300000,49144,Élise Monnier,33740,284596,2022-03-16
CASH_IN,126551,Agence_mtn_Cotonou,300000,173449,Élise Monnier,284596,411147,2022-03-16
CASH_OUT,368967,Élise Monnier,411147,42180,Agence_mtn_Abomey,300000,-68967,2022-03-17
TRANSFER,38236,Élise Monnier,42180,3944,Madeleine Philippe-Grondin,43246,5010,2022-03-19
TRANSFER,2082,Élise Monnier,3944,1862,Anouk Delahaye-Gimenez,232331,230249,2022-03-21
CASH_IN,152778,Agence_mtn_Abomey,300000,147222,Élise Monnier,1862,154640,2022-03-24
CASH_IN,224503,Agence_mtn_Abomey,300000,75497,Élise Monnier,154640,379143,2022-03-25
CASH_OUT,63572,Élise Monnier,379143,315571,Agence_mtn_Ouidah,300000,236428,2022-03-26
CASH_IN,93606,Agence_mtn_Abomey,300000,206394,Margaud-Michelle Briand,-7705,85901,2022-03-04
TRANSFER,935,René de la Delaunay,1283,348,Margaud-Michelle Briand,85901,86836,2022-03-06
TRANSFER,66264,Margaud-Michelle Briand,86836,20572,Élisabeth Blot-Bruneau,406946,340682,2022-03-06
TRANSFER,183410,Anouk Delahaye-Gimenez,230249,46839,Margaud-Michelle Briand,20572,203982,2022-03-07
CASH_IN,132292,Agence_mtn_Ouidah,300000,167708,Margaud-Michelle Briand,203982,336274,2022-03-10
CASH_IN,87791,Agence_mtn_Ouidah,300000,212209,Margaud-Michelle Briand,336274,424065,2022-03-10
TRANSFER,4198,Madeleine Philippe-Grondin,5010,812,Margaud-Michelle Briand,424065,428263,2022-03-11
CASH_IN,222987,Agence_mtn_Ouidah,300000,77013,Margaud-Michelle Briand,428263,651250,2022-03-16
CASH_OUT,252375,Margaud-Michelle Briand,651250,398875,Agence_mtn_Cotonou,300000,47625,2022-03-20
TRANSFER,2127,Thibault Martin,8262,6135,Margaud-Michelle Briand,398875,401002,2022-03-21
TRANSFER,196704,Margaud-Michelle Briand,401002,204298,Madeleine Philippe-Grondin,812,-195892,2022-03-22
CASH_OUT,56565,Margaud-Michelle Briand,204298,147733,Agence_mtn_Ouidah,300000,243435,2022-03-24
CASH_IN,231736,Agence_mtn_Cotonou,300000,68264,Margaud-Michelle Briand,147733,379469,2022-03-26
TRANSFER,261851,Nicolas Blin,636326,374475,Margaud-Michelle Briand,379469,641320,2022-03-27
CASH_IN,175615,Agence_mtn_Ouidah,300000,124385,Jacques Marchand,1813,177428,2022-03-03
CASH_OUT,42987,Jacques Marchand,177428,134441,Agence_mtn_Ouidah,300000,257013,2022-03-04
TRANSFER,50632,Jacques Marchand,134441,83809,Charles Guérin,69779,19147,2022-03-08
TRANSFER,49505,Jacques Marchand,83809,34304,Robert Henry-Poulain,379226,329721,2022-03-13
TRANSFER,252309,Élisabeth Blot-Bruneau,340682,88373,Jacques Marchand,34304,286613,2022-03-18
CASH_OUT,243830,Jacques Marchand,286613,42783,Agence_mtn_Abomey,300000,56170,2022-03-22
CASH_OUT,29880,Jacques Marchand,42783,12903,Agence_mtn_Cotonou,300000,270120,2022-03-27
CASH_OUT,78915,Élisabeth Blot-Bruneau,88373,9458,Agence_mtn_Abomey,300000,221085,2022-03-02
TRANSFER,2809,Thibault Martin,6135,3326,Élisabeth Blot-Bruneau,9458,12267,2022-03-05
CASH_IN,148218,Agence_mtn_Abomey,300000,151782,Élisabeth Blot-Bruneau,12267,160485,2022-03-06
TRANSFER,82207,Françoise Denis de Allard,145766,63559,Élisabeth Blot-Bruneau,160485,242692,2022-03-07
CASH_OUT,87649,Élisabeth Blot-Bruneau,242692,155043,Agence_mtn_Cotonou,300000,212351,2022-03-10
CASH_IN,245356,Agence_mtn_Ouidah,300000,54644,Élisabeth Blot-Bruneau,155043,400399,2022-03-12
CASH_OUT,351893,Élisabeth Blot-Bruneau,400399,48506,Agence_mtn_Ouidah,300000,-51893,2022-03-15
TRANSFER,16535,François Vaillant,235568,219033,Élisabeth Blot-Bruneau,48506,65041,2022-03-16
CASH_OUT,13273,Élisabeth Blot-Bruneau,65041,51768,Agence_mtn_Cotonou,300000,286727,2022-03-16
CASH_OUT,28677,Élisabeth Blot-Bruneau,51768,23091,Agence_mtn_Ouidah,300000,271323,2022-03-18
CASH_IN,228633,Agence_mtn_Ouidah,300000,71367,Élisabeth Blot-Bruneau,23091,251724,2022-03-19
CASH_IN,290258,Agence_mtn_Ouidah,300000,9742,Élisabeth Blot-Bruneau,251724,541982,2022-03-20
TRANSFER,75744,Élisabeth Blot-Bruneau,541982,466238,Guillaume de la Nguyen,676005,600261,2022-03-21
CASH_IN,107046,Agence_mtn_Cotonou,300000,192954,Élisabeth Blot-Bruneau,466238,573284,2022-03-22
CASH_IN,246368,Agence_mtn_Cotonou,300000,53632,Astrid de Pascal,-12185,234183,2022-03-02
CASH_OUT,172435,Astrid de Pascal,234183,61748,Agence_mtn_Cotonou,300000,127565,2022-03-03
CASH_OUT,49256,Astrid de Pascal,61748,12492,Agence_mtn_Abomey,300000,250744,2022-03-08
CASH_IN,127685,Agence_mtn_Ouidah,300000,172315,Astrid de Pascal,12492,140177,2022-03-12
CASH_IN,199179,Agence_mtn_Cotonou,300000,100821,Astrid de Pascal,140177,339356,2022-03-14
CASH_IN,77251,Agence_mtn_Cotonou,300000,222749,Astrid de Pascal,339356,416607,2022-03-17
TRANSFER,22337,François Vaillant,219033,196696,Astrid de Pascal,416607,438944,2022-03-20
CASH_OUT,248236,Astrid de Pascal,438944,190708,Agence_mtn_Abomey,300000,51764,2022-03-23
CASH_IN,147840,Agence_mtn_Cotonou,300000,152160,Astrid de Pascal,190708,338548,2022-03-25
CASH_IN,6431,Agence_mtn_Abomey,300000,293569,Guillaume de la Nguyen,600261,606692,2022-03-01
TRANSFER,32119,Guillaume de la Nguyen,606692,574573,Guy-Augustin Pinto,481981,449862,2022-03-03
CASH_OUT,36472,Guillaume de la Nguyen,574573,538101,Agence_mtn_Abomey,300000,263528,2022-03-06
CASH_IN,261896,Agence_mtn_Abomey,300000,38104,Guillaume de la Nguyen,538101,799997,2022-03-07
TRANSFER,2288,Thibault Martin,3326,1038,Guillaume de la Nguyen,799997,802285,2022-03-12
CASH_IN,52710,Agence_mtn_Abomey,300000,247290,Guillaume de la Nguyen,802285,854995,2022-03-13
CASH_IN,57548,Agence_mtn_Cotonou,300000,242452,Guillaume de la Nguyen,854995,912543,2022-03-14
TRANSFER,356541,Guillaume de la Nguyen,912543,556002,Marcel de la Buisson,637949,281408,2022-03-15
CASH_IN,58873,Agence_mtn_Cotonou,300000,241127,Guillaume de la Nguyen,556002,614875,2022-03-16
CASH_IN,203854,Agence_mtn_Ouidah,300000,96146,Guillaume de la Nguyen,614875,818729,2022-03-17
CASH_IN,97962,Agence_mtn_Abomey,300000,202038,Guillaume de la Nguyen,818729,916691,2022-03-17
CASH_OUT,733878,Guillaume de la Nguyen,916691,182813,Agence_mtn_Cotonou,300000,-433878,2022-03-17
TRANSFER,38062,Nicolas Blin,374475,336413,Guillaume de la Nguyen,182813,220875,2022-03-18
CASH_IN,201466,Agence_mtn_Ouidah,300000,98534,Guillaume de la Nguyen,220875,422341,2022-03-22
CASH_OUT,400541,Guillaume de la Nguyen,422341,21800,Agence_mtn_Abomey,300000,-100541,2022-03-24
CASH_OUT,14713,Guillaume de la Nguyen,21800,7087,Agence_mtn_Cotonou,300000,285287,2022-03-25
CASH_IN,205135,Agence_mtn_Cotonou,300000,94865,Guillaume de la Nguyen,7087,212222,2022-03-25
CASH_IN,268480,Agence_mtn_Ouidah,300000,31520,Guillaume de la Nguyen,212222,480702,2022-03-27
CASH_IN,133623,Agence_mtn_Abomey,300000,166377,Nicole-Renée Gay,-34111,99512,2022-03-02
CASH_OUT,6958,Nicole-Renée Gay,99512,92554,Agence_mtn_Ouidah,300000,293042,2022-03-02
TRANSFER,40921,Alfred Paris,91458,50537,Nicole-Renée Gay,92554,133475,2022-03-02
TRANSFER,65151,Nicole-Renée Gay,133475,68324,Charles Guérin,19147,-46004,2022-03-02
TRANSFER,17315,Nicole-Renée Gay,68324,51009,Valérie de Pottier,289950,272635,2022-03-03
CASH_OUT,9684,Nicole-Renée Gay,51009,41325,Agence_mtn_Abomey,300000,290316,2022-03-06
CASH_OUT,18355,Nicole-Renée Gay,41325,22970,Agence_mtn_Ouidah,300000,281645,2022-03-08
TRANSFER,305,Thibault Martin,1038,733,Nicole-Renée Gay,22970,23275,2022-03-16
CASH_IN,20324,Agence_mtn_Abomey,300000,279676,Nicole-Renée Gay,23275,43599,2022-03-20
CASH_OUT,12531,Nicole-Renée Gay,43599,31068,Agence_mtn_Ouidah,300000,287469,2022-03-21
CASH_OUT,1762,Nicole-Renée Gay,31068,29306,Agence_mtn_Ouidah,300000,298238,2022-03-22
CASH_OUT,13234,Nicole-Renée Gay,29306,16072,Agence_mtn_Cotonou,300000,286766,2022-03-23
CASH_OUT,2134,Nicole-Renée Gay,16072,13938,Agence_mtn_Cotonou,300000,297866,2022-03-23
CASH_OUT,10514,Nicole-Renée Gay,13938,3424,Agence_mtn_Abomey,300000,289486,2022-03-26
CASH_IN,40035,Agence_mtn_Cotonou,300000,259965,Nicole-Renée Gay,3424,43459,2022-03-26
TRANSFER,29071,Nicole-Renée Gay,43459,14388,Alexandre Delaunay,1259469,1230398,2022-03-26
CASH_IN,93251,Agence_mtn_Ouidah,300000,206749,Simone du Allard,-24137,69114,2022-03-02
CASH_IN,115557,Agence_mtn_Abomey,300000,184443,Simone du Allard,69114,184671,2022-03-06
TRANSFER,108024,Robert Henry-Poulain,329721,221697,Simone du Allard,184671,292695,2022-03-12
CASH_IN,193399,Agence_mtn_Cotonou,300000,106601,Simone du Allard,292695,486094,2022-03-14
CASH_OUT,400827,Simone du Allard,486094,85267,Agence_mtn_Cotonou,300000,-100827,2022-03-14
CASH_OUT,11319,Simone du Allard,85267,73948,Agence_mtn_Abomey,300000,288681,2022-03-24
CASH_OUT,1729,Simone du Allard,73948,72219,Agence_mtn_Ouidah,300000,298271,2022-03-26
CASH_IN,70561,Agence_mtn_Ouidah,300000,229439,Simone du Allard,72219,142780,2022-03-27
CASH_OUT,438958,Astrid Aubert-Thierry,459754,20796,Agence_mtn_Abomey,300000,-138958,2022-03-04
CASH_OUT,10841,Astrid Aubert-Thierry,20796,9955,Agence_mtn_Cotonou,300000,289159,2022-03-05
CASH_IN,153839,Agence_mtn_Ouidah,300000,146161,Astrid Aubert-Thierry,9955,163794,2022-03-05
CASH_OUT,33039,Astrid Aubert-Thierry,163794,130755,Agence_mtn_Cotonou,300000,266961,2022-03-05
CASH_OUT,126644,Astrid Aubert-Thierry,130755,4111,Agence_mtn_Ouidah,300000,173356,2022-03-05
CASH_OUT,3303,Astrid Aubert-Thierry,4111,808,Agence_mtn_Abomey,300000,296697,2022-03-10
CASH_IN,100266,Agence_mtn_Abomey,300000,199734,Astrid Aubert-Thierry,808,101074,2022-03-10
CASH_OUT,52058,Astrid Aubert-Thierry,101074,49016,Agence_mtn_Cotonou,300000,247942,2022-03-14
TRANSFER,41603,Astrid Aubert-Thierry,49016,7413,Guy-Augustin Pinto,449862,408259,2022-03-19
CASH_OUT,4159,Astrid Aubert-Thierry,7413,3254,Agence_mtn_Cotonou,300000,295841,2022-03-19
TRANSFER,127,Astrid Aubert-Thierry,3254,3127,Guy-Augustin Pinto,408259,408132,2022-03-19
CASH_OUT,2733,Astrid Aubert-Thierry,3127,394,Agence_mtn_Cotonou,300000,297267,2022-03-20
TRANSFER,36278,Anouk Delahaye-Gimenez,46839,10561,Astrid Aubert-Thierry,394,36672,2022-03-20
CASH_OUT,23285,Astrid Aubert-Thierry,36672,13387,Agence_mtn_Ouidah,300000,276715,2022-03-24
TRANSFER,769303,Alexandre Delaunay,1230398,461095,Astrid Aubert-Thierry,13387,782690,2022-03-25
CASH_IN,204747,Agence_mtn_Cotonou,300000,95253,Charles Guérin,-46004,158743,2022-03-03
TRANSFER,60930,Gilbert Moulin,244888,183958,Charles Guérin,158743,219673,2022-03-07
CASH_OUT,67839,Charles Guérin,219673,151834,Agence_mtn_Ouidah,300000,232161,2022-03-07
TRANSFER,79502,Robert Henry-Poulain,221697,142195,Charles Guérin,151834,231336,2022-03-09
TRANSFER,149945,Charles Guérin,231336,81391,Valérie de Pottier,272635,122690,2022-03-11
TRANSFER,73068,Charles Guérin,81391,8323,Nicolas Blin,336413,263345,2022-03-12
TRANSFER,194,René de la Delaunay,348,154,Charles Guérin,8323,8517,2022-03-16
CASH_IN,165557,Agence_mtn_Cotonou,300000,134443,Charles Guérin,8517,174074,2022-03-19
TRANSFER,66005,Charles Guérin,174074,108069,Robert Henry-Poulain,142195,76190,2022-03-22
CASH_OUT,6674,Charles Guérin,108069,101395,Agence_mtn_Abomey,300000,293326,2022-03-25
CASH_IN,258564,Agence_mtn_Cotonou,300000,41436,Michelle de la Daniel,-201335,57229,2022-03-01
CASH_IN,178381,Agence_mtn_Abomey,300000,121619,Michelle de la Daniel,57229,235610,2022-03-03
CASH_OUT,132778,Michelle de la Daniel,235610,102832,Agence_mtn_Ouidah,300000,167222,2022-03-04
TRANSFER,13853,Michelle de la Daniel,102832,88979,Nicolas Blin,263345,249492,2022-03-05
TRANSFER,39841,Alfred Paris,50537,10696,Michelle de la Daniel,88979,128820,2022-03-06
CASH_IN,253102,Agence_mtn_Ouidah,300000,46898,Michelle de la Daniel,128820,381922,2022-03-06
CASH_IN,23908,Agence_mtn_Ouidah,300000,276092,Michelle de la Daniel,381922,405830,2022-03-11
CASH_OUT,159221,Michelle de la Daniel,405830,246609,Agence_mtn_Abomey,300000,140779,2022-03-13
CASH_IN,12342,Agence_mtn_Ouidah,300000,287658,Michelle de la Daniel,246609,258951,2022-03-16
TRANSFER,119527,Michelle de la Daniel,258951,139424,Michelle de la Daniel,258951,378478,2022-03-17
CASH_IN,69083,Agence_mtn_Cotonou,300000,230917,Michelle de la Daniel,139424,208507,2022-03-17
CASH_OUT,43140,Michelle de la Daniel,208507,165367,Agence_mtn_Cotonou,300000,256860,2022-03-19
TRANSFER,50735,Michelle de la Daniel,165367,114632,Alfred Paris,10696,-40039,2022-03-19
CASH_OUT,57473,Michelle de la Daniel,114632,57159,Agence_mtn_Abomey,300000,242527,2022-03-21
CASH_IN,80030,Agence_mtn_Ouidah,300000,219970,Michelle de la Daniel,57159,137189,2022-03-21
CASH_OUT,103197,Michelle de la Daniel,137189,33992,Agence_mtn_Ouidah,300000,196803,2022-03-22
TRANSFER,949,Michelle de la Daniel,33992,33043,Anouk Delahaye-Gimenez,10561,9612,2022-03-25
CASH_IN,246059,Agence_mtn_Cotonou,300000,53941,Michelle de la Daniel,33043,279102,2022-03-26
CASH_IN,84409,Agence_mtn_Cotonou,300000,215591,Sabine Perrier,-19899,64510,2022-03-01
CASH_OUT,3768,Sabine Perrier,64510,60742,Agence_mtn_Cotonou,300000,296232,2022-03-06
TRANSFER,27760,Sabine Perrier,60742,32982,Nicolas Blin,249492,221732,2022-03-10
CASH_OUT,31804,Sabine Perrier,32982,1178,Agence_mtn_Cotonou,300000,268196,2022-03-11
CASH_IN,124328,Agence_mtn_Ouidah,300000,175672,Sabine Perrier,1178,125506,2022-03-11
CASH_IN,276063,Agence_mtn_Ouidah,300000,23937,Sabine Perrier,125506,401569,2022-03-15
CASH_IN,113113,Agence_mtn_Cotonou,300000,186887,Sabine Perrier,401569,514682,2022-03-15
CASH_IN,270648,Agence_mtn_Ouidah,300000,29352,Sabine Perrier,514682,785330,2022-03-15
CASH_IN,1609,Agence_mtn_Abomey,300000,298391,Sabine Perrier,785330,786939,2022-03-16
TRANSFER,326432,Sabine Perrier,786939,460507,Charlotte Perrier,48832,-277600,2022-03-16
CASH_IN,281006,Agence_mtn_Abomey,300000,18994,Sabine Perrier,460507,741513,2022-03-19
CASH_IN,52987,Agence_mtn_Abomey,300000,247013,Sabine Perrier,741513,794500,2022-03-21
TRANSFER,183534,Sabine Perrier,794500,610966,François Vaillant,196696,13162,2022-03-22
TRANSFER,53647,Sabine Perrier,610966,557319,Françoise Denis de Allard,63559,9912,2022-03-25
CASH_IN,140604,Agence_mtn_Abomey,300000,159396,Sabine Perrier,557319,697923,2022-03-25
TRANSFER,256027,Guy-Augustin Pinto,408132,152105,Sabine Perrier,697923,953950,2022-03-27
TRANSFER,448,Thibault Martin,733,285,Marcel de la Buisson,281408,281856,2022-03-09
CASH_IN,263998,Agence_mtn_Cotonou,300000,36002,Marcel de la Buisson,281856,545854,2022-03-09
TRANSFER,3939,Françoise Denis de Allard,9912,5973,Marcel de la Buisson,545854,549793,2022-03-10
CASH_IN,47408,Agence_mtn_Abomey,300000,252592,Marcel de la Buisson,549793,597201,2022-03-14
CASH_IN,248304,Agence_mtn_Ouidah,300000,51696,Marcel de la Buisson,597201,845505,2022-03-15
CASH_IN,68157,Agence_mtn_Ouidah,300000,231843,Marcel de la Buisson,845505,913662,2022-03-16
CASH_IN,106063,Agence_mtn_Ouidah,300000,193937,Marcel de la Buisson,913662,1019725,2022-03-20
CASH_OUT,614173,Marcel de la Buisson,1019725,405552,Agence_mtn_Abomey,300000,-314173,2022-03-23
CASH_IN,22212,Agence_mtn_Ouidah,300000,277788,Marcel de la Buisson,405552,427764,2022-03-26
CASH_IN,194010,Agence_mtn_Cotonou,300000,105990,Nathalie-Claire De Oliveira,-31257,162753,2022-03-05
CASH_OUT,61790,Nathalie-Claire De Oliveira,162753,100963,Agence_mtn_Ouidah,300000,238210,2022-03-05
CASH_IN,128241,Agence_mtn_Cotonou,300000,171759,Nathalie-Claire De Oliveira,100963,229204,2022-03-05
CASH_OUT,195929,Nathalie-Claire De Oliveira,229204,33275,Agence_mtn_Abomey,300000,104071,2022-03-07
CASH_IN,35863,Agence_mtn_Cotonou,300000,264137,Nathalie-Claire De Oliveira,33275,69138,2022-03-11
CASH_OUT,40218,Nathalie-Claire De Oliveira,69138,28920,Agence_mtn_Cotonou,300000,259782,2022-03-13
CASH_OUT,27290,Nathalie-Claire De Oliveira,28920,1630,Agence_mtn_Cotonou,300000,272710,2022-03-15
CASH_OUT,1402,Nathalie-Claire De Oliveira,1630,228,Agence_mtn_Abomey,300000,298598,2022-03-20
CASH_IN,26625,Agence_mtn_Cotonou,300000,273375,Nathalie-Claire De Oliveira,228,26853,2022-03-20
CASH_OUT,20455,Nathalie-Claire De Oliveira,26853,6398,Agence_mtn_Ouidah,300000,279545,2022-03-23
TRANSFER,2939,Nathalie-Claire De Oliveira,6398,3459,Nicolas Blin,221732,218793,2022-03-26
CASH_IN,78730,Agence_mtn_Abomey,300000,221270,Raymond Simon,-203307,-124577,2022-03-01
CASH_IN,274035,Agence_mtn_Abomey,300000,25965,Raymond Simon,-124577,149458,2022-03-04
CASH_OUT,98621,Raymond Simon,149458,50837,Agence_mtn_Abomey,300000,201379,2022-03-04
CASH_OUT,8926,Raymond Simon,50837,41911,Agence_mtn_Abomey,300000,291074,2022-03-07
CASH_IN,278400,Agence_mtn_Abomey,300000,21600,Raymond Simon,41911,320311,2022-03-07
TRANSFER,396913,Alexandre Delaunay,461095,64182,Raymond Simon,320311,717224,2022-03-12
TRANSFER,137664,Raymond Simon,717224,579560,René de la Delaunay,154,-137510,2022-03-12
CASH_IN,160817,Agence_mtn_Cotonou,300000,139183,Raymond Simon,579560,740377,2022-03-14
CASH_IN,224588,Agence_mtn_Abomey,300000,75412,Raymond Simon,740377,964965,2022-03-20
TRANSFER,6026,François Vaillant,13162,7136,Raymond Simon,964965,970991,2022-03-21
TRANSFER,123715,Raymond Simon,970991,847276,Robert Henry-Poulain,76190,-47525,2022-03-21
CASH_OUT,133523,Raymond Simon,847276,713753,Agence_mtn_Ouidah,300000,166477,2022-03-22
CASH_IN,288447,Agence_mtn_Ouidah,300000,11553,Raymond Simon,713753,1002200,2022-03-24
CASH_OUT,127342,Raymond Simon,1002200,874858,Agence_mtn_Abomey,300000,172658,2022-03-26
CASH_IN,219295,Agence_mtn_Cotonou,300000,80705,Alfred Paris,-40039,179256,2022-03-03
CASH_IN,4625,Agence_mtn_Cotonou,300000,295375,Alfred Paris,179256,183881,2022-03-03
CASH_OUT,119653,Alfred Paris,183881,64228,Agence_mtn_Cotonou,300000,180347,2022-03-04
TRANSFER,13668,Alfred Paris,64228,50560,Guy-Augustin Pinto,152105,138437,2022-03-05
TRANSFER,27165,Alfred Paris,50560,23395,Édouard Grondin du Fleury,91979,64814,2022-03-06
TRANSFER,111572,Guy-Augustin Pinto,138437,26865,Alfred Paris,23395,134967,2022-03-10
CASH_IN,273470,Agence_mtn_Ouidah,300000,26530,Alfred Paris,134967,408437,2022-03-10
CASH_IN,240878,Agence_mtn_Cotonou,300000,59122,Alfred Paris,408437,649315,2022-03-11
CASH_IN,155354,Agence_mtn_Cotonou,300000,144646,Alfred Paris,649315,804669,2022-03-11
CASH_IN,229246,Agence_mtn_Abomey,300000,70754,Alfred Paris,804669,1033915,2022-03-12
CASH_IN,127118,Agence_mtn_Ouidah,300000,172882,Alfred Paris,1033915,1161033,2022-03-14
CASH_OUT,1040951,Alfred Paris,1161033,120082,Agence_mtn_Abomey,300000,-740951,2022-03-14
CASH_OUT,2485,Alfred Paris,120082,117597,Agence_mtn_Cotonou,300000,297515,2022-03-15
CASH_IN,209238,Agence_mtn_Abomey,300000,90762,Alfred Paris,117597,326835,2022-03-19
TRANSFER,253,Thibault Martin,285,32,Alfred Paris,326835,327088,2022-03-23
TRANSFER,2400,François Vaillant,7136,4736,Alfred Paris,327088,329488,2022-03-24
CASH_OUT,294491,Alfred Paris,329488,34997,Agence_mtn_Abomey,300000,5509,2022-03-24
CASH_OUT,5785,Alfred Paris,34997,29212,Agence_mtn_Cotonou,300000,294215,2022-03-26
TRANSFER,20026,Alfred Paris,29212,9186,Alexandre Delaunay,64182,44156,2022-03-27
CASH_IN,31355,Agence_mtn_Ouidah,300000,268645,Thibault-Julien Chevallier,-47298,-15943,2022-03-02
CASH_IN,116805,Agence_mtn_Cotonou,300000,183195,Thibault-Julien Chevallier,-15943,100862,2022-03-03
TRANSFER,29579,Thibault-Julien Chevallier,100862,71283,Guy-Augustin Pinto,26865,-2714,2022-03-05
TRANSFER,3901,Thibault-Julien Chevallier,71283,67382,Alexandre Delaunay,44156,40255,2022-03-07
CASH_OUT,41842,Thibault-Julien Chevallier,67382,25540,Agence_mtn_Abomey,300000,258158,2022-03-07
CASH_IN,175152,Agence_mtn_Abomey,300000,124848,Thibault-Julien Chevallier,25540,200692,2022-03-09
CASH_IN,229981,Agence_mtn_Ouidah,300000,70019,Thibault-Julien Chevallier,200692,430673,2022-03-12
CASH_IN,268806,Agence_mtn_Abomey,300000,31194,Thibault-Julien Chevallier,430673,699479,2022-03-12
TRANSFER,620396,Thibault-Julien Chevallier,699479,79083,Thibault-Julien Chevallier,699479,79083,2022-03-13
CASH_OUT,71642,Thibault-Julien Chevallier,79083,7441,Agence_mtn_Ouidah,300000,228358,2022-03-16
TRANSFER,3721,Thibault-Julien Chevallier,7441,3720,Thibault-Julien Chevallier,7441,11162,2022-03-18
CASH_OUT,1289,Thibault-Julien Chevallier,3720,2431,Agence_mtn_Abomey,300000,298711,2022-03-19
TRANSFER,27610,Édouard Grondin du Fleury,64814,37204,Thibault-Julien Chevallier,2431,30041,2022-03-20
CASH_IN,268914,Agence_mtn_Cotonou,300000,31086,Thibault-Julien Chevallier,30041,298955,2022-03-20
TRANSFER,3917,Françoise Denis de Allard,5973,2056,Thibault-Julien Chevallier,298955,302872,2022-03-22
TRANSFER,238898,Thibault-Julien Chevallier,302872,63974,Édouard Grondin du Fleury,37204,-201694,2022-03-24
CASH_IN,5440,Agence_mtn_Ouidah,300000,294560,Thibault-Julien Chevallier,63974,69414,2022-03-24
TRANSFER,14475,Thibault-Julien Chevallier,69414,54939,Christophe Teixeira,1215223,1200748,2022-03-25
CASH_OUT,20344,Thibault-Julien Chevallier,54939,34595,Agence_mtn_Ouidah,300000,279656,2022-03-26
CASH_IN,184775,Agence_mtn_Ouidah,300000,115225,Charlotte Perrier,-277600,-92825,2022-03-03
CASH_IN,59458,Agence_mtn_Cotonou,300000,240542,Charlotte Perrier,-92825,-33367,2022-03-04
CASH_IN,150014,Agence_mtn_Abomey,300000,149986,Charlotte Perrier,-33367,116647,2022-03-05
CASH_OUT,95395,Charlotte Perrier,116647,21252,Agence_mtn_Ouidah,300000,204605,2022-03-07
CASH_OUT,13759,Charlotte Perrier,21252,7493,Agence_mtn_Abomey,300000,286241,2022-03-10
CASH_OUT,6972,Charlotte Perrier,7493,521,Agence_mtn_Ouidah,300000,293028,2022-03-11
CASH_IN,259081,Agence_mtn_Abomey,300000,40919,Charlotte Perrier,521,259602,2022-03-13
CASH_IN,192196,Agence_mtn_Abomey,300000,107804,Charlotte Perrier,259602,451798,2022-03-15
TRANSFER,1002487,Christophe Teixeira,1200748,198261,Charlotte Perrier,451798,1454285,2022-03-17
TRANSFER,44822,Christophe Teixeira,198261,153439,Charlotte Perrier,1454285,1499107,2022-03-17
TRANSFER,1417139,Charlotte Perrier,1499107,81968,Alexandre Delaunay,40255,-1376884,2022-03-17
CASH_IN,115544,Agence_mtn_Cotonou,300000,184456,Charlotte Perrier,81968,197512,2022-03-19
CASH_IN,126174,Agence_mtn_Abomey,300000,173826,Charlotte Perrier,197512,323686,2022-03-20
CASH_IN,44861,Agence_mtn_Cotonou,300000,255139,Charlotte Perrier,323686,368547,2022-03-21
TRANSFER,152194,Charlotte Perrier,368547,216353,Christophe Teixeira,153439,1245,2022-03-21
CASH_OUT,133383,Charlotte Perrier,216353,82970,Agence_mtn_Abomey,300000,166617,2022-03-23
TRANSFER,28798,Charlotte Perrier,82970,54172,Charlotte Perrier,82970,54172,2022-03-24
CASH_OUT,30818,Charlotte Perrier,54172,23354,Agence_mtn_Abomey,300000,269182,2022-03-24
CASH_IN,172988,Agence_mtn_Abomey,300000,127012,Charlotte Perrier,23354,196342,2022-03-26
CASH_OUT,102762,Charlotte Perrier,196342,93580,Agence_mtn_Cotonou,300000,197238,2022-03-27
CASH_IN,205760,Agence_mtn_Abomey,300000,94240,Corinne Roussel,-301103,-95343,2022-03-07
CASH_IN,226682,Agence_mtn_Ouidah,300000,73318,Corinne Roussel,-95343,131339,2022-03-13
TRANSFER,100113,Corinne Roussel,131339,31226,Gilbert Moulin,183958,83845,2022-03-19
CASH_OUT,3525,Corinne Roussel,31226,27701,Agence_mtn_Abomey,300000,296475,2022-03-21
CASH_OUT,16431,Corinne Roussel,27701,11270,Agence_mtn_Ouidah,300000,283569,2022-03-24
CASH_OUT,6431,Corinne Roussel,11270,4839,Agence_mtn_Abomey,300000,293569,2022-03-26
CASH_OUT,203,Corinne Roussel,4839,4636,Agence_mtn_Cotonou,300000,299797,2022-03-26
CASH_IN,195766,Agence_mtn_Abomey,300000,104234,Élisabeth Delattre,-761336,-565570,2022-03-01
CASH_IN,232705,Agence_mtn_Cotonou,300000,67295,Élisabeth Delattre,-565570,-332865,2022-03-02
CASH_IN,225815,Agence_mtn_Cotonou,300000,74185,Élisabeth Delattre,-332865,-107050,2022-03-06
CASH_IN,266809,Agence_mtn_Abomey,300000,33191,Élisabeth Delattre,-107050,159759,2022-03-07
TRANSFER,20264,Nicolas Blin,218793,198529,Élisabeth Delattre,159759,180023,2022-03-08
CASH_IN,291136,Agence_mtn_Ouidah,300000,8864,Élisabeth Delattre,180023,471159,2022-03-14
CASH_IN,238611,Agence_mtn_Ouidah,300000,61389,Élisabeth Delattre,471159,709770,2022-03-16
CASH_OUT,515653,Élisabeth Delattre,709770,194117,Agence_mtn_Abomey,300000,-215653,2022-03-18
CASH_OUT,53478,Élisabeth Delattre,194117,140639,Agence_mtn_Cotonou,300000,246522,2022-03-18
CASH_IN,256002,Agence_mtn_Abomey,300000,43998,Élisabeth Delattre,140639,396641,2022-03-18
CASH_IN,266762,Agence_mtn_Cotonou,300000,33238,Élisabeth Delattre,396641,663403,2022-03-19
CASH_OUT,138153,Élisabeth Delattre,663403,525250,Agence_mtn_Abomey,300000,161847,2022-03-21
CASH_IN,56139,Agence_mtn_Ouidah,300000,243861,Clémence-Alice Ruiz,-180588,-124449,2022-03-02
CASH_IN,116272,Agence_mtn_Abomey,300000,183728,Clémence-Alice Ruiz,-124449,-8177,2022-03-02
CASH_IN,120390,Agence_mtn_Ouidah,300000,179610,Clémence-Alice Ruiz,-8177,112213,2022-03-02
CASH_IN,92345,Agence_mtn_Ouidah,300000,207655,Clémence-Alice Ruiz,112213,204558,2022-03-04
CASH_OUT,65425,Clémence-Alice Ruiz,204558,139133,Agence_mtn_Ouidah,300000,234575,2022-03-05
CASH_IN,239417,Agence_mtn_Cotonou,300000,60583,Clémence-Alice Ruiz,139133,378550,2022-03-06
CASH_OUT,12974,Clémence-Alice Ruiz,378550,365576,Agence_mtn_Ouidah,300000,287026,2022-03-12
CASH_OUT,174086,Clémence-Alice Ruiz,365576,191490,Agence_mtn_Ouidah,300000,125914,2022-03-13
CASH_IN,76984,Agence_mtn_Abomey,300000,223016,Clémence-Alice Ruiz,191490,268474,2022-03-15
CASH_OUT,225216,Clémence-Alice Ruiz,268474,43258,Agence_mtn_Cotonou,300000,74784,2022-03-18
CASH_IN,104888,Agence_mtn_Ouidah,300000,195112,Clémence-Alice Ruiz,43258,148146,2022-03-25
CASH_OUT,62360,Clémence-Alice Ruiz,148146,85786,Agence_mtn_Cotonou,300000,237640,2022-03-26
TRANSFER,7431,Gilbert Moulin,83845,76414,Anouk Delahaye-Gimenez,9612,2181,2022-03-02
CASH_IN,172968,Agence_mtn_Cotonou,300000,127032,Gilbert Moulin,76414,249382,2022-03-04
TRANSFER,175,Christophe Teixeira,1245,1070,Gilbert Moulin,249382,249557,2022-03-07
CASH_IN,260942,Agence_mtn_Ouidah,300000,39058,Gilbert Moulin,249557,510499,2022-03-08
CASH_IN,59610,Agence_mtn_Ouidah,300000,240390,Gilbert Moulin,510499,570109,2022-03-10
CASH_OUT,216480,Gilbert Moulin,570109,353629,Agence_mtn_Abomey,300000,83520,2022-03-10
CASH_OUT,37991,Gilbert Moulin,353629,315638,Agence_mtn_Abomey,300000,262009,2022-03-12
CASH_IN,12831,Agence_mtn_Ouidah,300000,287169,Gilbert Moulin,315638,328469,2022-03-13
CASH_IN,287904,Agence_mtn_Cotonou,300000,12096,Gilbert Moulin,328469,616373,2022-03-16
CASH_IN,247868,Agence_mtn_Abomey,300000,52132,Gilbert Moulin,616373,864241,2022-03-17
TRANSFER,2000,Françoise Denis de Allard,2056,56,Gilbert Moulin,864241,866241,2022-03-18
CASH_IN,184899,Agence_mtn_Ouidah,300000,115101,Gilbert Moulin,866241,1051140,2022-03-19
CASH_OUT,563937,Gilbert Moulin,1051140,487203,Agence_mtn_Cotonou,300000,-263937,2022-03-19
CASH_IN,65469,Agence_mtn_Abomey,300000,234531,Gilbert Moulin,487203,552672,2022-03-26
CASH_IN,238783,Agence_mtn_Ouidah,300000,61217,Gilbert Moulin,552672,791455,2022-03-26
CASH_IN,92201,Agence_mtn_Abomey,300000,207799,Louis du Boyer,-24651,67550,2022-03-01
CASH_IN,265626,Agence_mtn_Ouidah,300000,34374,Louis du Boyer,67550,333176,2022-03-02
TRANSFER,41358,Louis du Boyer,333176,291818,Anouk Delahaye-Gimenez,2181,-39177,2022-03-03
CASH_IN,88416,Agence_mtn_Cotonou,300000,211584,Louis du Boyer,291818,380234,2022-03-05
TRANSFER,854,Christophe Teixeira,1070,216,Louis du Boyer,380234,381088,2022-03-07
CASH_IN,294829,Agence_mtn_Abomey,300000,5171,Louis du Boyer,381088,675917,2022-03-08
TRANSFER,136515,Louis du Boyer,675917,539402,François Vaillant,4736,-131779,2022-03-17
CASH_IN,185893,Agence_mtn_Cotonou,300000,114107,Louis du Boyer,539402,725295,2022-03-21
TRANSFER,146066,Louis du Boyer,725295,579229,Christophe Teixeira,216,-145850,2022-03-24
CASH_IN,216004,Agence_mtn_Ouidah,300000,83996,Louis du Boyer,579229,795233,2022-03-26
CASH_IN,62871,Agence_mtn_Cotonou,300000,237129,Christophe Besnard-Diaz,-469889,-407018,2022-03-03
CASH_IN,51661,Agence_mtn_Ouidah,300000,248339,Christophe Besnard-Diaz,-407018,-355357,2022-03-04
CASH_IN,67824,Agence_mtn_Abomey,300000,232176,Christophe Besnard-Diaz,-355357,-287533,2022-03-05
CASH_IN,141803,Agence_mtn_Ouidah,300000,158197,Christophe Besnard-Diaz,-287533,-145730,2022-03-08
CASH_IN,299661,Agence_mtn_Cotonou,300000,339,Christophe Besnard-Diaz,-145730,153931,2022-03-08
CASH_OUT,41382,Christophe Besnard-Diaz,153931,112549,Agence_mtn_Ouidah,300000,258618,2022-03-10
CASH_IN,293324,Agence_mtn_Cotonou,300000,6676,Christophe Besnard-Diaz,112549,405873,2022-03-12
CASH_OUT,36207,Christophe Besnard-Diaz,405873,369666,Agence_mtn_Abomey,300000,263793,2022-03-13
TRANSFER,46379,Christophe Besnard-Diaz,369666,323287,Christophe Besnard-Diaz,369666,323287,2022-03-14
CASH_OUT,59846,Christophe Besnard-Diaz,323287,263441,Agence_mtn_Cotonou,300000,240154,2022-03-15
TRANSFER,166729,Christophe Besnard-Diaz,263441,96712,Christophe Besnard-Diaz,263441,430170,2022-03-15
TRANSFER,41000,Christophe Besnard-Diaz,96712,55712,Christophe Besnard-Diaz,96712,55712,2022-03-17
TRANSFER,21990,Christophe Besnard-Diaz,55712,33722,Christophe Besnard-Diaz,55712,77702,2022-03-18
CASH_IN,198872,Agence_mtn_Ouidah,300000,101128,Christophe Besnard-Diaz,33722,232594,2022-03-20
CASH_OUT,72304,Christophe Besnard-Diaz,232594,160290,Agence_mtn_Ouidah,300000,227696,2022-03-20
CASH_IN,32629,Agence_mtn_Abomey,300000,267371,Christophe Besnard-Diaz,160290,192919,2022-03-23
CASH_IN,17318,Agence_mtn_Ouidah,300000,282682,Robert Henry-Poulain,-47525,-30207,2022-03-07
CASH_IN,68946,Agence_mtn_Ouidah,300000,231054,Robert Henry-Poulain,-30207,38739,2022-03-08
CASH_IN,52443,Agence_mtn_Cotonou,300000,247557,Robert Henry-Poulain,38739,91182,2022-03-08
CASH_IN,117841,Agence_mtn_Cotonou,300000,182159,Robert Henry-Poulain,91182,209023,2022-03-10
CASH_OUT,175803,Robert Henry-Poulain,209023,33220,Agence_mtn_Cotonou,300000,124197,2022-03-11
CASH_IN,293872,Agence_mtn_Cotonou,300000,6128,Robert Henry-Poulain,33220,327092,2022-03-11
CASH_IN,46220,Agence_mtn_Cotonou,300000,253780,Robert Henry-Poulain,327092,373312,2022-03-15
CASH_OUT,95293,Robert Henry-Poulain,373312,278019,Agence_mtn_Cotonou,300000,204707,2022-03-16
CASH_OUT,215311,Robert Henry-Poulain,278019,62708,Agence_mtn_Cotonou,300000,84689,2022-03-17
CASH_OUT,9513,Robert Henry-Poulain,62708,53195,Agence_mtn_Cotonou,300000,290487,2022-03-17
CASH_OUT,43629,Robert Henry-Poulain,53195,9566,Agence_mtn_Cotonou,300000,256371,2022-03-19
CASH_OUT,4615,Robert Henry-Poulain,9566,4951,Agence_mtn_Abomey,300000,295385,2022-03-19
CASH_IN,249866,Agence_mtn_Ouidah,300000,50134,Robert Henry-Poulain,4951,254817,2022-03-21
CASH_OUT,122113,Robert Henry-Poulain,254817,132704,Agence_mtn_Cotonou,300000,177887,2022-03-23
CASH_OUT,106385,Robert Henry-Poulain,132704,26319,Agence_mtn_Abomey,300000,193615,2022-03-23
CASH_OUT,9203,Robert Henry-Poulain,26319,17116,Agence_mtn_Abomey,300000,290797,2022-03-27
CASH_IN,112457,Agence_mtn_Ouidah,300000,187543,Hélène Blanchard-Renault,-70999,41458,2022-03-05
CASH_IN,187467,Agence_mtn_Cotonou,300000,112533,Hélène Blanchard-Renault,41458,228925,2022-03-06
CASH_IN,177331,Agence_mtn_Cotonou,300000,122669,Hélène Blanchard-Renault,228925,406256,2022-03-11
CASH_OUT,54393,Hélène Blanchard-Renault,406256,351863,Agence_mtn_Ouidah,300000,245607,2022-03-13
TRANSFER,231415,Hélène Blanchard-Renault,351863,120448,Hélène Blanchard-Renault,351863,120448,2022-03-14
TRANSFER,68901,Hélène Blanchard-Renault,120448,51547,Hélène Blanchard-Renault,120448,189349,2022-03-16
CASH_IN,76300,Agence_mtn_Ouidah,300000,223700,Hélène Blanchard-Renault,51547,127847,2022-03-17
CASH_OUT,33897,Hélène Blanchard-Renault,127847,93950,Agence_mtn_Ouidah,300000,266103,2022-03-18
TRANSFER,52949,Hélène Blanchard-Renault,93950,41001,Hélène Blanchard-Renault,93950,146899,2022-03-19
CASH_IN,287644,Agence_mtn_Abomey,300000,12356,Hélène Blanchard-Renault,41001,328645,2022-03-21
CASH_IN,200768,Agence_mtn_Cotonou,300000,99232,Hélène Blanchard-Renault,328645,529413,2022-03-22
CASH_OUT,523795,Hélène Blanchard-Renault,529413,5618,Agence_mtn_Abomey,300000,-223795,2022-03-23
CASH_IN,182497,Agence_mtn_Abomey,300000,117503,Éléonore Marin Le Morel,-709383,-526886,2022-03-03
CASH_IN,43238,Agence_mtn_Cotonou,300000,256762,Éléonore Marin Le Morel,-526886,-483648,2022-03-03
CASH_IN,120759,Agence_mtn_Ouidah,300000,179241,Éléonore Marin Le Morel,-483648,-362889,2022-03-05
CASH_IN,113398,Agence_mtn_Ouidah,300000,186602,Éléonore Marin Le Morel,-362889,-249491,2022-03-08
CASH_IN,265442,Agence_mtn_Ouidah,300000,34558,Éléonore Marin Le Morel,-249491,15951,2022-03-12
CASH_OUT,8921,Éléonore Marin Le Morel,15951,7030,Agence_mtn_Cotonou,300000,291079,2022-03-12
CASH_OUT,2540,Éléonore Marin Le Morel,7030,4490,Agence_mtn_Ouidah,300000,297460,2022-03-15
CASH_OUT,837,Éléonore Marin Le Morel,4490,3653,Agence_mtn_Ouidah,300000,299163,2022-03-16
TRANSFER,1767,Éléonore Marin Le Morel,3653,1886,Éléonore Marin Le Morel,3653,1886,2022-03-19
CASH_IN,185079,Agence_mtn_Ouidah,300000,114921,Éléonore Marin Le Morel,1886,186965,2022-03-19
CASH_IN,120015,Agence_mtn_Cotonou,300000,179985,Éléonore Marin Le Morel,186965,306980,2022-03-20
CASH_IN,71637,Agence_mtn_Abomey,300000,228363,Éléonore Marin Le Morel,306980,378617,2022-03-27
CASH_IN,8305,Agence_mtn_Abomey,300000,291695,Alexandre Delaunay,-1376884,-1368579,2022-03-02
CASH_IN,17967,Agence_mtn_Abomey,300000,282033,Alexandre Delaunay,-1368579,-1350612,2022-03-03
CASH_IN,155116,Agence_mtn_Ouidah,300000,144884,Alexandre Delaunay,-1350612,-1195496,2022-03-04
CASH_IN,216567,Agence_mtn_Cotonou,300000,83433,Alexandre Delaunay,-1195496,-978929,2022-03-05
CASH_IN,280929,Agence_mtn_Ouidah,300000,19071,Alexandre Delaunay,-978929,-698000,2022-03-11
CASH_IN,138771,Agence_mtn_Ouidah,300000,161229,Alexandre Delaunay,-698000,-559229,2022-03-12
CASH_IN,209281,Agence_mtn_Cotonou,300000,90719,Alexandre Delaunay,-559229,-349948,2022-03-15
CASH_IN,293060,Agence_mtn_Abomey,300000,6940,Alexandre Delaunay,-349948,-56888,2022-03-21
CASH_IN,27211,Agence_mtn_Ouidah,300000,272789,Alexandre Delaunay,-56888,-29677,2022-03-23
CASH_IN,259742,Agence_mtn_Cotonou,300000,40258,Alexandre Delaunay,-29677,230065,2022-03-24
CASH_IN,118296,Agence_mtn_Abomey,300000,181704,Alexandre Delaunay,230065,348361,2022-03-27
CASH_IN,172809,Agence_mtn_Abomey,300000,127191,Anouk Delahaye-Gimenez,-39177,133632,2022-03-01
TRANSFER,102855,Anouk Delahaye-Gimenez,133632,30777,Anouk Delahaye-Gimenez,133632,236487,2022-03-02
CASH_IN,28037,Agence_mtn_Ouidah,300000,271963,Anouk Delahaye-Gimenez,30777,58814,2022-03-08
CASH_IN,11193,Agence_mtn_Ouidah,300000,288807,Anouk Delahaye-Gimenez,58814,70007,2022-03-08
CASH_IN,74022,Agence_mtn_Abomey,300000,225978,Anouk Delahaye-Gimenez,70007,144029,2022-03-10
TRANSFER,56784,Anouk Delahaye-Gimenez,144029,87245,Anouk Delahaye-Gimenez,144029,200813,2022-03-14
CASH_OUT,54888,Anouk Delahaye-Gimenez,87245,32357,Agence_mtn_Cotonou,300000,245112,2022-03-20
CASH_OUT,5132,Anouk Delahaye-Gimenez,32357,27225,Agence_mtn_Ouidah,300000,294868,2022-03-21
CASH_OUT,26831,Anouk Delahaye-Gimenez,27225,394,Agence_mtn_Cotonou,300000,273169,2022-03-21
CASH_OUT,163,Anouk Delahaye-Gimenez,394,231,Agence_mtn_Abomey,300000,299837,2022-03-22
CASH_OUT,128,Anouk Delahaye-Gimenez,231,103,Agence_mtn_Cotonou,300000,299872,2022-03-23
CASH_IN,214685,Agence_mtn_Ouidah,300000,85315,Anouk Delahaye-Gimenez,103,214788,2022-03-25
CASH_IN,87226,Agence_mtn_Ouidah,300000,212774,Anouk Delahaye-Gimenez,214788,302014,2022-03-27
CASH_IN,237984,Agence_mtn_Cotonou,300000,62016,Madeleine Philippe-Grondin,-195892,42092,2022-03-01
CASH_IN,10753,Agence_mtn_Abomey,300000,289247,Madeleine Philippe-Grondin,42092,52845,2022-03-01
TRANSFER,46586,Madeleine Philippe-Grondin,52845,6259,Madeleine Philippe-Grondin,52845,6259,2022-03-02
TRANSFER,5061,Madeleine Philippe-Grondin,6259,1198,Madeleine Philippe-Grondin,6259,11320,2022-03-02
CASH_IN,51193,Agence_mtn_Abomey,300000,248807,Madeleine Philippe-Grondin,1198,52391,2022-03-04
CASH_OUT,47434,Madeleine Philippe-Grondin,52391,4957,Agence_mtn_Ouidah,300000,252566,2022-03-10
CASH_IN,175382,Agence_mtn_Cotonou,300000,124618,Madeleine Philippe-Grondin,4957,180339,2022-03-13
CASH_OUT,87692,Madeleine Philippe-Grondin,180339,92647,Agence_mtn_Abomey,300000,212308,2022-03-13
TRANSFER,81197,Madeleine Philippe-Grondin,92647,11450,Madeleine Philippe-Grondin,92647,11450,2022-03-13
TRANSFER,679,Madeleine Philippe-Grondin,11450,10771,Madeleine Philippe-Grondin,11450,10771,2022-03-13
CASH_IN,207437,Agence_mtn_Cotonou,300000,92563,Madeleine Philippe-Grondin,10771,218208,2022-03-15
CASH_IN,274528,Agence_mtn_Ouidah,300000,25472,Madeleine Philippe-Grondin,218208,492736,2022-03-16
CASH_OUT,410278,Madeleine Philippe-Grondin,492736,82458,Agence_mtn_Ouidah,300000,-110278,2022-03-19
CASH_IN,268413,Agence_mtn_Cotonou,300000,31587,Madeleine Philippe-Grondin,82458,350871,2022-03-20
CASH_IN,142332,Agence_mtn_Cotonou,300000,157668,Madeleine Philippe-Grondin,350871,493203,2022-03-22
CASH_IN,3993,Agence_mtn_Cotonou,300000,296007,Pénélope Boulay,-1321814,-1317821,2022-03-01
CASH_IN,62986,Agence_mtn_Abomey,300000,237014,Pénélope Boulay,-1317821,-1254835,2022-03-03
CASH_IN,117126,Agence_mtn_Ouidah,300000,182874,Pénélope Boulay,-1254835,-1137709,2022-03-03
CASH_IN,190151,Agence_mtn_Cotonou,300000,109849,Pénélope Boulay,-1137709,-947558,2022-03-10
CASH_IN,228569,Agence_mtn_Abomey,300000,71431,Pénélope Boulay,-947558,-718989,2022-03-11
CASH_IN,113912,Agence_mtn_Abomey,300000,186088,Pénélope Boulay,-718989,-605077,2022-03-12
CASH_IN,227631,Agence_mtn_Ouidah,300000,72369,Pénélope Boulay,-605077,-377446,2022-03-12
CASH_IN,81868,Agence_mtn_Abomey,300000,218132,Pénélope Boulay,-377446,-295578,2022-03-13
CASH_IN,161856,Agence_mtn_Ouidah,300000,138144,Pénélope Boulay,-295578,-133722,2022-03-14
CASH_IN,258524,Agence_mtn_Ouidah,300000,41476,Pénélope Boulay,-133722,124802,2022-03-15
CASH_IN,56001,Agence_mtn_Ouidah,300000,243999,Pénélope Boulay,124802,180803,2022-03-18
CASH_OUT,830,Pénélope Boulay,180803,179973,Agence_mtn_Abomey,300000,299170,2022-03-18
TRANSFER,140850,Pénélope Boulay,179973,39123,Pénélope Boulay,179973,320823,2022-03-21
CASH_OUT,7207,Pénélope Boulay,39123,31916,Agence_mtn_Cotonou,300000,292793,2022-03-23
TRANSFER,17740,Pénélope Boulay,31916,14176,Pénélope Boulay,31916,14176,2022-03-23
TRANSFER,7648,Pénélope Boulay,14176,6528,Pénélope Boulay,14176,21824,2022-03-24
CASH_IN,168694,Agence_mtn_Cotonou,300000,131306,Pénélope Boulay,6528,175222,2022-03-25
CASH_OUT,84877,Pénélope Boulay,175222,90345,Agence_mtn_Ouidah,300000,215123,2022-03-26
CASH_IN,55697,Agence_mtn_Cotonou,300000,244303,René de la Delaunay,-137510,-81813,2022-03-01
CASH_IN,34378,Agence_mtn_Ouidah,300000,265622,René de la Delaunay,-81813,-47435,2022-03-02
CASH_IN,228208,Agence_mtn_Abomey,300000,71792,René de la Delaunay,-47435,180773,2022-03-02
CASH_IN,235356,Agence_mtn_Ouidah,300000,64644,René de la Delaunay,180773,416129,2022-03-04
TRANSFER,175807,René de la Delaunay,416129,240322,René de la Delaunay,416129,240322,2022-03-08
CASH_IN,249538,Agence_mtn_Abomey,300000,50462,René de la Delaunay,240322,489860,2022-03-10
CASH_OUT,211098,René de la Delaunay,489860,278762,Agence_mtn_Abomey,300000,88902,2022-03-12
CASH_IN,255058,Agence_mtn_Ouidah,300000,44942,René de la Delaunay,278762,533820,2022-03-12
CASH_IN,131418,Agence_mtn_Cotonou,300000,168582,René de la Delaunay,533820,665238,2022-03-15
TRANSFER,167642,René de la Delaunay,665238,497596,René de la Delaunay,665238,497596,2022-03-16
CASH_IN,130265,Agence_mtn_Cotonou,300000,169735,René de la Delaunay,497596,627861,2022-03-16
CASH_IN,295717,Agence_mtn_Abomey,300000,4283,René de la Delaunay,627861,923578,2022-03-18
CASH_IN,100616,Agence_mtn_Ouidah,300000,199384,René de la Delaunay,923578,1024194,2022-03-22
CASH_OUT,636439,René de la Delaunay,1024194,387755,Agence_mtn_Ouidah,300000,-336439,2022-03-22
CASH_OUT,170007,René de la Delaunay,387755,217748,Agence_mtn_Cotonou,300000,129993,2022-03-23
CASH_IN,162772,Agence_mtn_Ouidah,300000,137228,René de la Delaunay,217748,380520,2022-03-25
CASH_IN,209768,Agence_mtn_Abomey,300000,90232,René de la Delaunay,380520,590288,2022-03-25
CASH_IN,98794,Agence_mtn_Cotonou,300000,201206,Thibault Martin,32,98826,2022-03-01
TRANSFER,94818,Thibault Martin,98826,4008,Thibault Martin,98826,193644,2022-03-06
CASH_IN,73752,Agence_mtn_Cotonou,300000,226248,Thibault Martin,4008,77760,2022-03-09
CASH_IN,48113,Agence_mtn_Cotonou,300000,251887,Thibault Martin,77760,125873,2022-03-13
CASH_OUT,95458,Thibault Martin,125873,30415,Agence_mtn_Ouidah,300000,204542,2022-03-13
CASH_OUT,8836,Thibault Martin,30415,21579,Agence_mtn_Ouidah,300000,291164,2022-03-15
CASH_OUT,12468,Thibault Martin,21579,9111,Agence_mtn_Abomey,300000,287532,2022-03-17
CASH_OUT,4971,Thibault Martin,9111,4140,Agence_mtn_Ouidah,300000,295029,2022-03-25
CASH_IN,33290,Agence_mtn_Abomey,300000,266710,Thibault Martin,4140,37430,2022-03-26
CASH_IN,101889,Agence_mtn_Cotonou,300000,198111,Guy-Augustin Pinto,-2714,99175,2022-03-04
TRANSFER,62112,Guy-Augustin Pinto,99175,37063,Guy-Augustin Pinto,99175,37063,2022-03-07
CASH_IN,156970,Agence_mtn_Cotonou,300000,143030,Guy-Augustin Pinto,37063,194033,2022-03-09
CASH_IN,70351,Agence_mtn_Ouidah,300000,229649,Guy-Augustin Pinto,194033,264384,2022-03-11
CASH_OUT,107995,Guy-Augustin Pinto,264384,156389,Agence_mtn_Cotonou,300000,192005,2022-03-11
CASH_OUT,6204,Guy-Augustin Pinto,156389,150185,Agence_mtn_Cotonou,300000,293796,2022-03-14
CASH_IN,268052,Agence_mtn_Ouidah,300000,31948,Guy-Augustin Pinto,150185,418237,2022-03-17
CASH_IN,24528,Agence_mtn_Cotonou,300000,275472,Guy-Augustin Pinto,418237,442765,2022-03-19
CASH_OUT,61577,Guy-Augustin Pinto,442765,381188,Agence_mtn_Cotonou,300000,238423,2022-03-20
CASH_IN,283907,Agence_mtn_Cotonou,300000,16093,Guy-Augustin Pinto,381188,665095,2022-03-21
CASH_OUT,604546,Guy-Augustin Pinto,665095,60549,Agence_mtn_Abomey,300000,-304546,2022-03-21
CASH_IN,111124,Agence_mtn_Ouidah,300000,188876,Françoise Denis de Allard,56,111180,2022-03-02
CASH_IN,254465,Agence_mtn_Cotonou,300000,45535,Françoise Denis de Allard,111180,365645,2022-03-02
TRANSFER,235035,Françoise Denis de Allard,365645,130610,Françoise Denis de Allard,365645,130610,2022-03-02
CASH_IN,200721,Agence_mtn_Cotonou,300000,99279,Françoise Denis de Allard,130610,331331,2022-03-02
TRANSFER,219176,Françoise Denis de Allard,331331,112155,Françoise Denis de Allard,331331,112155,2022-03-04
CASH_OUT,19498,Françoise Denis de Allard,112155,92657,Agence_mtn_Cotonou,300000,280502,2022-03-05
CASH_IN,143394,Agence_mtn_Abomey,300000,156606,Françoise Denis de Allard,92657,236051,2022-03-05
CASH_IN,31973,Agence_mtn_Abomey,300000,268027,Françoise Denis de Allard,236051,268024,2022-03-06
CASH_IN,274693,Agence_mtn_Abomey,300000,25307,Françoise Denis de Allard,268024,542717,2022-03-07
CASH_OUT,344057,Françoise Denis de Allard,542717,198660,Agence_mtn_Cotonou,300000,-44057,2022-03-08
CASH_OUT,129457,Françoise Denis de Allard,198660,69203,Agence_mtn_Abomey,300000,170543,2022-03-14
CASH_OUT,31249,Françoise Denis de Allard,69203,37954,Agence_mtn_Cotonou,300000,268751,2022-03-23
CASH_IN,34163,Agence_mtn_Abomey,300000,265837,Françoise Denis de Allard,37954,72117,2022-03-27
CASH_IN,73520,Agence_mtn_Ouidah,300000,226480,François Vaillant,-131779,-58259,2022-03-01
CASH_IN,245515,Agence_mtn_Ouidah,300000,54485,François Vaillant,-58259,187256,2022-03-04
CASH_IN,22840,Agence_mtn_Abomey,300000,277160,François Vaillant,187256,210096,2022-03-10
TRANSFER,200933,François Vaillant,210096,9163,François Vaillant,210096,411029,2022-03-11
CASH_IN,237250,Agence_mtn_Abomey,300000,62750,François Vaillant,9163,246413,2022-03-14
CASH_IN,186425,Agence_mtn_Cotonou,300000,113575,François Vaillant,246413,432838,2022-03-21
CASH_OUT,391203,François Vaillant,432838,41635,Agence_mtn_Cotonou,300000,-91203,2022-03-22
CASH_OUT,17331,François Vaillant,41635,24304,Agence_mtn_Cotonou,300000,282669,2022-03-26
CASH_IN,8655,Agence_mtn_Ouidah,300000,291345,Madeleine Hardy,-135989,-127334,2022-03-02
CASH_IN,23375,Agence_mtn_Abomey,300000,276625,Madeleine Hardy,-127334,-103959,2022-03-03
CASH_IN,3704,Agence_mtn_Cotonou,300000,296296,Madeleine Hardy,-103959,-100255,2022-03-03
CASH_IN,32801,Agence_mtn_Abomey,300000,267199,Madeleine Hardy,-100255,-67454,2022-03-05
CASH_IN,285733,Agence_mtn_Cotonou,300000,14267,Madeleine Hardy,-67454,218279,2022-03-06
CASH_IN,48228,Agence_mtn_Ouidah,300000,251772,Madeleine Hardy,218279,266507,2022-03-07
CASH_IN,213492,Agence_mtn_Cotonou,300000,86508,Madeleine Hardy,266507,479999,2022-03-07
CASH_OUT,404581,Madeleine Hardy,479999,75418,Agence_mtn_Cotonou,300000,-104581,2022-03-11
CASH_OUT,22821,Madeleine Hardy,75418,52597,Agence_mtn_Cotonou,300000,277179,2022-03-13
TRANSFER,33646,Madeleine Hardy,52597,18951,Madeleine Hardy,52597,18951,2022-03-14
CASH_OUT,18579,Madeleine Hardy,18951,372,Agence_mtn_Cotonou,300000,281421,2022-03-20
CASH_IN,196409,Agence_mtn_Ouidah,300000,103591,Madeleine Hardy,372,196781,2022-03-21
CASH_IN,176869,Agence_mtn_Cotonou,300000,123131,Madeleine Hardy,196781,373650,2022-03-24
CASH_IN,210342,Agence_mtn_Cotonou,300000,89658,Madeleine Hardy,373650,583992,2022-03-24
CASH_OUT,355264,Madeleine Hardy,583992,228728,Agence_mtn_Ouidah,300000,-55264,2022-03-27
CASH_IN,86349,Agence_mtn_Ouidah,300000,213651,Alexandre Blanchard,-1258053,-1171704,2022-03-02
CASH_IN,134585,Agence_mtn_Abomey,300000,165415,Alexandre Blanchard,-1171704,-1037119,2022-03-07
CASH_IN,141025,Agence_mtn_Abomey,300000,158975,Alexandre Blanchard,-1037119,-896094,2022-03-08
CASH_IN,78549,Agence_mtn_Abomey,300000,221451,Alexandre Blanchard,-896094,-817545,2022-03-08
CASH_IN,98129,Agence_mtn_Cotonou,300000,201871,Alexandre Blanchard,-817545,-719416,2022-03-08
CASH_IN,61304,Agence_mtn_Ouidah,300000,238696,Alexandre Blanchard,-719416,-658112,2022-03-13
CASH_IN,10023,Agence_mtn_Abomey,300000,289977,Alexandre Blanchard,-658112,-648089,2022-03-14
CASH_IN,263640,Agence_mtn_Cotonou,300000,36360,Alexandre Blanchard,-648089,-384449,2022-03-18
CASH_IN,257686,Agence_mtn_Cotonou,300000,42314,Alexandre Blanchard,-384449,-126763,2022-03-19
CASH_IN,157789,Agence_mtn_Abomey,300000,142211,Alexandre Blanchard,-126763,31026,2022-03-19
TRANSFER,30666,Alexandre Blanchard,31026,360,Alexandre Blanchard,31026,61692,2022-03-20
TRANSFER,218,Alexandre Blanchard,360,142,Alexandre Blanchard,360,578,2022-03-21
CASH_OUT,113,Alexandre Blanchard,142,29,Agence_mtn_Ouidah,300000,299887,2022-03-22
CASH_IN,1970,Agence_mtn_Cotonou,300000,298030,Alexandre Blanchard,29,1999,2022-03-25
CASH_OUT,150,Alexandre Blanchard,1999,1849,Agence_mtn_Ouidah,300000,299850,2022-03-26
CASH_OUT,506,Alexandre Blanchard,1849,1343,Agence_mtn_Abomey,300000,299494,2022-03-27
CASH_IN,107756,Agence_mtn_Cotonou,300000,192244,Édouard Grondin du Fleury,-201694,-93938,2022-03-05
CASH_IN,141870,Agence_mtn_Ouidah,300000,158130,Édouard Grondin du Fleury,-93938,47932,2022-03-05
TRANSFER,27606,Édouard Grondin du Fleury,47932,20326,Édouard Grondin du Fleury,47932,75538,2022-03-07
CASH_IN,90572,Agence_mtn_Abomey,300000,209428,Édouard Grondin du Fleury,20326,110898,2022-03-10
CASH_IN,145337,Agence_mtn_Ouidah,300000,154663,Édouard Grondin du Fleury,110898,256235,2022-03-11
CASH_OUT,104065,Édouard Grondin du Fleury,256235,152170,Agence_mtn_Ouidah,300000,195935,2022-03-13
CASH_IN,13614,Agence_mtn_Abomey,300000,286386,Édouard Grondin du Fleury,152170,165784,2022-03-19
CASH_OUT,47774,Édouard Grondin du Fleury,165784,118010,Agence_mtn_Abomey,300000,252226,2022-03-22
CASH_OUT,49004,Édouard Grondin du Fleury,118010,69006,Agence_mtn_Cotonou,300000,250996,2022-03-23
CASH_IN,229160,Agence_mtn_Ouidah,300000,70840,Édouard Grondin du Fleury,69006,298166,2022-03-27
CASH_IN,71916,Agence_mtn_Abomey,300000,228084,Christophe Teixeira,-145850,-73934,2022-03-02
CASH_IN,51676,Agence_mtn_Abomey,300000,248324,Christophe Teixeira,-73934,-22258,2022-03-04
CASH_IN,103457,Agence_mtn_Ouidah,300000,196543,Christophe Teixeira,-22258,81199,2022-03-06
CASH_IN,58595,Agence_mtn_Ouidah,300000,241405,Christophe Teixeira,81199,139794,2022-03-14
CASH_OUT,542,Christophe Teixeira,139794,139252,Agence_mtn_Ouidah,300000,299458,2022-03-18
CASH_IN,165894,Agence_mtn_Ouidah,300000,134106,Christophe Teixeira,139252,305146,2022-03-19
CASH_OUT,75304,Christophe Teixeira,305146,229842,Agence_mtn_Ouidah,300000,224696,2022-03-22
CASH_OUT,32206,Christophe Teixeira,229842,197636,Agence_mtn_Cotonou,300000,267794,2022-03-22
CASH_IN,240775,Agence_mtn_Ouidah,300000,59225,Christophe Teixeira,197636,438411,2022-03-26
CASH_IN,116444,Agence_mtn_Ouidah,300000,183556,Marc Baudry,-330744,-214300,2022-03-01
CASH_IN,11325,Agence_mtn_Abomey,300000,288675,Marc Baudry,-214300,-202975,2022-03-05
CASH_IN,61613,Agence_mtn_Ouidah,300000,238387,Marc Baudry,-202975,-141362,2022-03-08
CASH_IN,77519,Agence_mtn_Abomey,300000,222481,Marc Baudry,-141362,-63843,2022-03-09
CASH_IN,78956,Agence_mtn_Abomey,300000,221044,Marc Baudry,-63843,15113,2022-03-12
CASH_IN,249762,Agence_mtn_Ouidah,300000,50238,Marc Baudry,15113,264875,2022-03-12
TRANSFER,20480,Marc Baudry,264875,244395,Marc Baudry,264875,244395,2022-03-15
TRANSFER,109880,Marc Baudry,244395,134515,Marc Baudry,244395,354275,2022-03-15
CASH_OUT,134002,Marc Baudry,134515,513,Agence_mtn_Ouidah,300000,165998,2022-03-17
CASH_OUT,374,Marc Baudry,513,139,Agence_mtn_Ouidah,300000,299626,2022-03-22
CASH_IN,185400,Agence_mtn_Abomey,300000,114600,Marc Baudry,139,185539,2022-03-22
CASH_OUT,16499,Marc Baudry,185539,169040,Agence_mtn_Ouidah,300000,283501,2022-03-22
CASH_OUT,67113,Marc Baudry,169040,101927,Agence_mtn_Ouidah,300000,232887,2022-03-23
CASH_IN,116412,Agence_mtn_Ouidah,300000,183588,Marc Baudry,101927,218339,2022-03-24
CASH_IN,151148,Agence_mtn_Abomey,300000,148852,Marc Baudry,218339,369487,2022-03-25
CASH_IN,156984,Agence_mtn_Abomey,300000,143016,Marc Baudry,369487,526471,2022-03-25
CASH_OUT,84553,Marc Baudry,526471,441918,Agence_mtn_Ouidah,300000,215447,2022-03-27
CASH_IN,15890,Agence_mtn_Abomey,300000,284110,Valérie-Claudine Marin,-358435,-342545,2022-03-01
CASH_IN,209413,Agence_mtn_Abomey,300000,90587,Valérie-Claudine Marin,-342545,-133132,2022-03-02
CASH_IN,190757,Agence_mtn_Abomey,300000,109243,Valérie-Claudine Marin,-133132,57625,2022-03-03
CASH_OUT,46791,Valérie-Claudine Marin,57625,10834,Agence_mtn_Abomey,300000,253209,2022-03-05
CASH_OUT,8228,Valérie-Claudine Marin,10834,2606,Agence_mtn_Cotonou,300000,291772,2022-03-07
CASH_OUT,479,Valérie-Claudine Marin,2606,2127,Agence_mtn_Abomey,300000,299521,2022-03-10
CASH_IN,257017,Agence_mtn_Cotonou,300000,42983,Valérie-Claudine Marin,2127,259144,2022-03-13
CASH_OUT,196686,Valérie-Claudine Marin,259144,62458,Agence_mtn_Ouidah,300000,103314,2022-03-14
CASH_OUT,3843,Valérie-Claudine Marin,62458,58615,Agence_mtn_Ouidah,300000,296157,2022-03-15
CASH_IN,147775,Agence_mtn_Cotonou,300000,152225,Valérie-Claudine Marin,58615,206390,2022-03-17
CASH_IN,229477,Agence_mtn_Cotonou,300000,70523,Valérie-Claudine Marin,206390,435867,2022-03-17
CASH_OUT,357229,Valérie-Claudine Marin,435867,78638,Agence_mtn_Abomey,300000,-57229,2022-03-18
TRANSFER,46953,Valérie-Claudine Marin,78638,31685,Valérie-Claudine Marin,78638,125591,2022-03-18
TRANSFER,28565,Valérie-Claudine Marin,31685,3120,Valérie-Claudine Marin,31685,3120,2022-03-19
CASH_OUT,1097,Valérie-Claudine Marin,3120,2023,Agence_mtn_Abomey,300000,298903,2022-03-19
CASH_OUT,744,Valérie-Claudine Marin,2023,1279,Agence_mtn_Ouidah,300000,299256,2022-03-22
CASH_OUT,1055,Valérie-Claudine Marin,1279,224,Agence_mtn_Ouidah,300000,298945,2022-03-22
CASH_OUT,117,Valérie-Claudine Marin,224,107,Agence_mtn_Cotonou,300000,299883,2022-03-27
CASH_IN,275472,Agence_mtn_Cotonou,300000,24528,Raymond de Le Roux,-212171,63301,2022-03-01
TRANSFER,18983,Raymond de Le Roux,63301,44318,Raymond de Le Roux,63301,82284,2022-03-01
CASH_OUT,21495,Raymond de Le Roux,44318,22823,Agence_mtn_Abomey,300000,278505,2022-03-05
TRANSFER,17390,Raymond de Le Roux,22823,5433,Raymond de Le Roux,22823,40213,2022-03-06
TRANSFER,1497,Raymond de Le Roux,5433,3936,Raymond de Le Roux,5433,3936,2022-03-06
TRANSFER,911,Raymond de Le Roux,3936,3025,Raymond de Le Roux,3936,3025,2022-03-07
CASH_OUT,507,Raymond de Le Roux,3025,2518,Agence_mtn_Abomey,300000,299493,2022-03-11
CASH_IN,184118,Agence_mtn_Cotonou,300000,115882,Raymond de Le Roux,2518,186636,2022-03-12
CASH_IN,135300,Agence_mtn_Abomey,300000,164700,Raymond de Le Roux,186636,321936,2022-03-12
CASH_IN,95850,Agence_mtn_Cotonou,300000,204150,Raymond de Le Roux,321936,417786,2022-03-26
CASH_OUT,1517942,Alexandre Delaunay,1525100,7158,Agence_mtn_Ouidah,300000,-1217942,2022-04-05
CASH_IN,69980,Agence_mtn_Abomey,300000,230020,Alexandre Delaunay,7158,77138,2022-04-15
TRANSFER,40432,Sylvie Dupré,399500,359068,Alexandre Delaunay,77138,117570,2022-04-15
CASH_IN,231795,Agence_mtn_Ouidah,300000,68205,Aimé Bernier,1082500,1314295,2022-04-01
CASH_IN,76149,Agence_mtn_Abomey,300000,223851,Aimé Bernier,1314295,1390444,2022-04-10
CASH_IN,9297,Agence_mtn_Ouidah,300000,290703,Aimé Bernier,1390444,1399741,2022-04-21
CASH_OUT,519975,Aimé Bernier,1399741,879766,Agence_mtn_Cotonou,300000,-219975,2022-04-24
TRANSFER,115097,Nicolas Blin,406700,291603,Aimé Bernier,879766,994863,2022-04-26
CASH_IN,251049,Agence_mtn_Cotonou,300000,48951,Honoré Grégoire-Breton,211600,462649,2022-04-01
CASH_IN,281590,Agence_mtn_Abomey,300000,18410,Honoré Grégoire-Breton,462649,744239,2022-04-15
CASH_IN,104056,Agence_mtn_Ouidah,300000,195944,Zacharie Fabre,705600,809656,2022-04-03
CASH_IN,288232,Agence_mtn_Ouidah,300000,11768,Zacharie Fabre,809656,1097888,2022-04-26
CASH_OUT,228247,Véronique Hardy,345700,117453,Agence_mtn_Ouidah,300000,71753,2022-04-24
TRANSFER,1320026,Gérard Cordier,1546500,226474,Gilbert Moulin,55200,1375226,2022-04-03
CASH_IN,288181,Agence_mtn_Abomey,300000,11819,Gilbert Moulin,1375226,1663407,2022-04-09
CASH_OUT,364837,Gilbert Moulin,1663407,1298570,Agence_mtn_Cotonou,300000,-64837,2022-04-24
CASH_IN,151611,Agence_mtn_Cotonou,300000,148389,Gilbert Moulin,1298570,1450181,2022-04-25
TRANSFER,832509,Jules-Marc Chauvet,1719600,887091,François Vaillant,128900,-703609,2022-04-17
CASH_IN,177221,Agence_mtn_Ouidah,300000,122779,Christine Rossi,1509500,1686721,2022-04-03
TRANSFER,1083724,Christine Rossi,1686721,602997,René de la Delaunay,1178800,95076,2022-04-04
CASH_OUT,210512,Christine Rossi,602997,392485,Agence_mtn_Cotonou,300000,89488,2022-04-09
CASH_IN,200343,Agence_mtn_Cotonou,300000,99657,Christine Rossi,392485,592828,2022-04-11
TRANSFER,417959,Christine Rossi,592828,174869,Maryse Delorme,1820000,1402041,2022-04-16
CASH_OUT,1013655,Martin Moreau,1675800,662145,Agence_mtn_Cotonou,300000,-713655,2022-04-19
CASH_OUT,925669,Jacques Le Marion,1087600,161931,Agence_mtn_Ouidah,300000,-625669,2022-04-12
TRANSFER,1154999,Françoise Denis de Allard,1487300,332301,Jacques Le Marion,161931,1316930,2022-04-23
CASH_IN,60604,Agence_mtn_Cotonou,300000,239396,Jacques Le Marion,1316930,1377534,2022-04-26
CASH_IN,259179,Agence_mtn_Ouidah,300000,40821,Astrid Aubert-Thierry,1948700,2207879,2022-04-11
CASH_OUT,422732,Jacques Laporte de Blanchet,1702900,1280168,Agence_mtn_Cotonou,300000,-122732,2022-04-04
CASH_OUT,1194475,Jacques Laporte de Blanchet,1280168,85693,Agence_mtn_Cotonou,300000,-894475,2022-04-09
CASH_IN,26454,Agence_mtn_Ouidah,300000,273546,Jacques Laporte de Blanchet,85693,112147,2022-04-10
CASH_IN,40359,Agence_mtn_Ouidah,300000,259641,Jacques Laporte de Blanchet,112147,152506,2022-04-22
CASH_IN,61276,Agence_mtn_Ouidah,300000,238724,Madeleine Philippe-Grondin,1221100,1282376,2022-04-26
CASH_OUT,122563,Clémence-Alice Ruiz,329200,206637,Agence_mtn_Ouidah,300000,177437,2022-04-08
TRANSFER,84743,Clémence-Alice Ruiz,206637,121894,Charlotte Perrier,244100,159357,2022-04-09
TRANSFER,154858,Marthe Perrin,163500,8642,Clémence-Alice Ruiz,121894,276752,2022-04-10
CASH_IN,190187,Agence_mtn_Abomey,300000,109813,Clémence-Alice Ruiz,276752,466939,2022-04-20
TRANSFER,266058,Marc Costa-Daniel,1131000,864942,Clémence-Alice Ruiz,466939,732997,2022-04-24
TRANSFER,252443,Michelle de la Daniel,261600,9157,Honoré de la Prévost,1373300,1120857,2022-04-07
TRANSFER,7109,Michelle de la Daniel,9157,2048,Sylvie Dupré,359068,351959,2022-04-10
CASH_IN,129547,Agence_mtn_Cotonou,300000,170453,Michelle de la Daniel,2048,131595,2022-04-14
TRANSFER,84001,Michelle de la Daniel,131595,47594,Marcel de la Buisson,847100,763099,2022-04-22
CASH_IN,85495,Agence_mtn_Abomey,300000,214505,Margot Julien,1413900,1499395,2022-04-05
TRANSFER,126866,Roland Huet,1149900,1023034,Margot Julien,1499395,1626261,2022-04-10
CASH_OUT,908670,Margot Julien,1626261,717591,Agence_mtn_Ouidah,300000,-608670,2022-04-16
CASH_OUT,128566,Margot Julien,717591,589025,Agence_mtn_Abomey,300000,171434,2022-04-22
TRANSFER,343742,Nathalie-Claire De Oliveira,1568300,1224558,Guillaume de la Nguyen,1207700,863958,2022-04-10
CASH_IN,294083,Agence_mtn_Cotonou,300000,5917,Nathalie-Claire De Oliveira,1224558,1518641,2022-04-23
CASH_OUT,358037,Nathalie-Claire De Oliveira,1518641,1160604,Agence_mtn_Cotonou,300000,-58037,2022-04-23
CASH_IN,214725,Agence_mtn_Cotonou,300000,85275,Édouard Grondin du Fleury,269200,483925,2022-04-09
CASH_IN,151859,Agence_mtn_Cotonou,300000,148141,Édouard Grondin du Fleury,483925,635784,2022-04-11
CASH_OUT,385647,Édouard Grondin du Fleury,635784,250137,Agence_mtn_Abomey,300000,-85647,2022-04-20
CASH_IN,38115,Agence_mtn_Abomey,300000,261885,Édouard Grondin du Fleury,250137,288252,2022-04-21
CASH_IN,15529,Agence_mtn_Ouidah,300000,284471,Valérie de Pottier,1817800,1833329,2022-04-05
TRANSFER,152890,Marine Chevallier,827100,674210,Emmanuel Vallée,1306700,1459590,2022-04-04
CASH_OUT,477467,Emmanuel Vallée,1459590,982123,Agence_mtn_Cotonou,300000,-177467,2022-04-11
CASH_OUT,519096,Emmanuel Vallée,982123,463027,Agence_mtn_Abomey,300000,-219096,2022-04-17
CASH_OUT,410537,Georges-Alfred Pruvost,769900,359363,Agence_mtn_Ouidah,300000,-110537,2022-04-13
CASH_IN,18929,Agence_mtn_Cotonou,300000,281071,Georges-Alfred Pruvost,359363,378292,2022-04-26
CASH_IN,280106,Agence_mtn_Ouidah,300000,19894,Océane Faure,616900,897006,2022-04-02
CASH_OUT,360004,Océane Faure,897006,537002,Agence_mtn_Cotonou,300000,-60004,2022-04-12
CASH_OUT,310977,Océane Faure,537002,226025,Agence_mtn_Abomey,300000,-10977,2022-04-21
CASH_IN,175266,Agence_mtn_Abomey,300000,124734,Thérèse-Juliette Camus,1323200,1498466,2022-04-22
CASH_IN,68181,Agence_mtn_Ouidah,300000,231819,Jérôme Laporte Le Gauthier,109400,177581,2022-04-09
CASH_IN,205300,Agence_mtn_Ouidah,300000,94700,Jérôme Laporte Le Gauthier,177581,382881,2022-04-18
CASH_OUT,92497,Jérôme Laporte Le Gauthier,382881,290384,Agence_mtn_Abomey,300000,207503,2022-04-20
CASH_IN,150524,Agence_mtn_Abomey,300000,149476,Jérôme Laporte Le Gauthier,290384,440908,2022-04-24
CASH_OUT,368323,Gérard Blot de Blanc,1503100,1134777,Agence_mtn_Abomey,300000,-68323,2022-04-02
CASH_OUT,1077190,Gérard Blot de Blanc,1134777,57587,Agence_mtn_Cotonou,300000,-777190,2022-04-11
CASH_OUT,7538,Gérard Blot de Blanc,57587,50049,Agence_mtn_Ouidah,300000,292462,2022-04-19
CASH_OUT,190492,Nicolas Blin,291603,101111,Agence_mtn_Ouidah,300000,109508,2022-04-02
CASH_OUT,4577,Nicolas Blin,101111,96534,Agence_mtn_Ouidah,300000,295423,2022-04-06
CASH_OUT,35623,Nicolas Blin,96534,60911,Agence_mtn_Cotonou,300000,264377,2022-04-08
TRANSFER,1110856,Louis du Boyer,1483100,372244,Nicolas Blin,60911,1171767,2022-04-16
CASH_IN,97080,Agence_mtn_Cotonou,300000,202920,Nicolas Blin,1171767,1268847,2022-04-20
CASH_IN,63381,Agence_mtn_Cotonou,300000,236619,Hélène Alexandre de la Samson,1613100,1676481,2022-04-01
CASH_OUT,1151350,Hélène Alexandre de la Samson,1676481,525131,Agence_mtn_Abomey,300000,-851350,2022-04-01
TRANSFER,3515,Hélène Alexandre de la Samson,525131,521616,Sylvie Dupré,351959,348444,2022-04-02
CASH_OUT,225178,Hélène Alexandre de la Samson,521616,296438,Agence_mtn_Ouidah,300000,74822,2022-04-03
CASH_OUT,278625,Hélène Alexandre de la Samson,296438,17813,Agence_mtn_Ouidah,300000,21375,2022-04-04
CASH_OUT,4597,Hélène Alexandre de la Samson,17813,13216,Agence_mtn_Cotonou,300000,295403,2022-04-04
CASH_OUT,216,Hélène Alexandre de la Samson,13216,13000,Agence_mtn_Cotonou,300000,299784,2022-04-07
CASH_IN,294030,Agence_mtn_Cotonou,300000,5970,Hélène Alexandre de la Samson,13000,307030,2022-04-08
TRANSFER,11287,Hélène Alexandre de la Samson,307030,295743,Raymond-Yves Boulanger,15400,4113,2022-04-08
TRANSFER,663294,Marine Chevallier,674210,10916,Hélène Alexandre de la Samson,295743,959037,2022-04-10
CASH_IN,118564,Agence_mtn_Ouidah,300000,181436,Hélène Alexandre de la Samson,959037,1077601,2022-04-14
CASH_OUT,643597,Hélène Alexandre de la Samson,1077601,434004,Agence_mtn_Ouidah,300000,-343597,2022-04-15
CASH_IN,81039,Agence_mtn_Cotonou,300000,218961,Hélène Alexandre de la Samson,434004,515043,2022-04-16
CASH_IN,44315,Agence_mtn_Cotonou,300000,255685,Hélène Alexandre de la Samson,515043,559358,2022-04-18
TRANSFER,131364,Hélène Alexandre de la Samson,559358,427994,Anouk Delahaye-Gimenez,1150100,1018736,2022-04-19
CASH_OUT,389818,Hélène Alexandre de la Samson,427994,38176,Agence_mtn_Cotonou,300000,-89818,2022-04-19
CASH_IN,252506,Agence_mtn_Cotonou,300000,47494,Hélène Alexandre de la Samson,38176,290682,2022-04-21
CASH_OUT,246210,Hélène Alexandre de la Samson,290682,44472,Agence_mtn_Ouidah,300000,53790,2022-04-21
TRANSFER,1779592,Aurélie Maury,1980200,200608,Hélène Alexandre de la Samson,44472,1824064,2022-04-22
CASH_OUT,196756,Hélène Alexandre de la Samson,1824064,1627308,Agence_mtn_Abomey,300000,103244,2022-04-23
TRANSFER,299765,Hélène Alexandre de la Samson,1627308,1327543,Élise Monnier,845900,546135,2022-04-25
TRANSFER,1047167,Hélène Alexandre de la Samson,1327543,280376,Josette du Hamon,1052800,5633,2022-04-26
CASH_OUT,27666,Hélène Alexandre de la Samson,280376,252710,Agence_mtn_Cotonou,300000,272334,2022-04-26
TRANSFER,120490,Sylvie Dupré,348444,227954,Hélène Alexandre de la Samson,252710,373200,2022-04-27
TRANSFER,784490,Nathalie Da Silva,1014700,230210,Hélène Alexandre de la Samson,373200,1157690,2022-04-27
CASH_IN,40744,Agence_mtn_Ouidah,300000,259256,Louis de la Imbert,1550100,1590844,2022-04-02
TRANSFER,1572671,Louis de la Imbert,1590844,18173,Julien Devaux,587400,-985271,2022-04-02
CASH_OUT,12199,Louis de la Imbert,18173,5974,Agence_mtn_Cotonou,300000,287801,2022-04-05
CASH_OUT,1932,Louis de la Imbert,5974,4042,Agence_mtn_Abomey,300000,298068,2022-04-05
TRANSFER,1861,Louis de la Imbert,4042,2181,Georges Muller,1568200,1566339,2022-04-05
CASH_OUT,1918,Louis de la Imbert,2181,263,Agence_mtn_Ouidah,300000,298082,2022-04-06
CASH_OUT,256,Louis de la Imbert,263,7,Agence_mtn_Ouidah,300000,299744,2022-04-09
CASH_IN,231398,Agence_mtn_Cotonou,300000,68602,Louis de la Imbert,7,231405,2022-04-11
CASH_OUT,8117,Louis de la Imbert,231405,223288,Agence_mtn_Cotonou,300000,291883,2022-04-12
CASH_IN,298024,Agence_mtn_Cotonou,300000,1976,Louis de la Imbert,223288,521312,2022-04-12
CASH_OUT,32781,Louis de la Imbert,521312,488531,Agence_mtn_Cotonou,300000,267219,2022-04-13
CASH_OUT,462766,Louis de la Imbert,488531,25765,Agence_mtn_Cotonou,300000,-162766,2022-04-14
TRANSFER,20096,Louis de la Imbert,25765,5669,Céline-Inès Meunier,1220900,1200804,2022-04-15
CASH_OUT,3899,Louis de la Imbert,5669,1770,Agence_mtn_Cotonou,300000,296101,2022-04-15
CASH_OUT,1120,Louis de la Imbert,1770,650,Agence_mtn_Ouidah,300000,298880,2022-04-17
CASH_OUT,367,Louis de la Imbert,650,283,Agence_mtn_Abomey,300000,299633,2022-04-18
TRANSFER,132719,Marc Baudry,542800,410081,Louis de la Imbert,283,133002,2022-04-19
CASH_OUT,101173,Louis de la Imbert,133002,31829,Agence_mtn_Abomey,300000,198827,2022-04-21
CASH_IN,114966,Agence_mtn_Cotonou,300000,185034,Louis de la Imbert,31829,146795,2022-04-21
TRANSFER,32995,René de la Delaunay,95076,62081,Louis de la Imbert,146795,179790,2022-04-22
CASH_OUT,33159,Louis de la Imbert,179790,146631,Agence_mtn_Ouidah,300000,266841,2022-04-24
CASH_OUT,35896,Louis de la Imbert,146631,110735,Agence_mtn_Cotonou,300000,264104,2022-04-25
CASH_IN,165344,Agence_mtn_Ouidah,300000,134656,Louis de la Imbert,110735,276079,2022-04-26
TRANSFER,44329,Emmanuelle Le Allain,47000,2671,Louis de la Imbert,276079,320408,2022-04-27
TRANSFER,13375,Louis de la Imbert,320408,307033,Éléonore Marin Le Morel,1929500,1916125,2022-04-27
CASH_IN,226063,Agence_mtn_Abomey,300000,73937,René de la Delaunay,62081,288144,2022-04-02
TRANSFER,575094,Guy-Augustin Pinto,874100,299006,René de la Delaunay,288144,863238,2022-04-03
CASH_OUT,530040,René de la Delaunay,863238,333198,Agence_mtn_Cotonou,300000,-230040,2022-04-03
CASH_IN,242050,Agence_mtn_Cotonou,300000,57950,René de la Delaunay,333198,575248,2022-04-05
CASH_IN,287150,Agence_mtn_Abomey,300000,12850,René de la Delaunay,575248,862398,2022-04-06
TRANSFER,594070,René de la Delaunay,862398,268328,Thibault-Julien Chevallier,98200,-495870,2022-04-06
TRANSFER,1097279,Matthieu Cousin,1175200,77921,René de la Delaunay,268328,1365607,2022-04-08
CASH_OUT,1073836,René de la Delaunay,1365607,291771,Agence_mtn_Cotonou,300000,-773836,2022-04-09
TRANSFER,24382,René de la Delaunay,291771,267389,Honoré de la Prévost,1120857,1096475,2022-04-09
TRANSFER,503628,Julie Germain Le Vaillant,1499200,995572,René de la Delaunay,267389,771017,2022-04-10
CASH_OUT,737964,René de la Delaunay,771017,33053,Agence_mtn_Cotonou,300000,-437964,2022-04-14
CASH_OUT,7298,René de la Delaunay,33053,25755,Agence_mtn_Ouidah,300000,292702,2022-04-15
CASH_OUT,10367,René de la Delaunay,25755,15388,Agence_mtn_Ouidah,300000,289633,2022-04-16
CASH_IN,92080,Agence_mtn_Ouidah,300000,207920,René de la Delaunay,15388,107468,2022-04-17
CASH_OUT,35987,René de la Delaunay,107468,71481,Agence_mtn_Ouidah,300000,264013,2022-04-18
TRANSFER,42157,René de la Delaunay,71481,29324,Aurélie Maury,200608,158451,2022-04-18
CASH_IN,156791,Agence_mtn_Ouidah,300000,143209,René de la Delaunay,29324,186115,2022-04-23
TRANSFER,66043,René de la Delaunay,186115,120072,Matthieu Cousin,77921,11878,2022-04-23
CASH_OUT,67837,René de la Delaunay,120072,52235,Agence_mtn_Ouidah,300000,232163,2022-04-23
CASH_IN,77668,Agence_mtn_Abomey,300000,222332,René de la Delaunay,52235,129903,2022-04-24
TRANSFER,9743,Marine Chevallier,10916,1173,René de la Delaunay,129903,139646,2022-04-24
TRANSFER,65228,René de la Delaunay,139646,74418,Louis du Boyer,372244,307016,2022-04-25
CASH_IN,264262,Agence_mtn_Ouidah,300000,35738,René de la Delaunay,74418,338680,2022-04-25
CASH_OUT,175352,René de la Delaunay,338680,163328,Agence_mtn_Cotonou,300000,124648,2022-04-25
CASH_IN,5018,Agence_mtn_Ouidah,300000,294982,René de la Delaunay,163328,168346,2022-04-26
CASH_OUT,69644,René de la Delaunay,168346,98702,Agence_mtn_Cotonou,300000,230356,2022-04-26
TRANSFER,6051,Stéphanie Guichard,1861200,1855149,Matthieu Cousin,11878,5827,2022-04-02
TRANSFER,262438,Jean Guilbert-Lenoir,465700,203262,Stéphanie Guichard,1855149,2117587,2022-04-03
CASH_IN,150081,Agence_mtn_Abomey,300000,149919,Stéphanie Guichard,2117587,2267668,2022-04-03
TRANSFER,875928,Maurice de Brunet,1187700,311772,Stéphanie Guichard,2267668,3143596,2022-04-05
CASH_OUT,2500557,Stéphanie Guichard,3143596,643039,Agence_mtn_Abomey,300000,-2200557,2022-04-06
TRANSFER,285955,Stéphanie Guichard,643039,357084,Charles Guérin,1740500,1454545,2022-04-07
TRANSFER,500722,Sophie-Anouk Boulanger,715500,214778,Stéphanie Guichard,357084,857806,2022-04-08
CASH_IN,86728,Agence_mtn_Ouidah,300000,213272,Stéphanie Guichard,857806,944534,2022-04-08
TRANSFER,172916,Margaud-Michelle Briand,346900,173984,Stéphanie Guichard,944534,1117450,2022-04-10
CASH_IN,51082,Agence_mtn_Abomey,300000,248918,Stéphanie Guichard,1117450,1168532,2022-04-11
CASH_IN,166447,Agence_mtn_Abomey,300000,133553,Stéphanie Guichard,1168532,1334979,2022-04-14
TRANSFER,1263255,Stéphanie Guichard,1334979,71724,Augustin-Jérôme Merle,247600,-1015655,2022-04-14
CASH_IN,65985,Agence_mtn_Ouidah,300000,234015,Stéphanie Guichard,71724,137709,2022-04-16
TRANSFER,981187,Maryse Delorme,1402041,420854,Stéphanie Guichard,137709,1118896,2022-04-17
CASH_OUT,154954,Stéphanie Guichard,1118896,963942,Agence_mtn_Cotonou,300000,145046,2022-04-18
CASH_IN,197609,Agence_mtn_Cotonou,300000,102391,Stéphanie Guichard,963942,1161551,2022-04-18
CASH_OUT,932011,Stéphanie Guichard,1161551,229540,Agence_mtn_Cotonou,300000,-632011,2022-04-20
CASH_OUT,71958,Stéphanie Guichard,229540,157582,Agence_mtn_Abomey,300000,228042,2022-04-22
CASH_OUT,25702,Stéphanie Guichard,157582,131880,Agence_mtn_Ouidah,300000,274298,2022-04-22
CASH_OUT,105688,Stéphanie Guichard,131880,26192,Agence_mtn_Abomey,300000,194312,2022-04-23
CASH_OUT,14306,Stéphanie Guichard,26192,11886,Agence_mtn_Cotonou,300000,285694,2022-04-23
CASH_OUT,8569,Stéphanie Guichard,11886,3317,Agence_mtn_Ouidah,300000,291431,2022-04-23
CASH_OUT,1555,Stéphanie Guichard,3317,1762,Agence_mtn_Ouidah,300000,298445,2022-04-24
TRANSFER,55800,Jean Guilbert-Lenoir,203262,147462,Stéphanie Guichard,1762,57562,2022-04-27
CASH_IN,78745,Agence_mtn_Ouidah,300000,221255,Stéphanie Guichard,57562,136307,2022-04-27
CASH_OUT,50911,Stéphanie Guichard,136307,85396,Agence_mtn_Abomey,300000,249089,2022-04-27
CASH_OUT,904926,Maggie Barbier,1159000,254074,Agence_mtn_Ouidah,300000,-604926,2022-04-01
TRANSFER,1636,Raymond-Yves Boulanger,4113,2477,Maggie Barbier,254074,255710,2022-04-03
CASH_OUT,224158,Maggie Barbier,255710,31552,Agence_mtn_Abomey,300000,75842,2022-04-04
CASH_IN,113546,Agence_mtn_Ouidah,300000,186454,Maggie Barbier,31552,145098,2022-04-05
TRANSFER,341622,Robert Henry-Poulain,359300,17678,Maggie Barbier,145098,486720,2022-04-07
CASH_OUT,395812,Maggie Barbier,486720,90908,Agence_mtn_Abomey,300000,-95812,2022-04-08
TRANSFER,9304,Maggie Barbier,90908,81604,Laurent Marion,70100,60796,2022-04-09
CASH_IN,111033,Agence_mtn_Ouidah,300000,188967,Maggie Barbier,81604,192637,2022-04-09
CASH_OUT,105778,Maggie Barbier,192637,86859,Agence_mtn_Abomey,300000,194222,2022-04-11
CASH_IN,90340,Agence_mtn_Cotonou,300000,209660,Maggie Barbier,86859,177199,2022-04-11
CASH_IN,56337,Agence_mtn_Abomey,300000,243663,Maggie Barbier,177199,233536,2022-04-11
TRANSFER,774266,Jacques Marchand,935300,161034,Maggie Barbier,233536,1007802,2022-04-12
TRANSFER,346198,Maggie Barbier,1007802,661604,Astrid de Pascal,1006000,659802,2022-04-12
TRANSFER,581847,Maggie Barbier,661604,79757,Élisabeth Blot-Bruneau,523600,-58247,2022-04-13
TRANSFER,320760,Françoise Denis de Allard,332301,11541,Maggie Barbier,79757,400517,2022-04-13
TRANSFER,15503,Laurent Marion,60796,45293,Maggie Barbier,400517,416020,2022-04-13
CASH_IN,261035,Agence_mtn_Ouidah,300000,38965,Maggie Barbier,416020,677055,2022-04-14
CASH_IN,137236,Agence_mtn_Ouidah,300000,162764,Maggie Barbier,677055,814291,2022-04-15
CASH_IN,247201,Agence_mtn_Cotonou,300000,52799,Maggie Barbier,814291,1061492,2022-04-16
CASH_IN,9924,Agence_mtn_Ouidah,300000,290076,Maggie Barbier,1061492,1071416,2022-04-17
CASH_OUT,733942,Maggie Barbier,1071416,337474,Agence_mtn_Abomey,300000,-433942,2022-04-18
CASH_IN,193062,Agence_mtn_Cotonou,300000,106938,Maggie Barbier,337474,530536,2022-04-20
CASH_IN,137289,Agence_mtn_Cotonou,300000,162711,Maggie Barbier,530536,667825,2022-04-21
TRANSFER,511970,Maggie Barbier,667825,155855,Élise Monnier,546135,34165,2022-04-22
CASH_OUT,15163,Maggie Barbier,155855,140692,Agence_mtn_Ouidah,300000,284837,2022-04-23
CASH_IN,171584,Agence_mtn_Ouidah,300000,128416,Maggie Barbier,140692,312276,2022-04-23
CASH_OUT,229224,Maggie Barbier,312276,83052,Agence_mtn_Abomey,300000,70776,2022-04-23
CASH_IN,291338,Agence_mtn_Ouidah,300000,8662,Maggie Barbier,83052,374390,2022-04-25
CASH_OUT,342930,Maggie Barbier,374390,31460,Agence_mtn_Cotonou,300000,-42930,2022-04-25
TRANSFER,1295544,Charles Guérin,1454545,159001,Maggie Barbier,31460,1327004,2022-04-27
CASH_IN,281763,Agence_mtn_Abomey,300000,18237,Raymond de Le Roux,626700,908463,2022-04-04
CASH_IN,287237,Agence_mtn_Cotonou,300000,12763,Raymond de Le Roux,908463,1195700,2022-04-04
CASH_OUT,217974,Raymond de Le Roux,1195700,977726,Agence_mtn_Cotonou,300000,82026,2022-04-04
CASH_IN,4211,Agence_mtn_Ouidah,300000,295789,Raymond de Le Roux,977726,981937,2022-04-04
CASH_OUT,511219,Raymond de Le Roux,981937,470718,Agence_mtn_Ouidah,300000,-211219,2022-04-05
TRANSFER,167,Josette du Hamon,5633,5466,Raymond de Le Roux,470718,470885,2022-04-06
TRANSFER,1594,Emmanuelle Le Allain,2671,1077,Raymond de Le Roux,470885,472479,2022-04-06
CASH_IN,205489,Agence_mtn_Abomey,300000,94511,Raymond de Le Roux,472479,677968,2022-04-07
CASH_OUT,132073,Raymond de Le Roux,677968,545895,Agence_mtn_Abomey,300000,167927,2022-04-10
CASH_OUT,231078,Raymond de Le Roux,545895,314817,Agence_mtn_Cotonou,300000,68922,2022-04-12
CASH_OUT,47699,Raymond de Le Roux,314817,267118,Agence_mtn_Abomey,300000,252301,2022-04-13
CASH_IN,236959,Agence_mtn_Cotonou,300000,63041,Raymond de Le Roux,267118,504077,2022-04-17
TRANSFER,325050,Raymond de Le Roux,504077,179027,Danielle-Henriette Tessier,93400,-231650,2022-04-18
CASH_OUT,91411,Raymond de Le Roux,179027,87616,Agence_mtn_Cotonou,300000,208589,2022-04-20
TRANSFER,62115,Raymond de Le Roux,87616,25501,Éléonore Marin Le Morel,1916125,1854010,2022-04-20
CASH_IN,174780,Agence_mtn_Cotonou,300000,125220,Raymond de Le Roux,25501,200281,2022-04-21
TRANSFER,121223,Raymond de Le Roux,200281,79058,Hélène Blanchard-Renault,138800,17577,2022-04-21
CASH_OUT,75448,Raymond de Le Roux,79058,3610,Agence_mtn_Cotonou,300000,224552,2022-04-23
CASH_OUT,148,Raymond de Le Roux,3610,3462,Agence_mtn_Abomey,300000,299852,2022-04-23
CASH_IN,257338,Agence_mtn_Cotonou,300000,42662,Raymond de Le Roux,3462,260800,2022-04-25
CASH_IN,238016,Agence_mtn_Ouidah,300000,61984,Raymond de Le Roux,260800,498816,2022-04-26
CASH_IN,180772,Agence_mtn_Cotonou,300000,119228,Raymond de Le Roux,498816,679588,2022-04-26
CASH_IN,222971,Agence_mtn_Cotonou,300000,77029,Raymond de Le Roux,679588,902559,2022-04-27
CASH_IN,168734,Agence_mtn_Cotonou,300000,131266,François Vaillant,-703609,-534875,2022-04-05
CASH_IN,17533,Agence_mtn_Cotonou,300000,282467,François Vaillant,-534875,-517342,2022-04-06
CASH_IN,22140,Agence_mtn_Cotonou,300000,277860,François Vaillant,-517342,-495202,2022-04-06
CASH_IN,133300,Agence_mtn_Cotonou,300000,166700,François Vaillant,-495202,-361902,2022-04-06
CASH_IN,116003,Agence_mtn_Abomey,300000,183997,François Vaillant,-361902,-245899,2022-04-07
CASH_IN,65955,Agence_mtn_Abomey,300000,234045,François Vaillant,-245899,-179944,2022-04-07
CASH_IN,239937,Agence_mtn_Cotonou,300000,60063,François Vaillant,-179944,59993,2022-04-07
TRANSFER,53196,François Vaillant,59993,6797,Matthieu Cousin,5827,-47369,2022-04-07
CASH_IN,123078,Agence_mtn_Cotonou,300000,176922,François Vaillant,6797,129875,2022-04-08
CASH_OUT,2306,François Vaillant,129875,127569,Agence_mtn_Ouidah,300000,297694,2022-04-08
CASH_OUT,65348,François Vaillant,127569,62221,Agence_mtn_Cotonou,300000,234652,2022-04-09
CASH_OUT,35511,François Vaillant,62221,26710,Agence_mtn_Abomey,300000,264489,2022-04-11
TRANSFER,4849,François Vaillant,26710,21861,Robert Henry-Poulain,17678,12829,2022-04-11
CASH_OUT,16601,François Vaillant,21861,5260,Agence_mtn_Ouidah,300000,283399,2022-04-12
TRANSFER,993,François Vaillant,5260,4267,Céline-Inès Meunier,1200804,1199811,2022-04-13
CASH_OUT,182,François Vaillant,4267,4085,Agence_mtn_Ouidah,300000,299818,2022-04-13
TRANSFER,3283,François Vaillant,4085,802,Emmanuel Legrand,1417300,1414017,2022-04-13
CASH_OUT,185,François Vaillant,802,617,Agence_mtn_Ouidah,300000,299815,2022-04-14
TRANSFER,278391,Nicole-Renée Gay,1114300,835909,François Vaillant,617,279008,2022-04-14
TRANSFER,44500,François Vaillant,279008,234508,Marine Labbé,1801700,1757200,2022-04-14
CASH_OUT,72545,François Vaillant,234508,161963,Agence_mtn_Abomey,300000,227455,2022-04-16
CASH_OUT,96851,François Vaillant,161963,65112,Agence_mtn_Cotonou,300000,203149,2022-04-18
CASH_OUT,603,François Vaillant,65112,64509,Agence_mtn_Ouidah,300000,299397,2022-04-20
CASH_OUT,7410,François Vaillant,64509,57099,Agence_mtn_Abomey,300000,292590,2022-04-20
TRANSFER,145250,Charles Guérin,159001,13751,François Vaillant,57099,202349,2022-04-21
CASH_IN,111336,Agence_mtn_Ouidah,300000,188664,François Vaillant,202349,313685,2022-04-24
CASH_IN,111373,Agence_mtn_Ouidah,300000,188627,François Vaillant,313685,425058,2022-04-24
CASH_OUT,194280,François Vaillant,425058,230778,Agence_mtn_Abomey,300000,105720,2022-04-26
TRANSFER,19059,Sébastien Coste,28800,9741,Nicole Huet,579700,560641,2022-04-02
CASH_IN,160900,Agence_mtn_Cotonou,300000,139100,Sébastien Coste,9741,170641,2022-04-04
CASH_IN,203758,Agence_mtn_Ouidah,300000,96242,Sébastien Coste,170641,374399,2022-04-05
CASH_IN,282256,Agence_mtn_Cotonou,300000,17744,Sébastien Coste,374399,656655,2022-04-09
CASH_OUT,653343,Sébastien Coste,656655,3312,Agence_mtn_Cotonou,300000,-353343,2022-04-12
CASH_OUT,123,Sébastien Coste,3312,3189,Agence_mtn_Abomey,300000,299877,2022-04-12
CASH_OUT,1127,Sébastien Coste,3189,2062,Agence_mtn_Ouidah,300000,298873,2022-04-15
TRANSFER,1353,Sébastien Coste,2062,709,Marc Costa-Daniel,864942,863589,2022-04-15
CASH_IN,164086,Agence_mtn_Abomey,300000,135914,Sébastien Coste,709,164795,2022-04-18
TRANSFER,456355,Roger-Roger Delmas,1390400,934045,Sébastien Coste,164795,621150,2022-04-20
CASH_OUT,375193,Sébastien Coste,621150,245957,Agence_mtn_Ouidah,300000,-75193,2022-04-21
TRANSFER,138559,Maurice de Brunet,311772,173213,Sébastien Coste,245957,384516,2022-04-21
TRANSFER,1088790,Georges Muller,1566339,477549,Sébastien Coste,384516,1473306,2022-04-21
CASH_IN,102063,Agence_mtn_Abomey,300000,197937,Sébastien Coste,1473306,1575369,2022-04-21
TRANSFER,440428,Corinne Roussel,671200,230772,Sébastien Coste,1575369,2015797,2022-04-22
CASH_OUT,1088761,Sébastien Coste,2015797,927036,Agence_mtn_Abomey,300000,-788761,2022-04-22
TRANSFER,502594,Sébastien Coste,927036,424442,Raymond Simon,1947600,1445006,2022-04-23
TRANSFER,39085,Emmanuel Legrand,1414017,1374932,Sébastien Coste,424442,463527,2022-04-23
CASH_IN,17795,Agence_mtn_Ouidah,300000,282205,Sébastien Coste,463527,481322,2022-04-24
TRANSFER,1955,Sébastien Coste,481322,479367,Michèle Faivre,834800,832845,2022-04-25
CASH_OUT,302594,Sébastien Coste,479367,176773,Agence_mtn_Ouidah,300000,-2594,2022-04-25
TRANSFER,44720,Maurice de Brunet,173213,128493,Sébastien Coste,176773,221493,2022-04-25
TRANSFER,142840,Sébastien Coste,221493,78653,Madeleine Hardy,515100,372260,2022-04-25
CASH_IN,289815,Agence_mtn_Ouidah,300000,10185,Sébastien Coste,78653,368468,2022-04-25
CASH_OUT,306890,Sébastien Coste,368468,61578,Agence_mtn_Cotonou,300000,-6890,2022-04-26
TRANSFER,892333,Clémence Dufour,973600,81267,Christophe Besnard-Diaz,1935500,2827833,2022-04-01
CASH_OUT,1370398,Christophe Besnard-Diaz,2827833,1457435,Agence_mtn_Abomey,300000,-1070398,2022-04-01
CASH_IN,61681,Agence_mtn_Abomey,300000,238319,Christophe Besnard-Diaz,1457435,1519116,2022-04-01
CASH_IN,25600,Agence_mtn_Ouidah,300000,274400,Christophe Besnard-Diaz,1519116,1544716,2022-04-02
TRANSFER,1078092,Christophe Besnard-Diaz,1544716,466624,Marcel de la Buisson,763099,-314993,2022-04-03
CASH_OUT,309271,Christophe Besnard-Diaz,466624,157353,Agence_mtn_Ouidah,300000,-9271,2022-04-06
CASH_OUT,54527,Christophe Besnard-Diaz,157353,102826,Agence_mtn_Abomey,300000,245473,2022-04-11
TRANSFER,1157419,Gabrielle Hamon,1934000,776581,Christophe Besnard-Diaz,102826,1260245,2022-04-11
CASH_OUT,1235309,Christophe Besnard-Diaz,1260245,24936,Agence_mtn_Abomey,300000,-935309,2022-04-12
CASH_OUT,23154,Christophe Besnard-Diaz,24936,1782,Agence_mtn_Abomey,300000,276846,2022-04-14
CASH_IN,155057,Agence_mtn_Ouidah,300000,144943,Christophe Besnard-Diaz,1782,156839,2022-04-14
TRANSFER,153935,Christophe Besnard-Diaz,156839,2904,Marc Baudry,410081,256146,2022-04-15
TRANSFER,123025,Nathalie Da Silva,230210,107185,Christophe Besnard-Diaz,2904,125929,2022-04-15
CASH_OUT,31561,Christophe Besnard-Diaz,125929,94368,Agence_mtn_Ouidah,300000,268439,2022-04-16
CASH_IN,189325,Agence_mtn_Ouidah,300000,110675,Christophe Besnard-Diaz,94368,283693,2022-04-16
CASH_IN,47558,Agence_mtn_Abomey,300000,252442,Christophe Besnard-Diaz,283693,331251,2022-04-17
TRANSFER,31061,Christophe Besnard-Diaz,331251,300190,Astrid de Pascal,659802,628741,2022-04-19
TRANSFER,209268,Sylvie Dupré,227954,18686,Christophe Besnard-Diaz,300190,509458,2022-04-19
CASH_OUT,286918,Christophe Besnard-Diaz,509458,222540,Agence_mtn_Ouidah,300000,13082,2022-04-21
CASH_OUT,90145,Christophe Besnard-Diaz,222540,132395,Agence_mtn_Abomey,300000,209855,2022-04-22
CASH_OUT,24334,Christophe Besnard-Diaz,132395,108061,Agence_mtn_Cotonou,300000,275666,2022-04-25
TRANSFER,73315,Jean Guilbert-Lenoir,147462,74147,Nicole-Renée Gay,835909,762594,2022-04-01
TRANSFER,293089,Madeleine Hardy,372260,79171,Jean Guilbert-Lenoir,74147,367236,2022-04-01
CASH_OUT,311963,Jean Guilbert-Lenoir,367236,55273,Agence_mtn_Cotonou,300000,-11963,2022-04-04
TRANSFER,53996,Jean Guilbert-Lenoir,55273,1277,Laurent Marion,45293,-8703,2022-04-04
CASH_OUT,762,Jean Guilbert-Lenoir,1277,515,Agence_mtn_Cotonou,300000,299238,2022-04-05
TRANSFER,73198,Gérard Cordier,226474,153276,Jean Guilbert-Lenoir,515,73713,2022-04-05
TRANSFER,383253,Élisabeth Delattre,1089000,705747,Jean Guilbert-Lenoir,73713,456966,2022-04-05
CASH_IN,81499,Agence_mtn_Cotonou,300000,218501,Jean Guilbert-Lenoir,456966,538465,2022-04-06
CASH_OUT,94999,Jean Guilbert-Lenoir,538465,443466,Agence_mtn_Ouidah,300000,205001,2022-04-07
CASH_IN,82759,Agence_mtn_Abomey,300000,217241,Jean Guilbert-Lenoir,443466,526225,2022-04-08
TRANSFER,6356,Élise Monnier,34165,27809,Jean Guilbert-Lenoir,526225,532581,2022-04-10
TRANSFER,67147,Jean Guilbert-Lenoir,532581,465434,Marine Labbé,1757200,1690053,2022-04-10
TRANSFER,47758,Nathalie Da Silva,107185,59427,Jean Guilbert-Lenoir,465434,513192,2022-04-11
CASH_IN,265323,Agence_mtn_Cotonou,300000,34677,Jean Guilbert-Lenoir,513192,778515,2022-04-11
CASH_OUT,237602,Jean Guilbert-Lenoir,778515,540913,Agence_mtn_Abomey,300000,62398,2022-04-13
CASH_IN,62005,Agence_mtn_Cotonou,300000,237995,Jean Guilbert-Lenoir,540913,602918,2022-04-13
CASH_IN,162427,Agence_mtn_Cotonou,300000,137573,Jean Guilbert-Lenoir,602918,765345,2022-04-14
CASH_IN,104771,Agence_mtn_Cotonou,300000,195229,Jean Guilbert-Lenoir,765345,870116,2022-04-16
CASH_OUT,726660,Jean Guilbert-Lenoir,870116,143456,Agence_mtn_Cotonou,300000,-426660,2022-04-16
TRANSFER,571,Emmanuelle Le Allain,1077,506,Jean Guilbert-Lenoir,143456,144027,2022-04-16
TRANSFER,19720,Jean Guilbert-Lenoir,144027,124307,Alfred Paris,1146200,1126480,2022-04-17
CASH_IN,69254,Agence_mtn_Cotonou,300000,230746,Jean Guilbert-Lenoir,124307,193561,2022-04-18
CASH_OUT,3040,Jean Guilbert-Lenoir,193561,190521,Agence_mtn_Ouidah,300000,296960,2022-04-18
CASH_OUT,116872,Jean Guilbert-Lenoir,190521,73649,Agence_mtn_Cotonou,300000,183128,2022-04-22
CASH_OUT,50647,Jean Guilbert-Lenoir,73649,23002,Agence_mtn_Abomey,300000,249353,2022-04-22
CASH_IN,182236,Agence_mtn_Abomey,300000,117764,Jean Guilbert-Lenoir,23002,205238,2022-04-24
TRANSFER,3623,Jean Guilbert-Lenoir,205238,201615,Guillaume de la Nguyen,863958,860335,2022-04-24
CASH_IN,191307,Agence_mtn_Abomey,300000,108693,Jean Guilbert-Lenoir,201615,392922,2022-04-25
CASH_OUT,90888,Jean Guilbert-Lenoir,392922,302034,Agence_mtn_Cotonou,300000,209112,2022-04-27
TRANSFER,253797,Jean Guilbert-Lenoir,302034,48237,Robert Henry-Poulain,12829,-240968,2022-04-27
CASH_IN,107798,Agence_mtn_Cotonou,300000,192202,Nicole-Renée Gay,762594,870392,2022-04-01
TRANSFER,106675,Sophie-Anouk Boulanger,214778,108103,Nicole-Renée Gay,870392,977067,2022-04-01
CASH_IN,113916,Agence_mtn_Cotonou,300000,186084,Nicole-Renée Gay,977067,1090983,2022-04-02
CASH_IN,25259,Agence_mtn_Abomey,300000,274741,Nicole-Renée Gay,1090983,1116242,2022-04-04
TRANSFER,726301,Nicole-Renée Gay,1116242,389941,Marthe Perrin,8642,-717659,2022-04-07
CASH_IN,5810,Agence_mtn_Cotonou,300000,294190,Nicole-Renée Gay,389941,395751,2022-04-08
CASH_IN,91090,Agence_mtn_Ouidah,300000,208910,Nicole-Renée Gay,395751,486841,2022-04-10
CASH_IN,59362,Agence_mtn_Ouidah,300000,240638,Nicole-Renée Gay,486841,546203,2022-04-10
TRANSFER,536697,Nicole-Renée Gay,546203,9506,Marine Chevallier,1173,-535524,2022-04-10
CASH_IN,169254,Agence_mtn_Cotonou,300000,130746,Nicole-Renée Gay,9506,178760,2022-04-11
TRANSFER,66728,Nicole-Renée Gay,178760,112032,Michèle Faivre,832845,766117,2022-04-11
CASH_OUT,86538,Nicole-Renée Gay,112032,25494,Agence_mtn_Abomey,300000,213462,2022-04-14
TRANSFER,16696,Nicole-Renée Gay,25494,8798,Madeleine Hardy,79171,62475,2022-04-16
TRANSFER,208313,Olivier Benard,1341200,1132887,Nicole-Renée Gay,8798,217111,2022-04-16
CASH_OUT,76190,Nicole-Renée Gay,217111,140921,Agence_mtn_Abomey,300000,223810,2022-04-16
CASH_IN,144086,Agence_mtn_Ouidah,300000,155914,Nicole-Renée Gay,140921,285007,2022-04-17
CASH_IN,246803,Agence_mtn_Abomey,300000,53197,Nicole-Renée Gay,285007,531810,2022-04-18
CASH_OUT,502428,Nicole-Renée Gay,531810,29382,Agence_mtn_Ouidah,300000,-202428,2022-04-21
CASH_IN,253550,Agence_mtn_Abomey,300000,46450,Nicole-Renée Gay,29382,282932,2022-04-21
CASH_IN,102352,Agence_mtn_Abomey,300000,197648,Nicole-Renée Gay,282932,385284,2022-04-22
CASH_OUT,3696,Nicole-Renée Gay,385284,381588,Agence_mtn_Ouidah,300000,296304,2022-04-23
TRANSFER,186431,Nicole-Renée Gay,381588,195157,Michèle Faivre,766117,579686,2022-04-25
CASH_OUT,106012,Nicole-Renée Gay,195157,89145,Agence_mtn_Abomey,300000,193988,2022-04-27
CASH_OUT,50754,Guy-Augustin Pinto,299006,248252,Agence_mtn_Abomey,300000,249246,2022-04-03
CASH_IN,245942,Agence_mtn_Cotonou,300000,54058,Guy-Augustin Pinto,248252,494194,2022-04-04
CASH_IN,298929,Agence_mtn_Ouidah,300000,1071,Guy-Augustin Pinto,494194,793123,2022-04-05
TRANSFER,507080,Guy-Augustin Pinto,793123,286043,Astrid de Pascal,628741,121661,2022-04-06
CASH_OUT,212970,Guy-Augustin Pinto,286043,73073,Agence_mtn_Cotonou,300000,87030,2022-04-07
CASH_OUT,72601,Guy-Augustin Pinto,73073,472,Agence_mtn_Abomey,300000,227399,2022-04-08
CASH_IN,136997,Agence_mtn_Ouidah,300000,163003,Guy-Augustin Pinto,472,137469,2022-04-09
CASH_OUT,92941,Guy-Augustin Pinto,137469,44528,Agence_mtn_Abomey,300000,207059,2022-04-10
CASH_OUT,31839,Guy-Augustin Pinto,44528,12689,Agence_mtn_Cotonou,300000,268161,2022-04-11
CASH_IN,57768,Agence_mtn_Abomey,300000,242232,Guy-Augustin Pinto,12689,70457,2022-04-11
CASH_OUT,37092,Guy-Augustin Pinto,70457,33365,Agence_mtn_Ouidah,300000,262908,2022-04-16
TRANSFER,16892,Guy-Augustin Pinto,33365,16473,Guillaume de la Nguyen,860335,843443,2022-04-16
CASH_OUT,2319,Guy-Augustin Pinto,16473,14154,Agence_mtn_Ouidah,300000,297681,2022-04-17
CASH_OUT,6549,Guy-Augustin Pinto,14154,7605,Agence_mtn_Abomey,300000,293451,2022-04-18
CASH_OUT,5746,Guy-Augustin Pinto,7605,1859,Agence_mtn_Abomey,300000,294254,2022-04-18
CASH_OUT,1662,Guy-Augustin Pinto,1859,197,Agence_mtn_Cotonou,300000,298338,2022-04-18
CASH_IN,224711,Agence_mtn_Ouidah,300000,75289,Guy-Augustin Pinto,197,224908,2022-04-19
CASH_OUT,215527,Guy-Augustin Pinto,224908,9381,Agence_mtn_Ouidah,300000,84473,2022-04-19
CASH_IN,85691,Agence_mtn_Abomey,300000,214309,Guy-Augustin Pinto,9381,95072,2022-04-21
TRANSFER,873762,Thibault Martin,1214100,340338,Guy-Augustin Pinto,95072,968834,2022-04-22
TRANSFER,559712,Guy-Augustin Pinto,968834,409122,Charles Guérin,13751,-545961,2022-04-23
TRANSFER,91023,Guy-Augustin Pinto,409122,318099,Guy-Augustin Pinto,409122,318099,2022-04-24
CASH_OUT,72922,Guy-Augustin Pinto,318099,245177,Agence_mtn_Ouidah,300000,227078,2022-04-24
TRANSFER,1763930,Éléonore Marin Le Morel,1854010,90080,Guy-Augustin Pinto,245177,2009107,2022-04-25
CASH_OUT,144876,Guy-Augustin Pinto,2009107,1864231,Agence_mtn_Cotonou,300000,155124,2022-04-26
CASH_OUT,686946,Roland Huet,1023034,336088,Agence_mtn_Abomey,300000,-386946,2022-04-02
CASH_IN,52553,Agence_mtn_Cotonou,300000,247447,Roland Huet,336088,388641,2022-04-02
TRANSFER,899184,Louise-Aurore Payet,1865100,965916,Roland Huet,388641,1287825,2022-04-02
CASH_IN,147154,Agence_mtn_Cotonou,300000,152846,Roland Huet,1287825,1434979,2022-04-02
CASH_IN,224093,Agence_mtn_Cotonou,300000,75907,Roland Huet,1434979,1659072,2022-04-03
TRANSFER,60397,Astrid de Pascal,121661,61264,Roland Huet,1659072,1719469,2022-04-04
TRANSFER,315922,Thibault Martin,340338,24416,Roland Huet,1719469,2035391,2022-04-05
TRANSFER,18905,Madeleine Hardy,62475,43570,Roland Huet,2035391,2054296,2022-04-08
CASH_IN,44140,Agence_mtn_Abomey,300000,255860,Roland Huet,2054296,2098436,2022-04-09
CASH_OUT,587439,Roland Huet,2098436,1510997,Agence_mtn_Ouidah,300000,-287439,2022-04-09
CASH_OUT,995765,Roland Huet,1510997,515232,Agence_mtn_Ouidah,300000,-695765,2022-04-10
CASH_OUT,252187,Roland Huet,515232,263045,Agence_mtn_Abomey,300000,47813,2022-04-11
CASH_OUT,204820,Roland Huet,263045,58225,Agence_mtn_Ouidah,300000,95180,2022-04-12
CASH_OUT,26589,Roland Huet,58225,31636,Agence_mtn_Cotonou,300000,273411,2022-04-12
TRANSFER,631,Roland Huet,31636,31005,Margaud-Michelle Briand,173984,173353,2022-04-16
CASH_IN,221396,Agence_mtn_Abomey,300000,78604,Roland Huet,31005,252401,2022-04-16
TRANSFER,699885,Alfred Paris,1126480,426595,Roland Huet,252401,952286,2022-04-19
CASH_IN,17097,Agence_mtn_Ouidah,300000,282903,Roland Huet,952286,969383,2022-04-21
TRANSFER,401806,Guillaume de la Nguyen,843443,441637,Roland Huet,969383,1371189,2022-04-21
CASH_IN,161971,Agence_mtn_Ouidah,300000,138029,Roland Huet,1371189,1533160,2022-04-22
TRANSFER,1326842,Roland Huet,1533160,206318,Simone du Allard,1761300,434458,2022-04-24
CASH_OUT,79700,Roland Huet,206318,126618,Agence_mtn_Cotonou,300000,220300,2022-04-24
TRANSFER,377140,Simone du Allard,434458,57318,Roland Huet,126618,503758,2022-04-26
CASH_OUT,200517,Roland Huet,503758,303241,Agence_mtn_Ouidah,300000,99483,2022-04-26
CASH_OUT,100463,Roland Huet,303241,202778,Agence_mtn_Abomey,300000,199537,2022-04-26
CASH_IN,188522,Agence_mtn_Ouidah,300000,111478,Roland Huet,202778,391300,2022-04-27
CASH_IN,9180,Agence_mtn_Abomey,300000,290820,Raymond Simon,1445006,1454186,2022-04-01
CASH_OUT,889169,Raymond Simon,1454186,565017,Agence_mtn_Cotonou,300000,-589169,2022-04-02
CASH_IN,53564,Agence_mtn_Abomey,300000,246436,Raymond Simon,565017,618581,2022-04-02
CASH_IN,173003,Agence_mtn_Cotonou,300000,126997,Raymond Simon,618581,791584,2022-04-03
CASH_OUT,626958,Raymond Simon,791584,164626,Agence_mtn_Ouidah,300000,-326958,2022-04-06
CASH_IN,68522,Agence_mtn_Cotonou,300000,231478,Raymond Simon,164626,233148,2022-04-07
CASH_IN,96282,Agence_mtn_Abomey,300000,203718,Raymond Simon,233148,329430,2022-04-10
CASH_OUT,4136,Raymond Simon,329430,325294,Agence_mtn_Ouidah,300000,295864,2022-04-11
CASH_IN,21143,Agence_mtn_Cotonou,300000,278857,Raymond Simon,325294,346437,2022-04-13
TRANSFER,152794,Anouk Delahaye-Gimenez,1018736,865942,Raymond Simon,346437,499231,2022-04-14
CASH_OUT,306945,Raymond Simon,499231,192286,Agence_mtn_Cotonou,300000,-6945,2022-04-14
TRANSFER,170766,Raymond Simon,192286,21520,Emmanuel Legrand,1374932,1204166,2022-04-15
TRANSFER,40986,Marc Baudry,256146,215160,Raymond Simon,21520,62506,2022-04-15
TRANSFER,55921,Corinne Roussel,230772,174851,Raymond Simon,62506,118427,2022-04-17
CASH_OUT,67292,Raymond Simon,118427,51135,Agence_mtn_Abomey,300000,232708,2022-04-19
CASH_OUT,5331,Raymond Simon,51135,45804,Agence_mtn_Cotonou,300000,294669,2022-04-19
TRANSFER,2315,Raymond Simon,45804,43489,Marine Labbé,1690053,1687738,2022-04-21
CASH_OUT,6927,Raymond Simon,43489,36562,Agence_mtn_Abomey,300000,293073,2022-04-21
CASH_OUT,28654,Raymond Simon,36562,7908,Agence_mtn_Cotonou,300000,271346,2022-04-22
CASH_IN,297794,Agence_mtn_Abomey,300000,2206,Raymond Simon,7908,305702,2022-04-24
CASH_IN,243181,Agence_mtn_Cotonou,300000,56819,Raymond Simon,305702,548883,2022-04-27
TRANSFER,56210,Jacques Marchand,161034,104824,Madeleine Hardy,43570,-12640,2022-04-01
CASH_OUT,45109,Jacques Marchand,104824,59715,Agence_mtn_Cotonou,300000,254891,2022-04-01
CASH_OUT,5084,Jacques Marchand,59715,54631,Agence_mtn_Ouidah,300000,294916,2022-04-03
TRANSFER,41449,Jacques Marchand,54631,13182,Maryse Delorme,420854,379405,2022-04-06
CASH_OUT,8137,Jacques Marchand,13182,5045,Agence_mtn_Cotonou,300000,291863,2022-04-06
CASH_IN,153875,Agence_mtn_Ouidah,300000,146125,Jacques Marchand,5045,158920,2022-04-09
CASH_OUT,13727,Jacques Marchand,158920,145193,Agence_mtn_Cotonou,300000,286273,2022-04-09
CASH_IN,133306,Agence_mtn_Ouidah,300000,166694,Jacques Marchand,145193,278499,2022-04-10
CASH_IN,67201,Agence_mtn_Cotonou,300000,232799,Jacques Marchand,278499,345700,2022-04-12
CASH_OUT,59565,Jacques Marchand,345700,286135,Agence_mtn_Ouidah,300000,240435,2022-04-13
TRANSFER,80941,Jacques Marchand,286135,205194,Roger-Roger Delmas,934045,853104,2022-04-13
CASH_OUT,177829,Jacques Marchand,205194,27365,Agence_mtn_Abomey,300000,122171,2022-04-14
CASH_OUT,5366,Jacques Marchand,27365,21999,Agence_mtn_Abomey,300000,294634,2022-04-15
TRANSFER,4858,Jacques Marchand,21999,17141,Guillaume de la Nguyen,441637,436779,2022-04-15
CASH_OUT,14351,Jacques Marchand,17141,2790,Agence_mtn_Ouidah,300000,285649,2022-04-16
CASH_OUT,901,Jacques Marchand,2790,1889,Agence_mtn_Ouidah,300000,299099,2022-04-16
CASH_IN,8908,Agence_mtn_Abomey,300000,291092,Jacques Marchand,1889,10797,2022-04-16
CASH_IN,16013,Agence_mtn_Abomey,300000,283987,Jacques Marchand,10797,26810,2022-04-18
CASH_IN,49980,Agence_mtn_Ouidah,300000,250020,Jacques Marchand,26810,76790,2022-04-18
TRANSFER,44791,Jacques Marchand,76790,31999,Gabrielle Hamon,776581,731790,2022-04-19
CASH_OUT,27280,Jacques Marchand,31999,4719,Agence_mtn_Cotonou,300000,272720,2022-04-20
TRANSFER,1396,Jacques Marchand,4719,3323,Corinne Roussel,174851,173455,2022-04-21
CASH_OUT,3024,Jacques Marchand,3323,299,Agence_mtn_Abomey,300000,296976,2022-04-21
CASH_IN,207600,Agence_mtn_Cotonou,300000,92400,Jacques Marchand,299,207899,2022-04-22
CASH_IN,101988,Agence_mtn_Cotonou,300000,198012,Jacques Marchand,207899,309887,2022-04-24
CASH_IN,12032,Agence_mtn_Abomey,300000,287968,Jacques Marchand,309887,321919,2022-04-24
CASH_OUT,297040,Jacques Marchand,321919,24879,Agence_mtn_Ouidah,300000,2960,2022-04-24
CASH_OUT,15437,Jacques Marchand,24879,9442,Agence_mtn_Cotonou,300000,284563,2022-04-25
CASH_IN,198674,Agence_mtn_Abomey,300000,101326,Jacques Marchand,9442,208116,2022-04-27
TRANSFER,38594,Gabrielle Hamon,731790,693196,Jacques Marchand,208116,246710,2022-04-27
CASH_IN,21738,Agence_mtn_Cotonou,300000,278262,Gérard Cordier,153276,175014,2022-04-01
TRANSFER,604705,Roger-Roger Delmas,853104,248399,Gérard Cordier,175014,779719,2022-04-01
TRANSFER,73293,Sophie-Anouk Boulanger,108103,34810,Gérard Cordier,779719,853012,2022-04-03
CASH_IN,262795,Agence_mtn_Abomey,300000,37205,Gérard Cordier,853012,1115807,2022-04-03
CASH_IN,134327,Agence_mtn_Cotonou,300000,165673,Gérard Cordier,1115807,1250134,2022-04-04
TRANSFER,929741,Gérard Cordier,1250134,320393,Hélène Blanchard-Renault,17577,-912164,2022-04-04
CASH_IN,179544,Agence_mtn_Cotonou,300000,120456,Gérard Cordier,320393,499937,2022-04-08
CASH_OUT,8585,Gérard Cordier,499937,491352,Agence_mtn_Cotonou,300000,291415,2022-04-09
CASH_IN,64618,Agence_mtn_Ouidah,300000,235382,Gérard Cordier,491352,555970,2022-04-09
TRANSFER,142014,Gérard Cordier,555970,413956,Céline-Inès Meunier,1199811,1057797,2022-04-12
TRANSFER,142821,Roger-Roger Delmas,248399,105578,Gérard Cordier,413956,556777,2022-04-15
TRANSFER,51443,Clémence Dufour,81267,29824,Gérard Cordier,556777,608220,2022-04-16
CASH_IN,190435,Agence_mtn_Cotonou,300000,109565,Gérard Cordier,608220,798655,2022-04-17
CASH_IN,4820,Agence_mtn_Ouidah,300000,295180,Gérard Cordier,798655,803475,2022-04-18
TRANSFER,151,Emmanuelle Le Allain,506,355,Gérard Cordier,803475,803626,2022-04-18
CASH_OUT,305626,Gérard Cordier,803626,498000,Agence_mtn_Ouidah,300000,-5626,2022-04-19
CASH_OUT,136613,Gérard Cordier,498000,361387,Agence_mtn_Cotonou,300000,163387,2022-04-20
CASH_IN,86037,Agence_mtn_Abomey,300000,213963,Gérard Cordier,361387,447424,2022-04-20
TRANSFER,554313,Henri de Didier,1840400,1286087,Gérard Cordier,447424,1001737,2022-04-21
CASH_IN,167728,Agence_mtn_Ouidah,300000,132272,Gérard Cordier,1001737,1169465,2022-04-22
TRANSFER,314755,Guillaume de la Nguyen,436779,122024,Gérard Cordier,1169465,1484220,2022-04-23
CASH_IN,97506,Agence_mtn_Abomey,300000,202494,Gérard Cordier,1484220,1581726,2022-04-23
CASH_OUT,375884,Gérard Cordier,1581726,1205842,Agence_mtn_Cotonou,300000,-75884,2022-04-24
CASH_IN,232948,Agence_mtn_Abomey,300000,67052,Gérard Cordier,1205842,1438790,2022-04-26
CASH_OUT,1119858,Gérard Cordier,1438790,318932,Agence_mtn_Cotonou,300000,-819858,2022-04-27
CASH_IN,102975,Agence_mtn_Ouidah,300000,197025,Olivier Benard,1132887,1235862,2022-04-01
CASH_OUT,432351,Olivier Benard,1235862,803511,Agence_mtn_Abomey,300000,-132351,2022-04-03
CASH_IN,200862,Agence_mtn_Cotonou,300000,99138,Olivier Benard,803511,1004373,2022-04-03
CASH_IN,7662,Agence_mtn_Cotonou,300000,292338,Olivier Benard,1004373,1012035,2022-04-04
TRANSFER,477739,Olivier Benard,1012035,534296,Nathalie Da Silva,59427,-418312,2022-04-05
TRANSFER,301113,Olivier Benard,534296,233183,Corinne Roussel,173455,-127658,2022-04-06
CASH_IN,36159,Agence_mtn_Ouidah,300000,263841,Olivier Benard,233183,269342,2022-04-06
CASH_IN,88400,Agence_mtn_Cotonou,300000,211600,Olivier Benard,269342,357742,2022-04-07
CASH_OUT,184535,Olivier Benard,357742,173207,Agence_mtn_Ouidah,300000,115465,2022-04-08
TRANSFER,312605,Nicole Huet,560641,248036,Olivier Benard,173207,485812,2022-04-09
CASH_OUT,212004,Olivier Benard,485812,273808,Agence_mtn_Abomey,300000,87996,2022-04-09
CASH_OUT,12248,Olivier Benard,273808,261560,Agence_mtn_Cotonou,300000,287752,2022-04-11
CASH_IN,53871,Agence_mtn_Abomey,300000,246129,Olivier Benard,261560,315431,2022-04-12
TRANSFER,66383,Olivier Benard,315431,249048,Clémence Dufour,29824,-36559,2022-04-13
CASH_OUT,177823,Olivier Benard,249048,71225,Agence_mtn_Cotonou,300000,122177,2022-04-14
CASH_OUT,23108,Olivier Benard,71225,48117,Agence_mtn_Ouidah,300000,276892,2022-04-14
CASH_OUT,22695,Olivier Benard,48117,25422,Agence_mtn_Cotonou,300000,277305,2022-04-16
CASH_OUT,8484,Olivier Benard,25422,16938,Agence_mtn_Ouidah,300000,291516,2022-04-17
CASH_OUT,12047,Olivier Benard,16938,4891,Agence_mtn_Ouidah,300000,287953,2022-04-17
TRANSFER,14408,Élise Monnier,27809,13401,Olivier Benard,4891,19299,2022-04-17
TRANSFER,18897,Olivier Benard,19299,402,Pénélope Boulay,23400,4503,2022-04-18
CASH_OUT,284,Olivier Benard,402,118,Agence_mtn_Abomey,300000,299716,2022-04-18
TRANSFER,105,Olivier Benard,118,13,Louise-Aurore Payet,965916,965811,2022-04-19
CASH_IN,169700,Agence_mtn_Cotonou,300000,130300,Olivier Benard,13,169713,2022-04-19
CASH_IN,91265,Agence_mtn_Ouidah,300000,208735,Olivier Benard,169713,260978,2022-04-20
CASH_OUT,248999,Olivier Benard,260978,11979,Agence_mtn_Abomey,300000,51001,2022-04-24
CASH_OUT,2045,Olivier Benard,11979,9934,Agence_mtn_Abomey,300000,297955,2022-04-25
TRANSFER,5130,Olivier Benard,9934,4804,Guillaume de la Nguyen,122024,116894,2022-04-27
CASH_IN,219090,Agence_mtn_Abomey,300000,80910,Olivier Benard,4804,223894,2022-04-27
CASH_IN,89568,Agence_mtn_Cotonou,300000,210432,Georges Muller,477549,567117,2022-04-01
CASH_IN,251166,Agence_mtn_Ouidah,300000,48834,Georges Muller,567117,818283,2022-04-01
CASH_IN,208052,Agence_mtn_Cotonou,300000,91948,Georges Muller,818283,1026335,2022-04-01
CASH_IN,260822,Agence_mtn_Cotonou,300000,39178,Georges Muller,1026335,1287157,2022-04-02
CASH_OUT,675962,Georges Muller,1287157,611195,Agence_mtn_Cotonou,300000,-375962,2022-04-03
CASH_IN,148681,Agence_mtn_Ouidah,300000,151319,Georges Muller,611195,759876,2022-04-03
CASH_IN,38499,Agence_mtn_Cotonou,300000,261501,Georges Muller,759876,798375,2022-04-03
CASH_OUT,267577,Georges Muller,798375,530798,Agence_mtn_Ouidah,300000,32423,2022-04-03
CASH_IN,108899,Agence_mtn_Abomey,300000,191101,Georges Muller,530798,639697,2022-04-07
CASH_OUT,591610,Georges Muller,639697,48087,Agence_mtn_Cotonou,300000,-291610,2022-04-08
CASH_IN,12220,Agence_mtn_Abomey,300000,287780,Georges Muller,48087,60307,2022-04-09
CASH_OUT,10515,Georges Muller,60307,49792,Agence_mtn_Ouidah,300000,289485,2022-04-09
CASH_OUT,49578,Georges Muller,49792,214,Agence_mtn_Abomey,300000,250422,2022-04-11
CASH_IN,63918,Agence_mtn_Abomey,300000,236082,Georges Muller,214,64132,2022-04-12
TRANSFER,115859,Anouk Delahaye-Gimenez,865942,750083,Georges Muller,64132,179991,2022-04-14
CASH_IN,147273,Agence_mtn_Abomey,300000,152727,Georges Muller,179991,327264,2022-04-14
CASH_OUT,308641,Georges Muller,327264,18623,Agence_mtn_Abomey,300000,-8641,2022-04-15
CASH_OUT,4767,Georges Muller,18623,13856,Agence_mtn_Abomey,300000,295233,2022-04-15
TRANSFER,151383,Céline-Inès Meunier,1057797,906414,Georges Muller,13856,165239,2022-04-16
CASH_IN,266079,Agence_mtn_Cotonou,300000,33921,Georges Muller,165239,431318,2022-04-17
CASH_IN,51061,Agence_mtn_Abomey,300000,248939,Georges Muller,431318,482379,2022-04-18
CASH_OUT,415386,Georges Muller,482379,66993,Agence_mtn_Abomey,300000,-115386,2022-04-18
TRANSFER,107376,Élisabeth Delattre,705747,598371,Georges Muller,66993,174369,2022-04-19
CASH_IN,110413,Agence_mtn_Abomey,300000,189587,Georges Muller,174369,284782,2022-04-19
CASH_IN,211305,Agence_mtn_Abomey,300000,88695,Georges Muller,284782,496087,2022-04-24
CASH_OUT,251566,Georges Muller,496087,244521,Agence_mtn_Ouidah,300000,48434,2022-04-25
CASH_IN,89775,Agence_mtn_Abomey,300000,210225,Georges Muller,244521,334296,2022-04-25
CASH_OUT,43222,Georges Muller,334296,291074,Agence_mtn_Cotonou,300000,256778,2022-04-26
CASH_IN,35670,Agence_mtn_Ouidah,300000,264330,Georges Muller,291074,326744,2022-04-27
CASH_OUT,285142,Georges Muller,326744,41602,Agence_mtn_Ouidah,300000,14858,2022-04-27
CASH_IN,133947,Agence_mtn_Ouidah,300000,166053,Julien Devaux,-985271,-851324,2022-04-01
CASH_IN,167841,Agence_mtn_Cotonou,300000,132159,Julien Devaux,-851324,-683483,2022-04-01
CASH_IN,168459,Agence_mtn_Abomey,300000,131541,Julien Devaux,-683483,-515024,2022-04-01
CASH_IN,132214,Agence_mtn_Cotonou,300000,167786,Julien Devaux,-515024,-382810,2022-04-04
CASH_IN,113724,Agence_mtn_Abomey,300000,186276,Julien Devaux,-382810,-269086,2022-04-06
CASH_IN,109067,Agence_mtn_Ouidah,300000,190933,Julien Devaux,-269086,-160019,2022-04-06
CASH_IN,64777,Agence_mtn_Ouidah,300000,235223,Julien Devaux,-160019,-95242,2022-04-06
CASH_IN,219743,Agence_mtn_Cotonou,300000,80257,Julien Devaux,-95242,124501,2022-04-09
CASH_IN,91097,Agence_mtn_Cotonou,300000,208903,Julien Devaux,124501,215598,2022-04-09
TRANSFER,183604,Julien Devaux,215598,31994,Honoré de la Prévost,1096475,912871,2022-04-11
TRANSFER,28187,Julien Devaux,31994,3807,Julie Germain Le Vaillant,995572,967385,2022-04-13
CASH_OUT,2789,Julien Devaux,3807,1018,Agence_mtn_Ouidah,300000,297211,2022-04-13
CASH_IN,251725,Agence_mtn_Ouidah,300000,48275,Julien Devaux,1018,252743,2022-04-14
CASH_IN,3588,Agence_mtn_Abomey,300000,296412,Julien Devaux,252743,256331,2022-04-15
CASH_OUT,252356,Julien Devaux,256331,3975,Agence_mtn_Ouidah,300000,47644,2022-04-17
CASH_IN,58286,Agence_mtn_Cotonou,300000,241714,Julien Devaux,3975,62261,2022-04-17
TRANSFER,26815,Julien Devaux,62261,35446,Louise-Aurore Payet,965811,938996,2022-04-17
CASH_IN,5425,Agence_mtn_Ouidah,300000,294575,Julien Devaux,35446,40871,2022-04-18
CASH_IN,81267,Agence_mtn_Ouidah,300000,218733,Julien Devaux,40871,122138,2022-04-19
TRANSFER,108411,Julien Devaux,122138,13727,Louis du Boyer,307016,198605,2022-04-19
TRANSFER,9568,Françoise Denis de Allard,11541,1973,Julien Devaux,13727,23295,2022-04-19
CASH_IN,80108,Agence_mtn_Ouidah,300000,219892,Julien Devaux,23295,103403,2022-04-21
CASH_IN,162889,Agence_mtn_Cotonou,300000,137111,Julien Devaux,103403,266292,2022-04-23
CASH_OUT,107003,Julien Devaux,266292,159289,Agence_mtn_Cotonou,300000,192997,2022-04-23
CASH_OUT,157702,Julien Devaux,159289,1587,Agence_mtn_Cotonou,300000,142298,2022-04-24
CASH_OUT,438,Julien Devaux,1587,1149,Agence_mtn_Abomey,300000,299562,2022-04-25
CASH_OUT,201,Julien Devaux,1149,948,Agence_mtn_Abomey,300000,299799,2022-04-25
CASH_OUT,314,Julien Devaux,948,634,Agence_mtn_Abomey,300000,299686,2022-04-26
CASH_IN,264534,Agence_mtn_Abomey,300000,35466,Julien Devaux,634,265168,2022-04-27
TRANSFER,7657,Sylvie Dupré,18686,11029,Josette du Hamon,5466,13123,2022-04-01
CASH_IN,72156,Agence_mtn_Abomey,300000,227844,Josette du Hamon,13123,85279,2022-04-01
TRANSFER,82864,Margaud-Michelle Briand,173353,90489,Josette du Hamon,85279,168143,2022-04-03
CASH_IN,40936,Agence_mtn_Abomey,300000,259064,Josette du Hamon,168143,209079,2022-04-06
TRANSFER,330,Pénélope Boulay,4503,4173,Josette du Hamon,209079,209409,2022-04-06
TRANSFER,69544,Josette du Hamon,209409,139865,Françoise Denis de Allard,1973,-67571,2022-04-08
CASH_IN,145762,Agence_mtn_Abomey,300000,154238,Josette du Hamon,139865,285627,2022-04-09
TRANSFER,50118,Louis du Boyer,198605,148487,Josette du Hamon,285627,335745,2022-04-09
CASH_IN,87698,Agence_mtn_Ouidah,300000,212302,Josette du Hamon,335745,423443,2022-04-11
CASH_IN,87527,Agence_mtn_Cotonou,300000,212473,Josette du Hamon,423443,510970,2022-04-13
CASH_OUT,195394,Josette du Hamon,510970,315576,Agence_mtn_Abomey,300000,104606,2022-04-13
CASH_OUT,7322,Josette du Hamon,315576,308254,Agence_mtn_Ouidah,300000,292678,2022-04-14
CASH_OUT,177352,Josette du Hamon,308254,130902,Agence_mtn_Abomey,300000,122648,2022-04-14
CASH_OUT,114124,Josette du Hamon,130902,16778,Agence_mtn_Ouidah,300000,185876,2022-04-15
CASH_OUT,16305,Josette du Hamon,16778,473,Agence_mtn_Cotonou,300000,283695,2022-04-18
TRANSFER,299,Josette du Hamon,473,174,Emmanuel Legrand,1204166,1203867,2022-04-19
CASH_IN,60983,Agence_mtn_Cotonou,300000,239017,Josette du Hamon,174,61157,2022-04-20
CASH_OUT,52826,Josette du Hamon,61157,8331,Agence_mtn_Abomey,300000,247174,2022-04-20
CASH_IN,173181,Agence_mtn_Abomey,300000,126819,Josette du Hamon,8331,181512,2022-04-23
CASH_OUT,62997,Josette du Hamon,181512,118515,Agence_mtn_Cotonou,300000,237003,2022-04-23
TRANSFER,86891,Josette du Hamon,118515,31624,Henri de Didier,1286087,1199196,2022-04-23
TRANSFER,3830,Josette du Hamon,31624,27794,Pénélope Boulay,4173,343,2022-04-24
CASH_IN,278190,Agence_mtn_Ouidah,300000,21810,Josette du Hamon,27794,305984,2022-04-27
CASH_IN,28884,Agence_mtn_Abomey,300000,271116,Josette du Hamon,305984,334868,2022-04-27
CASH_IN,235768,Agence_mtn_Abomey,300000,64232,Charles Guérin,-545961,-310193,2022-04-02
CASH_IN,122476,Agence_mtn_Cotonou,300000,177524,Charles Guérin,-310193,-187717,2022-04-05
CASH_IN,164360,Agence_mtn_Abomey,300000,135640,Charles Guérin,-187717,-23357,2022-04-06
CASH_IN,117860,Agence_mtn_Ouidah,300000,182140,Charles Guérin,-23357,94503,2022-04-06
CASH_IN,186308,Agence_mtn_Ouidah,300000,113692,Charles Guérin,94503,280811,2022-04-07
TRANSFER,56830,Charles Guérin,280811,223981,Sophie-Anouk Boulanger,34810,-22020,2022-04-07
CASH_OUT,56241,Charles Guérin,223981,167740,Agence_mtn_Cotonou,300000,243759,2022-04-10
CASH_IN,10199,Agence_mtn_Abomey,300000,289801,Charles Guérin,167740,177939,2022-04-10
TRANSFER,173904,Charles Guérin,177939,4035,Roger-Roger Delmas,105578,-68326,2022-04-10
CASH_IN,125505,Agence_mtn_Abomey,300000,174495,Charles Guérin,4035,129540,2022-04-12
TRANSFER,96598,Honoré de la Prévost,912871,816273,Charles Guérin,129540,226138,2022-04-12
CASH_IN,71761,Agence_mtn_Cotonou,300000,228239,Charles Guérin,226138,297899,2022-04-16
TRANSFER,297602,Maryse Delorme,379405,81803,Charles Guérin,297899,595501,2022-04-17
TRANSFER,134728,Julie Germain Le Vaillant,967385,832657,Charles Guérin,595501,730229,2022-04-20
CASH_IN,132631,Agence_mtn_Cotonou,300000,167369,Charles Guérin,730229,862860,2022-04-20
CASH_IN,164145,Agence_mtn_Ouidah,300000,135855,Charles Guérin,862860,1027005,2022-04-21
CASH_IN,104094,Agence_mtn_Cotonou,300000,195906,Charles Guérin,1027005,1131099,2022-04-21
CASH_IN,118312,Agence_mtn_Ouidah,300000,181688,Charles Guérin,1131099,1249411,2022-04-23
CASH_OUT,1079819,Charles Guérin,1249411,169592,Agence_mtn_Cotonou,300000,-779819,2022-04-27
CASH_OUT,43614,Charles Guérin,169592,125978,Agence_mtn_Ouidah,300000,256386,2022-04-27
CASH_IN,234085,Agence_mtn_Cotonou,300000,65915,Françoise Denis de Allard,-67571,166514,2022-04-05
CASH_OUT,3257,Françoise Denis de Allard,166514,163257,Agence_mtn_Cotonou,300000,296743,2022-04-09
CASH_OUT,40763,Françoise Denis de Allard,163257,122494,Agence_mtn_Ouidah,300000,259237,2022-04-11
CASH_IN,251099,Agence_mtn_Cotonou,300000,48901,Françoise Denis de Allard,122494,373593,2022-04-12
TRANSFER,29911,Françoise Denis de Allard,373593,343682,Marc Baudry,215160,185249,2022-04-17
CASH_IN,50801,Agence_mtn_Abomey,300000,249199,Françoise Denis de Allard,343682,394483,2022-04-19
CASH_IN,26135,Agence_mtn_Cotonou,300000,273865,Françoise Denis de Allard,394483,420618,2022-04-23
CASH_IN,235783,Agence_mtn_Cotonou,300000,64217,Françoise Denis de Allard,420618,656401,2022-04-24
CASH_IN,129891,Agence_mtn_Abomey,300000,170109,Françoise Denis de Allard,656401,786292,2022-04-24
TRANSFER,504713,Françoise Denis de Allard,786292,281579,Simone du Allard,57318,-447395,2022-04-26
CASH_IN,287297,Agence_mtn_Cotonou,300000,12703,Marc Baudry,185249,472546,2022-04-02
CASH_OUT,231023,Marc Baudry,472546,241523,Agence_mtn_Cotonou,300000,68977,2022-04-02
CASH_OUT,64006,Marc Baudry,241523,177517,Agence_mtn_Cotonou,300000,235994,2022-04-06
TRANSFER,43294,Marc Baudry,177517,134223,Gabrielle Hamon,693196,649902,2022-04-07
TRANSFER,106745,Maurice de Brunet,128493,21748,Marc Baudry,134223,240968,2022-04-07
CASH_OUT,204513,Marc Baudry,240968,36455,Agence_mtn_Ouidah,300000,95487,2022-04-08
CASH_OUT,30751,Marc Baudry,36455,5704,Agence_mtn_Abomey,300000,269249,2022-04-10
CASH_IN,98155,Agence_mtn_Ouidah,300000,201845,Marc Baudry,5704,103859,2022-04-11
CASH_OUT,45176,Marc Baudry,103859,58683,Agence_mtn_Ouidah,300000,254824,2022-04-14
TRANSFER,5077,Élise Monnier,13401,8324,Marc Baudry,58683,63760,2022-04-15
CASH_IN,14337,Agence_mtn_Cotonou,300000,285663,Marc Baudry,63760,78097,2022-04-15
CASH_IN,76422,Agence_mtn_Ouidah,300000,223578,Marc Baudry,78097,154519,2022-04-16
TRANSFER,90757,Marc Baudry,154519,63762,Astrid de Pascal,61264,-29493,2022-04-17
CASH_OUT,20908,Marc Baudry,63762,42854,Agence_mtn_Ouidah,300000,279092,2022-04-20
TRANSFER,35964,Marc Baudry,42854,6890,Maurice de Brunet,21748,-14216,2022-04-21
CASH_OUT,1522,Marc Baudry,6890,5368,Agence_mtn_Abomey,300000,298478,2022-04-22
TRANSFER,3890,Sylvie Dupré,11029,7139,Marc Baudry,5368,9258,2022-04-23
CASH_IN,13364,Agence_mtn_Abomey,300000,286636,Marc Baudry,9258,22622,2022-04-24
CASH_IN,125625,Agence_mtn_Cotonou,300000,174375,Marc Baudry,22622,148247,2022-04-25
CASH_IN,159459,Agence_mtn_Cotonou,300000,140541,Roger-Roger Delmas,-68326,91133,2022-04-03
CASH_IN,49286,Agence_mtn_Cotonou,300000,250714,Roger-Roger Delmas,91133,140419,2022-04-04
TRANSFER,45902,Roger-Roger Delmas,140419,94517,Henri de Didier,1199196,1153294,2022-04-06
TRANSFER,68660,Roger-Roger Delmas,94517,25857,Raymond-Yves Boulanger,2477,-66183,2022-04-12
CASH_OUT,16879,Roger-Roger Delmas,25857,8978,Agence_mtn_Ouidah,300000,283121,2022-04-12
CASH_IN,137983,Agence_mtn_Ouidah,300000,162017,Roger-Roger Delmas,8978,146961,2022-04-14
TRANSFER,106,Pénélope Boulay,343,237,Roger-Roger Delmas,146961,147067,2022-04-14
CASH_OUT,16614,Roger-Roger Delmas,147067,130453,Agence_mtn_Cotonou,300000,283386,2022-04-15
CASH_IN,284322,Agence_mtn_Abomey,300000,15678,Roger-Roger Delmas,130453,414775,2022-04-16
CASH_IN,58312,Agence_mtn_Abomey,300000,241688,Roger-Roger Delmas,414775,473087,2022-04-17
CASH_IN,205030,Agence_mtn_Cotonou,300000,94970,Roger-Roger Delmas,473087,678117,2022-04-19
CASH_IN,77995,Agence_mtn_Ouidah,300000,222005,Roger-Roger Delmas,678117,756112,2022-04-21
CASH_OUT,315859,Roger-Roger Delmas,756112,440253,Agence_mtn_Abomey,300000,-15859,2022-04-22
CASH_OUT,117025,Roger-Roger Delmas,440253,323228,Agence_mtn_Abomey,300000,182975,2022-04-27
CASH_IN,37434,Agence_mtn_Abomey,300000,262566,Robert Henry-Poulain,-240968,-203534,2022-04-01
CASH_IN,151300,Agence_mtn_Ouidah,300000,148700,Robert Henry-Poulain,-203534,-52234,2022-04-02
CASH_IN,62220,Agence_mtn_Ouidah,300000,237780,Robert Henry-Poulain,-52234,9986,2022-04-03
CASH_OUT,8258,Robert Henry-Poulain,9986,1728,Agence_mtn_Abomey,300000,291742,2022-04-03
CASH_OUT,584,Robert Henry-Poulain,1728,1144,Agence_mtn_Ouidah,300000,299416,2022-04-06
TRANSFER,10611,Aurélie Maury,158451,147840,Robert Henry-Poulain,1144,11755,2022-04-07
TRANSFER,3338,Robert Henry-Poulain,11755,8417,Marine Labbé,1687738,1684400,2022-04-12
TRANSFER,8340,Robert Henry-Poulain,8417,77,Louis du Boyer,148487,140147,2022-04-14
CASH_IN,144039,Agence_mtn_Abomey,300000,155961,Robert Henry-Poulain,77,144116,2022-04-14
CASH_OUT,46292,Robert Henry-Poulain,144116,97824,Agence_mtn_Ouidah,300000,253708,2022-04-17
TRANSFER,14870,Robert Henry-Poulain,97824,82954,Nicole Huet,248036,233166,2022-04-18
CASH_OUT,74434,Robert Henry-Poulain,82954,8520,Agence_mtn_Abomey,300000,225566,2022-04-18
TRANSFER,242,Emmanuelle Le Allain,355,113,Robert Henry-Poulain,8520,8762,2022-04-21
CASH_OUT,7651,Robert Henry-Poulain,8762,1111,Agence_mtn_Abomey,300000,292349,2022-04-22
TRANSFER,516,Robert Henry-Poulain,1111,595,Margaud-Michelle Briand,90489,89973,2022-04-26
CASH_IN,283187,Agence_mtn_Ouidah,300000,16813,Robert Henry-Poulain,595,283782,2022-04-27
TRANSFER,55032,Guillaume de la Nguyen,116894,61862,Alfred Paris,426595,371563,2022-04-02
TRANSFER,56865,Guillaume de la Nguyen,61862,4997,Julie Germain Le Vaillant,832657,775792,2022-04-03
CASH_OUT,3248,Guillaume de la Nguyen,4997,1749,Agence_mtn_Ouidah,300000,296752,2022-04-04
TRANSFER,223,Pénélope Boulay,237,14,Guillaume de la Nguyen,1749,1972,2022-04-05
CASH_IN,49763,Agence_mtn_Abomey,300000,250237,Guillaume de la Nguyen,1972,51735,2022-04-09
CASH_OUT,8912,Guillaume de la Nguyen,51735,42823,Agence_mtn_Ouidah,300000,291088,2022-04-11
CASH_IN,230992,Agence_mtn_Abomey,300000,69008,Guillaume de la Nguyen,42823,273815,2022-04-11
CASH_OUT,210917,Guillaume de la Nguyen,273815,62898,Agence_mtn_Cotonou,300000,89083,2022-04-12
CASH_OUT,32666,Guillaume de la Nguyen,62898,30232,Agence_mtn_Cotonou,300000,267334,2022-04-13
CASH_IN,52428,Agence_mtn_Ouidah,300000,247572,Guillaume de la Nguyen,30232,82660,2022-04-14
CASH_OUT,27171,Guillaume de la Nguyen,82660,55489,Agence_mtn_Abomey,300000,272829,2022-04-15
CASH_IN,277572,Agence_mtn_Ouidah,300000,22428,Guillaume de la Nguyen,55489,333061,2022-04-17
TRANSFER,13646,Guillaume de la Nguyen,333061,319415,Aurélie Maury,147840,134194,2022-04-17
TRANSFER,23619,Maryse Delorme,81803,58184,Guillaume de la Nguyen,319415,343034,2022-04-19
TRANSFER,321220,Guillaume de la Nguyen,343034,21814,Emmanuelle Le Allain,113,-321107,2022-04-23
CASH_IN,271159,Agence_mtn_Abomey,300000,28841,Guillaume de la Nguyen,21814,292973,2022-04-24
CASH_OUT,41350,Guillaume de la Nguyen,292973,251623,Agence_mtn_Ouidah,300000,258650,2022-04-25
CASH_IN,19052,Agence_mtn_Cotonou,300000,280948,Guillaume de la Nguyen,251623,270675,2022-04-25
TRANSFER,76051,Éléonore Marin Le Morel,90080,14029,Guillaume de la Nguyen,270675,346726,2022-04-25
CASH_OUT,244012,Guillaume de la Nguyen,346726,102714,Agence_mtn_Abomey,300000,55988,2022-04-26
CASH_IN,42894,Agence_mtn_Ouidah,300000,257106,Marine Chevallier,-535524,-492630,2022-04-02
CASH_IN,80328,Agence_mtn_Ouidah,300000,219672,Marine Chevallier,-492630,-412302,2022-04-04
CASH_IN,210656,Agence_mtn_Abomey,300000,89344,Marine Chevallier,-412302,-201646,2022-04-04
CASH_IN,45332,Agence_mtn_Cotonou,300000,254668,Marine Chevallier,-201646,-156314,2022-04-07
CASH_IN,151364,Agence_mtn_Cotonou,300000,148636,Marine Chevallier,-156314,-4950,2022-04-08
CASH_IN,206642,Agence_mtn_Ouidah,300000,93358,Marine Chevallier,-4950,201692,2022-04-09
CASH_OUT,10338,Marine Chevallier,201692,191354,Agence_mtn_Ouidah,300000,289662,2022-04-16
CASH_OUT,108518,Marine Chevallier,191354,82836,Agence_mtn_Ouidah,300000,191482,2022-04-25
CASH_OUT,52104,Marine Chevallier,82836,30732,Agence_mtn_Abomey,300000,247896,2022-04-26
CASH_IN,20349,Agence_mtn_Cotonou,300000,279651,Marine Chevallier,30732,51081,2022-04-27
CASH_IN,219773,Agence_mtn_Abomey,300000,80227,Marine Chevallier,51081,270854,2022-04-27
CASH_IN,169451,Agence_mtn_Ouidah,300000,130549,Marthe Perrin,-717659,-548208,2022-04-02
CASH_IN,95329,Agence_mtn_Cotonou,300000,204671,Marthe Perrin,-548208,-452879,2022-04-03
CASH_IN,256875,Agence_mtn_Abomey,300000,43125,Marthe Perrin,-452879,-196004,2022-04-06
CASH_IN,33013,Agence_mtn_Abomey,300000,266987,Marthe Perrin,-196004,-162991,2022-04-06
CASH_IN,279036,Agence_mtn_Abomey,300000,20964,Marthe Perrin,-162991,116045,2022-04-07
CASH_OUT,97333,Marthe Perrin,116045,18712,Agence_mtn_Abomey,300000,202667,2022-04-08
TRANSFER,4132,Maryse Delorme,58184,54052,Marthe Perrin,18712,22844,2022-04-11
TRANSFER,562,Marthe Perrin,22844,22282,Marc Costa-Daniel,863589,863027,2022-04-11
TRANSFER,665536,Louise-Aurore Payet,938996,273460,Marthe Perrin,22282,687818,2022-04-13
TRANSFER,46553,Marthe Perrin,687818,641265,Élise Monnier,8324,-38229,2022-04-15
CASH_IN,289579,Agence_mtn_Cotonou,300000,10421,Marthe Perrin,641265,930844,2022-04-16
CASH_IN,85872,Agence_mtn_Ouidah,300000,214128,Marthe Perrin,930844,1016716,2022-04-18
CASH_OUT,102470,Marthe Perrin,1016716,914246,Agence_mtn_Ouidah,300000,197530,2022-04-21
CASH_OUT,219337,Marthe Perrin,914246,694909,Agence_mtn_Cotonou,300000,80663,2022-04-21
TRANSFER,1374635,Marine Labbé,1684400,309765,Marthe Perrin,694909,2069544,2022-04-21
CASH_IN,273496,Agence_mtn_Cotonou,300000,26504,Marthe Perrin,2069544,2343040,2022-04-22
TRANSFER,492779,Anouk Delahaye-Gimenez,750083,257304,Marthe Perrin,2343040,2835819,2022-04-22
CASH_OUT,2106374,Marthe Perrin,2835819,729445,Agence_mtn_Ouidah,300000,-1806374,2022-04-24
CASH_IN,229638,Agence_mtn_Cotonou,300000,70362,Marthe Perrin,729445,959083,2022-04-26
CASH_IN,5747,Agence_mtn_Abomey,300000,294253,Emmanuelle Le Allain,-321107,-315360,2022-04-01
CASH_IN,107556,Agence_mtn_Cotonou,300000,192444,Emmanuelle Le Allain,-315360,-207804,2022-04-03
CASH_IN,246297,Agence_mtn_Abomey,300000,53703,Emmanuelle Le Allain,-207804,38493,2022-04-04
CASH_OUT,23237,Emmanuelle Le Allain,38493,15256,Agence_mtn_Ouidah,300000,276763,2022-04-04
CASH_IN,247847,Agence_mtn_Ouidah,300000,52153,Emmanuelle Le Allain,15256,263103,2022-04-05
CASH_IN,80231,Agence_mtn_Ouidah,300000,219769,Emmanuelle Le Allain,263103,343334,2022-04-07
CASH_IN,210152,Agence_mtn_Cotonou,300000,89848,Emmanuelle Le Allain,343334,553486,2022-04-07
CASH_IN,158623,Agence_mtn_Abomey,300000,141377,Emmanuelle Le Allain,553486,712109,2022-04-10
TRANSFER,107462,Aurélie Maury,134194,26732,Emmanuelle Le Allain,712109,819571,2022-04-11
CASH_IN,257915,Agence_mtn_Abomey,300000,42085,Emmanuelle Le Allain,819571,1077486,2022-04-14
TRANSFER,136173,Nicole Huet,233166,96993,Emmanuelle Le Allain,1077486,1213659,2022-04-15
TRANSFER,536364,Emmanuelle Le Allain,1213659,677295,Maryse Delorme,54052,-482312,2022-04-15
CASH_IN,163256,Agence_mtn_Cotonou,300000,136744,Emmanuelle Le Allain,677295,840551,2022-04-17
TRANSFER,216211,Emmanuelle Le Allain,840551,624340,Louise-Aurore Payet,273460,57249,2022-04-17
TRANSFER,113514,Emmanuelle Le Allain,624340,510826,Éléonore Marin Le Morel,14029,-99485,2022-04-18
CASH_OUT,403761,Emmanuelle Le Allain,510826,107065,Agence_mtn_Cotonou,300000,-103761,2022-04-19
CASH_IN,257898,Agence_mtn_Ouidah,300000,42102,Emmanuelle Le Allain,107065,364963,2022-04-20
CASH_OUT,33038,Emmanuelle Le Allain,364963,331925,Agence_mtn_Ouidah,300000,266962,2022-04-22
CASH_OUT,235020,Emmanuelle Le Allain,331925,96905,Agence_mtn_Cotonou,300000,64980,2022-04-22
CASH_IN,216297,Agence_mtn_Cotonou,300000,83703,Thibault-Julien Chevallier,-495870,-279573,2022-04-01
CASH_IN,262724,Agence_mtn_Cotonou,300000,37276,Thibault-Julien Chevallier,-279573,-16849,2022-04-01
CASH_IN,70891,Agence_mtn_Ouidah,300000,229109,Thibault-Julien Chevallier,-16849,54042,2022-04-04
TRANSFER,110336,Michèle Faivre,579686,469350,Thibault-Julien Chevallier,54042,164378,2022-04-04
CASH_OUT,159297,Thibault-Julien Chevallier,164378,5081,Agence_mtn_Cotonou,300000,140703,2022-04-06
CASH_IN,114274,Agence_mtn_Ouidah,300000,185726,Thibault-Julien Chevallier,5081,119355,2022-04-08
CASH_OUT,36544,Thibault-Julien Chevallier,119355,82811,Agence_mtn_Abomey,300000,263456,2022-04-10
CASH_IN,147900,Agence_mtn_Cotonou,300000,152100,Thibault-Julien Chevallier,82811,230711,2022-04-11
TRANSFER,152807,Thibault-Julien Chevallier,230711,77904,Aurélie Maury,26732,-126075,2022-04-14
TRANSFER,30180,Thibault-Julien Chevallier,77904,47724,Élisabeth Delattre,598371,568191,2022-04-16
CASH_IN,164456,Agence_mtn_Ouidah,300000,135544,Thibault-Julien Chevallier,47724,212180,2022-04-17
CASH_IN,41975,Agence_mtn_Cotonou,300000,258025,Thibault-Julien Chevallier,212180,254155,2022-04-17
CASH_IN,149116,Agence_mtn_Cotonou,300000,150884,Thibault-Julien Chevallier,254155,403271,2022-04-19
TRANSFER,10565,Louise-Aurore Payet,57249,46684,Thibault-Julien Chevallier,403271,413836,2022-04-19
TRANSFER,336975,Élisabeth Delattre,568191,231216,Thibault-Julien Chevallier,413836,750811,2022-04-20
CASH_OUT,733084,Thibault-Julien Chevallier,750811,17727,Agence_mtn_Abomey,300000,-433084,2022-04-24
CASH_IN,245949,Agence_mtn_Ouidah,300000,54051,Thibault-Julien Chevallier,17727,263676,2022-04-25
CASH_IN,19362,Agence_mtn_Cotonou,300000,280638,Thibault-Julien Chevallier,263676,283038,2022-04-25
CASH_IN,190331,Agence_mtn_Cotonou,300000,109669,Thibault-Julien Chevallier,283038,473369,2022-04-25
TRANSFER,3861,Thibault-Julien Chevallier,473369,469508,Julie Germain Le Vaillant,775792,771931,2022-04-27
CASH_IN,208871,Agence_mtn_Cotonou,300000,91129,Louis du Boyer,140147,349018,2022-04-01
CASH_OUT,2532,Louis du Boyer,349018,346486,Agence_mtn_Cotonou,300000,297468,2022-04-08
CASH_OUT,17398,Louis du Boyer,346486,329088,Agence_mtn_Cotonou,300000,282602,2022-04-08
CASH_IN,14499,Agence_mtn_Abomey,300000,285501,Louis du Boyer,329088,343587,2022-04-09
CASH_OUT,215311,Louis du Boyer,343587,128276,Agence_mtn_Abomey,300000,84689,2022-04-10
CASH_OUT,24387,Louis du Boyer,128276,103889,Agence_mtn_Cotonou,300000,275613,2022-04-10
CASH_IN,54123,Agence_mtn_Abomey,300000,245877,Louis du Boyer,103889,158012,2022-04-10
CASH_IN,93087,Agence_mtn_Abomey,300000,206913,Louis du Boyer,158012,251099,2022-04-16
CASH_IN,113145,Agence_mtn_Ouidah,300000,186855,Louis du Boyer,251099,364244,2022-04-17
CASH_IN,152555,Agence_mtn_Abomey,300000,147445,Louis du Boyer,364244,516799,2022-04-18
TRANSFER,19047,Thibault Martin,24416,5369,Louis du Boyer,516799,535846,2022-04-19
TRANSFER,58655,Margaud-Michelle Briand,89973,31318,Louis du Boyer,535846,594501,2022-04-20
CASH_OUT,21620,Louis du Boyer,594501,572881,Agence_mtn_Abomey,300000,278380,2022-04-22
TRANSFER,639823,Julie Germain Le Vaillant,771931,132108,Louis du Boyer,572881,1212704,2022-04-23
CASH_IN,140914,Agence_mtn_Ouidah,300000,159086,Louis du Boyer,1212704,1353618,2022-04-23
CASH_OUT,256533,Louis du Boyer,1353618,1097085,Agence_mtn_Cotonou,300000,43467,2022-04-25
TRANSFER,860354,Louis du Boyer,1097085,236731,Emmanuel Legrand,1203867,343513,2022-04-26
CASH_OUT,4996,Sylvie Dupré,7139,2143,Agence_mtn_Cotonou,300000,295004,2022-04-02
CASH_OUT,919,Sylvie Dupré,2143,1224,Agence_mtn_Ouidah,300000,299081,2022-04-02
TRANSFER,140520,Emmanuel Legrand,343513,202993,Sylvie Dupré,1224,141744,2022-04-03
CASH_IN,261566,Agence_mtn_Abomey,300000,38434,Sylvie Dupré,141744,403310,2022-04-06
CASH_OUT,4539,Sylvie Dupré,403310,398771,Agence_mtn_Cotonou,300000,295461,2022-04-08
CASH_IN,292250,Agence_mtn_Ouidah,300000,7750,Sylvie Dupré,398771,691021,2022-04-08
CASH_OUT,562031,Sylvie Dupré,691021,128990,Agence_mtn_Cotonou,300000,-262031,2022-04-09
CASH_OUT,66489,Sylvie Dupré,128990,62501,Agence_mtn_Abomey,300000,233511,2022-04-10
CASH_IN,53483,Agence_mtn_Abomey,300000,246517,Sylvie Dupré,62501,115984,2022-04-12
CASH_IN,269059,Agence_mtn_Abomey,300000,30941,Sylvie Dupré,115984,385043,2022-04-14
TRANSFER,398715,Henri de Didier,1153294,754579,Sylvie Dupré,385043,783758,2022-04-16
CASH_OUT,597527,Sylvie Dupré,783758,186231,Agence_mtn_Ouidah,300000,-297527,2022-04-16
CASH_IN,258680,Agence_mtn_Abomey,300000,41320,Sylvie Dupré,186231,444911,2022-04-16
CASH_OUT,380243,Sylvie Dupré,444911,64668,Agence_mtn_Abomey,300000,-80243,2022-04-18
TRANSFER,14430,Sylvie Dupré,64668,50238,Thibault Martin,5369,-9061,2022-04-21
TRANSFER,42708,Sylvie Dupré,50238,7530,Michèle Faivre,469350,426642,2022-04-23
CASH_IN,117930,Agence_mtn_Cotonou,300000,182070,Sylvie Dupré,7530,125460,2022-04-25
CASH_IN,266012,Agence_mtn_Abomey,300000,33988,Maryse Delorme,-482312,-216300,2022-04-02
CASH_IN,144246,Agence_mtn_Abomey,300000,155754,Maryse Delorme,-216300,-72054,2022-04-02
CASH_IN,228492,Agence_mtn_Ouidah,300000,71508,Maryse Delorme,-72054,156438,2022-04-05
TRANSFER,153784,Maryse Delorme,156438,2654,Maryse Delorme,156438,2654,2022-04-06
TRANSFER,93751,Nicole Huet,96993,3242,Maryse Delorme,2654,96405,2022-04-07
CASH_OUT,49429,Maryse Delorme,96405,46976,Agence_mtn_Cotonou,300000,250571,2022-04-08
TRANSFER,737498,Henri de Didier,754579,17081,Maryse Delorme,46976,784474,2022-04-09
TRANSFER,167605,Élisabeth Delattre,231216,63611,Maryse Delorme,784474,952079,2022-04-13
CASH_OUT,60305,Maryse Delorme,952079,891774,Agence_mtn_Ouidah,300000,239695,2022-04-14
CASH_IN,111133,Agence_mtn_Abomey,300000,188867,Maryse Delorme,891774,1002907,2022-04-15
CASH_IN,54750,Agence_mtn_Ouidah,300000,245250,Maryse Delorme,1002907,1057657,2022-04-18
TRANSFER,207129,Maryse Delorme,1057657,850528,Alfred Paris,371563,164434,2022-04-18
TRANSFER,210811,Marine Labbé,309765,98954,Maryse Delorme,850528,1061339,2022-04-21
CASH_IN,218195,Agence_mtn_Cotonou,300000,81805,Maryse Delorme,1061339,1279534,2022-04-23
CASH_OUT,726534,Maryse Delorme,1279534,553000,Agence_mtn_Ouidah,300000,-426534,2022-04-23
CASH_OUT,356010,Maryse Delorme,553000,196990,Agence_mtn_Abomey,300000,-56010,2022-04-24
CASH_IN,7846,Agence_mtn_Cotonou,300000,292154,Pénélope Boulay,14,7860,2022-04-02
TRANSFER,1441,Pénélope Boulay,7860,6419,Michèle Faivre,426642,425201,2022-04-04
CASH_IN,209609,Agence_mtn_Ouidah,300000,90391,Pénélope Boulay,6419,216028,2022-04-04
CASH_IN,297082,Agence_mtn_Ouidah,300000,2918,Pénélope Boulay,216028,513110,2022-04-05
CASH_IN,143671,Agence_mtn_Abomey,300000,156329,Pénélope Boulay,513110,656781,2022-04-06
TRANSFER,451170,Pénélope Boulay,656781,205611,Marc Costa-Daniel,863027,411857,2022-04-10
CASH_IN,128978,Agence_mtn_Abomey,300000,171022,Pénélope Boulay,205611,334589,2022-04-13
CASH_IN,100564,Agence_mtn_Abomey,300000,199436,Pénélope Boulay,334589,435153,2022-04-14
TRANSFER,35330,Gabrielle Hamon,649902,614572,Pénélope Boulay,435153,470483,2022-04-16
TRANSFER,182898,Anouk Delahaye-Gimenez,257304,74406,Pénélope Boulay,470483,653381,2022-04-21
CASH_IN,126474,Agence_mtn_Ouidah,300000,173526,Pénélope Boulay,653381,779855,2022-04-22
TRANSFER,60850,Pénélope Boulay,779855,719005,Charlotte Perrier,159357,98507,2022-04-25
CASH_IN,39148,Agence_mtn_Ouidah,300000,260852,Pénélope Boulay,719005,758153,2022-04-26
CASH_IN,161110,Agence_mtn_Ouidah,300000,138890,Simone du Allard,-447395,-286285,2022-04-02
CASH_IN,156667,Agence_mtn_Abomey,300000,143333,Simone du Allard,-286285,-129618,2022-04-03
CASH_IN,285069,Agence_mtn_Abomey,300000,14931,Simone du Allard,-129618,155451,2022-04-06
TRANSFER,23253,Simone du Allard,155451,132198,Nicole Huet,3242,-20011,2022-04-07
CASH_OUT,8993,Simone du Allard,132198,123205,Agence_mtn_Ouidah,300000,291007,2022-04-10
CASH_OUT,73693,Simone du Allard,123205,49512,Agence_mtn_Cotonou,300000,226307,2022-04-13
TRANSFER,16232,Simone du Allard,49512,33280,Élisabeth Delattre,63611,47379,2022-04-14
CASH_IN,137483,Agence_mtn_Cotonou,300000,162517,Simone du Allard,33280,170763,2022-04-17
CASH_OUT,125989,Simone du Allard,170763,44774,Agence_mtn_Cotonou,300000,174011,2022-04-18
CASH_OUT,13039,Simone du Allard,44774,31735,Agence_mtn_Abomey,300000,286961,2022-04-22
CASH_OUT,27573,Simone du Allard,31735,4162,Agence_mtn_Abomey,300000,272427,2022-04-25
CASH_IN,275532,Agence_mtn_Ouidah,300000,24468,Simone du Allard,4162,279694,2022-04-25
CASH_OUT,64705,Simone du Allard,279694,214989,Agence_mtn_Abomey,300000,235295,2022-04-27
CASH_OUT,59683,Charlotte Perrier,98507,38824,Agence_mtn_Cotonou,300000,240317,2022-04-01
CASH_OUT,34902,Charlotte Perrier,38824,3922,Agence_mtn_Abomey,300000,265098,2022-04-04
CASH_OUT,3370,Charlotte Perrier,3922,552,Agence_mtn_Ouidah,300000,296630,2022-04-05
TRANSFER,426,Charlotte Perrier,552,126,Marine Labbé,98954,98528,2022-04-07
CASH_OUT,107,Charlotte Perrier,126,19,Agence_mtn_Cotonou,300000,299893,2022-04-08
CASH_IN,295985,Agence_mtn_Cotonou,300000,4015,Charlotte Perrier,19,296004,2022-04-11
TRANSFER,6226,Henri de Didier,17081,10855,Charlotte Perrier,296004,302230,2022-04-12
CASH_OUT,297531,Charlotte Perrier,302230,4699,Agence_mtn_Abomey,300000,2469,2022-04-14
CASH_IN,2115,Agence_mtn_Abomey,300000,297885,Charlotte Perrier,4699,6814,2022-04-16
CASH_OUT,459,Charlotte Perrier,6814,6355,Agence_mtn_Abomey,300000,299541,2022-04-20
TRANSFER,2877,Charlotte Perrier,6355,3478,Céline-Inès Meunier,906414,903537,2022-04-21
CASH_IN,60276,Agence_mtn_Abomey,300000,239724,Charlotte Perrier,3478,63754,2022-04-24
CASH_OUT,13490,Charlotte Perrier,63754,50264,Agence_mtn_Abomey,300000,286510,2022-04-25
CASH_IN,73324,Agence_mtn_Cotonou,300000,226676,Charlotte Perrier,50264,123588,2022-04-26
CASH_OUT,49425,Anouk Delahaye-Gimenez,74406,24981,Agence_mtn_Cotonou,300000,250575,2022-04-03
TRANSFER,645,Anouk Delahaye-Gimenez,24981,24336,Alfred Paris,164434,163789,2022-04-07
CASH_IN,247658,Agence_mtn_Ouidah,300000,52342,Anouk Delahaye-Gimenez,24336,271994,2022-04-08
CASH_IN,75931,Agence_mtn_Abomey,300000,224069,Anouk Delahaye-Gimenez,271994,347925,2022-04-14
TRANSFER,77805,Anouk Delahaye-Gimenez,347925,270120,Élisabeth Delattre,47379,-30426,2022-04-18
TRANSFER,340185,Marc Costa-Daniel,411857,71672,Anouk Delahaye-Gimenez,270120,610305,2022-04-18
CASH_IN,226907,Agence_mtn_Ouidah,300000,73093,Anouk Delahaye-Gimenez,610305,837212,2022-04-20
TRANSFER,168497,Céline-Inès Meunier,903537,735040,Anouk Delahaye-Gimenez,837212,1005709,2022-04-24
CASH_IN,161971,Agence_mtn_Abomey,300000,138029,Marcel de la Buisson,-314993,-153022,2022-04-05
CASH_IN,298059,Agence_mtn_Cotonou,300000,1941,Marcel de la Buisson,-153022,145037,2022-04-08
CASH_IN,207014,Agence_mtn_Cotonou,300000,92986,Marcel de la Buisson,145037,352051,2022-04-11
TRANSFER,176093,Marcel de la Buisson,352051,175958,Honoré de la Prévost,816273,640180,2022-04-13
CASH_OUT,153316,Marcel de la Buisson,175958,22642,Agence_mtn_Cotonou,300000,146684,2022-04-14
CASH_OUT,11390,Marcel de la Buisson,22642,11252,Agence_mtn_Cotonou,300000,288610,2022-04-14
TRANSFER,28968,Marc Costa-Daniel,71672,42704,Marcel de la Buisson,11252,40220,2022-04-14
CASH_OUT,32015,Marcel de la Buisson,40220,8205,Agence_mtn_Cotonou,300000,267985,2022-04-15
TRANSFER,24024,Marc Costa-Daniel,42704,18680,Marcel de la Buisson,8205,32229,2022-04-15
CASH_IN,93706,Agence_mtn_Cotonou,300000,206294,Marcel de la Buisson,32229,125935,2022-04-17
CASH_OUT,24402,Marcel de la Buisson,125935,101533,Agence_mtn_Cotonou,300000,275598,2022-04-17
TRANSFER,87242,Marcel de la Buisson,101533,14291,Marcel de la Buisson,101533,14291,2022-04-19
CASH_IN,292855,Agence_mtn_Cotonou,300000,7145,Marcel de la Buisson,14291,307146,2022-04-19
TRANSFER,115716,Marcel de la Buisson,307146,191430,Gabrielle Hamon,614572,498856,2022-04-19
CASH_OUT,129292,Marcel de la Buisson,191430,62138,Agence_mtn_Cotonou,300000,170708,2022-04-20
CASH_OUT,26952,Marcel de la Buisson,62138,35186,Agence_mtn_Abomey,300000,273048,2022-04-24
CASH_IN,9761,Agence_mtn_Cotonou,300000,290239,Marcel de la Buisson,35186,44947,2022-04-26
TRANSFER,35026,Marcel de la Buisson,44947,9921,Emmanuel Legrand,202993,167967,2022-04-27
CASH_IN,156424,Agence_mtn_Ouidah,300000,143576,Gabrielle Hamon,498856,655280,2022-04-01
CASH_OUT,397631,Gabrielle Hamon,655280,257649,Agence_mtn_Ouidah,300000,-97631,2022-04-02
TRANSFER,16613,Marc Costa-Daniel,18680,2067,Gabrielle Hamon,257649,274262,2022-04-09
CASH_IN,216186,Agence_mtn_Cotonou,300000,83814,Gabrielle Hamon,274262,490448,2022-04-09
CASH_IN,143326,Agence_mtn_Ouidah,300000,156674,Gabrielle Hamon,490448,633774,2022-04-10
TRANSFER,605569,Gabrielle Hamon,633774,28205,Margaud-Michelle Briand,31318,-574251,2022-04-10
CASH_IN,166044,Agence_mtn_Abomey,300000,133956,Gabrielle Hamon,28205,194249,2022-04-12
CASH_OUT,120260,Gabrielle Hamon,194249,73989,Agence_mtn_Ouidah,300000,179740,2022-04-12
CASH_IN,295523,Agence_mtn_Abomey,300000,4477,Gabrielle Hamon,73989,369512,2022-04-12
CASH_IN,61451,Agence_mtn_Ouidah,300000,238549,Gabrielle Hamon,369512,430963,2022-04-20
CASH_OUT,40804,Gabrielle Hamon,430963,390159,Agence_mtn_Cotonou,300000,259196,2022-04-23
CASH_OUT,224826,Gabrielle Hamon,390159,165333,Agence_mtn_Cotonou,300000,75174,2022-04-24
CASH_IN,83484,Agence_mtn_Cotonou,300000,216516,Matthieu Cousin,-47369,36115,2022-04-03
TRANSFER,34453,Matthieu Cousin,36115,1662,Matthieu Cousin,36115,1662,2022-04-08
CASH_IN,169482,Agence_mtn_Cotonou,300000,130518,Matthieu Cousin,1662,171144,2022-04-08
TRANSFER,287,Henri de Didier,10855,10568,Matthieu Cousin,171144,171431,2022-04-09
CASH_IN,19137,Agence_mtn_Cotonou,300000,280863,Matthieu Cousin,171431,190568,2022-04-13
CASH_OUT,24108,Matthieu Cousin,190568,166460,Agence_mtn_Cotonou,300000,275892,2022-04-24
CASH_IN,170279,Agence_mtn_Abomey,300000,129721,Matthieu Cousin,166460,336739,2022-04-27
CASH_IN,100960,Agence_mtn_Ouidah,300000,199040,Matthieu Cousin,336739,437699,2022-04-27
CASH_IN,273731,Agence_mtn_Cotonou,300000,26269,Laurent Marion,-8703,265028,2022-04-02
CASH_OUT,89455,Laurent Marion,265028,175573,Agence_mtn_Cotonou,300000,210545,2022-04-02
TRANSFER,117746,Laurent Marion,175573,57827,Marine Labbé,98528,-19218,2022-04-03
CASH_IN,84051,Agence_mtn_Ouidah,300000,215949,Laurent Marion,57827,141878,2022-04-05
TRANSFER,5755,Henri de Didier,10568,4813,Laurent Marion,141878,147633,2022-04-06
CASH_OUT,49141,Laurent Marion,147633,98492,Agence_mtn_Cotonou,300000,250859,2022-04-07
CASH_IN,298543,Agence_mtn_Abomey,300000,1457,Laurent Marion,98492,397035,2022-04-11
TRANSFER,1161,Marc Costa-Daniel,2067,906,Laurent Marion,397035,398196,2022-04-12
CASH_OUT,387221,Laurent Marion,398196,10975,Agence_mtn_Cotonou,300000,-87221,2022-04-13
TRANSFER,1739,Laurent Marion,10975,9236,Marc Costa-Daniel,906,-833,2022-04-16
CASH_IN,3710,Agence_mtn_Cotonou,300000,296290,Laurent Marion,9236,12946,2022-04-19
TRANSFER,5928,Alfred Paris,163789,157861,Laurent Marion,12946,18874,2022-04-25
CASH_IN,111825,Agence_mtn_Ouidah,300000,188175,Élisabeth Blot-Bruneau,-58247,53578,2022-04-03
CASH_IN,100786,Agence_mtn_Cotonou,300000,199214,Élisabeth Blot-Bruneau,53578,154364,2022-04-03
CASH_IN,145414,Agence_mtn_Abomey,300000,154586,Élisabeth Blot-Bruneau,154364,299778,2022-04-04
CASH_IN,232289,Agence_mtn_Abomey,300000,67711,Élisabeth Blot-Bruneau,299778,532067,2022-04-06
CASH_IN,73300,Agence_mtn_Cotonou,300000,226700,Élisabeth Blot-Bruneau,532067,605367,2022-04-11
CASH_IN,196631,Agence_mtn_Cotonou,300000,103369,Élisabeth Blot-Bruneau,605367,801998,2022-04-11
CASH_IN,229475,Agence_mtn_Abomey,300000,70525,Élisabeth Blot-Bruneau,801998,1031473,2022-04-12
CASH_IN,142296,Agence_mtn_Ouidah,300000,157704,Élisabeth Blot-Bruneau,1031473,1173769,2022-04-13
CASH_OUT,863839,Élisabeth Blot-Bruneau,1173769,309930,Agence_mtn_Ouidah,300000,-563839,2022-04-15
TRANSFER,140187,Élisabeth Blot-Bruneau,309930,169743,Alfred Paris,157861,17674,2022-04-19
CASH_OUT,120411,Élisabeth Blot-Bruneau,169743,49332,Agence_mtn_Cotonou,300000,179589,2022-04-19
CASH_IN,136035,Agence_mtn_Ouidah,300000,163965,Élisabeth Blot-Bruneau,49332,185367,2022-04-19
TRANSFER,171953,Élisabeth Blot-Bruneau,185367,13414,Élisabeth Blot-Bruneau,185367,357320,2022-04-19
CASH_IN,259573,Agence_mtn_Abomey,300000,40427,Élisabeth Blot-Bruneau,13414,272987,2022-04-21
TRANSFER,390159,Honoré de la Prévost,640180,250021,Élisabeth Blot-Bruneau,272987,663146,2022-04-21
CASH_OUT,151185,Élisabeth Blot-Bruneau,663146,511961,Agence_mtn_Cotonou,300000,148815,2022-04-24
TRANSFER,15183,Alfred Paris,17674,2491,Honoré de la Prévost,250021,234838,2022-04-02
CASH_IN,295701,Agence_mtn_Ouidah,300000,4299,Alfred Paris,2491,298192,2022-04-02
TRANSFER,86671,Alfred Paris,298192,211521,Alfred Paris,298192,384863,2022-04-02
CASH_IN,288310,Agence_mtn_Cotonou,300000,11690,Alfred Paris,211521,499831,2022-04-06
CASH_IN,102461,Agence_mtn_Cotonou,300000,197539,Alfred Paris,499831,602292,2022-04-06
CASH_OUT,469304,Alfred Paris,602292,132988,Agence_mtn_Abomey,300000,-169304,2022-04-07
CASH_OUT,49987,Alfred Paris,132988,83001,Agence_mtn_Cotonou,300000,250013,2022-04-10
CASH_OUT,57830,Alfred Paris,83001,25171,Agence_mtn_Abomey,300000,242170,2022-04-10
TRANSFER,8498,Alfred Paris,25171,16673,Honoré de la Prévost,234838,226340,2022-04-10
CASH_OUT,3334,Alfred Paris,16673,13339,Agence_mtn_Abomey,300000,296666,2022-04-12
TRANSFER,65471,Honoré de la Prévost,226340,160869,Alfred Paris,13339,78810,2022-04-13
CASH_OUT,65607,Alfred Paris,78810,13203,Agence_mtn_Ouidah,300000,234393,2022-04-18
CASH_IN,191840,Agence_mtn_Abomey,300000,108160,Augustin-Jérôme Merle,-1015655,-823815,2022-04-04
CASH_IN,81230,Agence_mtn_Cotonou,300000,218770,Augustin-Jérôme Merle,-823815,-742585,2022-04-04
CASH_IN,262727,Agence_mtn_Abomey,300000,37273,Augustin-Jérôme Merle,-742585,-479858,2022-04-05
CASH_IN,149026,Agence_mtn_Abomey,300000,150974,Augustin-Jérôme Merle,-479858,-330832,2022-04-07
CASH_IN,128210,Agence_mtn_Cotonou,300000,171790,Augustin-Jérôme Merle,-330832,-202622,2022-04-13
CASH_IN,211664,Agence_mtn_Cotonou,300000,88336,Augustin-Jérôme Merle,-202622,9042,2022-04-14
CASH_OUT,2768,Augustin-Jérôme Merle,9042,6274,Agence_mtn_Cotonou,300000,297232,2022-04-19
TRANSFER,6209,Augustin-Jérôme Merle,6274,65,Augustin-Jérôme Merle,6274,12483,2022-04-20
CASH_IN,131344,Agence_mtn_Abomey,300000,168656,Augustin-Jérôme Merle,65,131409,2022-04-23
CASH_IN,227291,Agence_mtn_Ouidah,300000,72709,Augustin-Jérôme Merle,131409,358700,2022-04-23
CASH_IN,101774,Agence_mtn_Cotonou,300000,198226,Augustin-Jérôme Merle,358700,460474,2022-04-25
CASH_IN,263789,Agence_mtn_Ouidah,300000,36211,Augustin-Jérôme Merle,460474,724263,2022-04-26
CASH_IN,9350,Agence_mtn_Ouidah,300000,290650,Nicole Huet,-20011,-10661,2022-04-01
CASH_IN,283227,Agence_mtn_Ouidah,300000,16773,Nicole Huet,-10661,272566,2022-04-01
CASH_IN,257172,Agence_mtn_Cotonou,300000,42828,Nicole Huet,272566,529738,2022-04-02
CASH_OUT,319789,Nicole Huet,529738,209949,Agence_mtn_Ouidah,300000,-19789,2022-04-04
CASH_OUT,60773,Nicole Huet,209949,149176,Agence_mtn_Ouidah,300000,239227,2022-04-07
TRANSFER,70181,Nicole Huet,149176,78995,Nicole Huet,149176,219357,2022-04-08
CASH_IN,81293,Agence_mtn_Ouidah,300000,218707,Nicole Huet,78995,160288,2022-04-09
TRANSFER,45233,Nicole Huet,160288,115055,Nicole Huet,160288,115055,2022-04-09
TRANSFER,66633,Nicole Huet,115055,48422,Nicole Huet,115055,48422,2022-04-11
CASH_IN,271335,Agence_mtn_Ouidah,300000,28665,Nicole Huet,48422,319757,2022-04-14
CASH_OUT,52471,Nicole Huet,319757,267286,Agence_mtn_Abomey,300000,247529,2022-04-14
CASH_OUT,183553,Nicole Huet,267286,83733,Agence_mtn_Ouidah,300000,116447,2022-04-15
CASH_OUT,49603,Nicole Huet,83733,34130,Agence_mtn_Abomey,300000,250397,2022-04-17
CASH_IN,284917,Agence_mtn_Cotonou,300000,15083,Nicole Huet,34130,319047,2022-04-17
CASH_OUT,301995,Nicole Huet,319047,17052,Agence_mtn_Ouidah,300000,-1995,2022-04-19
CASH_IN,270577,Agence_mtn_Cotonou,300000,29423,Nicole Huet,17052,287629,2022-04-20
CASH_OUT,215356,Nicole Huet,287629,72273,Agence_mtn_Ouidah,300000,84644,2022-04-22
CASH_IN,140630,Agence_mtn_Ouidah,300000,159370,Corinne Roussel,-127658,12972,2022-04-02
CASH_IN,136836,Agence_mtn_Abomey,300000,163164,Corinne Roussel,12972,149808,2022-04-04
CASH_IN,69387,Agence_mtn_Ouidah,300000,230613,Corinne Roussel,149808,219195,2022-04-04
TRANSFER,66291,Corinne Roussel,219195,152904,Corinne Roussel,219195,152904,2022-04-05
TRANSFER,123388,Corinne Roussel,152904,29516,Corinne Roussel,152904,276292,2022-04-16
CASH_OUT,20779,Corinne Roussel,29516,8737,Agence_mtn_Ouidah,300000,279221,2022-04-19
CASH_OUT,4591,Corinne Roussel,8737,4146,Agence_mtn_Ouidah,300000,295409,2022-04-21
CASH_OUT,529,Corinne Roussel,4146,3617,Agence_mtn_Ouidah,300000,299471,2022-04-22
CASH_OUT,3484,Corinne Roussel,3617,133,Agence_mtn_Cotonou,300000,296516,2022-04-22
CASH_OUT,105,Corinne Roussel,133,28,Agence_mtn_Cotonou,300000,299895,2022-04-24
CASH_IN,2319,Agence_mtn_Cotonou,300000,297681,Corinne Roussel,28,2347,2022-04-26
CASH_IN,274599,Agence_mtn_Abomey,300000,25401,Raymond-Yves Boulanger,-66183,208416,2022-04-02
CASH_OUT,65559,Raymond-Yves Boulanger,208416,142857,Agence_mtn_Ouidah,300000,234441,2022-04-02
CASH_OUT,139561,Raymond-Yves Boulanger,142857,3296,Agence_mtn_Abomey,300000,160439,2022-04-05
TRANSFER,1773,Raymond-Yves Boulanger,3296,1523,Raymond-Yves Boulanger,3296,5069,2022-04-09
CASH_IN,285222,Agence_mtn_Abomey,300000,14778,Raymond-Yves Boulanger,1523,286745,2022-04-10
CASH_IN,206660,Agence_mtn_Cotonou,300000,93340,Raymond-Yves Boulanger,286745,493405,2022-04-10
CASH_IN,214174,Agence_mtn_Ouidah,300000,85826,Raymond-Yves Boulanger,493405,707579,2022-04-24
CASH_IN,145551,Agence_mtn_Abomey,300000,154449,Madeleine Hardy,-12640,132911,2022-04-05
CASH_IN,44175,Agence_mtn_Cotonou,300000,255825,Madeleine Hardy,132911,177086,2022-04-08
TRANSFER,135458,Madeleine Hardy,177086,41628,Madeleine Hardy,177086,312544,2022-04-10
CASH_OUT,31598,Madeleine Hardy,41628,10030,Agence_mtn_Ouidah,300000,268402,2022-04-14
CASH_IN,149463,Agence_mtn_Ouidah,300000,150537,Madeleine Hardy,10030,159493,2022-04-24
CASH_IN,65744,Agence_mtn_Abomey,300000,234256,Élisabeth Delattre,-30426,35318,2022-04-01
CASH_IN,258281,Agence_mtn_Cotonou,300000,41719,Élisabeth Delattre,35318,293599,2022-04-02
CASH_OUT,62143,Élisabeth Delattre,293599,231456,Agence_mtn_Cotonou,300000,237857,2022-04-02
TRANSFER,53100,Élisabeth Delattre,231456,178356,Élisabeth Delattre,231456,284556,2022-04-03
CASH_IN,111438,Agence_mtn_Abomey,300000,188562,Élisabeth Delattre,178356,289794,2022-04-08
CASH_IN,98119,Agence_mtn_Abomey,300000,201881,Élisabeth Delattre,289794,387913,2022-04-09
CASH_OUT,97906,Élisabeth Delattre,387913,290007,Agence_mtn_Ouidah,300000,202094,2022-04-14
CASH_IN,33973,Agence_mtn_Ouidah,300000,266027,Élisabeth Delattre,290007,323980,2022-04-14
CASH_OUT,209790,Élisabeth Delattre,323980,114190,Agence_mtn_Ouidah,300000,90210,2022-04-16
CASH_IN,296595,Agence_mtn_Cotonou,300000,3405,Élisabeth Delattre,114190,410785,2022-04-22
CASH_IN,41664,Agence_mtn_Abomey,300000,258336,Élisabeth Delattre,410785,452449,2022-04-25
CASH_IN,6060,Agence_mtn_Ouidah,300000,293940,Éléonore Marin Le Morel,-99485,-93425,2022-04-01
CASH_IN,39239,Agence_mtn_Cotonou,300000,260761,Éléonore Marin Le Morel,-93425,-54186,2022-04-02
CASH_IN,281484,Agence_mtn_Cotonou,300000,18516,Éléonore Marin Le Morel,-54186,227298,2022-04-06
CASH_OUT,31909,Éléonore Marin Le Morel,227298,195389,Agence_mtn_Ouidah,300000,268091,2022-04-07
CASH_IN,145809,Agence_mtn_Abomey,300000,154191,Éléonore Marin Le Morel,195389,341198,2022-04-13
CASH_OUT,319924,Éléonore Marin Le Morel,341198,21274,Agence_mtn_Abomey,300000,-19924,2022-04-23
CASH_IN,201343,Agence_mtn_Ouidah,300000,98657,Marc Costa-Daniel,-833,200510,2022-04-02
CASH_OUT,184291,Marc Costa-Daniel,200510,16219,Agence_mtn_Abomey,300000,115709,2022-04-05
CASH_IN,133885,Agence_mtn_Ouidah,300000,166115,Marc Costa-Daniel,16219,150104,2022-04-06
TRANSFER,139831,Marc Costa-Daniel,150104,10273,Marc Costa-Daniel,150104,10273,2022-04-12
CASH_IN,186921,Agence_mtn_Cotonou,300000,113079,Marc Costa-Daniel,10273,197194,2022-04-12
CASH_IN,129511,Agence_mtn_Abomey,300000,170489,Marc Costa-Daniel,197194,326705,2022-04-15
CASH_OUT,324834,Marc Costa-Daniel,326705,1871,Agence_mtn_Abomey,300000,-24834,2022-04-15
CASH_OUT,422,Marc Costa-Daniel,1871,1449,Agence_mtn_Cotonou,300000,299578,2022-04-16
CASH_OUT,1268,Marc Costa-Daniel,1449,181,Agence_mtn_Abomey,300000,298732,2022-04-18
CASH_IN,115347,Agence_mtn_Ouidah,300000,184653,Marc Costa-Daniel,181,115528,2022-04-19
CASH_IN,155035,Agence_mtn_Cotonou,300000,144965,Marc Costa-Daniel,115528,270563,2022-04-21
CASH_OUT,33284,Marc Costa-Daniel,270563,237279,Agence_mtn_Ouidah,300000,266716,2022-04-23
CASH_IN,190350,Agence_mtn_Ouidah,300000,109650,Marc Costa-Daniel,237279,427629,2022-04-26
CASH_IN,13344,Agence_mtn_Ouidah,300000,286656,Nathalie Da Silva,-418312,-404968,2022-04-02
CASH_IN,231720,Agence_mtn_Cotonou,300000,68280,Nathalie Da Silva,-404968,-173248,2022-04-02
CASH_IN,202609,Agence_mtn_Cotonou,300000,97391,Nathalie Da Silva,-173248,29361,2022-04-08
CASH_OUT,1385,Nathalie Da Silva,29361,27976,Agence_mtn_Abomey,300000,298615,2022-04-16
CASH_OUT,7774,Nathalie Da Silva,27976,20202,Agence_mtn_Abomey,300000,292226,2022-04-17
CASH_IN,181069,Agence_mtn_Abomey,300000,118931,Nathalie Da Silva,20202,201271,2022-04-20
CASH_IN,74097,Agence_mtn_Abomey,300000,225903,Nathalie Da Silva,201271,275368,2022-04-21
CASH_OUT,209295,Nathalie Da Silva,275368,66073,Agence_mtn_Cotonou,300000,90705,2022-04-27
CASH_IN,170312,Agence_mtn_Ouidah,300000,129688,Nathalie Da Silva,66073,236385,2022-04-27
CASH_IN,231064,Agence_mtn_Cotonou,300000,68936,Sophie-Anouk Boulanger,-22020,209044,2022-04-05
CASH_OUT,135389,Sophie-Anouk Boulanger,209044,73655,Agence_mtn_Ouidah,300000,164611,2022-04-05
CASH_IN,279313,Agence_mtn_Abomey,300000,20687,Sophie-Anouk Boulanger,73655,352968,2022-04-06
CASH_OUT,130922,Sophie-Anouk Boulanger,352968,222046,Agence_mtn_Cotonou,300000,169078,2022-04-15
CASH_IN,286518,Agence_mtn_Abomey,300000,13482,Sophie-Anouk Boulanger,222046,508564,2022-04-15
TRANSFER,18092,Sophie-Anouk Boulanger,508564,490472,Sophie-Anouk Boulanger,508564,490472,2022-04-16
CASH_IN,245021,Agence_mtn_Cotonou,300000,54979,Sophie-Anouk Boulanger,490472,735493,2022-04-18
CASH_OUT,607423,Sophie-Anouk Boulanger,735493,128070,Agence_mtn_Abomey,300000,-307423,2022-04-19
CASH_OUT,10440,Sophie-Anouk Boulanger,128070,117630,Agence_mtn_Ouidah,300000,289560,2022-04-23
CASH_IN,180611,Agence_mtn_Cotonou,300000,119389,Sophie-Anouk Boulanger,117630,298241,2022-04-26
CASH_IN,275824,Agence_mtn_Abomey,300000,24176,Hélène Blanchard-Renault,-912164,-636340,2022-04-04
CASH_IN,250303,Agence_mtn_Abomey,300000,49697,Hélène Blanchard-Renault,-636340,-386037,2022-04-04
CASH_IN,108482,Agence_mtn_Cotonou,300000,191518,Hélène Blanchard-Renault,-386037,-277555,2022-04-06
CASH_IN,117208,Agence_mtn_Abomey,300000,182792,Hélène Blanchard-Renault,-277555,-160347,2022-04-10
CASH_IN,27488,Agence_mtn_Ouidah,300000,272512,Hélène Blanchard-Renault,-160347,-132859,2022-04-10
CASH_IN,228177,Agence_mtn_Ouidah,300000,71823,Hélène Blanchard-Renault,-132859,95318,2022-04-12
TRANSFER,52710,Hélène Blanchard-Renault,95318,42608,Hélène Blanchard-Renault,95318,42608,2022-04-12
TRANSFER,9399,Hélène Blanchard-Renault,42608,33209,Hélène Blanchard-Renault,42608,52007,2022-04-15
CASH_IN,57089,Agence_mtn_Cotonou,300000,242911,Hélène Blanchard-Renault,33209,90298,2022-04-16
CASH_OUT,12950,Hélène Blanchard-Renault,90298,77348,Agence_mtn_Cotonou,300000,287050,2022-04-18
CASH_IN,133917,Agence_mtn_Ouidah,300000,166083,Hélène Blanchard-Renault,77348,211265,2022-04-19
CASH_OUT,180046,Hélène Blanchard-Renault,211265,31219,Agence_mtn_Ouidah,300000,119954,2022-04-21
CASH_IN,62814,Agence_mtn_Ouidah,300000,237186,Hélène Blanchard-Renault,31219,94033,2022-04-23
CASH_IN,174845,Agence_mtn_Abomey,300000,125155,Aurélie Maury,-126075,48770,2022-04-07
TRANSFER,3399,Aurélie Maury,48770,45371,Aurélie Maury,48770,45371,2022-04-07
CASH_OUT,42461,Aurélie Maury,45371,2910,Agence_mtn_Cotonou,300000,257539,2022-04-08
CASH_OUT,862,Aurélie Maury,2910,2048,Agence_mtn_Ouidah,300000,299138,2022-04-11
CASH_OUT,1152,Aurélie Maury,2048,896,Agence_mtn_Cotonou,300000,298848,2022-04-16
CASH_IN,272348,Agence_mtn_Cotonou,300000,27652,Aurélie Maury,896,273244,2022-04-24
CASH_IN,290821,Agence_mtn_Abomey,300000,9179,Aurélie Maury,273244,564065,2022-04-26
CASH_IN,250350,Agence_mtn_Abomey,300000,49650,Clémence Dufour,-36559,213791,2022-04-02
CASH_OUT,198889,Clémence Dufour,213791,14902,Agence_mtn_Cotonou,300000,101111,2022-04-02
CASH_IN,118274,Agence_mtn_Cotonou,300000,181726,Clémence Dufour,14902,133176,2022-04-08
CASH_IN,76319,Agence_mtn_Cotonou,300000,223681,Clémence Dufour,133176,209495,2022-04-10
TRANSFER,25671,Clémence Dufour,209495,183824,Clémence Dufour,209495,183824,2022-04-10
CASH_OUT,178007,Clémence Dufour,183824,5817,Agence_mtn_Cotonou,300000,121993,2022-04-13
CASH_OUT,5164,Clémence Dufour,5817,653,Agence_mtn_Cotonou,300000,294836,2022-04-19
CASH_IN,175187,Agence_mtn_Abomey,300000,124813,Danielle-Henriette Tessier,-231650,-56463,2022-04-03
CASH_IN,134132,Agence_mtn_Abomey,300000,165868,Danielle-Henriette Tessier,-56463,77669,2022-04-10
CASH_OUT,32591,Danielle-Henriette Tessier,77669,45078,Agence_mtn_Cotonou,300000,267409,2022-04-10
TRANSFER,39242,Danielle-Henriette Tessier,45078,5836,Danielle-Henriette Tessier,45078,84320,2022-04-13
CASH_IN,5365,Agence_mtn_Ouidah,300000,294635,Danielle-Henriette Tessier,5836,11201,2022-04-15
CASH_IN,114634,Agence_mtn_Abomey,300000,185366,Danielle-Henriette Tessier,11201,125835,2022-04-16
CASH_IN,40014,Agence_mtn_Cotonou,300000,259986,Astrid de Pascal,-29493,10521,2022-04-02
CASH_IN,221406,Agence_mtn_Ouidah,300000,78594,Astrid de Pascal,10521,231927,2022-04-03
CASH_IN,144276,Agence_mtn_Abomey,300000,155724,Astrid de Pascal,231927,376203,2022-04-04
TRANSFER,220820,Astrid de Pascal,376203,155383,Astrid de Pascal,376203,597023,2022-04-04
CASH_OUT,6203,Astrid de Pascal,155383,149180,Agence_mtn_Ouidah,300000,293797,2022-04-09
TRANSFER,99236,Astrid de Pascal,149180,49944,Astrid de Pascal,149180,248416,2022-04-10
TRANSFER,20260,Astrid de Pascal,49944,29684,Astrid de Pascal,49944,29684,2022-04-11
CASH_IN,288450,Agence_mtn_Ouidah,300000,11550,Astrid de Pascal,29684,318134,2022-04-12
CASH_IN,49370,Agence_mtn_Ouidah,300000,250630,Astrid de Pascal,318134,367504,2022-04-14
CASH_IN,247977,Agence_mtn_Abomey,300000,52023,Astrid de Pascal,367504,615481,2022-04-15
CASH_OUT,283419,Astrid de Pascal,615481,332062,Agence_mtn_Cotonou,300000,16581,2022-04-20
CASH_IN,103295,Agence_mtn_Abomey,300000,196705,Astrid de Pascal,332062,435357,2022-04-27
CASH_IN,144625,Agence_mtn_Cotonou,300000,155375,Marine Labbé,-19218,125407,2022-04-02
TRANSFER,17916,Marine Labbé,125407,107491,Marine Labbé,125407,143323,2022-04-04
CASH_IN,131479,Agence_mtn_Cotonou,300000,168521,Marine Labbé,107491,238970,2022-04-07
TRANSFER,190053,Marine Labbé,238970,48917,Marine Labbé,238970,48917,2022-04-09
CASH_OUT,33972,Marine Labbé,48917,14945,Agence_mtn_Abomey,300000,266028,2022-04-11
CASH_OUT,7063,Marine Labbé,14945,7882,Agence_mtn_Ouidah,300000,292937,2022-04-12
CASH_OUT,7759,Marine Labbé,7882,123,Agence_mtn_Ouidah,300000,292241,2022-04-16
CASH_OUT,114,Marine Labbé,123,9,Agence_mtn_Abomey,300000,299886,2022-04-27
CASH_IN,172874,Agence_mtn_Ouidah,300000,127126,Thibault Martin,-9061,163813,2022-04-02
CASH_IN,93270,Agence_mtn_Cotonou,300000,206730,Thibault Martin,163813,257083,2022-04-04
TRANSFER,191031,Thibault Martin,257083,66052,Thibault Martin,257083,448114,2022-04-06
TRANSFER,7303,Thibault Martin,66052,58749,Thibault Martin,66052,73355,2022-04-07
CASH_IN,283372,Agence_mtn_Cotonou,300000,16628,Thibault Martin,58749,342121,2022-04-09
TRANSFER,45609,Thibault Martin,342121,296512,Thibault Martin,342121,296512,2022-04-11
TRANSFER,59302,Thibault Martin,296512,237210,Thibault Martin,296512,355814,2022-04-11
CASH_IN,2899,Agence_mtn_Cotonou,300000,297101,Thibault Martin,237210,240109,2022-04-14
CASH_OUT,17164,Thibault Martin,240109,222945,Agence_mtn_Cotonou,300000,282836,2022-04-22
CASH_IN,66721,Agence_mtn_Abomey,300000,233279,Thibault Martin,222945,289666,2022-04-25
CASH_IN,129678,Agence_mtn_Abomey,300000,170322,Élise Monnier,-38229,91449,2022-04-03
CASH_IN,85904,Agence_mtn_Ouidah,300000,214096,Élise Monnier,91449,177353,2022-04-04
CASH_IN,55139,Agence_mtn_Cotonou,300000,244861,Élise Monnier,177353,232492,2022-04-04
CASH_OUT,79953,Élise Monnier,232492,152539,Agence_mtn_Cotonou,300000,220047,2022-04-07
TRANSFER,86738,Élise Monnier,152539,65801,Élise Monnier,152539,65801,2022-04-07
CASH_OUT,17682,Élise Monnier,65801,48119,Agence_mtn_Cotonou,300000,282318,2022-04-08
CASH_IN,69261,Agence_mtn_Ouidah,300000,230739,Élise Monnier,48119,117380,2022-04-10
CASH_IN,245200,Agence_mtn_Ouidah,300000,54800,Élise Monnier,117380,362580,2022-04-13
CASH_IN,222101,Agence_mtn_Ouidah,300000,77899,Élise Monnier,362580,584681,2022-04-14
CASH_IN,63632,Agence_mtn_Abomey,300000,236368,Élise Monnier,584681,648313,2022-04-16
CASH_IN,95482,Agence_mtn_Cotonou,300000,204518,Élise Monnier,648313,743795,2022-04-19
CASH_IN,4553,Agence_mtn_Cotonou,300000,295447,Élise Monnier,743795,748348,2022-04-19
CASH_OUT,155492,Élise Monnier,748348,592856,Agence_mtn_Ouidah,300000,144508,2022-04-21
CASH_IN,97649,Agence_mtn_Cotonou,300000,202351,Élise Monnier,592856,690505,2022-04-26
CASH_IN,23757,Agence_mtn_Ouidah,300000,276243,Maurice de Brunet,-14216,9541,2022-04-01
CASH_IN,98891,Agence_mtn_Cotonou,300000,201109,Maurice de Brunet,9541,108432,2022-04-01
TRANSFER,46682,Maurice de Brunet,108432,61750,Maurice de Brunet,108432,61750,2022-04-03
CASH_OUT,37399,Maurice de Brunet,61750,24351,Agence_mtn_Cotonou,300000,262601,2022-04-04
CASH_IN,160822,Agence_mtn_Cotonou,300000,139178,Maurice de Brunet,24351,185173,2022-04-04
CASH_OUT,170590,Maurice de Brunet,185173,14583,Agence_mtn_Ouidah,300000,129410,2022-04-07
CASH_IN,201075,Agence_mtn_Cotonou,300000,98925,Maurice de Brunet,14583,215658,2022-04-09
TRANSFER,35368,Maurice de Brunet,215658,180290,Maurice de Brunet,215658,251026,2022-04-10
TRANSFER,62824,Maurice de Brunet,180290,117466,Maurice de Brunet,180290,117466,2022-04-13
TRANSFER,100929,Maurice de Brunet,117466,16537,Maurice de Brunet,117466,16537,2022-04-14
CASH_OUT,5420,Maurice de Brunet,16537,11117,Agence_mtn_Cotonou,300000,294580,2022-04-17
CASH_IN,174346,Agence_mtn_Ouidah,300000,125654,Maurice de Brunet,11117,185463,2022-04-22
CASH_IN,76781,Agence_mtn_Cotonou,300000,223219,Maurice de Brunet,185463,262244,2022-04-23
CASH_OUT,97920,Maurice de Brunet,262244,164324,Agence_mtn_Ouidah,300000,202080,2022-04-27
CASH_IN,192694,Agence_mtn_Ouidah,300000,107306,Maurice de Brunet,164324,357018,2022-04-27
CASH_OUT,158327,Clémence Dufour,1893600,1735273,Agence_mtn_Cotonou,300000,141673,2022-05-09
TRANSFER,927710,Honoré Grégoire-Breton,1262500,334790,Marine Chevallier,264400,-663310,2022-05-06
CASH_IN,235410,Agence_mtn_Ouidah,300000,64590,Honoré Grégoire-Breton,334790,570200,2022-05-08
CASH_IN,258026,Agence_mtn_Cotonou,300000,41974,Honoré Grégoire-Breton,570200,828226,2022-05-13
TRANSFER,1092700,Sophie-Anouk Boulanger,1101200,8500,Stéphanie Guichard,896500,-196200,2022-05-03
CASH_IN,258631,Agence_mtn_Abomey,300000,41369,Sophie-Anouk Boulanger,8500,267131,2022-05-13
CASH_IN,93079,Agence_mtn_Cotonou,300000,206921,Sophie-Anouk Boulanger,267131,360210,2022-05-14
CASH_OUT,314920,Sophie-Anouk Boulanger,360210,45290,Agence_mtn_Cotonou,300000,-14920,2022-05-20
CASH_OUT,44459,Sophie-Anouk Boulanger,45290,831,Agence_mtn_Cotonou,300000,255541,2022-05-21
CASH_OUT,78123,Nicolas Blin,796500,718377,Agence_mtn_Ouidah,300000,221877,2022-05-10
CASH_IN,8747,Agence_mtn_Cotonou,300000,291253,Nicolas Blin,718377,727124,2022-05-10
TRANSFER,248090,Nicolas Blin,727124,479034,Christophe Teixeira,1286400,1038310,2022-05-23
CASH_IN,189437,Agence_mtn_Ouidah,300000,110563,Robert Henry-Poulain,76800,266237,2022-05-08
TRANSFER,165595,Robert Henry-Poulain,266237,100642,Charlotte Perrier,830800,665205,2022-05-21
CASH_IN,167717,Agence_mtn_Cotonou,300000,132283,Robert Henry-Poulain,100642,268359,2022-05-22
CASH_OUT,147214,Robert Henry-Poulain,268359,121145,Agence_mtn_Cotonou,300000,152786,2022-05-23
CASH_IN,5846,Agence_mtn_Abomey,300000,294154,Emmanuel Vallée,590900,596746,2022-05-01
TRANSFER,2135,Martin Moreau,490300,488165,Thibault-Julien Chevallier,209100,211235,2022-05-04
CASH_IN,108353,Agence_mtn_Cotonou,300000,191647,Thibault-Julien Chevallier,211235,319588,2022-05-19
CASH_IN,195638,Agence_mtn_Cotonou,300000,104362,Marcel de la Buisson,1302700,1498338,2022-05-11
CASH_IN,265827,Agence_mtn_Abomey,300000,34173,Marcel de la Buisson,1498338,1764165,2022-05-13
TRANSFER,558454,Marcel de la Buisson,1764165,1205711,Matthieu Cousin,1732300,1173846,2022-05-22
TRANSFER,613134,Clémence-Alice Ruiz,681600,68466,Marcel de la Buisson,1205711,1818845,2022-05-26
CASH_IN,262989,Agence_mtn_Abomey,300000,37011,Simone du Allard,1793800,2056789,2022-05-06
CASH_OUT,273976,Simone du Allard,2056789,1782813,Agence_mtn_Cotonou,300000,26024,2022-05-10
TRANSFER,1550494,Simone du Allard,1782813,232319,Hélène Alexandre de la Samson,983000,-567494,2022-05-26
CASH_IN,221358,Agence_mtn_Abomey,300000,78642,Christophe Teixeira,1038310,1259668,2022-05-07
CASH_IN,115607,Agence_mtn_Ouidah,300000,184393,Christophe Teixeira,1259668,1375275,2022-05-23
CASH_OUT,546223,Maryse Delorme,926100,379877,Agence_mtn_Abomey,300000,-246223,2022-05-01
CASH_IN,70445,Agence_mtn_Abomey,300000,229555,Maryse Delorme,379877,450322,2022-05-11
TRANSFER,862565,Raymond de Le Roux,1229600,367035,Jacques Marchand,1180300,2042865,2022-05-02
CASH_IN,176741,Agence_mtn_Ouidah,300000,123259,Jacques Marchand,2042865,2219606,2022-05-21
CASH_OUT,2103107,Jacques Marchand,2219606,116499,Agence_mtn_Cotonou,300000,-1803107,2022-05-23
CASH_IN,29910,Agence_mtn_Abomey,300000,270090,Jacques Marchand,116499,146409,2022-05-23
CASH_IN,22882,Agence_mtn_Cotonou,300000,277118,Danielle-Henriette Tessier,36700,59582,2022-05-11
TRANSFER,135423,Charles Guérin,355000,219577,Julie Germain Le Vaillant,1218400,1353823,2022-05-01
CASH_OUT,555329,Julie Germain Le Vaillant,1353823,798494,Agence_mtn_Ouidah,300000,-255329,2022-05-20
CASH_OUT,1046429,Thibault Martin,1729400,682971,Agence_mtn_Abomey,300000,-746429,2022-05-05
TRANSFER,215078,Gilbert Moulin,1474600,1259522,Thibault Martin,682971,898049,2022-05-06
CASH_OUT,840667,Thibault Martin,898049,57382,Agence_mtn_Ouidah,300000,-540667,2022-05-08
CASH_OUT,7951,Thibault Martin,57382,49431,Agence_mtn_Cotonou,300000,292049,2022-05-08
TRANSFER,881398,Sébastien Coste,1225700,344302,Thibault Martin,49431,930829,2022-05-13
CASH_IN,174100,Agence_mtn_Cotonou,300000,125900,Zacharie Fabre,67600,241700,2022-05-01
TRANSFER,96089,Zacharie Fabre,241700,145611,Marthe Perrin,984300,888211,2022-05-01
CASH_OUT,16315,Zacharie Fabre,145611,129296,Agence_mtn_Abomey,300000,283685,2022-05-19
CASH_IN,89716,Agence_mtn_Ouidah,300000,210284,Zacharie Fabre,129296,219012,2022-05-25
CASH_IN,153051,Agence_mtn_Cotonou,300000,146949,Madeleine Hardy,1387800,1540851,2022-05-08
TRANSFER,63870,Véronique Hardy,607500,543630,Alexandre Delaunay,1183300,1247170,2022-05-01
TRANSFER,377227,Alexandre Delaunay,1247170,869943,Honoré de la Prévost,1063400,686173,2022-05-12
CASH_OUT,299191,Alexandre Delaunay,869943,570752,Agence_mtn_Ouidah,300000,809,2022-05-21
TRANSFER,176394,Alexandre Delaunay,570752,394358,Élise Monnier,1936900,1760506,2022-05-27
CASH_IN,225836,Agence_mtn_Cotonou,300000,74164,Astrid de Pascal,32800,258636,2022-05-07
CASH_IN,230661,Agence_mtn_Ouidah,300000,69339,Astrid de Pascal,258636,489297,2022-05-15
TRANSFER,100431,Océane Faure,207400,106969,Astrid de Pascal,489297,589728,2022-05-16
CASH_OUT,466972,Astrid de Pascal,589728,122756,Agence_mtn_Cotonou,300000,-166972,2022-05-23
TRANSFER,663056,François Vaillant,664700,1644,Astrid de Pascal,122756,785812,2022-05-27
TRANSFER,16390,Marine Labbé,93100,76710,Guy-Augustin Pinto,80500,64110,2022-05-01
CASH_OUT,1311520,Élise Monnier,1760506,448986,Agence_mtn_Cotonou,300000,-1011520,2022-05-21
CASH_OUT,322114,Élise Monnier,448986,126872,Agence_mtn_Cotonou,300000,-22114,2022-05-21
TRANSFER,64081,Élise Monnier,126872,62791,Michelle de la Daniel,250400,186319,2022-05-22
TRANSFER,35165,Océane Faure,106969,71804,Margot Julien,1734600,1699435,2022-05-26
CASH_OUT,60398,Océane Faure,71804,11406,Agence_mtn_Abomey,300000,239602,2022-05-27
CASH_IN,117424,Agence_mtn_Ouidah,300000,182576,Pénélope Boulay,475000,592424,2022-05-01
CASH_OUT,457609,Pénélope Boulay,592424,134815,Agence_mtn_Abomey,300000,-157609,2022-05-14
CASH_OUT,61332,Pénélope Boulay,134815,73483,Agence_mtn_Ouidah,300000,238668,2022-05-27
CASH_IN,165586,Agence_mtn_Abomey,300000,134414,Roger-Roger Delmas,131900,297486,2022-05-02
CASH_IN,137856,Agence_mtn_Ouidah,300000,162144,Roger-Roger Delmas,297486,435342,2022-05-04
CASH_IN,192063,Agence_mtn_Ouidah,300000,107937,Roger-Roger Delmas,435342,627405,2022-05-04
TRANSFER,61490,Roger-Roger Delmas,627405,565915,Louise-Aurore Payet,1509300,1447810,2022-05-04
CASH_OUT,527714,Roger-Roger Delmas,565915,38201,Agence_mtn_Abomey,300000,-227714,2022-05-06
CASH_OUT,22540,Roger-Roger Delmas,38201,15661,Agence_mtn_Cotonou,300000,277460,2022-05-06
CASH_IN,231460,Agence_mtn_Cotonou,300000,68540,Roger-Roger Delmas,15661,247121,2022-05-06
TRANSFER,105208,Gérard Cordier,1549300,1444092,Roger-Roger Delmas,247121,352329,2022-05-07
CASH_IN,260384,Agence_mtn_Cotonou,300000,39616,Roger-Roger Delmas,352329,612713,2022-05-09
CASH_IN,102494,Agence_mtn_Ouidah,300000,197506,Roger-Roger Delmas,612713,715207,2022-05-10
TRANSFER,1521080,Alfred Paris,1771800,250720,Roger-Roger Delmas,715207,2236287,2022-05-11
CASH_OUT,2066523,Roger-Roger Delmas,2236287,169764,Agence_mtn_Cotonou,300000,-1766523,2022-05-14
TRANSFER,1575323,Emmanuel Legrand,1884900,309577,Roger-Roger Delmas,169764,1745087,2022-05-14
CASH_OUT,789233,Roger-Roger Delmas,1745087,955854,Agence_mtn_Ouidah,300000,-489233,2022-05-14
TRANSFER,1009,François Vaillant,1644,635,Roger-Roger Delmas,955854,956863,2022-05-15
CASH_IN,190284,Agence_mtn_Ouidah,300000,109716,Roger-Roger Delmas,956863,1147147,2022-05-17
TRANSFER,488547,Roger-Roger Delmas,1147147,658600,Emmanuel Legrand,309577,-178970,2022-05-19
CASH_IN,23770,Agence_mtn_Ouidah,300000,276230,Roger-Roger Delmas,658600,682370,2022-05-20
CASH_IN,75685,Agence_mtn_Ouidah,300000,224315,Roger-Roger Delmas,682370,758055,2022-05-21
CASH_IN,3290,Agence_mtn_Cotonou,300000,296710,Roger-Roger Delmas,758055,761345,2022-05-22
CASH_IN,26445,Agence_mtn_Ouidah,300000,273555,Roger-Roger Delmas,761345,787790,2022-05-24
TRANSFER,326974,Roger-Roger Delmas,787790,460816,Sabine Perrier,138200,-188774,2022-05-27
TRANSFER,1273405,Jacques Laporte de Blanchet,1752900,479495,Sylvie Dupré,169400,-1104005,2022-05-03
CASH_OUT,328107,Jacques Laporte de Blanchet,479495,151388,Agence_mtn_Abomey,300000,-28107,2022-05-03
TRANSFER,20042,Michelle de la Daniel,186319,166277,Jacques Laporte de Blanchet,151388,171430,2022-05-03
CASH_OUT,80415,Jacques Laporte de Blanchet,171430,91015,Agence_mtn_Ouidah,300000,219585,2022-05-06
TRANSFER,50602,Jacques Laporte de Blanchet,91015,40413,Nicole-Renée Gay,1434000,1383398,2022-05-06
CASH_IN,57918,Agence_mtn_Ouidah,300000,242082,Jacques Laporte de Blanchet,40413,98331,2022-05-07
CASH_OUT,31419,Jacques Laporte de Blanchet,98331,66912,Agence_mtn_Abomey,300000,268581,2022-05-09
CASH_IN,217043,Agence_mtn_Ouidah,300000,82957,Jacques Laporte de Blanchet,66912,283955,2022-05-10
CASH_OUT,90856,Jacques Laporte de Blanchet,283955,193099,Agence_mtn_Abomey,300000,209144,2022-05-11
CASH_OUT,144123,Jacques Laporte de Blanchet,193099,48976,Agence_mtn_Abomey,300000,155877,2022-05-12
CASH_OUT,16860,Jacques Laporte de Blanchet,48976,32116,Agence_mtn_Cotonou,300000,283140,2022-05-13
TRANSFER,3573,Jacques Laporte de Blanchet,32116,28543,Josette du Hamon,1409900,1406327,2022-05-14
CASH_IN,291690,Agence_mtn_Cotonou,300000,8310,Jacques Laporte de Blanchet,28543,320233,2022-05-15
CASH_IN,82661,Agence_mtn_Abomey,300000,217339,Jacques Laporte de Blanchet,320233,402894,2022-05-16
TRANSFER,13027,Jacques Laporte de Blanchet,402894,389867,Jacques Le Marion,206800,193773,2022-05-16
CASH_IN,173867,Agence_mtn_Cotonou,300000,126133,Jacques Laporte de Blanchet,389867,563734,2022-05-17
TRANSFER,1384014,Roland Huet,1851800,467786,Jacques Laporte de Blanchet,563734,1947748,2022-05-18
TRANSFER,680928,Jacques Laporte de Blanchet,1947748,1266820,Laurent Marion,1050300,369372,2022-05-20
CASH_OUT,1056579,Jacques Laporte de Blanchet,1266820,210241,Agence_mtn_Ouidah,300000,-756579,2022-05-20
CASH_OUT,63412,Jacques Laporte de Blanchet,210241,146829,Agence_mtn_Abomey,300000,236588,2022-05-21
CASH_IN,22422,Agence_mtn_Cotonou,300000,277578,Jacques Laporte de Blanchet,146829,169251,2022-05-21
CASH_IN,113331,Agence_mtn_Cotonou,300000,186669,Jacques Laporte de Blanchet,169251,282582,2022-05-25
CASH_OUT,44414,Jacques Laporte de Blanchet,282582,238168,Agence_mtn_Ouidah,300000,255586,2022-05-25
CASH_IN,178704,Agence_mtn_Cotonou,300000,121296,Jacques Laporte de Blanchet,238168,416872,2022-05-26
TRANSFER,1085521,Gérard Cordier,1444092,358571,Jacques Laporte de Blanchet,416872,1502393,2022-05-27
CASH_IN,62399,Agence_mtn_Ouidah,300000,237601,Christine Rossi,1469500,1531899,2022-05-01
CASH_OUT,923374,Christine Rossi,1531899,608525,Agence_mtn_Ouidah,300000,-623374,2022-05-02
CASH_IN,197623,Agence_mtn_Ouidah,300000,102377,Christine Rossi,608525,806148,2022-05-02
TRANSFER,1011737,Valérie-Claudine Marin,1324200,312463,Christine Rossi,806148,1817885,2022-05-03
CASH_OUT,1744363,Christine Rossi,1817885,73522,Agence_mtn_Cotonou,300000,-1444363,2022-05-05
TRANSFER,8863,Christine Rossi,73522,64659,Honoré de la Prévost,686173,677310,2022-05-05
TRANSFER,44204,Christine Rossi,64659,20455,Clémence-Alice Ruiz,68466,24262,2022-05-05
CASH_IN,295798,Agence_mtn_Abomey,300000,4202,Christine Rossi,20455,316253,2022-05-08
CASH_OUT,33107,Christine Rossi,316253,283146,Agence_mtn_Abomey,300000,266893,2022-05-08
CASH_IN,211612,Agence_mtn_Ouidah,300000,88388,Christine Rossi,283146,494758,2022-05-10
CASH_OUT,363335,Christine Rossi,494758,131423,Agence_mtn_Cotonou,300000,-63335,2022-05-12
CASH_IN,113487,Agence_mtn_Abomey,300000,186513,Christine Rossi,131423,244910,2022-05-13
TRANSFER,132161,Marthe Perrin,888211,756050,Christine Rossi,244910,377071,2022-05-13
CASH_IN,191843,Agence_mtn_Abomey,300000,108157,Christine Rossi,377071,568914,2022-05-14
CASH_OUT,217855,Christine Rossi,568914,351059,Agence_mtn_Ouidah,300000,82145,2022-05-14
TRANSFER,371859,Nathalie Da Silva,1862100,1490241,Christine Rossi,351059,722918,2022-05-15
TRANSFER,175357,Hélène Blanchard-Renault,660900,485543,Christine Rossi,722918,898275,2022-05-18
CASH_IN,251090,Agence_mtn_Cotonou,300000,48910,Christine Rossi,898275,1149365,2022-05-19
CASH_IN,57283,Agence_mtn_Abomey,300000,242717,Christine Rossi,1149365,1206648,2022-05-20
TRANSFER,941685,Christine Rossi,1206648,264963,Michèle Faivre,1045500,103815,2022-05-20
CASH_OUT,51059,Christine Rossi,264963,213904,Agence_mtn_Ouidah,300000,248941,2022-05-20
CASH_OUT,99728,Christine Rossi,213904,114176,Agence_mtn_Cotonou,300000,200272,2022-05-20
CASH_OUT,52553,Christine Rossi,114176,61623,Agence_mtn_Cotonou,300000,247447,2022-05-22
CASH_OUT,36335,Christine Rossi,61623,25288,Agence_mtn_Cotonou,300000,263665,2022-05-22
CASH_IN,160900,Agence_mtn_Ouidah,300000,139100,Christine Rossi,25288,186188,2022-05-24
TRANSFER,55442,Christine Rossi,186188,130746,Valérie de Pottier,726700,671258,2022-05-24
TRANSFER,234624,Martin Moreau,488165,253541,Christine Rossi,130746,365370,2022-05-25
CASH_OUT,73266,Christine Rossi,365370,292104,Agence_mtn_Ouidah,300000,226734,2022-05-26
CASH_IN,187609,Agence_mtn_Abomey,300000,112391,Christine Rossi,292104,479713,2022-05-26
CASH_OUT,86299,Christine Rossi,479713,393414,Agence_mtn_Ouidah,300000,213701,2022-05-26
CASH_OUT,526101,Nicole-Renée Gay,1383398,857297,Agence_mtn_Cotonou,300000,-226101,2022-05-01
CASH_OUT,55922,Nicole-Renée Gay,857297,801375,Agence_mtn_Cotonou,300000,244078,2022-05-01
CASH_OUT,219366,Nicole-Renée Gay,801375,582009,Agence_mtn_Abomey,300000,80634,2022-05-03
CASH_OUT,455393,Nicole-Renée Gay,582009,126616,Agence_mtn_Abomey,300000,-155393,2022-05-04
TRANSFER,75696,Nicole-Renée Gay,126616,50920,François Vaillant,635,-75061,2022-05-08
CASH_IN,220532,Agence_mtn_Cotonou,300000,79468,Nicole-Renée Gay,50920,271452,2022-05-08
CASH_IN,186958,Agence_mtn_Ouidah,300000,113042,Nicole-Renée Gay,271452,458410,2022-05-08
CASH_OUT,336698,Nicole-Renée Gay,458410,121712,Agence_mtn_Abomey,300000,-36698,2022-05-08
CASH_IN,104386,Agence_mtn_Ouidah,300000,195614,Nicole-Renée Gay,121712,226098,2022-05-08
CASH_OUT,160272,Nicole-Renée Gay,226098,65826,Agence_mtn_Cotonou,300000,139728,2022-05-12
TRANSFER,34099,Marthe Perrin,756050,721951,Nicole-Renée Gay,65826,99925,2022-05-12
CASH_OUT,68632,Nicole-Renée Gay,99925,31293,Agence_mtn_Ouidah,300000,231368,2022-05-13
CASH_IN,72931,Agence_mtn_Ouidah,300000,227069,Nicole-Renée Gay,31293,104224,2022-05-17
CASH_OUT,23893,Nicole-Renée Gay,104224,80331,Agence_mtn_Ouidah,300000,276107,2022-05-18
TRANSFER,34868,Nicole-Renée Gay,80331,45463,Nicole-Renée Gay,80331,115199,2022-05-18
TRANSFER,11792,Nicole-Renée Gay,45463,33671,Clémence-Alice Ruiz,24262,12470,2022-05-19
TRANSFER,1250776,Nathalie-Claire De Oliveira,1655100,404324,Nicole-Renée Gay,33671,1284447,2022-05-20
CASH_IN,100759,Agence_mtn_Cotonou,300000,199241,Nicole-Renée Gay,1284447,1385206,2022-05-21
CASH_OUT,823696,Nicole-Renée Gay,1385206,561510,Agence_mtn_Ouidah,300000,-523696,2022-05-22
CASH_OUT,310146,Nicole-Renée Gay,561510,251364,Agence_mtn_Ouidah,300000,-10146,2022-05-25
TRANSFER,19266,Nicole-Renée Gay,251364,232098,Valérie de Pottier,671258,651992,2022-05-25
TRANSFER,598382,Aimé Bernier,897300,298918,Nicole-Renée Gay,232098,830480,2022-05-27
CASH_IN,177897,Agence_mtn_Abomey,300000,122103,Alexandre Blanchard,947700,1125597,2022-05-02
TRANSFER,574554,Alexandre Blanchard,1125597,551043,Élisabeth Delattre,669900,95346,2022-05-02
CASH_IN,101178,Agence_mtn_Abomey,300000,198822,Alexandre Blanchard,551043,652221,2022-05-04
CASH_OUT,423534,Alexandre Blanchard,652221,228687,Agence_mtn_Abomey,300000,-123534,2022-05-04
TRANSFER,297737,Charlotte Perrier,665205,367468,Alexandre Blanchard,228687,526424,2022-05-05
CASH_OUT,352664,Alexandre Blanchard,526424,173760,Agence_mtn_Ouidah,300000,-52664,2022-05-06
CASH_IN,146779,Agence_mtn_Abomey,300000,153221,Alexandre Blanchard,173760,320539,2022-05-09
CASH_OUT,44763,Alexandre Blanchard,320539,275776,Agence_mtn_Abomey,300000,255237,2022-05-12
CASH_IN,230035,Agence_mtn_Cotonou,300000,69965,Alexandre Blanchard,275776,505811,2022-05-13
TRANSFER,147977,Alexandre Blanchard,505811,357834,Louis de la Imbert,235000,87023,2022-05-13
CASH_OUT,10763,Alexandre Blanchard,357834,347071,Agence_mtn_Abomey,300000,289237,2022-05-13
CASH_IN,298120,Agence_mtn_Abomey,300000,1880,Alexandre Blanchard,347071,645191,2022-05-15
CASH_IN,99056,Agence_mtn_Abomey,300000,200944,Alexandre Blanchard,645191,744247,2022-05-15
TRANSFER,51641,Alexandre Blanchard,744247,692606,Élisabeth Blot-Bruneau,1619000,1567359,2022-05-15
CASH_OUT,139866,Alexandre Blanchard,692606,552740,Agence_mtn_Ouidah,300000,160134,2022-05-19
CASH_OUT,202149,Alexandre Blanchard,552740,350591,Agence_mtn_Ouidah,300000,97851,2022-05-20
CASH_IN,137468,Agence_mtn_Cotonou,300000,162532,Alexandre Blanchard,350591,488059,2022-05-20
TRANSFER,50061,Marc Costa-Daniel,286100,236039,Alexandre Blanchard,488059,538120,2022-05-21
CASH_OUT,328673,Alexandre Blanchard,538120,209447,Agence_mtn_Ouidah,300000,-28673,2022-05-21
TRANSFER,207893,Alexandre Blanchard,209447,1554,Jules-Marc Chauvet,80300,-127593,2022-05-22
CASH_OUT,961,Alexandre Blanchard,1554,593,Agence_mtn_Abomey,300000,299039,2022-05-24
CASH_OUT,401,Alexandre Blanchard,593,192,Agence_mtn_Ouidah,300000,299599,2022-05-25
CASH_OUT,104,Alexandre Blanchard,192,88,Agence_mtn_Abomey,300000,299896,2022-05-26
CASH_IN,15777,Agence_mtn_Cotonou,300000,284223,Alexandre Blanchard,88,15865,2022-05-27
TRANSFER,3282,Alexandre Blanchard,15865,12583,Josette du Hamon,1406327,1403045,2022-05-27
CASH_IN,285864,Agence_mtn_Cotonou,300000,14136,Michelle de la Daniel,166277,452141,2022-05-01
CASH_IN,213328,Agence_mtn_Ouidah,300000,86672,Michelle de la Daniel,452141,665469,2022-05-02
CASH_OUT,401057,Michelle de la Daniel,665469,264412,Agence_mtn_Cotonou,300000,-101057,2022-05-02
CASH_OUT,54881,Michelle de la Daniel,264412,209531,Agence_mtn_Abomey,300000,245119,2022-05-03
CASH_OUT,7936,Michelle de la Daniel,209531,201595,Agence_mtn_Cotonou,300000,292064,2022-05-04
CASH_IN,152514,Agence_mtn_Abomey,300000,147486,Michelle de la Daniel,201595,354109,2022-05-05
TRANSFER,540207,Maggie Barbier,1296700,756493,Michelle de la Daniel,354109,894316,2022-05-05
TRANSFER,163820,Michelle de la Daniel,894316,730496,Nathalie-Claire De Oliveira,404324,240504,2022-05-09
CASH_OUT,647315,Michelle de la Daniel,730496,83181,Agence_mtn_Ouidah,300000,-347315,2022-05-10
CASH_OUT,24817,Michelle de la Daniel,83181,58364,Agence_mtn_Ouidah,300000,275183,2022-05-13
CASH_OUT,44684,Michelle de la Daniel,58364,13680,Agence_mtn_Ouidah,300000,255316,2022-05-14
CASH_OUT,11749,Michelle de la Daniel,13680,1931,Agence_mtn_Ouidah,300000,288251,2022-05-16
CASH_IN,60773,Agence_mtn_Cotonou,300000,239227,Michelle de la Daniel,1931,62704,2022-05-16
CASH_IN,35408,Agence_mtn_Abomey,300000,264592,Michelle de la Daniel,62704,98112,2022-05-17
CASH_OUT,85389,Michelle de la Daniel,98112,12723,Agence_mtn_Ouidah,300000,214611,2022-05-17
TRANSFER,8264,Michelle de la Daniel,12723,4459,Jérôme Laporte Le Gauthier,644700,636436,2022-05-17
CASH_IN,156882,Agence_mtn_Abomey,300000,143118,Michelle de la Daniel,4459,161341,2022-05-18
TRANSFER,215180,Sébastien Coste,344302,129122,Michelle de la Daniel,161341,376521,2022-05-22
CASH_IN,113898,Agence_mtn_Ouidah,300000,186102,Michelle de la Daniel,376521,490419,2022-05-22
CASH_OUT,463372,Michelle de la Daniel,490419,27047,Agence_mtn_Ouidah,300000,-163372,2022-05-22
CASH_IN,81123,Agence_mtn_Cotonou,300000,218877,Michelle de la Daniel,27047,108170,2022-05-22
TRANSFER,8613,Michelle de la Daniel,108170,99557,Anouk Delahaye-Gimenez,167800,159187,2022-05-24
CASH_IN,278312,Agence_mtn_Cotonou,300000,21688,Michelle de la Daniel,99557,377869,2022-05-24
CASH_OUT,274496,Michelle de la Daniel,377869,103373,Agence_mtn_Cotonou,300000,25504,2022-05-24
TRANSFER,173969,Jacques Le Marion,193773,19804,Michelle de la Daniel,103373,277342,2022-05-26
CASH_IN,128503,Agence_mtn_Ouidah,300000,171497,Nathalie Da Silva,1490241,1618744,2022-05-06
TRANSFER,512738,Valérie de Pottier,651992,139254,Nathalie Da Silva,1618744,2131482,2022-05-08
CASH_IN,166813,Agence_mtn_Cotonou,300000,133187,Nathalie Da Silva,2131482,2298295,2022-05-09
CASH_OUT,2167245,Nathalie Da Silva,2298295,131050,Agence_mtn_Abomey,300000,-1867245,2022-05-11
CASH_OUT,120029,Nathalie Da Silva,131050,11021,Agence_mtn_Ouidah,300000,179971,2022-05-13
TRANSFER,96364,Laurent Marion,369372,273008,Nathalie Da Silva,11021,107385,2022-05-13
TRANSFER,102218,Nathalie Da Silva,107385,5167,Marc Costa-Daniel,236039,133821,2022-05-14
TRANSFER,614,Nathalie Da Silva,5167,4553,Michèle Faivre,103815,103201,2022-05-14
CASH_IN,233765,Agence_mtn_Cotonou,300000,66235,Nathalie Da Silva,4553,238318,2022-05-14
TRANSFER,421631,Hélène Blanchard-Renault,485543,63912,Nathalie Da Silva,238318,659949,2022-05-15
CASH_OUT,600390,Nathalie Da Silva,659949,59559,Agence_mtn_Abomey,300000,-300390,2022-05-16
TRANSFER,214818,Charlotte Perrier,367468,152650,Nathalie Da Silva,59559,274377,2022-05-16
TRANSFER,36919,Nathalie Da Silva,274377,237458,Nathalie Da Silva,274377,311296,2022-05-17
CASH_IN,155719,Agence_mtn_Abomey,300000,144281,Nathalie Da Silva,237458,393177,2022-05-18
TRANSFER,70149,Nathalie Da Silva,393177,323028,Louise-Aurore Payet,1447810,1377661,2022-05-18
TRANSFER,11393,Nathalie Da Silva,323028,311635,Corinne Roussel,1030100,1018707,2022-05-19
CASH_IN,1376,Agence_mtn_Cotonou,300000,298624,Nathalie Da Silva,311635,313011,2022-05-21
CASH_IN,257336,Agence_mtn_Cotonou,300000,42664,Nathalie Da Silva,313011,570347,2022-05-24
CASH_IN,124171,Agence_mtn_Ouidah,300000,175829,Nathalie Da Silva,570347,694518,2022-05-24
TRANSFER,183207,Nathalie Da Silva,694518,511311,Georges Muller,366000,182793,2022-05-27
CASH_IN,68823,Agence_mtn_Abomey,300000,231177,Nathalie Da Silva,511311,580134,2022-05-27
CASH_IN,188292,Agence_mtn_Cotonou,300000,111708,Michèle Faivre,103201,291493,2022-05-03
CASH_OUT,216375,Michèle Faivre,291493,75118,Agence_mtn_Cotonou,300000,83625,2022-05-03
CASH_OUT,69962,Michèle Faivre,75118,5156,Agence_mtn_Cotonou,300000,230038,2022-05-06
CASH_IN,65744,Agence_mtn_Ouidah,300000,234256,Michèle Faivre,5156,70900,2022-05-08
CASH_IN,182848,Agence_mtn_Cotonou,300000,117152,Michèle Faivre,70900,253748,2022-05-08
CASH_OUT,31754,Michèle Faivre,253748,221994,Agence_mtn_Cotonou,300000,268246,2022-05-09
CASH_IN,168106,Agence_mtn_Abomey,300000,131894,Michèle Faivre,221994,390100,2022-05-10
TRANSFER,455417,Augustin-Jérôme Merle,687300,231883,Michèle Faivre,390100,845517,2022-05-12
CASH_IN,154811,Agence_mtn_Cotonou,300000,145189,Michèle Faivre,845517,1000328,2022-05-14
CASH_OUT,568033,Michèle Faivre,1000328,432295,Agence_mtn_Ouidah,300000,-268033,2022-05-14
TRANSFER,365657,Michèle Faivre,432295,66638,Aimé Bernier,298918,-66739,2022-05-15
TRANSFER,48462,Michèle Faivre,66638,18176,Honoré de la Prévost,677310,628848,2022-05-15
CASH_IN,236052,Agence_mtn_Abomey,300000,63948,Michèle Faivre,18176,254228,2022-05-16
CASH_OUT,39921,Michèle Faivre,254228,214307,Agence_mtn_Ouidah,300000,260079,2022-05-17
CASH_OUT,144840,Michèle Faivre,214307,69467,Agence_mtn_Abomey,300000,155160,2022-05-18
TRANSFER,653,Michèle Faivre,69467,68814,Louise-Aurore Payet,1377661,1377008,2022-05-18
TRANSFER,28860,Michèle Faivre,68814,39954,Augustin-Jérôme Merle,231883,203023,2022-05-18
CASH_IN,184614,Agence_mtn_Cotonou,300000,115386,Michèle Faivre,39954,224568,2022-05-19
CASH_IN,126344,Agence_mtn_Ouidah,300000,173656,Michèle Faivre,224568,350912,2022-05-20
CASH_OUT,298861,Michèle Faivre,350912,52051,Agence_mtn_Ouidah,300000,1139,2022-05-20
CASH_OUT,40064,Michèle Faivre,52051,11987,Agence_mtn_Cotonou,300000,259936,2022-05-22
CASH_OUT,5297,Michèle Faivre,11987,6690,Agence_mtn_Ouidah,300000,294703,2022-05-22
CASH_OUT,1884,Michèle Faivre,6690,4806,Agence_mtn_Abomey,300000,298116,2022-05-23
TRANSFER,2186,Michèle Faivre,4806,2620,Éléonore Marin Le Morel,704100,701914,2022-05-24
CASH_OUT,192,Michèle Faivre,2620,2428,Agence_mtn_Cotonou,300000,299808,2022-05-24
CASH_OUT,148,Michèle Faivre,2428,2280,Agence_mtn_Abomey,300000,299852,2022-05-25
CASH_OUT,1383,Michèle Faivre,2280,897,Agence_mtn_Abomey,300000,298617,2022-05-26
CASH_IN,80735,Agence_mtn_Ouidah,300000,219265,Sabine Perrier,-188774,-108039,2022-05-02
CASH_IN,208069,Agence_mtn_Ouidah,300000,91931,Sabine Perrier,-108039,100030,2022-05-03
TRANSFER,20345,Sabine Perrier,100030,79685,Jérôme Laporte Le Gauthier,636436,616091,2022-05-04
CASH_OUT,71915,Sabine Perrier,79685,7770,Agence_mtn_Ouidah,300000,228085,2022-05-05
CASH_OUT,4866,Sabine Perrier,7770,2904,Agence_mtn_Cotonou,300000,295134,2022-05-06
CASH_OUT,2523,Sabine Perrier,2904,381,Agence_mtn_Cotonou,300000,297477,2022-05-07
TRANSFER,228097,Guillaume de la Nguyen,1955500,1727403,Sabine Perrier,381,228478,2022-05-07
TRANSFER,191237,Sabine Perrier,228478,37241,Nathalie-Claire De Oliveira,240504,49267,2022-05-09
CASH_OUT,15800,Sabine Perrier,37241,21441,Agence_mtn_Ouidah,300000,284200,2022-05-09
TRANSFER,3445,Sabine Perrier,21441,17996,Éléonore Marin Le Morel,701914,698469,2022-05-10
CASH_IN,133211,Agence_mtn_Ouidah,300000,166789,Sabine Perrier,17996,151207,2022-05-12
CASH_OUT,92088,Sabine Perrier,151207,59119,Agence_mtn_Abomey,300000,207912,2022-05-12
TRANSFER,48983,Sabine Perrier,59119,10136,Clémence-Alice Ruiz,12470,-36513,2022-05-12
CASH_IN,242413,Agence_mtn_Ouidah,300000,57587,Sabine Perrier,10136,252549,2022-05-14
CASH_OUT,131436,Sabine Perrier,252549,121113,Agence_mtn_Ouidah,300000,168564,2022-05-15
CASH_OUT,53019,Sabine Perrier,121113,68094,Agence_mtn_Ouidah,300000,246981,2022-05-15
CASH_OUT,5108,Sabine Perrier,68094,62986,Agence_mtn_Cotonou,300000,294892,2022-05-15
CASH_OUT,53439,Sabine Perrier,62986,9547,Agence_mtn_Ouidah,300000,246561,2022-05-16
TRANSFER,94950,Marc Costa-Daniel,133821,38871,Sabine Perrier,9547,104497,2022-05-17
CASH_OUT,101509,Sabine Perrier,104497,2988,Agence_mtn_Cotonou,300000,198491,2022-05-19
TRANSFER,33839,Hélène Blanchard-Renault,63912,30073,Sabine Perrier,2988,36827,2022-05-21
TRANSFER,30236,Sabine Perrier,36827,6591,Gérard Blot de Blanc,1344400,1314164,2022-05-21
CASH_OUT,1791,Sabine Perrier,6591,4800,Agence_mtn_Ouidah,300000,298209,2022-05-22
CASH_OUT,2434,Sabine Perrier,4800,2366,Agence_mtn_Cotonou,300000,297566,2022-05-23
CASH_IN,62384,Agence_mtn_Cotonou,300000,237616,Sabine Perrier,2366,64750,2022-05-24
TRANSFER,55757,Sabine Perrier,64750,8993,Roland Huet,467786,412029,2022-05-24
TRANSFER,10458,Élisabeth Blot-Bruneau,1567359,1556901,Sabine Perrier,8993,19451,2022-05-26
CASH_OUT,8920,Sabine Perrier,19451,10531,Agence_mtn_Ouidah,300000,291080,2022-05-27
TRANSFER,482563,Marthe Perrin,721951,239388,Christophe Besnard-Diaz,39000,521563,2022-05-04
CASH_IN,274563,Agence_mtn_Cotonou,300000,25437,Christophe Besnard-Diaz,521563,796126,2022-05-05
TRANSFER,60510,Christophe Besnard-Diaz,796126,735616,Valérie de Pottier,139254,78744,2022-05-05
TRANSFER,198033,Christophe Besnard-Diaz,735616,537583,Nathalie-Claire De Oliveira,49267,-148766,2022-05-05
CASH_OUT,284089,Christophe Besnard-Diaz,537583,253494,Agence_mtn_Ouidah,300000,15911,2022-05-07
TRANSFER,153569,Christophe Besnard-Diaz,253494,99925,Christophe Besnard-Diaz,253494,407063,2022-05-10
CASH_IN,258528,Agence_mtn_Abomey,300000,41472,Christophe Besnard-Diaz,99925,358453,2022-05-12
TRANSFER,29014,Marc Costa-Daniel,38871,9857,Christophe Besnard-Diaz,358453,387467,2022-05-14
CASH_OUT,173689,Christophe Besnard-Diaz,387467,213778,Agence_mtn_Cotonou,300000,126311,2022-05-15
CASH_OUT,25019,Christophe Besnard-Diaz,213778,188759,Agence_mtn_Ouidah,300000,274981,2022-05-15
CASH_IN,83966,Agence_mtn_Abomey,300000,216034,Christophe Besnard-Diaz,188759,272725,2022-05-15
CASH_IN,69470,Agence_mtn_Abomey,300000,230530,Christophe Besnard-Diaz,272725,342195,2022-05-18
CASH_IN,296866,Agence_mtn_Ouidah,300000,3134,Christophe Besnard-Diaz,342195,639061,2022-05-19
CASH_IN,210464,Agence_mtn_Cotonou,300000,89536,Christophe Besnard-Diaz,639061,849525,2022-05-19
CASH_OUT,746243,Christophe Besnard-Diaz,849525,103282,Agence_mtn_Abomey,300000,-446243,2022-05-19
TRANSFER,5891,Hélène Blanchard-Renault,30073,24182,Christophe Besnard-Diaz,103282,109173,2022-05-20
CASH_OUT,74692,Christophe Besnard-Diaz,109173,34481,Agence_mtn_Abomey,300000,225308,2022-05-22
CASH_OUT,7287,Christophe Besnard-Diaz,34481,27194,Agence_mtn_Cotonou,300000,292713,2022-05-24
CASH_IN,253198,Agence_mtn_Ouidah,300000,46802,Christophe Besnard-Diaz,27194,280392,2022-05-25
TRANSFER,40755,Christophe Besnard-Diaz,280392,239637,Gérard Blot de Blanc,1314164,1273409,2022-05-26
TRANSFER,171737,Véronique Hardy,543630,371893,Christophe Besnard-Diaz,239637,411374,2022-05-26
TRANSFER,6973,René de la Delaunay,105500,98527,Édouard Grondin du Fleury,1964200,1971173,2022-05-01
CASH_IN,62342,Agence_mtn_Cotonou,300000,237658,Édouard Grondin du Fleury,1971173,2033515,2022-05-01
CASH_OUT,198983,Édouard Grondin du Fleury,2033515,1834532,Agence_mtn_Cotonou,300000,101017,2022-05-03
TRANSFER,293086,Édouard Grondin du Fleury,1834532,1541446,Jean Guilbert-Lenoir,447900,154814,2022-05-04
TRANSFER,9027,Édouard Grondin du Fleury,1541446,1532419,Guillaume de la Nguyen,1727403,1718376,2022-05-04
CASH_OUT,540930,Édouard Grondin du Fleury,1532419,991489,Agence_mtn_Cotonou,300000,-240930,2022-05-05
TRANSFER,175763,Madeleine Philippe-Grondin,179100,3337,Édouard Grondin du Fleury,991489,1167252,2022-05-05
TRANSFER,1085116,Édouard Grondin du Fleury,1167252,82136,Astrid Aubert-Thierry,401900,-683216,2022-05-05
CASH_OUT,21313,Édouard Grondin du Fleury,82136,60823,Agence_mtn_Cotonou,300000,278687,2022-05-06
CASH_OUT,48436,Édouard Grondin du Fleury,60823,12387,Agence_mtn_Abomey,300000,251564,2022-05-06
CASH_IN,195221,Agence_mtn_Ouidah,300000,104779,Édouard Grondin du Fleury,12387,207608,2022-05-07
CASH_OUT,25852,Édouard Grondin du Fleury,207608,181756,Agence_mtn_Abomey,300000,274148,2022-05-08
CASH_OUT,50670,Édouard Grondin du Fleury,181756,131086,Agence_mtn_Abomey,300000,249330,2022-05-08
CASH_OUT,21326,Édouard Grondin du Fleury,131086,109760,Agence_mtn_Abomey,300000,278674,2022-05-10
CASH_IN,41139,Agence_mtn_Cotonou,300000,258861,Édouard Grondin du Fleury,109760,150899,2022-05-10
CASH_OUT,26414,Édouard Grondin du Fleury,150899,124485,Agence_mtn_Ouidah,300000,273586,2022-05-11
TRANSFER,108158,Marc Baudry,315700,207542,Édouard Grondin du Fleury,124485,232643,2022-05-12
TRANSFER,49972,Édouard Grondin du Fleury,232643,182671,Anouk Delahaye-Gimenez,159187,109215,2022-05-15
CASH_OUT,4118,Édouard Grondin du Fleury,182671,178553,Agence_mtn_Ouidah,300000,295882,2022-05-18
CASH_IN,201167,Agence_mtn_Abomey,300000,98833,Édouard Grondin du Fleury,178553,379720,2022-05-18
CASH_OUT,158120,Édouard Grondin du Fleury,379720,221600,Agence_mtn_Abomey,300000,141880,2022-05-20
CASH_OUT,105634,Édouard Grondin du Fleury,221600,115966,Agence_mtn_Abomey,300000,194366,2022-05-20
CASH_OUT,114713,Édouard Grondin du Fleury,115966,1253,Agence_mtn_Abomey,300000,185287,2022-05-20
CASH_IN,238866,Agence_mtn_Cotonou,300000,61134,Édouard Grondin du Fleury,1253,240119,2022-05-22
CASH_OUT,161293,Édouard Grondin du Fleury,240119,78826,Agence_mtn_Cotonou,300000,138707,2022-05-27
CASH_IN,291099,Agence_mtn_Ouidah,300000,8901,Guillaume de la Nguyen,1718376,2009475,2022-05-01
TRANSFER,3446,Marc Costa-Daniel,9857,6411,Guillaume de la Nguyen,2009475,2012921,2022-05-03
TRANSFER,745835,Guillaume de la Nguyen,2012921,1267086,Corinne Roussel,1018707,272872,2022-05-03
CASH_OUT,1014246,Guillaume de la Nguyen,1267086,252840,Agence_mtn_Abomey,300000,-714246,2022-05-04
CASH_IN,123256,Agence_mtn_Abomey,300000,176744,Guillaume de la Nguyen,252840,376096,2022-05-05
CASH_IN,2330,Agence_mtn_Ouidah,300000,297670,Guillaume de la Nguyen,376096,378426,2022-05-07
TRANSFER,1022312,Josette du Hamon,1403045,380733,Guillaume de la Nguyen,378426,1400738,2022-05-08
CASH_OUT,580814,Guillaume de la Nguyen,1400738,819924,Agence_mtn_Abomey,300000,-280814,2022-05-08
CASH_OUT,572090,Guillaume de la Nguyen,819924,247834,Agence_mtn_Ouidah,300000,-272090,2022-05-09
CASH_OUT,137819,Guillaume de la Nguyen,247834,110015,Agence_mtn_Abomey,300000,162181,2022-05-09
CASH_IN,118664,Agence_mtn_Abomey,300000,181336,Guillaume de la Nguyen,110015,228679,2022-05-10
CASH_IN,125178,Agence_mtn_Abomey,300000,174822,Guillaume de la Nguyen,228679,353857,2022-05-11
CASH_OUT,267791,Guillaume de la Nguyen,353857,86066,Agence_mtn_Cotonou,300000,32209,2022-05-13
CASH_OUT,14835,Guillaume de la Nguyen,86066,71231,Agence_mtn_Abomey,300000,285165,2022-05-14
TRANSFER,386846,Georges-Alfred Pruvost,984400,597554,Guillaume de la Nguyen,71231,458077,2022-05-15
CASH_IN,182021,Agence_mtn_Cotonou,300000,117979,Guillaume de la Nguyen,458077,640098,2022-05-16
CASH_IN,74042,Agence_mtn_Cotonou,300000,225958,Guillaume de la Nguyen,640098,714140,2022-05-19
CASH_OUT,299024,Guillaume de la Nguyen,714140,415116,Agence_mtn_Cotonou,300000,976,2022-05-21
TRANSFER,77341,Louis de la Imbert,87023,9682,Guillaume de la Nguyen,415116,492457,2022-05-22
CASH_OUT,46504,Guillaume de la Nguyen,492457,445953,Agence_mtn_Cotonou,300000,253496,2022-05-23
CASH_OUT,185611,Guillaume de la Nguyen,445953,260342,Agence_mtn_Cotonou,300000,114389,2022-05-23
CASH_OUT,152534,Guillaume de la Nguyen,260342,107808,Agence_mtn_Ouidah,300000,147466,2022-05-25
CASH_IN,94098,Agence_mtn_Abomey,300000,205902,Guillaume de la Nguyen,107808,201906,2022-05-25
TRANSFER,488,Louis de la Imbert,9682,9194,Guillaume de la Nguyen,201906,202394,2022-05-27
TRANSFER,113993,Laurent Marion,273008,159015,Éléonore Marin Le Morel,698469,584476,2022-05-02
CASH_OUT,114189,Laurent Marion,159015,44826,Agence_mtn_Ouidah,300000,185811,2022-05-03
CASH_OUT,26486,Laurent Marion,44826,18340,Agence_mtn_Cotonou,300000,273514,2022-05-04
TRANSFER,5009,Hélène Blanchard-Renault,24182,19173,Laurent Marion,18340,23349,2022-05-07
CASH_OUT,21722,Laurent Marion,23349,1627,Agence_mtn_Cotonou,300000,278278,2022-05-09
CASH_IN,202682,Agence_mtn_Cotonou,300000,97318,Laurent Marion,1627,204309,2022-05-09
CASH_IN,139127,Agence_mtn_Abomey,300000,160873,Laurent Marion,204309,343436,2022-05-09
CASH_OUT,33052,Laurent Marion,343436,310384,Agence_mtn_Ouidah,300000,266948,2022-05-10
CASH_OUT,230044,Laurent Marion,310384,80340,Agence_mtn_Cotonou,300000,69956,2022-05-10
CASH_OUT,32515,Laurent Marion,80340,47825,Agence_mtn_Ouidah,300000,267485,2022-05-11
TRANSFER,252850,Gérard Cordier,358571,105721,Laurent Marion,47825,300675,2022-05-11
CASH_OUT,158914,Laurent Marion,300675,141761,Agence_mtn_Ouidah,300000,141086,2022-05-12
CASH_OUT,17664,Laurent Marion,141761,124097,Agence_mtn_Cotonou,300000,282336,2022-05-12
CASH_IN,196586,Agence_mtn_Ouidah,300000,103414,Laurent Marion,124097,320683,2022-05-12
CASH_IN,263142,Agence_mtn_Abomey,300000,36858,Laurent Marion,320683,583825,2022-05-14
CASH_OUT,52096,Laurent Marion,583825,531729,Agence_mtn_Abomey,300000,247904,2022-05-14
TRANSFER,31051,Laurent Marion,531729,500678,Gérard Cordier,105721,74670,2022-05-15
TRANSFER,70814,Raymond de Le Roux,367035,296221,Laurent Marion,500678,571492,2022-05-16
TRANSFER,538424,Louise-Aurore Payet,1377008,838584,Laurent Marion,571492,1109916,2022-05-19
CASH_IN,142988,Agence_mtn_Ouidah,300000,157012,Laurent Marion,1109916,1252904,2022-05-19
TRANSFER,893969,Laurent Marion,1252904,358935,Valérie de Pottier,78744,-815225,2022-05-19
TRANSFER,101249,Anouk Delahaye-Gimenez,109215,7966,Laurent Marion,358935,460184,2022-05-20
TRANSFER,148588,Laurent Marion,460184,311596,Marc Costa-Daniel,6411,-142177,2022-05-20
TRANSFER,140701,Nicole Huet,261000,120299,Laurent Marion,311596,452297,2022-05-21
TRANSFER,431264,Gilbert Moulin,1259522,828258,Laurent Marion,452297,883561,2022-05-21
TRANSFER,18446,Alfred Paris,250720,232274,Laurent Marion,883561,902007,2022-05-22
CASH_IN,297943,Agence_mtn_Cotonou,300000,2057,Laurent Marion,902007,1199950,2022-05-22
CASH_IN,11252,Agence_mtn_Ouidah,300000,288748,Laurent Marion,1199950,1211202,2022-05-22
CASH_IN,95054,Agence_mtn_Abomey,300000,204946,Laurent Marion,1211202,1306256,2022-05-23
CASH_IN,172586,Agence_mtn_Cotonou,300000,127414,Laurent Marion,1306256,1478842,2022-05-25
CASH_IN,49404,Agence_mtn_Ouidah,300000,250596,Jules-Marc Chauvet,-127593,-78189,2022-05-04
CASH_IN,257046,Agence_mtn_Ouidah,300000,42954,Jules-Marc Chauvet,-78189,178857,2022-05-05
TRANSFER,32554,René de la Delaunay,98527,65973,Jules-Marc Chauvet,178857,211411,2022-05-05
CASH_OUT,149429,Jules-Marc Chauvet,211411,61982,Agence_mtn_Abomey,300000,150571,2022-05-05
CASH_IN,274663,Agence_mtn_Cotonou,300000,25337,Jules-Marc Chauvet,61982,336645,2022-05-06
CASH_IN,74709,Agence_mtn_Ouidah,300000,225291,Jules-Marc Chauvet,336645,411354,2022-05-09
TRANSFER,550122,Françoise Denis de Allard,1799900,1249778,Jules-Marc Chauvet,411354,961476,2022-05-10
CASH_OUT,806333,Jules-Marc Chauvet,961476,155143,Agence_mtn_Cotonou,300000,-506333,2022-05-11
CASH_IN,238891,Agence_mtn_Abomey,300000,61109,Jules-Marc Chauvet,155143,394034,2022-05-13
CASH_IN,164806,Agence_mtn_Abomey,300000,135194,Jules-Marc Chauvet,394034,558840,2022-05-15
TRANSFER,277715,Jules-Marc Chauvet,558840,281125,Jérôme Laporte Le Gauthier,616091,338376,2022-05-16
CASH_IN,255308,Agence_mtn_Ouidah,300000,44692,Jules-Marc Chauvet,281125,536433,2022-05-16
CASH_IN,219641,Agence_mtn_Abomey,300000,80359,Jules-Marc Chauvet,536433,756074,2022-05-19
TRANSFER,136512,Élisabeth Blot-Bruneau,1556901,1420389,Jules-Marc Chauvet,756074,892586,2022-05-20
CASH_IN,156290,Agence_mtn_Abomey,300000,143710,Jules-Marc Chauvet,892586,1048876,2022-05-20
CASH_IN,296593,Agence_mtn_Ouidah,300000,3407,Jules-Marc Chauvet,1048876,1345469,2022-05-20
CASH_OUT,1084598,Jules-Marc Chauvet,1345469,260871,Agence_mtn_Cotonou,300000,-784598,2022-05-22
CASH_IN,227678,Agence_mtn_Ouidah,300000,72322,Jules-Marc Chauvet,260871,488549,2022-05-25
CASH_IN,53702,Agence_mtn_Cotonou,300000,246298,Jules-Marc Chauvet,488549,542251,2022-05-26
CASH_IN,214957,Agence_mtn_Cotonou,300000,85043,Jules-Marc Chauvet,542251,757208,2022-05-27
CASH_OUT,558415,Jules-Marc Chauvet,757208,198793,Agence_mtn_Ouidah,300000,-258415,2022-05-27
CASH_IN,12782,Agence_mtn_Abomey,300000,287218,Corinne Roussel,272872,285654,2022-05-01
TRANSFER,10354,Gérard Cordier,74670,64316,Corinne Roussel,285654,296008,2022-05-02
CASH_IN,183977,Agence_mtn_Abomey,300000,116023,Corinne Roussel,296008,479985,2022-05-05
CASH_OUT,382071,Corinne Roussel,479985,97914,Agence_mtn_Cotonou,300000,-82071,2022-05-06
TRANSFER,17484,Corinne Roussel,97914,80430,Roland Huet,412029,394545,2022-05-08
CASH_OUT,43161,Corinne Roussel,80430,37269,Agence_mtn_Abomey,300000,256839,2022-05-08
CASH_IN,129266,Agence_mtn_Cotonou,300000,170734,Corinne Roussel,37269,166535,2022-05-10
CASH_OUT,79940,Corinne Roussel,166535,86595,Agence_mtn_Cotonou,300000,220060,2022-05-11
CASH_IN,121387,Agence_mtn_Cotonou,300000,178613,Corinne Roussel,86595,207982,2022-05-13
CASH_OUT,131714,Corinne Roussel,207982,76268,Agence_mtn_Ouidah,300000,168286,2022-05-14
CASH_IN,86730,Agence_mtn_Cotonou,300000,213270,Corinne Roussel,76268,162998,2022-05-14
CASH_OUT,19989,Corinne Roussel,162998,143009,Agence_mtn_Cotonou,300000,280011,2022-05-17
TRANSFER,337224,Josette du Hamon,380733,43509,Corinne Roussel,143009,480233,2022-05-17
TRANSFER,38094,Corinne Roussel,480233,442139,Élisabeth Delattre,95346,57252,2022-05-19
CASH_IN,181240,Agence_mtn_Cotonou,300000,118760,Corinne Roussel,442139,623379,2022-05-19
TRANSFER,215900,Corinne Roussel,623379,407479,Honoré de la Prévost,628848,412948,2022-05-21
CASH_IN,208119,Agence_mtn_Abomey,300000,91881,Corinne Roussel,407479,615598,2022-05-21
CASH_OUT,461381,Corinne Roussel,615598,154217,Agence_mtn_Ouidah,300000,-161381,2022-05-21
CASH_OUT,91986,Corinne Roussel,154217,62231,Agence_mtn_Ouidah,300000,208014,2022-05-22
CASH_OUT,18917,Corinne Roussel,62231,43314,Agence_mtn_Cotonou,300000,281083,2022-05-23
CASH_OUT,5174,Corinne Roussel,43314,38140,Agence_mtn_Abomey,300000,294826,2022-05-24
TRANSFER,224412,Honoré de la Prévost,412948,188536,Corinne Roussel,38140,262552,2022-05-24
CASH_IN,83733,Agence_mtn_Ouidah,300000,216267,Corinne Roussel,262552,346285,2022-05-27
TRANSFER,1362884,Margaud-Michelle Briand,1442700,79816,Corinne Roussel,346285,1709169,2022-05-27
CASH_OUT,122741,Alfred Paris,232274,109533,Agence_mtn_Cotonou,300000,177259,2022-05-01
TRANSFER,5847,Anouk Delahaye-Gimenez,7966,2119,Alfred Paris,109533,115380,2022-05-01
TRANSFER,1266982,Élisabeth Blot-Bruneau,1420389,153407,Alfred Paris,115380,1382362,2022-05-02
CASH_IN,296336,Agence_mtn_Abomey,300000,3664,Alfred Paris,1382362,1678698,2022-05-02
CASH_IN,273533,Agence_mtn_Ouidah,300000,26467,Alfred Paris,1678698,1952231,2022-05-02
CASH_OUT,1386410,Alfred Paris,1952231,565821,Agence_mtn_Abomey,300000,-1086410,2022-05-03
CASH_OUT,365536,Alfred Paris,565821,200285,Agence_mtn_Ouidah,300000,-65536,2022-05-04
CASH_IN,121057,Agence_mtn_Cotonou,300000,178943,Alfred Paris,200285,321342,2022-05-05
TRANSFER,118243,Marc Baudry,207542,89299,Alfred Paris,321342,439585,2022-05-06
CASH_IN,227477,Agence_mtn_Cotonou,300000,72523,Alfred Paris,439585,667062,2022-05-07
TRANSFER,210241,Alfred Paris,667062,456821,Louise-Aurore Payet,838584,628343,2022-05-09
CASH_IN,281113,Agence_mtn_Cotonou,300000,18887,Alfred Paris,456821,737934,2022-05-09
CASH_OUT,487103,Alfred Paris,737934,250831,Agence_mtn_Cotonou,300000,-187103,2022-05-11
TRANSFER,16180,Alfred Paris,250831,234651,Hélène Blanchard-Renault,19173,2993,2022-05-11
CASH_OUT,40884,Alfred Paris,234651,193767,Agence_mtn_Cotonou,300000,259116,2022-05-11
TRANSFER,35595,Alfred Paris,193767,158172,Georges-Alfred Pruvost,597554,561959,2022-05-12
TRANSFER,54163,Alfred Paris,158172,104009,Valérie-Claudine Marin,312463,258300,2022-05-13
TRANSFER,57424,René de la Delaunay,65973,8549,Alfred Paris,104009,161433,2022-05-15
CASH_OUT,58601,Alfred Paris,161433,102832,Agence_mtn_Ouidah,300000,241399,2022-05-16
CASH_OUT,39290,Alfred Paris,102832,63542,Agence_mtn_Cotonou,300000,260710,2022-05-18
TRANSFER,194477,Jérôme Laporte Le Gauthier,338376,143899,Alfred Paris,63542,258019,2022-05-18
TRANSFER,43417,Alfred Paris,258019,214602,Céline-Inès Meunier,824600,781183,2022-05-18
CASH_OUT,22678,Alfred Paris,214602,191924,Agence_mtn_Cotonou,300000,277322,2022-05-19
CASH_IN,97180,Agence_mtn_Ouidah,300000,202820,Alfred Paris,191924,289104,2022-05-21
TRANSFER,158749,Alfred Paris,289104,130355,Françoise Denis de Allard,1249778,1091029,2022-05-22
CASH_OUT,123422,Alfred Paris,130355,6933,Agence_mtn_Abomey,300000,176578,2022-05-22
CASH_OUT,1870,Alfred Paris,6933,5063,Agence_mtn_Ouidah,300000,298130,2022-05-22
TRANSFER,2864,Alfred Paris,5063,2199,Françoise Denis de Allard,1091029,1088165,2022-05-22
CASH_OUT,1509,Alfred Paris,2199,690,Agence_mtn_Abomey,300000,298491,2022-05-26
CASH_IN,268349,Agence_mtn_Cotonou,300000,31651,Alfred Paris,690,269039,2022-05-26
CASH_IN,139351,Agence_mtn_Cotonou,300000,160649,Raymond de Le Roux,296221,435572,2022-05-02
TRANSFER,407111,Raymond de Le Roux,435572,28461,Honoré de la Prévost,188536,-218575,2022-05-04
CASH_IN,114872,Agence_mtn_Cotonou,300000,185128,Raymond de Le Roux,28461,143333,2022-05-04
CASH_OUT,31279,Raymond de Le Roux,143333,112054,Agence_mtn_Ouidah,300000,268721,2022-05-08
TRANSFER,80240,Raymond de Le Roux,112054,31814,Élisabeth Blot-Bruneau,153407,73167,2022-05-10
TRANSFER,5386,Raymond de Le Roux,31814,26428,Georges Muller,182793,177407,2022-05-11
CASH_OUT,21346,Raymond de Le Roux,26428,5082,Agence_mtn_Ouidah,300000,278654,2022-05-11
CASH_IN,149944,Agence_mtn_Ouidah,300000,150056,Raymond de Le Roux,5082,155026,2022-05-11
CASH_OUT,12805,Raymond de Le Roux,155026,142221,Agence_mtn_Cotonou,300000,287195,2022-05-12
CASH_IN,135707,Agence_mtn_Cotonou,300000,164293,Raymond de Le Roux,142221,277928,2022-05-12
CASH_IN,256002,Agence_mtn_Abomey,300000,43998,Raymond de Le Roux,277928,533930,2022-05-12
CASH_IN,268033,Agence_mtn_Cotonou,300000,31967,Raymond de Le Roux,533930,801963,2022-05-12
CASH_IN,18934,Agence_mtn_Ouidah,300000,281066,Raymond de Le Roux,801963,820897,2022-05-13
CASH_IN,196666,Agence_mtn_Abomey,300000,103334,Raymond de Le Roux,820897,1017563,2022-05-13
TRANSFER,1245729,Margot Julien,1699435,453706,Raymond de Le Roux,1017563,2263292,2022-05-16
TRANSFER,1475937,Raymond de Le Roux,2263292,787355,Françoise Denis de Allard,1088165,-387772,2022-05-17
TRANSFER,599,Anouk Delahaye-Gimenez,2119,1520,Raymond de Le Roux,787355,787954,2022-05-20
CASH_IN,53734,Agence_mtn_Cotonou,300000,246266,Raymond de Le Roux,787954,841688,2022-05-23
CASH_IN,118159,Agence_mtn_Cotonou,300000,181841,Raymond de Le Roux,841688,959847,2022-05-24
CASH_IN,58061,Agence_mtn_Abomey,300000,241939,Raymond de Le Roux,959847,1017908,2022-05-25
CASH_OUT,893190,Raymond de Le Roux,1017908,124718,Agence_mtn_Ouidah,300000,-593190,2022-05-25
CASH_OUT,14615,Raymond de Le Roux,124718,110103,Agence_mtn_Ouidah,300000,285385,2022-05-27
CASH_IN,221869,Agence_mtn_Cotonou,300000,78131,Guy-Augustin Pinto,64110,285979,2022-05-01
TRANSFER,14858,Louis du Boyer,18400,3542,Guy-Augustin Pinto,285979,300837,2022-05-03
CASH_IN,84956,Agence_mtn_Abomey,300000,215044,Guy-Augustin Pinto,300837,385793,2022-05-05
TRANSFER,348996,Guy-Augustin Pinto,385793,36797,Gérard Cordier,64316,-284680,2022-05-05
CASH_IN,255649,Agence_mtn_Ouidah,300000,44351,Guy-Augustin Pinto,36797,292446,2022-05-07
CASH_OUT,37001,Guy-Augustin Pinto,292446,255445,Agence_mtn_Cotonou,300000,262999,2022-05-08
CASH_IN,295696,Agence_mtn_Cotonou,300000,4304,Guy-Augustin Pinto,255445,551141,2022-05-08
TRANSFER,353177,Véronique Hardy,371893,18716,Guy-Augustin Pinto,551141,904318,2022-05-09
TRANSFER,640018,Guy-Augustin Pinto,904318,264300,Véronique Hardy,18716,-621302,2022-05-10
CASH_OUT,86619,Guy-Augustin Pinto,264300,177681,Agence_mtn_Ouidah,300000,213381,2022-05-14
TRANSFER,664,Anouk Delahaye-Gimenez,1520,856,Guy-Augustin Pinto,177681,178345,2022-05-15
CASH_IN,277694,Agence_mtn_Ouidah,300000,22306,Guy-Augustin Pinto,178345,456039,2022-05-15
CASH_IN,25804,Agence_mtn_Ouidah,300000,274196,Guy-Augustin Pinto,456039,481843,2022-05-17
CASH_OUT,199148,Guy-Augustin Pinto,481843,282695,Agence_mtn_Cotonou,300000,100852,2022-05-17
CASH_IN,284948,Agence_mtn_Ouidah,300000,15052,Guy-Augustin Pinto,282695,567643,2022-05-17
TRANSFER,538223,Guy-Augustin Pinto,567643,29420,Sébastien Coste,129122,-409101,2022-05-18
CASH_OUT,10344,Guy-Augustin Pinto,29420,19076,Agence_mtn_Ouidah,300000,289656,2022-05-18
CASH_OUT,7739,Guy-Augustin Pinto,19076,11337,Agence_mtn_Cotonou,300000,292261,2022-05-19
CASH_IN,53162,Agence_mtn_Ouidah,300000,246838,Guy-Augustin Pinto,11337,64499,2022-05-19
CASH_OUT,42728,Guy-Augustin Pinto,64499,21771,Agence_mtn_Cotonou,300000,257272,2022-05-21
CASH_IN,77072,Agence_mtn_Abomey,300000,222928,Guy-Augustin Pinto,21771,98843,2022-05-21
CASH_OUT,56641,Guy-Augustin Pinto,98843,42202,Agence_mtn_Abomey,300000,243359,2022-05-22
CASH_OUT,19593,Guy-Augustin Pinto,42202,22609,Agence_mtn_Abomey,300000,280407,2022-05-23
CASH_OUT,11335,Guy-Augustin Pinto,22609,11274,Agence_mtn_Abomey,300000,288665,2022-05-24
CASH_OUT,6895,Guy-Augustin Pinto,11274,4379,Agence_mtn_Ouidah,300000,293105,2022-05-24
CASH_OUT,4056,Guy-Augustin Pinto,4379,323,Agence_mtn_Ouidah,300000,295944,2022-05-25
CASH_OUT,120,Guy-Augustin Pinto,323,203,Agence_mtn_Abomey,300000,299880,2022-05-25
CASH_IN,206168,Agence_mtn_Ouidah,300000,93832,Marc Costa-Daniel,-142177,63991,2022-05-01
TRANSFER,34197,Marc Costa-Daniel,63991,29794,Margot Julien,453706,419509,2022-05-01
CASH_OUT,4150,Marc Costa-Daniel,29794,25644,Agence_mtn_Ouidah,300000,295850,2022-05-02
CASH_IN,146044,Agence_mtn_Cotonou,300000,153956,Marc Costa-Daniel,25644,171688,2022-05-02
CASH_OUT,155284,Marc Costa-Daniel,171688,16404,Agence_mtn_Ouidah,300000,144716,2022-05-02
CASH_IN,198406,Agence_mtn_Abomey,300000,101594,Marc Costa-Daniel,16404,214810,2022-05-04
CASH_OUT,170289,Marc Costa-Daniel,214810,44521,Agence_mtn_Ouidah,300000,129711,2022-05-05
CASH_IN,65719,Agence_mtn_Cotonou,300000,234281,Marc Costa-Daniel,44521,110240,2022-05-05
TRANSFER,10003,Marc Costa-Daniel,110240,100237,Jérôme Laporte Le Gauthier,143899,133896,2022-05-07
CASH_IN,11310,Agence_mtn_Ouidah,300000,288690,Marc Costa-Daniel,100237,111547,2022-05-09
CASH_IN,37826,Agence_mtn_Cotonou,300000,262174,Marc Costa-Daniel,111547,149373,2022-05-10
CASH_IN,157502,Agence_mtn_Abomey,300000,142498,Marc Costa-Daniel,149373,306875,2022-05-11
CASH_OUT,7637,Marc Costa-Daniel,306875,299238,Agence_mtn_Cotonou,300000,292363,2022-05-11
CASH_IN,252524,Agence_mtn_Abomey,300000,47476,Marc Costa-Daniel,299238,551762,2022-05-12
CASH_IN,252634,Agence_mtn_Ouidah,300000,47366,Marc Costa-Daniel,551762,804396,2022-05-13
CASH_IN,265980,Agence_mtn_Ouidah,300000,34020,Marc Costa-Daniel,804396,1070376,2022-05-15
TRANSFER,40831,Nicole Huet,120299,79468,Marc Costa-Daniel,1070376,1111207,2022-05-15
TRANSFER,281797,Roland Huet,394545,112748,Marc Costa-Daniel,1111207,1393004,2022-05-16
TRANSFER,148,Anouk Delahaye-Gimenez,856,708,Marc Costa-Daniel,1393004,1393152,2022-05-16
CASH_IN,63940,Agence_mtn_Ouidah,300000,236060,Marc Costa-Daniel,1393152,1457092,2022-05-18
CASH_OUT,744587,Marc Costa-Daniel,1457092,712505,Agence_mtn_Ouidah,300000,-444587,2022-05-20
TRANSFER,96841,Marc Costa-Daniel,712505,615664,Charlotte Perrier,152650,55809,2022-05-21
TRANSFER,163370,Éléonore Marin Le Morel,584476,421106,Marc Costa-Daniel,615664,779034,2022-05-21
CASH_IN,127122,Agence_mtn_Abomey,300000,172878,Marc Costa-Daniel,779034,906156,2022-05-22
CASH_OUT,6214,Marc Costa-Daniel,906156,899942,Agence_mtn_Cotonou,300000,293786,2022-05-23
TRANSFER,214201,Marthe Perrin,239388,25187,Marc Costa-Daniel,899942,1114143,2022-05-24
TRANSFER,144004,Martin Moreau,253541,109537,Marc Costa-Daniel,1114143,1258147,2022-05-24
CASH_IN,43223,Agence_mtn_Cotonou,300000,256777,Marc Costa-Daniel,1258147,1301370,2022-05-25
CASH_IN,280670,Agence_mtn_Abomey,300000,19330,Hélène Alexandre de la Samson,-567494,-286824,2022-05-01
CASH_IN,8052,Agence_mtn_Cotonou,300000,291948,Hélène Alexandre de la Samson,-286824,-278772,2022-05-03
CASH_IN,298997,Agence_mtn_Cotonou,300000,1003,Hélène Alexandre de la Samson,-278772,20225,2022-05-04
CASH_IN,67040,Agence_mtn_Abomey,300000,232960,Hélène Alexandre de la Samson,20225,87265,2022-05-04
CASH_IN,85379,Agence_mtn_Ouidah,300000,214621,Hélène Alexandre de la Samson,87265,172644,2022-05-04
CASH_OUT,65241,Hélène Alexandre de la Samson,172644,107403,Agence_mtn_Abomey,300000,234759,2022-05-05
CASH_OUT,56726,Hélène Alexandre de la Samson,107403,50677,Agence_mtn_Abomey,300000,243274,2022-05-05
CASH_IN,82047,Agence_mtn_Abomey,300000,217953,Hélène Alexandre de la Samson,50677,132724,2022-05-07
CASH_IN,173403,Agence_mtn_Abomey,300000,126597,Hélène Alexandre de la Samson,132724,306127,2022-05-08
TRANSFER,4824,Louis de la Imbert,9194,4370,Hélène Alexandre de la Samson,306127,310951,2022-05-08
CASH_IN,170323,Agence_mtn_Ouidah,300000,129677,Hélène Alexandre de la Samson,310951,481274,2022-05-08
CASH_OUT,207644,Hélène Alexandre de la Samson,481274,273630,Agence_mtn_Ouidah,300000,92356,2022-05-08
CASH_IN,103966,Agence_mtn_Abomey,300000,196034,Hélène Alexandre de la Samson,273630,377596,2022-05-09
TRANSFER,168446,Hélène Alexandre de la Samson,377596,209150,Céline-Inès Meunier,781183,612737,2022-05-09
CASH_OUT,90616,Hélène Alexandre de la Samson,209150,118534,Agence_mtn_Ouidah,300000,209384,2022-05-10
TRANSFER,20919,Augustin-Jérôme Merle,203023,182104,Hélène Alexandre de la Samson,118534,139453,2022-05-12
TRANSFER,442,Louis du Boyer,3542,3100,Hélène Alexandre de la Samson,139453,139895,2022-05-13
CASH_OUT,25694,Hélène Alexandre de la Samson,139895,114201,Agence_mtn_Ouidah,300000,274306,2022-05-13
CASH_IN,199288,Agence_mtn_Abomey,300000,100712,Hélène Alexandre de la Samson,114201,313489,2022-05-13
TRANSFER,83876,Hélène Alexandre de la Samson,313489,229613,Georges Muller,177407,93531,2022-05-14
CASH_OUT,100483,Hélène Alexandre de la Samson,229613,129130,Agence_mtn_Cotonou,300000,199517,2022-05-15
CASH_IN,199707,Agence_mtn_Ouidah,300000,100293,Hélène Alexandre de la Samson,129130,328837,2022-05-16
TRANSFER,7846,René de la Delaunay,8549,703,Hélène Alexandre de la Samson,328837,336683,2022-05-16
CASH_IN,114168,Agence_mtn_Ouidah,300000,185832,Hélène Alexandre de la Samson,336683,450851,2022-05-16
TRANSFER,3043,Roland Huet,112748,109705,Hélène Alexandre de la Samson,450851,453894,2022-05-19
CASH_IN,206788,Agence_mtn_Cotonou,300000,93212,Hélène Alexandre de la Samson,453894,660682,2022-05-22
CASH_IN,19486,Agence_mtn_Cotonou,300000,280514,Hélène Alexandre de la Samson,660682,680168,2022-05-24
TRANSFER,1777,Louis de la Imbert,4370,2593,Hélène Alexandre de la Samson,680168,681945,2022-05-25
CASH_OUT,413798,Hélène Alexandre de la Samson,681945,268147,Agence_mtn_Ouidah,300000,-113798,2022-05-26
TRANSFER,166956,Hélène Alexandre de la Samson,268147,101191,Charlotte Perrier,55809,-111147,2022-05-27
TRANSFER,873163,Gabrielle Hamon,1818600,945437,Éléonore Marin Le Morel,421106,1294269,2022-05-01
CASH_OUT,121557,Éléonore Marin Le Morel,1294269,1172712,Agence_mtn_Ouidah,300000,178443,2022-05-01
TRANSFER,1600,Louis de la Imbert,2593,993,Éléonore Marin Le Morel,1172712,1174312,2022-05-02
TRANSFER,1720,Madeleine Philippe-Grondin,3337,1617,Éléonore Marin Le Morel,1174312,1176032,2022-05-03
CASH_IN,30514,Agence_mtn_Ouidah,300000,269486,Éléonore Marin Le Morel,1176032,1206546,2022-05-05
CASH_OUT,729617,Éléonore Marin Le Morel,1206546,476929,Agence_mtn_Cotonou,300000,-429617,2022-05-08
TRANSFER,122239,Matthieu Cousin,1173846,1051607,Éléonore Marin Le Morel,476929,599168,2022-05-08
CASH_IN,16375,Agence_mtn_Ouidah,300000,283625,Éléonore Marin Le Morel,599168,615543,2022-05-08
CASH_IN,219418,Agence_mtn_Cotonou,300000,80582,Éléonore Marin Le Morel,615543,834961,2022-05-08
CASH_OUT,416278,Éléonore Marin Le Morel,834961,418683,Agence_mtn_Abomey,300000,-116278,2022-05-11
TRANSFER,47942,Roland Huet,109705,61763,Éléonore Marin Le Morel,418683,466625,2022-05-13
CASH_IN,231460,Agence_mtn_Abomey,300000,68540,Éléonore Marin Le Morel,466625,698085,2022-05-13
CASH_OUT,516713,Éléonore Marin Le Morel,698085,181372,Agence_mtn_Cotonou,300000,-216713,2022-05-14
CASH_IN,58445,Agence_mtn_Ouidah,300000,241555,Éléonore Marin Le Morel,181372,239817,2022-05-17
TRANSFER,33677,Margaud-Michelle Briand,79816,46139,Éléonore Marin Le Morel,239817,273494,2022-05-19
TRANSFER,156423,Margot Julien,419509,263086,Éléonore Marin Le Morel,273494,429917,2022-05-21
CASH_OUT,182615,Éléonore Marin Le Morel,429917,247302,Agence_mtn_Cotonou,300000,117385,2022-05-21
CASH_OUT,190740,Éléonore Marin Le Morel,247302,56562,Agence_mtn_Abomey,300000,109260,2022-05-22
CASH_IN,32769,Agence_mtn_Abomey,300000,267231,Éléonore Marin Le Morel,56562,89331,2022-05-23
CASH_IN,264835,Agence_mtn_Cotonou,300000,35165,Éléonore Marin Le Morel,89331,354166,2022-05-25
CASH_OUT,339175,Céline-Inès Meunier,612737,273562,Agence_mtn_Ouidah,300000,-39175,2022-05-01
TRANSFER,203994,Céline-Inès Meunier,273562,69568,Jacques Le Marion,19804,-184190,2022-05-04
CASH_IN,225340,Agence_mtn_Ouidah,300000,74660,Céline-Inès Meunier,69568,294908,2022-05-05
TRANSFER,283979,Céline-Inès Meunier,294908,10929,Jérôme Laporte Le Gauthier,133896,-150083,2022-05-11
CASH_IN,177946,Agence_mtn_Ouidah,300000,122054,Céline-Inès Meunier,10929,188875,2022-05-12
TRANSFER,163071,Céline-Inès Meunier,188875,25804,René de la Delaunay,703,-162368,2022-05-13
TRANSFER,18807,Céline-Inès Meunier,25804,6997,Georges-Alfred Pruvost,561959,543152,2022-05-16
TRANSFER,670,Louis de la Imbert,993,323,Céline-Inès Meunier,6997,7667,2022-05-16
CASH_IN,141328,Agence_mtn_Ouidah,300000,158672,Céline-Inès Meunier,7667,148995,2022-05-16
TRANSFER,21409,Josette du Hamon,43509,22100,Céline-Inès Meunier,148995,170404,2022-05-25
CASH_IN,265628,Agence_mtn_Abomey,300000,34372,Gérard Cordier,-284680,-19052,2022-05-02
CASH_IN,188315,Agence_mtn_Abomey,300000,111685,Gérard Cordier,-19052,169263,2022-05-05
TRANSFER,203519,Gérard Blot de Blanc,1273409,1069890,Gérard Cordier,169263,372782,2022-05-06
CASH_OUT,366051,Gérard Cordier,372782,6731,Agence_mtn_Abomey,300000,-66051,2022-05-08
TRANSFER,48496,Élisabeth Blot-Bruneau,73167,24671,Gérard Cordier,6731,55227,2022-05-11
CASH_IN,252505,Agence_mtn_Abomey,300000,47495,Gérard Cordier,55227,307732,2022-05-11
CASH_IN,297582,Agence_mtn_Abomey,300000,2418,Gérard Cordier,307732,605314,2022-05-11
CASH_IN,237160,Agence_mtn_Ouidah,300000,62840,Gérard Cordier,605314,842474,2022-05-12
TRANSFER,533820,Gérard Cordier,842474,308654,Margot Julien,263086,-270734,2022-05-17
CASH_OUT,100419,Gérard Cordier,308654,208235,Agence_mtn_Cotonou,300000,199581,2022-05-18
CASH_OUT,106017,Gérard Cordier,208235,102218,Agence_mtn_Ouidah,300000,193983,2022-05-18
TRANSFER,95069,Augustin-Jérôme Merle,182104,87035,Gérard Cordier,102218,197287,2022-05-20
TRANSFER,523586,Matthieu Cousin,1051607,528021,Gérard Cordier,197287,720873,2022-05-21
CASH_IN,162670,Agence_mtn_Ouidah,300000,137330,Gérard Cordier,720873,883543,2022-05-25
CASH_IN,98349,Agence_mtn_Ouidah,300000,201651,Gérard Cordier,883543,981892,2022-05-27
CASH_OUT,414799,Gérard Cordier,981892,567093,Agence_mtn_Ouidah,300000,-114799,2022-05-27
CASH_IN,195127,Agence_mtn_Ouidah,300000,104873,Gérard Cordier,567093,762220,2022-05-27
CASH_IN,7916,Agence_mtn_Ouidah,300000,292084,Marthe Perrin,25187,33103,2022-05-05
CASH_OUT,2257,Marthe Perrin,33103,30846,Agence_mtn_Ouidah,300000,297743,2022-05-12
CASH_IN,193129,Agence_mtn_Abomey,300000,106871,Marthe Perrin,30846,223975,2022-05-13
TRANSFER,185603,Marthe Perrin,223975,38372,Georges-Alfred Pruvost,543152,357549,2022-05-15
TRANSFER,58362,Valérie-Claudine Marin,258300,199938,Marthe Perrin,38372,96734,2022-05-26
CASH_IN,160860,Agence_mtn_Abomey,300000,139140,Marthe Perrin,96734,257594,2022-05-27
CASH_OUT,231270,Gabrielle Hamon,945437,714167,Agence_mtn_Cotonou,300000,68730,2022-05-03
CASH_OUT,226946,Gabrielle Hamon,714167,487221,Agence_mtn_Abomey,300000,73054,2022-05-05
CASH_IN,223411,Agence_mtn_Cotonou,300000,76589,Gabrielle Hamon,487221,710632,2022-05-07
TRANSFER,27519,Roland Huet,61763,34244,Gabrielle Hamon,710632,738151,2022-05-12
CASH_IN,151403,Agence_mtn_Abomey,300000,148597,Gabrielle Hamon,738151,889554,2022-05-15
TRANSFER,777994,Gabrielle Hamon,889554,111560,Gérard Blot de Blanc,1069890,291896,2022-05-20
CASH_OUT,528,Gabrielle Hamon,111560,111032,Agence_mtn_Abomey,300000,299472,2022-05-21
CASH_IN,164485,Agence_mtn_Abomey,300000,135515,Gabrielle Hamon,111032,275517,2022-05-24
CASH_OUT,168187,Gabrielle Hamon,275517,107330,Agence_mtn_Abomey,300000,131813,2022-05-25
CASH_OUT,30591,Roland Huet,34244,3653,Agence_mtn_Abomey,300000,269409,2022-05-01
TRANSFER,561,Anouk Delahaye-Gimenez,708,147,Roland Huet,3653,4214,2022-05-09
CASH_OUT,2237,Roland Huet,4214,1977,Agence_mtn_Ouidah,300000,297763,2022-05-10
CASH_IN,92254,Agence_mtn_Abomey,300000,207746,Roland Huet,1977,94231,2022-05-12
TRANSFER,13566,Roland Huet,94231,80665,Augustin-Jérôme Merle,87035,73469,2022-05-13
CASH_OUT,10760,Roland Huet,80665,69905,Agence_mtn_Cotonou,300000,289240,2022-05-14
CASH_OUT,48242,Roland Huet,69905,21663,Agence_mtn_Ouidah,300000,251758,2022-05-15
CASH_IN,22401,Agence_mtn_Cotonou,300000,277599,Roland Huet,21663,44064,2022-05-16
CASH_OUT,31140,Roland Huet,44064,12924,Agence_mtn_Cotonou,300000,268860,2022-05-18
TRANSFER,180664,Louise-Aurore Payet,628343,447679,Roland Huet,12924,193588,2022-05-19
TRANSFER,41109,Martin Moreau,109537,68428,Roland Huet,193588,234697,2022-05-22
CASH_IN,249274,Agence_mtn_Abomey,300000,50726,Roland Huet,234697,483971,2022-05-24
CASH_OUT,16642,Élisabeth Delattre,57252,40610,Agence_mtn_Ouidah,300000,283358,2022-05-02
TRANSFER,322861,Georges-Alfred Pruvost,357549,34688,Élisabeth Delattre,40610,363471,2022-05-03
CASH_IN,259967,Agence_mtn_Cotonou,300000,40033,Élisabeth Delattre,363471,623438,2022-05-05
CASH_OUT,616879,Élisabeth Delattre,623438,6559,Agence_mtn_Ouidah,300000,-316879,2022-05-05
CASH_OUT,2323,Élisabeth Delattre,6559,4236,Agence_mtn_Ouidah,300000,297677,2022-05-09
CASH_OUT,1206,Élisabeth Delattre,4236,3030,Agence_mtn_Cotonou,300000,298794,2022-05-11
CASH_IN,229201,Agence_mtn_Abomey,300000,70799,Élisabeth Delattre,3030,232231,2022-05-13
CASH_IN,115253,Agence_mtn_Ouidah,300000,184747,Élisabeth Delattre,232231,347484,2022-05-18
CASH_IN,163382,Agence_mtn_Abomey,300000,136618,Élisabeth Delattre,347484,510866,2022-05-21
TRANSFER,285988,Gérard Blot de Blanc,291896,5908,Élisabeth Delattre,510866,796854,2022-05-22
CASH_OUT,158173,Élisabeth Delattre,796854,638681,Agence_mtn_Cotonou,300000,141827,2022-05-24
CASH_IN,242818,Agence_mtn_Ouidah,300000,57182,Élisabeth Delattre,638681,881499,2022-05-24
CASH_IN,174065,Agence_mtn_Abomey,300000,125935,Sébastien Coste,-409101,-235036,2022-05-04
CASH_IN,111756,Agence_mtn_Ouidah,300000,188244,Sébastien Coste,-235036,-123280,2022-05-05
CASH_IN,141988,Agence_mtn_Ouidah,300000,158012,Sébastien Coste,-123280,18708,2022-05-05
CASH_IN,275372,Agence_mtn_Cotonou,300000,24628,Sébastien Coste,18708,294080,2022-05-06
CASH_OUT,49752,Sébastien Coste,294080,244328,Agence_mtn_Cotonou,300000,250248,2022-05-07
CASH_OUT,237650,Sébastien Coste,244328,6678,Agence_mtn_Abomey,300000,62350,2022-05-09
TRANSFER,4266,Sébastien Coste,6678,2412,Nicole Huet,79468,75202,2022-05-10
CASH_OUT,1520,Sébastien Coste,2412,892,Agence_mtn_Abomey,300000,298480,2022-05-13
CASH_OUT,749,Sébastien Coste,892,143,Agence_mtn_Ouidah,300000,299251,2022-05-15
CASH_OUT,142,Sébastien Coste,143,1,Agence_mtn_Ouidah,300000,299858,2022-05-24
TRANSFER,399231,Matthieu Cousin,528021,128790,Gérard Blot de Blanc,5908,-393323,2022-05-03
CASH_OUT,19341,Matthieu Cousin,128790,109449,Agence_mtn_Ouidah,300000,280659,2022-05-03
CASH_IN,188141,Agence_mtn_Cotonou,300000,111859,Matthieu Cousin,109449,297590,2022-05-04
CASH_OUT,263033,Matthieu Cousin,297590,34557,Agence_mtn_Abomey,300000,36967,2022-05-05
TRANSFER,3606,Matthieu Cousin,34557,30951,Matthieu Cousin,34557,38163,2022-05-05
CASH_IN,228639,Agence_mtn_Abomey,300000,71361,Matthieu Cousin,30951,259590,2022-05-07
CASH_OUT,9438,Matthieu Cousin,259590,250152,Agence_mtn_Cotonou,300000,290562,2022-05-07
CASH_OUT,181644,Matthieu Cousin,250152,68508,Agence_mtn_Abomey,300000,118356,2022-05-07
CASH_IN,184193,Agence_mtn_Cotonou,300000,115807,Matthieu Cousin,68508,252701,2022-05-07
CASH_IN,71478,Agence_mtn_Ouidah,300000,228522,Matthieu Cousin,252701,324179,2022-05-12
CASH_IN,118338,Agence_mtn_Abomey,300000,181662,Matthieu Cousin,324179,442517,2022-05-14
CASH_OUT,59970,Matthieu Cousin,442517,382547,Agence_mtn_Ouidah,300000,240030,2022-05-15
CASH_IN,211864,Agence_mtn_Ouidah,300000,88136,Matthieu Cousin,382547,594411,2022-05-17
CASH_IN,13525,Agence_mtn_Cotonou,300000,286475,Matthieu Cousin,594411,607936,2022-05-19
CASH_OUT,480825,Matthieu Cousin,607936,127111,Agence_mtn_Abomey,300000,-180825,2022-05-20
CASH_IN,278979,Agence_mtn_Cotonou,300000,21021,Matthieu Cousin,127111,406090,2022-05-20
CASH_IN,259846,Agence_mtn_Abomey,300000,40154,Matthieu Cousin,406090,665936,2022-05-22
CASH_IN,73655,Agence_mtn_Cotonou,300000,226345,Matthieu Cousin,665936,739591,2022-05-22
TRANSFER,381861,Matthieu Cousin,739591,357730,Olivier Benard,818200,436339,2022-05-23
CASH_IN,174851,Agence_mtn_Cotonou,300000,125149,Stéphanie Guichard,-196200,-21349,2022-05-01
CASH_IN,297673,Agence_mtn_Abomey,300000,2327,Stéphanie Guichard,-21349,276324,2022-05-02
CASH_OUT,65701,Stéphanie Guichard,276324,210623,Agence_mtn_Abomey,300000,234299,2022-05-04
CASH_IN,6714,Agence_mtn_Abomey,300000,293286,Stéphanie Guichard,210623,217337,2022-05-06
TRANSFER,45967,Louise-Aurore Payet,447679,401712,Stéphanie Guichard,217337,263304,2022-05-09
CASH_OUT,20831,Stéphanie Guichard,263304,242473,Agence_mtn_Ouidah,300000,279169,2022-05-09
TRANSFER,384,Madeleine Philippe-Grondin,1617,1233,Stéphanie Guichard,242473,242857,2022-05-16
CASH_OUT,174540,Stéphanie Guichard,242857,68317,Agence_mtn_Abomey,300000,125460,2022-05-16
TRANSFER,6811,Élisabeth Blot-Bruneau,24671,17860,Stéphanie Guichard,68317,75128,2022-05-22
TRANSFER,57070,Stéphanie Guichard,75128,18058,Madeleine Philippe-Grondin,1233,-55837,2022-05-23
CASH_IN,125281,Agence_mtn_Cotonou,300000,174719,Charlotte Perrier,-111147,14134,2022-05-02
TRANSFER,11259,Charlotte Perrier,14134,2875,Charlotte Perrier,14134,2875,2022-05-05
CASH_OUT,2003,Charlotte Perrier,2875,872,Agence_mtn_Ouidah,300000,297997,2022-05-09
TRANSFER,40940,Marc Baudry,89299,48359,Charlotte Perrier,872,41812,2022-05-10
CASH_IN,216873,Agence_mtn_Cotonou,300000,83127,Charlotte Perrier,41812,258685,2022-05-12
TRANSFER,709338,Maggie Barbier,756493,47155,Charlotte Perrier,258685,968023,2022-05-19
CASH_IN,209046,Agence_mtn_Ouidah,300000,90954,Charlotte Perrier,968023,1177069,2022-05-20
CASH_OUT,69035,Charlotte Perrier,1177069,1108034,Agence_mtn_Abomey,300000,230965,2022-05-20
CASH_OUT,519107,Charlotte Perrier,1108034,588927,Agence_mtn_Abomey,300000,-219107,2022-05-22
CASH_IN,262094,Agence_mtn_Abomey,300000,37906,Charlotte Perrier,588927,851021,2022-05-23
TRANSFER,73318,Georges Muller,93531,20213,Charlotte Perrier,851021,924339,2022-05-24
CASH_IN,191748,Agence_mtn_Abomey,300000,108252,Charlotte Perrier,924339,1116087,2022-05-26
CASH_OUT,868887,Charlotte Perrier,1116087,247200,Agence_mtn_Cotonou,300000,-568887,2022-05-27
CASH_IN,64564,Agence_mtn_Abomey,300000,235436,Jean Guilbert-Lenoir,154814,219378,2022-05-02
CASH_IN,100980,Agence_mtn_Abomey,300000,199020,Jean Guilbert-Lenoir,219378,320358,2022-05-09
CASH_OUT,276005,Jean Guilbert-Lenoir,320358,44353,Agence_mtn_Ouidah,300000,23995,2022-05-09
TRANSFER,5615,Élisabeth Blot-Bruneau,17860,12245,Jean Guilbert-Lenoir,44353,49968,2022-05-09
CASH_OUT,13804,Jean Guilbert-Lenoir,49968,36164,Agence_mtn_Cotonou,300000,286196,2022-05-10
CASH_OUT,16933,Jean Guilbert-Lenoir,36164,19231,Agence_mtn_Ouidah,300000,283067,2022-05-11
CASH_OUT,6689,Jean Guilbert-Lenoir,19231,12542,Agence_mtn_Abomey,300000,293311,2022-05-15
CASH_IN,46527,Agence_mtn_Abomey,300000,253473,Jean Guilbert-Lenoir,12542,59069,2022-05-19
TRANSFER,67147,Nicole Huet,75202,8055,Jean Guilbert-Lenoir,59069,126216,2022-05-21
CASH_IN,162111,Agence_mtn_Cotonou,300000,137889,Jean Guilbert-Lenoir,126216,288327,2022-05-21
CASH_IN,239255,Agence_mtn_Abomey,300000,60745,Jean Guilbert-Lenoir,288327,527582,2022-05-22
CASH_OUT,209877,Jean Guilbert-Lenoir,527582,317705,Agence_mtn_Abomey,300000,90123,2022-05-23
CASH_IN,221003,Agence_mtn_Ouidah,300000,78997,Jean Guilbert-Lenoir,317705,538708,2022-05-23
CASH_IN,65407,Agence_mtn_Abomey,300000,234593,Nathalie-Claire De Oliveira,-148766,-83359,2022-05-04
CASH_IN,55495,Agence_mtn_Ouidah,300000,244505,Nathalie-Claire De Oliveira,-83359,-27864,2022-05-05
CASH_IN,116465,Agence_mtn_Cotonou,300000,183535,Nathalie-Claire De Oliveira,-27864,88601,2022-05-08
CASH_IN,211031,Agence_mtn_Ouidah,300000,88969,Nathalie-Claire De Oliveira,88601,299632,2022-05-08
CASH_IN,190487,Agence_mtn_Ouidah,300000,109513,Nathalie-Claire De Oliveira,299632,490119,2022-05-09
CASH_OUT,461436,Nathalie-Claire De Oliveira,490119,28683,Agence_mtn_Ouidah,300000,-161436,2022-05-10
TRANSFER,11492,Élisabeth Blot-Bruneau,12245,753,Nathalie-Claire De Oliveira,28683,40175,2022-05-11
TRANSFER,29904,Marc Baudry,48359,18455,Nathalie-Claire De Oliveira,40175,70079,2022-05-14
CASH_OUT,68961,Nathalie-Claire De Oliveira,70079,1118,Agence_mtn_Cotonou,300000,231039,2022-05-15
CASH_IN,82947,Agence_mtn_Ouidah,300000,217053,Nathalie-Claire De Oliveira,1118,84065,2022-05-16
CASH_IN,8269,Agence_mtn_Cotonou,300000,291731,Nathalie-Claire De Oliveira,84065,92334,2022-05-20
TRANSFER,36303,Nathalie-Claire De Oliveira,92334,56031,Marc Baudry,18455,-17848,2022-05-21
CASH_OUT,34796,Nathalie-Claire De Oliveira,56031,21235,Agence_mtn_Ouidah,300000,265204,2022-05-24
CASH_OUT,17742,Josette du Hamon,22100,4358,Agence_mtn_Abomey,300000,282258,2022-05-01
CASH_IN,45415,Agence_mtn_Cotonou,300000,254585,Josette du Hamon,4358,49773,2022-05-04
CASH_IN,40551,Agence_mtn_Abomey,300000,259449,Josette du Hamon,49773,90324,2022-05-10
TRANSFER,34204,Josette du Hamon,90324,56120,Gilbert Moulin,828258,794054,2022-05-10
CASH_OUT,23107,Josette du Hamon,56120,33013,Agence_mtn_Cotonou,300000,276893,2022-05-11
CASH_OUT,11672,Josette du Hamon,33013,21341,Agence_mtn_Ouidah,300000,288328,2022-05-13
CASH_IN,191306,Agence_mtn_Ouidah,300000,108694,Josette du Hamon,21341,212647,2022-05-14
CASH_OUT,165376,Josette du Hamon,212647,47271,Agence_mtn_Cotonou,300000,134624,2022-05-17
CASH_OUT,3889,Josette du Hamon,47271,43382,Agence_mtn_Abomey,300000,296111,2022-05-17
CASH_OUT,2501,Josette du Hamon,43382,40881,Agence_mtn_Ouidah,300000,297499,2022-05-19
TRANSFER,3701,Nicole Huet,8055,4354,Josette du Hamon,40881,44582,2022-05-20
TRANSFER,18602,Maggie Barbier,47155,28553,Josette du Hamon,44582,63184,2022-05-21
TRANSFER,65734,Augustin-Jérôme Merle,73469,7735,Josette du Hamon,63184,128918,2022-05-23
CASH_IN,40962,Agence_mtn_Cotonou,300000,259038,Josette du Hamon,128918,169880,2022-05-24
CASH_IN,268983,Agence_mtn_Abomey,300000,31017,Josette du Hamon,169880,438863,2022-05-26
TRANSFER,20697,Martin Moreau,68428,47731,Josette du Hamon,438863,459560,2022-05-26
CASH_IN,85962,Agence_mtn_Cotonou,300000,214038,Josette du Hamon,459560,545522,2022-05-27
CASH_IN,11736,Agence_mtn_Ouidah,300000,288264,Hélène Blanchard-Renault,2993,14729,2022-05-01
TRANSFER,1389,Nicole Huet,4354,2965,Hélène Blanchard-Renault,14729,16118,2022-05-01
TRANSFER,354562,Olivier Benard,436339,81777,Hélène Blanchard-Renault,16118,370680,2022-05-02
TRANSFER,1033282,Raymond-Yves Boulanger,1820300,787018,Hélène Blanchard-Renault,370680,1403962,2022-05-08
CASH_IN,260560,Agence_mtn_Abomey,300000,39440,Hélène Blanchard-Renault,1403962,1664522,2022-05-08
TRANSFER,167332,Valérie-Claudine Marin,199938,32606,Hélène Blanchard-Renault,1664522,1831854,2022-05-10
TRANSFER,710362,Hélène Blanchard-Renault,1831854,1121492,Nicole Huet,2965,-707397,2022-05-10
CASH_IN,206822,Agence_mtn_Abomey,300000,93178,Hélène Blanchard-Renault,1121492,1328314,2022-05-11
CASH_OUT,45418,Hélène Blanchard-Renault,1328314,1282896,Agence_mtn_Abomey,300000,254582,2022-05-11
CASH_IN,67672,Agence_mtn_Abomey,300000,232328,Hélène Blanchard-Renault,1282896,1350568,2022-05-12
CASH_OUT,1344685,Hélène Blanchard-Renault,1350568,5883,Agence_mtn_Abomey,300000,-1044685,2022-05-13
CASH_IN,94730,Agence_mtn_Cotonou,300000,205270,Hélène Blanchard-Renault,5883,100613,2022-05-14
CASH_OUT,60938,Hélène Blanchard-Renault,100613,39675,Agence_mtn_Abomey,300000,239062,2022-05-16
CASH_IN,39366,Agence_mtn_Cotonou,300000,260634,Hélène Blanchard-Renault,39675,79041,2022-05-21
CASH_IN,136770,Agence_mtn_Abomey,300000,163230,Hélène Blanchard-Renault,79041,215811,2022-05-25
TRANSFER,5465,Margaud-Michelle Briand,46139,40674,Hélène Blanchard-Renault,215811,221276,2022-05-27
CASH_IN,278362,Agence_mtn_Abomey,300000,21638,Françoise Denis de Allard,-387772,-109410,2022-05-01
CASH_IN,160225,Agence_mtn_Ouidah,300000,139775,Françoise Denis de Allard,-109410,50815,2022-05-06
CASH_OUT,15060,Françoise Denis de Allard,50815,35755,Agence_mtn_Ouidah,300000,284940,2022-05-08
CASH_OUT,30736,Françoise Denis de Allard,35755,5019,Agence_mtn_Abomey,300000,269264,2022-05-08
CASH_OUT,4084,Françoise Denis de Allard,5019,935,Agence_mtn_Abomey,300000,295916,2022-05-08
CASH_IN,246699,Agence_mtn_Abomey,300000,53301,Françoise Denis de Allard,935,247634,2022-05-10
CASH_IN,160018,Agence_mtn_Ouidah,300000,139982,Françoise Denis de Allard,247634,407652,2022-05-11
CASH_OUT,62817,Françoise Denis de Allard,407652,344835,Agence_mtn_Cotonou,300000,237183,2022-05-12
CASH_IN,121140,Agence_mtn_Cotonou,300000,178860,Françoise Denis de Allard,344835,465975,2022-05-12
CASH_IN,25839,Agence_mtn_Abomey,300000,274161,Françoise Denis de Allard,465975,491814,2022-05-12
CASH_IN,276046,Agence_mtn_Abomey,300000,23954,Françoise Denis de Allard,491814,767860,2022-05-16
CASH_IN,282124,Agence_mtn_Cotonou,300000,17876,Françoise Denis de Allard,767860,1049984,2022-05-16
CASH_OUT,730850,Françoise Denis de Allard,1049984,319134,Agence_mtn_Ouidah,300000,-430850,2022-05-17
CASH_IN,7753,Agence_mtn_Ouidah,300000,292247,Françoise Denis de Allard,319134,326887,2022-05-18
CASH_IN,202017,Agence_mtn_Abomey,300000,97983,Françoise Denis de Allard,326887,528904,2022-05-21
CASH_IN,223135,Agence_mtn_Cotonou,300000,76865,Françoise Denis de Allard,528904,752039,2022-05-21
CASH_IN,60164,Agence_mtn_Ouidah,300000,239836,Emmanuel Legrand,-178970,-118806,2022-05-06
CASH_IN,129497,Agence_mtn_Ouidah,300000,170503,Emmanuel Legrand,-118806,10691,2022-05-07
CASH_IN,84605,Agence_mtn_Abomey,300000,215395,Emmanuel Legrand,10691,95296,2022-05-07
CASH_IN,3191,Agence_mtn_Ouidah,300000,296809,Emmanuel Legrand,95296,98487,2022-05-07
CASH_OUT,63876,Emmanuel Legrand,98487,34611,Agence_mtn_Ouidah,300000,236124,2022-05-08
CASH_IN,119496,Agence_mtn_Ouidah,300000,180504,Emmanuel Legrand,34611,154107,2022-05-09
TRANSFER,662813,Gilbert Moulin,794054,131241,Emmanuel Legrand,154107,816920,2022-05-11
TRANSFER,69812,Olivier Benard,81777,11965,Emmanuel Legrand,816920,886732,2022-05-14
TRANSFER,376080,Emmanuel Legrand,886732,510652,Raymond-Yves Boulanger,787018,410938,2022-05-14
TRANSFER,491115,Emmanuel Legrand,510652,19537,Georges Muller,20213,-470902,2022-05-14
CASH_OUT,2182,Emmanuel Legrand,19537,17355,Agence_mtn_Cotonou,300000,297818,2022-05-15
TRANSFER,4140,Emmanuel Legrand,17355,13215,Louis de la Imbert,323,-3817,2022-05-16
TRANSFER,10101,Emmanuel Legrand,13215,3114,Julien Devaux,406200,396099,2022-05-17
TRANSFER,2307,Emmanuel Legrand,3114,807,Julien Devaux,396099,393792,2022-05-17
CASH_IN,191324,Agence_mtn_Cotonou,300000,108676,Emmanuel Legrand,807,192131,2022-05-21
TRANSFER,103533,Emmanuel Legrand,192131,88598,Raymond-Yves Boulanger,410938,307405,2022-05-22
TRANSFER,62598,Emmanuel Legrand,88598,26000,Valérie-Claudine Marin,32606,-29992,2022-05-22
CASH_IN,221896,Agence_mtn_Ouidah,300000,78104,Emmanuel Legrand,26000,247896,2022-05-25
CASH_OUT,151198,Emmanuel Legrand,247896,96698,Agence_mtn_Abomey,300000,148802,2022-05-26
CASH_IN,208499,Agence_mtn_Ouidah,300000,91501,Emmanuel Legrand,96698,305197,2022-05-27
CASH_IN,162806,Agence_mtn_Abomey,300000,137194,Martin Moreau,47731,210537,2022-05-07
CASH_IN,91148,Agence_mtn_Ouidah,300000,208852,Martin Moreau,210537,301685,2022-05-08
CASH_IN,178214,Agence_mtn_Ouidah,300000,121786,Martin Moreau,301685,479899,2022-05-13
CASH_OUT,40602,Martin Moreau,479899,439297,Agence_mtn_Ouidah,300000,259398,2022-05-14
CASH_IN,291532,Agence_mtn_Ouidah,300000,8468,Martin Moreau,439297,730829,2022-05-15
CASH_IN,1100,Agence_mtn_Cotonou,300000,298900,Martin Moreau,730829,731929,2022-05-21
CASH_IN,213204,Agence_mtn_Cotonou,300000,86796,Martin Moreau,731929,945133,2022-05-22
CASH_OUT,620688,Martin Moreau,945133,324445,Agence_mtn_Ouidah,300000,-320688,2022-05-24
CASH_OUT,229040,Martin Moreau,324445,95405,Agence_mtn_Ouidah,300000,70960,2022-05-25
CASH_IN,25498,Agence_mtn_Cotonou,300000,274502,Martin Moreau,95405,120903,2022-05-25
TRANSFER,23871,Georges-Alfred Pruvost,34688,10817,Raymond-Yves Boulanger,307405,283534,2022-05-02
CASH_IN,299051,Agence_mtn_Cotonou,300000,949,Georges-Alfred Pruvost,10817,309868,2022-05-02
CASH_OUT,84939,Georges-Alfred Pruvost,309868,224929,Agence_mtn_Ouidah,300000,215061,2022-05-02
CASH_OUT,209486,Georges-Alfred Pruvost,224929,15443,Agence_mtn_Abomey,300000,90514,2022-05-04
TRANSFER,7621,Georges-Alfred Pruvost,15443,7822,Raymond-Yves Boulanger,283534,275913,2022-05-06
CASH_IN,163211,Agence_mtn_Ouidah,300000,136789,Georges-Alfred Pruvost,7822,171033,2022-05-07
TRANSFER,92789,Georges-Alfred Pruvost,171033,78244,Olivier Benard,11965,-80824,2022-05-07
TRANSFER,22887,Georges-Alfred Pruvost,78244,55357,Julien Devaux,393792,370905,2022-05-07
CASH_IN,64523,Agence_mtn_Abomey,300000,235477,Georges-Alfred Pruvost,55357,119880,2022-05-14
TRANSFER,109702,Georges-Alfred Pruvost,119880,10178,Raymond-Yves Boulanger,275913,166211,2022-05-15
CASH_IN,273724,Agence_mtn_Abomey,300000,26276,Georges-Alfred Pruvost,10178,283902,2022-05-18
TRANSFER,24271,Georges-Alfred Pruvost,283902,259631,Margaud-Michelle Briand,40674,16403,2022-05-20
CASH_OUT,223224,Georges-Alfred Pruvost,259631,36407,Agence_mtn_Ouidah,300000,76776,2022-05-22
TRANSFER,24259,Julien Devaux,370905,346646,Augustin-Jérôme Merle,7735,31994,2022-05-04
CASH_IN,245665,Agence_mtn_Cotonou,300000,54335,Augustin-Jérôme Merle,31994,277659,2022-05-05
TRANSFER,261617,Augustin-Jérôme Merle,277659,16042,Margaud-Michelle Briand,16403,-245214,2022-05-06
TRANSFER,260833,Julien Devaux,346646,85813,Augustin-Jérôme Merle,16042,276875,2022-05-10
CASH_OUT,121765,Augustin-Jérôme Merle,276875,155110,Agence_mtn_Abomey,300000,178235,2022-05-10
CASH_OUT,129004,Augustin-Jérôme Merle,155110,26106,Agence_mtn_Ouidah,300000,170996,2022-05-14
CASH_OUT,6656,Augustin-Jérôme Merle,26106,19450,Agence_mtn_Abomey,300000,293344,2022-05-14
CASH_IN,242788,Agence_mtn_Cotonou,300000,57212,Augustin-Jérôme Merle,19450,262238,2022-05-16
TRANSFER,200126,Augustin-Jérôme Merle,262238,62112,Louis du Boyer,3100,-197026,2022-05-16
CASH_OUT,26089,Augustin-Jérôme Merle,62112,36023,Agence_mtn_Abomey,300000,273911,2022-05-17
CASH_OUT,13571,Augustin-Jérôme Merle,36023,22452,Agence_mtn_Cotonou,300000,286429,2022-05-18
TRANSFER,9470,Augustin-Jérôme Merle,22452,12982,Maggie Barbier,28553,19083,2022-05-18
CASH_OUT,8878,Augustin-Jérôme Merle,12982,4104,Agence_mtn_Abomey,300000,291122,2022-05-19
TRANSFER,9096,Maggie Barbier,19083,9987,Augustin-Jérôme Merle,4104,13200,2022-05-21
CASH_IN,15445,Agence_mtn_Abomey,300000,284555,Augustin-Jérôme Merle,13200,28645,2022-05-21
CASH_OUT,13648,Augustin-Jérôme Merle,28645,14997,Agence_mtn_Cotonou,300000,286352,2022-05-23
CASH_OUT,4063,Augustin-Jérôme Merle,14997,10934,Agence_mtn_Cotonou,300000,295937,2022-05-25
CASH_IN,75658,Agence_mtn_Abomey,300000,224342,Augustin-Jérôme Merle,10934,86592,2022-05-27
TRANSFER,30540,Gilbert Moulin,131241,100701,Augustin-Jérôme Merle,86592,117132,2022-05-27
CASH_IN,200124,Agence_mtn_Cotonou,300000,99876,Véronique Hardy,-621302,-421178,2022-05-01
CASH_IN,16793,Agence_mtn_Ouidah,300000,283207,Véronique Hardy,-421178,-404385,2022-05-01
CASH_IN,235627,Agence_mtn_Cotonou,300000,64373,Véronique Hardy,-404385,-168758,2022-05-03
CASH_IN,217367,Agence_mtn_Abomey,300000,82633,Véronique Hardy,-168758,48609,2022-05-06
TRANSFER,4245,Véronique Hardy,48609,44364,Véronique Hardy,48609,44364,2022-05-07
TRANSFER,4248,Maggie Barbier,9987,5739,Véronique Hardy,44364,48612,2022-05-09
TRANSFER,10880,Julien Devaux,85813,74933,Véronique Hardy,48612,59492,2022-05-17
TRANSFER,4574,Véronique Hardy,59492,54918,Gilbert Moulin,100701,96127,2022-05-18
CASH_IN,37780,Agence_mtn_Ouidah,300000,262220,Véronique Hardy,54918,92698,2022-05-19
TRANSFER,48374,Julien Devaux,74933,26559,Véronique Hardy,92698,141072,2022-05-23
CASH_IN,90973,Agence_mtn_Ouidah,300000,209027,Véronique Hardy,141072,232045,2022-05-26
CASH_IN,266430,Agence_mtn_Abomey,300000,33570,Valérie-Claudine Marin,-29992,236438,2022-05-02
TRANSFER,33946,Gilbert Moulin,96127,62181,Valérie-Claudine Marin,236438,270384,2022-05-04
CASH_OUT,141906,Valérie-Claudine Marin,270384,128478,Agence_mtn_Cotonou,300000,158094,2022-05-12
CASH_IN,45031,Agence_mtn_Cotonou,300000,254969,Valérie-Claudine Marin,128478,173509,2022-05-13
CASH_OUT,88889,Valérie-Claudine Marin,173509,84620,Agence_mtn_Abomey,300000,211111,2022-05-15
TRANSFER,21006,Valérie-Claudine Marin,84620,63614,Julien Devaux,26559,5553,2022-05-15
TRANSFER,34365,Valérie-Claudine Marin,63614,29249,Julien Devaux,5553,-28812,2022-05-16
CASH_IN,32201,Agence_mtn_Cotonou,300000,267799,Valérie-Claudine Marin,29249,61450,2022-05-17
CASH_IN,115306,Agence_mtn_Ouidah,300000,184694,Valérie-Claudine Marin,61450,176756,2022-05-17
CASH_OUT,166761,Valérie-Claudine Marin,176756,9995,Agence_mtn_Ouidah,300000,133239,2022-05-18
CASH_IN,75518,Agence_mtn_Cotonou,300000,224482,Valérie-Claudine Marin,9995,85513,2022-05-19
CASH_IN,151236,Agence_mtn_Cotonou,300000,148764,Valérie-Claudine Marin,85513,236749,2022-05-19
CASH_IN,120601,Agence_mtn_Abomey,300000,179399,Valérie-Claudine Marin,236749,357350,2022-05-20
CASH_OUT,337777,Valérie-Claudine Marin,357350,19573,Agence_mtn_Cotonou,300000,-37777,2022-05-21
CASH_OUT,6156,Valérie-Claudine Marin,19573,13417,Agence_mtn_Ouidah,300000,293844,2022-05-23
CASH_OUT,9100,Valérie-Claudine Marin,13417,4317,Agence_mtn_Cotonou,300000,290900,2022-05-26
TRANSFER,4839,Maggie Barbier,5739,900,Valérie-Claudine Marin,4317,9156,2022-05-27
CASH_OUT,491,Maggie Barbier,900,409,Agence_mtn_Abomey,300000,299509,2022-05-01
TRANSFER,120,Maggie Barbier,409,289,Maggie Barbier,409,529,2022-05-02
CASH_IN,290512,Agence_mtn_Abomey,300000,9488,Maggie Barbier,289,290801,2022-05-02
CASH_IN,173005,Agence_mtn_Cotonou,300000,126995,Maggie Barbier,290801,463806,2022-05-02
TRANSFER,73240,Maggie Barbier,463806,390566,Maggie Barbier,463806,390566,2022-05-02
CASH_IN,118986,Agence_mtn_Abomey,300000,181014,Maggie Barbier,390566,509552,2022-05-04
CASH_IN,112761,Agence_mtn_Abomey,300000,187239,Maggie Barbier,509552,622313,2022-05-05
CASH_IN,195673,Agence_mtn_Ouidah,300000,104327,Maggie Barbier,622313,817986,2022-05-05
TRANSFER,474690,Maggie Barbier,817986,343296,Maggie Barbier,817986,343296,2022-05-06
CASH_OUT,204953,Maggie Barbier,343296,138343,Agence_mtn_Ouidah,300000,95047,2022-05-08
CASH_OUT,51206,Maggie Barbier,138343,87137,Agence_mtn_Abomey,300000,248794,2022-05-16
CASH_IN,264774,Agence_mtn_Abomey,300000,35226,Maggie Barbier,87137,351911,2022-05-19
CASH_OUT,330185,Maggie Barbier,351911,21726,Agence_mtn_Cotonou,300000,-30185,2022-05-20
CASH_IN,61271,Agence_mtn_Abomey,300000,238729,Maggie Barbier,21726,82997,2022-05-22
CASH_OUT,24302,Maggie Barbier,82997,58695,Agence_mtn_Abomey,300000,275698,2022-05-27
CASH_IN,196942,Agence_mtn_Cotonou,300000,103058,Maggie Barbier,58695,255637,2022-05-27
CASH_IN,243775,Agence_mtn_Abomey,300000,56225,Gérard Blot de Blanc,-393323,-149548,2022-05-10
CASH_IN,40702,Agence_mtn_Abomey,300000,259298,Gérard Blot de Blanc,-149548,-108846,2022-05-10
CASH_IN,175064,Agence_mtn_Cotonou,300000,124936,Gérard Blot de Blanc,-108846,66218,2022-05-14
CASH_IN,238840,Agence_mtn_Abomey,300000,61160,Gérard Blot de Blanc,66218,305058,2022-05-20
CASH_IN,177133,Agence_mtn_Abomey,300000,122867,Gérard Blot de Blanc,305058,482191,2022-05-23
CASH_OUT,34956,Gérard Blot de Blanc,482191,447235,Agence_mtn_Abomey,300000,265044,2022-05-23
CASH_OUT,22726,Gérard Blot de Blanc,447235,424509,Agence_mtn_Abomey,300000,277274,2022-05-24
CASH_IN,286999,Agence_mtn_Ouidah,300000,13001,Gérard Blot de Blanc,424509,711508,2022-05-26
CASH_IN,154586,Agence_mtn_Abomey,300000,145414,Louis du Boyer,-197026,-42440,2022-05-04
CASH_IN,155867,Agence_mtn_Abomey,300000,144133,Louis du Boyer,-42440,113427,2022-05-07
CASH_OUT,49748,Louis du Boyer,113427,63679,Agence_mtn_Cotonou,300000,250252,2022-05-08
TRANSFER,24570,Louis du Boyer,63679,39109,Louis du Boyer,63679,88249,2022-05-09
TRANSFER,10405,Louis du Boyer,39109,28704,Louis du Boyer,39109,28704,2022-05-11
CASH_IN,194326,Agence_mtn_Abomey,300000,105674,Louis du Boyer,28704,223030,2022-05-12
TRANSFER,98916,Louis du Boyer,223030,124114,Louis du Boyer,223030,321946,2022-05-13
CASH_OUT,21012,Louis du Boyer,124114,103102,Agence_mtn_Cotonou,300000,278988,2022-05-17
CASH_IN,3824,Agence_mtn_Ouidah,300000,296176,Louis du Boyer,103102,106926,2022-05-18
CASH_IN,155938,Agence_mtn_Cotonou,300000,144062,Louis du Boyer,106926,262864,2022-05-20
CASH_OUT,219680,Louis du Boyer,262864,43184,Agence_mtn_Abomey,300000,80320,2022-05-23
CASH_OUT,12610,Louis du Boyer,43184,30574,Agence_mtn_Ouidah,300000,287390,2022-05-24
CASH_OUT,22849,Louis du Boyer,30574,7725,Agence_mtn_Ouidah,300000,277151,2022-05-24
CASH_IN,68576,Agence_mtn_Cotonou,300000,231424,Louis de la Imbert,-3817,64759,2022-05-03
CASH_IN,266744,Agence_mtn_Ouidah,300000,33256,Louis de la Imbert,64759,331503,2022-05-04
CASH_OUT,166102,Louis de la Imbert,331503,165401,Agence_mtn_Cotonou,300000,133898,2022-05-10
CASH_OUT,58372,Louis de la Imbert,165401,107029,Agence_mtn_Abomey,300000,241628,2022-05-12
CASH_IN,47483,Agence_mtn_Cotonou,300000,252517,Louis de la Imbert,107029,154512,2022-05-13
CASH_OUT,148991,Louis de la Imbert,154512,5521,Agence_mtn_Abomey,300000,151009,2022-05-19
CASH_IN,130578,Agence_mtn_Abomey,300000,169422,Louis de la Imbert,5521,136099,2022-05-23
CASH_IN,63613,Agence_mtn_Cotonou,300000,236387,Louis de la Imbert,136099,199712,2022-05-26
CASH_IN,82357,Agence_mtn_Abomey,300000,217643,Marine Chevallier,-663310,-580953,2022-05-01
CASH_IN,185302,Agence_mtn_Ouidah,300000,114698,Marine Chevallier,-580953,-395651,2022-05-13
CASH_IN,133884,Agence_mtn_Ouidah,300000,166116,Marine Chevallier,-395651,-261767,2022-05-13
CASH_IN,261422,Agence_mtn_Cotonou,300000,38578,Marine Chevallier,-261767,-345,2022-05-16
CASH_IN,230011,Agence_mtn_Ouidah,300000,69989,Marine Chevallier,-345,229666,2022-05-17
CASH_OUT,155639,Marine Chevallier,229666,74027,Agence_mtn_Ouidah,300000,144361,2022-05-20
CASH_OUT,27164,Marine Chevallier,74027,46863,Agence_mtn_Abomey,300000,272836,2022-05-24
CASH_OUT,26103,Marine Chevallier,46863,20760,Agence_mtn_Ouidah,300000,273897,2022-05-27
CASH_IN,72633,Agence_mtn_Abomey,300000,227367,Margaud-Michelle Briand,-245214,-172581,2022-05-01
CASH_IN,132865,Agence_mtn_Abomey,300000,167135,Margaud-Michelle Briand,-172581,-39716,2022-05-02
CASH_IN,42818,Agence_mtn_Abomey,300000,257182,Margaud-Michelle Briand,-39716,3102,2022-05-07
CASH_IN,90261,Agence_mtn_Ouidah,300000,209739,Margaud-Michelle Briand,3102,93363,2022-05-10
TRANSFER,1399,Margaud-Michelle Briand,93363,91964,Margaud-Michelle Briand,93363,91964,2022-05-11
TRANSFER,31508,Margaud-Michelle Briand,91964,60456,Margaud-Michelle Briand,91964,60456,2022-05-11
CASH_OUT,33974,Margaud-Michelle Briand,60456,26482,Agence_mtn_Abomey,300000,266026,2022-05-11
CASH_OUT,5653,Margaud-Michelle Briand,26482,20829,Agence_mtn_Ouidah,300000,294347,2022-05-12
CASH_IN,212233,Agence_mtn_Abomey,300000,87767,Margaud-Michelle Briand,20829,233062,2022-05-13
CASH_IN,11340,Agence_mtn_Ouidah,300000,288660,Margaud-Michelle Briand,233062,244402,2022-05-15
CASH_IN,256425,Agence_mtn_Abomey,300000,43575,Margaud-Michelle Briand,244402,500827,2022-05-15
CASH_IN,188061,Agence_mtn_Ouidah,300000,111939,Margaud-Michelle Briand,500827,688888,2022-05-19
CASH_IN,135308,Agence_mtn_Cotonou,300000,164692,Margaud-Michelle Briand,688888,824196,2022-05-24
CASH_IN,166811,Agence_mtn_Ouidah,300000,133189,François Vaillant,-75061,91750,2022-05-02
TRANSFER,41514,François Vaillant,91750,50236,François Vaillant,91750,50236,2022-05-03
TRANSFER,15739,François Vaillant,50236,34497,François Vaillant,50236,34497,2022-05-03
CASH_IN,224038,Agence_mtn_Ouidah,300000,75962,François Vaillant,34497,258535,2022-05-05
CASH_IN,120173,Agence_mtn_Ouidah,300000,179827,François Vaillant,258535,378708,2022-05-05
TRANSFER,163357,François Vaillant,378708,215351,François Vaillant,378708,215351,2022-05-07
CASH_OUT,146541,François Vaillant,215351,68810,Agence_mtn_Cotonou,300000,153459,2022-05-14
TRANSFER,32262,François Vaillant,68810,36548,François Vaillant,68810,101072,2022-05-15
CASH_OUT,22426,François Vaillant,36548,14122,Agence_mtn_Ouidah,300000,277574,2022-05-15
CASH_OUT,11279,François Vaillant,14122,2843,Agence_mtn_Cotonou,300000,288721,2022-05-21
CASH_OUT,2437,François Vaillant,2843,406,Agence_mtn_Cotonou,300000,297563,2022-05-21
CASH_IN,59364,Agence_mtn_Cotonou,300000,240636,Nicole Huet,-707397,-648033,2022-05-04
CASH_IN,283927,Agence_mtn_Abomey,300000,16073,Nicole Huet,-648033,-364106,2022-05-04
CASH_IN,61328,Agence_mtn_Ouidah,300000,238672,Nicole Huet,-364106,-302778,2022-05-05
CASH_IN,106812,Agence_mtn_Cotonou,300000,193188,Nicole Huet,-302778,-195966,2022-05-07
CASH_IN,15505,Agence_mtn_Abomey,300000,284495,Nicole Huet,-195966,-180461,2022-05-11
CASH_IN,1594,Agence_mtn_Abomey,300000,298406,Nicole Huet,-180461,-178867,2022-05-13
CASH_IN,139692,Agence_mtn_Cotonou,300000,160308,Nicole Huet,-178867,-39175,2022-05-15
CASH_IN,288947,Agence_mtn_Ouidah,300000,11053,Nicole Huet,-39175,249772,2022-05-18
CASH_IN,172130,Agence_mtn_Abomey,300000,127870,Nicole Huet,249772,421902,2022-05-20
CASH_IN,71465,Agence_mtn_Cotonou,300000,228535,Nicole Huet,421902,493367,2022-05-25
CASH_IN,110029,Agence_mtn_Cotonou,300000,189971,Georges Muller,-470902,-360873,2022-05-02
CASH_IN,18721,Agence_mtn_Ouidah,300000,281279,Georges Muller,-360873,-342152,2022-05-06
CASH_IN,268710,Agence_mtn_Cotonou,300000,31290,Georges Muller,-342152,-73442,2022-05-07
CASH_IN,187182,Agence_mtn_Cotonou,300000,112818,Georges Muller,-73442,113740,2022-05-08
CASH_OUT,92866,Georges Muller,113740,20874,Agence_mtn_Ouidah,300000,207134,2022-05-09
TRANSFER,3600,Georges Muller,20874,17274,Georges Muller,20874,17274,2022-05-10
CASH_OUT,543,Georges Muller,17274,16731,Agence_mtn_Cotonou,300000,299457,2022-05-10
CASH_IN,298150,Agence_mtn_Ouidah,300000,1850,Georges Muller,16731,314881,2022-05-12
CASH_OUT,171888,Georges Muller,314881,142993,Agence_mtn_Ouidah,300000,128112,2022-05-14
CASH_IN,153058,Agence_mtn_Ouidah,300000,146942,Georges Muller,142993,296051,2022-05-15
CASH_IN,297993,Agence_mtn_Abomey,300000,2007,Georges Muller,296051,594044,2022-05-20
TRANSFER,86506,Georges Muller,594044,507538,Georges Muller,594044,680550,2022-05-23
CASH_IN,20633,Agence_mtn_Ouidah,300000,279367,Georges Muller,507538,528171,2022-05-24
CASH_OUT,94301,Georges Muller,528171,433870,Agence_mtn_Cotonou,300000,205699,2022-05-24
CASH_OUT,409546,Georges Muller,433870,24324,Agence_mtn_Cotonou,300000,-109546,2022-05-24
CASH_OUT,1397,Georges Muller,24324,22927,Agence_mtn_Cotonou,300000,298603,2022-05-25
CASH_OUT,13418,Georges Muller,22927,9509,Agence_mtn_Abomey,300000,286582,2022-05-25
CASH_OUT,3330,Georges Muller,9509,6179,Agence_mtn_Ouidah,300000,296670,2022-05-27
CASH_IN,249172,Agence_mtn_Ouidah,300000,50828,Marc Baudry,-17848,231324,2022-05-01
CASH_OUT,202640,Marc Baudry,231324,28684,Agence_mtn_Abomey,300000,97360,2022-05-05
TRANSFER,10734,Marc Baudry,28684,17950,Marc Baudry,28684,17950,2022-05-06
CASH_OUT,752,Marc Baudry,17950,17198,Agence_mtn_Cotonou,300000,299248,2022-05-06
CASH_IN,168776,Agence_mtn_Cotonou,300000,131224,Marc Baudry,17198,185974,2022-05-09
CASH_OUT,23394,Marc Baudry,185974,162580,Agence_mtn_Abomey,300000,276606,2022-05-11
CASH_OUT,121632,Marc Baudry,162580,40948,Agence_mtn_Cotonou,300000,178368,2022-05-13
CASH_OUT,30304,Marc Baudry,40948,10644,Agence_mtn_Cotonou,300000,269696,2022-05-14
CASH_OUT,5039,Marc Baudry,10644,5605,Agence_mtn_Ouidah,300000,294961,2022-05-15
CASH_IN,90818,Agence_mtn_Ouidah,300000,209182,Marc Baudry,5605,96423,2022-05-22
CASH_OUT,85698,Marc Baudry,96423,10725,Agence_mtn_Ouidah,300000,214302,2022-05-27
CASH_IN,261071,Agence_mtn_Cotonou,300000,38929,Aimé Bernier,-66739,194332,2022-05-03
TRANSFER,58623,Aimé Bernier,194332,135709,Aimé Bernier,194332,252955,2022-05-03
CASH_IN,87445,Agence_mtn_Ouidah,300000,212555,Aimé Bernier,135709,223154,2022-05-06
TRANSFER,195007,Aimé Bernier,223154,28147,Aimé Bernier,223154,418161,2022-05-07
CASH_OUT,13163,Aimé Bernier,28147,14984,Agence_mtn_Abomey,300000,286837,2022-05-10
CASH_IN,262264,Agence_mtn_Abomey,300000,37736,Aimé Bernier,14984,277248,2022-05-14
CASH_OUT,131413,Aimé Bernier,277248,145835,Agence_mtn_Cotonou,300000,168587,2022-05-18
CASH_IN,253071,Agence_mtn_Abomey,300000,46929,Aimé Bernier,145835,398906,2022-05-24
CASH_IN,82978,Agence_mtn_Ouidah,300000,217022,Jacques Le Marion,-184190,-101212,2022-05-04
CASH_IN,159009,Agence_mtn_Abomey,300000,140991,Jacques Le Marion,-101212,57797,2022-05-05
CASH_IN,234954,Agence_mtn_Ouidah,300000,65046,Jacques Le Marion,57797,292751,2022-05-08
CASH_OUT,160630,Jacques Le Marion,292751,132121,Agence_mtn_Abomey,300000,139370,2022-05-14
CASH_IN,18096,Agence_mtn_Abomey,300000,281904,Jacques Le Marion,132121,150217,2022-05-19
CASH_IN,237524,Agence_mtn_Abomey,300000,62476,Clémence-Alice Ruiz,-36513,201011,2022-05-01
TRANSFER,93297,Clémence-Alice Ruiz,201011,107714,Clémence-Alice Ruiz,201011,107714,2022-05-04
CASH_OUT,17845,Clémence-Alice Ruiz,107714,89869,Agence_mtn_Abomey,300000,282155,2022-05-04
CASH_OUT,42640,Clémence-Alice Ruiz,89869,47229,Agence_mtn_Cotonou,300000,257360,2022-05-05
CASH_IN,207888,Agence_mtn_Cotonou,300000,92112,Clémence-Alice Ruiz,47229,255117,2022-05-13
CASH_IN,130635,Agence_mtn_Abomey,300000,169365,Clémence-Alice Ruiz,255117,385752,2022-05-13
CASH_OUT,236248,Clémence-Alice Ruiz,385752,149504,Agence_mtn_Ouidah,300000,63752,2022-05-15
CASH_OUT,122980,Clémence-Alice Ruiz,149504,26524,Agence_mtn_Cotonou,300000,177020,2022-05-15
CASH_OUT,2493,Clémence-Alice Ruiz,26524,24031,Agence_mtn_Ouidah,300000,297507,2022-05-15
CASH_IN,34142,Agence_mtn_Ouidah,300000,265858,Clémence-Alice Ruiz,24031,58173,2022-05-19
CASH_IN,289723,Agence_mtn_Ouidah,300000,10277,Clémence-Alice Ruiz,58173,347896,2022-05-22
CASH_IN,270572,Agence_mtn_Cotonou,300000,29428,Clémence-Alice Ruiz,347896,618468,2022-05-23
CASH_OUT,349146,Clémence-Alice Ruiz,618468,269322,Agence_mtn_Ouidah,300000,-49146,2022-05-24
CASH_IN,112586,Agence_mtn_Abomey,300000,187414,Clémence-Alice Ruiz,269322,381908,2022-05-27
CASH_IN,58603,Agence_mtn_Abomey,300000,241397,Sylvie Dupré,-1104005,-1045402,2022-05-01
CASH_IN,70205,Agence_mtn_Ouidah,300000,229795,Sylvie Dupré,-1045402,-975197,2022-05-04
CASH_IN,121628,Agence_mtn_Cotonou,300000,178372,Sylvie Dupré,-975197,-853569,2022-05-05
CASH_IN,40910,Agence_mtn_Cotonou,300000,259090,Sylvie Dupré,-853569,-812659,2022-05-07
CASH_IN,128945,Agence_mtn_Abomey,300000,171055,Sylvie Dupré,-812659,-683714,2022-05-17
CASH_IN,207668,Agence_mtn_Cotonou,300000,92332,Sylvie Dupré,-683714,-476046,2022-05-17
CASH_IN,147571,Agence_mtn_Ouidah,300000,152429,Sylvie Dupré,-476046,-328475,2022-05-18
CASH_IN,261673,Agence_mtn_Cotonou,300000,38327,Sylvie Dupré,-328475,-66802,2022-05-19
CASH_IN,219726,Agence_mtn_Abomey,300000,80274,Sylvie Dupré,-66802,152924,2022-05-20
TRANSFER,136236,Sylvie Dupré,152924,16688,Sylvie Dupré,152924,289160,2022-05-20
CASH_IN,278724,Agence_mtn_Cotonou,300000,21276,Sylvie Dupré,16688,295412,2022-05-20
CASH_IN,211339,Agence_mtn_Cotonou,300000,88661,Sylvie Dupré,295412,506751,2022-05-24
CASH_OUT,23141,Sylvie Dupré,506751,483610,Agence_mtn_Ouidah,300000,276859,2022-05-25
CASH_IN,273802,Agence_mtn_Abomey,300000,26198,Olivier Benard,-80824,192978,2022-05-09
TRANSFER,63287,Olivier Benard,192978,129691,Olivier Benard,192978,129691,2022-05-09
CASH_IN,170017,Agence_mtn_Abomey,300000,129983,Olivier Benard,129691,299708,2022-05-14
CASH_IN,116747,Agence_mtn_Cotonou,300000,183253,Olivier Benard,299708,416455,2022-05-15
CASH_IN,61770,Agence_mtn_Abomey,300000,238230,Olivier Benard,416455,478225,2022-05-15
TRANSFER,443200,Olivier Benard,478225,35025,Olivier Benard,478225,921425,2022-05-17
CASH_OUT,3625,Olivier Benard,35025,31400,Agence_mtn_Ouidah,300000,296375,2022-05-26
CASH_IN,9143,Agence_mtn_Abomey,300000,290857,Astrid Aubert-Thierry,-683216,-674073,2022-05-02
CASH_IN,65318,Agence_mtn_Abomey,300000,234682,Astrid Aubert-Thierry,-674073,-608755,2022-05-06
CASH_IN,217446,Agence_mtn_Abomey,300000,82554,Astrid Aubert-Thierry,-608755,-391309,2022-05-11
CASH_IN,284759,Agence_mtn_Abomey,300000,15241,Astrid Aubert-Thierry,-391309,-106550,2022-05-12
CASH_IN,128988,Agence_mtn_Ouidah,300000,171012,Astrid Aubert-Thierry,-106550,22438,2022-05-14
CASH_OUT,17953,Astrid Aubert-Thierry,22438,4485,Agence_mtn_Abomey,300000,282047,2022-05-15
TRANSFER,1419,Astrid Aubert-Thierry,4485,3066,Astrid Aubert-Thierry,4485,5904,2022-05-17
TRANSFER,1877,Astrid Aubert-Thierry,3066,1189,Astrid Aubert-Thierry,3066,1189,2022-05-18
CASH_IN,144127,Agence_mtn_Cotonou,300000,155873,Astrid Aubert-Thierry,1189,145316,2022-05-20
CASH_IN,242124,Agence_mtn_Abomey,300000,57876,Astrid Aubert-Thierry,145316,387440,2022-05-20
CASH_OUT,268280,Astrid Aubert-Thierry,387440,119160,Agence_mtn_Ouidah,300000,31720,2022-05-21
CASH_OUT,96470,Astrid Aubert-Thierry,119160,22690,Agence_mtn_Cotonou,300000,203530,2022-05-21
CASH_OUT,18979,Astrid Aubert-Thierry,22690,3711,Agence_mtn_Ouidah,300000,281021,2022-05-21
TRANSFER,2589,Astrid Aubert-Thierry,3711,1122,Astrid Aubert-Thierry,3711,6300,2022-05-22
CASH_OUT,134,Astrid Aubert-Thierry,1122,988,Agence_mtn_Abomey,300000,299866,2022-05-25
CASH_IN,107391,Agence_mtn_Ouidah,300000,192609,René de la Delaunay,-162368,-54977,2022-05-01
CASH_IN,31257,Agence_mtn_Abomey,300000,268743,René de la Delaunay,-54977,-23720,2022-05-01
CASH_IN,162036,Agence_mtn_Ouidah,300000,137964,René de la Delaunay,-23720,138316,2022-05-02
CASH_OUT,48305,René de la Delaunay,138316,90011,Agence_mtn_Abomey,300000,251695,2022-05-03
CASH_IN,129822,Agence_mtn_Cotonou,300000,170178,René de la Delaunay,90011,219833,2022-05-03
TRANSFER,185554,René de la Delaunay,219833,34279,René de la Delaunay,219833,34279,2022-05-06
CASH_OUT,24206,René de la Delaunay,34279,10073,Agence_mtn_Ouidah,300000,275794,2022-05-07
CASH_IN,273052,Agence_mtn_Cotonou,300000,26948,René de la Delaunay,10073,283125,2022-05-10
CASH_IN,229135,Agence_mtn_Ouidah,300000,70865,René de la Delaunay,283125,512260,2022-05-14
CASH_IN,299410,Agence_mtn_Cotonou,300000,590,René de la Delaunay,512260,811670,2022-05-14
CASH_IN,18512,Agence_mtn_Cotonou,300000,281488,René de la Delaunay,811670,830182,2022-05-15
CASH_IN,85074,Agence_mtn_Ouidah,300000,214926,René de la Delaunay,830182,915256,2022-05-19
CASH_IN,50231,Agence_mtn_Abomey,300000,249769,Jérôme Laporte Le Gauthier,-150083,-99852,2022-05-02
CASH_IN,187327,Agence_mtn_Cotonou,300000,112673,Jérôme Laporte Le Gauthier,-99852,87475,2022-05-03
TRANSFER,35268,Jérôme Laporte Le Gauthier,87475,52207,Jérôme Laporte Le Gauthier,87475,52207,2022-05-03
CASH_OUT,39138,Jérôme Laporte Le Gauthier,52207,13069,Agence_mtn_Abomey,300000,260862,2022-05-04
CASH_OUT,3499,Jérôme Laporte Le Gauthier,13069,9570,Agence_mtn_Ouidah,300000,296501,2022-05-07
TRANSFER,3833,Jérôme Laporte Le Gauthier,9570,5737,Jérôme Laporte Le Gauthier,9570,5737,2022-05-09
CASH_IN,241904,Agence_mtn_Ouidah,300000,58096,Jérôme Laporte Le Gauthier,5737,247641,2022-05-09
TRANSFER,35247,Jérôme Laporte Le Gauthier,247641,212394,Jérôme Laporte Le Gauthier,247641,282888,2022-05-10
TRANSFER,121008,Jérôme Laporte Le Gauthier,212394,91386,Jérôme Laporte Le Gauthier,212394,333402,2022-05-12
CASH_IN,53425,Agence_mtn_Abomey,300000,246575,Jérôme Laporte Le Gauthier,91386,144811,2022-05-12
CASH_IN,66072,Agence_mtn_Ouidah,300000,233928,Jérôme Laporte Le Gauthier,144811,210883,2022-05-15
CASH_OUT,180343,Jérôme Laporte Le Gauthier,210883,30540,Agence_mtn_Ouidah,300000,119657,2022-05-17
CASH_OUT,18037,Jérôme Laporte Le Gauthier,30540,12503,Agence_mtn_Abomey,300000,281963,2022-05-23
CASH_IN,116416,Agence_mtn_Abomey,300000,183584,Madeleine Philippe-Grondin,-55837,60579,2022-05-02
CASH_IN,16479,Agence_mtn_Ouidah,300000,283521,Madeleine Philippe-Grondin,60579,77058,2022-05-04
TRANSFER,9671,Madeleine Philippe-Grondin,77058,67387,Madeleine Philippe-Grondin,77058,86729,2022-05-08
TRANSFER,45970,Madeleine Philippe-Grondin,67387,21417,Madeleine Philippe-Grondin,67387,113357,2022-05-08
CASH_IN,23052,Agence_mtn_Cotonou,300000,276948,Madeleine Philippe-Grondin,21417,44469,2022-05-22
CASH_OUT,36215,Madeleine Philippe-Grondin,44469,8254,Agence_mtn_Abomey,300000,263785,2022-05-25
CASH_IN,283506,Agence_mtn_Abomey,300000,16494,Madeleine Philippe-Grondin,8254,291760,2022-05-27
CASH_IN,18199,Agence_mtn_Cotonou,300000,281801,Valérie de Pottier,-815225,-797026,2022-05-01
CASH_IN,234415,Agence_mtn_Cotonou,300000,65585,Valérie de Pottier,-797026,-562611,2022-05-07
CASH_IN,291062,Agence_mtn_Cotonou,300000,8938,Valérie de Pottier,-562611,-271549,2022-05-10
CASH_IN,200570,Agence_mtn_Abomey,300000,99430,Valérie de Pottier,-271549,-70979,2022-05-13
CASH_IN,104278,Agence_mtn_Abomey,300000,195722,Valérie de Pottier,-70979,33299,2022-05-14
CASH_IN,67700,Agence_mtn_Abomey,300000,232300,Valérie de Pottier,33299,100999,2022-05-23
CASH_IN,107054,Agence_mtn_Cotonou,300000,192946,Valérie de Pottier,100999,208053,2022-05-24
CASH_IN,103181,Agence_mtn_Cotonou,300000,196819,Margot Julien,-270734,-167553,2022-05-01
CASH_IN,208054,Agence_mtn_Cotonou,300000,91946,Margot Julien,-167553,40501,2022-05-06
CASH_OUT,654,Margot Julien,40501,39847,Agence_mtn_Cotonou,300000,299346,2022-05-11
TRANSFER,730,Margot Julien,39847,39117,Margot Julien,39847,39117,2022-05-15
CASH_OUT,8002,Margot Julien,39117,31115,Agence_mtn_Abomey,300000,291998,2022-05-16
CASH_IN,252002,Agence_mtn_Cotonou,300000,47998,Margot Julien,31115,283117,2022-05-25
CASH_OUT,1160448,Danielle-Henriette Tessier,1821800,661352,Agence_mtn_Ouidah,300000,-860448,2022-06-06
CASH_OUT,490569,Danielle-Henriette Tessier,661352,170783,Agence_mtn_Cotonou,300000,-190569,2022-06-10
CASH_OUT,52462,Danielle-Henriette Tessier,170783,118321,Agence_mtn_Ouidah,300000,247538,2022-06-15
CASH_OUT,100223,Danielle-Henriette Tessier,118321,18098,Agence_mtn_Abomey,300000,199777,2022-06-19
TRANSFER,18766,Laurent Marion,1640500,1621734,Hélène Blanchard-Renault,1583200,1564434,2022-06-02
TRANSFER,807665,Aurélie Maury,1055500,247835,Laurent Marion,1621734,2429399,2022-06-08
CASH_OUT,769450,Laurent Marion,2429399,1659949,Agence_mtn_Ouidah,300000,-469450,2022-06-21
TRANSFER,262617,Clémence Dufour,1110000,847383,Laurent Marion,1659949,1922566,2022-06-21
CASH_IN,138430,Agence_mtn_Cotonou,300000,161570,Laurent Marion,1922566,2060996,2022-06-21
CASH_OUT,430029,Clémence-Alice Ruiz,1561700,1131671,Agence_mtn_Abomey,300000,-130029,2022-06-04
TRANSFER,703269,Clémence-Alice Ruiz,1131671,428402,Jérôme Laporte Le Gauthier,668100,-35169,2022-06-04
TRANSFER,53784,Jules-Marc Chauvet,468000,414216,Clémence-Alice Ruiz,428402,482186,2022-06-08
CASH_IN,116876,Agence_mtn_Ouidah,300000,183124,Clémence-Alice Ruiz,482186,599062,2022-06-18
CASH_IN,78281,Agence_mtn_Ouidah,300000,221719,Charlotte Perrier,1614500,1692781,2022-06-14
CASH_IN,282144,Agence_mtn_Cotonou,300000,17856,Charlotte Perrier,1692781,1974925,2022-06-18
TRANSFER,1834263,Charlotte Perrier,1974925,140662,Honoré de la Prévost,1878900,44637,2022-06-23
CASH_OUT,130530,Charlotte Perrier,140662,10132,Agence_mtn_Abomey,300000,169470,2022-06-26
CASH_OUT,428324,René de la Delaunay,1449500,1021176,Agence_mtn_Abomey,300000,-128324,2022-06-02
CASH_IN,43396,Agence_mtn_Cotonou,300000,256604,René de la Delaunay,1021176,1064572,2022-06-05
TRANSFER,873106,René de la Delaunay,1064572,191466,Louise-Aurore Payet,634600,-238506,2022-06-21
CASH_IN,177142,Agence_mtn_Abomey,300000,122858,Raymond Simon,1595900,1773042,2022-06-23
CASH_OUT,43639,Jules-Marc Chauvet,414216,370577,Agence_mtn_Cotonou,300000,256361,2022-06-12
CASH_IN,143272,Agence_mtn_Ouidah,300000,156728,Jules-Marc Chauvet,370577,513849,2022-06-17
CASH_IN,234018,Agence_mtn_Ouidah,300000,65982,Jules-Marc Chauvet,513849,747867,2022-06-23
CASH_IN,291647,Agence_mtn_Abomey,300000,8353,Jules-Marc Chauvet,747867,1039514,2022-06-27
CASH_OUT,267397,Zacharie Fabre,1256600,989203,Agence_mtn_Abomey,300000,32603,2022-06-07
CASH_OUT,44888,Zacharie Fabre,989203,944315,Agence_mtn_Cotonou,300000,255112,2022-06-11
CASH_IN,146479,Agence_mtn_Ouidah,300000,153521,Zacharie Fabre,944315,1090794,2022-06-18
CASH_OUT,715142,Thérèse-Juliette Camus,733000,17858,Agence_mtn_Cotonou,300000,-415142,2022-06-02
CASH_IN,181919,Agence_mtn_Ouidah,300000,118081,Thérèse-Juliette Camus,17858,199777,2022-06-06
CASH_IN,155281,Agence_mtn_Ouidah,300000,144719,Thérèse-Juliette Camus,199777,355058,2022-06-21
CASH_OUT,42247,Robert Henry-Poulain,48400,6153,Agence_mtn_Ouidah,300000,257753,2022-06-14
CASH_OUT,2849,Robert Henry-Poulain,6153,3304,Agence_mtn_Cotonou,300000,297151,2022-06-18
CASH_OUT,1902,Robert Henry-Poulain,3304,1402,Agence_mtn_Ouidah,300000,298098,2022-06-20
TRANSFER,102705,Raymond-Yves Boulanger,362900,260195,Robert Henry-Poulain,1402,104107,2022-06-27
CASH_IN,140570,Agence_mtn_Ouidah,300000,159430,Madeleine Philippe-Grondin,1631600,1772170,2022-06-09
CASH_IN,113032,Agence_mtn_Abomey,300000,186968,Madeleine Philippe-Grondin,1772170,1885202,2022-06-17
CASH_OUT,300664,Maryse Delorme,714800,414136,Agence_mtn_Ouidah,300000,-664,2022-06-19
CASH_IN,254573,Agence_mtn_Cotonou,300000,45427,Corinne Roussel,204800,459373,2022-06-04
CASH_IN,152229,Agence_mtn_Abomey,300000,147771,Corinne Roussel,459373,611602,2022-06-06
TRANSFER,70727,Corinne Roussel,611602,540875,Julien Devaux,1449500,1378773,2022-06-08
CASH_IN,5009,Agence_mtn_Cotonou,300000,294991,Corinne Roussel,540875,545884,2022-06-18
TRANSFER,144660,Jacques Laporte de Blanchet,294600,149940,Michelle de la Daniel,1479700,1335040,2022-06-05
CASH_IN,129427,Agence_mtn_Ouidah,300000,170573,Hélène Blanchard-Renault,1564434,1693861,2022-06-03
TRANSFER,1524430,Hélène Blanchard-Renault,1693861,169431,Nathalie-Claire De Oliveira,1014900,-509530,2022-06-03
TRANSFER,6130,Hélène Alexandre de la Samson,7800,1670,Hélène Blanchard-Renault,169431,175561,2022-06-06
TRANSFER,71339,Hélène Blanchard-Renault,175561,104222,Élise Monnier,829400,758061,2022-06-17
CASH_IN,232884,Agence_mtn_Ouidah,300000,67116,Hélène Blanchard-Renault,104222,337106,2022-06-17
CASH_IN,3913,Agence_mtn_Abomey,300000,296087,Henri de Didier,492500,496413,2022-06-13
CASH_OUT,356865,Henri de Didier,496413,139548,Agence_mtn_Ouidah,300000,-56865,2022-06-13
CASH_IN,171128,Agence_mtn_Abomey,300000,128872,Henri de Didier,139548,310676,2022-06-15
TRANSFER,329739,Élise Monnier,758061,428322,Henri de Didier,310676,640415,2022-06-23
CASH_IN,259670,Agence_mtn_Cotonou,300000,40330,Henri de Didier,640415,900085,2022-06-25
CASH_IN,31703,Agence_mtn_Cotonou,300000,268297,Anouk Delahaye-Gimenez,1594200,1625903,2022-06-22
CASH_IN,88963,Agence_mtn_Ouidah,300000,211037,Élise Monnier,428322,517285,2022-06-04
TRANSFER,399809,Élise Monnier,517285,117476,Thibault Martin,243100,-156709,2022-06-22
CASH_OUT,110584,Élise Monnier,117476,6892,Agence_mtn_Ouidah,300000,189416,2022-06-25
CASH_OUT,165063,Georges-Alfred Pruvost,418100,253037,Agence_mtn_Ouidah,300000,134937,2022-06-05
CASH_OUT,169018,Georges-Alfred Pruvost,253037,84019,Agence_mtn_Ouidah,300000,130982,2022-06-18
CASH_IN,3764,Agence_mtn_Ouidah,300000,296236,Thibault Martin,-156709,-152945,2022-06-12
CASH_IN,220345,Agence_mtn_Abomey,300000,79655,Thibault Martin,-152945,67400,2022-06-16
TRANSFER,302482,Gilbert Moulin,490700,188218,Thibault Martin,67400,369882,2022-06-22
CASH_IN,294012,Agence_mtn_Abomey,300000,5988,Françoise Denis de Allard,864400,1158412,2022-06-02
CASH_OUT,958883,Françoise Denis de Allard,1158412,199529,Agence_mtn_Cotonou,300000,-658883,2022-06-15
TRANSFER,28271,Françoise Denis de Allard,199529,171258,Alfred Paris,660000,631729,2022-06-23
CASH_IN,220179,Agence_mtn_Abomey,300000,79821,Alfred Paris,631729,851908,2022-06-07
CASH_OUT,426260,Alfred Paris,851908,425648,Agence_mtn_Cotonou,300000,-126260,2022-06-10
TRANSFER,577518,Marc Baudry,1062900,485382,Alfred Paris,425648,1003166,2022-06-19
CASH_OUT,408503,Alfred Paris,1003166,594663,Agence_mtn_Cotonou,300000,-108503,2022-06-21
TRANSFER,358804,Alfred Paris,594663,235859,Matthieu Cousin,1003400,644596,2022-06-24
CASH_IN,264484,Agence_mtn_Cotonou,300000,35516,Aurélie Maury,247835,512319,2022-06-08
CASH_OUT,410914,Aurélie Maury,512319,101405,Agence_mtn_Ouidah,300000,-110914,2022-06-13
CASH_IN,10215,Agence_mtn_Ouidah,300000,289785,Aurélie Maury,101405,111620,2022-06-21
CASH_OUT,105670,Aurélie Maury,111620,5950,Agence_mtn_Ouidah,300000,194330,2022-06-21
CASH_OUT,66575,Éléonore Marin Le Morel,1047200,980625,Agence_mtn_Abomey,300000,233425,2022-06-03
CASH_OUT,555159,Éléonore Marin Le Morel,980625,425466,Agence_mtn_Abomey,300000,-255159,2022-06-20
CASH_OUT,91089,Éléonore Marin Le Morel,425466,334377,Agence_mtn_Ouidah,300000,208911,2022-06-22
CASH_OUT,298473,Éléonore Marin Le Morel,334377,35904,Agence_mtn_Cotonou,300000,1527,2022-06-25
TRANSFER,317795,Jean Guilbert-Lenoir,1865000,1547205,Hélène Alexandre de la Samson,1670,-316125,2022-06-12
CASH_IN,217418,Agence_mtn_Ouidah,300000,82582,Gérard Blot de Blanc,821400,1038818,2022-06-01
TRANSFER,1391944,Emmanuelle Le Allain,1982100,590156,Gérard Blot de Blanc,1038818,2430762,2022-06-02
CASH_IN,110022,Agence_mtn_Abomey,300000,189978,Gérard Blot de Blanc,2430762,2540784,2022-06-05
CASH_OUT,2371498,Gérard Blot de Blanc,2540784,169286,Agence_mtn_Ouidah,300000,-2071498,2022-06-05
CASH_OUT,152271,Gérard Blot de Blanc,169286,17015,Agence_mtn_Ouidah,300000,147729,2022-06-05
CASH_IN,146436,Agence_mtn_Abomey,300000,153564,Gérard Blot de Blanc,17015,163451,2022-06-06
TRANSFER,99930,Gérard Blot de Blanc,163451,63521,Sylvie Dupré,1204100,1104170,2022-06-06
CASH_IN,179693,Agence_mtn_Cotonou,300000,120307,Gérard Blot de Blanc,63521,243214,2022-06-07
CASH_OUT,174610,Gérard Blot de Blanc,243214,68604,Agence_mtn_Cotonou,300000,125390,2022-06-08
TRANSFER,50852,Gérard Blot de Blanc,68604,17752,Nicolas Blin,285100,234248,2022-06-09
TRANSFER,232893,Nicolas Blin,234248,1355,Gérard Blot de Blanc,17752,250645,2022-06-09
CASH_OUT,127695,Gérard Blot de Blanc,250645,122950,Agence_mtn_Abomey,300000,172305,2022-06-10
TRANSFER,430622,Maggie Barbier,508200,77578,Gérard Blot de Blanc,122950,553572,2022-06-10
CASH_IN,182778,Agence_mtn_Cotonou,300000,117222,Gérard Blot de Blanc,553572,736350,2022-06-11
TRANSFER,720744,Gérard Blot de Blanc,736350,15606,Astrid de Pascal,843400,122656,2022-06-14
CASH_IN,194634,Agence_mtn_Abomey,300000,105366,Gérard Blot de Blanc,15606,210240,2022-06-14
TRANSFER,78685,Gérard Blot de Blanc,210240,131555,Olivier Benard,346000,267315,2022-06-15
TRANSFER,64790,Gérard Blot de Blanc,131555,66765,Sébastien Coste,786200,721410,2022-06-18
CASH_OUT,65368,Gérard Blot de Blanc,66765,1397,Agence_mtn_Cotonou,300000,234632,2022-06-20
TRANSFER,308662,Marc Baudry,485382,176720,Gérard Blot de Blanc,1397,310059,2022-06-21
CASH_IN,67593,Agence_mtn_Abomey,300000,232407,Gérard Blot de Blanc,310059,377652,2022-06-21
CASH_IN,185975,Agence_mtn_Ouidah,300000,114025,Gérard Blot de Blanc,377652,563627,2022-06-22
CASH_OUT,206457,Gérard Blot de Blanc,563627,357170,Agence_mtn_Cotonou,300000,93543,2022-06-24
CASH_IN,176803,Agence_mtn_Ouidah,300000,123197,Raymond-Yves Boulanger,260195,436998,2022-06-01
TRANSFER,108449,Emmanuelle Le Allain,590156,481707,Raymond-Yves Boulanger,436998,545447,2022-06-04
TRANSFER,144100,Gilbert Moulin,188218,44118,Raymond-Yves Boulanger,545447,689547,2022-06-05
CASH_OUT,158616,Raymond-Yves Boulanger,689547,530931,Agence_mtn_Ouidah,300000,141384,2022-06-06
CASH_IN,116188,Agence_mtn_Abomey,300000,183812,Raymond-Yves Boulanger,530931,647119,2022-06-06
CASH_OUT,549673,Raymond-Yves Boulanger,647119,97446,Agence_mtn_Cotonou,300000,-249673,2022-06-06
CASH_IN,258891,Agence_mtn_Ouidah,300000,41109,Raymond-Yves Boulanger,97446,356337,2022-06-07
TRANSFER,80368,Véronique Hardy,433000,352632,Raymond-Yves Boulanger,356337,436705,2022-06-07
TRANSFER,123646,Raymond-Yves Boulanger,436705,313059,Josette du Hamon,64700,-58946,2022-06-08
CASH_OUT,32244,Raymond-Yves Boulanger,313059,280815,Agence_mtn_Ouidah,300000,267756,2022-06-09
TRANSFER,166820,Raymond-Yves Boulanger,280815,113995,Maurice de Brunet,341300,174480,2022-06-11
CASH_IN,208851,Agence_mtn_Ouidah,300000,91149,Raymond-Yves Boulanger,113995,322846,2022-06-14
CASH_OUT,51572,Raymond-Yves Boulanger,322846,271274,Agence_mtn_Abomey,300000,248428,2022-06-15
TRANSFER,21585,Raymond-Yves Boulanger,271274,249689,Emmanuelle Le Allain,481707,460122,2022-06-17
TRANSFER,181675,Nicole Huet,1052800,871125,Raymond-Yves Boulanger,249689,431364,2022-06-19
CASH_OUT,41070,Raymond-Yves Boulanger,431364,390294,Agence_mtn_Ouidah,300000,258930,2022-06-19
CASH_IN,293587,Agence_mtn_Cotonou,300000,6413,Raymond-Yves Boulanger,390294,683881,2022-06-20
CASH_IN,245968,Agence_mtn_Cotonou,300000,54032,Raymond-Yves Boulanger,683881,929849,2022-06-21
CASH_IN,135727,Agence_mtn_Abomey,300000,164273,Raymond-Yves Boulanger,929849,1065576,2022-06-22
CASH_OUT,822870,Raymond-Yves Boulanger,1065576,242706,Agence_mtn_Cotonou,300000,-522870,2022-06-22
TRANSFER,151865,Raymond-Yves Boulanger,242706,90841,Nicole Huet,871125,719260,2022-06-23
CASH_IN,118696,Agence_mtn_Ouidah,300000,181304,Raymond-Yves Boulanger,90841,209537,2022-06-24
TRANSFER,1555848,Margot Julien,1644100,88252,Raymond-Yves Boulanger,209537,1765385,2022-06-24
CASH_IN,117189,Agence_mtn_Ouidah,300000,182811,Raymond-Yves Boulanger,1765385,1882574,2022-06-25
CASH_OUT,1562371,Raymond-Yves Boulanger,1882574,320203,Agence_mtn_Ouidah,300000,-1262371,2022-06-26
TRANSFER,66366,Roland Huet,160300,93934,Raymond-Yves Boulanger,320203,386569,2022-06-26
TRANSFER,75822,Raymond-Yves Boulanger,386569,310747,Clémence Dufour,847383,771561,2022-06-26
CASH_OUT,83270,Raymond-Yves Boulanger,310747,227477,Agence_mtn_Ouidah,300000,216730,2022-06-27
TRANSFER,270732,Sabine Perrier,548900,278168,Gabrielle Hamon,578300,307568,2022-06-05
TRANSFER,120462,Sabine Perrier,278168,157706,Emmanuelle Le Allain,460122,339660,2022-06-05
CASH_IN,15125,Agence_mtn_Ouidah,300000,284875,Sabine Perrier,157706,172831,2022-06-06
TRANSFER,135231,Sabine Perrier,172831,37600,Gabrielle Hamon,307568,172337,2022-06-07
TRANSFER,70973,Maurice de Brunet,174480,103507,Sabine Perrier,37600,108573,2022-06-07
CASH_OUT,66381,Sabine Perrier,108573,42192,Agence_mtn_Abomey,300000,233619,2022-06-09
CASH_OUT,15537,Sabine Perrier,42192,26655,Agence_mtn_Cotonou,300000,284463,2022-06-11
CASH_OUT,4436,Sabine Perrier,26655,22219,Agence_mtn_Abomey,300000,295564,2022-06-11
TRANSFER,68643,Jacques Marchand,646400,577757,Sabine Perrier,22219,90862,2022-06-11
TRANSFER,591087,Nicole Huet,719260,128173,Sabine Perrier,90862,681949,2022-06-12
CASH_IN,32947,Agence_mtn_Abomey,300000,267053,Sabine Perrier,681949,714896,2022-06-12
CASH_OUT,398648,Sabine Perrier,714896,316248,Agence_mtn_Cotonou,300000,-98648,2022-06-12
TRANSFER,174306,Sabine Perrier,316248,141942,Emmanuelle Le Allain,339660,165354,2022-06-14
TRANSFER,113450,Marcel de la Buisson,1087700,974250,Sabine Perrier,141942,255392,2022-06-15
CASH_IN,232305,Agence_mtn_Ouidah,300000,67695,Sabine Perrier,255392,487697,2022-06-15
TRANSFER,123085,Sabine Perrier,487697,364612,Maggie Barbier,77578,-45507,2022-06-15
TRANSFER,106958,Sabine Perrier,364612,257654,Marthe Perrin,1959300,1852342,2022-06-16
CASH_OUT,22479,Sabine Perrier,257654,235175,Agence_mtn_Abomey,300000,277521,2022-06-16
TRANSFER,132212,Christophe Besnard-Diaz,872000,739788,Sabine Perrier,235175,367387,2022-06-17
CASH_IN,265216,Agence_mtn_Cotonou,300000,34784,Sabine Perrier,367387,632603,2022-06-19
CASH_IN,267949,Agence_mtn_Abomey,300000,32051,Sabine Perrier,632603,900552,2022-06-21
CASH_OUT,92659,Sabine Perrier,900552,807893,Agence_mtn_Ouidah,300000,207341,2022-06-21
TRANSFER,491454,Sabine Perrier,807893,316439,Sophie-Anouk Boulanger,362300,-129154,2022-06-23
CASH_OUT,246094,Sabine Perrier,316439,70345,Agence_mtn_Ouidah,300000,53906,2022-06-23
CASH_OUT,46583,Sabine Perrier,70345,23762,Agence_mtn_Ouidah,300000,253417,2022-06-24
TRANSFER,12465,Sabine Perrier,23762,11297,Julien Devaux,1378773,1366308,2022-06-25
CASH_OUT,10011,Sabine Perrier,11297,1286,Agence_mtn_Abomey,300000,289989,2022-06-26
CASH_IN,36734,Agence_mtn_Cotonou,300000,263266,Sabine Perrier,1286,38020,2022-06-26
TRANSFER,112115,François Vaillant,1211800,1099685,Sébastien Coste,721410,833525,2022-06-01
CASH_OUT,357548,Sébastien Coste,833525,475977,Agence_mtn_Abomey,300000,-57548,2022-06-02
TRANSFER,151734,Sébastien Coste,475977,324243,Julie Germain Le Vaillant,1600500,1448766,2022-06-06
CASH_OUT,227992,Sébastien Coste,324243,96251,Agence_mtn_Cotonou,300000,72008,2022-06-06
TRANSFER,94134,Augustin-Jérôme Merle,320900,226766,Sébastien Coste,96251,190385,2022-06-08
CASH_IN,249301,Agence_mtn_Cotonou,300000,50699,Sébastien Coste,190385,439686,2022-06-08
CASH_IN,267402,Agence_mtn_Cotonou,300000,32598,Sébastien Coste,439686,707088,2022-06-09
TRANSFER,114149,Olivier Benard,267315,153166,Sébastien Coste,707088,821237,2022-06-11
TRANSFER,296450,Marthe Perrin,1852342,1555892,Sébastien Coste,821237,1117687,2022-06-12
TRANSFER,555312,Sébastien Coste,1117687,562375,Sébastien Coste,1117687,1672999,2022-06-16
TRANSFER,730,Nicolas Blin,1355,625,Sébastien Coste,562375,563105,2022-06-17
TRANSFER,1511375,Martin Moreau,1639100,127725,Sébastien Coste,563105,2074480,2022-06-17
CASH_OUT,1029508,Sébastien Coste,2074480,1044972,Agence_mtn_Abomey,300000,-729508,2022-06-17
TRANSFER,479951,Valérie de Pottier,622000,142049,Sébastien Coste,1044972,1524923,2022-06-18
CASH_OUT,1018070,Sébastien Coste,1524923,506853,Agence_mtn_Abomey,300000,-718070,2022-06-18
CASH_OUT,288980,Sébastien Coste,506853,217873,Agence_mtn_Ouidah,300000,11020,2022-06-18
CASH_OUT,145268,Sébastien Coste,217873,72605,Agence_mtn_Ouidah,300000,154732,2022-06-19
TRANSFER,61123,Sébastien Coste,72605,11482,Simone du Allard,464500,403377,2022-06-20
TRANSFER,350851,Simone du Allard,403377,52526,Sébastien Coste,11482,362333,2022-06-22
CASH_IN,210543,Agence_mtn_Cotonou,300000,89457,Sébastien Coste,362333,572876,2022-06-23
CASH_OUT,61086,Sébastien Coste,572876,511790,Agence_mtn_Ouidah,300000,238914,2022-06-23
TRANSFER,177879,Gérard Cordier,287900,110021,Sébastien Coste,511790,689669,2022-06-24
CASH_IN,282353,Agence_mtn_Cotonou,300000,17647,Sébastien Coste,689669,972022,2022-06-24
CASH_OUT,970459,Sébastien Coste,972022,1563,Agence_mtn_Ouidah,300000,-670459,2022-06-24
CASH_IN,293814,Agence_mtn_Abomey,300000,6186,Gérard Cordier,110021,403835,2022-06-02
CASH_OUT,281452,Gérard Cordier,403835,122383,Agence_mtn_Abomey,300000,18548,2022-06-02
TRANSFER,8365,Gérard Cordier,122383,114018,Christophe Besnard-Diaz,739788,731423,2022-06-02
CASH_IN,243819,Agence_mtn_Cotonou,300000,56181,Gérard Cordier,114018,357837,2022-06-03
CASH_IN,257754,Agence_mtn_Ouidah,300000,42246,Gérard Cordier,357837,615591,2022-06-05
CASH_IN,164862,Agence_mtn_Cotonou,300000,135138,Gérard Cordier,615591,780453,2022-06-06
CASH_IN,93843,Agence_mtn_Abomey,300000,206157,Gérard Cordier,780453,874296,2022-06-06
CASH_OUT,58921,Gérard Cordier,874296,815375,Agence_mtn_Abomey,300000,241079,2022-06-07
TRANSFER,77646,Gabrielle Hamon,172337,94691,Gérard Cordier,815375,893021,2022-06-08
TRANSFER,201998,Aimé Bernier,1375200,1173202,Gérard Cordier,893021,1095019,2022-06-09
TRANSFER,398428,Charles Guérin,1601400,1202972,Gérard Cordier,1095019,1493447,2022-06-10
TRANSFER,128587,Raymond de Le Roux,383700,255113,Gérard Cordier,1493447,1622034,2022-06-12
CASH_IN,161359,Agence_mtn_Abomey,300000,138641,Gérard Cordier,1622034,1783393,2022-06-15
CASH_OUT,300347,Gérard Cordier,1783393,1483046,Agence_mtn_Abomey,300000,-347,2022-06-15
CASH_IN,263418,Agence_mtn_Cotonou,300000,36582,Gérard Cordier,1483046,1746464,2022-06-15
TRANSFER,243240,Gérard Cordier,1746464,1503224,Augustin-Jérôme Merle,226766,-16474,2022-06-18
CASH_OUT,1135428,Gérard Cordier,1503224,367796,Agence_mtn_Cotonou,300000,-835428,2022-06-20
CASH_OUT,2691,Gérard Cordier,367796,365105,Agence_mtn_Abomey,300000,297309,2022-06-20
CASH_IN,167464,Agence_mtn_Abomey,300000,132536,Gérard Cordier,365105,532569,2022-06-21
CASH_IN,112938,Agence_mtn_Cotonou,300000,187062,Gérard Cordier,532569,645507,2022-06-23
CASH_IN,255894,Agence_mtn_Cotonou,300000,44106,Gérard Cordier,645507,901401,2022-06-23
CASH_OUT,649293,Gérard Cordier,901401,252108,Agence_mtn_Cotonou,300000,-349293,2022-06-23
CASH_OUT,30875,Gérard Cordier,252108,221233,Agence_mtn_Ouidah,300000,269125,2022-06-26
TRANSFER,25114,Alexandre Blanchard,57600,32486,Gérard Cordier,221233,246347,2022-06-26
CASH_OUT,39104,Gérard Cordier,246347,207243,Agence_mtn_Cotonou,300000,260896,2022-06-27
TRANSFER,161998,Marc Baudry,176720,14722,Élisabeth Delattre,967500,805502,2022-06-03
TRANSFER,2882,Marc Baudry,14722,11840,Stéphanie Guichard,1772300,1769418,2022-06-06
CASH_IN,137374,Agence_mtn_Abomey,300000,162626,Marc Baudry,11840,149214,2022-06-06
TRANSFER,78700,Maurice de Brunet,103507,24807,Marc Baudry,149214,227914,2022-06-06
CASH_OUT,107455,Marc Baudry,227914,120459,Agence_mtn_Abomey,300000,192545,2022-06-09
CASH_OUT,64479,Marc Baudry,120459,55980,Agence_mtn_Ouidah,300000,235521,2022-06-10
TRANSFER,22169,Marc Baudry,55980,33811,Astrid Aubert-Thierry,693300,671131,2022-06-10
TRANSFER,33688,Marc Baudry,33811,123,Julie Germain Le Vaillant,1448766,1415078,2022-06-11
CASH_IN,275227,Agence_mtn_Ouidah,300000,24773,Marc Baudry,123,275350,2022-06-14
CASH_IN,150290,Agence_mtn_Ouidah,300000,149710,Marc Baudry,275350,425640,2022-06-17
CASH_IN,108546,Agence_mtn_Abomey,300000,191454,Marc Baudry,425640,534186,2022-06-18
CASH_IN,29088,Agence_mtn_Abomey,300000,270912,Marc Baudry,534186,563274,2022-06-18
TRANSFER,438530,Sylvie Dupré,1104170,665640,Marc Baudry,563274,1001804,2022-06-19
CASH_IN,242115,Agence_mtn_Cotonou,300000,57885,Marc Baudry,1001804,1243919,2022-06-20
CASH_OUT,1168695,Marc Baudry,1243919,75224,Agence_mtn_Ouidah,300000,-868695,2022-06-21
CASH_IN,212594,Agence_mtn_Cotonou,300000,87406,Marc Baudry,75224,287818,2022-06-23
CASH_OUT,136614,Marc Baudry,287818,151204,Agence_mtn_Ouidah,300000,163386,2022-06-23
CASH_IN,284525,Agence_mtn_Ouidah,300000,15475,Marc Baudry,151204,435729,2022-06-23
CASH_IN,37462,Agence_mtn_Abomey,300000,262538,Marc Baudry,435729,473191,2022-06-25
TRANSFER,157277,Aimé Bernier,1173202,1015925,Marc Baudry,473191,630468,2022-06-26
CASH_IN,118446,Agence_mtn_Abomey,300000,181554,Marc Baudry,630468,748914,2022-06-27
CASH_OUT,324679,Marc Baudry,748914,424235,Agence_mtn_Ouidah,300000,-24679,2022-06-27
CASH_IN,13676,Agence_mtn_Abomey,300000,286324,Nicole Huet,128173,141849,2022-06-02
CASH_OUT,116167,Nicole Huet,141849,25682,Agence_mtn_Abomey,300000,183833,2022-06-02
CASH_OUT,5170,Nicole Huet,25682,20512,Agence_mtn_Abomey,300000,294830,2022-06-04
TRANSFER,18959,Nicole Huet,20512,1553,Olivier Benard,153166,134207,2022-06-04
CASH_OUT,1307,Nicole Huet,1553,246,Agence_mtn_Abomey,300000,298693,2022-06-05
CASH_IN,220333,Agence_mtn_Abomey,300000,79667,Nicole Huet,246,220579,2022-06-07
TRANSFER,138934,Nicole Huet,220579,81645,Louis du Boyer,597200,458266,2022-06-08
CASH_IN,201598,Agence_mtn_Abomey,300000,98402,Nicole Huet,81645,283243,2022-06-08
CASH_IN,72182,Agence_mtn_Ouidah,300000,227818,Nicole Huet,283243,355425,2022-06-09
CASH_OUT,45397,Nicole Huet,355425,310028,Agence_mtn_Cotonou,300000,254603,2022-06-10
CASH_OUT,207218,Nicole Huet,310028,102810,Agence_mtn_Ouidah,300000,92782,2022-06-10
CASH_OUT,73324,Nicole Huet,102810,29486,Agence_mtn_Abomey,300000,226676,2022-06-14
TRANSFER,789171,Roger-Roger Delmas,1067400,278229,Nicole Huet,29486,818657,2022-06-14
CASH_IN,72389,Agence_mtn_Cotonou,300000,227611,Nicole Huet,818657,891046,2022-06-15
CASH_OUT,78254,Nicole Huet,891046,812792,Agence_mtn_Abomey,300000,221746,2022-06-16
TRANSFER,336688,Nicole Huet,812792,476104,Astrid Aubert-Thierry,671131,334443,2022-06-16
CASH_OUT,277054,Nicole Huet,476104,199050,Agence_mtn_Abomey,300000,22946,2022-06-17
TRANSFER,114954,Nicole Huet,199050,84096,Simone du Allard,52526,-62428,2022-06-19
TRANSFER,6180,Gilbert Moulin,44118,37938,Nicole Huet,84096,90276,2022-06-22
CASH_OUT,5936,Nicole Huet,90276,84340,Agence_mtn_Cotonou,300000,294064,2022-06-23
CASH_IN,94717,Agence_mtn_Abomey,300000,205283,Nicole Huet,84340,179057,2022-06-23
TRANSFER,5558,Guillaume de la Nguyen,106200,100642,Nicole Huet,179057,184615,2022-06-27
CASH_IN,233791,Agence_mtn_Ouidah,300000,66209,Stéphanie Guichard,1769418,2003209,2022-06-03
CASH_OUT,650247,Stéphanie Guichard,2003209,1352962,Agence_mtn_Abomey,300000,-350247,2022-06-04
TRANSFER,583408,Sylvie Dupré,665640,82232,Stéphanie Guichard,1352962,1936370,2022-06-04
CASH_OUT,540868,Stéphanie Guichard,1936370,1395502,Agence_mtn_Ouidah,300000,-240868,2022-06-04
CASH_OUT,899509,Stéphanie Guichard,1395502,495993,Agence_mtn_Ouidah,300000,-599509,2022-06-05
CASH_IN,296039,Agence_mtn_Ouidah,300000,3961,Stéphanie Guichard,495993,792032,2022-06-06
CASH_IN,274119,Agence_mtn_Abomey,300000,25881,Stéphanie Guichard,792032,1066151,2022-06-06
CASH_IN,42634,Agence_mtn_Abomey,300000,257366,Stéphanie Guichard,1066151,1108785,2022-06-06
CASH_IN,13441,Agence_mtn_Abomey,300000,286559,Stéphanie Guichard,1108785,1122226,2022-06-09
CASH_IN,17333,Agence_mtn_Cotonou,300000,282667,Stéphanie Guichard,1122226,1139559,2022-06-09
CASH_IN,84577,Agence_mtn_Ouidah,300000,215423,Stéphanie Guichard,1139559,1224136,2022-06-10
TRANSFER,769963,Julien Devaux,1366308,596345,Stéphanie Guichard,1224136,1994099,2022-06-10
TRANSFER,13602,Marc Costa-Daniel,107600,93998,Stéphanie Guichard,1994099,2007701,2022-06-10
TRANSFER,263537,Stéphanie Guichard,2007701,1744164,Stéphanie Guichard,2007701,1744164,2022-06-10
CASH_OUT,1022965,Stéphanie Guichard,1744164,721199,Agence_mtn_Abomey,300000,-722965,2022-06-11
CASH_IN,171361,Agence_mtn_Cotonou,300000,128639,Stéphanie Guichard,721199,892560,2022-06-12
TRANSFER,198247,Stéphanie Guichard,892560,694313,Jacques Le Marion,1717000,1518753,2022-06-12
CASH_OUT,323028,Stéphanie Guichard,694313,371285,Agence_mtn_Ouidah,300000,-23028,2022-06-13
CASH_OUT,224253,Stéphanie Guichard,371285,147032,Agence_mtn_Abomey,300000,75747,2022-06-14
TRANSFER,14550,Stéphanie Guichard,147032,132482,Alexandre Delaunay,731100,716550,2022-06-16
CASH_OUT,48545,Stéphanie Guichard,132482,83937,Agence_mtn_Abomey,300000,251455,2022-06-17
CASH_OUT,37981,Stéphanie Guichard,83937,45956,Agence_mtn_Cotonou,300000,262019,2022-06-18
CASH_OUT,23128,Stéphanie Guichard,45956,22828,Agence_mtn_Ouidah,300000,276872,2022-06-19
TRANSFER,381656,François Vaillant,1099685,718029,Stéphanie Guichard,22828,404484,2022-06-19
TRANSFER,254995,Astrid Aubert-Thierry,334443,79448,Stéphanie Guichard,404484,659479,2022-06-22
CASH_OUT,583446,Stéphanie Guichard,659479,76033,Agence_mtn_Cotonou,300000,-283446,2022-06-24
CASH_IN,239016,Agence_mtn_Cotonou,300000,60984,Stéphanie Guichard,76033,315049,2022-06-25
CASH_IN,267924,Agence_mtn_Ouidah,300000,32076,Stéphanie Guichard,315049,582973,2022-06-25
CASH_OUT,139399,Emmanuelle Le Allain,165354,25955,Agence_mtn_Cotonou,300000,160601,2022-06-01
TRANSFER,8494,Emmanuelle Le Allain,25955,17461,Clémence Dufour,771561,763067,2022-06-02
TRANSFER,337,Emmanuelle Le Allain,17461,17124,Honoré de la Prévost,44637,44300,2022-06-03
CASH_IN,200403,Agence_mtn_Ouidah,300000,99597,Emmanuelle Le Allain,17124,217527,2022-06-05
TRANSFER,69795,Roland Huet,93934,24139,Emmanuelle Le Allain,217527,287322,2022-06-06
TRANSFER,43507,Emmanuelle Le Allain,287322,243815,Pénélope Boulay,433000,389493,2022-06-06
TRANSFER,1091920,Marine Labbé,1846600,754680,Emmanuelle Le Allain,243815,1335735,2022-06-07
CASH_IN,47751,Agence_mtn_Ouidah,300000,252249,Emmanuelle Le Allain,1335735,1383486,2022-06-08
CASH_IN,127770,Agence_mtn_Abomey,300000,172230,Emmanuelle Le Allain,1383486,1511256,2022-06-09
TRANSFER,948462,Emmanuelle Le Allain,1511256,562794,Maurice de Brunet,24807,-923655,2022-06-10
TRANSFER,343905,Emmanuelle Le Allain,562794,218889,Christophe Besnard-Diaz,731423,387518,2022-06-10
CASH_IN,44271,Agence_mtn_Cotonou,300000,255729,Emmanuelle Le Allain,218889,263160,2022-06-10
TRANSFER,118537,Julien Devaux,596345,477808,Emmanuelle Le Allain,263160,381697,2022-06-11
CASH_OUT,222587,Emmanuelle Le Allain,381697,159110,Agence_mtn_Cotonou,300000,77413,2022-06-13
CASH_OUT,81333,Emmanuelle Le Allain,159110,77777,Agence_mtn_Abomey,300000,218667,2022-06-16
CASH_OUT,72854,Emmanuelle Le Allain,77777,4923,Agence_mtn_Abomey,300000,227146,2022-06-20
TRANSFER,276319,Emmanuel Vallée,338200,61881,Emmanuelle Le Allain,4923,281242,2022-06-22
CASH_IN,15302,Agence_mtn_Ouidah,300000,284698,Emmanuelle Le Allain,281242,296544,2022-06-22
TRANSFER,160079,Emmanuelle Le Allain,296544,136465,Pénélope Boulay,389493,229414,2022-06-23
CASH_OUT,70365,Emmanuelle Le Allain,136465,66100,Agence_mtn_Abomey,300000,229635,2022-06-24
CASH_OUT,11608,Emmanuelle Le Allain,66100,54492,Agence_mtn_Abomey,300000,288392,2022-06-25
CASH_OUT,40378,Emmanuelle Le Allain,54492,14114,Agence_mtn_Ouidah,300000,259622,2022-06-27
TRANSFER,6714,Emmanuelle Le Allain,14114,7400,Valérie-Claudine Marin,1723900,1717186,2022-06-27
CASH_IN,89371,Agence_mtn_Cotonou,300000,210629,Océane Faure,295800,385171,2022-06-01
CASH_IN,59361,Agence_mtn_Ouidah,300000,240639,Océane Faure,385171,444532,2022-06-02
TRANSFER,906129,Marthe Perrin,1555892,649763,Océane Faure,444532,1350661,2022-06-02
CASH_OUT,1238602,Océane Faure,1350661,112059,Agence_mtn_Abomey,300000,-938602,2022-06-03
CASH_OUT,13665,Océane Faure,112059,98394,Agence_mtn_Abomey,300000,286335,2022-06-04
CASH_OUT,81054,Océane Faure,98394,17340,Agence_mtn_Cotonou,300000,218946,2022-06-06
TRANSFER,14712,Océane Faure,17340,2628,Honoré de la Prévost,44300,29588,2022-06-06
CASH_OUT,1957,Océane Faure,2628,671,Agence_mtn_Cotonou,300000,298043,2022-06-08
TRANSFER,317,Océane Faure,671,354,Honoré de la Prévost,29588,29271,2022-06-09
CASH_OUT,221,Océane Faure,354,133,Agence_mtn_Ouidah,300000,299779,2022-06-10
CASH_IN,266091,Agence_mtn_Abomey,300000,33909,Océane Faure,133,266224,2022-06-11
TRANSFER,23080,Océane Faure,266224,243144,Gabrielle Hamon,94691,71611,2022-06-15
CASH_IN,90973,Agence_mtn_Ouidah,300000,209027,Océane Faure,243144,334117,2022-06-16
CASH_IN,173591,Agence_mtn_Abomey,300000,126409,Océane Faure,334117,507708,2022-06-17
CASH_OUT,457633,Océane Faure,507708,50075,Agence_mtn_Ouidah,300000,-157633,2022-06-18
CASH_IN,223879,Agence_mtn_Abomey,300000,76121,Océane Faure,50075,273954,2022-06-19
CASH_IN,138405,Agence_mtn_Ouidah,300000,161595,Océane Faure,273954,412359,2022-06-20
CASH_OUT,211402,Océane Faure,412359,200957,Agence_mtn_Cotonou,300000,88598,2022-06-20
CASH_OUT,123969,Océane Faure,200957,76988,Agence_mtn_Cotonou,300000,176031,2022-06-20
CASH_OUT,4328,Océane Faure,76988,72660,Agence_mtn_Ouidah,300000,295672,2022-06-21
CASH_OUT,59884,Océane Faure,72660,12776,Agence_mtn_Abomey,300000,240116,2022-06-21
TRANSFER,307735,François Vaillant,718029,410294,Océane Faure,12776,320511,2022-06-22
TRANSFER,64057,Valérie de Pottier,142049,77992,Océane Faure,320511,384568,2022-06-22
CASH_OUT,320641,Océane Faure,384568,63927,Agence_mtn_Abomey,300000,-20641,2022-06-23
CASH_IN,180173,Agence_mtn_Cotonou,300000,119827,Océane Faure,63927,244100,2022-06-24
TRANSFER,1081040,Valérie-Claudine Marin,1717186,636146,Océane Faure,244100,1325140,2022-06-24
CASH_OUT,98081,Océane Faure,1325140,1227059,Agence_mtn_Cotonou,300000,201919,2022-06-24
CASH_OUT,389687,Océane Faure,1227059,837372,Agence_mtn_Cotonou,300000,-89687,2022-06-25
CASH_IN,148994,Agence_mtn_Abomey,300000,151006,Océane Faure,837372,986366,2022-06-25
CASH_IN,185815,Agence_mtn_Ouidah,300000,114185,Honoré de la Prévost,29271,215086,2022-06-03
CASH_OUT,13830,Honoré de la Prévost,215086,201256,Agence_mtn_Abomey,300000,286170,2022-06-04
TRANSFER,527297,Valérie-Claudine Marin,636146,108849,Honoré de la Prévost,201256,728553,2022-06-04
TRANSFER,193084,Honoré de la Prévost,728553,535469,Céline-Inès Meunier,1899100,1706016,2022-06-06
CASH_OUT,448803,Honoré de la Prévost,535469,86666,Agence_mtn_Cotonou,300000,-148803,2022-06-06
CASH_OUT,22637,Honoré de la Prévost,86666,64029,Agence_mtn_Ouidah,300000,277363,2022-06-07
CASH_IN,170442,Agence_mtn_Ouidah,300000,129558,Honoré de la Prévost,64029,234471,2022-06-10
CASH_OUT,178280,Honoré de la Prévost,234471,56191,Agence_mtn_Ouidah,300000,121720,2022-06-11
CASH_OUT,33502,Honoré de la Prévost,56191,22689,Agence_mtn_Abomey,300000,266498,2022-06-11
TRANSFER,1177276,Charles Guérin,1202972,25696,Honoré de la Prévost,22689,1199965,2022-06-13
CASH_OUT,260021,Honoré de la Prévost,1199965,939944,Agence_mtn_Abomey,300000,39979,2022-06-14
CASH_IN,109247,Agence_mtn_Cotonou,300000,190753,Honoré de la Prévost,939944,1049191,2022-06-14
CASH_OUT,928869,Honoré de la Prévost,1049191,120322,Agence_mtn_Ouidah,300000,-628869,2022-06-16
CASH_IN,77629,Agence_mtn_Cotonou,300000,222371,Honoré de la Prévost,120322,197951,2022-06-17
CASH_OUT,167774,Honoré de la Prévost,197951,30177,Agence_mtn_Ouidah,300000,132226,2022-06-17
CASH_IN,2286,Agence_mtn_Abomey,300000,297714,Honoré de la Prévost,30177,32463,2022-06-20
TRANSFER,13401,Honoré de la Prévost,32463,19062,Michèle Faivre,372800,359399,2022-06-22
TRANSFER,434841,Matthieu Cousin,644596,209755,Honoré de la Prévost,19062,453903,2022-06-24
CASH_IN,219767,Agence_mtn_Cotonou,300000,80233,Honoré de la Prévost,453903,673670,2022-06-26
CASH_OUT,666426,Honoré de la Prévost,673670,7244,Agence_mtn_Abomey,300000,-366426,2022-06-27
CASH_IN,73096,Agence_mtn_Ouidah,300000,226904,Honoré de la Prévost,7244,80340,2022-06-27
CASH_IN,171252,Agence_mtn_Ouidah,300000,128748,Jacques Marchand,577757,749009,2022-06-01
TRANSFER,26763,Valérie-Claudine Marin,108849,82086,Jacques Marchand,749009,775772,2022-06-03
CASH_IN,266034,Agence_mtn_Ouidah,300000,33966,Jacques Marchand,775772,1041806,2022-06-05
CASH_OUT,900665,Jacques Marchand,1041806,141141,Agence_mtn_Abomey,300000,-600665,2022-06-05
CASH_IN,146651,Agence_mtn_Cotonou,300000,153349,Jacques Marchand,141141,287792,2022-06-06
TRANSFER,250943,Jacques Marchand,287792,36849,Matthieu Cousin,209755,-41188,2022-06-06
CASH_OUT,7523,Jacques Marchand,36849,29326,Agence_mtn_Cotonou,300000,292477,2022-06-06
TRANSFER,20030,Jacques Marchand,29326,9296,Julie Germain Le Vaillant,1415078,1395048,2022-06-07
TRANSFER,4093,Jacques Marchand,9296,5203,Élisabeth Blot-Bruneau,632200,628107,2022-06-08
TRANSFER,1264,Jacques Marchand,5203,3939,Céline-Inès Meunier,1706016,1704752,2022-06-08
CASH_OUT,2354,Jacques Marchand,3939,1585,Agence_mtn_Abomey,300000,297646,2022-06-09
CASH_IN,74816,Agence_mtn_Ouidah,300000,225184,Jacques Marchand,1585,76401,2022-06-10
TRANSFER,60950,Jacques Marchand,76401,15451,Gabrielle Hamon,71611,10661,2022-06-11
CASH_OUT,1266,Jacques Marchand,15451,14185,Agence_mtn_Abomey,300000,298734,2022-06-13
CASH_OUT,841,Jacques Marchand,14185,13344,Agence_mtn_Ouidah,300000,299159,2022-06-14
CASH_OUT,10389,Jacques Marchand,13344,2955,Agence_mtn_Ouidah,300000,289611,2022-06-14
CASH_OUT,1247,Jacques Marchand,2955,1708,Agence_mtn_Cotonou,300000,298753,2022-06-15
TRANSFER,168518,Raymond de Le Roux,255113,86595,Jacques Marchand,1708,170226,2022-06-16
CASH_OUT,141791,Jacques Marchand,170226,28435,Agence_mtn_Ouidah,300000,158209,2022-06-16
CASH_IN,210347,Agence_mtn_Ouidah,300000,89653,Jacques Marchand,28435,238782,2022-06-17
CASH_OUT,226903,Jacques Marchand,238782,11879,Agence_mtn_Cotonou,300000,73097,2022-06-17
CASH_OUT,1072,Jacques Marchand,11879,10807,Agence_mtn_Abomey,300000,298928,2022-06-18
TRANSFER,3185,Jacques Marchand,10807,7622,Aimé Bernier,1015925,1012740,2022-06-19
TRANSFER,144652,Aimé Bernier,1012740,868088,Jacques Marchand,7622,152274,2022-06-21
CASH_IN,169715,Agence_mtn_Abomey,300000,130285,Jacques Marchand,152274,321989,2022-06-22
CASH_OUT,264001,Jacques Marchand,321989,57988,Agence_mtn_Ouidah,300000,35999,2022-06-22
CASH_IN,17141,Agence_mtn_Cotonou,300000,282859,Jacques Marchand,57988,75129,2022-06-26
CASH_OUT,56389,Jacques Marchand,75129,18740,Agence_mtn_Abomey,300000,243611,2022-06-26
CASH_IN,235031,Agence_mtn_Ouidah,300000,64969,Jacques Marchand,18740,253771,2022-06-27
CASH_IN,8927,Agence_mtn_Abomey,300000,291073,Sophie-Anouk Boulanger,-129154,-120227,2022-06-02
CASH_IN,140682,Agence_mtn_Ouidah,300000,159318,Sophie-Anouk Boulanger,-120227,20455,2022-06-03
CASH_OUT,16550,Sophie-Anouk Boulanger,20455,3905,Agence_mtn_Cotonou,300000,283450,2022-06-05
TRANSFER,13289,Marthe Perrin,649763,636474,Sophie-Anouk Boulanger,3905,17194,2022-06-05
CASH_IN,245192,Agence_mtn_Cotonou,300000,54808,Sophie-Anouk Boulanger,17194,262386,2022-06-06
CASH_OUT,26739,Sophie-Anouk Boulanger,262386,235647,Agence_mtn_Abomey,300000,273261,2022-06-08
CASH_IN,298421,Agence_mtn_Abomey,300000,1579,Sophie-Anouk Boulanger,235647,534068,2022-06-08
TRANSFER,115955,Martin Moreau,127725,11770,Sophie-Anouk Boulanger,534068,650023,2022-06-09
TRANSFER,111036,Sophie-Anouk Boulanger,650023,538987,Marine Labbé,754680,643644,2022-06-09
CASH_OUT,58621,Sophie-Anouk Boulanger,538987,480366,Agence_mtn_Ouidah,300000,241379,2022-06-11
TRANSFER,312079,Véronique Hardy,352632,40553,Sophie-Anouk Boulanger,480366,792445,2022-06-11
CASH_OUT,433690,Sophie-Anouk Boulanger,792445,358755,Agence_mtn_Cotonou,300000,-133690,2022-06-12
TRANSFER,85234,Sophie-Anouk Boulanger,358755,273521,Jacques Le Marion,1518753,1433519,2022-06-15
TRANSFER,58776,Sophie-Anouk Boulanger,273521,214745,Martin Moreau,11770,-47006,2022-06-16
TRANSFER,460585,Marine Labbé,643644,183059,Sophie-Anouk Boulanger,214745,675330,2022-06-18
TRANSFER,1293826,Jacques Le Marion,1433519,139693,Sophie-Anouk Boulanger,675330,1969156,2022-06-19
CASH_IN,4043,Agence_mtn_Ouidah,300000,295957,Sophie-Anouk Boulanger,1969156,1973199,2022-06-19
CASH_IN,168844,Agence_mtn_Ouidah,300000,131156,Sophie-Anouk Boulanger,1973199,2142043,2022-06-21
CASH_IN,111640,Agence_mtn_Abomey,300000,188360,Sophie-Anouk Boulanger,2142043,2253683,2022-06-21
CASH_OUT,198202,Sophie-Anouk Boulanger,2253683,2055481,Agence_mtn_Ouidah,300000,101798,2022-06-22
CASH_IN,274477,Agence_mtn_Cotonou,300000,25523,Sophie-Anouk Boulanger,2055481,2329958,2022-06-23
CASH_IN,76961,Agence_mtn_Ouidah,300000,223039,Sophie-Anouk Boulanger,2329958,2406919,2022-06-25
CASH_IN,57376,Agence_mtn_Cotonou,300000,242624,Sophie-Anouk Boulanger,2406919,2464295,2022-06-25
CASH_IN,15673,Agence_mtn_Ouidah,300000,284327,Sophie-Anouk Boulanger,2464295,2479968,2022-06-26
CASH_OUT,847770,Sophie-Anouk Boulanger,2479968,1632198,Agence_mtn_Ouidah,300000,-547770,2022-06-26
CASH_IN,169543,Agence_mtn_Ouidah,300000,130457,Sophie-Anouk Boulanger,1632198,1801741,2022-06-27
CASH_OUT,1060366,Sophie-Anouk Boulanger,1801741,741375,Agence_mtn_Cotonou,300000,-760366,2022-06-27
CASH_IN,144452,Agence_mtn_Cotonou,300000,155548,Sophie-Anouk Boulanger,741375,885827,2022-06-27
TRANSFER,24304,Marthe Perrin,636474,612170,Christophe Besnard-Diaz,387518,363214,2022-06-02
CASH_OUT,87979,Marthe Perrin,612170,524191,Agence_mtn_Ouidah,300000,212021,2022-06-02
TRANSFER,320013,Élisabeth Delattre,805502,485489,Marthe Perrin,524191,844204,2022-06-05
TRANSFER,461,Nicolas Blin,625,164,Marthe Perrin,844204,844665,2022-06-06
CASH_OUT,264808,Marthe Perrin,844665,579857,Agence_mtn_Ouidah,300000,35192,2022-06-08
CASH_OUT,448919,Marthe Perrin,579857,130938,Agence_mtn_Abomey,300000,-148919,2022-06-11
TRANSFER,57585,Valérie-Claudine Marin,82086,24501,Marthe Perrin,130938,188523,2022-06-11
CASH_OUT,116919,Marthe Perrin,188523,71604,Agence_mtn_Cotonou,300000,183081,2022-06-13
CASH_OUT,52492,Marthe Perrin,71604,19112,Agence_mtn_Ouidah,300000,247508,2022-06-13
CASH_OUT,17410,Marthe Perrin,19112,1702,Agence_mtn_Abomey,300000,282590,2022-06-16
CASH_IN,126255,Agence_mtn_Abomey,300000,173745,Marthe Perrin,1702,127957,2022-06-18
CASH_IN,21088,Agence_mtn_Abomey,300000,278912,Marthe Perrin,127957,149045,2022-06-19
CASH_IN,266255,Agence_mtn_Cotonou,300000,33745,Marthe Perrin,149045,415300,2022-06-20
TRANSFER,405551,Marthe Perrin,415300,9749,Jacques Le Marion,139693,-265858,2022-06-21
TRANSFER,1356,Marthe Perrin,9749,8393,Emmanuel Vallée,61881,60525,2022-06-21
CASH_OUT,2419,Marthe Perrin,8393,5974,Agence_mtn_Abomey,300000,297581,2022-06-22
TRANSFER,4395,Marthe Perrin,5974,1579,Clémence Dufour,763067,758672,2022-06-23
TRANSFER,372216,Guy-Augustin Pinto,1171500,799284,Marthe Perrin,1579,373795,2022-06-24
TRANSFER,53431,Astrid Aubert-Thierry,79448,26017,Marthe Perrin,373795,427226,2022-06-25
CASH_IN,14207,Agence_mtn_Cotonou,300000,285793,Marthe Perrin,427226,441433,2022-06-25
CASH_IN,30290,Agence_mtn_Cotonou,300000,269710,Marthe Perrin,441433,471723,2022-06-27
CASH_IN,85799,Agence_mtn_Abomey,300000,214201,Marthe Perrin,471723,557522,2022-06-27
CASH_IN,157047,Agence_mtn_Abomey,300000,142953,Nathalie Da Silva,1166500,1323547,2022-06-02
TRANSFER,1148609,Nathalie Da Silva,1323547,174938,Olivier Benard,134207,-1014402,2022-06-02
CASH_OUT,15943,Nathalie Da Silva,174938,158995,Agence_mtn_Abomey,300000,284057,2022-06-03
CASH_OUT,56906,Nathalie Da Silva,158995,102089,Agence_mtn_Ouidah,300000,243094,2022-06-04
CASH_IN,202459,Agence_mtn_Abomey,300000,97541,Nathalie Da Silva,102089,304548,2022-06-05
TRANSFER,199987,Nathalie Da Silva,304548,104561,Astrid de Pascal,122656,-77331,2022-06-05
CASH_IN,156619,Agence_mtn_Cotonou,300000,143381,Nathalie Da Silva,104561,261180,2022-06-05
CASH_IN,296990,Agence_mtn_Cotonou,300000,3010,Nathalie Da Silva,261180,558170,2022-06-05
CASH_OUT,106730,Nathalie Da Silva,558170,451440,Agence_mtn_Cotonou,300000,193270,2022-06-05
CASH_OUT,132471,Nathalie Da Silva,451440,318969,Agence_mtn_Ouidah,300000,167529,2022-06-06
TRANSFER,192998,Nicole-Renée Gay,853300,660302,Nathalie Da Silva,318969,511967,2022-06-10
TRANSFER,449901,Nathalie Da Silva,511967,62066,Valérie-Claudine Marin,24501,-425400,2022-06-11
CASH_OUT,18727,Nathalie Da Silva,62066,43339,Agence_mtn_Cotonou,300000,281273,2022-06-12
CASH_IN,173463,Agence_mtn_Ouidah,300000,126537,Nathalie Da Silva,43339,216802,2022-06-13
CASH_OUT,4280,Nathalie Da Silva,216802,212522,Agence_mtn_Ouidah,300000,295720,2022-06-14
CASH_OUT,76601,Nathalie Da Silva,212522,135921,Agence_mtn_Abomey,300000,223399,2022-06-14
TRANSFER,2227,Nathalie Da Silva,135921,133694,Georges Muller,1215800,1213573,2022-06-14
CASH_OUT,73029,Nathalie Da Silva,133694,60665,Agence_mtn_Cotonou,300000,226971,2022-06-15
CASH_OUT,15223,Nathalie Da Silva,60665,45442,Agence_mtn_Cotonou,300000,284777,2022-06-16
TRANSFER,324980,Christophe Teixeira,790000,465020,Nathalie Da Silva,45442,370422,2022-06-17
CASH_IN,161188,Agence_mtn_Abomey,300000,138812,Nathalie Da Silva,370422,531610,2022-06-17
TRANSFER,229390,Nathalie Da Silva,531610,302220,Madeleine Hardy,719900,490510,2022-06-18
CASH_IN,297245,Agence_mtn_Ouidah,300000,2755,Nathalie Da Silva,302220,599465,2022-06-18
CASH_OUT,343172,Nathalie Da Silva,599465,256293,Agence_mtn_Cotonou,300000,-43172,2022-06-19
TRANSFER,250278,Michèle Faivre,359399,109121,Nathalie Da Silva,256293,506571,2022-06-21
TRANSFER,474825,Nathalie Da Silva,506571,31746,Nathalie Da Silva,506571,981396,2022-06-21
TRANSFER,21766,Astrid Aubert-Thierry,26017,4251,Nathalie Da Silva,31746,53512,2022-06-22
TRANSFER,165068,Roger-Roger Delmas,278229,113161,Nathalie Da Silva,53512,218580,2022-06-23
CASH_IN,175580,Agence_mtn_Cotonou,300000,124420,Nathalie Da Silva,218580,394160,2022-06-25
CASH_OUT,274761,Nathalie Da Silva,394160,119399,Agence_mtn_Cotonou,300000,25239,2022-06-27
CASH_IN,126572,Agence_mtn_Ouidah,300000,173428,Julien Devaux,477808,604380,2022-06-01
CASH_IN,112490,Agence_mtn_Abomey,300000,187510,Julien Devaux,604380,716870,2022-06-03
CASH_OUT,516173,Julien Devaux,716870,200697,Agence_mtn_Abomey,300000,-216173,2022-06-05
CASH_IN,194895,Agence_mtn_Cotonou,300000,105105,Julien Devaux,200697,395592,2022-06-05
CASH_IN,235695,Agence_mtn_Ouidah,300000,64305,Julien Devaux,395592,631287,2022-06-05
CASH_IN,143416,Agence_mtn_Abomey,300000,156584,Julien Devaux,631287,774703,2022-06-06
CASH_IN,183898,Agence_mtn_Cotonou,300000,116102,Julien Devaux,774703,958601,2022-06-08
TRANSFER,916608,Georges Muller,1213573,296965,Julien Devaux,958601,1875209,2022-06-10
CASH_OUT,664039,Julien Devaux,1875209,1211170,Agence_mtn_Cotonou,300000,-364039,2022-06-10
TRANSFER,142,Nicolas Blin,164,22,Julien Devaux,1211170,1211312,2022-06-11
TRANSFER,243661,Julien Devaux,1211312,967651,Clémence Dufour,758672,515011,2022-06-12
CASH_OUT,206853,Julien Devaux,967651,760798,Agence_mtn_Cotonou,300000,93147,2022-06-14
CASH_OUT,246829,Julien Devaux,760798,513969,Agence_mtn_Ouidah,300000,53171,2022-06-15
TRANSFER,10235,Aimé Bernier,868088,857853,Julien Devaux,513969,524204,2022-06-16
TRANSFER,146151,Julien Devaux,524204,378053,Élisabeth Delattre,485489,339338,2022-06-17
CASH_OUT,233921,Julien Devaux,378053,144132,Agence_mtn_Abomey,300000,66079,2022-06-18
CASH_OUT,38033,Julien Devaux,144132,106099,Agence_mtn_Ouidah,300000,261967,2022-06-20
CASH_OUT,20935,Julien Devaux,106099,85164,Agence_mtn_Ouidah,300000,279065,2022-06-21
CASH_OUT,55426,Julien Devaux,85164,29738,Agence_mtn_Ouidah,300000,244574,2022-06-21
CASH_IN,139658,Agence_mtn_Abomey,300000,160342,Julien Devaux,29738,169396,2022-06-24
CASH_IN,208708,Agence_mtn_Abomey,300000,91292,Julien Devaux,169396,378104,2022-06-26
CASH_OUT,78543,Julien Devaux,378104,299561,Agence_mtn_Abomey,300000,221457,2022-06-27
TRANSFER,51933,Raymond de Le Roux,86595,34662,Louis du Boyer,458266,510199,2022-06-02
CASH_OUT,497619,Louis du Boyer,510199,12580,Agence_mtn_Abomey,300000,-197619,2022-06-02
CASH_OUT,5556,Louis du Boyer,12580,7024,Agence_mtn_Cotonou,300000,294444,2022-06-02
TRANSFER,688,Louis du Boyer,7024,6336,Madeleine Hardy,490510,489822,2022-06-03
CASH_IN,223041,Agence_mtn_Ouidah,300000,76959,Louis du Boyer,6336,229377,2022-06-03
CASH_IN,250165,Agence_mtn_Cotonou,300000,49835,Louis du Boyer,229377,479542,2022-06-04
CASH_OUT,122830,Louis du Boyer,479542,356712,Agence_mtn_Abomey,300000,177170,2022-06-04
CASH_IN,123172,Agence_mtn_Ouidah,300000,176828,Louis du Boyer,356712,479884,2022-06-06
CASH_OUT,159792,Louis du Boyer,479884,320092,Agence_mtn_Ouidah,300000,140208,2022-06-06
CASH_IN,129292,Agence_mtn_Abomey,300000,170708,Louis du Boyer,320092,449384,2022-06-08
CASH_OUT,429486,Louis du Boyer,449384,19898,Agence_mtn_Abomey,300000,-129486,2022-06-08
CASH_OUT,1143,Louis du Boyer,19898,18755,Agence_mtn_Abomey,300000,298857,2022-06-10
TRANSFER,4681,Louis du Boyer,18755,14074,Pénélope Boulay,229414,224733,2022-06-11
TRANSFER,331846,François Vaillant,410294,78448,Louis du Boyer,14074,345920,2022-06-11
CASH_IN,259972,Agence_mtn_Ouidah,300000,40028,Louis du Boyer,345920,605892,2022-06-13
CASH_OUT,557794,Louis du Boyer,605892,48098,Agence_mtn_Cotonou,300000,-257794,2022-06-13
TRANSFER,47078,Louis du Boyer,48098,1020,Gilbert Moulin,37938,-9140,2022-06-14
CASH_IN,170890,Agence_mtn_Ouidah,300000,129110,Louis du Boyer,1020,171910,2022-06-15
CASH_IN,226735,Agence_mtn_Ouidah,300000,73265,Louis du Boyer,171910,398645,2022-06-16
TRANSFER,815199,Céline-Inès Meunier,1704752,889553,Louis du Boyer,398645,1213844,2022-06-16
CASH_OUT,12138,Louis du Boyer,1213844,1201706,Agence_mtn_Abomey,300000,287862,2022-06-17
CASH_OUT,277254,Louis du Boyer,1201706,924452,Agence_mtn_Cotonou,300000,22746,2022-06-19
CASH_OUT,67350,Louis du Boyer,924452,857102,Agence_mtn_Abomey,300000,232650,2022-06-20
CASH_IN,168041,Agence_mtn_Cotonou,300000,131959,Louis du Boyer,857102,1025143,2022-06-21
TRANSFER,206946,Margaud-Michelle Briand,809500,602554,Louis du Boyer,1025143,1232089,2022-06-22
TRANSFER,7517,Gabrielle Hamon,10661,3144,Louis du Boyer,1232089,1239606,2022-06-22
TRANSFER,694701,Louis du Boyer,1239606,544905,Michelle de la Daniel,1335040,640339,2022-06-23
CASH_OUT,98405,Louis du Boyer,544905,446500,Agence_mtn_Abomey,300000,201595,2022-06-24
CASH_IN,186993,Agence_mtn_Abomey,300000,113007,Louis du Boyer,446500,633493,2022-06-27
CASH_IN,51430,Agence_mtn_Cotonou,300000,248570,Clémence Dufour,515011,566441,2022-06-04
TRANSFER,55389,Clémence Dufour,566441,511052,Alexandre Blanchard,32486,-22903,2022-06-06
CASH_IN,128777,Agence_mtn_Abomey,300000,171223,Clémence Dufour,511052,639829,2022-06-06
CASH_OUT,503783,Clémence Dufour,639829,136046,Agence_mtn_Ouidah,300000,-203783,2022-06-06
CASH_IN,257346,Agence_mtn_Ouidah,300000,42654,Clémence Dufour,136046,393392,2022-06-07
CASH_IN,51143,Agence_mtn_Cotonou,300000,248857,Clémence Dufour,393392,444535,2022-06-07
CASH_OUT,275064,Clémence Dufour,444535,169471,Agence_mtn_Abomey,300000,24936,2022-06-08
TRANSFER,48052,Clémence Dufour,169471,121419,Madeleine Hardy,489822,441770,2022-06-08
CASH_OUT,104177,Clémence Dufour,121419,17242,Agence_mtn_Abomey,300000,195823,2022-06-09
CASH_OUT,2804,Clémence Dufour,17242,14438,Agence_mtn_Cotonou,300000,297196,2022-06-09
CASH_OUT,2640,Clémence Dufour,14438,11798,Agence_mtn_Cotonou,300000,297360,2022-06-09
CASH_OUT,6952,Clémence Dufour,11798,4846,Agence_mtn_Ouidah,300000,293048,2022-06-09
TRANSFER,1447,Clémence Dufour,4846,3399,Marine Labbé,183059,181612,2022-06-09
TRANSFER,576107,Margaud-Michelle Briand,602554,26447,Clémence Dufour,3399,579506,2022-06-10
CASH_IN,213121,Agence_mtn_Ouidah,300000,86879,Clémence Dufour,579506,792627,2022-06-11
CASH_IN,186682,Agence_mtn_Abomey,300000,113318,Clémence Dufour,792627,979309,2022-06-13
CASH_IN,249565,Agence_mtn_Cotonou,300000,50435,Clémence Dufour,979309,1228874,2022-06-15
CASH_IN,114631,Agence_mtn_Cotonou,300000,185369,Clémence Dufour,1228874,1343505,2022-06-16
CASH_IN,18974,Agence_mtn_Ouidah,300000,281026,Clémence Dufour,1343505,1362479,2022-06-17
CASH_OUT,769728,Clémence Dufour,1362479,592751,Agence_mtn_Ouidah,300000,-469728,2022-06-20
CASH_IN,174351,Agence_mtn_Ouidah,300000,125649,Clémence Dufour,592751,767102,2022-06-20
CASH_IN,30603,Agence_mtn_Ouidah,300000,269397,Clémence Dufour,767102,797705,2022-06-20
CASH_OUT,443023,Clémence Dufour,797705,354682,Agence_mtn_Cotonou,300000,-143023,2022-06-23
CASH_OUT,226063,Clémence Dufour,354682,128619,Agence_mtn_Cotonou,300000,73937,2022-06-25
CASH_IN,179583,Agence_mtn_Ouidah,300000,120417,Clémence Dufour,128619,308202,2022-06-27
TRANSFER,711112,Julie Germain Le Vaillant,1395048,683936,Marc Costa-Daniel,93998,-617114,2022-06-01
CASH_OUT,129275,Julie Germain Le Vaillant,683936,554661,Agence_mtn_Ouidah,300000,170725,2022-06-02
CASH_OUT,383712,Julie Germain Le Vaillant,554661,170949,Agence_mtn_Cotonou,300000,-83712,2022-06-03
CASH_OUT,107817,Julie Germain Le Vaillant,170949,63132,Agence_mtn_Ouidah,300000,192183,2022-06-04
TRANSFER,769745,Guy-Augustin Pinto,799284,29539,Julie Germain Le Vaillant,63132,832877,2022-06-05
TRANSFER,898745,Louis de la Imbert,1677900,779155,Julie Germain Le Vaillant,832877,1731622,2022-06-07
TRANSFER,1159300,Julie Germain Le Vaillant,1731622,572322,Gabrielle Hamon,3144,-1156156,2022-06-08
CASH_OUT,218423,Julie Germain Le Vaillant,572322,353899,Agence_mtn_Ouidah,300000,81577,2022-06-08
TRANSFER,224398,Julie Germain Le Vaillant,353899,129501,Céline-Inès Meunier,889553,665155,2022-06-09
CASH_IN,259888,Agence_mtn_Abomey,300000,40112,Julie Germain Le Vaillant,129501,389389,2022-06-11
CASH_IN,62520,Agence_mtn_Ouidah,300000,237480,Julie Germain Le Vaillant,389389,451909,2022-06-12
CASH_IN,276609,Agence_mtn_Cotonou,300000,23391,Julie Germain Le Vaillant,451909,728518,2022-06-14
CASH_IN,72046,Agence_mtn_Cotonou,300000,227954,Julie Germain Le Vaillant,728518,800564,2022-06-14
CASH_IN,102895,Agence_mtn_Cotonou,300000,197105,Julie Germain Le Vaillant,800564,903459,2022-06-15
CASH_IN,71765,Agence_mtn_Ouidah,300000,228235,Julie Germain Le Vaillant,903459,975224,2022-06-16
CASH_OUT,448571,Julie Germain Le Vaillant,975224,526653,Agence_mtn_Cotonou,300000,-148571,2022-06-16
TRANSFER,5162,Julie Germain Le Vaillant,526653,521491,Michelle de la Daniel,640339,635177,2022-06-17
CASH_OUT,162174,Julie Germain Le Vaillant,521491,359317,Agence_mtn_Ouidah,300000,137826,2022-06-17
CASH_IN,191532,Agence_mtn_Cotonou,300000,108468,Julie Germain Le Vaillant,359317,550849,2022-06-18
CASH_IN,222251,Agence_mtn_Abomey,300000,77749,Julie Germain Le Vaillant,550849,773100,2022-06-18
CASH_OUT,273752,Julie Germain Le Vaillant,773100,499348,Agence_mtn_Ouidah,300000,26248,2022-06-20
CASH_OUT,476643,Julie Germain Le Vaillant,499348,22705,Agence_mtn_Ouidah,300000,-176643,2022-06-20
TRANSFER,12358,Julie Germain Le Vaillant,22705,10347,Madeleine Hardy,441770,429412,2022-06-21
CASH_IN,179849,Agence_mtn_Cotonou,300000,120151,Julie Germain Le Vaillant,10347,190196,2022-06-25
CASH_IN,128165,Agence_mtn_Cotonou,300000,171835,Julie Germain Le Vaillant,190196,318361,2022-06-26
TRANSFER,39584,François Vaillant,78448,38864,Julie Germain Le Vaillant,318361,357945,2022-06-27
CASH_IN,83751,Agence_mtn_Ouidah,300000,216249,Julie Germain Le Vaillant,357945,441696,2022-06-27
TRANSFER,2924,Roland Huet,24139,21215,Marcel de la Buisson,974250,977174,2022-06-02
CASH_OUT,343209,Marcel de la Buisson,977174,633965,Agence_mtn_Ouidah,300000,-43209,2022-06-03
CASH_IN,165196,Agence_mtn_Abomey,300000,134804,Marcel de la Buisson,633965,799161,2022-06-04
CASH_OUT,322455,Marcel de la Buisson,799161,476706,Agence_mtn_Ouidah,300000,-22455,2022-06-06
CASH_OUT,178386,Marcel de la Buisson,476706,298320,Agence_mtn_Cotonou,300000,121614,2022-06-06
TRANSFER,224767,Marcel de la Buisson,298320,73553,Louis de la Imbert,779155,554388,2022-06-07
CASH_IN,66504,Agence_mtn_Cotonou,300000,233496,Marcel de la Buisson,73553,140057,2022-06-07
CASH_IN,121876,Agence_mtn_Ouidah,300000,178124,Marcel de la Buisson,140057,261933,2022-06-08
TRANSFER,140093,Marcel de la Buisson,261933,121840,Charles Guérin,25696,-114397,2022-06-08
CASH_OUT,55347,Marcel de la Buisson,121840,66493,Agence_mtn_Abomey,300000,244653,2022-06-10
TRANSFER,5735,Guy-Augustin Pinto,29539,23804,Marcel de la Buisson,66493,72228,2022-06-12
CASH_OUT,5957,Marcel de la Buisson,72228,66271,Agence_mtn_Abomey,300000,294043,2022-06-13
CASH_OUT,315,Marcel de la Buisson,66271,65956,Agence_mtn_Cotonou,300000,299685,2022-06-14
CASH_OUT,7788,Marcel de la Buisson,65956,58168,Agence_mtn_Abomey,300000,292212,2022-06-14
CASH_OUT,765,Marcel de la Buisson,58168,57403,Agence_mtn_Cotonou,300000,299235,2022-06-16
CASH_OUT,8576,Marcel de la Buisson,57403,48827,Agence_mtn_Ouidah,300000,291424,2022-06-17
CASH_IN,293803,Agence_mtn_Cotonou,300000,6197,Marcel de la Buisson,48827,342630,2022-06-19
CASH_IN,99093,Agence_mtn_Cotonou,300000,200907,Marcel de la Buisson,342630,441723,2022-06-19
CASH_OUT,233264,Marcel de la Buisson,441723,208459,Agence_mtn_Abomey,300000,66736,2022-06-20
TRANSFER,11217,Marcel de la Buisson,208459,197242,Raymond de Le Roux,34662,23445,2022-06-20
CASH_OUT,151378,Marcel de la Buisson,197242,45864,Agence_mtn_Abomey,300000,148622,2022-06-21
CASH_IN,139561,Agence_mtn_Abomey,300000,160439,Marcel de la Buisson,45864,185425,2022-06-21
TRANSFER,46147,Marcel de la Buisson,185425,139278,Pénélope Boulay,224733,178586,2022-06-21
TRANSFER,23169,Édouard Grondin du Fleury,84300,61131,Marcel de la Buisson,139278,162447,2022-06-21
TRANSFER,21207,Marcel de la Buisson,162447,141240,Roger-Roger Delmas,113161,91954,2022-06-22
CASH_IN,170528,Agence_mtn_Cotonou,300000,129472,Marcel de la Buisson,141240,311768,2022-06-24
CASH_OUT,99817,Marcel de la Buisson,311768,211951,Agence_mtn_Ouidah,300000,200183,2022-06-27
TRANSFER,45090,Céline-Inès Meunier,665155,620065,Alexandre Delaunay,716550,671460,2022-06-01
CASH_OUT,520334,Céline-Inès Meunier,620065,99731,Agence_mtn_Abomey,300000,-220334,2022-06-01
CASH_IN,254676,Agence_mtn_Cotonou,300000,45324,Céline-Inès Meunier,99731,354407,2022-06-03
CASH_IN,115391,Agence_mtn_Cotonou,300000,184609,Céline-Inès Meunier,354407,469798,2022-06-07
TRANSFER,3734,Astrid Aubert-Thierry,4251,517,Céline-Inès Meunier,469798,473532,2022-06-09
CASH_OUT,277375,Céline-Inès Meunier,473532,196157,Agence_mtn_Ouidah,300000,22625,2022-06-11
CASH_IN,24623,Agence_mtn_Cotonou,300000,275377,Céline-Inès Meunier,196157,220780,2022-06-17
CASH_OUT,207526,Céline-Inès Meunier,220780,13254,Agence_mtn_Ouidah,300000,92474,2022-06-19
TRANSFER,4660,Céline-Inès Meunier,13254,8594,Madeleine Hardy,429412,424752,2022-06-20
TRANSFER,1864,Céline-Inès Meunier,8594,6730,Christophe Teixeira,465020,463156,2022-06-20
TRANSFER,2054,Guillaume de la Nguyen,100642,98588,Céline-Inès Meunier,6730,8784,2022-06-22
CASH_OUT,2987,Céline-Inès Meunier,8784,5797,Agence_mtn_Abomey,300000,297013,2022-06-23
CASH_IN,78232,Agence_mtn_Abomey,300000,221768,Céline-Inès Meunier,5797,84029,2022-06-26
CASH_IN,67322,Agence_mtn_Ouidah,300000,232678,Emmanuel Vallée,60525,127847,2022-06-04
CASH_IN,263753,Agence_mtn_Abomey,300000,36247,Emmanuel Vallée,127847,391600,2022-06-05
CASH_OUT,293903,Emmanuel Vallée,391600,97697,Agence_mtn_Cotonou,300000,6097,2022-06-06
CASH_OUT,81626,Emmanuel Vallée,97697,16071,Agence_mtn_Ouidah,300000,218374,2022-06-06
CASH_IN,122427,Agence_mtn_Ouidah,300000,177573,Emmanuel Vallée,16071,138498,2022-06-08
TRANSFER,844870,Aimé Bernier,857853,12983,Emmanuel Vallée,138498,983368,2022-06-08
CASH_IN,114961,Agence_mtn_Ouidah,300000,185039,Emmanuel Vallée,983368,1098329,2022-06-10
CASH_OUT,412287,Emmanuel Vallée,1098329,686042,Agence_mtn_Cotonou,300000,-112287,2022-06-11
CASH_OUT,280697,Emmanuel Vallée,686042,405345,Agence_mtn_Abomey,300000,19303,2022-06-12
CASH_IN,119951,Agence_mtn_Abomey,300000,180049,Emmanuel Vallée,405345,525296,2022-06-12
TRANSFER,234,Astrid Aubert-Thierry,517,283,Emmanuel Vallée,525296,525530,2022-06-17
CASH_IN,221586,Agence_mtn_Ouidah,300000,78414,Emmanuel Vallée,525530,747116,2022-06-18
TRANSFER,105147,Emmanuel Vallée,747116,641969,Marine Labbé,181612,76465,2022-06-18
CASH_OUT,34323,Emmanuel Vallée,641969,607646,Agence_mtn_Ouidah,300000,265677,2022-06-19
CASH_IN,220719,Agence_mtn_Ouidah,300000,79281,Emmanuel Vallée,607646,828365,2022-06-20
TRANSFER,414125,Emmanuel Vallée,828365,414240,Christophe Teixeira,463156,49031,2022-06-21
CASH_IN,172412,Agence_mtn_Ouidah,300000,127588,Emmanuel Vallée,414240,586652,2022-06-22
CASH_IN,174257,Agence_mtn_Abomey,300000,125743,Emmanuel Vallée,586652,760909,2022-06-23
CASH_OUT,338649,Emmanuel Vallée,760909,422260,Agence_mtn_Cotonou,300000,-38649,2022-06-26
CASH_IN,152374,Agence_mtn_Ouidah,300000,147626,Augustin-Jérôme Merle,-16474,135900,2022-06-03
TRANSFER,95305,Augustin-Jérôme Merle,135900,40595,Raymond de Le Roux,23445,-71860,2022-06-04
CASH_IN,183451,Agence_mtn_Ouidah,300000,116549,Augustin-Jérôme Merle,40595,224046,2022-06-04
CASH_IN,183768,Agence_mtn_Ouidah,300000,116232,Augustin-Jérôme Merle,224046,407814,2022-06-08
CASH_IN,274750,Agence_mtn_Abomey,300000,25250,Augustin-Jérôme Merle,407814,682564,2022-06-10
TRANSFER,55803,Marine Labbé,76465,20662,Augustin-Jérôme Merle,682564,738367,2022-06-12
CASH_OUT,463207,Augustin-Jérôme Merle,738367,275160,Agence_mtn_Ouidah,300000,-163207,2022-06-13
CASH_OUT,30775,Augustin-Jérôme Merle,275160,244385,Agence_mtn_Cotonou,300000,269225,2022-06-14
CASH_IN,210992,Agence_mtn_Abomey,300000,89008,Augustin-Jérôme Merle,244385,455377,2022-06-14
CASH_IN,98415,Agence_mtn_Cotonou,300000,201585,Augustin-Jérôme Merle,455377,553792,2022-06-15
TRANSFER,30744,Valérie de Pottier,77992,47248,Augustin-Jérôme Merle,553792,584536,2022-06-15
CASH_IN,297536,Agence_mtn_Ouidah,300000,2464,Augustin-Jérôme Merle,584536,882072,2022-06-17
CASH_OUT,423817,Augustin-Jérôme Merle,882072,458255,Agence_mtn_Ouidah,300000,-123817,2022-06-17
CASH_IN,83317,Agence_mtn_Ouidah,300000,216683,Augustin-Jérôme Merle,458255,541572,2022-06-20
TRANSFER,399691,Élisabeth Blot-Bruneau,628107,228416,Augustin-Jérôme Merle,541572,941263,2022-06-20
CASH_OUT,443770,Augustin-Jérôme Merle,941263,497493,Agence_mtn_Cotonou,300000,-143770,2022-06-22
CASH_IN,259088,Agence_mtn_Cotonou,300000,40912,Augustin-Jérôme Merle,497493,756581,2022-06-25
CASH_OUT,80606,Augustin-Jérôme Merle,756581,675975,Agence_mtn_Cotonou,300000,219394,2022-06-27
CASH_IN,102597,Agence_mtn_Cotonou,300000,197403,Marc Costa-Daniel,-617114,-514517,2022-06-05
CASH_IN,245817,Agence_mtn_Ouidah,300000,54183,Marc Costa-Daniel,-514517,-268700,2022-06-07
CASH_IN,156499,Agence_mtn_Abomey,300000,143501,Marc Costa-Daniel,-268700,-112201,2022-06-11
CASH_IN,294163,Agence_mtn_Abomey,300000,5837,Marc Costa-Daniel,-112201,181962,2022-06-12
TRANSFER,12746,Marc Costa-Daniel,181962,169216,Sylvie Dupré,82232,69486,2022-06-17
CASH_IN,120329,Agence_mtn_Cotonou,300000,179671,Marc Costa-Daniel,169216,289545,2022-06-17
TRANSFER,37975,Édouard Grondin du Fleury,61131,23156,Marc Costa-Daniel,289545,327520,2022-06-17
CASH_IN,164549,Agence_mtn_Abomey,300000,135451,Marc Costa-Daniel,327520,492069,2022-06-22
CASH_IN,261572,Agence_mtn_Cotonou,300000,38428,Marc Costa-Daniel,492069,753641,2022-06-25
CASH_OUT,174,Astrid Aubert-Thierry,283,109,Agence_mtn_Ouidah,300000,299826,2022-06-01
CASH_IN,137855,Agence_mtn_Ouidah,300000,162145,Astrid Aubert-Thierry,109,137964,2022-06-11
CASH_OUT,75390,Astrid Aubert-Thierry,137964,62574,Agence_mtn_Ouidah,300000,224610,2022-06-12
TRANSFER,52271,Sylvie Dupré,69486,17215,Astrid Aubert-Thierry,62574,114845,2022-06-13
CASH_OUT,47997,Astrid Aubert-Thierry,114845,66848,Agence_mtn_Abomey,300000,252003,2022-06-13
TRANSFER,37381,Astrid Aubert-Thierry,66848,29467,Michelle de la Daniel,635177,597796,2022-06-15
TRANSFER,18734,Astrid Aubert-Thierry,29467,10733,Christophe Teixeira,49031,30297,2022-06-17
CASH_OUT,8779,Astrid Aubert-Thierry,10733,1954,Agence_mtn_Ouidah,300000,291221,2022-06-17
CASH_OUT,1618,Astrid Aubert-Thierry,1954,336,Agence_mtn_Ouidah,300000,298382,2022-06-19
TRANSFER,62387,Michèle Faivre,109121,46734,Astrid Aubert-Thierry,336,62723,2022-06-20
CASH_IN,162317,Agence_mtn_Cotonou,300000,137683,Astrid Aubert-Thierry,62723,225040,2022-06-20
CASH_IN,235890,Agence_mtn_Cotonou,300000,64110,Astrid Aubert-Thierry,225040,460930,2022-06-21
CASH_OUT,194006,Astrid Aubert-Thierry,460930,266924,Agence_mtn_Abomey,300000,105994,2022-06-21
CASH_IN,218755,Agence_mtn_Abomey,300000,81245,Astrid Aubert-Thierry,266924,485679,2022-06-22
CASH_OUT,26881,Astrid Aubert-Thierry,485679,458798,Agence_mtn_Abomey,300000,273119,2022-06-23
TRANSFER,422533,Astrid Aubert-Thierry,458798,36265,Guillaume de la Nguyen,98588,-323945,2022-06-26
CASH_OUT,81325,Louis de la Imbert,554388,473063,Agence_mtn_Cotonou,300000,218675,2022-06-02
CASH_IN,190212,Agence_mtn_Abomey,300000,109788,Louis de la Imbert,473063,663275,2022-06-05
TRANSFER,395345,Madeleine Hardy,424752,29407,Louis de la Imbert,663275,1058620,2022-06-05
CASH_OUT,698923,Louis de la Imbert,1058620,359697,Agence_mtn_Cotonou,300000,-398923,2022-06-05
CASH_OUT,347784,Louis de la Imbert,359697,11913,Agence_mtn_Cotonou,300000,-47784,2022-06-06
TRANSFER,6761,Louis de la Imbert,11913,5152,Margaud-Michelle Briand,26447,19686,2022-06-06
CASH_IN,74766,Agence_mtn_Abomey,300000,225234,Louis de la Imbert,5152,79918,2022-06-07
CASH_IN,127196,Agence_mtn_Cotonou,300000,172804,Louis de la Imbert,79918,207114,2022-06-08
CASH_IN,97872,Agence_mtn_Abomey,300000,202128,Louis de la Imbert,207114,304986,2022-06-08
TRANSFER,566757,Nicole-Renée Gay,660302,93545,Louis de la Imbert,304986,871743,2022-06-09
CASH_OUT,174069,Louis de la Imbert,871743,697674,Agence_mtn_Abomey,300000,125931,2022-06-09
TRANSFER,9941,Roland Huet,21215,11274,Louis de la Imbert,697674,707615,2022-06-13
CASH_OUT,279843,Louis de la Imbert,707615,427772,Agence_mtn_Cotonou,300000,20157,2022-06-15
CASH_OUT,217766,Louis de la Imbert,427772,210006,Agence_mtn_Abomey,300000,82234,2022-06-20
CASH_OUT,197329,Louis de la Imbert,210006,12677,Agence_mtn_Ouidah,300000,102671,2022-06-21
CASH_IN,101390,Agence_mtn_Ouidah,300000,198610,Louis de la Imbert,12677,114067,2022-06-21
CASH_IN,40974,Agence_mtn_Ouidah,300000,259026,Louis de la Imbert,114067,155041,2022-06-22
TRANSFER,128981,Louis de la Imbert,155041,26060,Margaud-Michelle Briand,19686,-109295,2022-06-22
CASH_OUT,24629,Louis de la Imbert,26060,1431,Agence_mtn_Abomey,300000,275371,2022-06-24
CASH_IN,261446,Agence_mtn_Ouidah,300000,38554,Nicolas Blin,22,261468,2022-06-01
TRANSFER,17065,Guy-Augustin Pinto,23804,6739,Nicolas Blin,261468,278533,2022-06-04
CASH_OUT,159032,Nicolas Blin,278533,119501,Agence_mtn_Cotonou,300000,140968,2022-06-14
CASH_IN,296763,Agence_mtn_Abomey,300000,3237,Nicolas Blin,119501,416264,2022-06-17
CASH_OUT,225787,Nicolas Blin,416264,190477,Agence_mtn_Ouidah,300000,74213,2022-06-18
CASH_IN,190606,Agence_mtn_Abomey,300000,109394,Nicolas Blin,190477,381083,2022-06-23
TRANSFER,234552,Nicolas Blin,381083,146531,Édouard Grondin du Fleury,23156,-211396,2022-06-27
CASH_IN,193399,Agence_mtn_Abomey,300000,106601,Margaud-Michelle Briand,-109295,84104,2022-06-06
CASH_IN,207633,Agence_mtn_Cotonou,300000,92367,Margaud-Michelle Briand,84104,291737,2022-06-12
CASH_OUT,176282,Margaud-Michelle Briand,291737,115455,Agence_mtn_Abomey,300000,123718,2022-06-15
CASH_OUT,49225,Margaud-Michelle Briand,115455,66230,Agence_mtn_Abomey,300000,250775,2022-06-16
CASH_IN,13095,Agence_mtn_Cotonou,300000,286905,Margaud-Michelle Briand,66230,79325,2022-06-17
CASH_IN,267262,Agence_mtn_Ouidah,300000,32738,Margaud-Michelle Briand,79325,346587,2022-06-19
CASH_IN,162003,Agence_mtn_Abomey,300000,137997,Margaud-Michelle Briand,346587,508590,2022-06-23
CASH_OUT,234794,Margaud-Michelle Briand,508590,273796,Agence_mtn_Ouidah,300000,65206,2022-06-24
CASH_OUT,31709,Margaud-Michelle Briand,273796,242087,Agence_mtn_Abomey,300000,268291,2022-06-24
CASH_IN,168229,Agence_mtn_Cotonou,300000,131771,Margaud-Michelle Briand,242087,410316,2022-06-24
CASH_IN,244111,Agence_mtn_Abomey,300000,55889,Margaud-Michelle Briand,410316,654427,2022-06-25
CASH_OUT,324369,Alexandre Delaunay,671460,347091,Agence_mtn_Ouidah,300000,-24369,2022-06-02
TRANSFER,106728,Alexandre Delaunay,347091,240363,Alexandre Delaunay,347091,240363,2022-06-03
TRANSFER,60341,Nicole-Renée Gay,93545,33204,Alexandre Delaunay,240363,300704,2022-06-15
TRANSFER,86591,Alexandre Delaunay,300704,214113,Georges Muller,296965,210374,2022-06-18
TRANSFER,1889,Alexandre Delaunay,214113,212224,Christophe Teixeira,30297,28408,2022-06-21
CASH_IN,138596,Agence_mtn_Abomey,300000,161404,Alexandre Delaunay,212224,350820,2022-06-21
CASH_IN,293112,Agence_mtn_Ouidah,300000,6888,Alexandre Delaunay,350820,643932,2022-06-23
CASH_OUT,334265,Michelle de la Daniel,597796,263531,Agence_mtn_Cotonou,300000,-34265,2022-06-08
CASH_IN,135020,Agence_mtn_Abomey,300000,164980,Michelle de la Daniel,263531,398551,2022-06-14
CASH_OUT,289467,Michelle de la Daniel,398551,109084,Agence_mtn_Ouidah,300000,10533,2022-06-16
CASH_OUT,51575,Michelle de la Daniel,109084,57509,Agence_mtn_Ouidah,300000,248425,2022-06-18
CASH_OUT,55698,Michelle de la Daniel,57509,1811,Agence_mtn_Cotonou,300000,244302,2022-06-20
CASH_IN,159930,Agence_mtn_Cotonou,300000,140070,Michelle de la Daniel,1811,161741,2022-06-23
CASH_OUT,88264,Michelle de la Daniel,161741,73477,Agence_mtn_Abomey,300000,211736,2022-06-23
CASH_IN,188199,Agence_mtn_Ouidah,300000,111801,Michelle de la Daniel,73477,261676,2022-06-26
CASH_IN,44903,Agence_mtn_Abomey,300000,255097,Michelle de la Daniel,261676,306579,2022-06-27
TRANSFER,157307,Michelle de la Daniel,306579,149272,Georges Muller,210374,53067,2022-06-27
CASH_IN,259923,Agence_mtn_Ouidah,300000,40077,Michelle de la Daniel,149272,409195,2022-06-27
CASH_OUT,280537,Michelle de la Daniel,409195,128658,Agence_mtn_Ouidah,300000,19463,2022-06-27
CASH_OUT,168179,Pénélope Boulay,178586,10407,Agence_mtn_Abomey,300000,131821,2022-06-01
TRANSFER,2464,Pénélope Boulay,10407,7943,Christophe Besnard-Diaz,363214,360750,2022-06-02
CASH_IN,117564,Agence_mtn_Abomey,300000,182436,Pénélope Boulay,7943,125507,2022-06-02
TRANSFER,19851,Véronique Hardy,40553,20702,Pénélope Boulay,125507,145358,2022-06-03
CASH_OUT,48476,Pénélope Boulay,145358,96882,Agence_mtn_Ouidah,300000,251524,2022-06-03
TRANSFER,12354,Roger-Roger Delmas,91954,79600,Pénélope Boulay,96882,109236,2022-06-04
CASH_IN,124302,Agence_mtn_Cotonou,300000,175698,Pénélope Boulay,109236,233538,2022-06-05
CASH_IN,249626,Agence_mtn_Abomey,300000,50374,Pénélope Boulay,233538,483164,2022-06-08
TRANSFER,216329,Pénélope Boulay,483164,266835,Pénélope Boulay,483164,699493,2022-06-10
TRANSFER,1559,Marine Labbé,20662,19103,Pénélope Boulay,266835,268394,2022-06-13
CASH_IN,171244,Agence_mtn_Abomey,300000,128756,Pénélope Boulay,268394,439638,2022-06-16
TRANSFER,359049,Pénélope Boulay,439638,80589,Georges Muller,53067,-305982,2022-06-19
CASH_IN,243571,Agence_mtn_Abomey,300000,56429,Pénélope Boulay,80589,324160,2022-06-22
CASH_IN,289996,Agence_mtn_Ouidah,300000,10004,Pénélope Boulay,324160,614156,2022-06-22
TRANSFER,4404,Margot Julien,88252,83848,Pénélope Boulay,614156,618560,2022-06-26
CASH_IN,82358,Agence_mtn_Abomey,300000,217642,Georges Muller,-305982,-223624,2022-06-01
CASH_IN,194238,Agence_mtn_Abomey,300000,105762,Georges Muller,-223624,-29386,2022-06-02
CASH_IN,24315,Agence_mtn_Ouidah,300000,275685,Georges Muller,-29386,-5071,2022-06-03
CASH_IN,145404,Agence_mtn_Ouidah,300000,154596,Georges Muller,-5071,140333,2022-06-10
TRANSFER,82813,Georges Muller,140333,57520,Georges Muller,140333,223146,2022-06-11
CASH_IN,268286,Agence_mtn_Ouidah,300000,31714,Georges Muller,57520,325806,2022-06-12
TRANSFER,16198,Nicole-Renée Gay,33204,17006,Georges Muller,325806,342004,2022-06-13
TRANSFER,68468,Roger-Roger Delmas,79600,11132,Georges Muller,342004,410472,2022-06-14
CASH_OUT,270726,Georges Muller,410472,139746,Agence_mtn_Abomey,300000,29274,2022-06-16
CASH_OUT,50120,Georges Muller,139746,89626,Agence_mtn_Cotonou,300000,249880,2022-06-20
CASH_IN,105711,Agence_mtn_Abomey,300000,194289,Georges Muller,89626,195337,2022-06-23
CASH_IN,15399,Agence_mtn_Cotonou,300000,284601,Georges Muller,195337,210736,2022-06-25
CASH_IN,167986,Agence_mtn_Ouidah,300000,132014,Georges Muller,210736,378722,2022-06-25
TRANSFER,35539,Margot Julien,83848,48309,Georges Muller,378722,414261,2022-06-27
CASH_IN,225822,Agence_mtn_Ouidah,300000,74178,Marine Labbé,19103,244925,2022-06-02
CASH_IN,144321,Agence_mtn_Cotonou,300000,155679,Marine Labbé,244925,389246,2022-06-06
CASH_OUT,245738,Marine Labbé,389246,143508,Agence_mtn_Cotonou,300000,54262,2022-06-07
CASH_OUT,61922,Marine Labbé,143508,81586,Agence_mtn_Ouidah,300000,238078,2022-06-09
CASH_IN,284063,Agence_mtn_Abomey,300000,15937,Marine Labbé,81586,365649,2022-06-11
CASH_IN,275299,Agence_mtn_Cotonou,300000,24701,Marine Labbé,365649,640948,2022-06-12
TRANSFER,4683,Véronique Hardy,20702,16019,Marine Labbé,640948,645631,2022-06-18
TRANSFER,15606,Christophe Teixeira,28408,12802,Marine Labbé,645631,661237,2022-06-19
CASH_OUT,402146,Marine Labbé,661237,259091,Agence_mtn_Ouidah,300000,-102146,2022-06-22
CASH_IN,116687,Agence_mtn_Abomey,300000,183313,Marine Labbé,259091,375778,2022-06-23
CASH_OUT,280961,Marine Labbé,375778,94817,Agence_mtn_Abomey,300000,19039,2022-06-23
CASH_IN,154572,Agence_mtn_Abomey,300000,145428,Marine Labbé,94817,249389,2022-06-26
TRANSFER,91133,Marine Labbé,249389,158256,Roger-Roger Delmas,11132,-80001,2022-06-27
CASH_OUT,33239,Élisabeth Blot-Bruneau,228416,195177,Agence_mtn_Ouidah,300000,266761,2022-06-02
TRANSFER,149676,Élisabeth Blot-Bruneau,195177,45501,Madeleine Hardy,29407,-120269,2022-06-09
CASH_IN,278966,Agence_mtn_Cotonou,300000,21034,Élisabeth Blot-Bruneau,45501,324467,2022-06-13
TRANSFER,290059,Élisabeth Blot-Bruneau,324467,34408,Guy-Augustin Pinto,6739,-283320,2022-06-13
TRANSFER,21418,Élisabeth Blot-Bruneau,34408,12990,Aimé Bernier,12983,-8435,2022-06-17
CASH_OUT,8686,Élisabeth Blot-Bruneau,12990,4304,Agence_mtn_Abomey,300000,291314,2022-06-27
CASH_IN,83580,Agence_mtn_Ouidah,300000,216420,Alexandre Blanchard,-22903,60677,2022-06-01
CASH_OUT,17713,Alexandre Blanchard,60677,42964,Agence_mtn_Abomey,300000,282287,2022-06-01
TRANSFER,26155,Alexandre Blanchard,42964,16809,Nicole-Renée Gay,17006,-9149,2022-06-04
CASH_IN,25792,Agence_mtn_Abomey,300000,274208,Alexandre Blanchard,16809,42601,2022-06-04
CASH_OUT,8213,Alexandre Blanchard,42601,34388,Agence_mtn_Abomey,300000,291787,2022-06-05
TRANSFER,8524,Margot Julien,48309,39785,Alexandre Blanchard,34388,42912,2022-06-10
CASH_OUT,10007,Alexandre Blanchard,42912,32905,Agence_mtn_Ouidah,300000,289993,2022-06-12
CASH_IN,29308,Agence_mtn_Abomey,300000,270692,Alexandre Blanchard,32905,62213,2022-06-13
CASH_OUT,40265,Alexandre Blanchard,62213,21948,Agence_mtn_Ouidah,300000,259735,2022-06-16
CASH_OUT,3477,Alexandre Blanchard,21948,18471,Agence_mtn_Abomey,300000,296523,2022-06-16
CASH_IN,113143,Agence_mtn_Cotonou,300000,186857,Alexandre Blanchard,18471,131614,2022-06-16
CASH_OUT,127323,Alexandre Blanchard,131614,4291,Agence_mtn_Ouidah,300000,172677,2022-06-17
CASH_IN,266043,Agence_mtn_Ouidah,300000,33957,Alexandre Blanchard,4291,270334,2022-06-18
CASH_OUT,184293,Alexandre Blanchard,270334,86041,Agence_mtn_Ouidah,300000,115707,2022-06-20
CASH_IN,6614,Agence_mtn_Abomey,300000,293386,Alexandre Blanchard,86041,92655,2022-06-20
CASH_OUT,60745,Alexandre Blanchard,92655,31910,Agence_mtn_Abomey,300000,239255,2022-06-21
TRANSFER,25549,Alexandre Blanchard,31910,6361,Michèle Faivre,46734,21185,2022-06-22
TRANSFER,9844,Roland Huet,11274,1430,Alexandre Blanchard,6361,16205,2022-06-24
TRANSFER,967,Sylvie Dupré,17215,16248,Alexandre Blanchard,16205,17172,2022-06-26
TRANSFER,293061,Christophe Besnard-Diaz,360750,67689,Alexandre Blanchard,17172,310233,2022-06-27
CASH_OUT,38488,Christophe Besnard-Diaz,67689,29201,Agence_mtn_Abomey,300000,261512,2022-06-04
CASH_IN,136926,Agence_mtn_Cotonou,300000,163074,Christophe Besnard-Diaz,29201,166127,2022-06-04
CASH_OUT,56236,Christophe Besnard-Diaz,166127,109891,Agence_mtn_Abomey,300000,243764,2022-06-05
CASH_OUT,67114,Christophe Besnard-Diaz,109891,42777,Agence_mtn_Ouidah,300000,232886,2022-06-05
CASH_OUT,9770,Christophe Besnard-Diaz,42777,33007,Agence_mtn_Abomey,300000,290230,2022-06-06
CASH_IN,241733,Agence_mtn_Cotonou,300000,58267,Christophe Besnard-Diaz,33007,274740,2022-06-06
CASH_IN,148123,Agence_mtn_Abomey,300000,151877,Christophe Besnard-Diaz,274740,422863,2022-06-07
CASH_OUT,208351,Christophe Besnard-Diaz,422863,214512,Agence_mtn_Cotonou,300000,91649,2022-06-10
CASH_IN,183681,Agence_mtn_Ouidah,300000,116319,Christophe Besnard-Diaz,214512,398193,2022-06-17
TRANSFER,15360,Véronique Hardy,16019,659,Christophe Besnard-Diaz,398193,413553,2022-06-17
TRANSFER,380441,Christophe Besnard-Diaz,413553,33112,Christophe Besnard-Diaz,413553,33112,2022-06-17
CASH_IN,92437,Agence_mtn_Ouidah,300000,207563,Christophe Besnard-Diaz,33112,125549,2022-06-18
TRANSFER,27352,Margot Julien,39785,12433,Christophe Besnard-Diaz,125549,152901,2022-06-18
CASH_OUT,18301,Christophe Besnard-Diaz,152901,134600,Agence_mtn_Ouidah,300000,281699,2022-06-22
TRANSFER,227381,Élisabeth Delattre,339338,111957,Christophe Besnard-Diaz,134600,361981,2022-06-22
CASH_IN,232893,Agence_mtn_Abomey,300000,67107,Christophe Besnard-Diaz,361981,594874,2022-06-23
CASH_IN,279774,Agence_mtn_Abomey,300000,20226,Christophe Besnard-Diaz,594874,874648,2022-06-24
CASH_IN,266864,Agence_mtn_Abomey,300000,33136,Christophe Besnard-Diaz,874648,1141512,2022-06-24
CASH_OUT,164383,Christophe Besnard-Diaz,1141512,977129,Agence_mtn_Cotonou,300000,135617,2022-06-27
CASH_IN,2558,Agence_mtn_Ouidah,300000,297442,Guy-Augustin Pinto,-283320,-280762,2022-06-01
CASH_IN,243693,Agence_mtn_Abomey,300000,56307,Guy-Augustin Pinto,-280762,-37069,2022-06-01
CASH_IN,142936,Agence_mtn_Ouidah,300000,157064,Guy-Augustin Pinto,-37069,105867,2022-06-06
CASH_OUT,60947,Guy-Augustin Pinto,105867,44920,Agence_mtn_Abomey,300000,239053,2022-06-16
CASH_OUT,35927,Guy-Augustin Pinto,44920,8993,Agence_mtn_Ouidah,300000,264073,2022-06-25
TRANSFER,217,Véronique Hardy,659,442,Guy-Augustin Pinto,8993,9210,2022-06-26
CASH_IN,175745,Agence_mtn_Ouidah,300000,124255,Martin Moreau,-47006,128739,2022-06-02
CASH_IN,12420,Agence_mtn_Abomey,300000,287580,Martin Moreau,128739,141159,2022-06-06
CASH_OUT,69069,Martin Moreau,141159,72090,Agence_mtn_Cotonou,300000,230931,2022-06-07
TRANSFER,850,Christophe Teixeira,12802,11952,Martin Moreau,72090,72940,2022-06-11
TRANSFER,1323,Martin Moreau,72940,71617,Martin Moreau,72940,74263,2022-06-12
CASH_IN,135992,Agence_mtn_Abomey,300000,164008,Martin Moreau,71617,207609,2022-06-15
CASH_OUT,116192,Martin Moreau,207609,91417,Agence_mtn_Cotonou,300000,183808,2022-06-16
TRANSFER,67388,Martin Moreau,91417,24029,Margot Julien,12433,-54955,2022-06-16
TRANSFER,21258,Martin Moreau,24029,2771,Martin Moreau,24029,45287,2022-06-16
CASH_IN,158807,Agence_mtn_Abomey,300000,141193,Martin Moreau,2771,161578,2022-06-17
TRANSFER,574,Roland Huet,1430,856,Martin Moreau,161578,162152,2022-06-17
CASH_IN,11540,Agence_mtn_Cotonou,300000,288460,Martin Moreau,162152,173692,2022-06-18
CASH_IN,162222,Agence_mtn_Abomey,300000,137778,Martin Moreau,173692,335914,2022-06-20
CASH_IN,166598,Agence_mtn_Abomey,300000,133402,Martin Moreau,335914,502512,2022-06-21
CASH_OUT,74107,Martin Moreau,502512,428405,Agence_mtn_Abomey,300000,225893,2022-06-22
TRANSFER,10347,Christophe Teixeira,11952,1605,Martin Moreau,428405,438752,2022-06-22
TRANSFER,174753,Martin Moreau,438752,263999,Valérie de Pottier,47248,-127505,2022-06-24
TRANSFER,28029,Martin Moreau,263999,235970,Michèle Faivre,21185,-6844,2022-06-26
CASH_OUT,37286,Martin Moreau,235970,198684,Agence_mtn_Ouidah,300000,262714,2022-06-27
CASH_IN,178970,Agence_mtn_Cotonou,300000,121030,Nathalie-Claire De Oliveira,-509530,-330560,2022-06-02
CASH_IN,189608,Agence_mtn_Abomey,300000,110392,Nathalie-Claire De Oliveira,-330560,-140952,2022-06-06
CASH_IN,2906,Agence_mtn_Ouidah,300000,297094,Nathalie-Claire De Oliveira,-140952,-138046,2022-06-06
CASH_IN,77988,Agence_mtn_Cotonou,300000,222012,Nathalie-Claire De Oliveira,-138046,-60058,2022-06-06
CASH_IN,161229,Agence_mtn_Ouidah,300000,138771,Nathalie-Claire De Oliveira,-60058,101171,2022-06-09
CASH_IN,188353,Agence_mtn_Cotonou,300000,111647,Nathalie-Claire De Oliveira,101171,289524,2022-06-12
CASH_IN,229578,Agence_mtn_Abomey,300000,70422,Nathalie-Claire De Oliveira,289524,519102,2022-06-14
CASH_OUT,131707,Nathalie-Claire De Oliveira,519102,387395,Agence_mtn_Abomey,300000,168293,2022-06-16
CASH_OUT,62163,Nathalie-Claire De Oliveira,387395,325232,Agence_mtn_Abomey,300000,237837,2022-06-17
CASH_OUT,141371,Nathalie-Claire De Oliveira,325232,183861,Agence_mtn_Cotonou,300000,158629,2022-06-19
CASH_OUT,11923,Nathalie-Claire De Oliveira,183861,171938,Agence_mtn_Cotonou,300000,288077,2022-06-22
CASH_IN,17758,Agence_mtn_Cotonou,300000,282242,Nathalie-Claire De Oliveira,171938,189696,2022-06-24
CASH_OUT,31241,Nathalie-Claire De Oliveira,189696,158455,Agence_mtn_Cotonou,300000,268759,2022-06-24
CASH_IN,56429,Agence_mtn_Cotonou,300000,243571,Olivier Benard,-1014402,-957973,2022-06-02
CASH_IN,105068,Agence_mtn_Cotonou,300000,194932,Olivier Benard,-957973,-852905,2022-06-03
CASH_IN,206632,Agence_mtn_Ouidah,300000,93368,Olivier Benard,-852905,-646273,2022-06-05
CASH_IN,222796,Agence_mtn_Cotonou,300000,77204,Olivier Benard,-646273,-423477,2022-06-07
CASH_IN,126496,Agence_mtn_Ouidah,300000,173504,Olivier Benard,-423477,-296981,2022-06-07
CASH_IN,288654,Agence_mtn_Cotonou,300000,11346,Olivier Benard,-296981,-8327,2022-06-12
CASH_IN,105907,Agence_mtn_Cotonou,300000,194093,Olivier Benard,-8327,97580,2022-06-16
CASH_IN,284121,Agence_mtn_Ouidah,300000,15879,Olivier Benard,97580,381701,2022-06-22
CASH_IN,154056,Agence_mtn_Abomey,300000,145944,Olivier Benard,381701,535757,2022-06-25
CASH_IN,262274,Agence_mtn_Abomey,300000,37726,Aimé Bernier,-8435,253839,2022-06-03
CASH_IN,120626,Agence_mtn_Abomey,300000,179374,Aimé Bernier,253839,374465,2022-06-08
CASH_OUT,305586,Aimé Bernier,374465,68879,Agence_mtn_Abomey,300000,-5586,2022-06-10
CASH_IN,46608,Agence_mtn_Cotonou,300000,253392,Aimé Bernier,68879,115487,2022-06-17
CASH_IN,223124,Agence_mtn_Abomey,300000,76876,Aimé Bernier,115487,338611,2022-06-19
CASH_IN,85662,Agence_mtn_Cotonou,300000,214338,Aimé Bernier,338611,424273,2022-06-20
CASH_OUT,171928,Aimé Bernier,424273,252345,Agence_mtn_Abomey,300000,128072,2022-06-21
CASH_IN,277135,Agence_mtn_Ouidah,300000,22865,Aimé Bernier,252345,529480,2022-06-27
TRANSFER,183302,Aimé Bernier,529480,346178,Véronique Hardy,442,-182860,2022-06-27
CASH_IN,181575,Agence_mtn_Ouidah,300000,118425,Astrid de Pascal,-77331,104244,2022-06-01
CASH_OUT,101290,Astrid de Pascal,104244,2954,Agence_mtn_Cotonou,300000,198710,2022-06-01
TRANSFER,204,Astrid de Pascal,2954,2750,Roland Huet,856,652,2022-06-02
CASH_IN,289478,Agence_mtn_Cotonou,300000,10522,Astrid de Pascal,2750,292228,2022-06-04
TRANSFER,2653,François Vaillant,38864,36211,Astrid de Pascal,292228,294881,2022-06-07
CASH_OUT,231424,Astrid de Pascal,294881,63457,Agence_mtn_Abomey,300000,68576,2022-06-07
TRANSFER,6818,Élisabeth Delattre,111957,105139,Astrid de Pascal,63457,70275,2022-06-08
CASH_OUT,1691,Astrid de Pascal,70275,68584,Agence_mtn_Ouidah,300000,298309,2022-06-09
TRANSFER,575,Christophe Teixeira,1605,1030,Astrid de Pascal,68584,69159,2022-06-12
CASH_OUT,55729,Astrid de Pascal,69159,13430,Agence_mtn_Abomey,300000,244271,2022-06-13
CASH_OUT,6436,Astrid de Pascal,13430,6994,Agence_mtn_Ouidah,300000,293564,2022-06-14
CASH_IN,202721,Agence_mtn_Ouidah,300000,97279,Astrid de Pascal,6994,209715,2022-06-17
CASH_OUT,191552,Astrid de Pascal,209715,18163,Agence_mtn_Abomey,300000,108448,2022-06-21
TRANSFER,6618,Astrid de Pascal,18163,11545,Astrid de Pascal,18163,24781,2022-06-21
CASH_IN,269805,Agence_mtn_Ouidah,300000,30195,Astrid de Pascal,11545,281350,2022-06-22
TRANSFER,241007,Astrid de Pascal,281350,40343,Roland Huet,652,-240355,2022-06-23
CASH_IN,244407,Agence_mtn_Cotonou,300000,55593,Astrid de Pascal,40343,284750,2022-06-24
TRANSFER,10647,Astrid de Pascal,284750,274103,François Vaillant,36211,25564,2022-06-25
CASH_IN,84115,Agence_mtn_Ouidah,300000,215885,Astrid de Pascal,274103,358218,2022-06-26
TRANSFER,136766,Astrid de Pascal,358218,221452,Christophe Teixeira,1030,-135736,2022-06-27
CASH_IN,37422,Agence_mtn_Abomey,300000,262578,Guillaume de la Nguyen,-323945,-286523,2022-06-05
CASH_IN,125944,Agence_mtn_Abomey,300000,174056,Guillaume de la Nguyen,-286523,-160579,2022-06-13
CASH_IN,179153,Agence_mtn_Abomey,300000,120847,Guillaume de la Nguyen,-160579,18574,2022-06-14
CASH_IN,112250,Agence_mtn_Abomey,300000,187750,Guillaume de la Nguyen,18574,130824,2022-06-14
CASH_IN,178442,Agence_mtn_Abomey,300000,121558,Guillaume de la Nguyen,130824,309266,2022-06-23
TRANSFER,16389,François Vaillant,25564,9175,Guillaume de la Nguyen,309266,325655,2022-06-27
CASH_IN,216537,Agence_mtn_Cotonou,300000,83463,Nicole-Renée Gay,-9149,207388,2022-06-02
TRANSFER,118565,Nicole-Renée Gay,207388,88823,Nicole-Renée Gay,207388,88823,2022-06-06
TRANSFER,77762,Nicole-Renée Gay,88823,11061,Nicole-Renée Gay,88823,11061,2022-06-06
CASH_OUT,1738,Nicole-Renée Gay,11061,9323,Agence_mtn_Cotonou,300000,298262,2022-06-08
CASH_OUT,4062,Nicole-Renée Gay,9323,5261,Agence_mtn_Cotonou,300000,295938,2022-06-12
CASH_IN,141335,Agence_mtn_Ouidah,300000,158665,Nicole-Renée Gay,5261,146596,2022-06-13
TRANSFER,80078,Nicole-Renée Gay,146596,66518,Élisabeth Delattre,105139,25061,2022-06-15
CASH_IN,228897,Agence_mtn_Ouidah,300000,71103,Nicole-Renée Gay,66518,295415,2022-06-17
TRANSFER,1010,Élisabeth Delattre,25061,24051,Nicole-Renée Gay,295415,296425,2022-06-19
CASH_IN,8320,Agence_mtn_Ouidah,300000,291680,Michèle Faivre,-6844,1476,2022-06-01
CASH_OUT,427,Michèle Faivre,1476,1049,Agence_mtn_Ouidah,300000,299573,2022-06-02
CASH_OUT,507,Michèle Faivre,1049,542,Agence_mtn_Cotonou,300000,299493,2022-06-03
CASH_OUT,257,Michèle Faivre,542,285,Agence_mtn_Cotonou,300000,299743,2022-06-04
CASH_OUT,144,Michèle Faivre,285,141,Agence_mtn_Cotonou,300000,299856,2022-06-04
CASH_IN,202561,Agence_mtn_Cotonou,300000,97439,Michèle Faivre,141,202702,2022-06-10
CASH_IN,298957,Agence_mtn_Ouidah,300000,1043,Michèle Faivre,202702,501659,2022-06-10
TRANSFER,132337,Michèle Faivre,501659,369322,Élisabeth Delattre,24051,-108286,2022-06-12
TRANSFER,1400,François Vaillant,9175,7775,Michèle Faivre,369322,370722,2022-06-12
CASH_IN,170763,Agence_mtn_Ouidah,300000,129237,Michèle Faivre,370722,541485,2022-06-13
TRANSFER,199968,Michèle Faivre,541485,341517,Michèle Faivre,541485,741453,2022-06-16
TRANSFER,315835,Michèle Faivre,341517,25682,François Vaillant,7775,-308060,2022-06-17
CASH_OUT,798,Michèle Faivre,25682,24884,Agence_mtn_Ouidah,300000,299202,2022-06-18
CASH_OUT,8233,Michèle Faivre,24884,16651,Agence_mtn_Ouidah,300000,291767,2022-06-20
CASH_IN,178803,Agence_mtn_Abomey,300000,121197,Louise-Aurore Payet,-238506,-59703,2022-06-01
CASH_IN,241872,Agence_mtn_Cotonou,300000,58128,Louise-Aurore Payet,-59703,182169,2022-06-04
TRANSFER,56090,Louise-Aurore Payet,182169,126079,Louise-Aurore Payet,182169,238259,2022-06-07
CASH_IN,60884,Agence_mtn_Cotonou,300000,239116,Louise-Aurore Payet,126079,186963,2022-06-08
CASH_OUT,89484,Louise-Aurore Payet,186963,97479,Agence_mtn_Cotonou,300000,210516,2022-06-08
CASH_OUT,53153,Louise-Aurore Payet,97479,44326,Agence_mtn_Abomey,300000,246847,2022-06-10
CASH_OUT,28901,Louise-Aurore Payet,44326,15425,Agence_mtn_Abomey,300000,271099,2022-06-15
CASH_OUT,6264,Louise-Aurore Payet,15425,9161,Agence_mtn_Cotonou,300000,293736,2022-06-15
CASH_OUT,1142,Louise-Aurore Payet,9161,8019,Agence_mtn_Abomey,300000,298858,2022-06-18
CASH_IN,223193,Agence_mtn_Abomey,300000,76807,Louise-Aurore Payet,8019,231212,2022-06-19
CASH_OUT,85627,Louise-Aurore Payet,231212,145585,Agence_mtn_Cotonou,300000,214373,2022-06-21
CASH_IN,202200,Agence_mtn_Cotonou,300000,97800,Louise-Aurore Payet,145585,347785,2022-06-22
CASH_IN,232719,Agence_mtn_Abomey,300000,67281,Louise-Aurore Payet,347785,580504,2022-06-23
CASH_OUT,39662,Louise-Aurore Payet,580504,540842,Agence_mtn_Ouidah,300000,260338,2022-06-23
CASH_IN,167015,Agence_mtn_Ouidah,300000,132985,Matthieu Cousin,-41188,125827,2022-06-03
CASH_OUT,21250,Matthieu Cousin,125827,104577,Agence_mtn_Cotonou,300000,278750,2022-06-05
CASH_OUT,60672,Matthieu Cousin,104577,43905,Agence_mtn_Cotonou,300000,239328,2022-06-06
CASH_OUT,30881,Matthieu Cousin,43905,13024,Agence_mtn_Abomey,300000,269119,2022-06-12
CASH_IN,123289,Agence_mtn_Ouidah,300000,176711,Matthieu Cousin,13024,136313,2022-06-12
CASH_IN,85467,Agence_mtn_Ouidah,300000,214533,Matthieu Cousin,136313,221780,2022-06-16
CASH_OUT,10011,Matthieu Cousin,221780,211769,Agence_mtn_Ouidah,300000,289989,2022-06-26
CASH_IN,247404,Agence_mtn_Cotonou,300000,52596,Roger-Roger Delmas,-80001,167403,2022-06-02
CASH_IN,249723,Agence_mtn_Abomey,300000,50277,Roger-Roger Delmas,167403,417126,2022-06-04
CASH_IN,42583,Agence_mtn_Abomey,300000,257417,Roger-Roger Delmas,417126,459709,2022-06-07
TRANSFER,326345,Roger-Roger Delmas,459709,133364,Roger-Roger Delmas,459709,133364,2022-06-08
CASH_OUT,103327,Roger-Roger Delmas,133364,30037,Agence_mtn_Ouidah,300000,196673,2022-06-10
TRANSFER,13189,Roger-Roger Delmas,30037,16848,Roger-Roger Delmas,30037,16848,2022-06-11
TRANSFER,4633,Roger-Roger Delmas,16848,12215,Roger-Roger Delmas,16848,12215,2022-06-11
CASH_IN,214328,Agence_mtn_Ouidah,300000,85672,Roger-Roger Delmas,12215,226543,2022-06-11
CASH_OUT,114653,Roger-Roger Delmas,226543,111890,Agence_mtn_Abomey,300000,185347,2022-06-12
CASH_IN,7523,Agence_mtn_Ouidah,300000,292477,Roger-Roger Delmas,111890,119413,2022-06-17
CASH_OUT,11346,Roger-Roger Delmas,119413,108067,Agence_mtn_Abomey,300000,288654,2022-06-18
CASH_IN,11972,Agence_mtn_Ouidah,300000,288028,Roger-Roger Delmas,108067,120039,2022-06-19
CASH_IN,851,Agence_mtn_Ouidah,300000,299149,Roger-Roger Delmas,120039,120890,2022-06-20
CASH_OUT,103613,Roger-Roger Delmas,120890,17277,Agence_mtn_Abomey,300000,196387,2022-06-22
CASH_IN,250595,Agence_mtn_Abomey,300000,49405,Roger-Roger Delmas,17277,267872,2022-06-22
CASH_IN,54246,Agence_mtn_Ouidah,300000,245754,Roger-Roger Delmas,267872,322118,2022-06-24
CASH_IN,22112,Agence_mtn_Ouidah,300000,277888,Josette du Hamon,-58946,-36834,2022-06-01
CASH_IN,58174,Agence_mtn_Abomey,300000,241826,Josette du Hamon,-36834,21340,2022-06-01
CASH_IN,115959,Agence_mtn_Abomey,300000,184041,Josette du Hamon,21340,137299,2022-06-02
TRANSFER,71661,Josette du Hamon,137299,65638,Josette du Hamon,137299,208960,2022-06-02
CASH_IN,211659,Agence_mtn_Ouidah,300000,88341,Josette du Hamon,65638,277297,2022-06-02
CASH_IN,23981,Agence_mtn_Abomey,300000,276019,Josette du Hamon,277297,301278,2022-06-03
CASH_OUT,40358,Josette du Hamon,301278,260920,Agence_mtn_Ouidah,300000,259642,2022-06-05
TRANSFER,169002,Josette du Hamon,260920,91918,Josette du Hamon,260920,91918,2022-06-07
CASH_OUT,66667,Josette du Hamon,91918,25251,Agence_mtn_Cotonou,300000,233333,2022-06-10
CASH_IN,292261,Agence_mtn_Abomey,300000,7739,Josette du Hamon,25251,317512,2022-06-14
CASH_OUT,119387,Josette du Hamon,317512,198125,Agence_mtn_Ouidah,300000,180613,2022-06-15
CASH_IN,277069,Agence_mtn_Cotonou,300000,22931,Josette du Hamon,198125,475194,2022-06-15
TRANSFER,255261,Josette du Hamon,475194,219933,Josette du Hamon,475194,219933,2022-06-17
TRANSFER,192260,Josette du Hamon,219933,27673,Josette du Hamon,219933,27673,2022-06-17
CASH_IN,236448,Agence_mtn_Cotonou,300000,63552,Josette du Hamon,27673,264121,2022-06-18
CASH_IN,139429,Agence_mtn_Ouidah,300000,160571,Josette du Hamon,264121,403550,2022-06-21
CASH_IN,135068,Agence_mtn_Abomey,300000,164932,Josette du Hamon,403550,538618,2022-06-22
CASH_IN,166961,Agence_mtn_Cotonou,300000,133039,Josette du Hamon,538618,705579,2022-06-26
CASH_IN,249802,Agence_mtn_Cotonou,300000,50198,Josette du Hamon,705579,955381,2022-06-27
CASH_IN,45942,Agence_mtn_Abomey,300000,254058,Valérie-Claudine Marin,-425400,-379458,2022-06-05
CASH_IN,295871,Agence_mtn_Cotonou,300000,4129,Valérie-Claudine Marin,-379458,-83587,2022-06-07
CASH_IN,148715,Agence_mtn_Abomey,300000,151285,Valérie-Claudine Marin,-83587,65128,2022-06-10
TRANSFER,41111,Valérie-Claudine Marin,65128,24017,Valérie-Claudine Marin,65128,106239,2022-06-10
CASH_IN,251579,Agence_mtn_Cotonou,300000,48421,Valérie-Claudine Marin,24017,275596,2022-06-17
CASH_OUT,133586,Valérie-Claudine Marin,275596,142010,Agence_mtn_Cotonou,300000,166414,2022-06-19
CASH_OUT,12475,Valérie-Claudine Marin,142010,129535,Agence_mtn_Ouidah,300000,287525,2022-06-19
CASH_IN,59572,Agence_mtn_Abomey,300000,240428,Valérie-Claudine Marin,129535,189107,2022-06-22
CASH_IN,131761,Agence_mtn_Abomey,300000,168239,Valérie-Claudine Marin,189107,320868,2022-06-24
CASH_IN,234764,Agence_mtn_Ouidah,300000,65236,Jacques Le Marion,-265858,-31094,2022-06-01
CASH_IN,52097,Agence_mtn_Abomey,300000,247903,Jacques Le Marion,-31094,21003,2022-06-02
TRANSFER,19321,Jacques Le Marion,21003,1682,Jacques Le Marion,21003,40324,2022-06-03
CASH_IN,263049,Agence_mtn_Abomey,300000,36951,Jacques Le Marion,1682,264731,2022-06-08
TRANSFER,52890,Jacques Le Marion,264731,211841,Jacques Le Marion,264731,211841,2022-06-12
CASH_IN,153073,Agence_mtn_Abomey,300000,146927,Jacques Le Marion,211841,364914,2022-06-12
TRANSFER,142777,Jacques Le Marion,364914,222137,Jacques Le Marion,364914,222137,2022-06-14
TRANSFER,13997,Jacques Le Marion,222137,208140,Jacques Le Marion,222137,236134,2022-06-16
CASH_IN,197093,Agence_mtn_Abomey,300000,102907,Jacques Le Marion,208140,405233,2022-06-21
CASH_OUT,353948,Jacques Le Marion,405233,51285,Agence_mtn_Abomey,300000,-53948,2022-06-22
CASH_OUT,11584,Jacques Le Marion,51285,39701,Agence_mtn_Abomey,300000,288416,2022-06-23
CASH_OUT,12232,Jacques Le Marion,39701,27469,Agence_mtn_Ouidah,300000,287768,2022-06-24
CASH_IN,210858,Agence_mtn_Cotonou,300000,89142,Jacques Le Marion,27469,238327,2022-06-27
CASH_IN,23191,Agence_mtn_Cotonou,300000,276809,Jacques Le Marion,238327,261518,2022-06-27
CASH_IN,294091,Agence_mtn_Cotonou,300000,5909,Raymond de Le Roux,-71860,222231,2022-06-02
CASH_OUT,219329,Raymond de Le Roux,222231,2902,Agence_mtn_Ouidah,300000,80671,2022-06-07
CASH_IN,177033,Agence_mtn_Abomey,300000,122967,Raymond de Le Roux,2902,179935,2022-06-10
CASH_IN,216459,Agence_mtn_Ouidah,300000,83541,Raymond de Le Roux,179935,396394,2022-06-12
CASH_IN,196396,Agence_mtn_Abomey,300000,103604,Hélène Alexandre de la Samson,-316125,-119729,2022-06-02
CASH_IN,235476,Agence_mtn_Abomey,300000,64524,Hélène Alexandre de la Samson,-119729,115747,2022-06-04
TRANSFER,60786,Hélène Alexandre de la Samson,115747,54961,Hélène Alexandre de la Samson,115747,176533,2022-06-07
CASH_IN,94758,Agence_mtn_Ouidah,300000,205242,Hélène Alexandre de la Samson,54961,149719,2022-06-15
TRANSFER,55579,Hélène Alexandre de la Samson,149719,94140,Hélène Alexandre de la Samson,149719,205298,2022-06-16
CASH_IN,254676,Agence_mtn_Ouidah,300000,45324,Hélène Alexandre de la Samson,94140,348816,2022-06-26
CASH_OUT,74699,Hélène Alexandre de la Samson,348816,274117,Agence_mtn_Abomey,300000,225301,2022-06-27
CASH_IN,261959,Agence_mtn_Abomey,300000,38041,Maggie Barbier,-45507,216452,2022-06-02
CASH_OUT,42584,Maggie Barbier,216452,173868,Agence_mtn_Cotonou,300000,257416,2022-06-03
CASH_OUT,59989,Maggie Barbier,173868,113879,Agence_mtn_Abomey,300000,240011,2022-06-05
CASH_OUT,111057,Maggie Barbier,113879,2822,Agence_mtn_Abomey,300000,188943,2022-06-07
TRANSFER,356,Maggie Barbier,2822,2466,Maggie Barbier,2822,3178,2022-06-07
CASH_OUT,394,Maggie Barbier,2466,2072,Agence_mtn_Abomey,300000,299606,2022-06-09
TRANSFER,1893,Maggie Barbier,2072,179,Maggie Barbier,2072,179,2022-06-10
CASH_OUT,141,Maggie Barbier,179,38,Agence_mtn_Cotonou,300000,299859,2022-06-12
CASH_IN,208981,Agence_mtn_Ouidah,300000,91019,Maggie Barbier,38,209019,2022-06-12
CASH_IN,241761,Agence_mtn_Ouidah,300000,58239,Maggie Barbier,209019,450780,2022-06-13
CASH_IN,135710,Agence_mtn_Cotonou,300000,164290,Maggie Barbier,450780,586490,2022-06-13
TRANSFER,18168,Maggie Barbier,586490,568322,Maggie Barbier,586490,568322,2022-06-14
CASH_OUT,390445,Maggie Barbier,568322,177877,Agence_mtn_Cotonou,300000,-90445,2022-06-22
CASH_OUT,164751,Maggie Barbier,177877,13126,Agence_mtn_Cotonou,300000,135249,2022-06-22
CASH_IN,1061,Agence_mtn_Abomey,300000,298939,Charles Guérin,-114397,-113336,2022-06-01
CASH_IN,74721,Agence_mtn_Cotonou,300000,225279,Charles Guérin,-113336,-38615,2022-06-02
CASH_IN,166890,Agence_mtn_Cotonou,300000,133110,Charles Guérin,-38615,128275,2022-06-02
CASH_IN,135901,Agence_mtn_Cotonou,300000,164099,Charles Guérin,128275,264176,2022-06-03
CASH_IN,271317,Agence_mtn_Ouidah,300000,28683,Charles Guérin,264176,535493,2022-06-04
CASH_OUT,479974,Charles Guérin,535493,55519,Agence_mtn_Ouidah,300000,-179974,2022-06-05
CASH_IN,251830,Agence_mtn_Abomey,300000,48170,Charles Guérin,55519,307349,2022-06-06
CASH_OUT,150133,Charles Guérin,307349,157216,Agence_mtn_Abomey,300000,149867,2022-06-11
TRANSFER,25671,Charles Guérin,157216,131545,Charles Guérin,157216,182887,2022-06-11
CASH_IN,33188,Agence_mtn_Ouidah,300000,266812,Charles Guérin,131545,164733,2022-06-12
TRANSFER,28129,Charles Guérin,164733,136604,Charles Guérin,164733,136604,2022-06-15
CASH_OUT,112075,Charles Guérin,136604,24529,Agence_mtn_Abomey,300000,187925,2022-06-16
CASH_IN,136368,Agence_mtn_Cotonou,300000,163632,Charles Guérin,24529,160897,2022-06-19
CASH_IN,11851,Agence_mtn_Abomey,300000,288149,Charles Guérin,160897,172748,2022-06-21
CASH_IN,176938,Agence_mtn_Abomey,300000,123062,Charles Guérin,172748,349686,2022-06-25
CASH_IN,167466,Agence_mtn_Cotonou,300000,132534,Charles Guérin,349686,517152,2022-06-26
CASH_IN,239813,Agence_mtn_Ouidah,300000,60187,Jérôme Laporte Le Gauthier,-35169,204644,2022-06-03
CASH_IN,122519,Agence_mtn_Abomey,300000,177481,Jérôme Laporte Le Gauthier,204644,327163,2022-06-05
TRANSFER,140078,Jérôme Laporte Le Gauthier,327163,187085,Jérôme Laporte Le Gauthier,327163,187085,2022-06-08
TRANSFER,60564,Jérôme Laporte Le Gauthier,187085,126521,Jérôme Laporte Le Gauthier,187085,247649,2022-06-09
CASH_OUT,56867,Jérôme Laporte Le Gauthier,126521,69654,Agence_mtn_Cotonou,300000,243133,2022-06-10
CASH_OUT,26643,Jérôme Laporte Le Gauthier,69654,43011,Agence_mtn_Abomey,300000,273357,2022-06-16
CASH_IN,114726,Agence_mtn_Abomey,300000,185274,Jérôme Laporte Le Gauthier,43011,157737,2022-06-21
CASH_IN,277533,Agence_mtn_Cotonou,300000,22467,Élisabeth Delattre,-108286,169247,2022-06-05
TRANSFER,106873,Élisabeth Delattre,169247,62374,Élisabeth Delattre,169247,62374,2022-06-07
TRANSFER,22844,Élisabeth Delattre,62374,39530,Élisabeth Delattre,62374,39530,2022-06-13
CASH_OUT,27932,Élisabeth Delattre,39530,11598,Agence_mtn_Cotonou,300000,272068,2022-06-14
CASH_IN,168048,Agence_mtn_Cotonou,300000,131952,Élisabeth Delattre,11598,179646,2022-06-14
CASH_IN,249442,Agence_mtn_Cotonou,300000,50558,Élisabeth Delattre,179646,429088,2022-06-19
CASH_IN,122132,Agence_mtn_Ouidah,300000,177868,Élisabeth Delattre,429088,551220,2022-06-23
CASH_IN,119529,Agence_mtn_Ouidah,300000,180471,Élisabeth Delattre,551220,670749,2022-06-24
CASH_OUT,202773,Élisabeth Delattre,670749,467976,Agence_mtn_Cotonou,300000,97227,2022-06-27
CASH_IN,258347,Agence_mtn_Abomey,300000,41653,Élisabeth Delattre,467976,726323,2022-06-27
CASH_IN,49130,Agence_mtn_Cotonou,300000,250870,Simone du Allard,-62428,-13298,2022-06-04
CASH_IN,264745,Agence_mtn_Ouidah,300000,35255,Simone du Allard,-13298,251447,2022-06-07
TRANSFER,111405,Simone du Allard,251447,140042,Simone du Allard,251447,140042,2022-06-08
CASH_IN,162457,Agence_mtn_Cotonou,300000,137543,Simone du Allard,140042,302499,2022-06-14
CASH_OUT,56262,Simone du Allard,302499,246237,Agence_mtn_Ouidah,300000,243738,2022-06-16
TRANSFER,26706,Simone du Allard,246237,219531,Simone du Allard,246237,219531,2022-06-17
CASH_IN,174652,Agence_mtn_Cotonou,300000,125348,Simone du Allard,219531,394183,2022-06-17
CASH_OUT,8572,Simone du Allard,394183,385611,Agence_mtn_Ouidah,300000,291428,2022-06-19
CASH_OUT,30302,Simone du Allard,385611,355309,Agence_mtn_Abomey,300000,269698,2022-06-19
CASH_OUT,167767,Simone du Allard,355309,187542,Agence_mtn_Abomey,300000,132233,2022-06-21
CASH_OUT,158275,Simone du Allard,187542,29267,Agence_mtn_Ouidah,300000,141725,2022-06-24
CASH_IN,44106,Agence_mtn_Cotonou,300000,255894,Gilbert Moulin,-9140,34966,2022-06-11
CASH_OUT,12252,Gilbert Moulin,34966,22714,Agence_mtn_Cotonou,300000,287748,2022-06-11
CASH_OUT,19050,Gilbert Moulin,22714,3664,Agence_mtn_Cotonou,300000,280950,2022-06-13
CASH_IN,156594,Agence_mtn_Ouidah,300000,143406,Gilbert Moulin,3664,160258,2022-06-13
TRANSFER,98218,Gilbert Moulin,160258,62040,Gilbert Moulin,160258,258476,2022-06-16
CASH_IN,131234,Agence_mtn_Abomey,300000,168766,Gilbert Moulin,62040,193274,2022-06-19
CASH_OUT,183653,Gilbert Moulin,193274,9621,Agence_mtn_Abomey,300000,116347,2022-06-20
CASH_IN,73354,Agence_mtn_Abomey,300000,226646,Gilbert Moulin,9621,82975,2022-06-23
CASH_OUT,29866,Gilbert Moulin,82975,53109,Agence_mtn_Ouidah,300000,270134,2022-06-27
CASH_IN,65875,Agence_mtn_Abomey,300000,234125,Roland Huet,-240355,-174480,2022-06-03
CASH_IN,30771,Agence_mtn_Abomey,300000,269229,Roland Huet,-174480,-143709,2022-06-03
CASH_IN,232642,Agence_mtn_Abomey,300000,67358,Roland Huet,-143709,88933,2022-06-04
TRANSFER,30185,Roland Huet,88933,58748,Roland Huet,88933,119118,2022-06-04
CASH_OUT,46500,Roland Huet,58748,12248,Agence_mtn_Abomey,300000,253500,2022-06-15
CASH_IN,117786,Agence_mtn_Ouidah,300000,182214,Roland Huet,12248,130034,2022-06-18
CASH_OUT,11160,Roland Huet,130034,118874,Agence_mtn_Ouidah,300000,288840,2022-06-21
CASH_OUT,36064,Roland Huet,118874,82810,Agence_mtn_Ouidah,300000,263936,2022-06-22
CASH_OUT,2402,Roland Huet,82810,80408,Agence_mtn_Ouidah,300000,297598,2022-06-25
CASH_IN,290953,Agence_mtn_Abomey,300000,9047,Roland Huet,80408,371361,2022-06-25
CASH_IN,267564,Agence_mtn_Ouidah,300000,32436,Véronique Hardy,-182860,84704,2022-06-01
CASH_IN,123280,Agence_mtn_Ouidah,300000,176720,Véronique Hardy,84704,207984,2022-06-04
CASH_IN,180554,Agence_mtn_Ouidah,300000,119446,Véronique Hardy,207984,388538,2022-06-05
CASH_IN,252694,Agence_mtn_Cotonou,300000,47306,Véronique Hardy,388538,641232,2022-06-08
CASH_OUT,532739,Véronique Hardy,641232,108493,Agence_mtn_Cotonou,300000,-232739,2022-06-12
CASH_OUT,46656,Véronique Hardy,108493,61837,Agence_mtn_Ouidah,300000,253344,2022-06-21
CASH_IN,291634,Agence_mtn_Ouidah,300000,8366,Véronique Hardy,61837,353471,2022-06-27
CASH_IN,65611,Agence_mtn_Abomey,300000,234389,Margot Julien,-54955,10656,2022-06-02
TRANSFER,4638,Margot Julien,10656,6018,Margot Julien,10656,15294,2022-06-04
TRANSFER,1641,Margot Julien,6018,4377,Margot Julien,6018,4377,2022-06-05
CASH_OUT,3051,Margot Julien,4377,1326,Agence_mtn_Ouidah,300000,296949,2022-06-13
CASH_IN,96884,Agence_mtn_Ouidah,300000,203116,Margot Julien,1326,98210,2022-06-17
CASH_OUT,19542,Margot Julien,98210,78668,Agence_mtn_Abomey,300000,280458,2022-06-19
CASH_IN,214195,Agence_mtn_Cotonou,300000,85805,Margot Julien,78668,292863,2022-06-21
CASH_IN,145795,Agence_mtn_Cotonou,300000,154205,Édouard Grondin du Fleury,-211396,-65601,2022-06-05
CASH_IN,257080,Agence_mtn_Ouidah,300000,42920,Édouard Grondin du Fleury,-65601,191479,2022-06-07
CASH_OUT,137403,Édouard Grondin du Fleury,191479,54076,Agence_mtn_Abomey,300000,162597,2022-06-12
CASH_IN,13027,Agence_mtn_Cotonou,300000,286973,Édouard Grondin du Fleury,54076,67103,2022-06-12
TRANSFER,33329,Édouard Grondin du Fleury,67103,33774,Édouard Grondin du Fleury,67103,100432,2022-06-13
CASH_IN,197912,Agence_mtn_Cotonou,300000,102088,Édouard Grondin du Fleury,33774,231686,2022-06-15
CASH_OUT,191907,Édouard Grondin du Fleury,231686,39779,Agence_mtn_Cotonou,300000,108093,2022-06-16
CASH_IN,174150,Agence_mtn_Cotonou,300000,125850,Édouard Grondin du Fleury,39779,213929,2022-06-16
CASH_IN,117250,Agence_mtn_Ouidah,300000,182750,Édouard Grondin du Fleury,213929,331179,2022-06-21
CASH_IN,119922,Agence_mtn_Ouidah,300000,180078,Édouard Grondin du Fleury,331179,451101,2022-06-21
CASH_OUT,338962,Édouard Grondin du Fleury,451101,112139,Agence_mtn_Cotonou,300000,-38962,2022-06-22
CASH_IN,53651,Agence_mtn_Abomey,300000,246349,Édouard Grondin du Fleury,112139,165790,2022-06-23
CASH_IN,58653,Agence_mtn_Abomey,300000,241347,Édouard Grondin du Fleury,165790,224443,2022-06-23
CASH_IN,175107,Agence_mtn_Abomey,300000,124893,Gabrielle Hamon,-1156156,-981049,2022-06-02
CASH_IN,28516,Agence_mtn_Ouidah,300000,271484,Gabrielle Hamon,-981049,-952533,2022-06-02
CASH_IN,184450,Agence_mtn_Ouidah,300000,115550,Gabrielle Hamon,-952533,-768083,2022-06-10
CASH_IN,135297,Agence_mtn_Ouidah,300000,164703,Gabrielle Hamon,-768083,-632786,2022-06-10
CASH_IN,110611,Agence_mtn_Cotonou,300000,189389,Gabrielle Hamon,-632786,-522175,2022-06-13
CASH_IN,104789,Agence_mtn_Ouidah,300000,195211,Gabrielle Hamon,-522175,-417386,2022-06-13
CASH_IN,207352,Agence_mtn_Cotonou,300000,92648,Gabrielle Hamon,-417386,-210034,2022-06-16
CASH_IN,228431,Agence_mtn_Ouidah,300000,71569,Gabrielle Hamon,-210034,18397,2022-06-18
CASH_OUT,11754,Gabrielle Hamon,18397,6643,Agence_mtn_Cotonou,300000,288246,2022-06-22
CASH_IN,19097,Agence_mtn_Cotonou,300000,280903,Gabrielle Hamon,6643,25740,2022-06-24
CASH_IN,72395,Agence_mtn_Abomey,300000,227605,Gabrielle Hamon,25740,98135,2022-06-26
CASH_IN,235839,Agence_mtn_Abomey,300000,64161,Valérie de Pottier,-127505,108334,2022-06-03
CASH_OUT,79986,Valérie de Pottier,108334,28348,Agence_mtn_Cotonou,300000,220014,2022-06-09
CASH_OUT,24939,Valérie de Pottier,28348,3409,Agence_mtn_Ouidah,300000,275061,2022-06-09
CASH_IN,212299,Agence_mtn_Cotonou,300000,87701,Valérie de Pottier,3409,215708,2022-06-12
TRANSFER,60301,Valérie de Pottier,215708,155407,Valérie de Pottier,215708,155407,2022-06-13
CASH_OUT,111113,Valérie de Pottier,155407,44294,Agence_mtn_Abomey,300000,188887,2022-06-14
CASH_IN,135832,Agence_mtn_Ouidah,300000,164168,Valérie de Pottier,44294,180126,2022-06-20
CASH_OUT,106430,Valérie de Pottier,180126,73696,Agence_mtn_Abomey,300000,193570,2022-06-24
CASH_IN,170979,Agence_mtn_Abomey,300000,129021,Maurice de Brunet,-923655,-752676,2022-06-05
CASH_IN,223797,Agence_mtn_Ouidah,300000,76203,Maurice de Brunet,-752676,-528879,2022-06-06
CASH_IN,87446,Agence_mtn_Abomey,300000,212554,Maurice de Brunet,-528879,-441433,2022-06-08
CASH_IN,35965,Agence_mtn_Abomey,300000,264035,Maurice de Brunet,-441433,-405468,2022-06-14
CASH_IN,36897,Agence_mtn_Abomey,300000,263103,Maurice de Brunet,-405468,-368571,2022-06-16
CASH_IN,227936,Agence_mtn_Cotonou,300000,72064,Maurice de Brunet,-368571,-140635,2022-06-16
CASH_IN,255604,Agence_mtn_Abomey,300000,44396,Maurice de Brunet,-140635,114969,2022-06-16
CASH_IN,160822,Agence_mtn_Cotonou,300000,139178,Maurice de Brunet,114969,275791,2022-06-19
CASH_OUT,126750,Maurice de Brunet,275791,149041,Agence_mtn_Ouidah,300000,173250,2022-06-20
CASH_OUT,93317,Maurice de Brunet,149041,55724,Agence_mtn_Cotonou,300000,206683,2022-06-27
CASH_IN,143883,Agence_mtn_Ouidah,300000,156117,Maurice de Brunet,55724,199607,2022-06-27
CASH_IN,245708,Agence_mtn_Ouidah,300000,54292,François Vaillant,-308060,-62352,2022-06-01
CASH_IN,142259,Agence_mtn_Abomey,300000,157741,François Vaillant,-62352,79907,2022-06-02
CASH_OUT,19324,François Vaillant,79907,60583,Agence_mtn_Cotonou,300000,280676,2022-06-03
CASH_OUT,51497,François Vaillant,60583,9086,Agence_mtn_Cotonou,300000,248503,2022-06-06
TRANSFER,3393,François Vaillant,9086,5693,François Vaillant,9086,5693,2022-06-08
CASH_OUT,4464,François Vaillant,5693,1229,Agence_mtn_Cotonou,300000,295536,2022-06-10
CASH_IN,224559,Agence_mtn_Cotonou,300000,75441,François Vaillant,1229,225788,2022-06-12
CASH_OUT,121087,François Vaillant,225788,104701,Agence_mtn_Abomey,300000,178913,2022-06-12
CASH_OUT,82236,François Vaillant,104701,22465,Agence_mtn_Ouidah,300000,217764,2022-06-13
CASH_OUT,9922,François Vaillant,22465,12543,Agence_mtn_Abomey,300000,290078,2022-06-13
CASH_OUT,5448,François Vaillant,12543,7095,Agence_mtn_Abomey,300000,294552,2022-06-13
CASH_IN,293346,Agence_mtn_Ouidah,300000,6654,François Vaillant,7095,300441,2022-06-14
CASH_IN,28547,Agence_mtn_Cotonou,300000,271453,François Vaillant,300441,328988,2022-06-16
CASH_OUT,259080,François Vaillant,328988,69908,Agence_mtn_Ouidah,300000,40920,2022-06-23
CASH_IN,221555,Agence_mtn_Ouidah,300000,78445,Christophe Teixeira,-135736,85819,2022-06-01
CASH_IN,156704,Agence_mtn_Ouidah,300000,143296,Christophe Teixeira,85819,242523,2022-06-07
CASH_IN,297160,Agence_mtn_Ouidah,300000,2840,Christophe Teixeira,242523,539683,2022-06-08
CASH_IN,288392,Agence_mtn_Abomey,300000,11608,Christophe Teixeira,539683,828075,2022-06-13
CASH_IN,200607,Agence_mtn_Ouidah,300000,99393,Christophe Teixeira,828075,1028682,2022-06-15
CASH_IN,81575,Agence_mtn_Cotonou,300000,218425,Christophe Teixeira,1028682,1110257,2022-06-15
CASH_IN,227123,Agence_mtn_Cotonou,300000,72877,Christophe Teixeira,1110257,1337380,2022-06-15
CASH_IN,6149,Agence_mtn_Cotonou,300000,293851,Christophe Teixeira,1337380,1343529,2022-06-19
CASH_IN,24592,Agence_mtn_Ouidah,300000,275408,Christophe Teixeira,1343529,1368121,2022-06-19
CASH_OUT,5378,Christophe Teixeira,1368121,1362743,Agence_mtn_Ouidah,300000,294622,2022-06-22
CASH_OUT,382773,Christophe Teixeira,1362743,979970,Agence_mtn_Abomey,300000,-82773,2022-06-23
CASH_IN,156586,Agence_mtn_Abomey,300000,143414,Christophe Teixeira,979970,1136556,2022-06-24
CASH_OUT,40765,Christophe Teixeira,1136556,1095791,Agence_mtn_Ouidah,300000,259235,2022-06-25
CASH_OUT,540688,Christophe Teixeira,1095791,555103,Agence_mtn_Cotonou,300000,-240688,2022-06-26
CASH_OUT,8660,Louise-Aurore Payet,179100,170440,Agence_mtn_Ouidah,300000,291340,2022-07-19
CASH_IN,209324,Agence_mtn_Ouidah,300000,90676,Louise-Aurore Payet,170440,379764,2022-07-27
CASH_IN,51372,Agence_mtn_Ouidah,300000,248628,Augustin-Jérôme Merle,837900,889272,2022-07-11
TRANSFER,270959,Anouk Delahaye-Gimenez,1636700,1365741,Augustin-Jérôme Merle,889272,1160231,2022-07-11
CASH_IN,121489,Agence_mtn_Cotonou,300000,178511,Augustin-Jérôme Merle,1160231,1281720,2022-07-13
CASH_OUT,1087953,Augustin-Jérôme Merle,1281720,193767,Agence_mtn_Abomey,300000,-787953,2022-07-15
TRANSFER,15317,Emmanuel Vallée,1781000,1765683,Augustin-Jérôme Merle,193767,209084,2022-07-25
TRANSFER,1220703,Jean Guilbert-Lenoir,1249000,28297,Honoré Grégoire-Breton,1652200,2872903,2022-07-02
TRANSFER,1650500,Thibault Martin,1828500,178000,Honoré Grégoire-Breton,2872903,4523403,2022-07-08
TRANSFER,938647,Sylvie Dupré,1913300,974653,Honoré Grégoire-Breton,4523403,5462050,2022-07-10
CASH_OUT,2566880,Honoré Grégoire-Breton,5462050,2895170,Agence_mtn_Ouidah,300000,-2266880,2022-07-13
TRANSFER,676440,Marine Chevallier,1281500,605060,Alfred Paris,242300,-434140,2022-07-20
TRANSFER,330127,Marine Chevallier,605060,274933,Nathalie-Claire De Oliveira,1261100,930973,2022-07-23
CASH_OUT,482454,Roland Huet,1635100,1152646,Agence_mtn_Abomey,300000,-182454,2022-07-02
CASH_IN,132395,Agence_mtn_Cotonou,300000,167605,Roland Huet,1152646,1285041,2022-07-11
CASH_OUT,797199,Roland Huet,1285041,487842,Agence_mtn_Ouidah,300000,-497199,2022-07-12
CASH_IN,42371,Agence_mtn_Abomey,300000,257629,Roland Huet,487842,530213,2022-07-22
CASH_IN,280674,Agence_mtn_Abomey,300000,19326,Christine Rossi,978700,1259374,2022-07-09
CASH_OUT,733454,Christine Rossi,1259374,525920,Agence_mtn_Abomey,300000,-433454,2022-07-15
CASH_OUT,26293,Christine Rossi,525920,499627,Agence_mtn_Cotonou,300000,273707,2022-07-24
CASH_IN,36258,Agence_mtn_Cotonou,300000,263742,Georges-Alfred Pruvost,1664100,1700358,2022-07-20
CASH_IN,231373,Agence_mtn_Cotonou,300000,68627,Maryse Delorme,1339900,1571273,2022-07-15
CASH_IN,45022,Agence_mtn_Ouidah,300000,254978,Maryse Delorme,1571273,1616295,2022-07-18
CASH_OUT,1159219,Maryse Delorme,1616295,457076,Agence_mtn_Cotonou,300000,-859219,2022-07-21
CASH_IN,174051,Agence_mtn_Abomey,300000,125949,Maryse Delorme,457076,631127,2022-07-23
CASH_OUT,185362,Maryse Delorme,631127,445765,Agence_mtn_Ouidah,300000,114638,2022-07-24
CASH_OUT,142074,Aurélie Maury,1901100,1759026,Agence_mtn_Ouidah,300000,157926,2022-07-09
CASH_OUT,337430,Aurélie Maury,1759026,1421596,Agence_mtn_Ouidah,300000,-37430,2022-07-10
CASH_OUT,123908,Aurélie Maury,1421596,1297688,Agence_mtn_Abomey,300000,176092,2022-07-16
CASH_OUT,262533,Aurélie Maury,1297688,1035155,Agence_mtn_Abomey,300000,37467,2022-07-20
TRANSFER,305441,Clémence-Alice Ruiz,1844900,1539459,Thérèse-Juliette Camus,1494000,1188559,2022-07-04
TRANSFER,864382,Clémence-Alice Ruiz,1539459,675077,Louis de la Imbert,844000,-20382,2022-07-25
TRANSFER,741051,Nathalie Da Silva,1718600,977549,Clémence-Alice Ruiz,675077,1416128,2022-07-26
CASH_IN,132111,Agence_mtn_Ouidah,300000,167889,Thibault-Julien Chevallier,701500,833611,2022-07-10
TRANSFER,70597,Olivier Benard,86600,16003,Thibault-Julien Chevallier,833611,904208,2022-07-15
CASH_OUT,538139,Thibault-Julien Chevallier,904208,366069,Agence_mtn_Abomey,300000,-238139,2022-07-18
CASH_IN,114221,Agence_mtn_Abomey,300000,185779,Martin Moreau,208000,322221,2022-07-16
CASH_IN,11545,Agence_mtn_Ouidah,300000,288455,Martin Moreau,322221,333766,2022-07-27
TRANSFER,103304,Guy-Augustin Pinto,1867200,1763896,Nathalie Da Silva,977549,874245,2022-07-02
TRANSFER,567749,Alexandre Delaunay,1188800,621051,Guy-Augustin Pinto,1763896,2331645,2022-07-23
TRANSFER,874796,Christophe Besnard-Diaz,1734000,859204,Madeleine Philippe-Grondin,1598800,724004,2022-07-07
CASH_OUT,606549,Christophe Besnard-Diaz,859204,252655,Agence_mtn_Abomey,300000,-306549,2022-07-08
CASH_OUT,42225,Christophe Besnard-Diaz,252655,210430,Agence_mtn_Abomey,300000,257775,2022-07-13
CASH_IN,138976,Agence_mtn_Abomey,300000,161024,Élisabeth Delattre,1848400,1987376,2022-07-01
CASH_OUT,1776824,Élisabeth Delattre,1987376,210552,Agence_mtn_Abomey,300000,-1476824,2022-07-06
TRANSFER,173489,Clémence Dufour,256500,83011,Élisabeth Delattre,210552,384041,2022-07-08
CASH_IN,139671,Agence_mtn_Abomey,300000,160329,Élisabeth Delattre,384041,523712,2022-07-08
CASH_OUT,74480,Élisabeth Delattre,523712,449232,Agence_mtn_Cotonou,300000,225520,2022-07-20
CASH_OUT,44007,Julie Germain Le Vaillant,96100,52093,Agence_mtn_Abomey,300000,255993,2022-07-05
TRANSFER,1607379,Julien Devaux,1826500,219121,Julie Germain Le Vaillant,52093,1659472,2022-07-17
CASH_OUT,321398,Guillaume de la Nguyen,570600,249202,Agence_mtn_Abomey,300000,-21398,2022-07-04
CASH_IN,135610,Agence_mtn_Ouidah,300000,164390,Guillaume de la Nguyen,249202,384812,2022-07-14
CASH_IN,66867,Agence_mtn_Cotonou,300000,233133,Guillaume de la Nguyen,384812,451679,2022-07-16
CASH_OUT,324875,Guillaume de la Nguyen,451679,126804,Agence_mtn_Abomey,300000,-24875,2022-07-20
CASH_IN,169913,Agence_mtn_Cotonou,300000,130087,Jacques Marchand,1619800,1789713,2022-07-23
CASH_IN,279175,Agence_mtn_Cotonou,300000,20825,Thibault Martin,178000,457175,2022-07-03
CASH_OUT,285333,Thibault Martin,457175,171842,Agence_mtn_Ouidah,300000,14667,2022-07-06
CASH_IN,117046,Agence_mtn_Ouidah,300000,182954,Thibault Martin,171842,288888,2022-07-13
CASH_OUT,243838,Thibault Martin,288888,45050,Agence_mtn_Ouidah,300000,56162,2022-07-16
CASH_IN,171808,Agence_mtn_Cotonou,300000,128192,Thibault Martin,45050,216858,2022-07-17
CASH_OUT,238220,Henri de Didier,371200,132980,Agence_mtn_Cotonou,300000,61780,2022-07-26
TRANSFER,1349270,Anouk Delahaye-Gimenez,1365741,16471,Hélène Alexandre de la Samson,614600,1963870,2022-07-13
TRANSFER,1495358,Hélène Alexandre de la Samson,1963870,468512,Élisabeth Blot-Bruneau,1008900,-486458,2022-07-13
CASH_IN,184890,Agence_mtn_Abomey,300000,115110,Hélène Alexandre de la Samson,468512,653402,2022-07-14
TRANSFER,507105,Océane Faure,1237600,730495,Hélène Alexandre de la Samson,653402,1160507,2022-07-22
CASH_OUT,868203,Hélène Alexandre de la Samson,1160507,292304,Agence_mtn_Abomey,300000,-568203,2022-07-26
TRANSFER,260766,Laurent Marion,1617000,1356234,Madeleine Philippe-Grondin,724004,984770,2022-07-19
CASH_IN,121497,Agence_mtn_Ouidah,300000,178503,Madeleine Philippe-Grondin,984770,1106267,2022-07-23
CASH_IN,261702,Agence_mtn_Abomey,300000,38298,Stéphanie Guichard,169600,431302,2022-07-01
CASH_IN,86134,Agence_mtn_Cotonou,300000,213866,Stéphanie Guichard,431302,517436,2022-07-08
CASH_OUT,200858,Stéphanie Guichard,517436,316578,Agence_mtn_Cotonou,300000,99142,2022-07-21
CASH_OUT,163445,Céline-Inès Meunier,239500,76055,Agence_mtn_Abomey,300000,136555,2022-07-22
CASH_OUT,25794,Céline-Inès Meunier,76055,50261,Agence_mtn_Abomey,300000,274206,2022-07-25
CASH_OUT,18495,Jean Guilbert-Lenoir,28297,9802,Agence_mtn_Ouidah,300000,281505,2022-07-01
TRANSFER,625290,Madeleine Hardy,976300,351010,Jean Guilbert-Lenoir,9802,635092,2022-07-01
TRANSFER,463403,Marc Costa-Daniel,1463400,999997,Jean Guilbert-Lenoir,635092,1098495,2022-07-02
CASH_OUT,81873,Jean Guilbert-Lenoir,1098495,1016622,Agence_mtn_Ouidah,300000,218127,2022-07-03
CASH_IN,182314,Agence_mtn_Ouidah,300000,117686,Jean Guilbert-Lenoir,1016622,1198936,2022-07-05
CASH_IN,17489,Agence_mtn_Cotonou,300000,282511,Jean Guilbert-Lenoir,1198936,1216425,2022-07-06
CASH_OUT,884210,Jean Guilbert-Lenoir,1216425,332215,Agence_mtn_Cotonou,300000,-584210,2022-07-07
CASH_OUT,300273,Jean Guilbert-Lenoir,332215,31942,Agence_mtn_Cotonou,300000,-273,2022-07-09
TRANSFER,14714,Jean Guilbert-Lenoir,31942,17228,Michelle de la Daniel,1882100,1867386,2022-07-11
TRANSFER,340335,François Vaillant,696400,356065,Jean Guilbert-Lenoir,17228,357563,2022-07-12
TRANSFER,176216,François Vaillant,356065,179849,Jean Guilbert-Lenoir,357563,533779,2022-07-13
TRANSFER,64455,Emmanuel Legrand,70200,5745,Jean Guilbert-Lenoir,533779,598234,2022-07-14
CASH_IN,109338,Agence_mtn_Abomey,300000,190662,Jean Guilbert-Lenoir,598234,707572,2022-07-14
CASH_OUT,575226,Jean Guilbert-Lenoir,707572,132346,Agence_mtn_Ouidah,300000,-275226,2022-07-15
TRANSFER,94420,Jean Guilbert-Lenoir,132346,37926,Honoré de la Prévost,49700,-44720,2022-07-16
CASH_OUT,7209,Jean Guilbert-Lenoir,37926,30717,Agence_mtn_Ouidah,300000,292791,2022-07-16
CASH_IN,244034,Agence_mtn_Ouidah,300000,55966,Jean Guilbert-Lenoir,30717,274751,2022-07-16
TRANSFER,55680,Jean Guilbert-Lenoir,274751,219071,Jules-Marc Chauvet,533700,478020,2022-07-19
TRANSFER,166654,Jean Guilbert-Lenoir,219071,52417,Élise Monnier,1033200,866546,2022-07-21
TRANSFER,10919,Raymond de Le Roux,425000,414081,Jean Guilbert-Lenoir,52417,63336,2022-07-23
CASH_OUT,33491,Jean Guilbert-Lenoir,63336,29845,Agence_mtn_Ouidah,300000,266509,2022-07-24
CASH_IN,86472,Agence_mtn_Abomey,300000,213528,Jean Guilbert-Lenoir,29845,116317,2022-07-26
CASH_OUT,102579,Jean Guilbert-Lenoir,116317,13738,Agence_mtn_Cotonou,300000,197421,2022-07-26
TRANSFER,207894,Robert Henry-Poulain,400900,193006,Jean Guilbert-Lenoir,13738,221632,2022-07-26
CASH_OUT,77309,Clémence Dufour,83011,5702,Agence_mtn_Ouidah,300000,222691,2022-07-01
TRANSFER,5466,Clémence Dufour,5702,236,Gérard Blot de Blanc,1257200,1251734,2022-07-01
CASH_OUT,105,Clémence Dufour,236,131,Agence_mtn_Abomey,300000,299895,2022-07-03
CASH_OUT,131,Clémence Dufour,131,0,Agence_mtn_Abomey,300000,299869,2022-07-03
CASH_IN,288579,Agence_mtn_Abomey,300000,11421,Clémence Dufour,0,288579,2022-07-04
TRANSFER,265746,Clémence Dufour,288579,22833,Hélène Blanchard-Renault,1783400,1517654,2022-07-04
TRANSFER,866895,Corinne Roussel,1581300,714405,Clémence Dufour,22833,889728,2022-07-04
CASH_IN,266462,Agence_mtn_Abomey,300000,33538,Clémence Dufour,889728,1156190,2022-07-05
CASH_OUT,1055825,Clémence Dufour,1156190,100365,Agence_mtn_Ouidah,300000,-755825,2022-07-05
TRANSFER,37358,Clémence Dufour,100365,63007,Raymond de Le Roux,414081,376723,2022-07-05
TRANSFER,1153377,Valérie-Claudine Marin,1808300,654923,Clémence Dufour,63007,1216384,2022-07-07
TRANSFER,480035,Clémence Dufour,1216384,736349,Charles Guérin,743100,263065,2022-07-10
TRANSFER,60657,Gérard Blot de Blanc,1251734,1191077,Clémence Dufour,736349,797006,2022-07-13
CASH_OUT,139350,Clémence Dufour,797006,657656,Agence_mtn_Abomey,300000,160650,2022-07-14
CASH_IN,62894,Agence_mtn_Cotonou,300000,237106,Clémence Dufour,657656,720550,2022-07-16
TRANSFER,265935,Clémence Dufour,720550,454615,Louis du Boyer,731100,465165,2022-07-17
TRANSFER,230539,Clémence Dufour,454615,224076,Corinne Roussel,714405,483866,2022-07-17
CASH_IN,150840,Agence_mtn_Abomey,300000,149160,Clémence Dufour,224076,374916,2022-07-19
CASH_IN,116566,Agence_mtn_Ouidah,300000,183434,Clémence Dufour,374916,491482,2022-07-20
TRANSFER,410718,Clémence Dufour,491482,80764,Clémence Dufour,491482,902200,2022-07-20
CASH_OUT,50002,Clémence Dufour,80764,30762,Agence_mtn_Cotonou,300000,249998,2022-07-20
CASH_OUT,6551,Clémence Dufour,30762,24211,Agence_mtn_Ouidah,300000,293449,2022-07-21
CASH_OUT,11383,Clémence Dufour,24211,12828,Agence_mtn_Cotonou,300000,288617,2022-07-22
TRANSFER,2406,Clémence Dufour,12828,10422,Louis du Boyer,465165,462759,2022-07-22
TRANSFER,6042,Clémence Dufour,10422,4380,Valérie de Pottier,1706700,1700658,2022-07-23
CASH_IN,27788,Agence_mtn_Abomey,300000,272212,Clémence Dufour,4380,32168,2022-07-23
TRANSFER,832997,Hélène Blanchard-Renault,1517654,684657,Clémence Dufour,32168,865165,2022-07-23
CASH_OUT,337407,Clémence Dufour,865165,527758,Agence_mtn_Ouidah,300000,-37407,2022-07-25
TRANSFER,338036,Raymond de Le Roux,376723,38687,Gérard Cordier,1632100,1294064,2022-07-01
CASH_IN,108102,Agence_mtn_Cotonou,300000,191898,Raymond de Le Roux,38687,146789,2022-07-01
CASH_OUT,23051,Raymond de Le Roux,146789,123738,Agence_mtn_Ouidah,300000,276949,2022-07-01
CASH_IN,106081,Agence_mtn_Abomey,300000,193919,Raymond de Le Roux,123738,229819,2022-07-03
CASH_IN,227196,Agence_mtn_Abomey,300000,72804,Raymond de Le Roux,229819,457015,2022-07-06
TRANSFER,63739,Raymond de Le Roux,457015,393276,Anouk Delahaye-Gimenez,16471,-47268,2022-07-06
TRANSFER,1255052,Gérard Cordier,1294064,39012,Raymond de Le Roux,393276,1648328,2022-07-08
TRANSFER,1091197,Raymond de Le Roux,1648328,557131,Océane Faure,730495,-360702,2022-07-08
CASH_OUT,162938,Raymond de Le Roux,557131,394193,Agence_mtn_Cotonou,300000,137062,2022-07-09
CASH_OUT,321165,Raymond de Le Roux,394193,73028,Agence_mtn_Cotonou,300000,-21165,2022-07-10
CASH_OUT,51462,Raymond de Le Roux,73028,21566,Agence_mtn_Cotonou,300000,248538,2022-07-11
CASH_IN,172479,Agence_mtn_Ouidah,300000,127521,Raymond de Le Roux,21566,194045,2022-07-13
TRANSFER,81638,Raymond de Le Roux,194045,112407,Sophie-Anouk Boulanger,1169700,1088062,2022-07-13
TRANSFER,380860,Louis du Boyer,462759,81899,Raymond de Le Roux,112407,493267,2022-07-16
CASH_IN,204469,Agence_mtn_Cotonou,300000,95531,Raymond de Le Roux,493267,697736,2022-07-16
CASH_OUT,624476,Raymond de Le Roux,697736,73260,Agence_mtn_Ouidah,300000,-324476,2022-07-17
CASH_IN,114362,Agence_mtn_Abomey,300000,185638,Raymond de Le Roux,73260,187622,2022-07-18
TRANSFER,714226,Georges Muller,845800,131574,Raymond de Le Roux,187622,901848,2022-07-18
TRANSFER,448223,Raymond de Le Roux,901848,453625,Louis du Boyer,81899,-366324,2022-07-18
CASH_OUT,335077,Raymond de Le Roux,453625,118548,Agence_mtn_Cotonou,300000,-35077,2022-07-19
CASH_IN,228359,Agence_mtn_Cotonou,300000,71641,Raymond de Le Roux,118548,346907,2022-07-20
CASH_IN,181236,Agence_mtn_Abomey,300000,118764,Raymond de Le Roux,346907,528143,2022-07-20
TRANSFER,692995,Gabrielle Hamon,1411500,718505,Raymond de Le Roux,528143,1221138,2022-07-25
TRANSFER,1119079,Raymond de Le Roux,1221138,102059,Nicole-Renée Gay,1900500,781421,2022-07-26
CASH_OUT,9598,Raymond de Le Roux,102059,92461,Agence_mtn_Cotonou,300000,290402,2022-07-26
CASH_OUT,35625,Raymond de Le Roux,92461,56836,Agence_mtn_Abomey,300000,264375,2022-07-27
TRANSFER,314786,Gérard Blot de Blanc,1191077,876291,Emmanuel Legrand,5745,320531,2022-07-02
CASH_OUT,12469,Emmanuel Legrand,320531,308062,Agence_mtn_Ouidah,300000,287531,2022-07-03
CASH_OUT,214102,Emmanuel Legrand,308062,93960,Agence_mtn_Abomey,300000,85898,2022-07-04
TRANSFER,26093,Emmanuel Legrand,93960,67867,Emmanuel Vallée,1765683,1739590,2022-07-05
CASH_OUT,58809,Emmanuel Legrand,67867,9058,Agence_mtn_Abomey,300000,241191,2022-07-07
TRANSFER,5796,Emmanuel Legrand,9058,3262,Françoise Denis de Allard,106100,100304,2022-07-07
CASH_IN,12635,Agence_mtn_Abomey,300000,287365,Emmanuel Legrand,3262,15897,2022-07-09
CASH_OUT,9274,Emmanuel Legrand,15897,6623,Agence_mtn_Cotonou,300000,290726,2022-07-11
CASH_IN,283932,Agence_mtn_Abomey,300000,16068,Emmanuel Legrand,6623,290555,2022-07-12
TRANSFER,174478,Emmanuel Legrand,290555,116077,Gérard Cordier,39012,-135466,2022-07-12
CASH_IN,250298,Agence_mtn_Cotonou,300000,49702,Emmanuel Legrand,116077,366375,2022-07-13
TRANSFER,298308,Emmanuel Legrand,366375,68067,Charlotte Perrier,198600,-99708,2022-07-14
TRANSFER,51874,Emmanuel Legrand,68067,16193,Julien Devaux,219121,167247,2022-07-14
CASH_IN,139556,Agence_mtn_Ouidah,300000,160444,Emmanuel Legrand,16193,155749,2022-07-14
CASH_IN,34201,Agence_mtn_Ouidah,300000,265799,Emmanuel Legrand,155749,189950,2022-07-14
CASH_IN,219882,Agence_mtn_Cotonou,300000,80118,Emmanuel Legrand,189950,409832,2022-07-16
CASH_IN,67499,Agence_mtn_Abomey,300000,232501,Emmanuel Legrand,409832,477331,2022-07-18
TRANSFER,254885,Emmanuel Legrand,477331,222446,Sébastien Coste,438200,183315,2022-07-18
TRANSFER,97863,Madeleine Hardy,351010,253147,Emmanuel Legrand,222446,320309,2022-07-22
CASH_OUT,269504,Emmanuel Legrand,320309,50805,Agence_mtn_Cotonou,300000,30496,2022-07-23
CASH_IN,152952,Agence_mtn_Abomey,300000,147048,Emmanuel Legrand,50805,203757,2022-07-24
TRANSFER,84322,Emmanuel Legrand,203757,119435,Josette du Hamon,1568200,1483878,2022-07-25
CASH_IN,165886,Agence_mtn_Cotonou,300000,134114,Emmanuel Legrand,119435,285321,2022-07-26
CASH_IN,173868,Agence_mtn_Ouidah,300000,126132,Édouard Grondin du Fleury,1363900,1537768,2022-07-01
TRANSFER,608170,Zacharie Fabre,1283100,674930,Édouard Grondin du Fleury,1537768,2145938,2022-07-02
CASH_IN,63198,Agence_mtn_Cotonou,300000,236802,Édouard Grondin du Fleury,2145938,2209136,2022-07-03
CASH_IN,80576,Agence_mtn_Abomey,300000,219424,Édouard Grondin du Fleury,2209136,2289712,2022-07-03
TRANSFER,219001,Édouard Grondin du Fleury,2289712,2070711,Jacques Laporte de Blanchet,1242100,1023099,2022-07-03
TRANSFER,393202,Jacques Le Marion,1150200,756998,Édouard Grondin du Fleury,2070711,2463913,2022-07-03
CASH_OUT,344219,Édouard Grondin du Fleury,2463913,2119694,Agence_mtn_Cotonou,300000,-44219,2022-07-06
TRANSFER,180431,Édouard Grondin du Fleury,2119694,1939263,Raymond-Yves Boulanger,755200,574769,2022-07-06
CASH_OUT,1746295,Édouard Grondin du Fleury,1939263,192968,Agence_mtn_Ouidah,300000,-1446295,2022-07-07
TRANSFER,84477,Corinne Roussel,483866,399389,Édouard Grondin du Fleury,192968,277445,2022-07-08
TRANSFER,14716,Édouard Grondin du Fleury,277445,262729,Élise Monnier,866546,851830,2022-07-10
CASH_IN,173306,Agence_mtn_Abomey,300000,126694,Édouard Grondin du Fleury,262729,436035,2022-07-11
CASH_OUT,47883,Édouard Grondin du Fleury,436035,388152,Agence_mtn_Ouidah,300000,252117,2022-07-12
TRANSFER,563912,Nathalie-Claire De Oliveira,930973,367061,Édouard Grondin du Fleury,388152,952064,2022-07-12
CASH_IN,261711,Agence_mtn_Ouidah,300000,38289,Édouard Grondin du Fleury,952064,1213775,2022-07-13
CASH_OUT,470641,Édouard Grondin du Fleury,1213775,743134,Agence_mtn_Cotonou,300000,-170641,2022-07-13
CASH_OUT,695545,Édouard Grondin du Fleury,743134,47589,Agence_mtn_Ouidah,300000,-395545,2022-07-13
CASH_OUT,33208,Édouard Grondin du Fleury,47589,14381,Agence_mtn_Abomey,300000,266792,2022-07-14
TRANSFER,462478,Marcel de la Buisson,691800,229322,Édouard Grondin du Fleury,14381,476859,2022-07-14
CASH_IN,298506,Agence_mtn_Ouidah,300000,1494,Édouard Grondin du Fleury,476859,775365,2022-07-16
TRANSFER,1233908,Laurent Marion,1356234,122326,Édouard Grondin du Fleury,775365,2009273,2022-07-17
CASH_IN,144422,Agence_mtn_Ouidah,300000,155578,Édouard Grondin du Fleury,2009273,2153695,2022-07-19
CASH_IN,286933,Agence_mtn_Abomey,300000,13067,Édouard Grondin du Fleury,2153695,2440628,2022-07-19
CASH_IN,114386,Agence_mtn_Ouidah,300000,185614,Édouard Grondin du Fleury,2440628,2555014,2022-07-20
CASH_IN,34915,Agence_mtn_Abomey,300000,265085,Édouard Grondin du Fleury,2555014,2589929,2022-07-20
CASH_OUT,1529849,Édouard Grondin du Fleury,2589929,1060080,Agence_mtn_Cotonou,300000,-1229849,2022-07-20
TRANSFER,1503313,Alexandre Blanchard,1516600,13287,Édouard Grondin du Fleury,1060080,2563393,2022-07-22
CASH_IN,84824,Agence_mtn_Abomey,300000,215176,Édouard Grondin du Fleury,2563393,2648217,2022-07-24
TRANSFER,55551,Madeleine Hardy,253147,197596,Édouard Grondin du Fleury,2648217,2703768,2022-07-26
CASH_OUT,1420220,Édouard Grondin du Fleury,2703768,1283548,Agence_mtn_Abomey,300000,-1120220,2022-07-26
CASH_IN,297278,Agence_mtn_Cotonou,300000,2722,Margaud-Michelle Briand,502300,799578,2022-07-01
TRANSFER,387098,Raymond Simon,416400,29302,Margaud-Michelle Briand,799578,1186676,2022-07-02
TRANSFER,455647,Margaud-Michelle Briand,1186676,731029,Sébastien Coste,183315,-272332,2022-07-04
CASH_OUT,392178,Margaud-Michelle Briand,731029,338851,Agence_mtn_Ouidah,300000,-92178,2022-07-04
CASH_OUT,17305,Margaud-Michelle Briand,338851,321546,Agence_mtn_Cotonou,300000,282695,2022-07-06
CASH_OUT,48042,Margaud-Michelle Briand,321546,273504,Agence_mtn_Cotonou,300000,251958,2022-07-07
CASH_OUT,158082,Margaud-Michelle Briand,273504,115422,Agence_mtn_Cotonou,300000,141918,2022-07-09
CASH_IN,145658,Agence_mtn_Ouidah,300000,154342,Margaud-Michelle Briand,115422,261080,2022-07-10
CASH_OUT,159680,Margaud-Michelle Briand,261080,101400,Agence_mtn_Ouidah,300000,140320,2022-07-11
TRANSFER,17190,Margaud-Michelle Briand,101400,84210,Matthieu Cousin,1629700,1612510,2022-07-11
CASH_OUT,29477,Margaud-Michelle Briand,84210,54733,Agence_mtn_Cotonou,300000,270523,2022-07-12
TRANSFER,46212,Margaud-Michelle Briand,54733,8521,Valérie de Pottier,1700658,1654446,2022-07-12
CASH_IN,206046,Agence_mtn_Cotonou,300000,93954,Margaud-Michelle Briand,8521,214567,2022-07-13
CASH_IN,138516,Agence_mtn_Abomey,300000,161484,Margaud-Michelle Briand,214567,353083,2022-07-13
CASH_IN,75988,Agence_mtn_Cotonou,300000,224012,Margaud-Michelle Briand,353083,429071,2022-07-13
TRANSFER,399012,Gilbert Moulin,443500,44488,Margaud-Michelle Briand,429071,828083,2022-07-15
CASH_OUT,724444,Margaud-Michelle Briand,828083,103639,Agence_mtn_Abomey,300000,-424444,2022-07-17
CASH_IN,144386,Agence_mtn_Ouidah,300000,155614,Margaud-Michelle Briand,103639,248025,2022-07-20
CASH_IN,10526,Agence_mtn_Ouidah,300000,289474,Margaud-Michelle Briand,248025,258551,2022-07-20
CASH_IN,200581,Agence_mtn_Ouidah,300000,99419,Margaud-Michelle Briand,258551,459132,2022-07-21
CASH_IN,105072,Agence_mtn_Cotonou,300000,194928,Margaud-Michelle Briand,459132,564204,2022-07-22
CASH_IN,53856,Agence_mtn_Ouidah,300000,246144,Margaud-Michelle Briand,564204,618060,2022-07-22
TRANSFER,126578,Robert Henry-Poulain,193006,66428,Margaud-Michelle Briand,618060,744638,2022-07-23
CASH_IN,72399,Agence_mtn_Abomey,300000,227601,Margaud-Michelle Briand,744638,817037,2022-07-23
CASH_IN,1405,Agence_mtn_Ouidah,300000,298595,Margaud-Michelle Briand,817037,818442,2022-07-24
TRANSFER,326240,Marine Labbé,550200,223960,Margaud-Michelle Briand,818442,1144682,2022-07-25
CASH_IN,94670,Agence_mtn_Ouidah,300000,205330,Margaud-Michelle Briand,1144682,1239352,2022-07-27
CASH_IN,120435,Agence_mtn_Abomey,300000,179565,Margaud-Michelle Briand,1239352,1359787,2022-07-27
TRANSFER,273901,Marc Costa-Daniel,999997,726096,Nathalie Da Silva,874245,600344,2022-07-01
CASH_IN,187079,Agence_mtn_Cotonou,300000,112921,Marc Costa-Daniel,726096,913175,2022-07-01
TRANSFER,316349,Corinne Roussel,399389,83040,Marc Costa-Daniel,913175,1229524,2022-07-03
TRANSFER,111183,Nathalie-Claire De Oliveira,367061,255878,Marc Costa-Daniel,1229524,1340707,2022-07-07
CASH_OUT,828096,Marc Costa-Daniel,1340707,512611,Agence_mtn_Abomey,300000,-528096,2022-07-07
CASH_OUT,214960,Marc Costa-Daniel,512611,297651,Agence_mtn_Abomey,300000,85040,2022-07-07
CASH_OUT,128727,Marc Costa-Daniel,297651,168924,Agence_mtn_Ouidah,300000,171273,2022-07-08
CASH_OUT,142839,Marc Costa-Daniel,168924,26085,Agence_mtn_Cotonou,300000,157161,2022-07-12
TRANSFER,110921,Laurent Marion,122326,11405,Marc Costa-Daniel,26085,137006,2022-07-16
TRANSFER,88338,Marc Costa-Daniel,137006,48668,Aimé Bernier,371600,283262,2022-07-16
CASH_OUT,953,Marc Costa-Daniel,48668,47715,Agence_mtn_Cotonou,300000,299047,2022-07-16
CASH_OUT,46069,Marc Costa-Daniel,47715,1646,Agence_mtn_Ouidah,300000,253931,2022-07-16
CASH_OUT,1295,Marc Costa-Daniel,1646,351,Agence_mtn_Ouidah,300000,298705,2022-07-17
CASH_IN,41181,Agence_mtn_Abomey,300000,258819,Marc Costa-Daniel,351,41532,2022-07-20
CASH_OUT,27697,Marc Costa-Daniel,41532,13835,Agence_mtn_Abomey,300000,272303,2022-07-23
TRANSFER,993858,Valérie de Pottier,1654446,660588,Marc Costa-Daniel,13835,1007693,2022-07-24
CASH_OUT,494167,Marc Costa-Daniel,1007693,513526,Agence_mtn_Ouidah,300000,-194167,2022-07-25
CASH_IN,23256,Agence_mtn_Cotonou,300000,276744,Marc Costa-Daniel,513526,536782,2022-07-25
CASH_IN,214926,Agence_mtn_Ouidah,300000,85074,Marc Costa-Daniel,536782,751708,2022-07-27
TRANSFER,434410,Maggie Barbier,1606000,1171590,Marc Costa-Daniel,751708,1186118,2022-07-27
CASH_IN,154761,Agence_mtn_Cotonou,300000,145239,Marc Costa-Daniel,1186118,1340879,2022-07-27
CASH_IN,71907,Agence_mtn_Cotonou,300000,228093,Sébastien Coste,-272332,-200425,2022-07-01
CASH_IN,233599,Agence_mtn_Ouidah,300000,66401,Sébastien Coste,-200425,33174,2022-07-01
CASH_IN,196184,Agence_mtn_Ouidah,300000,103816,Sébastien Coste,33174,229358,2022-07-01
TRANSFER,15141,Sébastien Coste,229358,214217,Maurice de Brunet,461500,446359,2022-07-03
TRANSFER,730204,Sophie-Anouk Boulanger,1088062,357858,Sébastien Coste,214217,944421,2022-07-03
CASH_OUT,726844,Sébastien Coste,944421,217577,Agence_mtn_Ouidah,300000,-426844,2022-07-05
CASH_OUT,140062,Sébastien Coste,217577,77515,Agence_mtn_Ouidah,300000,159938,2022-07-05
CASH_IN,145111,Agence_mtn_Abomey,300000,154889,Sébastien Coste,77515,222626,2022-07-06
CASH_IN,237371,Agence_mtn_Abomey,300000,62629,Sébastien Coste,222626,459997,2022-07-08
TRANSFER,407355,Sébastien Coste,459997,52642,Michèle Faivre,1910500,1503145,2022-07-09
TRANSFER,26403,Sébastien Coste,52642,26239,Hélène Blanchard-Renault,684657,658254,2022-07-09
CASH_IN,221161,Agence_mtn_Cotonou,300000,78839,Sébastien Coste,26239,247400,2022-07-10
CASH_IN,244058,Agence_mtn_Abomey,300000,55942,Sébastien Coste,247400,491458,2022-07-12
CASH_OUT,211165,Sébastien Coste,491458,280293,Agence_mtn_Ouidah,300000,88835,2022-07-13
CASH_OUT,277321,Sébastien Coste,280293,2972,Agence_mtn_Abomey,300000,22679,2022-07-14
CASH_IN,284255,Agence_mtn_Ouidah,300000,15745,Sébastien Coste,2972,287227,2022-07-15
TRANSFER,261226,Sébastien Coste,287227,26001,Simone du Allard,1179400,918174,2022-07-16
CASH_IN,103442,Agence_mtn_Cotonou,300000,196558,Sébastien Coste,26001,129443,2022-07-19
TRANSFER,117062,Maggie Barbier,1171590,1054528,Sébastien Coste,129443,246505,2022-07-19
CASH_OUT,181359,Sébastien Coste,246505,65146,Agence_mtn_Ouidah,300000,118641,2022-07-19
CASH_IN,216050,Agence_mtn_Ouidah,300000,83950,Sébastien Coste,65146,281196,2022-07-20
CASH_OUT,3549,Sébastien Coste,281196,277647,Agence_mtn_Ouidah,300000,296451,2022-07-24
CASH_OUT,130129,Sébastien Coste,277647,147518,Agence_mtn_Ouidah,300000,169871,2022-07-25
TRANSFER,1117,Alexandre Blanchard,13287,12170,Sébastien Coste,147518,148635,2022-07-25
CASH_OUT,81749,Sébastien Coste,148635,66886,Agence_mtn_Abomey,300000,218251,2022-07-25
CASH_IN,248455,Agence_mtn_Abomey,300000,51545,Sébastien Coste,66886,315341,2022-07-25
CASH_IN,4904,Agence_mtn_Cotonou,300000,295096,Sébastien Coste,315341,320245,2022-07-27
TRANSFER,4552,Laurent Marion,11405,6853,Alexandre Delaunay,621051,625603,2022-07-01
CASH_IN,187494,Agence_mtn_Abomey,300000,112506,Alexandre Delaunay,625603,813097,2022-07-01
CASH_IN,92353,Agence_mtn_Ouidah,300000,207647,Alexandre Delaunay,813097,905450,2022-07-03
CASH_IN,138521,Agence_mtn_Abomey,300000,161479,Alexandre Delaunay,905450,1043971,2022-07-04
CASH_OUT,125272,Alexandre Delaunay,1043971,918699,Agence_mtn_Abomey,300000,174728,2022-07-09
TRANSFER,636361,Matthieu Cousin,1612510,976149,Alexandre Delaunay,918699,1555060,2022-07-09
TRANSFER,515326,Alexandre Delaunay,1555060,1039734,Jacques Le Marion,756998,241672,2022-07-10
CASH_OUT,756387,Alexandre Delaunay,1039734,283347,Agence_mtn_Abomey,300000,-456387,2022-07-11
CASH_IN,167237,Agence_mtn_Cotonou,300000,132763,Alexandre Delaunay,283347,450584,2022-07-11
CASH_IN,298484,Agence_mtn_Ouidah,300000,1516,Alexandre Delaunay,450584,749068,2022-07-12
CASH_IN,44105,Agence_mtn_Cotonou,300000,255895,Alexandre Delaunay,749068,793173,2022-07-13
CASH_IN,6674,Agence_mtn_Cotonou,300000,293326,Alexandre Delaunay,793173,799847,2022-07-15
CASH_OUT,8891,Alexandre Delaunay,799847,790956,Agence_mtn_Cotonou,300000,291109,2022-07-15
TRANSFER,6084,Alexandre Blanchard,12170,6086,Alexandre Delaunay,790956,797040,2022-07-17
CASH_OUT,571344,Alexandre Delaunay,797040,225696,Agence_mtn_Ouidah,300000,-271344,2022-07-17
CASH_OUT,55101,Alexandre Delaunay,225696,170595,Agence_mtn_Ouidah,300000,244899,2022-07-18
TRANSFER,30239,Corinne Roussel,83040,52801,Alexandre Delaunay,170595,200834,2022-07-19
CASH_IN,104507,Agence_mtn_Ouidah,300000,195493,Alexandre Delaunay,200834,305341,2022-07-20
TRANSFER,94380,Alexandre Delaunay,305341,210961,Maggie Barbier,1054528,960148,2022-07-20
TRANSFER,103377,Alexandre Delaunay,210961,107584,Matthieu Cousin,976149,872772,2022-07-21
CASH_OUT,89597,Alexandre Delaunay,107584,17987,Agence_mtn_Ouidah,300000,210403,2022-07-25
CASH_OUT,13340,Alexandre Delaunay,17987,4647,Agence_mtn_Cotonou,300000,286660,2022-07-25
CASH_IN,139223,Agence_mtn_Cotonou,300000,160777,Alexandre Delaunay,4647,143870,2022-07-25
CASH_IN,275806,Agence_mtn_Ouidah,300000,24194,Alexandre Delaunay,143870,419676,2022-07-26
CASH_OUT,225517,Alexandre Delaunay,419676,194159,Agence_mtn_Cotonou,300000,74483,2022-07-26
CASH_OUT,139741,Alexandre Delaunay,194159,54418,Agence_mtn_Ouidah,300000,160259,2022-07-27
CASH_IN,170844,Agence_mtn_Abomey,300000,129156,Marthe Perrin,1566200,1737044,2022-07-02
CASH_IN,183187,Agence_mtn_Abomey,300000,116813,Marthe Perrin,1737044,1920231,2022-07-02
CASH_IN,214893,Agence_mtn_Abomey,300000,85107,Marthe Perrin,1920231,2135124,2022-07-03
CASH_OUT,418717,Marthe Perrin,2135124,1716407,Agence_mtn_Cotonou,300000,-118717,2022-07-05
TRANSFER,1593534,Marthe Perrin,1716407,122873,Matthieu Cousin,872772,-720762,2022-07-06
CASH_IN,66244,Agence_mtn_Cotonou,300000,233756,Marthe Perrin,122873,189117,2022-07-06
TRANSFER,667653,Gabrielle Hamon,718505,50852,Marthe Perrin,189117,856770,2022-07-07
CASH_IN,256322,Agence_mtn_Ouidah,300000,43678,Marthe Perrin,856770,1113092,2022-07-08
TRANSFER,578749,Marthe Perrin,1113092,534343,Jules-Marc Chauvet,478020,-100729,2022-07-12
TRANSFER,780261,Michèle Faivre,1503145,722884,Marthe Perrin,534343,1314604,2022-07-12
CASH_IN,231490,Agence_mtn_Cotonou,300000,68510,Marthe Perrin,1314604,1546094,2022-07-13
CASH_OUT,1385455,Marthe Perrin,1546094,160639,Agence_mtn_Ouidah,300000,-1085455,2022-07-13
CASH_OUT,158614,Marthe Perrin,160639,2025,Agence_mtn_Abomey,300000,141386,2022-07-14
TRANSFER,985,Marthe Perrin,2025,1040,Marcel de la Buisson,229322,228337,2022-07-14
CASH_IN,201942,Agence_mtn_Cotonou,300000,98058,Marthe Perrin,1040,202982,2022-07-15
CASH_OUT,141975,Marthe Perrin,202982,61007,Agence_mtn_Ouidah,300000,158025,2022-07-15
CASH_IN,21131,Agence_mtn_Ouidah,300000,278869,Marthe Perrin,61007,82138,2022-07-15
CASH_OUT,54227,Marthe Perrin,82138,27911,Agence_mtn_Abomey,300000,245773,2022-07-16
CASH_IN,33143,Agence_mtn_Ouidah,300000,266857,Marthe Perrin,27911,61054,2022-07-22
TRANSFER,483640,Hélène Blanchard-Renault,658254,174614,Marthe Perrin,61054,544694,2022-07-22
CASH_IN,264668,Agence_mtn_Abomey,300000,35332,Marthe Perrin,544694,809362,2022-07-24
TRANSFER,526129,Michèle Faivre,722884,196755,Marthe Perrin,809362,1335491,2022-07-25
CASH_OUT,1167336,Marthe Perrin,1335491,168155,Agence_mtn_Cotonou,300000,-867336,2022-07-25
CASH_OUT,11259,Marthe Perrin,168155,156896,Agence_mtn_Ouidah,300000,288741,2022-07-26
CASH_OUT,2000,Marthe Perrin,156896,154896,Agence_mtn_Cotonou,300000,298000,2022-07-26
CASH_OUT,22777,Danielle-Henriette Tessier,854500,831723,Agence_mtn_Abomey,300000,277223,2022-07-02
CASH_IN,216966,Agence_mtn_Ouidah,300000,83034,Danielle-Henriette Tessier,831723,1048689,2022-07-04
CASH_IN,172693,Agence_mtn_Ouidah,300000,127307,Danielle-Henriette Tessier,1048689,1221382,2022-07-04
CASH_IN,14981,Agence_mtn_Abomey,300000,285019,Danielle-Henriette Tessier,1221382,1236363,2022-07-06
CASH_OUT,686128,Danielle-Henriette Tessier,1236363,550235,Agence_mtn_Cotonou,300000,-386128,2022-07-09
CASH_IN,299774,Agence_mtn_Abomey,300000,226,Danielle-Henriette Tessier,550235,850009,2022-07-09
CASH_OUT,532109,Danielle-Henriette Tessier,850009,317900,Agence_mtn_Abomey,300000,-232109,2022-07-10
TRANSFER,273457,Danielle-Henriette Tessier,317900,44443,Raymond-Yves Boulanger,574769,301312,2022-07-10
CASH_OUT,7698,Danielle-Henriette Tessier,44443,36745,Agence_mtn_Ouidah,300000,292302,2022-07-12
CASH_IN,179732,Agence_mtn_Abomey,300000,120268,Danielle-Henriette Tessier,36745,216477,2022-07-12
CASH_IN,254321,Agence_mtn_Ouidah,300000,45679,Danielle-Henriette Tessier,216477,470798,2022-07-15
TRANSFER,106094,François Vaillant,179849,73755,Danielle-Henriette Tessier,470798,576892,2022-07-15
TRANSFER,23851,Raymond Simon,29302,5451,Danielle-Henriette Tessier,576892,600743,2022-07-16
TRANSFER,595808,Danielle-Henriette Tessier,600743,4935,Gérard Blot de Blanc,876291,280483,2022-07-16
TRANSFER,367299,Valérie de Pottier,660588,293289,Danielle-Henriette Tessier,4935,372234,2022-07-16
TRANSFER,275612,Danielle-Henriette Tessier,372234,96622,Jacques Le Marion,241672,-33940,2022-07-16
CASH_OUT,3733,Danielle-Henriette Tessier,96622,92889,Agence_mtn_Abomey,300000,296267,2022-07-18
TRANSFER,59781,Danielle-Henriette Tessier,92889,33108,Marc Baudry,1121100,1061319,2022-07-18
CASH_IN,210111,Agence_mtn_Cotonou,300000,89889,Danielle-Henriette Tessier,33108,243219,2022-07-19
CASH_IN,208846,Agence_mtn_Ouidah,300000,91154,Danielle-Henriette Tessier,243219,452065,2022-07-20
TRANSFER,349442,Danielle-Henriette Tessier,452065,102623,Sophie-Anouk Boulanger,357858,8416,2022-07-20
TRANSFER,76382,Danielle-Henriette Tessier,102623,26241,Roger-Roger Delmas,1440200,1363818,2022-07-22
CASH_OUT,17388,Danielle-Henriette Tessier,26241,8853,Agence_mtn_Abomey,300000,282612,2022-07-22
TRANSFER,3790,Danielle-Henriette Tessier,8853,5063,Nicolas Blin,1185400,1181610,2022-07-23
CASH_IN,297608,Agence_mtn_Ouidah,300000,2392,Danielle-Henriette Tessier,5063,302671,2022-07-24
CASH_OUT,210063,Danielle-Henriette Tessier,302671,92608,Agence_mtn_Ouidah,300000,89937,2022-07-24
CASH_IN,175118,Agence_mtn_Cotonou,300000,124882,Danielle-Henriette Tessier,92608,267726,2022-07-25
CASH_OUT,232971,Danielle-Henriette Tessier,267726,34755,Agence_mtn_Abomey,300000,67029,2022-07-25
TRANSFER,3762,Danielle-Henriette Tessier,34755,30993,Raymond Simon,5451,1689,2022-07-27
TRANSFER,8257,Danielle-Henriette Tessier,30993,22736,Robert Henry-Poulain,66428,58171,2022-07-27
CASH_IN,222326,Agence_mtn_Cotonou,300000,77674,Matthieu Cousin,-720762,-498436,2022-07-02
CASH_IN,142775,Agence_mtn_Cotonou,300000,157225,Matthieu Cousin,-498436,-355661,2022-07-04
CASH_IN,40088,Agence_mtn_Ouidah,300000,259912,Matthieu Cousin,-355661,-315573,2022-07-04
CASH_IN,94132,Agence_mtn_Ouidah,300000,205868,Matthieu Cousin,-315573,-221441,2022-07-05
CASH_IN,279914,Agence_mtn_Abomey,300000,20086,Matthieu Cousin,-221441,58473,2022-07-06
CASH_IN,221965,Agence_mtn_Abomey,300000,78035,Matthieu Cousin,58473,280438,2022-07-06
CASH_OUT,36722,Matthieu Cousin,280438,243716,Agence_mtn_Ouidah,300000,263278,2022-07-06
CASH_IN,212292,Agence_mtn_Ouidah,300000,87708,Matthieu Cousin,243716,456008,2022-07-08
CASH_IN,253048,Agence_mtn_Ouidah,300000,46952,Matthieu Cousin,456008,709056,2022-07-09
TRANSFER,241451,Valérie de Pottier,293289,51838,Matthieu Cousin,709056,950507,2022-07-09
CASH_IN,207574,Agence_mtn_Abomey,300000,92426,Matthieu Cousin,950507,1158081,2022-07-10
CASH_OUT,657982,Matthieu Cousin,1158081,500099,Agence_mtn_Cotonou,300000,-357982,2022-07-11
CASH_OUT,308553,Matthieu Cousin,500099,191546,Agence_mtn_Cotonou,300000,-8553,2022-07-12
CASH_OUT,21186,Matthieu Cousin,191546,170360,Agence_mtn_Abomey,300000,278814,2022-07-12
TRANSFER,188874,Roger-Roger Delmas,1363818,1174944,Matthieu Cousin,170360,359234,2022-07-14
CASH_IN,252736,Agence_mtn_Ouidah,300000,47264,Matthieu Cousin,359234,611970,2022-07-17
CASH_OUT,248381,Matthieu Cousin,611970,363589,Agence_mtn_Abomey,300000,51619,2022-07-22
CASH_IN,147729,Agence_mtn_Abomey,300000,152271,Matthieu Cousin,363589,511318,2022-07-23
CASH_IN,215318,Agence_mtn_Cotonou,300000,84682,Matthieu Cousin,511318,726636,2022-07-23
CASH_IN,129638,Agence_mtn_Ouidah,300000,170362,Matthieu Cousin,726636,856274,2022-07-24
CASH_IN,9227,Agence_mtn_Ouidah,300000,290773,Matthieu Cousin,856274,865501,2022-07-26
CASH_IN,157748,Agence_mtn_Abomey,300000,142252,Matthieu Cousin,865501,1023249,2022-07-26
CASH_IN,256512,Agence_mtn_Ouidah,300000,43488,Matthieu Cousin,1023249,1279761,2022-07-26
CASH_IN,188392,Agence_mtn_Ouidah,300000,111608,Marine Labbé,223960,412352,2022-07-02
CASH_OUT,165055,Marine Labbé,412352,247297,Agence_mtn_Abomey,300000,134945,2022-07-02
CASH_OUT,234183,Marine Labbé,247297,13114,Agence_mtn_Ouidah,300000,65817,2022-07-02
CASH_OUT,11600,Marine Labbé,13114,1514,Agence_mtn_Cotonou,300000,288400,2022-07-03
TRANSFER,1165,Marine Labbé,1514,349,Hélène Blanchard-Renault,174614,173449,2022-07-06
CASH_IN,127166,Agence_mtn_Ouidah,300000,172834,Marine Labbé,349,127515,2022-07-08
TRANSFER,121371,Marine Labbé,127515,6144,Astrid Aubert-Thierry,1790200,1668829,2022-07-09
CASH_IN,183164,Agence_mtn_Ouidah,300000,116836,Marine Labbé,6144,189308,2022-07-11
CASH_OUT,82710,Marine Labbé,189308,106598,Agence_mtn_Abomey,300000,217290,2022-07-12
CASH_OUT,78480,Marine Labbé,106598,28118,Agence_mtn_Cotonou,300000,221520,2022-07-13
CASH_IN,122268,Agence_mtn_Abomey,300000,177732,Marine Labbé,28118,150386,2022-07-15
CASH_IN,190596,Agence_mtn_Abomey,300000,109404,Marine Labbé,150386,340982,2022-07-17
CASH_OUT,1840,Marine Labbé,340982,339142,Agence_mtn_Abomey,300000,298160,2022-07-18
CASH_OUT,103755,Marine Labbé,339142,235387,Agence_mtn_Abomey,300000,196245,2022-07-21
CASH_IN,76610,Agence_mtn_Ouidah,300000,223390,Marine Labbé,235387,311997,2022-07-22
CASH_OUT,246929,Marine Labbé,311997,65068,Agence_mtn_Cotonou,300000,53071,2022-07-23
TRANSFER,26929,Marine Labbé,65068,38139,Laurent Marion,6853,-20076,2022-07-24
CASH_OUT,12572,Marine Labbé,38139,25567,Agence_mtn_Abomey,300000,287428,2022-07-24
TRANSFER,115459,Georges Muller,131574,16115,Marine Labbé,25567,141026,2022-07-24
CASH_OUT,79632,Marine Labbé,141026,61394,Agence_mtn_Cotonou,300000,220368,2022-07-25
CASH_IN,41370,Agence_mtn_Cotonou,300000,258630,Marine Labbé,61394,102764,2022-07-25
CASH_IN,9470,Agence_mtn_Abomey,300000,290530,Marine Labbé,102764,112234,2022-07-26
CASH_OUT,67062,Marine Labbé,112234,45172,Agence_mtn_Cotonou,300000,232938,2022-07-26
CASH_IN,22267,Agence_mtn_Cotonou,300000,277733,Océane Faure,-360702,-338435,2022-07-01
CASH_IN,299097,Agence_mtn_Ouidah,300000,903,Océane Faure,-338435,-39338,2022-07-02
CASH_IN,48446,Agence_mtn_Abomey,300000,251554,Océane Faure,-39338,9108,2022-07-03
CASH_OUT,4680,Océane Faure,9108,4428,Agence_mtn_Abomey,300000,295320,2022-07-03
CASH_OUT,3568,Océane Faure,4428,860,Agence_mtn_Ouidah,300000,296432,2022-07-05
TRANSFER,1515879,Emmanuel Vallée,1739590,223711,Océane Faure,860,1516739,2022-07-07
CASH_OUT,1303927,Océane Faure,1516739,212812,Agence_mtn_Ouidah,300000,-1003927,2022-07-08
CASH_OUT,83875,Océane Faure,212812,128937,Agence_mtn_Ouidah,300000,216125,2022-07-08
CASH_OUT,84151,Océane Faure,128937,44786,Agence_mtn_Ouidah,300000,215849,2022-07-09
CASH_IN,241371,Agence_mtn_Abomey,300000,58629,Océane Faure,44786,286157,2022-07-09
CASH_IN,112383,Agence_mtn_Cotonou,300000,187617,Océane Faure,286157,398540,2022-07-12
CASH_IN,54201,Agence_mtn_Ouidah,300000,245799,Océane Faure,398540,452741,2022-07-12
TRANSFER,29309,Océane Faure,452741,423432,Julien Devaux,167247,137938,2022-07-16
CASH_IN,162168,Agence_mtn_Ouidah,300000,137832,Océane Faure,423432,585600,2022-07-16
TRANSFER,67324,Océane Faure,585600,518276,Georges Muller,16115,-51209,2022-07-16
TRANSFER,15173,Océane Faure,518276,503103,Michelle de la Daniel,1867386,1852213,2022-07-16
CASH_OUT,100757,Océane Faure,503103,402346,Agence_mtn_Abomey,300000,199243,2022-07-17
TRANSFER,208450,Océane Faure,402346,193896,Océane Faure,402346,193896,2022-07-17
CASH_OUT,115460,Océane Faure,193896,78436,Agence_mtn_Ouidah,300000,184540,2022-07-18
TRANSFER,207846,Maurice de Brunet,446359,238513,Océane Faure,78436,286282,2022-07-19
CASH_OUT,192076,Océane Faure,286282,94206,Agence_mtn_Abomey,300000,107924,2022-07-21
TRANSFER,1138517,Roger-Roger Delmas,1174944,36427,Océane Faure,94206,1232723,2022-07-22
TRANSFER,506601,Océane Faure,1232723,726122,Nathalie Da Silva,600344,93743,2022-07-22
CASH_IN,222011,Agence_mtn_Ouidah,300000,77989,Océane Faure,726122,948133,2022-07-23
CASH_IN,260946,Agence_mtn_Ouidah,300000,39054,Océane Faure,948133,1209079,2022-07-24
CASH_OUT,334724,Océane Faure,1209079,874355,Agence_mtn_Abomey,300000,-34724,2022-07-24
CASH_OUT,775984,Océane Faure,874355,98371,Agence_mtn_Abomey,300000,-475984,2022-07-24
CASH_OUT,27234,Océane Faure,98371,71137,Agence_mtn_Abomey,300000,272766,2022-07-26
TRANSFER,117132,Julien Devaux,137938,20806,Gabrielle Hamon,50852,-66280,2022-07-02
TRANSFER,312,Raymond Simon,1689,1377,Julien Devaux,20806,21118,2022-07-04
CASH_IN,245061,Agence_mtn_Ouidah,300000,54939,Julien Devaux,21118,266179,2022-07-07
CASH_OUT,250417,Julien Devaux,266179,15762,Agence_mtn_Abomey,300000,49583,2022-07-07
TRANSFER,3185,Julien Devaux,15762,12577,Margot Julien,1883500,1880315,2022-07-07
CASH_OUT,6588,Julien Devaux,12577,5989,Agence_mtn_Abomey,300000,293412,2022-07-08
CASH_OUT,2928,Julien Devaux,5989,3061,Agence_mtn_Cotonou,300000,297072,2022-07-08
TRANSFER,2344,Julien Devaux,3061,717,Jacques Laporte de Blanchet,1023099,1020755,2022-07-09
CASH_IN,50266,Agence_mtn_Cotonou,300000,249734,Julien Devaux,717,50983,2022-07-09
CASH_OUT,43311,Julien Devaux,50983,7672,Agence_mtn_Cotonou,300000,256689,2022-07-10
TRANSFER,6631,Julien Devaux,7672,1041,Olivier Benard,16003,9372,2022-07-10
CASH_IN,259867,Agence_mtn_Ouidah,300000,40133,Julien Devaux,1041,260908,2022-07-14
TRANSFER,140997,Julien Devaux,260908,119911,Michelle de la Daniel,1852213,1711216,2022-07-14
TRANSFER,118359,Julien Devaux,119911,1552,Roger-Roger Delmas,36427,-81932,2022-07-15
CASH_IN,140224,Agence_mtn_Ouidah,300000,159776,Julien Devaux,1552,141776,2022-07-16
TRANSFER,62949,Julien Devaux,141776,78827,Sylvie Dupré,974653,911704,2022-07-17
TRANSFER,92196,Nathalie-Claire De Oliveira,255878,163682,Julien Devaux,78827,171023,2022-07-20
CASH_OUT,34216,Julien Devaux,171023,136807,Agence_mtn_Ouidah,300000,265784,2022-07-21
CASH_OUT,116955,Julien Devaux,136807,19852,Agence_mtn_Ouidah,300000,183045,2022-07-22
CASH_IN,1760,Agence_mtn_Abomey,300000,298240,Julien Devaux,19852,21612,2022-07-25
TRANSFER,18627,Julien Devaux,21612,2985,Raymond-Yves Boulanger,301312,282685,2022-07-25
TRANSFER,2034,Julien Devaux,2985,951,Robert Henry-Poulain,58171,56137,2022-07-26
CASH_OUT,642,Julien Devaux,951,309,Agence_mtn_Abomey,300000,299358,2022-07-26
CASH_OUT,239,Julien Devaux,309,70,Agence_mtn_Cotonou,300000,299761,2022-07-26
TRANSFER,606671,Maggie Barbier,960148,353477,Michelle de la Daniel,1711216,1104545,2022-07-02
CASH_OUT,248114,Maggie Barbier,353477,105363,Agence_mtn_Cotonou,300000,51886,2022-07-04
CASH_OUT,105307,Maggie Barbier,105363,56,Agence_mtn_Cotonou,300000,194693,2022-07-04
CASH_IN,116959,Agence_mtn_Cotonou,300000,183041,Maggie Barbier,56,117015,2022-07-04
CASH_IN,190584,Agence_mtn_Ouidah,300000,109416,Maggie Barbier,117015,307599,2022-07-06
CASH_IN,222069,Agence_mtn_Abomey,300000,77931,Maggie Barbier,307599,529668,2022-07-06
CASH_IN,245200,Agence_mtn_Ouidah,300000,54800,Maggie Barbier,529668,774868,2022-07-06
CASH_OUT,100686,Maggie Barbier,774868,674182,Agence_mtn_Ouidah,300000,199314,2022-07-06
CASH_IN,266673,Agence_mtn_Cotonou,300000,33327,Maggie Barbier,674182,940855,2022-07-09
CASH_OUT,442484,Maggie Barbier,940855,498371,Agence_mtn_Abomey,300000,-142484,2022-07-10
CASH_OUT,460997,Maggie Barbier,498371,37374,Agence_mtn_Abomey,300000,-160997,2022-07-10
CASH_OUT,18032,Maggie Barbier,37374,19342,Agence_mtn_Cotonou,300000,281968,2022-07-12
CASH_IN,127664,Agence_mtn_Abomey,300000,172336,Maggie Barbier,19342,147006,2022-07-12
CASH_IN,148636,Agence_mtn_Ouidah,300000,151364,Maggie Barbier,147006,295642,2022-07-12
CASH_OUT,116055,Maggie Barbier,295642,179587,Agence_mtn_Ouidah,300000,183945,2022-07-13
CASH_IN,255611,Agence_mtn_Abomey,300000,44389,Maggie Barbier,179587,435198,2022-07-16
CASH_OUT,358297,Maggie Barbier,435198,76901,Agence_mtn_Cotonou,300000,-58297,2022-07-16
CASH_IN,195819,Agence_mtn_Ouidah,300000,104181,Maggie Barbier,76901,272720,2022-07-19
TRANSFER,197641,Maurice de Brunet,238513,40872,Maggie Barbier,272720,470361,2022-07-19
CASH_OUT,346289,Maggie Barbier,470361,124072,Agence_mtn_Ouidah,300000,-46289,2022-07-21
CASH_OUT,107048,Maggie Barbier,124072,17024,Agence_mtn_Ouidah,300000,192952,2022-07-22
CASH_OUT,2034,Maggie Barbier,17024,14990,Agence_mtn_Ouidah,300000,297966,2022-07-23
CASH_OUT,7182,Maggie Barbier,14990,7808,Agence_mtn_Ouidah,300000,292818,2022-07-25
CASH_OUT,3946,Maggie Barbier,7808,3862,Agence_mtn_Cotonou,300000,296054,2022-07-26
TRANSFER,437346,Jacques Laporte de Blanchet,1020755,583409,Maggie Barbier,3862,441208,2022-07-27
CASH_OUT,288457,Maggie Barbier,441208,152751,Agence_mtn_Abomey,300000,11543,2022-07-27
TRANSFER,594346,Éléonore Marin Le Morel,1786600,1192254,Emmanuel Vallée,223711,-370635,2022-07-01
CASH_OUT,299024,Éléonore Marin Le Morel,1192254,893230,Agence_mtn_Cotonou,300000,976,2022-07-02
CASH_IN,42609,Agence_mtn_Abomey,300000,257391,Éléonore Marin Le Morel,893230,935839,2022-07-06
TRANSFER,180414,Charles Guérin,263065,82651,Éléonore Marin Le Morel,935839,1116253,2022-07-06
TRANSFER,824688,Éléonore Marin Le Morel,1116253,291565,Sabine Perrier,1332300,507612,2022-07-06
TRANSFER,9069,Valérie de Pottier,51838,42769,Éléonore Marin Le Morel,291565,300634,2022-07-07
TRANSFER,77929,Françoise Denis de Allard,100304,22375,Éléonore Marin Le Morel,300634,378563,2022-07-08
CASH_OUT,368030,Éléonore Marin Le Morel,378563,10533,Agence_mtn_Abomey,300000,-68030,2022-07-09
TRANSFER,9073,Éléonore Marin Le Morel,10533,1460,Hélène Blanchard-Renault,173449,164376,2022-07-10
TRANSFER,141,Éléonore Marin Le Morel,1460,1319,Alexandre Blanchard,6086,5945,2022-07-11
CASH_IN,58883,Agence_mtn_Abomey,300000,241117,Éléonore Marin Le Morel,1319,60202,2022-07-12
CASH_IN,232885,Agence_mtn_Cotonou,300000,67115,Éléonore Marin Le Morel,60202,293087,2022-07-13
CASH_OUT,6271,Éléonore Marin Le Morel,293087,286816,Agence_mtn_Ouidah,300000,293729,2022-07-14
CASH_IN,60242,Agence_mtn_Abomey,300000,239758,Éléonore Marin Le Morel,286816,347058,2022-07-15
CASH_OUT,25781,Éléonore Marin Le Morel,347058,321277,Agence_mtn_Cotonou,300000,274219,2022-07-16
CASH_OUT,20745,Éléonore Marin Le Morel,321277,300532,Agence_mtn_Cotonou,300000,279255,2022-07-17
TRANSFER,227000,Éléonore Marin Le Morel,300532,73532,Maurice de Brunet,40872,-186128,2022-07-17
CASH_IN,31549,Agence_mtn_Cotonou,300000,268451,Éléonore Marin Le Morel,73532,105081,2022-07-18
CASH_OUT,80597,Éléonore Marin Le Morel,105081,24484,Agence_mtn_Ouidah,300000,219403,2022-07-19
CASH_OUT,24379,Éléonore Marin Le Morel,24484,105,Agence_mtn_Ouidah,300000,275621,2022-07-20
CASH_OUT,104,Éléonore Marin Le Morel,105,1,Agence_mtn_Abomey,300000,299896,2022-07-22
CASH_IN,238149,Agence_mtn_Cotonou,300000,61851,Éléonore Marin Le Morel,1,238150,2022-07-24
CASH_IN,32153,Agence_mtn_Abomey,300000,267847,Éléonore Marin Le Morel,238150,270303,2022-07-25
TRANSFER,477206,Nicolas Blin,1181610,704404,Nicolas Blin,1181610,704404,2022-07-02
CASH_OUT,439851,Nicolas Blin,704404,264553,Agence_mtn_Cotonou,300000,-139851,2022-07-03
TRANSFER,33710,Gilbert Moulin,44488,10778,Nicolas Blin,264553,298263,2022-07-03
TRANSFER,271092,Nicolas Blin,298263,27171,Christophe Teixeira,1641400,1370308,2022-07-03
CASH_OUT,3995,Nicolas Blin,27171,23176,Agence_mtn_Ouidah,300000,296005,2022-07-03
TRANSFER,121,Raymond Simon,1377,1256,Nicolas Blin,23176,23297,2022-07-03
TRANSFER,1458,Sophie-Anouk Boulanger,8416,6958,Nicolas Blin,23297,24755,2022-07-04
TRANSFER,4917,Olivier Benard,9372,4455,Nicolas Blin,24755,29672,2022-07-06
TRANSFER,428705,René de la Delaunay,1766900,1338195,Nicolas Blin,29672,458377,2022-07-06
TRANSFER,446897,Nicolas Blin,458377,11480,Alexandre Blanchard,5945,-440952,2022-07-07
CASH_OUT,761,Nicolas Blin,11480,10719,Agence_mtn_Abomey,300000,299239,2022-07-11
CASH_IN,84401,Agence_mtn_Cotonou,300000,215599,Nicolas Blin,10719,95120,2022-07-12
CASH_IN,131885,Agence_mtn_Ouidah,300000,168115,Nicolas Blin,95120,227005,2022-07-13
TRANSFER,7443,Nicolas Blin,227005,219562,Christophe Teixeira,1370308,1362865,2022-07-15
CASH_IN,243445,Agence_mtn_Ouidah,300000,56555,Nicolas Blin,219562,463007,2022-07-16
CASH_OUT,31365,Nicolas Blin,463007,431642,Agence_mtn_Ouidah,300000,268635,2022-07-17
CASH_IN,16378,Agence_mtn_Ouidah,300000,283622,Nicolas Blin,431642,448020,2022-07-17
TRANSFER,11090,Corinne Roussel,52801,41711,Nicolas Blin,448020,459110,2022-07-18
CASH_IN,17880,Agence_mtn_Ouidah,300000,282120,Nicolas Blin,459110,476990,2022-07-19
CASH_IN,50496,Agence_mtn_Cotonou,300000,249504,Nicolas Blin,476990,527486,2022-07-20
CASH_IN,28307,Agence_mtn_Abomey,300000,271693,Nicolas Blin,527486,555793,2022-07-20
TRANSFER,323376,Nicolas Blin,555793,232417,Gérard Blot de Blanc,280483,-42893,2022-07-20
TRANSFER,31514,Nicolas Blin,232417,200903,René de la Delaunay,1338195,1306681,2022-07-20
CASH_OUT,86244,Nicolas Blin,200903,114659,Agence_mtn_Abomey,300000,213756,2022-07-27
CASH_OUT,66464,Nicolas Blin,114659,48195,Agence_mtn_Ouidah,300000,233536,2022-07-27
CASH_IN,136553,Agence_mtn_Ouidah,300000,163447,Honoré de la Prévost,-44720,91833,2022-07-03
CASH_OUT,87775,Honoré de la Prévost,91833,4058,Agence_mtn_Ouidah,300000,212225,2022-07-03
TRANSFER,555699,Sylvie Dupré,911704,356005,Honoré de la Prévost,4058,559757,2022-07-03
TRANSFER,142553,Honoré de la Prévost,559757,417204,Raymond Simon,1256,-141297,2022-07-03
TRANSFER,114757,Honoré de la Prévost,417204,302447,Hélène Blanchard-Renault,164376,49619,2022-07-03
TRANSFER,57490,Honoré de la Prévost,302447,244957,Raymond-Yves Boulanger,282685,225195,2022-07-06
CASH_IN,230855,Agence_mtn_Cotonou,300000,69145,Honoré de la Prévost,244957,475812,2022-07-08
CASH_OUT,14868,Honoré de la Prévost,475812,460944,Agence_mtn_Abomey,300000,285132,2022-07-09
CASH_IN,207939,Agence_mtn_Abomey,300000,92061,Honoré de la Prévost,460944,668883,2022-07-09
CASH_IN,254132,Agence_mtn_Ouidah,300000,45868,Honoré de la Prévost,668883,923015,2022-07-09
CASH_OUT,567604,Honoré de la Prévost,923015,355411,Agence_mtn_Abomey,300000,-267604,2022-07-10
TRANSFER,151433,Madeleine Hardy,197596,46163,Honoré de la Prévost,355411,506844,2022-07-11
CASH_OUT,336942,Honoré de la Prévost,506844,169902,Agence_mtn_Cotonou,300000,-36942,2022-07-13
TRANSFER,36083,Honoré de la Prévost,169902,133819,François Vaillant,73755,37672,2022-07-13
TRANSFER,610812,Valérie-Claudine Marin,654923,44111,Honoré de la Prévost,133819,744631,2022-07-13
CASH_OUT,517469,Honoré de la Prévost,744631,227162,Agence_mtn_Cotonou,300000,-217469,2022-07-14
CASH_OUT,162449,Honoré de la Prévost,227162,64713,Agence_mtn_Ouidah,300000,137551,2022-07-14
CASH_IN,112415,Agence_mtn_Cotonou,300000,187585,Honoré de la Prévost,64713,177128,2022-07-15
CASH_IN,193710,Agence_mtn_Ouidah,300000,106290,Honoré de la Prévost,177128,370838,2022-07-16
TRANSFER,245931,Honoré de la Prévost,370838,124907,Robert Henry-Poulain,56137,-189794,2022-07-19
CASH_OUT,41668,Honoré de la Prévost,124907,83239,Agence_mtn_Cotonou,300000,258332,2022-07-20
CASH_OUT,43133,Honoré de la Prévost,83239,40106,Agence_mtn_Ouidah,300000,256867,2022-07-20
CASH_IN,90324,Agence_mtn_Abomey,300000,209676,Honoré de la Prévost,40106,130430,2022-07-20
CASH_OUT,65219,Honoré de la Prévost,130430,65211,Agence_mtn_Abomey,300000,234781,2022-07-20
CASH_OUT,56019,Honoré de la Prévost,65211,9192,Agence_mtn_Cotonou,300000,243981,2022-07-22
CASH_IN,40285,Agence_mtn_Abomey,300000,259715,Honoré de la Prévost,9192,49477,2022-07-23
CASH_IN,122512,Agence_mtn_Abomey,300000,177488,Honoré de la Prévost,49477,171989,2022-07-26
CASH_IN,25848,Agence_mtn_Ouidah,300000,274152,Honoré de la Prévost,171989,197837,2022-07-26
TRANSFER,350516,Zacharie Fabre,674930,324414,Astrid Aubert-Thierry,1668829,1318313,2022-07-01
CASH_OUT,306371,Zacharie Fabre,324414,18043,Agence_mtn_Abomey,300000,-6371,2022-07-02
TRANSFER,15690,Zacharie Fabre,18043,2353,Aimé Bernier,283262,267572,2022-07-02
CASH_IN,29990,Agence_mtn_Cotonou,300000,270010,Zacharie Fabre,2353,32343,2022-07-03
CASH_OUT,7603,Zacharie Fabre,32343,24740,Agence_mtn_Cotonou,300000,292397,2022-07-04
CASH_IN,284480,Agence_mtn_Abomey,300000,15520,Zacharie Fabre,24740,309220,2022-07-04
CASH_OUT,211009,Zacharie Fabre,309220,98211,Agence_mtn_Abomey,300000,88991,2022-07-06
TRANSFER,193345,Michèle Faivre,196755,3410,Zacharie Fabre,98211,291556,2022-07-09
CASH_OUT,139202,Zacharie Fabre,291556,152354,Agence_mtn_Cotonou,300000,160798,2022-07-09
CASH_IN,200022,Agence_mtn_Ouidah,300000,99978,Zacharie Fabre,152354,352376,2022-07-10
TRANSFER,105880,Zacharie Fabre,352376,246496,Élise Monnier,851830,745950,2022-07-11
TRANSFER,30516,Zacharie Fabre,246496,215980,Jacques Laporte de Blanchet,583409,552893,2022-07-12
CASH_IN,70807,Agence_mtn_Abomey,300000,229193,Zacharie Fabre,215980,286787,2022-07-13
TRANSFER,3235,Olivier Benard,4455,1220,Zacharie Fabre,286787,290022,2022-07-13
CASH_IN,157251,Agence_mtn_Ouidah,300000,142749,Zacharie Fabre,290022,447273,2022-07-17
TRANSFER,17845,Corinne Roussel,41711,23866,Zacharie Fabre,447273,465118,2022-07-18
TRANSFER,87717,Zacharie Fabre,465118,377401,Sylvie Dupré,356005,268288,2022-07-18
CASH_IN,2844,Agence_mtn_Cotonou,300000,297156,Zacharie Fabre,377401,380245,2022-07-18
CASH_IN,240372,Agence_mtn_Abomey,300000,59628,Zacharie Fabre,380245,620617,2022-07-19
CASH_OUT,575932,Zacharie Fabre,620617,44685,Agence_mtn_Abomey,300000,-275932,2022-07-19
CASH_IN,133709,Agence_mtn_Cotonou,300000,166291,Zacharie Fabre,44685,178394,2022-07-21
CASH_IN,49905,Agence_mtn_Abomey,300000,250095,Zacharie Fabre,178394,228299,2022-07-24
CASH_OUT,97036,Zacharie Fabre,228299,131263,Agence_mtn_Ouidah,300000,202964,2022-07-26
CASH_OUT,69215,Zacharie Fabre,131263,62048,Agence_mtn_Abomey,300000,230785,2022-07-26
CASH_IN,143170,Agence_mtn_Ouidah,300000,156830,Zacharie Fabre,62048,205218,2022-07-27
CASH_OUT,181951,René de la Delaunay,1306681,1124730,Agence_mtn_Abomey,300000,118049,2022-07-01
CASH_OUT,154865,René de la Delaunay,1124730,969865,Agence_mtn_Ouidah,300000,145135,2022-07-03
TRANSFER,424630,Christophe Teixeira,1362865,938235,René de la Delaunay,969865,1394495,2022-07-07
CASH_IN,15963,Agence_mtn_Cotonou,300000,284037,René de la Delaunay,1394495,1410458,2022-07-07
CASH_IN,17987,Agence_mtn_Abomey,300000,282013,René de la Delaunay,1410458,1428445,2022-07-09
CASH_OUT,732581,René de la Delaunay,1428445,695864,Agence_mtn_Cotonou,300000,-432581,2022-07-10
TRANSFER,439909,René de la Delaunay,695864,255955,Valérie de Pottier,42769,-397140,2022-07-11
CASH_IN,268698,Agence_mtn_Abomey,300000,31302,René de la Delaunay,255955,524653,2022-07-12
CASH_OUT,169827,René de la Delaunay,524653,354826,Agence_mtn_Abomey,300000,130173,2022-07-16
CASH_IN,289171,Agence_mtn_Ouidah,300000,10829,René de la Delaunay,354826,643997,2022-07-18
CASH_OUT,58123,René de la Delaunay,643997,585874,Agence_mtn_Ouidah,300000,241877,2022-07-23
TRANSFER,117565,Sylvie Dupré,268288,150723,René de la Delaunay,585874,703439,2022-07-24
CASH_OUT,582671,René de la Delaunay,703439,120768,Agence_mtn_Abomey,300000,-282671,2022-07-25
TRANSFER,1541213,Astrid de Pascal,1963000,421787,Margot Julien,1880315,3421528,2022-07-02
CASH_IN,209169,Agence_mtn_Abomey,300000,90831,Margot Julien,3421528,3630697,2022-07-02
TRANSFER,3293357,Margot Julien,3630697,337340,Nathalie-Claire De Oliveira,163682,-3129675,2022-07-03
TRANSFER,182393,Jacques Laporte de Blanchet,552893,370500,Margot Julien,337340,519733,2022-07-05
CASH_OUT,268779,Margot Julien,519733,250954,Agence_mtn_Abomey,300000,31221,2022-07-07
CASH_OUT,79356,Margot Julien,250954,171598,Agence_mtn_Ouidah,300000,220644,2022-07-10
TRANSFER,160810,Margot Julien,171598,10788,Michèle Faivre,3410,-157400,2022-07-10
CASH_OUT,3568,Margot Julien,10788,7220,Agence_mtn_Abomey,300000,296432,2022-07-14
TRANSFER,1126,Margot Julien,7220,6094,Françoise Denis de Allard,22375,21249,2022-07-16
CASH_OUT,2826,Margot Julien,6094,3268,Agence_mtn_Abomey,300000,297174,2022-07-16
CASH_IN,299094,Agence_mtn_Cotonou,300000,906,Margot Julien,3268,302362,2022-07-17
CASH_OUT,276544,Margot Julien,302362,25818,Agence_mtn_Abomey,300000,23456,2022-07-18
CASH_OUT,24349,Margot Julien,25818,1469,Agence_mtn_Ouidah,300000,275651,2022-07-18
TRANSFER,12604,Valérie-Claudine Marin,44111,31507,Margot Julien,1469,14073,2022-07-19
TRANSFER,9457,Madeleine Hardy,46163,36706,Margot Julien,14073,23530,2022-07-19
TRANSFER,16086,Margot Julien,23530,7444,Charles Guérin,82651,66565,2022-07-19
TRANSFER,4004,Margot Julien,7444,3440,Nicole-Renée Gay,781421,777417,2022-07-20
TRANSFER,996,Margot Julien,3440,2444,Simone du Allard,918174,917178,2022-07-21
CASH_OUT,2052,Margot Julien,2444,392,Agence_mtn_Abomey,300000,297948,2022-07-22
CASH_IN,205708,Agence_mtn_Cotonou,300000,94292,Margot Julien,392,206100,2022-07-25
TRANSFER,265933,Josette du Hamon,1483878,1217945,Élise Monnier,745950,1011883,2022-07-03
CASH_IN,177881,Agence_mtn_Cotonou,300000,122119,Élise Monnier,1011883,1189764,2022-07-05
TRANSFER,480208,Élise Monnier,1189764,709556,Marc Baudry,1061319,581111,2022-07-11
CASH_OUT,39061,Élise Monnier,709556,670495,Agence_mtn_Ouidah,300000,260939,2022-07-11
TRANSFER,257036,Élise Monnier,670495,413459,Astrid de Pascal,421787,164751,2022-07-12
CASH_IN,218567,Agence_mtn_Ouidah,300000,81433,Élise Monnier,413459,632026,2022-07-12
CASH_OUT,244528,Élise Monnier,632026,387498,Agence_mtn_Abomey,300000,55472,2022-07-14
CASH_IN,140958,Agence_mtn_Cotonou,300000,159042,Élise Monnier,387498,528456,2022-07-14
TRANSFER,65107,Charles Guérin,66565,1458,Élise Monnier,528456,593563,2022-07-15
CASH_IN,116116,Agence_mtn_Cotonou,300000,183884,Élise Monnier,593563,709679,2022-07-16
CASH_IN,278373,Agence_mtn_Cotonou,300000,21627,Élise Monnier,709679,988052,2022-07-17
CASH_OUT,7636,Élise Monnier,988052,980416,Agence_mtn_Cotonou,300000,292364,2022-07-18
TRANSFER,236816,Jacques Laporte de Blanchet,370500,133684,Élise Monnier,980416,1217232,2022-07-18
CASH_IN,14314,Agence_mtn_Ouidah,300000,285686,Élise Monnier,1217232,1231546,2022-07-18
CASH_IN,103902,Agence_mtn_Ouidah,300000,196098,Élise Monnier,1231546,1335448,2022-07-20
CASH_IN,50063,Agence_mtn_Abomey,300000,249937,Élise Monnier,1335448,1385511,2022-07-20
CASH_OUT,325438,Élise Monnier,1385511,1060073,Agence_mtn_Abomey,300000,-25438,2022-07-24
CASH_OUT,666897,Élise Monnier,1060073,393176,Agence_mtn_Cotonou,300000,-366897,2022-07-24
CASH_IN,137739,Agence_mtn_Abomey,300000,162261,Élise Monnier,393176,530915,2022-07-25
CASH_IN,135364,Agence_mtn_Ouidah,300000,164636,Christophe Teixeira,938235,1073599,2022-07-03
TRANSFER,600698,Christophe Teixeira,1073599,472901,Nicole-Renée Gay,777417,176719,2022-07-07
CASH_OUT,412372,Christophe Teixeira,472901,60529,Agence_mtn_Ouidah,300000,-112372,2022-07-09
CASH_IN,187446,Agence_mtn_Abomey,300000,112554,Christophe Teixeira,60529,247975,2022-07-10
CASH_OUT,138213,Christophe Teixeira,247975,109762,Agence_mtn_Cotonou,300000,161787,2022-07-15
CASH_IN,271332,Agence_mtn_Ouidah,300000,28668,Christophe Teixeira,109762,381094,2022-07-19
CASH_OUT,237552,Christophe Teixeira,381094,143542,Agence_mtn_Ouidah,300000,62448,2022-07-20
TRANSFER,93032,Christophe Teixeira,143542,50510,Nathalie Da Silva,93743,711,2022-07-22
CASH_OUT,47605,Christophe Teixeira,50510,2905,Agence_mtn_Cotonou,300000,252395,2022-07-24
CASH_IN,114420,Agence_mtn_Cotonou,300000,185580,Charlotte Perrier,-99708,14712,2022-07-03
TRANSFER,5407,Charlotte Perrier,14712,9305,Françoise Denis de Allard,21249,15842,2022-07-07
CASH_IN,128154,Agence_mtn_Abomey,300000,171846,Charlotte Perrier,9305,137459,2022-07-08
TRANSFER,108083,Charlotte Perrier,137459,29376,Nathalie Da Silva,711,-107372,2022-07-13
CASH_OUT,17976,Charlotte Perrier,29376,11400,Agence_mtn_Abomey,300000,282024,2022-07-24
TRANSFER,3567,Sophie-Anouk Boulanger,6958,3391,Charlotte Perrier,11400,14967,2022-07-26
CASH_IN,205509,Agence_mtn_Ouidah,300000,94491,Charlotte Perrier,14967,220476,2022-07-27
CASH_IN,227140,Agence_mtn_Cotonou,300000,72860,Alexandre Blanchard,-440952,-213812,2022-07-03
CASH_IN,140762,Agence_mtn_Ouidah,300000,159238,Alexandre Blanchard,-213812,-73050,2022-07-06
CASH_IN,226976,Agence_mtn_Ouidah,300000,73024,Alexandre Blanchard,-73050,153926,2022-07-14
TRANSFER,345,Hélène Blanchard-Renault,49619,49274,Alexandre Blanchard,153926,154271,2022-07-14
CASH_OUT,94880,Alexandre Blanchard,154271,59391,Agence_mtn_Abomey,300000,205120,2022-07-17
CASH_IN,65447,Agence_mtn_Abomey,300000,234553,Alexandre Blanchard,59391,124838,2022-07-18
CASH_OUT,29922,Alexandre Blanchard,124838,94916,Agence_mtn_Abomey,300000,270078,2022-07-20
CASH_OUT,12084,Alexandre Blanchard,94916,82832,Agence_mtn_Ouidah,300000,287916,2022-07-21
CASH_IN,90977,Agence_mtn_Cotonou,300000,209023,Louis de la Imbert,-20382,70595,2022-07-06
TRANSFER,28110,Louis de la Imbert,70595,42485,François Vaillant,37672,9562,2022-07-10
CASH_IN,107347,Agence_mtn_Ouidah,300000,192653,Louis de la Imbert,42485,149832,2022-07-10
CASH_IN,39906,Agence_mtn_Abomey,300000,260094,Louis de la Imbert,149832,189738,2022-07-14
CASH_IN,111139,Agence_mtn_Abomey,300000,188861,Louis de la Imbert,189738,300877,2022-07-17
CASH_IN,41666,Agence_mtn_Abomey,300000,258334,Louis de la Imbert,300877,342543,2022-07-18
CASH_OUT,128737,Louis de la Imbert,342543,213806,Agence_mtn_Ouidah,300000,171263,2022-07-18
TRANSFER,72897,Louis de la Imbert,213806,140909,Jacques Laporte de Blanchet,133684,60787,2022-07-21
CASH_IN,176762,Agence_mtn_Cotonou,300000,123238,Louis de la Imbert,140909,317671,2022-07-21
CASH_OUT,118952,Louis de la Imbert,317671,198719,Agence_mtn_Abomey,300000,181048,2022-07-23
CASH_OUT,51194,Louis de la Imbert,198719,147525,Agence_mtn_Ouidah,300000,248806,2022-07-24
TRANSFER,103646,Louis de la Imbert,147525,43879,Aimé Bernier,267572,163926,2022-07-24
TRANSFER,27082,Louis de la Imbert,43879,16797,Michelle de la Daniel,1104545,1077463,2022-07-25
CASH_OUT,7465,Louis de la Imbert,16797,9332,Agence_mtn_Cotonou,300000,292535,2022-07-26
TRANSFER,1825,Sophie-Anouk Boulanger,3391,1566,Sabine Perrier,507612,505787,2022-07-01
CASH_OUT,865,Sophie-Anouk Boulanger,1566,701,Agence_mtn_Abomey,300000,299135,2022-07-05
CASH_IN,95325,Agence_mtn_Abomey,300000,204675,Sophie-Anouk Boulanger,701,96026,2022-07-07
CASH_IN,188522,Agence_mtn_Abomey,300000,111478,Sophie-Anouk Boulanger,96026,284548,2022-07-09
CASH_IN,10231,Agence_mtn_Abomey,300000,289769,Sophie-Anouk Boulanger,284548,294779,2022-07-14
CASH_IN,41562,Agence_mtn_Cotonou,300000,258438,Sophie-Anouk Boulanger,294779,336341,2022-07-16
TRANSFER,277005,Sophie-Anouk Boulanger,336341,59336,Valérie-Claudine Marin,31507,-245498,2022-07-17
CASH_IN,45276,Agence_mtn_Abomey,300000,254724,Sophie-Anouk Boulanger,59336,104612,2022-07-25
CASH_OUT,104645,Nicole-Renée Gay,176719,72074,Agence_mtn_Cotonou,300000,195355,2022-07-02
TRANSFER,45422,Nicole-Renée Gay,72074,26652,Raymond-Yves Boulanger,225195,179773,2022-07-03
CASH_IN,233161,Agence_mtn_Cotonou,300000,66839,Nicole-Renée Gay,26652,259813,2022-07-04
CASH_OUT,223160,Nicole-Renée Gay,259813,36653,Agence_mtn_Abomey,300000,76840,2022-07-09
CASH_IN,182294,Agence_mtn_Cotonou,300000,117706,Nicole-Renée Gay,36653,218947,2022-07-12
CASH_OUT,85680,Nicole-Renée Gay,218947,133267,Agence_mtn_Ouidah,300000,214320,2022-07-15
CASH_OUT,87098,Nicole-Renée Gay,133267,46169,Agence_mtn_Abomey,300000,212902,2022-07-15
CASH_IN,209720,Agence_mtn_Cotonou,300000,90280,Nicole-Renée Gay,46169,255889,2022-07-17
CASH_OUT,4005,Nicole-Renée Gay,255889,251884,Agence_mtn_Abomey,300000,295995,2022-07-19
CASH_OUT,175676,Nicole-Renée Gay,251884,76208,Agence_mtn_Ouidah,300000,124324,2022-07-23
CASH_IN,36644,Agence_mtn_Ouidah,300000,263356,Nicole-Renée Gay,76208,112852,2022-07-25
CASH_IN,155894,Agence_mtn_Cotonou,300000,144106,Anouk Delahaye-Gimenez,-47268,108626,2022-07-03
CASH_OUT,90501,Anouk Delahaye-Gimenez,108626,18125,Agence_mtn_Ouidah,300000,209499,2022-07-07
CASH_OUT,13289,Anouk Delahaye-Gimenez,18125,4836,Agence_mtn_Cotonou,300000,286711,2022-07-08
CASH_OUT,2059,Anouk Delahaye-Gimenez,4836,2777,Agence_mtn_Abomey,300000,297941,2022-07-11
TRANSFER,2417,Anouk Delahaye-Gimenez,2777,360,Sylvie Dupré,150723,148306,2022-07-14
CASH_OUT,355,Anouk Delahaye-Gimenez,360,5,Agence_mtn_Abomey,300000,299645,2022-07-17
CASH_IN,25574,Agence_mtn_Ouidah,300000,274426,Anouk Delahaye-Gimenez,5,25579,2022-07-18
CASH_IN,113842,Agence_mtn_Cotonou,300000,186158,Anouk Delahaye-Gimenez,25579,139421,2022-07-19
CASH_IN,82805,Agence_mtn_Abomey,300000,217195,Anouk Delahaye-Gimenez,139421,222226,2022-07-19
CASH_OUT,48325,Anouk Delahaye-Gimenez,222226,173901,Agence_mtn_Ouidah,300000,251675,2022-07-22
CASH_IN,185039,Agence_mtn_Cotonou,300000,114961,Anouk Delahaye-Gimenez,173901,358940,2022-07-24
CASH_OUT,308510,Anouk Delahaye-Gimenez,358940,50430,Agence_mtn_Abomey,300000,-8510,2022-07-24
CASH_OUT,29115,Anouk Delahaye-Gimenez,50430,21315,Agence_mtn_Abomey,300000,270885,2022-07-26
CASH_IN,215487,Agence_mtn_Ouidah,300000,84513,Gérard Blot de Blanc,-42893,172594,2022-07-02
CASH_OUT,109607,Gérard Blot de Blanc,172594,62987,Agence_mtn_Cotonou,300000,190393,2022-07-06
CASH_OUT,30012,Gérard Blot de Blanc,62987,32975,Agence_mtn_Cotonou,300000,269988,2022-07-07
TRANSFER,1443,Charles Guérin,1458,15,Gérard Blot de Blanc,32975,34418,2022-07-07
TRANSFER,11834,Gérard Blot de Blanc,34418,22584,Jacques Laporte de Blanchet,60787,48953,2022-07-10
CASH_IN,107387,Agence_mtn_Cotonou,300000,192613,Gérard Blot de Blanc,22584,129971,2022-07-12
CASH_IN,100400,Agence_mtn_Ouidah,300000,199600,Gérard Blot de Blanc,129971,230371,2022-07-13
TRANSFER,100466,Astrid de Pascal,164751,64285,Gérard Blot de Blanc,230371,330837,2022-07-16
CASH_IN,126870,Agence_mtn_Ouidah,300000,173130,Gérard Blot de Blanc,330837,457707,2022-07-17
TRANSFER,352967,Gérard Blot de Blanc,457707,104740,Josette du Hamon,1217945,864978,2022-07-20
CASH_OUT,46682,Gérard Blot de Blanc,104740,58058,Agence_mtn_Abomey,300000,253318,2022-07-24
TRANSFER,813289,Simone du Allard,917178,103889,Gérard Blot de Blanc,58058,871347,2022-07-24
TRANSFER,811827,Gérard Blot de Blanc,871347,59520,Sabine Perrier,505787,-306040,2022-07-25
CASH_OUT,40286,Gérard Blot de Blanc,59520,19234,Agence_mtn_Abomey,300000,259714,2022-07-25
TRANSFER,9165,Aimé Bernier,163926,154761,Gérard Blot de Blanc,19234,28399,2022-07-27
CASH_OUT,12046,Gérard Blot de Blanc,28399,16353,Agence_mtn_Abomey,300000,287954,2022-07-27
TRANSFER,52838,Josette du Hamon,864978,812140,Raymond-Yves Boulanger,179773,232611,2022-07-01
CASH_OUT,206289,Raymond-Yves Boulanger,232611,26322,Agence_mtn_Ouidah,300000,93711,2022-07-06
CASH_IN,61915,Agence_mtn_Abomey,300000,238085,Raymond-Yves Boulanger,26322,88237,2022-07-14
CASH_IN,26588,Agence_mtn_Abomey,300000,273412,Raymond-Yves Boulanger,88237,114825,2022-07-16
TRANSFER,91141,Raymond-Yves Boulanger,114825,23684,Olivier Benard,1220,-89921,2022-07-16
TRANSFER,610726,Michelle de la Daniel,1077463,466737,Raymond-Yves Boulanger,23684,634410,2022-07-16
CASH_OUT,322533,Raymond-Yves Boulanger,634410,311877,Agence_mtn_Ouidah,300000,-22533,2022-07-17
TRANSFER,73734,Raymond-Yves Boulanger,311877,238143,Gilbert Moulin,10778,-62956,2022-07-18
CASH_IN,74613,Agence_mtn_Cotonou,300000,225387,Raymond-Yves Boulanger,238143,312756,2022-07-21
TRANSFER,178752,Raymond-Yves Boulanger,312756,134004,Marc Baudry,581111,402359,2022-07-24
CASH_OUT,30513,Raymond-Yves Boulanger,134004,103491,Agence_mtn_Ouidah,300000,269487,2022-07-24
CASH_IN,221793,Agence_mtn_Ouidah,300000,78207,Raymond-Yves Boulanger,103491,325284,2022-07-24
TRANSFER,101989,Raymond-Yves Boulanger,325284,223295,Madeleine Hardy,36706,-65283,2022-07-26
CASH_IN,152113,Agence_mtn_Ouidah,300000,147887,Gérard Cordier,-135466,16647,2022-07-01
CASH_OUT,6528,Gérard Cordier,16647,10119,Agence_mtn_Cotonou,300000,293472,2022-07-05
TRANSFER,66240,Simone du Allard,103889,37649,Gérard Cordier,10119,76359,2022-07-07
CASH_OUT,70893,Gérard Cordier,76359,5466,Agence_mtn_Ouidah,300000,229107,2022-07-07
CASH_OUT,4598,Gérard Cordier,5466,868,Agence_mtn_Ouidah,300000,295402,2022-07-07
TRANSFER,35196,Hélène Blanchard-Renault,49274,14078,Gérard Cordier,868,36064,2022-07-08
TRANSFER,24409,Gérard Cordier,36064,11655,Astrid de Pascal,64285,39876,2022-07-11
CASH_OUT,377,Gérard Cordier,11655,11278,Agence_mtn_Ouidah,300000,299623,2022-07-12
TRANSFER,8004,Gérard Cordier,11278,3274,Marc Baudry,402359,394355,2022-07-12
CASH_IN,70175,Agence_mtn_Abomey,300000,229825,Gérard Cordier,3274,73449,2022-07-13
CASH_OUT,48365,Gérard Cordier,73449,25084,Agence_mtn_Abomey,300000,251635,2022-07-19
CASH_OUT,1309,Gérard Cordier,25084,23775,Agence_mtn_Ouidah,300000,298691,2022-07-19
CASH_IN,238939,Agence_mtn_Ouidah,300000,61061,Gérard Cordier,23775,262714,2022-07-24
TRANSFER,2773,Gérard Cordier,262714,259941,Françoise Denis de Allard,15842,13069,2022-07-27
CASH_IN,188250,Agence_mtn_Cotonou,300000,111750,Jacques Le Marion,-33940,154310,2022-07-06
CASH_IN,182678,Agence_mtn_Ouidah,300000,117322,Jacques Le Marion,154310,336988,2022-07-10
CASH_IN,134896,Agence_mtn_Ouidah,300000,165104,Jacques Le Marion,336988,471884,2022-07-11
TRANSFER,68075,Marcel de la Buisson,228337,160262,Jacques Le Marion,471884,539959,2022-07-12
TRANSFER,25936,Jacques Laporte de Blanchet,48953,23017,Jacques Le Marion,539959,565895,2022-07-13
TRANSFER,95430,Josette du Hamon,812140,716710,Jacques Le Marion,565895,661325,2022-07-14
TRANSFER,190172,Jacques Le Marion,661325,471153,Jacques Le Marion,661325,471153,2022-07-15
TRANSFER,76123,Jacques Le Marion,471153,395030,François Vaillant,9562,-66561,2022-07-15
TRANSFER,284292,Jacques Le Marion,395030,110738,Astrid de Pascal,39876,-244416,2022-07-21
CASH_IN,160071,Agence_mtn_Abomey,300000,139929,Jacques Le Marion,110738,270809,2022-07-21
CASH_IN,203508,Agence_mtn_Abomey,300000,96492,Jacques Le Marion,270809,474317,2022-07-25
CASH_IN,121184,Agence_mtn_Ouidah,300000,178816,Jacques Le Marion,474317,595501,2022-07-27
CASH_IN,47032,Agence_mtn_Cotonou,300000,252968,Michelle de la Daniel,466737,513769,2022-07-06
TRANSFER,9996,Jacques Laporte de Blanchet,23017,13021,Michelle de la Daniel,513769,523765,2022-07-07
TRANSFER,322191,Michelle de la Daniel,523765,201574,Michelle de la Daniel,523765,845956,2022-07-09
CASH_OUT,165941,Michelle de la Daniel,201574,35633,Agence_mtn_Abomey,300000,134059,2022-07-13
TRANSFER,5529,Michelle de la Daniel,35633,30104,Aimé Bernier,154761,149232,2022-07-18
CASH_OUT,4245,Michelle de la Daniel,30104,25859,Agence_mtn_Abomey,300000,295755,2022-07-19
CASH_IN,244751,Agence_mtn_Ouidah,300000,55249,Michelle de la Daniel,25859,270610,2022-07-22
CASH_OUT,53069,Michelle de la Daniel,270610,217541,Agence_mtn_Abomey,300000,246931,2022-07-22
CASH_OUT,60145,Michelle de la Daniel,217541,157396,Agence_mtn_Ouidah,300000,239855,2022-07-24
TRANSFER,144014,Michelle de la Daniel,157396,13382,Marcel de la Buisson,160262,16248,2022-07-27
CASH_IN,126647,Agence_mtn_Ouidah,300000,173353,Maurice de Brunet,-186128,-59481,2022-07-07
CASH_IN,202169,Agence_mtn_Cotonou,300000,97831,Maurice de Brunet,-59481,142688,2022-07-07
CASH_OUT,127368,Maurice de Brunet,142688,15320,Agence_mtn_Cotonou,300000,172632,2022-07-09
CASH_OUT,2166,Maurice de Brunet,15320,13154,Agence_mtn_Cotonou,300000,297834,2022-07-11
CASH_IN,7573,Agence_mtn_Cotonou,300000,292427,Maurice de Brunet,13154,20727,2022-07-14
TRANSFER,13349,Simone du Allard,37649,24300,Maurice de Brunet,20727,34076,2022-07-15
CASH_IN,71983,Agence_mtn_Abomey,300000,228017,Maurice de Brunet,34076,106059,2022-07-15
CASH_OUT,70388,Maurice de Brunet,106059,35671,Agence_mtn_Ouidah,300000,229612,2022-07-26
CASH_OUT,12387,Maurice de Brunet,35671,23284,Agence_mtn_Cotonou,300000,287613,2022-07-27
CASH_IN,290722,Agence_mtn_Abomey,300000,9278,Valérie de Pottier,-397140,-106418,2022-07-01
CASH_IN,241998,Agence_mtn_Abomey,300000,58002,Valérie de Pottier,-106418,135580,2022-07-01
CASH_IN,280231,Agence_mtn_Cotonou,300000,19769,Valérie de Pottier,135580,415811,2022-07-06
TRANSFER,132159,Valérie de Pottier,415811,283652,Valérie de Pottier,415811,283652,2022-07-07
CASH_IN,192756,Agence_mtn_Abomey,300000,107244,Valérie de Pottier,283652,476408,2022-07-08
CASH_OUT,128375,Valérie de Pottier,476408,348033,Agence_mtn_Ouidah,300000,171625,2022-07-08
CASH_IN,96642,Agence_mtn_Abomey,300000,203358,Valérie de Pottier,348033,444675,2022-07-12
CASH_IN,100979,Agence_mtn_Abomey,300000,199021,Valérie de Pottier,444675,545654,2022-07-13
CASH_IN,259009,Agence_mtn_Cotonou,300000,40991,Valérie de Pottier,545654,804663,2022-07-14
CASH_OUT,265521,Valérie de Pottier,804663,539142,Agence_mtn_Cotonou,300000,34479,2022-07-16
TRANSFER,283491,Valérie de Pottier,539142,255651,Josette du Hamon,716710,433219,2022-07-18
TRANSFER,226878,Valérie de Pottier,255651,28773,Sylvie Dupré,148306,-78572,2022-07-20
TRANSFER,6046,Hélène Blanchard-Renault,14078,8032,Valérie de Pottier,28773,34819,2022-07-21
CASH_OUT,21658,Valérie de Pottier,34819,13161,Agence_mtn_Abomey,300000,278342,2022-07-21
TRANSFER,2849,Hélène Blanchard-Renault,8032,5183,Valérie de Pottier,13161,16010,2022-07-24
CASH_IN,72523,Agence_mtn_Abomey,300000,227477,Valérie de Pottier,16010,88533,2022-07-25
TRANSFER,59967,Valérie de Pottier,88533,28566,Marc Baudry,394355,334388,2022-07-26
CASH_IN,129697,Agence_mtn_Ouidah,300000,170303,Valérie de Pottier,28566,158263,2022-07-26
CASH_OUT,73141,Valérie de Pottier,158263,85122,Agence_mtn_Cotonou,300000,226859,2022-07-27
CASH_IN,124680,Agence_mtn_Cotonou,300000,175320,Gilbert Moulin,-62956,61724,2022-07-01
CASH_OUT,39924,Gilbert Moulin,61724,21800,Agence_mtn_Ouidah,300000,260076,2022-07-01
CASH_OUT,20269,Gilbert Moulin,21800,1531,Agence_mtn_Abomey,300000,279731,2022-07-01
CASH_IN,20801,Agence_mtn_Abomey,300000,279199,Gilbert Moulin,1531,22332,2022-07-04
CASH_IN,179115,Agence_mtn_Cotonou,300000,120885,Gilbert Moulin,22332,201447,2022-07-08
CASH_OUT,22640,Gilbert Moulin,201447,178807,Agence_mtn_Abomey,300000,277360,2022-07-10
CASH_OUT,51214,Gilbert Moulin,178807,127593,Agence_mtn_Abomey,300000,248786,2022-07-10
CASH_OUT,107944,Gilbert Moulin,127593,19649,Agence_mtn_Cotonou,300000,192056,2022-07-11
CASH_OUT,16781,Gilbert Moulin,19649,2868,Agence_mtn_Ouidah,300000,283219,2022-07-14
CASH_IN,45965,Agence_mtn_Cotonou,300000,254035,Gilbert Moulin,2868,48833,2022-07-21
CASH_IN,189062,Agence_mtn_Ouidah,300000,110938,Gilbert Moulin,48833,237895,2022-07-22
TRANSFER,86795,Gilbert Moulin,237895,151100,Hélène Blanchard-Renault,5183,-81612,2022-07-22
CASH_IN,217763,Agence_mtn_Ouidah,300000,82237,Gilbert Moulin,151100,368863,2022-07-25
CASH_OUT,263211,Gilbert Moulin,368863,105652,Agence_mtn_Cotonou,300000,36789,2022-07-26
CASH_IN,207582,Agence_mtn_Abomey,300000,92418,Gilbert Moulin,105652,313234,2022-07-27
CASH_IN,243398,Agence_mtn_Abomey,300000,56602,Astrid Aubert-Thierry,1318313,1561711,2022-07-01
CASH_OUT,452196,Astrid Aubert-Thierry,1561711,1109515,Agence_mtn_Ouidah,300000,-152196,2022-07-06
CASH_OUT,544623,Astrid Aubert-Thierry,1109515,564892,Agence_mtn_Cotonou,300000,-244623,2022-07-09
CASH_OUT,495916,Astrid Aubert-Thierry,564892,68976,Agence_mtn_Ouidah,300000,-195916,2022-07-11
TRANSFER,70133,Josette du Hamon,433219,363086,Astrid Aubert-Thierry,68976,139109,2022-07-13
TRANSFER,127233,Astrid Aubert-Thierry,139109,11876,Aimé Bernier,149232,21999,2022-07-14
TRANSFER,2177,Astrid Aubert-Thierry,11876,9699,Astrid Aubert-Thierry,11876,9699,2022-07-15
TRANSFER,9179,Astrid Aubert-Thierry,9699,520,Josette du Hamon,363086,353907,2022-07-18
CASH_OUT,160,Astrid Aubert-Thierry,520,360,Agence_mtn_Cotonou,300000,299840,2022-07-21
CASH_IN,234098,Agence_mtn_Cotonou,300000,65902,Astrid Aubert-Thierry,360,234458,2022-07-22
CASH_IN,49981,Agence_mtn_Ouidah,300000,250019,Astrid Aubert-Thierry,234458,284439,2022-07-24
TRANSFER,153039,Astrid Aubert-Thierry,284439,131400,Josette du Hamon,353907,200868,2022-07-25
TRANSFER,126,Josette du Hamon,200868,200742,Astrid Aubert-Thierry,131400,131526,2022-07-26
TRANSFER,130552,Josette du Hamon,200742,70190,Astrid Aubert-Thierry,131526,262078,2022-07-27
CASH_IN,238668,Agence_mtn_Abomey,300000,61332,Élisabeth Blot-Bruneau,-486458,-247790,2022-07-01
CASH_IN,196051,Agence_mtn_Cotonou,300000,103949,Élisabeth Blot-Bruneau,-247790,-51739,2022-07-03
CASH_IN,112130,Agence_mtn_Ouidah,300000,187870,Élisabeth Blot-Bruneau,-51739,60391,2022-07-09
CASH_OUT,10858,Élisabeth Blot-Bruneau,60391,49533,Agence_mtn_Cotonou,300000,289142,2022-07-12
TRANSFER,9890,Françoise Denis de Allard,13069,3179,Élisabeth Blot-Bruneau,49533,59423,2022-07-14
CASH_OUT,44026,Élisabeth Blot-Bruneau,59423,15397,Agence_mtn_Abomey,300000,255974,2022-07-18
CASH_IN,150026,Agence_mtn_Abomey,300000,149974,Marc Baudry,334388,484414,2022-07-01
TRANSFER,1992,Françoise Denis de Allard,3179,1187,Marc Baudry,484414,486406,2022-07-02
CASH_OUT,224870,Marc Baudry,486406,261536,Agence_mtn_Cotonou,300000,75130,2022-07-02
CASH_OUT,113387,Marc Baudry,261536,148149,Agence_mtn_Cotonou,300000,186613,2022-07-05
CASH_OUT,42515,Marc Baudry,148149,105634,Agence_mtn_Cotonou,300000,257485,2022-07-11
CASH_OUT,55624,Marc Baudry,105634,50010,Agence_mtn_Ouidah,300000,244376,2022-07-17
CASH_IN,21252,Agence_mtn_Ouidah,300000,278748,Marc Baudry,50010,71262,2022-07-21
CASH_IN,111184,Agence_mtn_Ouidah,300000,188816,Marc Baudry,71262,182446,2022-07-21
TRANSFER,20810,Marc Baudry,182446,161636,Françoise Denis de Allard,1187,-19623,2022-07-22
CASH_IN,117399,Agence_mtn_Ouidah,300000,182601,Marc Baudry,161636,279035,2022-07-24
CASH_IN,59444,Agence_mtn_Abomey,300000,240556,Marc Baudry,279035,338479,2022-07-27
CASH_IN,290348,Agence_mtn_Abomey,300000,9652,Astrid de Pascal,-244416,45932,2022-07-03
CASH_IN,22034,Agence_mtn_Ouidah,300000,277966,Astrid de Pascal,45932,67966,2022-07-09
CASH_IN,29659,Agence_mtn_Cotonou,300000,270341,Astrid de Pascal,67966,97625,2022-07-09
TRANSFER,54283,Josette du Hamon,70190,15907,Astrid de Pascal,97625,151908,2022-07-18
TRANSFER,85540,Astrid de Pascal,151908,66368,Aimé Bernier,21999,-63541,2022-07-19
TRANSFER,51035,Astrid de Pascal,66368,15333,Josette du Hamon,15907,-35128,2022-07-19
CASH_IN,124161,Agence_mtn_Abomey,300000,175839,Astrid de Pascal,15333,139494,2022-07-20
CASH_IN,129164,Agence_mtn_Cotonou,300000,170836,Astrid de Pascal,139494,268658,2022-07-20
TRANSFER,170672,Astrid de Pascal,268658,97986,Marcel de la Buisson,16248,-154424,2022-07-24
CASH_IN,22283,Agence_mtn_Abomey,300000,277717,Astrid de Pascal,97986,120269,2022-07-25
CASH_IN,134888,Agence_mtn_Abomey,300000,165112,Laurent Marion,-20076,114812,2022-07-01
CASH_OUT,58139,Laurent Marion,114812,56673,Agence_mtn_Abomey,300000,241861,2022-07-08
CASH_IN,81185,Agence_mtn_Cotonou,300000,218815,Laurent Marion,56673,137858,2022-07-10
CASH_IN,187287,Agence_mtn_Ouidah,300000,112713,Laurent Marion,137858,325145,2022-07-11
CASH_IN,121313,Agence_mtn_Abomey,300000,178687,Laurent Marion,325145,446458,2022-07-19
TRANSFER,22984,Simone du Allard,24300,1316,Laurent Marion,446458,469442,2022-07-22
CASH_OUT,44254,Laurent Marion,469442,425188,Agence_mtn_Abomey,300000,255746,2022-07-22
TRANSFER,11642,Jacques Laporte de Blanchet,13021,1379,Laurent Marion,425188,436830,2022-07-25
CASH_IN,170336,Agence_mtn_Ouidah,300000,129664,Laurent Marion,436830,607166,2022-07-26
CASH_IN,83695,Agence_mtn_Cotonou,300000,216305,Emmanuel Vallée,-370635,-286940,2022-07-04
CASH_IN,125394,Agence_mtn_Cotonou,300000,174606,Emmanuel Vallée,-286940,-161546,2022-07-06
CASH_IN,202851,Agence_mtn_Ouidah,300000,97149,Emmanuel Vallée,-161546,41305,2022-07-06
CASH_IN,262010,Agence_mtn_Abomey,300000,37990,Emmanuel Vallée,41305,303315,2022-07-08
CASH_IN,278317,Agence_mtn_Ouidah,300000,21683,Emmanuel Vallée,303315,581632,2022-07-09
TRANSFER,156656,Emmanuel Vallée,581632,424976,Simone du Allard,1316,-155340,2022-07-10
TRANSFER,344684,Emmanuel Vallée,424976,80292,Emmanuel Vallée,424976,769660,2022-07-12
CASH_OUT,36451,Emmanuel Vallée,80292,43841,Agence_mtn_Ouidah,300000,263549,2022-07-14
CASH_OUT,29493,Emmanuel Vallée,43841,14348,Agence_mtn_Ouidah,300000,270507,2022-07-16
CASH_OUT,11737,Emmanuel Vallée,14348,2611,Agence_mtn_Abomey,300000,288263,2022-07-18
TRANSFER,2476,Emmanuel Vallée,2611,135,Jacques Laporte de Blanchet,1379,-1097,2022-07-19
CASH_OUT,125,Emmanuel Vallée,135,10,Agence_mtn_Abomey,300000,299875,2022-07-24
CASH_IN,272595,Agence_mtn_Cotonou,300000,27405,Emmanuel Vallée,10,272605,2022-07-26
CASH_IN,18753,Agence_mtn_Ouidah,300000,281247,Roger-Roger Delmas,-81932,-63179,2022-07-02
CASH_IN,277223,Agence_mtn_Abomey,300000,22777,Roger-Roger Delmas,-63179,214044,2022-07-05
TRANSFER,20122,Roger-Roger Delmas,214044,193922,Roger-Roger Delmas,214044,193922,2022-07-13
TRANSFER,94594,Roger-Roger Delmas,193922,99328,Roger-Roger Delmas,193922,99328,2022-07-13
TRANSFER,15158,Roger-Roger Delmas,99328,84170,Roger-Roger Delmas,99328,114486,2022-07-17
CASH_IN,35143,Agence_mtn_Cotonou,300000,264857,Roger-Roger Delmas,84170,119313,2022-07-17
CASH_OUT,22595,Roger-Roger Delmas,119313,96718,Agence_mtn_Cotonou,300000,277405,2022-07-17
CASH_OUT,23390,Roger-Roger Delmas,96718,73328,Agence_mtn_Ouidah,300000,276610,2022-07-18
CASH_IN,61502,Agence_mtn_Abomey,300000,238498,Roger-Roger Delmas,73328,134830,2022-07-18
TRANSFER,81878,Roger-Roger Delmas,134830,52952,Roger-Roger Delmas,134830,216708,2022-07-19
CASH_OUT,33827,Roger-Roger Delmas,52952,19125,Agence_mtn_Ouidah,300000,266173,2022-07-19
CASH_OUT,6323,Roger-Roger Delmas,19125,12802,Agence_mtn_Ouidah,300000,293677,2022-07-19
CASH_OUT,5670,Roger-Roger Delmas,12802,7132,Agence_mtn_Abomey,300000,294330,2022-07-21
CASH_OUT,824,Roger-Roger Delmas,7132,6308,Agence_mtn_Abomey,300000,299176,2022-07-22
CASH_IN,41221,Agence_mtn_Abomey,300000,258779,Roger-Roger Delmas,6308,47529,2022-07-23
CASH_IN,94481,Agence_mtn_Cotonou,300000,205519,Roger-Roger Delmas,47529,142010,2022-07-24
CASH_IN,83513,Agence_mtn_Abomey,300000,216487,Roger-Roger Delmas,142010,225523,2022-07-24
CASH_IN,69160,Agence_mtn_Cotonou,300000,230840,François Vaillant,-66561,2599,2022-07-01
CASH_IN,68718,Agence_mtn_Cotonou,300000,231282,François Vaillant,2599,71317,2022-07-10
CASH_OUT,28207,François Vaillant,71317,43110,Agence_mtn_Ouidah,300000,271793,2022-07-15
CASH_IN,264854,Agence_mtn_Ouidah,300000,35146,François Vaillant,43110,307964,2022-07-15
CASH_IN,95911,Agence_mtn_Cotonou,300000,204089,François Vaillant,307964,403875,2022-07-15
CASH_IN,2091,Agence_mtn_Abomey,300000,297909,François Vaillant,403875,405966,2022-07-17
CASH_OUT,43757,François Vaillant,405966,362209,Agence_mtn_Cotonou,300000,256243,2022-07-22
CASH_OUT,236222,François Vaillant,362209,125987,Agence_mtn_Abomey,300000,63778,2022-07-24
CASH_OUT,78376,François Vaillant,125987,47611,Agence_mtn_Cotonou,300000,221624,2022-07-27
CASH_IN,116035,Agence_mtn_Abomey,300000,183965,Raymond Simon,-141297,-25262,2022-07-02
CASH_IN,131115,Agence_mtn_Abomey,300000,168885,Raymond Simon,-25262,105853,2022-07-04
TRANSFER,95826,Raymond Simon,105853,10027,Raymond Simon,105853,10027,2022-07-04
CASH_IN,256970,Agence_mtn_Abomey,300000,43030,Raymond Simon,10027,266997,2022-07-05
CASH_OUT,31675,Raymond Simon,266997,235322,Agence_mtn_Ouidah,300000,268325,2022-07-12
CASH_OUT,225317,Raymond Simon,235322,10005,Agence_mtn_Cotonou,300000,74683,2022-07-12
CASH_IN,297429,Agence_mtn_Cotonou,300000,2571,Raymond Simon,10005,307434,2022-07-16
CASH_OUT,241531,Raymond Simon,307434,65903,Agence_mtn_Ouidah,300000,58469,2022-07-25
CASH_IN,145723,Agence_mtn_Abomey,300000,154277,Françoise Denis de Allard,-19623,126100,2022-07-01
CASH_IN,190300,Agence_mtn_Cotonou,300000,109700,Françoise Denis de Allard,126100,316400,2022-07-01
TRANSFER,109191,Françoise Denis de Allard,316400,207209,Françoise Denis de Allard,316400,207209,2022-07-01
TRANSFER,69094,Françoise Denis de Allard,207209,138115,Françoise Denis de Allard,207209,138115,2022-07-03
CASH_IN,277462,Agence_mtn_Ouidah,300000,22538,Françoise Denis de Allard,138115,415577,2022-07-04
CASH_OUT,117626,Françoise Denis de Allard,415577,297951,Agence_mtn_Abomey,300000,182374,2022-07-05
TRANSFER,206744,Françoise Denis de Allard,297951,91207,Françoise Denis de Allard,297951,91207,2022-07-08
CASH_OUT,54329,Françoise Denis de Allard,91207,36878,Agence_mtn_Abomey,300000,245671,2022-07-11
CASH_OUT,24982,Françoise Denis de Allard,36878,11896,Agence_mtn_Abomey,300000,275018,2022-07-17
CASH_OUT,1489,Françoise Denis de Allard,11896,10407,Agence_mtn_Abomey,300000,298511,2022-07-27
CASH_IN,169279,Agence_mtn_Abomey,300000,130721,Hélène Blanchard-Renault,-81612,87667,2022-07-01
CASH_IN,66393,Agence_mtn_Cotonou,300000,233607,Hélène Blanchard-Renault,87667,154060,2022-07-02
CASH_IN,116223,Agence_mtn_Ouidah,300000,183777,Hélène Blanchard-Renault,154060,270283,2022-07-04
TRANSFER,139917,Hélène Blanchard-Renault,270283,130366,Hélène Blanchard-Renault,270283,130366,2022-07-05
CASH_OUT,120487,Hélène Blanchard-Renault,130366,9879,Agence_mtn_Abomey,300000,179513,2022-07-05
CASH_IN,280084,Agence_mtn_Cotonou,300000,19916,Hélène Blanchard-Renault,9879,289963,2022-07-08
CASH_OUT,184373,Hélène Blanchard-Renault,289963,105590,Agence_mtn_Ouidah,300000,115627,2022-07-08
CASH_OUT,24240,Hélène Blanchard-Renault,105590,81350,Agence_mtn_Abomey,300000,275760,2022-07-08
CASH_OUT,33595,Hélène Blanchard-Renault,81350,47755,Agence_mtn_Abomey,300000,266405,2022-07-11
CASH_IN,94255,Agence_mtn_Abomey,300000,205745,Hélène Blanchard-Renault,47755,142010,2022-07-13
CASH_IN,233260,Agence_mtn_Abomey,300000,66740,Hélène Blanchard-Renault,142010,375270,2022-07-16
CASH_IN,178462,Agence_mtn_Abomey,300000,121538,Hélène Blanchard-Renault,375270,553732,2022-07-17
CASH_OUT,98776,Hélène Blanchard-Renault,553732,454956,Agence_mtn_Ouidah,300000,201224,2022-07-20
CASH_IN,181720,Agence_mtn_Ouidah,300000,118280,Hélène Blanchard-Renault,454956,636676,2022-07-21
CASH_OUT,153212,Hélène Blanchard-Renault,636676,483464,Agence_mtn_Cotonou,300000,146788,2022-07-22
CASH_OUT,378579,Hélène Blanchard-Renault,483464,104885,Agence_mtn_Cotonou,300000,-78579,2022-07-27
CASH_IN,176593,Agence_mtn_Cotonou,300000,123407,Sabine Perrier,-306040,-129447,2022-07-01
CASH_IN,87048,Agence_mtn_Cotonou,300000,212952,Sabine Perrier,-129447,-42399,2022-07-02
CASH_IN,299745,Agence_mtn_Cotonou,300000,255,Sabine Perrier,-42399,257346,2022-07-05
CASH_IN,227816,Agence_mtn_Abomey,300000,72184,Sabine Perrier,257346,485162,2022-07-08
CASH_IN,284196,Agence_mtn_Cotonou,300000,15804,Sabine Perrier,485162,769358,2022-07-10
CASH_OUT,746108,Sabine Perrier,769358,23250,Agence_mtn_Ouidah,300000,-446108,2022-07-16
TRANSFER,14351,Sabine Perrier,23250,8899,Sabine Perrier,23250,37601,2022-07-16
CASH_IN,116089,Agence_mtn_Ouidah,300000,183911,Sabine Perrier,8899,124988,2022-07-17
CASH_OUT,57340,Sabine Perrier,124988,67648,Agence_mtn_Ouidah,300000,242660,2022-07-17
TRANSFER,8599,Sabine Perrier,67648,59049,Sabine Perrier,67648,76247,2022-07-20
CASH_OUT,18200,Sabine Perrier,59049,40849,Agence_mtn_Abomey,300000,281800,2022-07-21
CASH_OUT,35648,Sabine Perrier,40849,5201,Agence_mtn_Abomey,300000,264352,2022-07-22
CASH_IN,122168,Agence_mtn_Ouidah,300000,177832,Sabine Perrier,5201,127369,2022-07-25
CASH_OUT,29354,Sabine Perrier,127369,98015,Agence_mtn_Abomey,300000,270646,2022-07-25
CASH_IN,157681,Agence_mtn_Abomey,300000,142319,Louis du Boyer,-366324,-208643,2022-07-08
CASH_IN,131922,Agence_mtn_Abomey,300000,168078,Louis du Boyer,-208643,-76721,2022-07-09
CASH_IN,117977,Agence_mtn_Abomey,300000,182023,Louis du Boyer,-76721,41256,2022-07-13
CASH_IN,207289,Agence_mtn_Cotonou,300000,92711,Louis du Boyer,41256,248545,2022-07-14
TRANSFER,177287,Louis du Boyer,248545,71258,Louis du Boyer,248545,425832,2022-07-17
CASH_IN,280548,Agence_mtn_Cotonou,300000,19452,Louis du Boyer,71258,351806,2022-07-17
CASH_IN,35892,Agence_mtn_Abomey,300000,264108,Louis du Boyer,351806,387698,2022-07-18
CASH_IN,98316,Agence_mtn_Abomey,300000,201684,Louis du Boyer,387698,486014,2022-07-22
CASH_IN,191753,Agence_mtn_Cotonou,300000,108247,Louis du Boyer,486014,677767,2022-07-25
CASH_IN,150321,Agence_mtn_Ouidah,300000,149679,Gabrielle Hamon,-66280,84041,2022-07-05
CASH_OUT,11904,Gabrielle Hamon,84041,72137,Agence_mtn_Cotonou,300000,288096,2022-07-05
CASH_IN,127228,Agence_mtn_Cotonou,300000,172772,Gabrielle Hamon,72137,199365,2022-07-10
TRANSFER,144324,Gabrielle Hamon,199365,55041,Gabrielle Hamon,199365,55041,2022-07-11
TRANSFER,21513,Gabrielle Hamon,55041,33528,Gabrielle Hamon,55041,33528,2022-07-15
CASH_IN,298697,Agence_mtn_Abomey,300000,1303,Gabrielle Hamon,33528,332225,2022-07-16
CASH_OUT,266426,Gabrielle Hamon,332225,65799,Agence_mtn_Abomey,300000,33574,2022-07-18
CASH_IN,209932,Agence_mtn_Ouidah,300000,90068,Gabrielle Hamon,65799,275731,2022-07-21
CASH_OUT,76613,Gabrielle Hamon,275731,199118,Agence_mtn_Cotonou,300000,223387,2022-07-21
CASH_IN,193711,Agence_mtn_Cotonou,300000,106289,Jules-Marc Chauvet,-100729,92982,2022-07-01
TRANSFER,10551,Jules-Marc Chauvet,92982,82431,Jules-Marc Chauvet,92982,103533,2022-07-03
TRANSFER,4829,Jules-Marc Chauvet,82431,77602,Jules-Marc Chauvet,82431,77602,2022-07-04
TRANSFER,17605,Jules-Marc Chauvet,77602,59997,Jules-Marc Chauvet,77602,59997,2022-07-06
CASH_IN,258304,Agence_mtn_Cotonou,300000,41696,Jules-Marc Chauvet,59997,318301,2022-07-07
CASH_OUT,4409,Jules-Marc Chauvet,318301,313892,Agence_mtn_Abomey,300000,295591,2022-07-07
CASH_OUT,205017,Jules-Marc Chauvet,313892,108875,Agence_mtn_Cotonou,300000,94983,2022-07-08
CASH_IN,247347,Agence_mtn_Ouidah,300000,52653,Jules-Marc Chauvet,108875,356222,2022-07-09
CASH_OUT,80875,Jules-Marc Chauvet,356222,275347,Agence_mtn_Ouidah,300000,219125,2022-07-09
CASH_OUT,198404,Jules-Marc Chauvet,275347,76943,Agence_mtn_Cotonou,300000,101596,2022-07-11
CASH_IN,264428,Agence_mtn_Abomey,300000,35572,Jules-Marc Chauvet,76943,341371,2022-07-13
CASH_OUT,324823,Jules-Marc Chauvet,341371,16548,Agence_mtn_Abomey,300000,-24823,2022-07-19
CASH_OUT,177,Jules-Marc Chauvet,16548,16371,Agence_mtn_Ouidah,300000,299823,2022-07-20
CASH_OUT,11200,Jules-Marc Chauvet,16371,5171,Agence_mtn_Ouidah,300000,288800,2022-07-24
CASH_IN,262196,Agence_mtn_Abomey,300000,37804,Jules-Marc Chauvet,5171,267367,2022-07-26
CASH_IN,30460,Agence_mtn_Ouidah,300000,269540,Nathalie Da Silva,-107372,-76912,2022-07-05
CASH_IN,93843,Agence_mtn_Ouidah,300000,206157,Nathalie Da Silva,-76912,16931,2022-07-05
TRANSFER,11062,Nathalie Da Silva,16931,5869,Nathalie Da Silva,16931,5869,2022-07-06
TRANSFER,1197,Nathalie Da Silva,5869,4672,Nathalie Da Silva,5869,4672,2022-07-07
CASH_OUT,1927,Nathalie Da Silva,4672,2745,Agence_mtn_Cotonou,300000,298073,2022-07-08
CASH_OUT,529,Nathalie Da Silva,2745,2216,Agence_mtn_Cotonou,300000,299471,2022-07-09
CASH_IN,289500,Agence_mtn_Abomey,300000,10500,Nathalie Da Silva,2216,291716,2022-07-10
CASH_OUT,62188,Nathalie Da Silva,291716,229528,Agence_mtn_Ouidah,300000,237812,2022-07-12
CASH_OUT,55724,Nathalie Da Silva,229528,173804,Agence_mtn_Cotonou,300000,244276,2022-07-13
CASH_IN,188959,Agence_mtn_Cotonou,300000,111041,Nathalie Da Silva,173804,362763,2022-07-15
CASH_OUT,307921,Nathalie Da Silva,362763,54842,Agence_mtn_Cotonou,300000,-7921,2022-07-16
CASH_OUT,32933,Nathalie Da Silva,54842,21909,Agence_mtn_Abomey,300000,267067,2022-07-18
CASH_OUT,20288,Nathalie Da Silva,21909,1621,Agence_mtn_Cotonou,300000,279712,2022-07-19
CASH_OUT,477,Nathalie Da Silva,1621,1144,Agence_mtn_Cotonou,300000,299523,2022-07-22
CASH_OUT,1129,Nathalie Da Silva,1144,15,Agence_mtn_Abomey,300000,298871,2022-07-25
CASH_IN,181020,Agence_mtn_Cotonou,300000,118980,Sylvie Dupré,-78572,102448,2022-07-01
CASH_IN,44146,Agence_mtn_Ouidah,300000,255854,Sylvie Dupré,102448,146594,2022-07-03
CASH_OUT,34182,Sylvie Dupré,146594,112412,Agence_mtn_Cotonou,300000,265818,2022-07-03
TRANSFER,76638,Sylvie Dupré,112412,35774,Sylvie Dupré,112412,35774,2022-07-06
TRANSFER,29986,Sylvie Dupré,35774,5788,Sylvie Dupré,35774,65760,2022-07-07
CASH_IN,223101,Agence_mtn_Abomey,300000,76899,Sylvie Dupré,5788,228889,2022-07-12
TRANSFER,44760,Sylvie Dupré,228889,184129,Sylvie Dupré,228889,273649,2022-07-15
CASH_IN,67033,Agence_mtn_Cotonou,300000,232967,Sylvie Dupré,184129,251162,2022-07-21
CASH_IN,44417,Agence_mtn_Ouidah,300000,255583,Sylvie Dupré,251162,295579,2022-07-23
CASH_IN,285428,Agence_mtn_Cotonou,300000,14572,Sylvie Dupré,295579,581007,2022-07-23
CASH_OUT,455836,Sylvie Dupré,581007,125171,Agence_mtn_Ouidah,300000,-155836,2022-07-23
CASH_OUT,22217,Sylvie Dupré,125171,102954,Agence_mtn_Cotonou,300000,277783,2022-07-24
CASH_IN,154820,Agence_mtn_Ouidah,300000,145180,Michèle Faivre,-157400,-2580,2022-07-04
CASH_IN,1347,Agence_mtn_Cotonou,300000,298653,Michèle Faivre,-2580,-1233,2022-07-07
CASH_IN,100083,Agence_mtn_Ouidah,300000,199917,Michèle Faivre,-1233,98850,2022-07-08
TRANSFER,88187,Michèle Faivre,98850,10663,Michèle Faivre,98850,187037,2022-07-10
TRANSFER,4527,Michèle Faivre,10663,6136,Michèle Faivre,10663,6136,2022-07-11
TRANSFER,2283,Michèle Faivre,6136,3853,Michèle Faivre,6136,8419,2022-07-14
CASH_OUT,1779,Michèle Faivre,3853,2074,Agence_mtn_Abomey,300000,298221,2022-07-15
TRANSFER,910,Michèle Faivre,2074,1164,Michèle Faivre,2074,1164,2022-07-15
TRANSFER,212,Michèle Faivre,1164,952,Michèle Faivre,1164,952,2022-07-17
CASH_IN,257313,Agence_mtn_Abomey,300000,42687,Michèle Faivre,952,258265,2022-07-18
CASH_IN,240211,Agence_mtn_Ouidah,300000,59789,Michèle Faivre,258265,498476,2022-07-19
CASH_IN,236924,Agence_mtn_Cotonou,300000,63076,Michèle Faivre,498476,735400,2022-07-19
CASH_OUT,257791,Michèle Faivre,735400,477609,Agence_mtn_Ouidah,300000,42209,2022-07-19
CASH_IN,22112,Agence_mtn_Cotonou,300000,277888,Michèle Faivre,477609,499721,2022-07-25
CASH_OUT,350370,Michèle Faivre,499721,149351,Agence_mtn_Abomey,300000,-50370,2022-07-27
CASH_IN,220993,Agence_mtn_Abomey,300000,79007,Charles Guérin,15,221008,2022-07-01
TRANSFER,59286,Charles Guérin,221008,161722,Charles Guérin,221008,161722,2022-07-05
TRANSFER,19880,Charles Guérin,161722,141842,Charles Guérin,161722,141842,2022-07-09
CASH_IN,249192,Agence_mtn_Ouidah,300000,50808,Charles Guérin,141842,391034,2022-07-10
CASH_OUT,3195,Charles Guérin,391034,387839,Agence_mtn_Abomey,300000,296805,2022-07-12
CASH_OUT,138391,Charles Guérin,387839,249448,Agence_mtn_Ouidah,300000,161609,2022-07-14
CASH_OUT,193837,Charles Guérin,249448,55611,Agence_mtn_Abomey,300000,106163,2022-07-15
CASH_OUT,51238,Charles Guérin,55611,4373,Agence_mtn_Ouidah,300000,248762,2022-07-17
CASH_IN,246756,Agence_mtn_Ouidah,300000,53244,Charles Guérin,4373,251129,2022-07-21
CASH_OUT,113398,Charles Guérin,251129,137731,Agence_mtn_Cotonou,300000,186602,2022-07-23
CASH_IN,181741,Agence_mtn_Abomey,300000,118259,Alfred Paris,-434140,-252399,2022-07-01
CASH_IN,99599,Agence_mtn_Abomey,300000,200401,Alfred Paris,-252399,-152800,2022-07-02
CASH_IN,260136,Agence_mtn_Ouidah,300000,39864,Alfred Paris,-152800,107336,2022-07-03
CASH_IN,246051,Agence_mtn_Ouidah,300000,53949,Alfred Paris,107336,353387,2022-07-03
CASH_OUT,164431,Alfred Paris,353387,188956,Agence_mtn_Abomey,300000,135569,2022-07-04
TRANSFER,115926,Alfred Paris,188956,73030,Alfred Paris,188956,304882,2022-07-06
CASH_OUT,28055,Alfred Paris,73030,44975,Agence_mtn_Abomey,300000,271945,2022-07-07
CASH_OUT,631,Alfred Paris,44975,44344,Agence_mtn_Ouidah,300000,299369,2022-07-07
CASH_IN,28512,Agence_mtn_Cotonou,300000,271488,Alfred Paris,44344,72856,2022-07-07
TRANSFER,49044,Alfred Paris,72856,23812,Alfred Paris,72856,121900,2022-07-14
CASH_OUT,15114,Alfred Paris,23812,8698,Agence_mtn_Cotonou,300000,284886,2022-07-15
CASH_OUT,1430,Alfred Paris,8698,7268,Agence_mtn_Abomey,300000,298570,2022-07-15
CASH_OUT,5406,Alfred Paris,7268,1862,Agence_mtn_Abomey,300000,294594,2022-07-15
TRANSFER,443,Alfred Paris,1862,1419,Alfred Paris,1862,1419,2022-07-16
CASH_OUT,515,Alfred Paris,1419,904,Agence_mtn_Abomey,300000,299485,2022-07-18
CASH_OUT,804,Alfred Paris,904,100,Agence_mtn_Cotonou,300000,299196,2022-07-20
CASH_IN,250494,Agence_mtn_Ouidah,300000,49506,Alfred Paris,100,250594,2022-07-20
CASH_IN,112030,Agence_mtn_Ouidah,300000,187970,Alfred Paris,250594,362624,2022-07-24
CASH_OUT,156632,Alfred Paris,362624,205992,Agence_mtn_Abomey,300000,143368,2022-07-26
CASH_IN,35262,Agence_mtn_Ouidah,300000,264738,Aimé Bernier,-63541,-28279,2022-07-01
CASH_IN,232704,Agence_mtn_Abomey,300000,67296,Aimé Bernier,-28279,204425,2022-07-06
TRANSFER,2999,Aimé Bernier,204425,201426,Aimé Bernier,204425,201426,2022-07-06
CASH_IN,39904,Agence_mtn_Cotonou,300000,260096,Aimé Bernier,201426,241330,2022-07-08
CASH_OUT,208629,Aimé Bernier,241330,32701,Agence_mtn_Cotonou,300000,91371,2022-07-09
CASH_OUT,23181,Aimé Bernier,32701,9520,Agence_mtn_Ouidah,300000,276819,2022-07-16
CASH_IN,270542,Agence_mtn_Ouidah,300000,29458,Aimé Bernier,9520,280062,2022-07-18
CASH_OUT,166027,Aimé Bernier,280062,114035,Agence_mtn_Cotonou,300000,133973,2022-07-20
CASH_OUT,7766,Aimé Bernier,114035,106269,Agence_mtn_Abomey,300000,292234,2022-07-22
CASH_IN,258349,Agence_mtn_Ouidah,300000,41651,Josette du Hamon,-35128,223221,2022-07-01
TRANSFER,140124,Josette du Hamon,223221,83097,Josette du Hamon,223221,83097,2022-07-05
CASH_IN,144602,Agence_mtn_Abomey,300000,155398,Josette du Hamon,83097,227699,2022-07-07
CASH_IN,139002,Agence_mtn_Cotonou,300000,160998,Josette du Hamon,227699,366701,2022-07-08
CASH_OUT,29245,Josette du Hamon,366701,337456,Agence_mtn_Ouidah,300000,270755,2022-07-11
CASH_IN,170208,Agence_mtn_Ouidah,300000,129792,Josette du Hamon,337456,507664,2022-07-12
CASH_IN,124511,Agence_mtn_Ouidah,300000,175489,Josette du Hamon,507664,632175,2022-07-12
CASH_IN,234786,Agence_mtn_Abomey,300000,65214,Josette du Hamon,632175,866961,2022-07-12
CASH_IN,201610,Agence_mtn_Cotonou,300000,98390,Josette du Hamon,866961,1068571,2022-07-14
CASH_OUT,1006883,Josette du Hamon,1068571,61688,Agence_mtn_Abomey,300000,-706883,2022-07-21
CASH_IN,249258,Agence_mtn_Cotonou,300000,50742,Josette du Hamon,61688,310946,2022-07-23
CASH_OUT,3730,Josette du Hamon,310946,307216,Agence_mtn_Abomey,300000,296270,2022-07-23
CASH_IN,13857,Agence_mtn_Abomey,300000,286143,Josette du Hamon,307216,321073,2022-07-25
CASH_IN,54284,Agence_mtn_Abomey,300000,245716,Simone du Allard,-155340,-101056,2022-07-01
CASH_IN,167385,Agence_mtn_Abomey,300000,132615,Simone du Allard,-101056,66329,2022-07-04
CASH_OUT,28679,Simone du Allard,66329,37650,Agence_mtn_Abomey,300000,271321,2022-07-06
TRANSFER,10970,Simone du Allard,37650,26680,Simone du Allard,37650,26680,2022-07-07
TRANSFER,13207,Simone du Allard,26680,13473,Simone du Allard,26680,13473,2022-07-08
CASH_OUT,6288,Simone du Allard,13473,7185,Agence_mtn_Ouidah,300000,293712,2022-07-09
CASH_IN,4673,Agence_mtn_Abomey,300000,295327,Simone du Allard,7185,11858,2022-07-10
CASH_OUT,7622,Simone du Allard,11858,4236,Agence_mtn_Abomey,300000,292378,2022-07-13
CASH_IN,20394,Agence_mtn_Abomey,300000,279606,Simone du Allard,4236,24630,2022-07-14
CASH_OUT,15577,Simone du Allard,24630,9053,Agence_mtn_Ouidah,300000,284423,2022-07-15
CASH_OUT,2913,Simone du Allard,9053,6140,Agence_mtn_Cotonou,300000,297087,2022-07-18
CASH_IN,180529,Agence_mtn_Cotonou,300000,119471,Simone du Allard,6140,186669,2022-07-21
CASH_IN,163169,Agence_mtn_Cotonou,300000,136831,Marcel de la Buisson,-154424,8745,2022-07-01
CASH_IN,239709,Agence_mtn_Ouidah,300000,60291,Marcel de la Buisson,8745,248454,2022-07-03
TRANSFER,4682,Marcel de la Buisson,248454,243772,Marcel de la Buisson,248454,243772,2022-07-09
CASH_IN,194895,Agence_mtn_Cotonou,300000,105105,Marcel de la Buisson,243772,438667,2022-07-11
CASH_IN,225417,Agence_mtn_Ouidah,300000,74583,Marcel de la Buisson,438667,664084,2022-07-11
TRANSFER,380561,Marcel de la Buisson,664084,283523,Marcel de la Buisson,664084,1044645,2022-07-11
CASH_OUT,201987,Marcel de la Buisson,283523,81536,Agence_mtn_Ouidah,300000,98013,2022-07-14
CASH_OUT,72695,Marcel de la Buisson,81536,8841,Agence_mtn_Abomey,300000,227305,2022-07-16
TRANSFER,5577,Marcel de la Buisson,8841,3264,Marcel de la Buisson,8841,3264,2022-07-17
CASH_OUT,1370,Marcel de la Buisson,3264,1894,Agence_mtn_Abomey,300000,298630,2022-07-17
CASH_OUT,455,Marcel de la Buisson,1894,1439,Agence_mtn_Ouidah,300000,299545,2022-07-18
CASH_IN,266893,Agence_mtn_Ouidah,300000,33107,Marcel de la Buisson,1439,268332,2022-07-23
CASH_IN,94765,Agence_mtn_Ouidah,300000,205235,Marcel de la Buisson,268332,363097,2022-07-23
CASH_IN,67705,Agence_mtn_Abomey,300000,232295,Marcel de la Buisson,363097,430802,2022-07-23
CASH_IN,257596,Agence_mtn_Cotonou,300000,42404,Jacques Laporte de Blanchet,-1097,256499,2022-07-03
CASH_IN,299378,Agence_mtn_Abomey,300000,622,Jacques Laporte de Blanchet,256499,555877,2022-07-06
CASH_OUT,458630,Jacques Laporte de Blanchet,555877,97247,Agence_mtn_Cotonou,300000,-158630,2022-07-12
CASH_IN,92305,Agence_mtn_Abomey,300000,207695,Jacques Laporte de Blanchet,97247,189552,2022-07-13
CASH_OUT,1902,Jacques Laporte de Blanchet,189552,187650,Agence_mtn_Ouidah,300000,298098,2022-07-17
CASH_OUT,149318,Jacques Laporte de Blanchet,187650,38332,Agence_mtn_Cotonou,300000,150682,2022-07-17
CASH_IN,181949,Agence_mtn_Cotonou,300000,118051,Jacques Laporte de Blanchet,38332,220281,2022-07-18
CASH_IN,49397,Agence_mtn_Abomey,300000,250603,Jacques Laporte de Blanchet,220281,269678,2022-07-19
CASH_IN,86872,Agence_mtn_Ouidah,300000,213128,Jacques Laporte de Blanchet,269678,356550,2022-07-24
CASH_OUT,304369,Jacques Laporte de Blanchet,356550,52181,Agence_mtn_Ouidah,300000,-4369,2022-07-25
CASH_IN,248298,Agence_mtn_Ouidah,300000,51702,Georges Muller,-51209,197089,2022-07-01
TRANSFER,99086,Georges Muller,197089,98003,Georges Muller,197089,98003,2022-07-02
TRANSFER,61175,Georges Muller,98003,36828,Georges Muller,98003,159178,2022-07-09
TRANSFER,14419,Georges Muller,36828,22409,Georges Muller,36828,51247,2022-07-09
TRANSFER,3244,Georges Muller,22409,19165,Georges Muller,22409,19165,2022-07-10
TRANSFER,13281,Georges Muller,19165,5884,Georges Muller,19165,5884,2022-07-11
CASH_OUT,3083,Georges Muller,5884,2801,Agence_mtn_Ouidah,300000,296917,2022-07-11
CASH_IN,158838,Agence_mtn_Cotonou,300000,141162,Georges Muller,2801,161639,2022-07-12
CASH_IN,92622,Agence_mtn_Cotonou,300000,207378,Georges Muller,161639,254261,2022-07-13
CASH_IN,299656,Agence_mtn_Cotonou,300000,344,Georges Muller,254261,553917,2022-07-14
CASH_IN,72958,Agence_mtn_Ouidah,300000,227042,Georges Muller,553917,626875,2022-07-14
CASH_IN,28171,Agence_mtn_Abomey,300000,271829,Georges Muller,626875,655046,2022-07-18
CASH_IN,227234,Agence_mtn_Abomey,300000,72766,Georges Muller,655046,882280,2022-07-21
CASH_OUT,859154,Georges Muller,882280,23126,Agence_mtn_Abomey,300000,-559154,2022-07-23
CASH_OUT,21177,Georges Muller,23126,1949,Agence_mtn_Abomey,300000,278823,2022-07-24
CASH_IN,32849,Agence_mtn_Cotonou,300000,267151,Nathalie-Claire De Oliveira,-3129675,-3096826,2022-07-01
CASH_IN,215132,Agence_mtn_Ouidah,300000,84868,Nathalie-Claire De Oliveira,-3096826,-2881694,2022-07-01
CASH_IN,156684,Agence_mtn_Ouidah,300000,143316,Nathalie-Claire De Oliveira,-2881694,-2725010,2022-07-03
CASH_IN,110858,Agence_mtn_Abomey,300000,189142,Nathalie-Claire De Oliveira,-2725010,-2614152,2022-07-05
CASH_IN,264311,Agence_mtn_Abomey,300000,35689,Nathalie-Claire De Oliveira,-2614152,-2349841,2022-07-09
CASH_IN,8249,Agence_mtn_Abomey,300000,291751,Nathalie-Claire De Oliveira,-2349841,-2341592,2022-07-09
CASH_IN,75513,Agence_mtn_Cotonou,300000,224487,Nathalie-Claire De Oliveira,-2341592,-2266079,2022-07-13
CASH_IN,24203,Agence_mtn_Abomey,300000,275797,Nathalie-Claire De Oliveira,-2266079,-2241876,2022-07-15
CASH_IN,214372,Agence_mtn_Ouidah,300000,85628,Nathalie-Claire De Oliveira,-2241876,-2027504,2022-07-15
CASH_IN,137816,Agence_mtn_Abomey,300000,162184,Nathalie-Claire De Oliveira,-2027504,-1889688,2022-07-16
CASH_IN,54727,Agence_mtn_Ouidah,300000,245273,Nathalie-Claire De Oliveira,-1889688,-1834961,2022-07-16
CASH_IN,151681,Agence_mtn_Cotonou,300000,148319,Nathalie-Claire De Oliveira,-1834961,-1683280,2022-07-16
CASH_IN,81943,Agence_mtn_Cotonou,300000,218057,Nathalie-Claire De Oliveira,-1683280,-1601337,2022-07-22
CASH_IN,127512,Agence_mtn_Cotonou,300000,172488,Nathalie-Claire De Oliveira,-1601337,-1473825,2022-07-23
CASH_IN,48087,Agence_mtn_Ouidah,300000,251913,Nathalie-Claire De Oliveira,-1473825,-1425738,2022-07-25
CASH_IN,130095,Agence_mtn_Cotonou,300000,169905,Nathalie-Claire De Oliveira,-1425738,-1295643,2022-07-26
CASH_IN,170825,Agence_mtn_Cotonou,300000,129175,Nathalie-Claire De Oliveira,-1295643,-1124818,2022-07-27
CASH_IN,291298,Agence_mtn_Ouidah,300000,8702,Olivier Benard,-89921,201377,2022-07-06
TRANSFER,65487,Olivier Benard,201377,135890,Olivier Benard,201377,266864,2022-07-09
TRANSFER,95977,Olivier Benard,135890,39913,Olivier Benard,135890,39913,2022-07-10
CASH_OUT,7722,Olivier Benard,39913,32191,Agence_mtn_Cotonou,300000,292278,2022-07-10
CASH_OUT,19984,Olivier Benard,32191,12207,Agence_mtn_Ouidah,300000,280016,2022-07-11
CASH_IN,253374,Agence_mtn_Abomey,300000,46626,Olivier Benard,12207,265581,2022-07-15
TRANSFER,170191,Olivier Benard,265581,95390,Olivier Benard,265581,95390,2022-07-15
CASH_OUT,45428,Olivier Benard,95390,49962,Agence_mtn_Cotonou,300000,254572,2022-07-15
CASH_IN,252920,Agence_mtn_Ouidah,300000,47080,Olivier Benard,49962,302882,2022-07-20
CASH_IN,86978,Agence_mtn_Abomey,300000,213022,Olivier Benard,302882,389860,2022-07-22
CASH_OUT,94566,Olivier Benard,389860,295294,Agence_mtn_Cotonou,300000,205434,2022-07-23
CASH_IN,142243,Agence_mtn_Abomey,300000,157757,Robert Henry-Poulain,-189794,-47551,2022-07-06
CASH_IN,99877,Agence_mtn_Abomey,300000,200123,Robert Henry-Poulain,-47551,52326,2022-07-09
CASH_OUT,1490,Robert Henry-Poulain,52326,50836,Agence_mtn_Cotonou,300000,298510,2022-07-09
CASH_OUT,15104,Robert Henry-Poulain,50836,35732,Agence_mtn_Abomey,300000,284896,2022-07-10
CASH_IN,142551,Agence_mtn_Cotonou,300000,157449,Robert Henry-Poulain,35732,178283,2022-07-16
CASH_OUT,115369,Robert Henry-Poulain,178283,62914,Agence_mtn_Cotonou,300000,184631,2022-07-22
CASH_IN,297609,Agence_mtn_Cotonou,300000,2391,Robert Henry-Poulain,62914,360523,2022-07-27
CASH_IN,159038,Agence_mtn_Cotonou,300000,140962,Valérie-Claudine Marin,-245498,-86460,2022-07-02
CASH_IN,94960,Agence_mtn_Cotonou,300000,205040,Valérie-Claudine Marin,-86460,8500,2022-07-03
CASH_OUT,7098,Valérie-Claudine Marin,8500,1402,Agence_mtn_Ouidah,300000,292902,2022-07-05
TRANSFER,1202,Valérie-Claudine Marin,1402,200,Valérie-Claudine Marin,1402,2604,2022-07-08
CASH_IN,127245,Agence_mtn_Ouidah,300000,172755,Valérie-Claudine Marin,200,127445,2022-07-09
CASH_IN,29430,Agence_mtn_Cotonou,300000,270570,Valérie-Claudine Marin,127445,156875,2022-07-22
CASH_OUT,30922,Valérie-Claudine Marin,156875,125953,Agence_mtn_Cotonou,300000,269078,2022-07-24
CASH_IN,30346,Agence_mtn_Abomey,300000,269654,Valérie-Claudine Marin,125953,156299,2022-07-27
CASH_IN,85589,Agence_mtn_Ouidah,300000,214411,Valérie-Claudine Marin,156299,241888,2022-07-27
CASH_IN,104193,Agence_mtn_Abomey,300000,195807,Michèle Faivre,1452600,1556793,2022-08-13
CASH_IN,106466,Agence_mtn_Cotonou,300000,193534,Roger-Roger Delmas,770900,877366,2022-08-15
CASH_OUT,551316,Roger-Roger Delmas,877366,326050,Agence_mtn_Cotonou,300000,-251316,2022-08-17
CASH_IN,21996,Agence_mtn_Ouidah,300000,278004,Roger-Roger Delmas,326050,348046,2022-08-26
TRANSFER,606811,Céline-Inès Meunier,1377500,770689,Emmanuel Legrand,1187300,1794111,2022-08-13
CASH_IN,132984,Agence_mtn_Cotonou,300000,167016,Emmanuel Legrand,1794111,1927095,2022-08-27
TRANSFER,361840,Jérôme Laporte Le Gauthier,867200,505360,Henri de Didier,1889200,1527360,2022-08-11
CASH_OUT,55884,Jérôme Laporte Le Gauthier,505360,449476,Agence_mtn_Cotonou,300000,244116,2022-08-16
CASH_IN,114895,Agence_mtn_Abomey,300000,185105,Jérôme Laporte Le Gauthier,449476,564371,2022-08-20
CASH_OUT,256264,Jérôme Laporte Le Gauthier,564371,308107,Agence_mtn_Cotonou,300000,43736,2022-08-22
TRANSFER,19429,Sophie-Anouk Boulanger,114400,94971,Jérôme Laporte Le Gauthier,308107,327536,2022-08-23
CASH_OUT,489582,Georges-Alfred Pruvost,571200,81618,Agence_mtn_Ouidah,300000,-189582,2022-08-13
TRANSFER,314872,Marc Baudry,332700,17828,Georges-Alfred Pruvost,81618,396490,2022-08-20
CASH_OUT,10543,Georges-Alfred Pruvost,396490,385947,Agence_mtn_Abomey,300000,289457,2022-08-25
CASH_OUT,506842,Alexandre Blanchard,1431700,924858,Agence_mtn_Cotonou,300000,-206842,2022-08-02
CASH_OUT,365171,Alexandre Blanchard,924858,559687,Agence_mtn_Abomey,300000,-65171,2022-08-07
CASH_OUT,308275,Alexandre Blanchard,559687,251412,Agence_mtn_Cotonou,300000,-8275,2022-08-19
CASH_IN,124013,Agence_mtn_Ouidah,300000,175987,Nathalie Da Silva,300000,424013,2022-08-03
CASH_OUT,368758,Nathalie Da Silva,424013,55255,Agence_mtn_Abomey,300000,-68758,2022-08-05
CASH_OUT,34078,Nathalie Da Silva,55255,21177,Agence_mtn_Cotonou,300000,265922,2022-08-12
TRANSFER,143056,Élisabeth Delattre,440700,297644,Nathalie Da Silva,21177,164233,2022-08-25
TRANSFER,385586,Georges Muller,1766200,1380614,Robert Henry-Poulain,540500,926086,2022-08-21
TRANSFER,532382,Élisabeth Blot-Bruneau,1368000,835618,Olivier Benard,237200,769582,2022-08-03
CASH_OUT,7069,Olivier Benard,769582,762513,Agence_mtn_Ouidah,300000,292931,2022-08-07
CASH_IN,127667,Agence_mtn_Abomey,300000,172333,Olivier Benard,762513,890180,2022-08-23
CASH_OUT,150204,Jean Guilbert-Lenoir,196700,46496,Agence_mtn_Abomey,300000,149796,2022-08-18
CASH_OUT,36281,Sabine Perrier,55500,19219,Agence_mtn_Abomey,300000,263719,2022-08-02
CASH_OUT,231641,Valérie-Claudine Marin,925800,694159,Agence_mtn_Abomey,300000,68359,2022-08-02
CASH_OUT,349730,Valérie-Claudine Marin,694159,344429,Agence_mtn_Abomey,300000,-49730,2022-08-18
TRANSFER,304495,Valérie-Claudine Marin,344429,39934,Hélène Alexandre de la Samson,1221600,917105,2022-08-27
TRANSFER,5994,Julien Devaux,65100,59106,Jacques Le Marion,1987300,1981306,2022-08-10
CASH_IN,201723,Agence_mtn_Cotonou,300000,98277,Julien Devaux,59106,260829,2022-08-15
CASH_IN,34651,Agence_mtn_Abomey,300000,265349,Julien Devaux,260829,295480,2022-08-26
CASH_OUT,836947,Margot Julien,1183000,346053,Agence_mtn_Ouidah,300000,-536947,2022-08-05
TRANSFER,472978,Hélène Alexandre de la Samson,917105,444127,Margot Julien,346053,819031,2022-08-07
TRANSFER,610226,Margot Julien,819031,208805,Madeleine Hardy,125600,-484626,2022-08-19
CASH_OUT,100076,Margot Julien,208805,108729,Agence_mtn_Abomey,300000,199924,2022-08-24
CASH_IN,196345,Agence_mtn_Abomey,300000,103655,Marine Chevallier,578200,774545,2022-08-11
TRANSFER,607495,Marine Chevallier,774545,167050,Élise Monnier,447400,-160095,2022-08-17
CASH_IN,119815,Agence_mtn_Abomey,300000,180185,Marine Chevallier,167050,286865,2022-08-20
TRANSFER,11193,Marc Baudry,17828,6635,Marine Chevallier,286865,298058,2022-08-24
CASH_IN,267006,Agence_mtn_Cotonou,300000,32994,Marine Chevallier,298058,565064,2022-08-27
CASH_IN,208994,Agence_mtn_Abomey,300000,91006,Louise-Aurore Payet,3500,212494,2022-08-07
CASH_IN,101149,Agence_mtn_Cotonou,300000,198851,Louise-Aurore Payet,212494,313643,2022-08-27
TRANSFER,16682,Nicole-Renée Gay,155500,138818,Clémence Dufour,1952700,1969382,2022-08-05
CASH_IN,298143,Agence_mtn_Cotonou,300000,1857,Clémence Dufour,1969382,2267525,2022-08-06
CASH_OUT,156423,Clémence Dufour,2267525,2111102,Agence_mtn_Cotonou,300000,143577,2022-08-13
TRANSFER,1508342,Clémence Dufour,2111102,602760,Josette du Hamon,1259400,-248942,2022-08-19
CASH_OUT,325579,Clémence Dufour,602760,277181,Agence_mtn_Cotonou,300000,-25579,2022-08-21
CASH_OUT,150620,Aimé Bernier,758300,607680,Agence_mtn_Cotonou,300000,149380,2022-08-23
TRANSFER,402997,Aimé Bernier,607680,204683,Georges Muller,1380614,977617,2022-08-25
CASH_OUT,710692,Hélène Blanchard-Renault,1071500,360808,Agence_mtn_Abomey,300000,-410692,2022-08-01
TRANSFER,1048778,Emmanuelle Le Allain,1592400,543622,Matthieu Cousin,1077200,2125978,2022-08-02
CASH_IN,185879,Agence_mtn_Abomey,300000,114121,Matthieu Cousin,2125978,2311857,2022-08-03
CASH_IN,103434,Agence_mtn_Abomey,300000,196566,Matthieu Cousin,2311857,2415291,2022-08-06
TRANSFER,2483,Jacques Laporte de Blanchet,196100,193617,Matthieu Cousin,2415291,2417774,2022-08-13
CASH_OUT,2173499,Matthieu Cousin,2417774,244275,Agence_mtn_Abomey,300000,-1873499,2022-08-25
CASH_OUT,141166,Danielle-Henriette Tessier,715200,574034,Agence_mtn_Abomey,300000,158834,2022-08-01
CASH_OUT,364167,Danielle-Henriette Tessier,574034,209867,Agence_mtn_Abomey,300000,-64167,2022-08-13
CASH_OUT,174765,Danielle-Henriette Tessier,209867,35102,Agence_mtn_Cotonou,300000,125235,2022-08-19
TRANSFER,884146,Gérard Cordier,1716600,832454,Danielle-Henriette Tessier,35102,919248,2022-08-25
TRANSFER,279126,Marc Costa-Daniel,369700,90574,Maggie Barbier,1720500,1441374,2022-08-01
CASH_OUT,89766,Marc Costa-Daniel,90574,808,Agence_mtn_Cotonou,300000,210234,2022-08-11
CASH_OUT,262467,Véronique Hardy,293400,30933,Agence_mtn_Abomey,300000,37533,2022-08-05
CASH_IN,106238,Agence_mtn_Abomey,300000,193762,Véronique Hardy,30933,137171,2022-08-12
CASH_IN,3721,Agence_mtn_Ouidah,300000,296279,Véronique Hardy,137171,140892,2022-08-17
CASH_OUT,206534,Alexandre Delaunay,270200,63666,Agence_mtn_Cotonou,300000,93466,2022-08-24
CASH_IN,165828,Agence_mtn_Cotonou,300000,134172,Marcel de la Buisson,1819500,1985328,2022-08-01
TRANSFER,870570,Océane Faure,1503000,632430,Marcel de la Buisson,1985328,2855898,2022-08-02
TRANSFER,2180889,Marcel de la Buisson,2855898,675009,François Vaillant,1106100,-1074789,2022-08-02
TRANSFER,139318,Marcel de la Buisson,675009,535691,Guy-Augustin Pinto,1631800,1492482,2022-08-03
CASH_IN,170604,Agence_mtn_Abomey,300000,129396,Marcel de la Buisson,535691,706295,2022-08-04
CASH_IN,118525,Agence_mtn_Cotonou,300000,181475,Marcel de la Buisson,706295,824820,2022-08-05
CASH_OUT,491386,Marcel de la Buisson,824820,333434,Agence_mtn_Ouidah,300000,-191386,2022-08-09
CASH_IN,222428,Agence_mtn_Ouidah,300000,77572,Marcel de la Buisson,333434,555862,2022-08-10
TRANSFER,411607,Marcel de la Buisson,555862,144255,Charles Guérin,1766100,1354493,2022-08-12
CASH_OUT,6191,Marcel de la Buisson,144255,138064,Agence_mtn_Abomey,300000,293809,2022-08-12
TRANSFER,711674,Éléonore Marin Le Morel,805400,93726,Marcel de la Buisson,138064,849738,2022-08-14
TRANSFER,366758,Marcel de la Buisson,849738,482980,Éléonore Marin Le Morel,93726,-273032,2022-08-15
CASH_IN,195109,Agence_mtn_Abomey,300000,104891,Marcel de la Buisson,482980,678089,2022-08-16
CASH_OUT,242264,Marcel de la Buisson,678089,435825,Agence_mtn_Cotonou,300000,57736,2022-08-16
CASH_IN,295318,Agence_mtn_Cotonou,300000,4682,Marcel de la Buisson,435825,731143,2022-08-18
CASH_IN,150139,Agence_mtn_Cotonou,300000,149861,Marcel de la Buisson,731143,881282,2022-08-18
TRANSFER,820852,Marcel de la Buisson,881282,60430,Thibault-Julien Chevallier,827600,6748,2022-08-19
TRANSFER,37357,Marcel de la Buisson,60430,23073,Sophie-Anouk Boulanger,94971,57614,2022-08-20
CASH_IN,199866,Agence_mtn_Cotonou,300000,100134,Marcel de la Buisson,23073,222939,2022-08-20
TRANSFER,1094468,Jacques Le Marion,1981306,886838,Marcel de la Buisson,222939,1317407,2022-08-23
TRANSFER,289155,Nicole Huet,769300,480145,Marcel de la Buisson,1317407,1606562,2022-08-24
CASH_OUT,1479802,Marcel de la Buisson,1606562,126760,Agence_mtn_Abomey,300000,-1179802,2022-08-24
CASH_IN,214630,Agence_mtn_Cotonou,300000,85370,Marcel de la Buisson,126760,341390,2022-08-26
CASH_OUT,1197674,Alfred Paris,1710200,512526,Agence_mtn_Ouidah,300000,-897674,2022-08-02
CASH_IN,100576,Agence_mtn_Cotonou,300000,199424,Alfred Paris,512526,613102,2022-08-02
TRANSFER,122888,Alfred Paris,613102,490214,Édouard Grondin du Fleury,1519500,1396612,2022-08-04
TRANSFER,271630,Alfred Paris,490214,218584,Honoré Grégoire-Breton,254900,-16730,2022-08-05
CASH_OUT,35626,Alfred Paris,218584,182958,Agence_mtn_Ouidah,300000,264374,2022-08-06
CASH_OUT,144214,Alfred Paris,182958,38744,Agence_mtn_Abomey,300000,155786,2022-08-06
TRANSFER,302273,Océane Faure,632430,330157,Alfred Paris,38744,341017,2022-08-07
CASH_IN,70136,Agence_mtn_Cotonou,300000,229864,Alfred Paris,341017,411153,2022-08-08
CASH_OUT,116569,Alfred Paris,411153,294584,Agence_mtn_Abomey,300000,183431,2022-08-08
CASH_OUT,243762,Alfred Paris,294584,50822,Agence_mtn_Cotonou,300000,56238,2022-08-11
CASH_OUT,38625,Alfred Paris,50822,12197,Agence_mtn_Cotonou,300000,261375,2022-08-11
CASH_OUT,11910,Alfred Paris,12197,287,Agence_mtn_Ouidah,300000,288090,2022-08-13
CASH_OUT,136,Alfred Paris,287,151,Agence_mtn_Cotonou,300000,299864,2022-08-15
TRANSFER,116,Alfred Paris,151,35,Élisabeth Blot-Bruneau,835618,835502,2022-08-17
CASH_IN,179181,Agence_mtn_Abomey,300000,120819,Alfred Paris,35,179216,2022-08-17
CASH_OUT,46007,Alfred Paris,179216,133209,Agence_mtn_Ouidah,300000,253993,2022-08-18
CASH_IN,89093,Agence_mtn_Abomey,300000,210907,Alfred Paris,133209,222302,2022-08-19
CASH_IN,140115,Agence_mtn_Abomey,300000,159885,Alfred Paris,222302,362417,2022-08-19
CASH_OUT,88622,Alfred Paris,362417,273795,Agence_mtn_Ouidah,300000,211378,2022-08-21
CASH_IN,79337,Agence_mtn_Ouidah,300000,220663,Alfred Paris,273795,353132,2022-08-21
CASH_OUT,5692,Alfred Paris,353132,347440,Agence_mtn_Cotonou,300000,294308,2022-08-26
CASH_OUT,50423,Alfred Paris,347440,297017,Agence_mtn_Abomey,300000,249577,2022-08-26
CASH_IN,175394,Agence_mtn_Ouidah,300000,124606,Maryse Delorme,1861900,2037294,2022-08-01
TRANSFER,1442080,Maryse Delorme,2037294,595214,Georges Muller,977617,-464463,2022-08-03
TRANSFER,21802,Raymond-Yves Boulanger,166100,144298,Maryse Delorme,595214,617016,2022-08-04
CASH_IN,279239,Agence_mtn_Ouidah,300000,20761,Maryse Delorme,617016,896255,2022-08-05
CASH_IN,159645,Agence_mtn_Abomey,300000,140355,Maryse Delorme,896255,1055900,2022-08-05
TRANSFER,1016365,Maryse Delorme,1055900,39535,Simone du Allard,742800,-273565,2022-08-08
CASH_IN,91906,Agence_mtn_Cotonou,300000,208094,Maryse Delorme,39535,131441,2022-08-08
CASH_IN,12021,Agence_mtn_Ouidah,300000,287979,Maryse Delorme,131441,143462,2022-08-08
CASH_OUT,107562,Maryse Delorme,143462,35900,Agence_mtn_Ouidah,300000,192438,2022-08-12
TRANSFER,19058,Nicole-Renée Gay,138818,119760,Maryse Delorme,35900,54958,2022-08-12
TRANSFER,35381,Maryse Delorme,54958,19577,Zacharie Fabre,349000,313619,2022-08-12
CASH_OUT,7657,Maryse Delorme,19577,11920,Agence_mtn_Cotonou,300000,292343,2022-08-12
CASH_OUT,1414,Maryse Delorme,11920,10506,Agence_mtn_Abomey,300000,298586,2022-08-13
CASH_IN,299505,Agence_mtn_Ouidah,300000,495,Maryse Delorme,10506,310011,2022-08-16
TRANSFER,234777,Maryse Delorme,310011,75234,Jacques Marchand,1267700,1032923,2022-08-18
CASH_OUT,10173,Maryse Delorme,75234,65061,Agence_mtn_Abomey,300000,289827,2022-08-19
CASH_IN,55461,Agence_mtn_Ouidah,300000,244539,Maryse Delorme,65061,120522,2022-08-19
TRANSFER,251253,Jules-Marc Chauvet,958100,706847,Maryse Delorme,120522,371775,2022-08-19
TRANSFER,162473,Maryse Delorme,371775,209302,Clémence-Alice Ruiz,452600,290127,2022-08-21
TRANSFER,306223,Gabrielle Hamon,519700,213477,Maryse Delorme,209302,515525,2022-08-21
CASH_OUT,498144,Maryse Delorme,515525,17381,Agence_mtn_Ouidah,300000,-198144,2022-08-22
TRANSFER,6111,Maryse Delorme,17381,11270,Jacques Marchand,1032923,1026812,2022-08-23
CASH_OUT,3979,Maryse Delorme,11270,7291,Agence_mtn_Cotonou,300000,296021,2022-08-23
CASH_OUT,47558,Emmanuelle Le Allain,543622,496064,Agence_mtn_Ouidah,300000,252442,2022-08-02
CASH_OUT,319532,Emmanuelle Le Allain,496064,176532,Agence_mtn_Ouidah,300000,-19532,2022-08-03
CASH_OUT,21395,Emmanuelle Le Allain,176532,155137,Agence_mtn_Abomey,300000,278605,2022-08-03
TRANSFER,87996,Nicole Huet,480145,392149,Emmanuelle Le Allain,155137,243133,2022-08-03
CASH_OUT,181606,Emmanuelle Le Allain,243133,61527,Agence_mtn_Ouidah,300000,118394,2022-08-03
CASH_OUT,25432,Emmanuelle Le Allain,61527,36095,Agence_mtn_Cotonou,300000,274568,2022-08-05
CASH_OUT,669,Emmanuelle Le Allain,36095,35426,Agence_mtn_Ouidah,300000,299331,2022-08-05
TRANSFER,11948,Emmanuelle Le Allain,35426,23478,Nathalie-Claire De Oliveira,998700,986752,2022-08-07
CASH_IN,221147,Agence_mtn_Cotonou,300000,78853,Emmanuelle Le Allain,23478,244625,2022-08-09
CASH_OUT,19670,Emmanuelle Le Allain,244625,224955,Agence_mtn_Cotonou,300000,280330,2022-08-09
CASH_OUT,55921,Emmanuelle Le Allain,224955,169034,Agence_mtn_Abomey,300000,244079,2022-08-09
TRANSFER,125129,Emmanuelle Le Allain,169034,43905,Thérèse-Juliette Camus,262500,137371,2022-08-10
TRANSFER,37388,Emmanuelle Le Allain,43905,6517,Margaud-Michelle Briand,415500,378112,2022-08-11
CASH_OUT,4125,Emmanuelle Le Allain,6517,2392,Agence_mtn_Ouidah,300000,295875,2022-08-13
CASH_OUT,1769,Emmanuelle Le Allain,2392,623,Agence_mtn_Ouidah,300000,298231,2022-08-14
TRANSFER,445,Emmanuelle Le Allain,623,178,Nicolas Blin,131600,131155,2022-08-15
TRANSFER,157645,Jacques Laporte de Blanchet,193617,35972,Emmanuelle Le Allain,178,157823,2022-08-15
CASH_IN,255160,Agence_mtn_Cotonou,300000,44840,Emmanuelle Le Allain,157823,412983,2022-08-16
CASH_OUT,245543,Emmanuelle Le Allain,412983,167440,Agence_mtn_Abomey,300000,54457,2022-08-17
TRANSFER,746197,Thibault Martin,828000,81803,Emmanuelle Le Allain,167440,913637,2022-08-18
TRANSFER,258273,Élisabeth Delattre,297644,39371,Emmanuelle Le Allain,913637,1171910,2022-08-18
TRANSFER,898864,Emmanuelle Le Allain,1171910,273046,Nicole-Renée Gay,119760,-779104,2022-08-20
CASH_OUT,120725,Emmanuelle Le Allain,273046,152321,Agence_mtn_Ouidah,300000,179275,2022-08-21
CASH_OUT,107648,Emmanuelle Le Allain,152321,44673,Agence_mtn_Cotonou,300000,192352,2022-08-24
TRANSFER,270192,Julie Germain Le Vaillant,304900,34708,Emmanuelle Le Allain,44673,314865,2022-08-27
CASH_OUT,167909,Emmanuelle Le Allain,314865,146956,Agence_mtn_Abomey,300000,132091,2022-08-27
CASH_IN,41234,Agence_mtn_Abomey,300000,258766,Éléonore Marin Le Morel,-273032,-231798,2022-08-01
CASH_IN,41773,Agence_mtn_Ouidah,300000,258227,Éléonore Marin Le Morel,-231798,-190025,2022-08-03
CASH_IN,140410,Agence_mtn_Ouidah,300000,159590,Éléonore Marin Le Morel,-190025,-49615,2022-08-05
CASH_IN,132520,Agence_mtn_Abomey,300000,167480,Éléonore Marin Le Morel,-49615,82905,2022-08-06
CASH_IN,91835,Agence_mtn_Ouidah,300000,208165,Éléonore Marin Le Morel,82905,174740,2022-08-08
CASH_IN,115493,Agence_mtn_Abomey,300000,184507,Éléonore Marin Le Morel,174740,290233,2022-08-08
CASH_IN,216418,Agence_mtn_Ouidah,300000,83582,Éléonore Marin Le Morel,290233,506651,2022-08-10
TRANSFER,66093,Astrid Aubert-Thierry,546100,480007,Éléonore Marin Le Morel,506651,572744,2022-08-11
CASH_OUT,490430,Éléonore Marin Le Morel,572744,82314,Agence_mtn_Cotonou,300000,-190430,2022-08-12
CASH_IN,192219,Agence_mtn_Ouidah,300000,107781,Éléonore Marin Le Morel,82314,274533,2022-08-13
CASH_OUT,8498,Éléonore Marin Le Morel,274533,266035,Agence_mtn_Abomey,300000,291502,2022-08-14
TRANSFER,210279,Éléonore Marin Le Morel,266035,55756,Guy-Augustin Pinto,1492482,1282203,2022-08-16
CASH_OUT,43295,Éléonore Marin Le Morel,55756,12461,Agence_mtn_Cotonou,300000,256705,2022-08-16
CASH_OUT,7084,Éléonore Marin Le Morel,12461,5377,Agence_mtn_Cotonou,300000,292916,2022-08-16
TRANSFER,73233,Gérard Blot de Blanc,139500,66267,Éléonore Marin Le Morel,5377,78610,2022-08-18
CASH_IN,277661,Agence_mtn_Ouidah,300000,22339,Éléonore Marin Le Morel,78610,356271,2022-08-19
TRANSFER,94017,Éléonore Marin Le Morel,356271,262254,Marthe Perrin,1839900,1745883,2022-08-20
CASH_OUT,233518,Éléonore Marin Le Morel,262254,28736,Agence_mtn_Cotonou,300000,66482,2022-08-20
TRANSFER,385856,Maggie Barbier,1441374,1055518,Éléonore Marin Le Morel,28736,414592,2022-08-22
CASH_OUT,366464,Éléonore Marin Le Morel,414592,48128,Agence_mtn_Cotonou,300000,-66464,2022-08-22
CASH_IN,115340,Agence_mtn_Cotonou,300000,184660,Éléonore Marin Le Morel,48128,163468,2022-08-22
CASH_IN,294903,Agence_mtn_Ouidah,300000,5097,Éléonore Marin Le Morel,163468,458371,2022-08-22
CASH_IN,126232,Agence_mtn_Ouidah,300000,173768,Éléonore Marin Le Morel,458371,584603,2022-08-27
CASH_OUT,27010,Gérard Blot de Blanc,66267,39257,Agence_mtn_Cotonou,300000,272990,2022-08-03
TRANSFER,1054315,Édouard Grondin du Fleury,1396612,342297,Gérard Blot de Blanc,39257,1093572,2022-08-03
TRANSFER,504429,Jacques Marchand,1026812,522383,Gérard Blot de Blanc,1093572,1598001,2022-08-04
CASH_IN,292870,Agence_mtn_Abomey,300000,7130,Gérard Blot de Blanc,1598001,1890871,2022-08-05
CASH_OUT,394180,Gérard Blot de Blanc,1890871,1496691,Agence_mtn_Cotonou,300000,-94180,2022-08-05
CASH_OUT,639762,Gérard Blot de Blanc,1496691,856929,Agence_mtn_Cotonou,300000,-339762,2022-08-06
TRANSFER,407278,Gérard Blot de Blanc,856929,449651,Charles Guérin,1354493,947215,2022-08-06
CASH_IN,73413,Agence_mtn_Cotonou,300000,226587,Gérard Blot de Blanc,449651,523064,2022-08-08
CASH_IN,175642,Agence_mtn_Ouidah,300000,124358,Gérard Blot de Blanc,523064,698706,2022-08-10
CASH_OUT,122153,Gérard Blot de Blanc,698706,576553,Agence_mtn_Abomey,300000,177847,2022-08-10
CASH_IN,118554,Agence_mtn_Ouidah,300000,181446,Gérard Blot de Blanc,576553,695107,2022-08-11
TRANSFER,1185799,Marthe Perrin,1745883,560084,Gérard Blot de Blanc,695107,1880906,2022-08-11
CASH_OUT,321862,Gérard Blot de Blanc,1880906,1559044,Agence_mtn_Ouidah,300000,-21862,2022-08-13
TRANSFER,104420,Gérard Blot de Blanc,1559044,1454624,Michelle de la Daniel,218800,114380,2022-08-13
TRANSFER,267872,Gérard Blot de Blanc,1454624,1186752,Madeleine Philippe-Grondin,577900,310028,2022-08-14
CASH_OUT,208375,Gérard Blot de Blanc,1186752,978377,Agence_mtn_Abomey,300000,91625,2022-08-15
TRANSFER,64916,Gérard Blot de Blanc,978377,913461,Valérie de Pottier,1497200,1432284,2022-08-16
TRANSFER,95269,Martin Moreau,1315200,1219931,Gérard Blot de Blanc,913461,1008730,2022-08-16
CASH_OUT,168600,Gérard Blot de Blanc,1008730,840130,Agence_mtn_Ouidah,300000,131400,2022-08-17
TRANSFER,183401,Gérard Blot de Blanc,840130,656729,Roland Huet,952600,769199,2022-08-17
CASH_OUT,343716,Gérard Blot de Blanc,656729,313013,Agence_mtn_Cotonou,300000,-43716,2022-08-17
CASH_OUT,263443,Gérard Blot de Blanc,313013,49570,Agence_mtn_Ouidah,300000,36557,2022-08-17
CASH_IN,231580,Agence_mtn_Ouidah,300000,68420,Gérard Blot de Blanc,49570,281150,2022-08-18
CASH_OUT,55717,Gérard Blot de Blanc,281150,225433,Agence_mtn_Cotonou,300000,244283,2022-08-19
TRANSFER,26004,Julie Germain Le Vaillant,34708,8704,Gérard Blot de Blanc,225433,251437,2022-08-20
CASH_IN,110436,Agence_mtn_Cotonou,300000,189564,Gérard Blot de Blanc,251437,361873,2022-08-23
TRANSFER,301787,Gérard Blot de Blanc,361873,60086,Marc Baudry,6635,-295152,2022-08-24
CASH_IN,205106,Agence_mtn_Cotonou,300000,94894,Gérard Blot de Blanc,60086,265192,2022-08-24
CASH_OUT,109003,Gérard Blot de Blanc,265192,156189,Agence_mtn_Ouidah,300000,190997,2022-08-27
TRANSFER,188566,Raymond de Le Roux,493000,304434,Margaud-Michelle Briand,378112,189546,2022-08-02
CASH_OUT,278463,Raymond de Le Roux,304434,25971,Agence_mtn_Abomey,300000,21537,2022-08-02
TRANSFER,1162349,Valérie de Pottier,1432284,269935,Raymond de Le Roux,25971,1188320,2022-08-03
CASH_IN,72326,Agence_mtn_Cotonou,300000,227674,Raymond de Le Roux,1188320,1260646,2022-08-04
CASH_OUT,654934,Raymond de Le Roux,1260646,605712,Agence_mtn_Cotonou,300000,-354934,2022-08-06
CASH_IN,177621,Agence_mtn_Abomey,300000,122379,Raymond de Le Roux,605712,783333,2022-08-07
CASH_IN,10044,Agence_mtn_Cotonou,300000,289956,Raymond de Le Roux,783333,793377,2022-08-08
CASH_OUT,124060,Raymond de Le Roux,793377,669317,Agence_mtn_Ouidah,300000,175940,2022-08-11
CASH_IN,99878,Agence_mtn_Abomey,300000,200122,Raymond de Le Roux,669317,769195,2022-08-12
CASH_OUT,567779,Raymond de Le Roux,769195,201416,Agence_mtn_Cotonou,300000,-267779,2022-08-14
TRANSFER,211429,Édouard Grondin du Fleury,342297,130868,Raymond de Le Roux,201416,412845,2022-08-17
CASH_IN,281217,Agence_mtn_Ouidah,300000,18783,Raymond de Le Roux,412845,694062,2022-08-21
CASH_OUT,489511,Raymond de Le Roux,694062,204551,Agence_mtn_Ouidah,300000,-189511,2022-08-21
CASH_OUT,91096,Raymond de Le Roux,204551,113455,Agence_mtn_Abomey,300000,208904,2022-08-22
CASH_IN,206681,Agence_mtn_Abomey,300000,93319,Raymond de Le Roux,113455,320136,2022-08-22
TRANSFER,76110,Raymond de Le Roux,320136,244026,Zacharie Fabre,313619,237509,2022-08-22
TRANSFER,1743,Raymond de Le Roux,244026,242283,Louis du Boyer,632700,630957,2022-08-23
TRANSFER,187963,Jacques Le Marion,886838,698875,Raymond de Le Roux,242283,430246,2022-08-24
CASH_IN,85645,Agence_mtn_Abomey,300000,214355,Raymond de Le Roux,430246,515891,2022-08-25
TRANSFER,33379,Margaud-Michelle Briand,189546,156167,Raymond de Le Roux,515891,549270,2022-08-26
CASH_IN,223889,Agence_mtn_Ouidah,300000,76111,Raymond de Le Roux,549270,773159,2022-08-27
TRANSFER,76546,Thérèse-Juliette Camus,137371,60825,Thibault-Julien Chevallier,6748,83294,2022-08-01
TRANSFER,63405,Thibault-Julien Chevallier,83294,19889,Hélène Alexandre de la Samson,444127,380722,2022-08-03
CASH_OUT,898,Thibault-Julien Chevallier,19889,18991,Agence_mtn_Abomey,300000,299102,2022-08-05
CASH_IN,123641,Agence_mtn_Ouidah,300000,176359,Thibault-Julien Chevallier,18991,142632,2022-08-06
CASH_OUT,12030,Thibault-Julien Chevallier,142632,130602,Agence_mtn_Cotonou,300000,287970,2022-08-06
TRANSFER,115971,Thibault-Julien Chevallier,130602,14631,Aurélie Maury,1709500,1593529,2022-08-06
CASH_OUT,5221,Thibault-Julien Chevallier,14631,9410,Agence_mtn_Abomey,300000,294779,2022-08-08
TRANSFER,1187096,Aurélie Maury,1593529,406433,Thibault-Julien Chevallier,9410,1196506,2022-08-09
CASH_IN,160526,Agence_mtn_Ouidah,300000,139474,Thibault-Julien Chevallier,1196506,1357032,2022-08-09
CASH_OUT,674786,Thibault-Julien Chevallier,1357032,682246,Agence_mtn_Abomey,300000,-374786,2022-08-11
CASH_OUT,287681,Thibault-Julien Chevallier,682246,394565,Agence_mtn_Ouidah,300000,12319,2022-08-11
CASH_OUT,81554,Thibault-Julien Chevallier,394565,313011,Agence_mtn_Ouidah,300000,218446,2022-08-12
CASH_IN,111303,Agence_mtn_Cotonou,300000,188697,Thibault-Julien Chevallier,313011,424314,2022-08-13
CASH_IN,113568,Agence_mtn_Abomey,300000,186432,Thibault-Julien Chevallier,424314,537882,2022-08-14
TRANSFER,432729,Guillaume de la Nguyen,1032600,599871,Thibault-Julien Chevallier,537882,970611,2022-08-16
CASH_IN,136348,Agence_mtn_Ouidah,300000,163652,Thibault-Julien Chevallier,970611,1106959,2022-08-16
TRANSFER,1757442,Marine Labbé,1817500,60058,Thibault-Julien Chevallier,1106959,2864401,2022-08-17
CASH_OUT,2270926,Thibault-Julien Chevallier,2864401,593475,Agence_mtn_Abomey,300000,-1970926,2022-08-17
TRANSFER,422142,Thibault-Julien Chevallier,593475,171333,Aurélie Maury,406433,-15709,2022-08-19
TRANSFER,73404,Thibault-Julien Chevallier,171333,97929,Anouk Delahaye-Gimenez,1548200,1474796,2022-08-19
CASH_IN,42210,Agence_mtn_Ouidah,300000,257790,Thibault-Julien Chevallier,97929,140139,2022-08-19
TRANSFER,52717,Thibault-Julien Chevallier,140139,87422,Nicolas Blin,131155,78438,2022-08-19
CASH_IN,188940,Agence_mtn_Abomey,300000,111060,Thibault-Julien Chevallier,87422,276362,2022-08-20
CASH_IN,234517,Agence_mtn_Cotonou,300000,65483,Thibault-Julien Chevallier,276362,510879,2022-08-22
CASH_OUT,460793,Thibault-Julien Chevallier,510879,50086,Agence_mtn_Abomey,300000,-160793,2022-08-22
CASH_IN,172415,Agence_mtn_Ouidah,300000,127585,Thibault-Julien Chevallier,50086,222501,2022-08-23
TRANSFER,80606,Thibault-Julien Chevallier,222501,141895,Emmanuel Vallée,1379900,1299294,2022-08-24
CASH_IN,169200,Agence_mtn_Abomey,300000,130800,Thibault-Julien Chevallier,141895,311095,2022-08-24
TRANSFER,5278,Thibault-Julien Chevallier,311095,305817,Sophie-Anouk Boulanger,57614,52336,2022-08-24
TRANSFER,269338,Thibault-Julien Chevallier,305817,36479,Jules-Marc Chauvet,706847,437509,2022-08-26
TRANSFER,428838,Marthe Perrin,560084,131246,Michelle de la Daniel,114380,-314458,2022-08-03
TRANSFER,117124,Marthe Perrin,131246,14122,Louis du Boyer,630957,513833,2022-08-03
CASH_OUT,311,Marthe Perrin,14122,13811,Agence_mtn_Cotonou,300000,299689,2022-08-04
TRANSFER,10612,Marthe Perrin,13811,3199,Henri de Didier,1527360,1516748,2022-08-04
CASH_OUT,2543,Marthe Perrin,3199,656,Agence_mtn_Abomey,300000,297457,2022-08-04
CASH_IN,276253,Agence_mtn_Ouidah,300000,23747,Marthe Perrin,656,276909,2022-08-06
CASH_IN,121005,Agence_mtn_Ouidah,300000,178995,Marthe Perrin,276909,397914,2022-08-07
CASH_IN,201482,Agence_mtn_Abomey,300000,98518,Marthe Perrin,397914,599396,2022-08-10
TRANSFER,497205,Marthe Perrin,599396,102191,Jacques Laporte de Blanchet,35972,-461233,2022-08-10
CASH_OUT,37085,Marthe Perrin,102191,65106,Agence_mtn_Ouidah,300000,262915,2022-08-13
CASH_IN,71899,Agence_mtn_Abomey,300000,228101,Marthe Perrin,65106,137005,2022-08-13
TRANSFER,70257,Marthe Perrin,137005,66748,Christophe Besnard-Diaz,1320300,1250043,2022-08-14
CASH_IN,196409,Agence_mtn_Ouidah,300000,103591,Marthe Perrin,66748,263157,2022-08-15
TRANSFER,5460,Nicolas Blin,78438,72978,Marthe Perrin,263157,268617,2022-08-15
TRANSFER,98494,Louis du Boyer,513833,415339,Marthe Perrin,268617,367111,2022-08-16
TRANSFER,108859,Marthe Perrin,367111,258252,Jacques Marchand,522383,413524,2022-08-17
TRANSFER,179232,Marthe Perrin,258252,79020,Martin Moreau,1219931,1040699,2022-08-20
CASH_OUT,39580,Marthe Perrin,79020,39440,Agence_mtn_Abomey,300000,260420,2022-08-21
CASH_IN,199537,Agence_mtn_Cotonou,300000,100463,Marthe Perrin,39440,238977,2022-08-25
TRANSFER,295526,Jacques Marchand,413524,117998,Marthe Perrin,238977,534503,2022-08-27
CASH_IN,18892,Agence_mtn_Cotonou,300000,281108,Marthe Perrin,534503,553395,2022-08-27
CASH_IN,20092,Agence_mtn_Ouidah,300000,279908,Madeleine Hardy,-484626,-464534,2022-08-02
CASH_IN,31985,Agence_mtn_Cotonou,300000,268015,Madeleine Hardy,-464534,-432549,2022-08-02
CASH_IN,207344,Agence_mtn_Ouidah,300000,92656,Madeleine Hardy,-432549,-225205,2022-08-02
CASH_IN,208749,Agence_mtn_Abomey,300000,91251,Madeleine Hardy,-225205,-16456,2022-08-02
CASH_IN,909,Agence_mtn_Abomey,300000,299091,Madeleine Hardy,-16456,-15547,2022-08-03
CASH_IN,153222,Agence_mtn_Ouidah,300000,146778,Madeleine Hardy,-15547,137675,2022-08-05
TRANSFER,5060,Madeleine Hardy,137675,132615,Maggie Barbier,1055518,1050458,2022-08-06
TRANSFER,5636,Julie Germain Le Vaillant,8704,3068,Madeleine Hardy,132615,138251,2022-08-08
CASH_IN,139064,Agence_mtn_Ouidah,300000,160936,Madeleine Hardy,138251,277315,2022-08-08
CASH_IN,94767,Agence_mtn_Cotonou,300000,205233,Madeleine Hardy,277315,372082,2022-08-10
TRANSFER,68814,Madeleine Hardy,372082,303268,Françoise Denis de Allard,1769800,1700986,2022-08-11
CASH_OUT,285871,Madeleine Hardy,303268,17397,Agence_mtn_Cotonou,300000,14129,2022-08-11
CASH_OUT,830,Madeleine Hardy,17397,16567,Agence_mtn_Cotonou,300000,299170,2022-08-15
TRANSFER,357959,Sylvie Dupré,818600,460641,Madeleine Hardy,16567,374526,2022-08-16
CASH_IN,288742,Agence_mtn_Abomey,300000,11258,Madeleine Hardy,374526,663268,2022-08-16
TRANSFER,293138,Jules-Marc Chauvet,437509,144371,Madeleine Hardy,663268,956406,2022-08-16
CASH_IN,217588,Agence_mtn_Ouidah,300000,82412,Madeleine Hardy,956406,1173994,2022-08-21
CASH_OUT,604918,Madeleine Hardy,1173994,569076,Agence_mtn_Cotonou,300000,-304918,2022-08-21
CASH_OUT,558715,Madeleine Hardy,569076,10361,Agence_mtn_Cotonou,300000,-258715,2022-08-21
TRANSFER,13702,Charlotte Perrier,430100,416398,Madeleine Hardy,10361,24063,2022-08-22
TRANSFER,248622,Maggie Barbier,1050458,801836,Madeleine Hardy,24063,272685,2022-08-27
CASH_IN,31994,Agence_mtn_Cotonou,300000,268006,Madeleine Hardy,272685,304679,2022-08-27
CASH_IN,269161,Agence_mtn_Cotonou,300000,30839,Jacques Laporte de Blanchet,-461233,-192072,2022-08-01
CASH_IN,186481,Agence_mtn_Cotonou,300000,113519,Jacques Laporte de Blanchet,-192072,-5591,2022-08-02
CASH_IN,52052,Agence_mtn_Ouidah,300000,247948,Jacques Laporte de Blanchet,-5591,46461,2022-08-03
TRANSFER,17569,Nicolas Blin,72978,55409,Jacques Laporte de Blanchet,46461,64030,2022-08-05
CASH_OUT,36802,Jacques Laporte de Blanchet,64030,27228,Agence_mtn_Ouidah,300000,263198,2022-08-07
CASH_IN,200303,Agence_mtn_Ouidah,300000,99697,Jacques Laporte de Blanchet,27228,227531,2022-08-07
CASH_OUT,119319,Jacques Laporte de Blanchet,227531,108212,Agence_mtn_Abomey,300000,180681,2022-08-08
TRANSFER,55299,Jacques Laporte de Blanchet,108212,52913,Martin Moreau,1040699,985400,2022-08-10
CASH_OUT,20719,Jacques Laporte de Blanchet,52913,32194,Agence_mtn_Abomey,300000,279281,2022-08-11
TRANSFER,34504,Sophie-Anouk Boulanger,52336,17832,Jacques Laporte de Blanchet,32194,66698,2022-08-11
TRANSFER,343817,Henri de Didier,1516748,1172931,Jacques Laporte de Blanchet,66698,410515,2022-08-12
CASH_OUT,379576,Jacques Laporte de Blanchet,410515,30939,Agence_mtn_Cotonou,300000,-79576,2022-08-13
CASH_IN,180470,Agence_mtn_Abomey,300000,119530,Jacques Laporte de Blanchet,30939,211409,2022-08-14
CASH_OUT,94717,Jacques Laporte de Blanchet,211409,116692,Agence_mtn_Abomey,300000,205283,2022-08-14
CASH_OUT,16564,Jacques Laporte de Blanchet,116692,100128,Agence_mtn_Ouidah,300000,283436,2022-08-15
TRANSFER,240281,Louis du Boyer,415339,175058,Jacques Laporte de Blanchet,100128,340409,2022-08-15
CASH_IN,143698,Agence_mtn_Ouidah,300000,156302,Jacques Laporte de Blanchet,340409,484107,2022-08-16
CASH_IN,91762,Agence_mtn_Cotonou,300000,208238,Jacques Laporte de Blanchet,484107,575869,2022-08-17
CASH_OUT,95625,Jacques Laporte de Blanchet,575869,480244,Agence_mtn_Cotonou,300000,204375,2022-08-17
CASH_OUT,209888,Jacques Laporte de Blanchet,480244,270356,Agence_mtn_Cotonou,300000,90112,2022-08-18
CASH_IN,12126,Agence_mtn_Ouidah,300000,287874,Jacques Laporte de Blanchet,270356,282482,2022-08-18
CASH_OUT,16683,Jacques Laporte de Blanchet,282482,265799,Agence_mtn_Ouidah,300000,283317,2022-08-20
CASH_OUT,146420,Jacques Laporte de Blanchet,265799,119379,Agence_mtn_Abomey,300000,153580,2022-08-22
TRANSFER,215985,Martin Moreau,985400,769415,Jacques Laporte de Blanchet,119379,335364,2022-08-24
TRANSFER,54128,Jacques Laporte de Blanchet,335364,281236,Emmanuel Vallée,1299294,1245166,2022-08-26
CASH_OUT,162553,Jacques Laporte de Blanchet,281236,118683,Agence_mtn_Abomey,300000,137447,2022-08-27
CASH_IN,68528,Agence_mtn_Ouidah,300000,231472,Marine Labbé,60058,128586,2022-08-01
TRANSFER,271701,Pénélope Boulay,320600,48899,Marine Labbé,128586,400287,2022-08-02
TRANSFER,212009,Marine Labbé,400287,188278,Louis de la Imbert,398900,186891,2022-08-03
TRANSFER,152345,Maurice de Brunet,822700,670355,Marine Labbé,188278,340623,2022-08-09
CASH_IN,39602,Agence_mtn_Cotonou,300000,260398,Marine Labbé,340623,380225,2022-08-10
CASH_IN,242783,Agence_mtn_Ouidah,300000,57217,Marine Labbé,380225,623008,2022-08-10
CASH_IN,52652,Agence_mtn_Ouidah,300000,247348,Marine Labbé,623008,675660,2022-08-12
CASH_OUT,463041,Marine Labbé,675660,212619,Agence_mtn_Ouidah,300000,-163041,2022-08-12
CASH_IN,58887,Agence_mtn_Cotonou,300000,241113,Marine Labbé,212619,271506,2022-08-13
TRANSFER,216738,Marine Labbé,271506,54768,Anouk Delahaye-Gimenez,1474796,1258058,2022-08-13
CASH_OUT,20434,Marine Labbé,54768,34334,Agence_mtn_Cotonou,300000,279566,2022-08-13
CASH_OUT,15190,Marine Labbé,34334,19144,Agence_mtn_Cotonou,300000,284810,2022-08-14
CASH_OUT,18671,Marine Labbé,19144,473,Agence_mtn_Ouidah,300000,281329,2022-08-15
CASH_IN,230267,Agence_mtn_Ouidah,300000,69733,Marine Labbé,473,230740,2022-08-16
TRANSFER,448055,Maggie Barbier,801836,353781,Marine Labbé,230740,678795,2022-08-16
TRANSFER,391623,Marine Labbé,678795,287172,Nicole Huet,392149,526,2022-08-18
CASH_OUT,57982,Marine Labbé,287172,229190,Agence_mtn_Abomey,300000,242018,2022-08-18
CASH_OUT,2323,Marine Labbé,229190,226867,Agence_mtn_Abomey,300000,297677,2022-08-18
CASH_OUT,136713,Marine Labbé,226867,90154,Agence_mtn_Cotonou,300000,163287,2022-08-19
TRANSFER,121511,Maurice de Brunet,670355,548844,Marine Labbé,90154,211665,2022-08-19
TRANSFER,253861,René de la Delaunay,341300,87439,Marine Labbé,211665,465526,2022-08-20
TRANSFER,110520,Marine Labbé,465526,355006,Laurent Marion,1313900,1203380,2022-08-21
CASH_OUT,352896,Marine Labbé,355006,2110,Agence_mtn_Abomey,300000,-52896,2022-08-21
CASH_OUT,441,Marine Labbé,2110,1669,Agence_mtn_Cotonou,300000,299559,2022-08-21
CASH_IN,79243,Agence_mtn_Ouidah,300000,220757,Marine Labbé,1669,80912,2022-08-22
CASH_IN,198258,Agence_mtn_Cotonou,300000,101742,Marine Labbé,80912,279170,2022-08-23
CASH_OUT,205324,Marine Labbé,279170,73846,Agence_mtn_Cotonou,300000,94676,2022-08-23
TRANSFER,2604,Marine Labbé,73846,71242,Édouard Grondin du Fleury,130868,128264,2022-08-24
TRANSFER,498749,Roland Huet,769199,270450,Marine Labbé,71242,569991,2022-08-25
CASH_IN,75213,Agence_mtn_Ouidah,300000,224787,Marine Labbé,569991,645204,2022-08-27
CASH_OUT,288961,Hélène Alexandre de la Samson,380722,91761,Agence_mtn_Cotonou,300000,11039,2022-08-02
TRANSFER,164127,Maurice de Brunet,548844,384717,Hélène Alexandre de la Samson,91761,255888,2022-08-02
CASH_OUT,145613,Hélène Alexandre de la Samson,255888,110275,Agence_mtn_Ouidah,300000,154387,2022-08-06
CASH_OUT,83708,Hélène Alexandre de la Samson,110275,26567,Agence_mtn_Ouidah,300000,216292,2022-08-07
TRANSFER,5708,Hélène Alexandre de la Samson,26567,20859,Jacques Le Marion,698875,693167,2022-08-09
CASH_OUT,2728,Hélène Alexandre de la Samson,20859,18131,Agence_mtn_Ouidah,300000,297272,2022-08-10
CASH_OUT,6092,Hélène Alexandre de la Samson,18131,12039,Agence_mtn_Abomey,300000,293908,2022-08-11
CASH_IN,247914,Agence_mtn_Abomey,300000,52086,Hélène Alexandre de la Samson,12039,259953,2022-08-11
TRANSFER,6214,Margaud-Michelle Briand,156167,149953,Hélène Alexandre de la Samson,259953,266167,2022-08-13
TRANSFER,88169,Hélène Alexandre de la Samson,266167,177998,Édouard Grondin du Fleury,128264,40095,2022-08-13
CASH_OUT,45613,Hélène Alexandre de la Samson,177998,132385,Agence_mtn_Ouidah,300000,254387,2022-08-14
CASH_OUT,9945,Hélène Alexandre de la Samson,132385,122440,Agence_mtn_Abomey,300000,290055,2022-08-14
TRANSFER,37895,Margaud-Michelle Briand,149953,112058,Hélène Alexandre de la Samson,122440,160335,2022-08-16
CASH_OUT,137358,Hélène Alexandre de la Samson,160335,22977,Agence_mtn_Ouidah,300000,162642,2022-08-18
TRANSFER,11022,Hélène Alexandre de la Samson,22977,11955,Françoise Denis de Allard,1700986,1689964,2022-08-19
CASH_IN,33020,Agence_mtn_Abomey,300000,266980,Hélène Alexandre de la Samson,11955,44975,2022-08-20
TRANSFER,1472,Élisabeth Delattre,39371,37899,Hélène Alexandre de la Samson,44975,46447,2022-08-20
CASH_OUT,35499,Hélène Alexandre de la Samson,46447,10948,Agence_mtn_Ouidah,300000,264501,2022-08-21
CASH_OUT,9580,Hélène Alexandre de la Samson,10948,1368,Agence_mtn_Abomey,300000,290420,2022-08-23
CASH_IN,285416,Agence_mtn_Cotonou,300000,14584,Hélène Alexandre de la Samson,1368,286784,2022-08-25
CASH_OUT,31893,Hélène Alexandre de la Samson,286784,254891,Agence_mtn_Cotonou,300000,268107,2022-08-27
CASH_IN,145950,Agence_mtn_Abomey,300000,154050,Corinne Roussel,1924700,2070650,2022-08-01
CASH_IN,31635,Agence_mtn_Abomey,300000,268365,Corinne Roussel,2070650,2102285,2022-08-02
TRANSFER,81377,Corinne Roussel,2102285,2020908,Nicole Huet,526,-80851,2022-08-02
CASH_IN,160086,Agence_mtn_Ouidah,300000,139914,Corinne Roussel,2020908,2180994,2022-08-03
CASH_IN,102375,Agence_mtn_Abomey,300000,197625,Corinne Roussel,2180994,2283369,2022-08-05
CASH_IN,204311,Agence_mtn_Abomey,300000,95689,Corinne Roussel,2283369,2487680,2022-08-05
CASH_OUT,2264414,Corinne Roussel,2487680,223266,Agence_mtn_Ouidah,300000,-1964414,2022-08-07
CASH_IN,262684,Agence_mtn_Ouidah,300000,37316,Corinne Roussel,223266,485950,2022-08-09
TRANSFER,203828,Corinne Roussel,485950,282122,Nicolas Blin,55409,-148419,2022-08-09
CASH_IN,34510,Agence_mtn_Ouidah,300000,265490,Corinne Roussel,282122,316632,2022-08-10
TRANSFER,222508,Corinne Roussel,316632,94124,Sophie-Anouk Boulanger,17832,-204676,2022-08-11
CASH_OUT,45761,Corinne Roussel,94124,48363,Agence_mtn_Ouidah,300000,254239,2022-08-11
CASH_OUT,15960,Corinne Roussel,48363,32403,Agence_mtn_Abomey,300000,284040,2022-08-11
CASH_OUT,14431,Corinne Roussel,32403,17972,Agence_mtn_Cotonou,300000,285569,2022-08-12
CASH_IN,156830,Agence_mtn_Abomey,300000,143170,Corinne Roussel,17972,174802,2022-08-13
CASH_OUT,91777,Corinne Roussel,174802,83025,Agence_mtn_Abomey,300000,208223,2022-08-16
TRANSFER,251734,Madeleine Philippe-Grondin,310028,58294,Corinne Roussel,83025,334759,2022-08-16
CASH_IN,250721,Agence_mtn_Abomey,300000,49279,Corinne Roussel,334759,585480,2022-08-19
CASH_IN,145977,Agence_mtn_Ouidah,300000,154023,Corinne Roussel,585480,731457,2022-08-21
TRANSFER,283268,Corinne Roussel,731457,448189,Corinne Roussel,731457,448189,2022-08-21
TRANSFER,300475,Corinne Roussel,448189,147714,Clémence-Alice Ruiz,290127,-10348,2022-08-21
CASH_OUT,112071,Corinne Roussel,147714,35643,Agence_mtn_Cotonou,300000,187929,2022-08-21
CASH_OUT,29053,Corinne Roussel,35643,6590,Agence_mtn_Cotonou,300000,270947,2022-08-22
CASH_OUT,4095,Corinne Roussel,6590,2495,Agence_mtn_Cotonou,300000,295905,2022-08-23
TRANSFER,1270,Corinne Roussel,2495,1225,Christophe Besnard-Diaz,1250043,1248773,2022-08-23
TRANSFER,601,Corinne Roussel,1225,624,Christophe Teixeira,607200,606599,2022-08-26
CASH_IN,79036,Agence_mtn_Cotonou,300000,220964,Corinne Roussel,624,79660,2022-08-27
TRANSFER,521960,Christophe Teixeira,606599,84639,Louis du Boyer,175058,-346902,2022-08-01
CASH_OUT,12805,Christophe Teixeira,84639,71834,Agence_mtn_Cotonou,300000,287195,2022-08-01
CASH_OUT,39935,Christophe Teixeira,71834,31899,Agence_mtn_Ouidah,300000,260065,2022-08-01
TRANSFER,5321,Christophe Teixeira,31899,26578,Nathalie-Claire De Oliveira,986752,981431,2022-08-03
CASH_IN,236140,Agence_mtn_Ouidah,300000,63860,Christophe Teixeira,26578,262718,2022-08-03
CASH_OUT,110251,Christophe Teixeira,262718,152467,Agence_mtn_Ouidah,300000,189749,2022-08-03
CASH_IN,255005,Agence_mtn_Ouidah,300000,44995,Christophe Teixeira,152467,407472,2022-08-04
TRANSFER,1022793,Honoré de la Prévost,1732100,709307,Christophe Teixeira,407472,1430265,2022-08-07
CASH_IN,286886,Agence_mtn_Cotonou,300000,13114,Christophe Teixeira,1430265,1717151,2022-08-08
CASH_IN,101186,Agence_mtn_Abomey,300000,198814,Christophe Teixeira,1717151,1818337,2022-08-11
CASH_OUT,23050,Christophe Teixeira,1818337,1795287,Agence_mtn_Abomey,300000,276950,2022-08-12
CASH_OUT,13635,Christophe Teixeira,1795287,1781652,Agence_mtn_Abomey,300000,286365,2022-08-12
CASH_IN,38230,Agence_mtn_Cotonou,300000,261770,Christophe Teixeira,1781652,1819882,2022-08-12
TRANSFER,586544,Christophe Teixeira,1819882,1233338,Jacques Le Marion,693167,106623,2022-08-13
CASH_OUT,149452,Christophe Teixeira,1233338,1083886,Agence_mtn_Abomey,300000,150548,2022-08-17
CASH_IN,62102,Agence_mtn_Ouidah,300000,237898,Christophe Teixeira,1083886,1145988,2022-08-18
CASH_IN,275439,Agence_mtn_Cotonou,300000,24561,Christophe Teixeira,1145988,1421427,2022-08-21
CASH_IN,210666,Agence_mtn_Ouidah,300000,89334,Christophe Teixeira,1421427,1632093,2022-08-22
CASH_OUT,54448,Christophe Teixeira,1632093,1577645,Agence_mtn_Abomey,300000,245552,2022-08-22
CASH_IN,244210,Agence_mtn_Ouidah,300000,55790,Christophe Teixeira,1577645,1821855,2022-08-23
TRANSFER,1672935,Christophe Teixeira,1821855,148920,Martin Moreau,769415,-903520,2022-08-23
TRANSFER,1161,Christophe Teixeira,148920,147759,Gérard Cordier,832454,831293,2022-08-25
CASH_OUT,45553,Christophe Teixeira,147759,102206,Agence_mtn_Ouidah,300000,254447,2022-08-26
TRANSFER,41067,Pénélope Boulay,48899,7832,Christophe Teixeira,102206,143273,2022-08-26
CASH_OUT,64844,Jacques Marchand,117998,53154,Agence_mtn_Abomey,300000,235156,2022-08-01
TRANSFER,172549,Anouk Delahaye-Gimenez,1258058,1085509,Jacques Marchand,53154,225703,2022-08-03
CASH_IN,220901,Agence_mtn_Ouidah,300000,79099,Jacques Marchand,225703,446604,2022-08-04
TRANSFER,178657,Jacques Marchand,446604,267947,Emmanuel Vallée,1245166,1066509,2022-08-05
CASH_IN,248901,Agence_mtn_Cotonou,300000,51099,Jacques Marchand,267947,516848,2022-08-05
CASH_IN,44972,Agence_mtn_Cotonou,300000,255028,Jacques Marchand,516848,561820,2022-08-07
CASH_OUT,311191,Jacques Marchand,561820,250629,Agence_mtn_Cotonou,300000,-11191,2022-08-10
TRANSFER,58089,Margaud-Michelle Briand,112058,53969,Jacques Marchand,250629,308718,2022-08-10
CASH_IN,155832,Agence_mtn_Abomey,300000,144168,Jacques Marchand,308718,464550,2022-08-11
CASH_IN,39737,Agence_mtn_Abomey,300000,260263,Jacques Marchand,464550,504287,2022-08-11
CASH_OUT,432662,Jacques Marchand,504287,71625,Agence_mtn_Cotonou,300000,-132662,2022-08-12
TRANSFER,35203,Jacques Marchand,71625,36422,Zacharie Fabre,237509,202306,2022-08-13
CASH_IN,137157,Agence_mtn_Cotonou,300000,162843,Jacques Marchand,36422,173579,2022-08-15
CASH_OUT,142385,Jacques Marchand,173579,31194,Agence_mtn_Abomey,300000,157615,2022-08-15
CASH_OUT,17976,Jacques Marchand,31194,13218,Agence_mtn_Ouidah,300000,282024,2022-08-16
TRANSFER,5711,Thérèse-Juliette Camus,60825,55114,Jacques Marchand,13218,18929,2022-08-16
CASH_IN,244612,Agence_mtn_Ouidah,300000,55388,Jacques Marchand,18929,263541,2022-08-17
CASH_OUT,22088,Jacques Marchand,263541,241453,Agence_mtn_Ouidah,300000,277912,2022-08-18
TRANSFER,58004,Jacques Marchand,241453,183449,Guillaume de la Nguyen,599871,541867,2022-08-20
TRANSFER,228167,Roland Huet,270450,42283,Jacques Marchand,183449,411616,2022-08-20
CASH_IN,43142,Agence_mtn_Ouidah,300000,256858,Jacques Marchand,411616,454758,2022-08-20
CASH_OUT,325230,Jacques Marchand,454758,129528,Agence_mtn_Abomey,300000,-25230,2022-08-21
CASH_IN,267124,Agence_mtn_Ouidah,300000,32876,Jacques Marchand,129528,396652,2022-08-25
CASH_IN,115250,Agence_mtn_Cotonou,300000,184750,Jacques Marchand,396652,511902,2022-08-25
CASH_OUT,319182,Jacques Marchand,511902,192720,Agence_mtn_Cotonou,300000,-19182,2022-08-26
CASH_OUT,104499,Jacques Marchand,192720,88221,Agence_mtn_Ouidah,300000,195501,2022-08-26
CASH_IN,207588,Agence_mtn_Abomey,300000,92412,Jacques Marchand,88221,295809,2022-08-27
CASH_IN,98950,Agence_mtn_Cotonou,300000,201050,Jacques Marchand,295809,394759,2022-08-27
CASH_OUT,34870,Jacques Marchand,394759,359889,Agence_mtn_Ouidah,300000,265130,2022-08-27
CASH_IN,116504,Agence_mtn_Cotonou,300000,183496,Michelle de la Daniel,-314458,-197954,2022-08-03
CASH_IN,195969,Agence_mtn_Ouidah,300000,104031,Michelle de la Daniel,-197954,-1985,2022-08-04
CASH_IN,287010,Agence_mtn_Ouidah,300000,12990,Michelle de la Daniel,-1985,285025,2022-08-06
CASH_IN,170847,Agence_mtn_Ouidah,300000,129153,Michelle de la Daniel,285025,455872,2022-08-06
TRANSFER,746514,Élisabeth Blot-Bruneau,835502,88988,Michelle de la Daniel,455872,1202386,2022-08-08
CASH_IN,258426,Agence_mtn_Cotonou,300000,41574,Michelle de la Daniel,1202386,1460812,2022-08-09
CASH_OUT,1225672,Michelle de la Daniel,1460812,235140,Agence_mtn_Cotonou,300000,-925672,2022-08-09
CASH_IN,234235,Agence_mtn_Abomey,300000,65765,Michelle de la Daniel,235140,469375,2022-08-13
CASH_IN,138262,Agence_mtn_Ouidah,300000,161738,Michelle de la Daniel,469375,607637,2022-08-15
CASH_IN,199104,Agence_mtn_Abomey,300000,100896,Michelle de la Daniel,607637,806741,2022-08-16
CASH_IN,156409,Agence_mtn_Abomey,300000,143591,Michelle de la Daniel,806741,963150,2022-08-16
CASH_IN,91301,Agence_mtn_Ouidah,300000,208699,Michelle de la Daniel,963150,1054451,2022-08-17
TRANSFER,436228,Michelle de la Daniel,1054451,618223,Emmanuel Vallée,1066509,630281,2022-08-17
CASH_IN,204516,Agence_mtn_Ouidah,300000,95484,Michelle de la Daniel,618223,822739,2022-08-19
CASH_OUT,466039,Michelle de la Daniel,822739,356700,Agence_mtn_Abomey,300000,-166039,2022-08-19
CASH_OUT,235381,Michelle de la Daniel,356700,121319,Agence_mtn_Ouidah,300000,64619,2022-08-20
TRANSFER,3871,Michelle de la Daniel,121319,117448,Gérard Cordier,831293,827422,2022-08-21
TRANSFER,39642,Jacques Le Marion,106623,66981,Michelle de la Daniel,117448,157090,2022-08-23
TRANSFER,788258,Nathalie-Claire De Oliveira,981431,193173,Michelle de la Daniel,157090,945348,2022-08-24
CASH_OUT,464622,Michelle de la Daniel,945348,480726,Agence_mtn_Abomey,300000,-164622,2022-08-24
CASH_OUT,412571,Michelle de la Daniel,480726,68155,Agence_mtn_Cotonou,300000,-112571,2022-08-24
CASH_IN,75677,Agence_mtn_Ouidah,300000,224323,Michelle de la Daniel,68155,143832,2022-08-25
TRANSFER,130406,Michelle de la Daniel,143832,13426,Jacques Le Marion,66981,-63425,2022-08-25
CASH_OUT,3627,Michelle de la Daniel,13426,9799,Agence_mtn_Cotonou,300000,296373,2022-08-26
CASH_OUT,2095,Michelle de la Daniel,9799,7704,Agence_mtn_Cotonou,300000,297905,2022-08-26
CASH_OUT,1390,Julie Germain Le Vaillant,3068,1678,Agence_mtn_Abomey,300000,298610,2022-08-01
TRANSFER,293,Julie Germain Le Vaillant,1678,1385,Gabrielle Hamon,213477,213184,2022-08-01
CASH_OUT,471,Julie Germain Le Vaillant,1385,914,Agence_mtn_Cotonou,300000,299529,2022-08-01
CASH_OUT,441,Julie Germain Le Vaillant,914,473,Agence_mtn_Abomey,300000,299559,2022-08-03
CASH_OUT,123,Julie Germain Le Vaillant,473,350,Agence_mtn_Cotonou,300000,299877,2022-08-03
TRANSFER,543310,Charles Guérin,947215,403905,Julie Germain Le Vaillant,350,543660,2022-08-03
TRANSFER,81274,Gérard Cordier,827422,746148,Julie Germain Le Vaillant,543660,624934,2022-08-05
CASH_IN,169866,Agence_mtn_Cotonou,300000,130134,Julie Germain Le Vaillant,624934,794800,2022-08-05
TRANSFER,603028,Julie Germain Le Vaillant,794800,191772,Anouk Delahaye-Gimenez,1085509,482481,2022-08-07
TRANSFER,338293,Anouk Delahaye-Gimenez,482481,144188,Julie Germain Le Vaillant,191772,530065,2022-08-08
CASH_IN,20283,Agence_mtn_Cotonou,300000,279717,Julie Germain Le Vaillant,530065,550348,2022-08-10
CASH_IN,130101,Agence_mtn_Ouidah,300000,169899,Julie Germain Le Vaillant,550348,680449,2022-08-11
CASH_OUT,256089,Julie Germain Le Vaillant,680449,424360,Agence_mtn_Abomey,300000,43911,2022-08-12
CASH_IN,160653,Agence_mtn_Cotonou,300000,139347,Julie Germain Le Vaillant,424360,585013,2022-08-12
CASH_OUT,380189,Julie Germain Le Vaillant,585013,204824,Agence_mtn_Cotonou,300000,-80189,2022-08-13
CASH_OUT,147089,Julie Germain Le Vaillant,204824,57735,Agence_mtn_Cotonou,300000,152911,2022-08-14
CASH_IN,97726,Agence_mtn_Ouidah,300000,202274,Julie Germain Le Vaillant,57735,155461,2022-08-15
CASH_OUT,103351,Julie Germain Le Vaillant,155461,52110,Agence_mtn_Cotonou,300000,196649,2022-08-15
TRANSFER,35605,Julie Germain Le Vaillant,52110,16505,Guillaume de la Nguyen,541867,506262,2022-08-17
CASH_IN,246384,Agence_mtn_Cotonou,300000,53616,Julie Germain Le Vaillant,16505,262889,2022-08-19
CASH_IN,130104,Agence_mtn_Ouidah,300000,169896,Julie Germain Le Vaillant,262889,392993,2022-08-20
TRANSFER,15711,Julie Germain Le Vaillant,392993,377282,Roland Huet,42283,26572,2022-08-21
TRANSFER,83327,Charlotte Perrier,416398,333071,Julie Germain Le Vaillant,377282,460609,2022-08-21
CASH_OUT,174489,Julie Germain Le Vaillant,460609,286120,Agence_mtn_Abomey,300000,125511,2022-08-22
CASH_OUT,203204,Julie Germain Le Vaillant,286120,82916,Agence_mtn_Cotonou,300000,96796,2022-08-24
TRANSFER,82568,Élisabeth Blot-Bruneau,88988,6420,Julie Germain Le Vaillant,82916,165484,2022-08-27
TRANSFER,102007,Julie Germain Le Vaillant,165484,63477,Céline-Inès Meunier,770689,668682,2022-08-27
CASH_OUT,42169,Julie Germain Le Vaillant,63477,21308,Agence_mtn_Abomey,300000,257831,2022-08-27
CASH_IN,148388,Agence_mtn_Abomey,300000,151612,Martin Moreau,-903520,-755132,2022-08-01
CASH_IN,116317,Agence_mtn_Cotonou,300000,183683,Martin Moreau,-755132,-638815,2022-08-02
CASH_IN,98794,Agence_mtn_Cotonou,300000,201206,Martin Moreau,-638815,-540021,2022-08-05
CASH_IN,243728,Agence_mtn_Ouidah,300000,56272,Martin Moreau,-540021,-296293,2022-08-06
CASH_IN,64537,Agence_mtn_Cotonou,300000,235463,Martin Moreau,-296293,-231756,2022-08-08
CASH_IN,177314,Agence_mtn_Abomey,300000,122686,Martin Moreau,-231756,-54442,2022-08-10
CASH_IN,153044,Agence_mtn_Ouidah,300000,146956,Martin Moreau,-54442,98602,2022-08-11
TRANSFER,166789,Valérie de Pottier,269935,103146,Martin Moreau,98602,265391,2022-08-11
TRANSFER,18412,Martin Moreau,265391,246979,Guy-Augustin Pinto,1282203,1263791,2022-08-13
TRANSFER,22816,Roland Huet,26572,3756,Martin Moreau,246979,269795,2022-08-13
CASH_IN,213386,Agence_mtn_Cotonou,300000,86614,Martin Moreau,269795,483181,2022-08-14
CASH_OUT,204306,Martin Moreau,483181,278875,Agence_mtn_Ouidah,300000,95694,2022-08-14
CASH_OUT,91029,Martin Moreau,278875,187846,Agence_mtn_Ouidah,300000,208971,2022-08-14
CASH_IN,82106,Agence_mtn_Abomey,300000,217894,Martin Moreau,187846,269952,2022-08-18
CASH_OUT,4419,Martin Moreau,269952,265533,Agence_mtn_Ouidah,300000,295581,2022-08-18
TRANSFER,1198938,Christophe Besnard-Diaz,1248773,49835,Martin Moreau,265533,1464471,2022-08-19
CASH_IN,291968,Agence_mtn_Abomey,300000,8032,Martin Moreau,1464471,1756439,2022-08-19
TRANSFER,340712,Martin Moreau,1756439,1415727,Stéphanie Guichard,831600,490888,2022-08-19
CASH_OUT,993874,Martin Moreau,1415727,421853,Agence_mtn_Abomey,300000,-693874,2022-08-21
CASH_IN,82234,Agence_mtn_Ouidah,300000,217766,Martin Moreau,421853,504087,2022-08-21
CASH_IN,47446,Agence_mtn_Abomey,300000,252554,Martin Moreau,504087,551533,2022-08-22
CASH_OUT,489976,Martin Moreau,551533,61557,Agence_mtn_Abomey,300000,-189976,2022-08-22
TRANSFER,264566,Honoré de la Prévost,709307,444741,Martin Moreau,61557,326123,2022-08-22
CASH_OUT,246100,Martin Moreau,326123,80023,Agence_mtn_Ouidah,300000,53900,2022-08-24
CASH_OUT,22413,Martin Moreau,80023,57610,Agence_mtn_Abomey,300000,277587,2022-08-24
CASH_OUT,42195,Martin Moreau,57610,15415,Agence_mtn_Ouidah,300000,257805,2022-08-25
CASH_IN,138972,Agence_mtn_Abomey,300000,161028,Martin Moreau,15415,154387,2022-08-25
CASH_IN,132154,Agence_mtn_Abomey,300000,167846,Martin Moreau,154387,286541,2022-08-25
TRANSFER,20497,Gabrielle Hamon,213184,192687,Martin Moreau,286541,307038,2022-08-26
TRANSFER,47202,Martin Moreau,307038,259836,Édouard Grondin du Fleury,40095,-7107,2022-08-26
CASH_IN,77162,Agence_mtn_Cotonou,300000,222838,Élise Monnier,-160095,-82933,2022-08-02
CASH_IN,177400,Agence_mtn_Abomey,300000,122600,Élise Monnier,-82933,94467,2022-08-02
CASH_IN,266443,Agence_mtn_Ouidah,300000,33557,Élise Monnier,94467,360910,2022-08-08
TRANSFER,186861,Élise Monnier,360910,174049,Élisabeth Blot-Bruneau,6420,-180441,2022-08-08
CASH_IN,67777,Agence_mtn_Ouidah,300000,232223,Élise Monnier,174049,241826,2022-08-09
TRANSFER,444054,Céline-Inès Meunier,668682,224628,Élise Monnier,241826,685880,2022-08-09
CASH_IN,169989,Agence_mtn_Ouidah,300000,130011,Élise Monnier,685880,855869,2022-08-10
CASH_OUT,460660,Élise Monnier,855869,395209,Agence_mtn_Ouidah,300000,-160660,2022-08-10
CASH_IN,110156,Agence_mtn_Ouidah,300000,189844,Élise Monnier,395209,505365,2022-08-13
CASH_OUT,166154,Élise Monnier,505365,339211,Agence_mtn_Cotonou,300000,133846,2022-08-14
CASH_OUT,54652,Élise Monnier,339211,284559,Agence_mtn_Abomey,300000,245348,2022-08-14
TRANSFER,210731,Élise Monnier,284559,73828,Nathalie-Claire De Oliveira,193173,-17558,2022-08-16
TRANSFER,33341,Élise Monnier,73828,40487,Madeleine Philippe-Grondin,58294,24953,2022-08-19
CASH_OUT,8389,Élise Monnier,40487,32098,Agence_mtn_Cotonou,300000,291611,2022-08-19
CASH_OUT,3466,Élise Monnier,32098,28632,Agence_mtn_Ouidah,300000,296534,2022-08-19
TRANSFER,154089,Charles Guérin,403905,249816,Élise Monnier,28632,182721,2022-08-21
CASH_IN,175783,Agence_mtn_Abomey,300000,124217,Élise Monnier,182721,358504,2022-08-23
TRANSFER,228065,Élise Monnier,358504,130439,Pénélope Boulay,7832,-220233,2022-08-25
TRANSFER,51900,Thérèse-Juliette Camus,55114,3214,Élise Monnier,130439,182339,2022-08-25
CASH_OUT,72808,Élise Monnier,182339,109531,Agence_mtn_Abomey,300000,227192,2022-08-26
CASH_OUT,55314,Élise Monnier,109531,54217,Agence_mtn_Abomey,300000,244686,2022-08-27
CASH_OUT,135386,Raymond-Yves Boulanger,144298,8912,Agence_mtn_Cotonou,300000,164614,2022-08-01
CASH_IN,183327,Agence_mtn_Abomey,300000,116673,Raymond-Yves Boulanger,8912,192239,2022-08-05
TRANSFER,7519,Raymond-Yves Boulanger,192239,184720,Guy-Augustin Pinto,1263791,1256272,2022-08-05
CASH_OUT,174621,Raymond-Yves Boulanger,184720,10099,Agence_mtn_Abomey,300000,125379,2022-08-05
CASH_IN,164979,Agence_mtn_Cotonou,300000,135021,Raymond-Yves Boulanger,10099,175078,2022-08-06
CASH_OUT,96930,Raymond-Yves Boulanger,175078,78148,Agence_mtn_Abomey,300000,203070,2022-08-07
CASH_OUT,18974,Raymond-Yves Boulanger,78148,59174,Agence_mtn_Abomey,300000,281026,2022-08-09
CASH_IN,259456,Agence_mtn_Abomey,300000,40544,Raymond-Yves Boulanger,59174,318630,2022-08-10
CASH_IN,31835,Agence_mtn_Abomey,300000,268165,Raymond-Yves Boulanger,318630,350465,2022-08-12
TRANSFER,174410,Charlotte Perrier,333071,158661,Raymond-Yves Boulanger,350465,524875,2022-08-13
CASH_IN,140746,Agence_mtn_Ouidah,300000,159254,Raymond-Yves Boulanger,524875,665621,2022-08-13
CASH_OUT,610759,Raymond-Yves Boulanger,665621,54862,Agence_mtn_Abomey,300000,-310759,2022-08-14
TRANSFER,125251,Charles Guérin,249816,124565,Raymond-Yves Boulanger,54862,180113,2022-08-23
TRANSFER,3401,Margaud-Michelle Briand,53969,50568,Raymond-Yves Boulanger,180113,183514,2022-08-23
CASH_IN,42347,Agence_mtn_Ouidah,300000,257653,Honoré Grégoire-Breton,-16730,25617,2022-08-05
CASH_IN,255750,Agence_mtn_Abomey,300000,44250,Honoré Grégoire-Breton,25617,281367,2022-08-08
CASH_OUT,138265,Honoré Grégoire-Breton,281367,143102,Agence_mtn_Abomey,300000,161735,2022-08-10
TRANSFER,110005,Honoré Grégoire-Breton,143102,33097,Honoré Grégoire-Breton,143102,253107,2022-08-13
TRANSFER,26812,Honoré Grégoire-Breton,33097,6285,Charlotte Perrier,158661,131849,2022-08-14
TRANSFER,33593,Christophe Besnard-Diaz,49835,16242,Honoré Grégoire-Breton,6285,39878,2022-08-16
TRANSFER,23482,Honoré Grégoire-Breton,39878,16396,Océane Faure,330157,306675,2022-08-20
CASH_IN,60336,Agence_mtn_Abomey,300000,239664,Roland Huet,3756,64092,2022-08-01
CASH_OUT,53570,Roland Huet,64092,10522,Agence_mtn_Cotonou,300000,246430,2022-08-01
CASH_OUT,6259,Roland Huet,10522,4263,Agence_mtn_Ouidah,300000,293741,2022-08-02
CASH_IN,121496,Agence_mtn_Abomey,300000,178504,Roland Huet,4263,125759,2022-08-07
CASH_OUT,55826,Roland Huet,125759,69933,Agence_mtn_Cotonou,300000,244174,2022-08-10
CASH_OUT,25094,Roland Huet,69933,44839,Agence_mtn_Ouidah,300000,274906,2022-08-12
CASH_IN,203945,Agence_mtn_Cotonou,300000,96055,Roland Huet,44839,248784,2022-08-14
CASH_IN,185824,Agence_mtn_Ouidah,300000,114176,Roland Huet,248784,434608,2022-08-15
TRANSFER,319916,Roland Huet,434608,114692,Astrid Aubert-Thierry,480007,160091,2022-08-19
CASH_IN,16165,Agence_mtn_Abomey,300000,283835,Roland Huet,114692,130857,2022-08-19
CASH_OUT,78674,Roland Huet,130857,52183,Agence_mtn_Cotonou,300000,221326,2022-08-19
TRANSFER,54281,Thibault Martin,81803,27522,Roland Huet,52183,106464,2022-08-25
TRANSFER,347901,Honoré de la Prévost,444741,96840,Roland Huet,106464,454365,2022-08-27
CASH_IN,241966,Agence_mtn_Abomey,300000,58034,Pénélope Boulay,-220233,21733,2022-08-02
CASH_OUT,3516,Pénélope Boulay,21733,18217,Agence_mtn_Abomey,300000,296484,2022-08-04
CASH_OUT,8922,Pénélope Boulay,18217,9295,Agence_mtn_Ouidah,300000,291078,2022-08-04
CASH_IN,57765,Agence_mtn_Abomey,300000,242235,Pénélope Boulay,9295,67060,2022-08-06
CASH_IN,166593,Agence_mtn_Ouidah,300000,133407,Pénélope Boulay,67060,233653,2022-08-06
CASH_OUT,66369,Pénélope Boulay,233653,167284,Agence_mtn_Abomey,300000,233631,2022-08-07
CASH_IN,129300,Agence_mtn_Abomey,300000,170700,Pénélope Boulay,167284,296584,2022-08-07
CASH_IN,156649,Agence_mtn_Cotonou,300000,143351,Pénélope Boulay,296584,453233,2022-08-08
CASH_IN,198701,Agence_mtn_Abomey,300000,101299,Pénélope Boulay,453233,651934,2022-08-09
CASH_OUT,409513,Pénélope Boulay,651934,242421,Agence_mtn_Cotonou,300000,-109513,2022-08-09
CASH_IN,109649,Agence_mtn_Abomey,300000,190351,Pénélope Boulay,242421,352070,2022-08-09
CASH_IN,228125,Agence_mtn_Ouidah,300000,71875,Pénélope Boulay,352070,580195,2022-08-11
CASH_IN,130038,Agence_mtn_Cotonou,300000,169962,Pénélope Boulay,580195,710233,2022-08-14
CASH_IN,250929,Agence_mtn_Cotonou,300000,49071,Pénélope Boulay,710233,961162,2022-08-14
TRANSFER,8726,Océane Faure,306675,297949,Pénélope Boulay,961162,969888,2022-08-18
CASH_IN,173220,Agence_mtn_Abomey,300000,126780,Pénélope Boulay,969888,1143108,2022-08-20
TRANSFER,37257,Céline-Inès Meunier,224628,187371,Pénélope Boulay,1143108,1180365,2022-08-22
CASH_OUT,304181,Pénélope Boulay,1180365,876184,Agence_mtn_Abomey,300000,-4181,2022-08-27
CASH_IN,278337,Agence_mtn_Cotonou,300000,21663,Sylvie Dupré,460641,738978,2022-08-02
CASH_OUT,482777,Sylvie Dupré,738978,256201,Agence_mtn_Cotonou,300000,-182777,2022-08-02
CASH_OUT,98656,Sylvie Dupré,256201,157545,Agence_mtn_Abomey,300000,201344,2022-08-03
CASH_IN,23557,Agence_mtn_Ouidah,300000,276443,Sylvie Dupré,157545,181102,2022-08-05
TRANSFER,161434,Sylvie Dupré,181102,19668,Laurent Marion,1203380,1041946,2022-08-06
CASH_OUT,15213,Sylvie Dupré,19668,4455,Agence_mtn_Abomey,300000,284787,2022-08-08
CASH_OUT,1164,Sylvie Dupré,4455,3291,Agence_mtn_Ouidah,300000,298836,2022-08-15
CASH_IN,229350,Agence_mtn_Abomey,300000,70650,Sylvie Dupré,3291,232641,2022-08-16
CASH_IN,157460,Agence_mtn_Ouidah,300000,142540,Sylvie Dupré,232641,390101,2022-08-16
CASH_OUT,173473,Sylvie Dupré,390101,216628,Agence_mtn_Abomey,300000,126527,2022-08-16
CASH_OUT,201707,Sylvie Dupré,216628,14921,Agence_mtn_Abomey,300000,98293,2022-08-22
CASH_IN,266408,Agence_mtn_Abomey,300000,33592,Sylvie Dupré,14921,281329,2022-08-22
CASH_OUT,359285,Guillaume de la Nguyen,506262,146977,Agence_mtn_Ouidah,300000,-59285,2022-08-01
CASH_OUT,130206,Guillaume de la Nguyen,146977,16771,Agence_mtn_Abomey,300000,169794,2022-08-03
CASH_OUT,11415,Guillaume de la Nguyen,16771,5356,Agence_mtn_Cotonou,300000,288585,2022-08-04
TRANSFER,1701,Guillaume de la Nguyen,5356,3655,Maurice de Brunet,384717,383016,2022-08-08
CASH_OUT,588,Guillaume de la Nguyen,3655,3067,Agence_mtn_Cotonou,300000,299412,2022-08-08
TRANSFER,287773,Maggie Barbier,353781,66008,Guillaume de la Nguyen,3067,290840,2022-08-12
CASH_OUT,47857,Guillaume de la Nguyen,290840,242983,Agence_mtn_Abomey,300000,252143,2022-08-16
CASH_IN,192647,Agence_mtn_Ouidah,300000,107353,Guillaume de la Nguyen,242983,435630,2022-08-23
CASH_IN,271388,Agence_mtn_Cotonou,300000,28612,Guillaume de la Nguyen,435630,707018,2022-08-24
CASH_OUT,73580,Guillaume de la Nguyen,707018,633438,Agence_mtn_Abomey,300000,226420,2022-08-25
CASH_IN,212754,Agence_mtn_Ouidah,300000,87246,Édouard Grondin du Fleury,-7107,205647,2022-08-03
CASH_IN,107196,Agence_mtn_Ouidah,300000,192804,Édouard Grondin du Fleury,205647,312843,2022-08-10
CASH_IN,184497,Agence_mtn_Abomey,300000,115503,Édouard Grondin du Fleury,312843,497340,2022-08-11
TRANSFER,24277,Maggie Barbier,66008,41731,Édouard Grondin du Fleury,497340,521617,2022-08-12
TRANSFER,32771,Astrid Aubert-Thierry,160091,127320,Édouard Grondin du Fleury,521617,554388,2022-08-12
TRANSFER,3040,Thérèse-Juliette Camus,3214,174,Édouard Grondin du Fleury,554388,557428,2022-08-20
TRANSFER,777226,Guy-Augustin Pinto,1256272,479046,Édouard Grondin du Fleury,557428,1334654,2022-08-24
CASH_OUT,1312741,Édouard Grondin du Fleury,1334654,21913,Agence_mtn_Ouidah,300000,-1012741,2022-08-27
TRANSFER,5214,Édouard Grondin du Fleury,21913,16699,Margaud-Michelle Briand,50568,45354,2022-08-27
CASH_IN,93643,Agence_mtn_Cotonou,300000,206357,Sophie-Anouk Boulanger,-204676,-111033,2022-08-01
CASH_IN,113258,Agence_mtn_Ouidah,300000,186742,Sophie-Anouk Boulanger,-111033,2225,2022-08-02
TRANSFER,5858,Christophe Besnard-Diaz,16242,10384,Sophie-Anouk Boulanger,2225,8083,2022-08-04
CASH_OUT,6036,Sophie-Anouk Boulanger,8083,2047,Agence_mtn_Ouidah,300000,293964,2022-08-04
TRANSFER,65631,Zacharie Fabre,202306,136675,Sophie-Anouk Boulanger,2047,67678,2022-08-06
CASH_IN,17609,Agence_mtn_Cotonou,300000,282391,Sophie-Anouk Boulanger,67678,85287,2022-08-11
CASH_IN,23099,Agence_mtn_Cotonou,300000,276901,Sophie-Anouk Boulanger,85287,108386,2022-08-13
TRANSFER,118,Thérèse-Juliette Camus,174,56,Sophie-Anouk Boulanger,108386,108504,2022-08-15
CASH_OUT,57751,Sophie-Anouk Boulanger,108504,50753,Agence_mtn_Abomey,300000,242249,2022-08-21
CASH_IN,286778,Agence_mtn_Ouidah,300000,13222,Sophie-Anouk Boulanger,50753,337531,2022-08-22
CASH_IN,249479,Agence_mtn_Abomey,300000,50521,Sophie-Anouk Boulanger,337531,587010,2022-08-26
CASH_IN,48833,Agence_mtn_Cotonou,300000,251167,Sophie-Anouk Boulanger,587010,635843,2022-08-26
CASH_IN,269069,Agence_mtn_Ouidah,300000,30931,Josette du Hamon,-248942,20127,2022-08-05
CASH_OUT,6974,Josette du Hamon,20127,13153,Agence_mtn_Cotonou,300000,293026,2022-08-05
CASH_OUT,9716,Josette du Hamon,13153,3437,Agence_mtn_Cotonou,300000,290284,2022-08-06
CASH_IN,89593,Agence_mtn_Ouidah,300000,210407,Josette du Hamon,3437,93030,2022-08-06
CASH_IN,227222,Agence_mtn_Abomey,300000,72778,Josette du Hamon,93030,320252,2022-08-07
CASH_OUT,233091,Josette du Hamon,320252,87161,Agence_mtn_Abomey,300000,66909,2022-08-08
TRANSFER,52536,Josette du Hamon,87161,34625,Charlotte Perrier,131849,79313,2022-08-13
TRANSFER,21898,Josette du Hamon,34625,12727,Élisabeth Delattre,37899,16001,2022-08-15
CASH_OUT,8605,Josette du Hamon,12727,4122,Agence_mtn_Ouidah,300000,291395,2022-08-17
CASH_OUT,802,Josette du Hamon,4122,3320,Agence_mtn_Abomey,300000,299198,2022-08-19
TRANSFER,2646,Josette du Hamon,3320,674,Zacharie Fabre,136675,134029,2022-08-20
CASH_IN,125983,Agence_mtn_Ouidah,300000,174017,Josette du Hamon,674,126657,2022-08-22
CASH_IN,102704,Agence_mtn_Cotonou,300000,197296,Josette du Hamon,126657,229361,2022-08-23
CASH_OUT,1699,Christophe Besnard-Diaz,10384,8685,Agence_mtn_Abomey,300000,298301,2022-08-06
CASH_OUT,5215,Christophe Besnard-Diaz,8685,3470,Agence_mtn_Abomey,300000,294785,2022-08-10
TRANSFER,950,Christophe Besnard-Diaz,3470,2520,Emmanuel Vallée,630281,629331,2022-08-11
CASH_OUT,1442,Christophe Besnard-Diaz,2520,1078,Agence_mtn_Cotonou,300000,298558,2022-08-12
CASH_OUT,736,Christophe Besnard-Diaz,1078,342,Agence_mtn_Ouidah,300000,299264,2022-08-13
TRANSFER,346392,Maurice de Brunet,383016,36624,Christophe Besnard-Diaz,342,346734,2022-08-13
TRANSFER,20007,Charles Guérin,124565,104558,Christophe Besnard-Diaz,346734,366741,2022-08-14
TRANSFER,155039,Louis de la Imbert,186891,31852,Christophe Besnard-Diaz,366741,521780,2022-08-14
TRANSFER,8823,Charles Guérin,104558,95735,Christophe Besnard-Diaz,521780,530603,2022-08-15
CASH_IN,273137,Agence_mtn_Ouidah,300000,26863,Christophe Besnard-Diaz,530603,803740,2022-08-18
CASH_OUT,28149,Christophe Besnard-Diaz,803740,775591,Agence_mtn_Abomey,300000,271851,2022-08-20
CASH_OUT,196605,Christophe Besnard-Diaz,775591,578986,Agence_mtn_Abomey,300000,103395,2022-08-22
TRANSFER,458644,Christophe Besnard-Diaz,578986,120342,Gabrielle Hamon,192687,-265957,2022-08-23
CASH_IN,24144,Agence_mtn_Ouidah,300000,275856,Christophe Besnard-Diaz,120342,144486,2022-08-25
TRANSFER,66847,Christophe Besnard-Diaz,144486,77639,Anouk Delahaye-Gimenez,144188,77341,2022-08-26
CASH_OUT,11503,Christophe Besnard-Diaz,77639,66136,Agence_mtn_Abomey,300000,288497,2022-08-27
CASH_IN,274324,Agence_mtn_Cotonou,300000,25676,Nathalie-Claire De Oliveira,-17558,256766,2022-08-05
CASH_IN,265579,Agence_mtn_Ouidah,300000,34421,Nathalie-Claire De Oliveira,256766,522345,2022-08-11
CASH_IN,91899,Agence_mtn_Ouidah,300000,208101,Nathalie-Claire De Oliveira,522345,614244,2022-08-12
TRANSFER,1796,René de la Delaunay,87439,85643,Nathalie-Claire De Oliveira,614244,616040,2022-08-13
TRANSFER,24000,Maurice de Brunet,36624,12624,Nathalie-Claire De Oliveira,616040,640040,2022-08-15
CASH_IN,157292,Agence_mtn_Ouidah,300000,142708,Nathalie-Claire De Oliveira,640040,797332,2022-08-19
CASH_IN,43660,Agence_mtn_Cotonou,300000,256340,Nathalie-Claire De Oliveira,797332,840992,2022-08-22
CASH_IN,38789,Agence_mtn_Cotonou,300000,261211,Henri de Didier,1172931,1211720,2022-08-03
TRANSFER,36937,Henri de Didier,1211720,1174783,Valérie de Pottier,103146,66209,2022-08-05
CASH_OUT,903206,Henri de Didier,1174783,271577,Agence_mtn_Cotonou,300000,-603206,2022-08-05
CASH_OUT,127787,Henri de Didier,271577,143790,Agence_mtn_Cotonou,300000,172213,2022-08-07
CASH_OUT,56610,Henri de Didier,143790,87180,Agence_mtn_Cotonou,300000,243390,2022-08-10
CASH_IN,246995,Agence_mtn_Cotonou,300000,53005,Henri de Didier,87180,334175,2022-08-12
CASH_OUT,57444,Henri de Didier,334175,276731,Agence_mtn_Cotonou,300000,242556,2022-08-16
CASH_OUT,154079,Henri de Didier,276731,122652,Agence_mtn_Abomey,300000,145921,2022-08-16
CASH_IN,261962,Agence_mtn_Ouidah,300000,38038,Henri de Didier,122652,384614,2022-08-17
CASH_IN,22638,Agence_mtn_Abomey,300000,277362,Henri de Didier,384614,407252,2022-08-21
CASH_IN,204319,Agence_mtn_Cotonou,300000,95681,Henri de Didier,407252,611571,2022-08-23
CASH_OUT,512910,Henri de Didier,611571,98661,Agence_mtn_Abomey,300000,-212910,2022-08-23
CASH_IN,32964,Agence_mtn_Abomey,300000,267036,Henri de Didier,98661,131625,2022-08-24
CASH_OUT,76678,Anouk Delahaye-Gimenez,77341,663,Agence_mtn_Cotonou,300000,223322,2022-08-04
CASH_OUT,597,Anouk Delahaye-Gimenez,663,66,Agence_mtn_Abomey,300000,299403,2022-08-06
CASH_IN,117348,Agence_mtn_Abomey,300000,182652,Anouk Delahaye-Gimenez,66,117414,2022-08-08
TRANSFER,83597,Anouk Delahaye-Gimenez,117414,33817,Anouk Delahaye-Gimenez,117414,33817,2022-08-09
CASH_OUT,20254,Anouk Delahaye-Gimenez,33817,13563,Agence_mtn_Cotonou,300000,279746,2022-08-11
TRANSFER,8300,Anouk Delahaye-Gimenez,13563,5263,Céline-Inès Meunier,187371,179071,2022-08-11
CASH_IN,140478,Agence_mtn_Cotonou,300000,159522,Anouk Delahaye-Gimenez,5263,145741,2022-08-11
TRANSFER,61307,Anouk Delahaye-Gimenez,145741,84434,Valérie de Pottier,66209,4902,2022-08-12
CASH_OUT,5715,Anouk Delahaye-Gimenez,84434,78719,Agence_mtn_Ouidah,300000,294285,2022-08-13
CASH_IN,119467,Agence_mtn_Ouidah,300000,180533,Anouk Delahaye-Gimenez,78719,198186,2022-08-13
CASH_IN,8767,Agence_mtn_Abomey,300000,291233,Anouk Delahaye-Gimenez,198186,206953,2022-08-24
TRANSFER,18453,Anouk Delahaye-Gimenez,206953,188500,Céline-Inès Meunier,179071,160618,2022-08-26
TRANSFER,105102,Anouk Delahaye-Gimenez,188500,83398,Emmanuel Vallée,629331,524229,2022-08-26
CASH_IN,28241,Agence_mtn_Abomey,300000,271759,Anouk Delahaye-Gimenez,83398,111639,2022-08-27
CASH_IN,210457,Agence_mtn_Ouidah,300000,89543,Maggie Barbier,41731,252188,2022-08-01
TRANSFER,49258,Honoré de la Prévost,96840,47582,Maggie Barbier,252188,301446,2022-08-02
TRANSFER,252798,Océane Faure,297949,45151,Maggie Barbier,301446,554244,2022-08-03
CASH_OUT,395795,Maggie Barbier,554244,158449,Agence_mtn_Abomey,300000,-95795,2022-08-03
CASH_OUT,120302,Maggie Barbier,158449,38147,Agence_mtn_Abomey,300000,179698,2022-08-03
TRANSFER,12363,Honoré de la Prévost,47582,35219,Maggie Barbier,38147,50510,2022-08-05
CASH_OUT,48320,Maggie Barbier,50510,2190,Agence_mtn_Ouidah,300000,251680,2022-08-05
CASH_IN,119852,Agence_mtn_Ouidah,300000,180148,Maggie Barbier,2190,122042,2022-08-06
CASH_IN,41106,Agence_mtn_Cotonou,300000,258894,Maggie Barbier,122042,163148,2022-08-08
CASH_IN,145850,Agence_mtn_Abomey,300000,154150,Maggie Barbier,163148,308998,2022-08-08
CASH_OUT,267458,Maggie Barbier,308998,41540,Agence_mtn_Cotonou,300000,32542,2022-08-11
CASH_OUT,35411,Maggie Barbier,41540,6129,Agence_mtn_Abomey,300000,264589,2022-08-16
CASH_OUT,4317,Maggie Barbier,6129,1812,Agence_mtn_Ouidah,300000,295683,2022-08-18
TRANSFER,14714,Élisabeth Delattre,16001,1287,Maggie Barbier,1812,16526,2022-08-21
CASH_OUT,5851,Maggie Barbier,16526,10675,Agence_mtn_Cotonou,300000,294149,2022-08-21
TRANSFER,9392,Madeleine Philippe-Grondin,24953,15561,Maggie Barbier,10675,20067,2022-08-22
TRANSFER,14676,Maggie Barbier,20067,5391,Céline-Inès Meunier,160618,145942,2022-08-25
CASH_OUT,1563,Maggie Barbier,5391,3828,Agence_mtn_Abomey,300000,298437,2022-08-25
TRANSFER,114250,Céline-Inès Meunier,145942,31692,Maggie Barbier,3828,118078,2022-08-25
CASH_IN,259848,Agence_mtn_Cotonou,300000,40152,Nicolas Blin,-148419,111429,2022-08-02
CASH_OUT,60202,Nicolas Blin,111429,51227,Agence_mtn_Ouidah,300000,239798,2022-08-08
TRANSFER,10388,Nicolas Blin,51227,40839,Océane Faure,45151,34763,2022-08-09
TRANSFER,13578,Nicolas Blin,40839,27261,Zacharie Fabre,134029,120451,2022-08-12
CASH_OUT,18910,Nicolas Blin,27261,8351,Agence_mtn_Abomey,300000,281090,2022-08-19
CASH_IN,182372,Agence_mtn_Ouidah,300000,117628,Nicolas Blin,8351,190723,2022-08-20
CASH_IN,24575,Agence_mtn_Abomey,300000,275425,Nicolas Blin,190723,215298,2022-08-21
CASH_IN,110421,Agence_mtn_Abomey,300000,189579,Nicolas Blin,215298,325719,2022-08-23
CASH_OUT,158129,Nicolas Blin,325719,167590,Agence_mtn_Abomey,300000,141871,2022-08-25
TRANSFER,68405,Nicolas Blin,167590,99185,Céline-Inès Meunier,31692,-36713,2022-08-25
CASH_OUT,519,Élisabeth Delattre,1287,768,Agence_mtn_Ouidah,300000,299481,2022-08-02
TRANSFER,25004,Margaud-Michelle Briand,45354,20350,Élisabeth Delattre,768,25772,2022-08-03
CASH_IN,213750,Agence_mtn_Abomey,300000,86250,Élisabeth Delattre,25772,239522,2022-08-03
CASH_OUT,113059,Élisabeth Delattre,239522,126463,Agence_mtn_Ouidah,300000,186941,2022-08-06
CASH_IN,275477,Agence_mtn_Ouidah,300000,24523,Élisabeth Delattre,126463,401940,2022-08-07
TRANSFER,1573,Madeleine Philippe-Grondin,15561,13988,Élisabeth Delattre,401940,403513,2022-08-08
TRANSFER,185925,Élisabeth Delattre,403513,217588,Guy-Augustin Pinto,479046,293121,2022-08-09
TRANSFER,107384,Élisabeth Delattre,217588,110204,Maurice de Brunet,12624,-94760,2022-08-09
TRANSFER,744,Madeleine Philippe-Grondin,13988,13244,Élisabeth Delattre,110204,110948,2022-08-09
CASH_IN,213075,Agence_mtn_Ouidah,300000,86925,Élisabeth Delattre,110948,324023,2022-08-10
CASH_IN,252198,Agence_mtn_Ouidah,300000,47802,Élisabeth Delattre,324023,576221,2022-08-10
TRANSFER,2297,Louis de la Imbert,31852,29555,Élisabeth Delattre,576221,578518,2022-08-12
TRANSFER,86619,Charles Guérin,95735,9116,Élisabeth Delattre,578518,665137,2022-08-17
TRANSFER,10434,Honoré de la Prévost,35219,24785,Élisabeth Delattre,665137,675571,2022-08-20
TRANSFER,575,Madeleine Philippe-Grondin,13244,12669,Élisabeth Delattre,675571,676146,2022-08-22
CASH_OUT,218666,Élisabeth Delattre,676146,457480,Agence_mtn_Abomey,300000,81334,2022-08-24
TRANSFER,266308,Élisabeth Delattre,457480,191172,Charlotte Perrier,79313,-186995,2022-08-24
CASH_IN,129707,Agence_mtn_Cotonou,300000,170293,Élisabeth Delattre,191172,320879,2022-08-26
TRANSFER,567,Valérie de Pottier,4902,4335,Valérie de Pottier,4902,5469,2022-08-01
CASH_IN,231277,Agence_mtn_Ouidah,300000,68723,Valérie de Pottier,4335,235612,2022-08-06
TRANSFER,186121,Guy-Augustin Pinto,293121,107000,Valérie de Pottier,235612,421733,2022-08-09
TRANSFER,48671,Valérie de Pottier,421733,373062,Jules-Marc Chauvet,144371,95700,2022-08-12
TRANSFER,9539,Thibault Martin,27522,17983,Valérie de Pottier,373062,382601,2022-08-20
TRANSFER,178680,Laurent Marion,1041946,863266,Valérie de Pottier,382601,561281,2022-08-26
CASH_IN,105733,Agence_mtn_Cotonou,300000,194267,Thérèse-Juliette Camus,56,105789,2022-08-05
CASH_OUT,75585,Thérèse-Juliette Camus,105789,30204,Agence_mtn_Ouidah,300000,224415,2022-08-05
CASH_OUT,19982,Thérèse-Juliette Camus,30204,10222,Agence_mtn_Cotonou,300000,280018,2022-08-07
CASH_OUT,137,Thérèse-Juliette Camus,10222,10085,Agence_mtn_Cotonou,300000,299863,2022-08-08
TRANSFER,386,Madeleine Philippe-Grondin,12669,12283,Thérèse-Juliette Camus,10085,10471,2022-08-11
CASH_IN,12803,Agence_mtn_Cotonou,300000,287197,Thérèse-Juliette Camus,10471,23274,2022-08-12
CASH_IN,189351,Agence_mtn_Abomey,300000,110649,Thérèse-Juliette Camus,23274,212625,2022-08-13
TRANSFER,166348,Thérèse-Juliette Camus,212625,46277,Honoré de la Prévost,24785,-141563,2022-08-15
CASH_IN,234318,Agence_mtn_Ouidah,300000,65682,Thérèse-Juliette Camus,46277,280595,2022-08-23
CASH_IN,42637,Agence_mtn_Abomey,300000,257363,Thérèse-Juliette Camus,280595,323232,2022-08-25
TRANSFER,118329,Stéphanie Guichard,490888,372559,Laurent Marion,863266,981595,2022-08-03
CASH_IN,284558,Agence_mtn_Abomey,300000,15442,Laurent Marion,981595,1266153,2022-08-04
CASH_OUT,158518,Laurent Marion,1266153,1107635,Agence_mtn_Abomey,300000,141482,2022-08-05
CASH_OUT,122969,Laurent Marion,1107635,984666,Agence_mtn_Ouidah,300000,177031,2022-08-07
CASH_IN,140934,Agence_mtn_Abomey,300000,159066,Laurent Marion,984666,1125600,2022-08-07
TRANSFER,921855,Laurent Marion,1125600,203745,René de la Delaunay,85643,-836212,2022-08-07
TRANSFER,700282,Gérard Cordier,746148,45866,Laurent Marion,203745,904027,2022-08-09
TRANSFER,2299,Charles Guérin,9116,6817,Laurent Marion,904027,906326,2022-08-09
CASH_IN,39194,Agence_mtn_Ouidah,300000,260806,Laurent Marion,906326,945520,2022-08-10
TRANSFER,15457,Océane Faure,34763,19306,Laurent Marion,945520,960977,2022-08-12
TRANSFER,662,Charles Guérin,6817,6155,Laurent Marion,960977,961639,2022-08-13
CASH_IN,179134,Agence_mtn_Abomey,300000,120866,Laurent Marion,961639,1140773,2022-08-13
CASH_IN,156101,Agence_mtn_Abomey,300000,143899,Laurent Marion,1140773,1296874,2022-08-21
CASH_IN,210606,Agence_mtn_Cotonou,300000,89394,Laurent Marion,1296874,1507480,2022-08-21
CASH_IN,156051,Agence_mtn_Cotonou,300000,143949,Laurent Marion,1507480,1663531,2022-08-23
TRANSFER,917511,Laurent Marion,1663531,746020,Stéphanie Guichard,372559,-544952,2022-08-24
TRANSFER,25878,Louis de la Imbert,29555,3677,Laurent Marion,746020,771898,2022-08-25
CASH_OUT,52162,Laurent Marion,771898,719736,Agence_mtn_Ouidah,300000,247838,2022-08-25
TRANSFER,1068,Madeleine Philippe-Grondin,12283,11215,Laurent Marion,719736,720804,2022-08-26
TRANSFER,76099,Jules-Marc Chauvet,95700,19601,Laurent Marion,720804,796903,2022-08-26
CASH_IN,24789,Agence_mtn_Ouidah,300000,275211,Nicole Huet,-80851,-56062,2022-08-03
CASH_IN,194402,Agence_mtn_Cotonou,300000,105598,Nicole Huet,-56062,138340,2022-08-05
TRANSFER,93443,Astrid Aubert-Thierry,127320,33877,Nicole Huet,138340,231783,2022-08-07
TRANSFER,33549,Nicole Huet,231783,198234,Charles Guérin,6155,-27394,2022-08-07
TRANSFER,135176,Nicole Huet,198234,63058,Nicole Huet,198234,63058,2022-08-12
CASH_OUT,35024,Nicole Huet,63058,28034,Agence_mtn_Ouidah,300000,264976,2022-08-13
CASH_OUT,14595,Nicole Huet,28034,13439,Agence_mtn_Ouidah,300000,285405,2022-08-14
CASH_OUT,7233,Nicole Huet,13439,6206,Agence_mtn_Abomey,300000,292767,2022-08-14
CASH_OUT,1331,Nicole Huet,6206,4875,Agence_mtn_Ouidah,300000,298669,2022-08-24
CASH_IN,41347,Agence_mtn_Abomey,300000,258653,Charlotte Perrier,-186995,-145648,2022-08-02
CASH_IN,113680,Agence_mtn_Cotonou,300000,186320,Charlotte Perrier,-145648,-31968,2022-08-03
CASH_IN,80204,Agence_mtn_Ouidah,300000,219796,Charlotte Perrier,-31968,48236,2022-08-04
CASH_IN,74899,Agence_mtn_Abomey,300000,225101,Charlotte Perrier,48236,123135,2022-08-06
CASH_OUT,6883,Charlotte Perrier,123135,116252,Agence_mtn_Cotonou,300000,293117,2022-08-07
CASH_OUT,72346,Charlotte Perrier,116252,43906,Agence_mtn_Ouidah,300000,227654,2022-08-08
TRANSFER,1319437,Françoise Denis de Allard,1689964,370527,Charlotte Perrier,43906,1363343,2022-08-10
CASH_OUT,1290516,Charlotte Perrier,1363343,72827,Agence_mtn_Abomey,300000,-990516,2022-08-13
CASH_IN,194334,Agence_mtn_Ouidah,300000,105666,Charlotte Perrier,72827,267161,2022-08-15
CASH_IN,96215,Agence_mtn_Ouidah,300000,203785,Charlotte Perrier,267161,363376,2022-08-17
TRANSFER,20915,Charlotte Perrier,363376,342461,Guy-Augustin Pinto,107000,86085,2022-08-17
TRANSFER,16092,Françoise Denis de Allard,370527,354435,Charlotte Perrier,342461,358553,2022-08-21
TRANSFER,2431,Jules-Marc Chauvet,19601,17170,Charlotte Perrier,358553,360984,2022-08-22
TRANSFER,4952,Thibault Martin,17983,13031,Charlotte Perrier,360984,365936,2022-08-22
TRANSFER,231668,Charlotte Perrier,365936,134268,Madeleine Philippe-Grondin,11215,-220453,2022-08-23
TRANSFER,82410,Charlotte Perrier,134268,51858,Françoise Denis de Allard,354435,272025,2022-08-24
CASH_IN,6680,Agence_mtn_Abomey,300000,293320,Charlotte Perrier,51858,58538,2022-08-24
CASH_OUT,22850,Charlotte Perrier,58538,35688,Agence_mtn_Cotonou,300000,277150,2022-08-25
CASH_OUT,3137,Océane Faure,19306,16169,Agence_mtn_Cotonou,300000,296863,2022-08-01
CASH_IN,218492,Agence_mtn_Abomey,300000,81508,Océane Faure,16169,234661,2022-08-04
CASH_IN,216831,Agence_mtn_Abomey,300000,83169,Océane Faure,234661,451492,2022-08-10
CASH_IN,271016,Agence_mtn_Cotonou,300000,28984,Océane Faure,451492,722508,2022-08-11
TRANSFER,28767,Océane Faure,722508,693741,Jules-Marc Chauvet,17170,-11597,2022-08-12
CASH_IN,28514,Agence_mtn_Abomey,300000,271486,Océane Faure,693741,722255,2022-08-12
CASH_IN,80146,Agence_mtn_Cotonou,300000,219854,Océane Faure,722255,802401,2022-08-15
CASH_OUT,453886,Océane Faure,802401,348515,Agence_mtn_Cotonou,300000,-153886,2022-08-16
TRANSFER,108771,Océane Faure,348515,239744,Françoise Denis de Allard,272025,163254,2022-08-16
TRANSFER,145507,Océane Faure,239744,94237,Louis de la Imbert,3677,-141830,2022-08-18
CASH_IN,111132,Agence_mtn_Ouidah,300000,188868,Océane Faure,94237,205369,2022-08-19
TRANSFER,91346,Océane Faure,205369,114023,Gérard Cordier,45866,-45480,2022-08-23
CASH_OUT,30783,Océane Faure,114023,83240,Agence_mtn_Cotonou,300000,269217,2022-08-23
TRANSFER,155716,Françoise Denis de Allard,163254,7538,Océane Faure,83240,238956,2022-08-24
TRANSFER,5410,Astrid Aubert-Thierry,33877,28467,Océane Faure,238956,244366,2022-08-24
CASH_IN,186734,Agence_mtn_Cotonou,300000,113266,Margaud-Michelle Briand,20350,207084,2022-08-02
TRANSFER,2551,Margaud-Michelle Briand,207084,204533,Margaud-Michelle Briand,207084,204533,2022-08-03
CASH_IN,135456,Agence_mtn_Ouidah,300000,164544,Margaud-Michelle Briand,204533,339989,2022-08-06
TRANSFER,111926,Margaud-Michelle Briand,339989,228063,Margaud-Michelle Briand,339989,228063,2022-08-08
CASH_OUT,13420,Margaud-Michelle Briand,228063,214643,Agence_mtn_Cotonou,300000,286580,2022-08-08
CASH_IN,273204,Agence_mtn_Ouidah,300000,26796,Margaud-Michelle Briand,214643,487847,2022-08-08
CASH_OUT,161663,Margaud-Michelle Briand,487847,326184,Agence_mtn_Cotonou,300000,138337,2022-08-10
TRANSFER,208241,Margaud-Michelle Briand,326184,117943,Françoise Denis de Allard,7538,-200703,2022-08-10
CASH_IN,237630,Agence_mtn_Ouidah,300000,62370,Margaud-Michelle Briand,117943,355573,2022-08-11
CASH_IN,110779,Agence_mtn_Cotonou,300000,189221,Margaud-Michelle Briand,355573,466352,2022-08-13
CASH_IN,212164,Agence_mtn_Abomey,300000,87836,Margaud-Michelle Briand,466352,678516,2022-08-13
CASH_OUT,362887,Margaud-Michelle Briand,678516,315629,Agence_mtn_Ouidah,300000,-62887,2022-08-16
CASH_IN,221416,Agence_mtn_Abomey,300000,78584,Margaud-Michelle Briand,315629,537045,2022-08-17
TRANSFER,427922,Margaud-Michelle Briand,537045,109123,Astrid Aubert-Thierry,28467,-399455,2022-08-19
CASH_IN,233560,Agence_mtn_Ouidah,300000,66440,Margaud-Michelle Briand,109123,342683,2022-08-27
CASH_IN,177701,Agence_mtn_Ouidah,300000,122299,Gérard Cordier,-45480,132221,2022-08-03
CASH_OUT,31134,Gérard Cordier,132221,101087,Agence_mtn_Abomey,300000,268866,2022-08-05
TRANSFER,72518,Gérard Cordier,101087,28569,Gérard Cordier,101087,173605,2022-08-09
CASH_OUT,3421,Gérard Cordier,28569,25148,Agence_mtn_Abomey,300000,296579,2022-08-09
CASH_OUT,2953,Gérard Cordier,25148,22195,Agence_mtn_Abomey,300000,297047,2022-08-10
CASH_OUT,4664,Gérard Cordier,22195,17531,Agence_mtn_Abomey,300000,295336,2022-08-10
TRANSFER,5513,Gérard Cordier,17531,12018,Guy-Augustin Pinto,86085,80572,2022-08-17
CASH_IN,32844,Agence_mtn_Abomey,300000,267156,Gérard Cordier,12018,44862,2022-08-17
CASH_IN,28360,Agence_mtn_Cotonou,300000,271640,Gérard Cordier,44862,73222,2022-08-23
CASH_IN,85703,Agence_mtn_Ouidah,300000,214297,Céline-Inès Meunier,-36713,48990,2022-08-04
CASH_OUT,9292,Céline-Inès Meunier,48990,39698,Agence_mtn_Cotonou,300000,290708,2022-08-05
CASH_OUT,5772,Céline-Inès Meunier,39698,33926,Agence_mtn_Cotonou,300000,294228,2022-08-07
CASH_OUT,12074,Céline-Inès Meunier,33926,21852,Agence_mtn_Cotonou,300000,287926,2022-08-13
CASH_OUT,4760,Céline-Inès Meunier,21852,17092,Agence_mtn_Cotonou,300000,295240,2022-08-13
CASH_OUT,8005,Céline-Inès Meunier,17092,9087,Agence_mtn_Cotonou,300000,291995,2022-08-18
CASH_OUT,3412,Céline-Inès Meunier,9087,5675,Agence_mtn_Abomey,300000,296588,2022-08-21
CASH_IN,298038,Agence_mtn_Ouidah,300000,1962,Céline-Inès Meunier,5675,303713,2022-08-23
TRANSFER,7467,Céline-Inès Meunier,303713,296246,Thibault Martin,13031,5564,2022-08-23
TRANSFER,155875,Céline-Inès Meunier,296246,140371,Guy-Augustin Pinto,80572,-75303,2022-08-24
TRANSFER,5460,Thibault Martin,5564,104,Céline-Inès Meunier,140371,145831,2022-08-26
CASH_OUT,99540,Céline-Inès Meunier,145831,46291,Agence_mtn_Abomey,300000,200460,2022-08-27
CASH_IN,150959,Agence_mtn_Cotonou,300000,149041,René de la Delaunay,-836212,-685253,2022-08-01
CASH_IN,68297,Agence_mtn_Abomey,300000,231703,René de la Delaunay,-685253,-616956,2022-08-01
CASH_IN,49000,Agence_mtn_Abomey,300000,251000,René de la Delaunay,-616956,-567956,2022-08-03
CASH_IN,187819,Agence_mtn_Cotonou,300000,112181,René de la Delaunay,-567956,-380137,2022-08-05
CASH_IN,117310,Agence_mtn_Abomey,300000,182690,René de la Delaunay,-380137,-262827,2022-08-06
CASH_IN,270424,Agence_mtn_Cotonou,300000,29576,René de la Delaunay,-262827,7597,2022-08-09
CASH_IN,38047,Agence_mtn_Cotonou,300000,261953,René de la Delaunay,7597,45644,2022-08-15
CASH_IN,255272,Agence_mtn_Cotonou,300000,44728,René de la Delaunay,45644,300916,2022-08-18
CASH_OUT,23904,René de la Delaunay,300916,277012,Agence_mtn_Ouidah,300000,276096,2022-08-21
CASH_IN,215674,Agence_mtn_Abomey,300000,84326,René de la Delaunay,277012,492686,2022-08-24
TRANSFER,212769,René de la Delaunay,492686,279917,Thibault Martin,104,-212665,2022-08-25
CASH_IN,68017,Agence_mtn_Abomey,300000,231983,Jacques Le Marion,-63425,4592,2022-08-02
CASH_IN,165352,Agence_mtn_Cotonou,300000,134648,Jacques Le Marion,4592,169944,2022-08-11
CASH_OUT,63931,Jacques Le Marion,169944,106013,Agence_mtn_Cotonou,300000,236069,2022-08-13
CASH_IN,8816,Agence_mtn_Ouidah,300000,291184,Jacques Le Marion,106013,114829,2022-08-14
CASH_IN,195739,Agence_mtn_Ouidah,300000,104261,Louis de la Imbert,-141830,53909,2022-08-13
CASH_IN,197117,Agence_mtn_Cotonou,300000,102883,Louis de la Imbert,53909,251026,2022-08-15
TRANSFER,116158,Louis de la Imbert,251026,134868,Louis de la Imbert,251026,134868,2022-08-17
CASH_IN,244100,Agence_mtn_Abomey,300000,55900,Louis de la Imbert,134868,378968,2022-08-19
CASH_IN,176311,Agence_mtn_Ouidah,300000,123689,Louis de la Imbert,378968,555279,2022-08-24
CASH_IN,177903,Agence_mtn_Abomey,300000,122097,Louis de la Imbert,555279,733182,2022-08-25
CASH_IN,224976,Agence_mtn_Ouidah,300000,75024,Louis de la Imbert,733182,958158,2022-08-25
CASH_IN,134991,Agence_mtn_Abomey,300000,165009,Stéphanie Guichard,-544952,-409961,2022-08-03
CASH_IN,114213,Agence_mtn_Ouidah,300000,185787,Stéphanie Guichard,-409961,-295748,2022-08-04
CASH_IN,88424,Agence_mtn_Abomey,300000,211576,Stéphanie Guichard,-295748,-207324,2022-08-05
CASH_IN,48294,Agence_mtn_Abomey,300000,251706,Stéphanie Guichard,-207324,-159030,2022-08-06
CASH_IN,220986,Agence_mtn_Cotonou,300000,79014,Stéphanie Guichard,-159030,61956,2022-08-06
CASH_IN,143559,Agence_mtn_Abomey,300000,156441,Stéphanie Guichard,61956,205515,2022-08-07
CASH_IN,27018,Agence_mtn_Ouidah,300000,272982,Stéphanie Guichard,205515,232533,2022-08-12
TRANSFER,34149,Stéphanie Guichard,232533,198384,Stéphanie Guichard,232533,266682,2022-08-18
CASH_IN,276158,Agence_mtn_Cotonou,300000,23842,Stéphanie Guichard,198384,474542,2022-08-18
CASH_IN,104559,Agence_mtn_Ouidah,300000,195441,Stéphanie Guichard,474542,579101,2022-08-21
CASH_IN,297413,Agence_mtn_Ouidah,300000,2587,Stéphanie Guichard,579101,876514,2022-08-27
CASH_IN,177166,Agence_mtn_Abomey,300000,122834,Françoise Denis de Allard,-200703,-23537,2022-08-03
CASH_IN,291677,Agence_mtn_Ouidah,300000,8323,Françoise Denis de Allard,-23537,268140,2022-08-04
CASH_OUT,142850,Françoise Denis de Allard,268140,125290,Agence_mtn_Ouidah,300000,157150,2022-08-05
CASH_OUT,59866,Françoise Denis de Allard,125290,65424,Agence_mtn_Ouidah,300000,240134,2022-08-05
CASH_IN,149878,Agence_mtn_Cotonou,300000,150122,Françoise Denis de Allard,65424,215302,2022-08-07
TRANSFER,100407,Françoise Denis de Allard,215302,114895,Françoise Denis de Allard,215302,114895,2022-08-08
CASH_OUT,23740,Françoise Denis de Allard,114895,91155,Agence_mtn_Abomey,300000,276260,2022-08-11
CASH_IN,275784,Agence_mtn_Abomey,300000,24216,Françoise Denis de Allard,91155,366939,2022-08-12
CASH_IN,46890,Agence_mtn_Cotonou,300000,253110,Françoise Denis de Allard,366939,413829,2022-08-12
CASH_IN,166472,Agence_mtn_Abomey,300000,133528,Françoise Denis de Allard,413829,580301,2022-08-13
CASH_OUT,50132,Françoise Denis de Allard,580301,530169,Agence_mtn_Abomey,300000,249868,2022-08-13
CASH_IN,124992,Agence_mtn_Abomey,300000,175008,Françoise Denis de Allard,530169,655161,2022-08-18
CASH_OUT,134604,Françoise Denis de Allard,655161,520557,Agence_mtn_Cotonou,300000,165396,2022-08-20
CASH_IN,247232,Agence_mtn_Ouidah,300000,52768,Françoise Denis de Allard,520557,767789,2022-08-23
CASH_IN,88241,Agence_mtn_Ouidah,300000,211759,Françoise Denis de Allard,767789,856030,2022-08-26
CASH_IN,116830,Agence_mtn_Ouidah,300000,183170,Françoise Denis de Allard,856030,972860,2022-08-27
CASH_IN,256086,Agence_mtn_Cotonou,300000,43914,Nicole-Renée Gay,-779104,-523018,2022-08-01
CASH_IN,254783,Agence_mtn_Abomey,300000,45217,Nicole-Renée Gay,-523018,-268235,2022-08-05
CASH_IN,49693,Agence_mtn_Cotonou,300000,250307,Nicole-Renée Gay,-268235,-218542,2022-08-05
CASH_IN,184921,Agence_mtn_Cotonou,300000,115079,Nicole-Renée Gay,-218542,-33621,2022-08-05
CASH_IN,169247,Agence_mtn_Abomey,300000,130753,Nicole-Renée Gay,-33621,135626,2022-08-08
CASH_OUT,82459,Nicole-Renée Gay,135626,53167,Agence_mtn_Cotonou,300000,217541,2022-08-08
CASH_OUT,7746,Nicole-Renée Gay,53167,45421,Agence_mtn_Ouidah,300000,292254,2022-08-16
TRANSFER,17519,Nicole-Renée Gay,45421,27902,Nicole-Renée Gay,45421,62940,2022-08-17
TRANSFER,22854,Nicole-Renée Gay,27902,5048,Nicole-Renée Gay,27902,50756,2022-08-17
CASH_OUT,4953,Nicole-Renée Gay,5048,95,Agence_mtn_Abomey,300000,295047,2022-08-22
CASH_IN,149321,Agence_mtn_Abomey,300000,150679,Nicole-Renée Gay,95,149416,2022-08-23
CASH_IN,4708,Agence_mtn_Ouidah,300000,295292,Nicole-Renée Gay,149416,154124,2022-08-24
CASH_OUT,52622,Nicole-Renée Gay,154124,101502,Agence_mtn_Abomey,300000,247378,2022-08-26
CASH_OUT,36484,Nicole-Renée Gay,101502,65018,Agence_mtn_Ouidah,300000,263516,2022-08-27
CASH_IN,236951,Agence_mtn_Abomey,300000,63049,Georges Muller,-464463,-227512,2022-08-04
CASH_IN,100339,Agence_mtn_Cotonou,300000,199661,Georges Muller,-227512,-127173,2022-08-05
CASH_IN,138829,Agence_mtn_Ouidah,300000,161171,Georges Muller,-127173,11656,2022-08-11
CASH_OUT,9265,Georges Muller,11656,2391,Agence_mtn_Ouidah,300000,290735,2022-08-13
CASH_IN,105932,Agence_mtn_Abomey,300000,194068,Georges Muller,2391,108323,2022-08-14
TRANSFER,71720,Georges Muller,108323,36603,Georges Muller,108323,180043,2022-08-18
CASH_OUT,14048,Georges Muller,36603,22555,Agence_mtn_Ouidah,300000,285952,2022-08-22
CASH_OUT,12376,Georges Muller,22555,10179,Agence_mtn_Cotonou,300000,287624,2022-08-26
CASH_IN,82005,Agence_mtn_Cotonou,300000,217995,Élisabeth Blot-Bruneau,-180441,-98436,2022-08-03
CASH_IN,158680,Agence_mtn_Abomey,300000,141320,Élisabeth Blot-Bruneau,-98436,60244,2022-08-06
CASH_OUT,27742,Élisabeth Blot-Bruneau,60244,32502,Agence_mtn_Abomey,300000,272258,2022-08-14
TRANSFER,24993,Élisabeth Blot-Bruneau,32502,7509,Élisabeth Blot-Bruneau,32502,57495,2022-08-14
CASH_IN,846,Agence_mtn_Abomey,300000,299154,Élisabeth Blot-Bruneau,7509,8355,2022-08-15
CASH_OUT,3413,Élisabeth Blot-Bruneau,8355,4942,Agence_mtn_Abomey,300000,296587,2022-08-15
CASH_OUT,560,Élisabeth Blot-Bruneau,4942,4382,Agence_mtn_Abomey,300000,299440,2022-08-16
CASH_IN,137842,Agence_mtn_Ouidah,300000,162158,Élisabeth Blot-Bruneau,4382,142224,2022-08-25
CASH_IN,232563,Agence_mtn_Cotonou,300000,67437,Élisabeth Blot-Bruneau,142224,374787,2022-08-25
CASH_IN,256246,Agence_mtn_Cotonou,300000,43754,Astrid Aubert-Thierry,-399455,-143209,2022-08-01
CASH_IN,280752,Agence_mtn_Cotonou,300000,19248,Astrid Aubert-Thierry,-143209,137543,2022-08-03
TRANSFER,82721,Astrid Aubert-Thierry,137543,54822,Astrid Aubert-Thierry,137543,220264,2022-08-04
CASH_OUT,14661,Astrid Aubert-Thierry,54822,40161,Agence_mtn_Abomey,300000,285339,2022-08-05
TRANSFER,38381,Astrid Aubert-Thierry,40161,1780,Astrid Aubert-Thierry,40161,1780,2022-08-06
TRANSFER,1589,Astrid Aubert-Thierry,1780,191,Astrid Aubert-Thierry,1780,191,2022-08-07
CASH_OUT,116,Astrid Aubert-Thierry,191,75,Agence_mtn_Abomey,300000,299884,2022-08-09
CASH_IN,273482,Agence_mtn_Cotonou,300000,26518,Astrid Aubert-Thierry,75,273557,2022-08-10
CASH_IN,242728,Agence_mtn_Abomey,300000,57272,Astrid Aubert-Thierry,273557,516285,2022-08-11
CASH_IN,42173,Agence_mtn_Cotonou,300000,257827,Astrid Aubert-Thierry,516285,558458,2022-08-11
TRANSFER,78931,Astrid Aubert-Thierry,558458,479527,Astrid Aubert-Thierry,558458,637389,2022-08-14
CASH_OUT,355832,Astrid Aubert-Thierry,479527,123695,Agence_mtn_Abomey,300000,-55832,2022-08-14
CASH_IN,26924,Agence_mtn_Ouidah,300000,273076,Astrid Aubert-Thierry,123695,150619,2022-08-16
CASH_OUT,142755,Astrid Aubert-Thierry,150619,7864,Agence_mtn_Abomey,300000,157245,2022-08-21
CASH_IN,161174,Agence_mtn_Cotonou,300000,138826,Charles Guérin,-27394,133780,2022-08-02
CASH_OUT,116737,Charles Guérin,133780,17043,Agence_mtn_Abomey,300000,183263,2022-08-04
CASH_IN,245876,Agence_mtn_Abomey,300000,54124,Charles Guérin,17043,262919,2022-08-05
CASH_OUT,77543,Charles Guérin,262919,185376,Agence_mtn_Ouidah,300000,222457,2022-08-06
CASH_OUT,149847,Charles Guérin,185376,35529,Agence_mtn_Cotonou,300000,150153,2022-08-06
CASH_IN,288110,Agence_mtn_Abomey,300000,11890,Charles Guérin,35529,323639,2022-08-07
CASH_OUT,164177,Charles Guérin,323639,159462,Agence_mtn_Ouidah,300000,135823,2022-08-08
CASH_IN,252353,Agence_mtn_Ouidah,300000,47647,Charles Guérin,159462,411815,2022-08-10
TRANSFER,17371,Charles Guérin,411815,394444,Charles Guérin,411815,394444,2022-08-16
CASH_IN,183983,Agence_mtn_Abomey,300000,116017,Charles Guérin,394444,578427,2022-08-21
CASH_IN,129000,Agence_mtn_Cotonou,300000,171000,Charles Guérin,578427,707427,2022-08-22
CASH_IN,186255,Agence_mtn_Cotonou,300000,113745,Charles Guérin,707427,893682,2022-08-22
CASH_IN,139960,Agence_mtn_Abomey,300000,160040,Charles Guérin,893682,1033642,2022-08-24
CASH_OUT,325061,Charles Guérin,1033642,708581,Agence_mtn_Ouidah,300000,-25061,2022-08-27
CASH_OUT,647801,Charles Guérin,708581,60780,Agence_mtn_Abomey,300000,-347801,2022-08-27
CASH_IN,69331,Agence_mtn_Cotonou,300000,230669,Jules-Marc Chauvet,-11597,57734,2022-08-03
CASH_OUT,6507,Jules-Marc Chauvet,57734,51227,Agence_mtn_Cotonou,300000,293493,2022-08-05
CASH_OUT,43715,Jules-Marc Chauvet,51227,7512,Agence_mtn_Ouidah,300000,256285,2022-08-05
TRANSFER,2510,Jules-Marc Chauvet,7512,5002,Jules-Marc Chauvet,7512,10022,2022-08-05
TRANSFER,3532,Jules-Marc Chauvet,5002,1470,Jules-Marc Chauvet,5002,8534,2022-08-06
CASH_IN,64415,Agence_mtn_Cotonou,300000,235585,Jules-Marc Chauvet,1470,65885,2022-08-10
TRANSFER,27915,Jules-Marc Chauvet,65885,37970,Jules-Marc Chauvet,65885,93800,2022-08-12
CASH_OUT,30304,Jules-Marc Chauvet,37970,7666,Agence_mtn_Cotonou,300000,269696,2022-08-12
CASH_OUT,7555,Jules-Marc Chauvet,7666,111,Agence_mtn_Ouidah,300000,292445,2022-08-13
CASH_OUT,108,Jules-Marc Chauvet,111,3,Agence_mtn_Ouidah,300000,299892,2022-08-16
CASH_IN,108534,Agence_mtn_Ouidah,300000,191466,Jules-Marc Chauvet,3,108537,2022-08-17
CASH_IN,13838,Agence_mtn_Cotonou,300000,286162,Jules-Marc Chauvet,108537,122375,2022-08-18
CASH_IN,115513,Agence_mtn_Cotonou,300000,184487,Jules-Marc Chauvet,122375,237888,2022-08-20
CASH_IN,185643,Agence_mtn_Abomey,300000,114357,Jules-Marc Chauvet,237888,423531,2022-08-21
CASH_IN,110742,Agence_mtn_Abomey,300000,189258,Jules-Marc Chauvet,423531,534273,2022-08-21
CASH_IN,43683,Agence_mtn_Ouidah,300000,256317,Jules-Marc Chauvet,534273,577956,2022-08-24
CASH_OUT,260693,Jules-Marc Chauvet,577956,317263,Agence_mtn_Cotonou,300000,39307,2022-08-24
CASH_IN,244688,Agence_mtn_Ouidah,300000,55312,Marc Baudry,-295152,-50464,2022-08-03
CASH_IN,44200,Agence_mtn_Ouidah,300000,255800,Marc Baudry,-50464,-6264,2022-08-04
CASH_IN,159030,Agence_mtn_Abomey,300000,140970,Marc Baudry,-6264,152766,2022-08-05
TRANSFER,94071,Marc Baudry,152766,58695,Marc Baudry,152766,58695,2022-08-07
TRANSFER,16404,Marc Baudry,58695,42291,Marc Baudry,58695,42291,2022-08-10
TRANSFER,29201,Marc Baudry,42291,13090,Marc Baudry,42291,13090,2022-08-13
CASH_IN,64747,Agence_mtn_Abomey,300000,235253,Marc Baudry,13090,77837,2022-08-16
CASH_IN,115376,Agence_mtn_Cotonou,300000,184624,Marc Baudry,77837,193213,2022-08-16
CASH_IN,123112,Agence_mtn_Ouidah,300000,176888,Marc Baudry,193213,316325,2022-08-16
CASH_IN,231993,Agence_mtn_Abomey,300000,68007,Marc Baudry,316325,548318,2022-08-19
CASH_OUT,45905,Marc Baudry,548318,502413,Agence_mtn_Abomey,300000,254095,2022-08-19
CASH_OUT,301573,Marc Baudry,502413,200840,Agence_mtn_Abomey,300000,-1573,2022-08-25
CASH_IN,200421,Agence_mtn_Abomey,300000,99579,Madeleine Philippe-Grondin,-220453,-20032,2022-08-01
CASH_IN,227414,Agence_mtn_Ouidah,300000,72586,Madeleine Philippe-Grondin,-20032,207382,2022-08-02
CASH_OUT,169864,Madeleine Philippe-Grondin,207382,37518,Agence_mtn_Ouidah,300000,130136,2022-08-06
CASH_OUT,1386,Madeleine Philippe-Grondin,37518,36132,Agence_mtn_Ouidah,300000,298614,2022-08-07
CASH_IN,111198,Agence_mtn_Ouidah,300000,188802,Madeleine Philippe-Grondin,36132,147330,2022-08-09
CASH_IN,161450,Agence_mtn_Abomey,300000,138550,Madeleine Philippe-Grondin,147330,308780,2022-08-10
TRANSFER,138272,Madeleine Philippe-Grondin,308780,170508,Madeleine Philippe-Grondin,308780,447052,2022-08-10
CASH_OUT,167579,Madeleine Philippe-Grondin,170508,2929,Agence_mtn_Abomey,300000,132421,2022-08-11
CASH_IN,78449,Agence_mtn_Abomey,300000,221551,Madeleine Philippe-Grondin,2929,81378,2022-08-12
CASH_IN,2817,Agence_mtn_Cotonou,300000,297183,Madeleine Philippe-Grondin,81378,84195,2022-08-13
CASH_OUT,6559,Madeleine Philippe-Grondin,84195,77636,Agence_mtn_Cotonou,300000,293441,2022-08-16
CASH_IN,239434,Agence_mtn_Ouidah,300000,60566,Simone du Allard,-273565,-34131,2022-08-03
CASH_IN,41514,Agence_mtn_Cotonou,300000,258486,Simone du Allard,-34131,7383,2022-08-03
TRANSFER,6928,Simone du Allard,7383,455,Simone du Allard,7383,14311,2022-08-05
CASH_OUT,435,Simone du Allard,455,20,Agence_mtn_Cotonou,300000,299565,2022-08-06
CASH_IN,79674,Agence_mtn_Abomey,300000,220326,Simone du Allard,20,79694,2022-08-06
CASH_OUT,48005,Simone du Allard,79694,31689,Agence_mtn_Abomey,300000,251995,2022-08-10
CASH_IN,176182,Agence_mtn_Ouidah,300000,123818,Simone du Allard,31689,207871,2022-08-10
CASH_IN,219848,Agence_mtn_Cotonou,300000,80152,Simone du Allard,207871,427719,2022-08-11
CASH_OUT,307665,Simone du Allard,427719,120054,Agence_mtn_Abomey,300000,-7665,2022-08-13
TRANSFER,52699,Simone du Allard,120054,67355,Simone du Allard,120054,67355,2022-08-13
CASH_IN,102019,Agence_mtn_Ouidah,300000,197981,Simone du Allard,67355,169374,2022-08-14
TRANSFER,82198,Simone du Allard,169374,87176,Simone du Allard,169374,251572,2022-08-14
TRANSFER,61734,Simone du Allard,87176,25442,Simone du Allard,87176,25442,2022-08-18
CASH_IN,265723,Agence_mtn_Cotonou,300000,34277,Simone du Allard,25442,291165,2022-08-19
CASH_OUT,265708,Simone du Allard,291165,25457,Agence_mtn_Cotonou,300000,34292,2022-08-21
CASH_OUT,16988,Simone du Allard,25457,8469,Agence_mtn_Abomey,300000,283012,2022-08-23
CASH_IN,1779,Agence_mtn_Abomey,300000,298221,Simone du Allard,8469,10248,2022-08-27
CASH_IN,240182,Agence_mtn_Cotonou,300000,59818,François Vaillant,-1074789,-834607,2022-08-05
CASH_IN,79121,Agence_mtn_Abomey,300000,220879,François Vaillant,-834607,-755486,2022-08-13
CASH_IN,98909,Agence_mtn_Cotonou,300000,201091,François Vaillant,-755486,-656577,2022-08-13
CASH_IN,288741,Agence_mtn_Abomey,300000,11259,François Vaillant,-656577,-367836,2022-08-14
CASH_IN,33727,Agence_mtn_Ouidah,300000,266273,François Vaillant,-367836,-334109,2022-08-16
CASH_IN,31484,Agence_mtn_Ouidah,300000,268516,François Vaillant,-334109,-302625,2022-08-16
CASH_IN,108525,Agence_mtn_Cotonou,300000,191475,François Vaillant,-302625,-194100,2022-08-26
CASH_IN,187477,Agence_mtn_Cotonou,300000,112523,Clémence-Alice Ruiz,-10348,177129,2022-08-01
CASH_IN,167817,Agence_mtn_Abomey,300000,132183,Clémence-Alice Ruiz,177129,344946,2022-08-03
CASH_OUT,209864,Clémence-Alice Ruiz,344946,135082,Agence_mtn_Abomey,300000,90136,2022-08-08
CASH_IN,235008,Agence_mtn_Cotonou,300000,64992,Clémence-Alice Ruiz,135082,370090,2022-08-09
CASH_IN,75204,Agence_mtn_Ouidah,300000,224796,Clémence-Alice Ruiz,370090,445294,2022-08-10
CASH_OUT,354997,Clémence-Alice Ruiz,445294,90297,Agence_mtn_Cotonou,300000,-54997,2022-08-10
TRANSFER,15984,Clémence-Alice Ruiz,90297,74313,Clémence-Alice Ruiz,90297,106281,2022-08-11
TRANSFER,19196,Clémence-Alice Ruiz,74313,55117,Clémence-Alice Ruiz,74313,55117,2022-08-12
CASH_OUT,39274,Clémence-Alice Ruiz,55117,15843,Agence_mtn_Ouidah,300000,260726,2022-08-13
TRANSFER,7180,Clémence-Alice Ruiz,15843,8663,Clémence-Alice Ruiz,15843,8663,2022-08-17
CASH_OUT,3252,Clémence-Alice Ruiz,8663,5411,Agence_mtn_Abomey,300000,296748,2022-08-27
CASH_IN,47693,Agence_mtn_Ouidah,300000,252307,Louis du Boyer,-346902,-299209,2022-08-04
CASH_IN,281226,Agence_mtn_Abomey,300000,18774,Louis du Boyer,-299209,-17983,2022-08-11
CASH_IN,77932,Agence_mtn_Ouidah,300000,222068,Louis du Boyer,-17983,59949,2022-08-14
CASH_OUT,53385,Louis du Boyer,59949,6564,Agence_mtn_Abomey,300000,246615,2022-08-19
CASH_IN,262602,Agence_mtn_Cotonou,300000,37398,Maurice de Brunet,-94760,167842,2022-08-01
CASH_OUT,73761,Maurice de Brunet,167842,94081,Agence_mtn_Abomey,300000,226239,2022-08-02
CASH_OUT,54700,Maurice de Brunet,94081,39381,Agence_mtn_Ouidah,300000,245300,2022-08-02
CASH_IN,7185,Agence_mtn_Abomey,300000,292815,Maurice de Brunet,39381,46566,2022-08-03
CASH_IN,255454,Agence_mtn_Abomey,300000,44546,Maurice de Brunet,46566,302020,2022-08-04
TRANSFER,198701,Maurice de Brunet,302020,103319,Maurice de Brunet,302020,500721,2022-08-08
CASH_OUT,26857,Maurice de Brunet,103319,76462,Agence_mtn_Ouidah,300000,273143,2022-08-11
TRANSFER,4443,Maurice de Brunet,76462,72019,Maurice de Brunet,76462,80905,2022-08-12
CASH_IN,290798,Agence_mtn_Ouidah,300000,9202,Maurice de Brunet,72019,362817,2022-08-13
CASH_IN,291238,Agence_mtn_Ouidah,300000,8762,Maurice de Brunet,362817,654055,2022-08-16
CASH_IN,92206,Agence_mtn_Abomey,300000,207794,Maurice de Brunet,654055,746261,2022-08-17
CASH_IN,133686,Agence_mtn_Cotonou,300000,166314,Maurice de Brunet,746261,879947,2022-08-18
CASH_IN,55337,Agence_mtn_Cotonou,300000,244663,Maurice de Brunet,879947,935284,2022-08-22
CASH_OUT,891883,Maurice de Brunet,935284,43401,Agence_mtn_Cotonou,300000,-591883,2022-08-22
CASH_OUT,11088,Maurice de Brunet,43401,32313,Agence_mtn_Ouidah,300000,288912,2022-08-24
CASH_IN,230806,Agence_mtn_Cotonou,300000,69194,Maurice de Brunet,32313,263119,2022-08-26
CASH_IN,152041,Agence_mtn_Abomey,300000,147959,Guy-Augustin Pinto,-75303,76738,2022-08-01
CASH_OUT,70329,Guy-Augustin Pinto,76738,6409,Agence_mtn_Ouidah,300000,229671,2022-08-02
CASH_OUT,5322,Guy-Augustin Pinto,6409,1087,Agence_mtn_Abomey,300000,294678,2022-08-05
TRANSFER,109,Guy-Augustin Pinto,1087,978,Guy-Augustin Pinto,1087,978,2022-08-06
CASH_OUT,706,Guy-Augustin Pinto,978,272,Agence_mtn_Abomey,300000,299294,2022-08-07
CASH_IN,299927,Agence_mtn_Abomey,300000,73,Guy-Augustin Pinto,272,300199,2022-08-10
CASH_IN,299667,Agence_mtn_Abomey,300000,333,Guy-Augustin Pinto,300199,599866,2022-08-10
CASH_OUT,442664,Guy-Augustin Pinto,599866,157202,Agence_mtn_Ouidah,300000,-142664,2022-08-11
CASH_OUT,127681,Guy-Augustin Pinto,157202,29521,Agence_mtn_Ouidah,300000,172319,2022-08-12
CASH_IN,269413,Agence_mtn_Abomey,300000,30587,Guy-Augustin Pinto,29521,298934,2022-08-16
CASH_IN,249207,Agence_mtn_Cotonou,300000,50793,Guy-Augustin Pinto,298934,548141,2022-08-19
CASH_IN,33080,Agence_mtn_Ouidah,300000,266920,Guy-Augustin Pinto,548141,581221,2022-08-21
CASH_IN,219369,Agence_mtn_Cotonou,300000,80631,Guy-Augustin Pinto,581221,800590,2022-08-23
CASH_OUT,368031,Guy-Augustin Pinto,800590,432559,Agence_mtn_Abomey,300000,-68031,2022-08-25
CASH_IN,198351,Agence_mtn_Cotonou,300000,101649,Gabrielle Hamon,-265957,-67606,2022-08-01
CASH_IN,7794,Agence_mtn_Ouidah,300000,292206,Gabrielle Hamon,-67606,-59812,2022-08-01
CASH_IN,95433,Agence_mtn_Cotonou,300000,204567,Gabrielle Hamon,-59812,35621,2022-08-01
TRANSFER,21087,Gabrielle Hamon,35621,14534,Gabrielle Hamon,35621,14534,2022-08-04
CASH_OUT,678,Gabrielle Hamon,14534,13856,Agence_mtn_Abomey,300000,299322,2022-08-06
CASH_IN,177979,Agence_mtn_Abomey,300000,122021,Gabrielle Hamon,13856,191835,2022-08-06
CASH_OUT,121837,Gabrielle Hamon,191835,69998,Agence_mtn_Abomey,300000,178163,2022-08-08
CASH_OUT,11610,Gabrielle Hamon,69998,58388,Agence_mtn_Abomey,300000,288390,2022-08-13
CASH_OUT,33371,Gabrielle Hamon,58388,25017,Agence_mtn_Ouidah,300000,266629,2022-08-14
TRANSFER,14251,Gabrielle Hamon,25017,10766,Gabrielle Hamon,25017,39268,2022-08-14
CASH_IN,283391,Agence_mtn_Ouidah,300000,16609,Gabrielle Hamon,10766,294157,2022-08-17
TRANSFER,209997,Gabrielle Hamon,294157,84160,Gabrielle Hamon,294157,504154,2022-08-17
TRANSFER,54242,Gabrielle Hamon,84160,29918,Gabrielle Hamon,84160,29918,2022-08-17
CASH_IN,187154,Agence_mtn_Ouidah,300000,112846,Gabrielle Hamon,29918,217072,2022-08-18
CASH_IN,235478,Agence_mtn_Ouidah,300000,64522,Gabrielle Hamon,217072,452550,2022-08-22
CASH_IN,271881,Agence_mtn_Cotonou,300000,28119,Aurélie Maury,-15709,256172,2022-08-01
TRANSFER,83331,Aurélie Maury,256172,172841,Aurélie Maury,256172,172841,2022-08-01
TRANSFER,47647,Aurélie Maury,172841,125194,Aurélie Maury,172841,125194,2022-08-02
CASH_OUT,61295,Aurélie Maury,125194,63899,Agence_mtn_Ouidah,300000,238705,2022-08-03
CASH_IN,171436,Agence_mtn_Ouidah,300000,128564,Aurélie Maury,63899,235335,2022-08-03
CASH_OUT,132137,Aurélie Maury,235335,103198,Agence_mtn_Cotonou,300000,167863,2022-08-03
TRANSFER,30947,Aurélie Maury,103198,72251,Aurélie Maury,103198,134145,2022-08-06
TRANSFER,62020,Aurélie Maury,72251,10231,Aurélie Maury,72251,134271,2022-08-06
CASH_OUT,5277,Aurélie Maury,10231,4954,Agence_mtn_Cotonou,300000,294723,2022-08-13
CASH_OUT,148,Aurélie Maury,4954,4806,Agence_mtn_Cotonou,300000,299852,2022-08-18
CASH_IN,205505,Agence_mtn_Abomey,300000,94495,Honoré de la Prévost,-141563,63942,2022-08-01
CASH_IN,122314,Agence_mtn_Cotonou,300000,177686,Honoré de la Prévost,63942,186256,2022-08-01
CASH_OUT,94491,Honoré de la Prévost,186256,91765,Agence_mtn_Ouidah,300000,205509,2022-08-03
TRANSFER,22495,Honoré de la Prévost,91765,69270,Honoré de la Prévost,91765,114260,2022-08-05
CASH_IN,267294,Agence_mtn_Cotonou,300000,32706,Honoré de la Prévost,69270,336564,2022-08-06
CASH_IN,52614,Agence_mtn_Abomey,300000,247386,Honoré de la Prévost,336564,389178,2022-08-07
CASH_IN,262673,Agence_mtn_Abomey,300000,37327,Honoré de la Prévost,389178,651851,2022-08-17
CASH_IN,131905,Agence_mtn_Abomey,300000,168095,Honoré de la Prévost,651851,783756,2022-08-18
CASH_OUT,315246,Louis de la Imbert,417600,102354,Agence_mtn_Abomey,300000,-15246,2022-09-08
TRANSFER,1694685,Marcel de la Buisson,1814500,119815,Louis de la Imbert,102354,1797039,2022-09-12
TRANSFER,732904,Louis de la Imbert,1797039,1064135,Simone du Allard,621900,-111004,2022-09-20
CASH_OUT,317480,Louis de la Imbert,1064135,746655,Agence_mtn_Abomey,300000,-17480,2022-09-23
CASH_IN,229839,Agence_mtn_Cotonou,300000,70161,Louis de la Imbert,746655,976494,2022-09-23
CASH_IN,279388,Agence_mtn_Abomey,300000,20612,Astrid de Pascal,1634500,1913888,2022-09-25
CASH_IN,190626,Agence_mtn_Cotonou,300000,109374,Christine Rossi,108300,298926,2022-09-01
TRANSFER,457523,Christophe Teixeira,1031200,573677,Christine Rossi,298926,756449,2022-09-05
CASH_IN,209021,Agence_mtn_Ouidah,300000,90979,Christine Rossi,756449,965470,2022-09-06
TRANSFER,275244,Christine Rossi,965470,690226,Michelle de la Daniel,1465700,1190456,2022-09-12
CASH_IN,65971,Agence_mtn_Abomey,300000,234029,Christine Rossi,690226,756197,2022-09-24
CASH_OUT,78233,Océane Faure,542000,463767,Agence_mtn_Ouidah,300000,221767,2022-09-08
CASH_IN,209850,Agence_mtn_Abomey,300000,90150,Océane Faure,463767,673617,2022-09-15
CASH_OUT,458464,Gérard Blot de Blanc,1150500,692036,Agence_mtn_Ouidah,300000,-158464,2022-09-12
CASH_OUT,340768,Gérard Blot de Blanc,692036,351268,Agence_mtn_Ouidah,300000,-40768,2022-09-21
CASH_IN,172944,Agence_mtn_Abomey,300000,127056,Robert Henry-Poulain,1709800,1882744,2022-09-21
TRANSFER,1409,Thérèse-Juliette Camus,4900,3491,Raymond de Le Roux,75200,76609,2022-09-08
CASH_OUT,3251,Raymond de Le Roux,76609,73358,Agence_mtn_Cotonou,300000,296749,2022-09-16
CASH_IN,1051,Agence_mtn_Cotonou,300000,298949,Raymond de Le Roux,73358,74409,2022-09-18
CASH_OUT,7088,Jules-Marc Chauvet,9200,2112,Agence_mtn_Ouidah,300000,292912,2022-09-07
TRANSFER,414153,Christophe Teixeira,573677,159524,Jules-Marc Chauvet,2112,416265,2022-09-13
CASH_OUT,129170,Jules-Marc Chauvet,416265,287095,Agence_mtn_Abomey,300000,170830,2022-09-19
CASH_OUT,261664,Jules-Marc Chauvet,287095,25431,Agence_mtn_Cotonou,300000,38336,2022-09-21
CASH_IN,80654,Agence_mtn_Cotonou,300000,219346,Margaud-Michelle Briand,1547400,1628054,2022-09-07
TRANSFER,41164,Marcel de la Buisson,119815,78651,Margaud-Michelle Briand,1628054,1669218,2022-09-09
CASH_IN,210164,Agence_mtn_Ouidah,300000,89836,Margaud-Michelle Briand,1669218,1879382,2022-09-19
CASH_OUT,1757132,Margaud-Michelle Briand,1879382,122250,Agence_mtn_Ouidah,300000,-1457132,2022-09-23
CASH_IN,146259,Agence_mtn_Ouidah,300000,153741,Margaud-Michelle Briand,122250,268509,2022-09-27
TRANSFER,123767,Sébastien Coste,346100,222333,Jacques Le Marion,564500,688267,2022-09-05
CASH_IN,150183,Agence_mtn_Cotonou,300000,149817,Josette du Hamon,939000,1089183,2022-09-03
CASH_IN,285635,Agence_mtn_Cotonou,300000,14365,Josette du Hamon,1089183,1374818,2022-09-05
TRANSFER,347924,Raymond-Yves Boulanger,1910300,1562376,Josette du Hamon,1374818,1722742,2022-09-12
CASH_IN,92390,Agence_mtn_Ouidah,300000,207610,Josette du Hamon,1722742,1815132,2022-09-20
TRANSFER,1758841,Josette du Hamon,1815132,56291,Sabine Perrier,541800,-1217041,2022-09-20
CASH_IN,189655,Agence_mtn_Abomey,300000,110345,Julien Devaux,1288500,1478155,2022-09-04
TRANSFER,1102018,Julien Devaux,1478155,376137,Michelle de la Daniel,1190456,88438,2022-09-11
TRANSFER,87034,Julien Devaux,376137,289103,Françoise Denis de Allard,963200,876166,2022-09-12
CASH_OUT,127618,Stéphanie Guichard,871100,743482,Agence_mtn_Ouidah,300000,172382,2022-09-04
CASH_IN,96550,Agence_mtn_Cotonou,300000,203450,Stéphanie Guichard,743482,840032,2022-09-11
CASH_OUT,38447,Stéphanie Guichard,840032,801585,Agence_mtn_Abomey,300000,261553,2022-09-14
TRANSFER,225221,Alfred Paris,260700,35479,Pénélope Boulay,115500,-109721,2022-09-08
TRANSFER,10512,Alfred Paris,35479,24967,Guy-Augustin Pinto,1353200,1342688,2022-09-12
TRANSFER,89335,Jacques Laporte de Blanchet,360500,271165,Alfred Paris,24967,114302,2022-09-15
CASH_IN,240148,Agence_mtn_Ouidah,300000,59852,Alfred Paris,114302,354450,2022-09-17
TRANSFER,264288,Georges-Alfred Pruvost,1425400,1161112,Alfred Paris,354450,618738,2022-09-22
CASH_OUT,120186,Valérie de Pottier,516900,396714,Agence_mtn_Ouidah,300000,179814,2022-09-19
TRANSFER,241299,Zacharie Fabre,858500,617201,Corinne Roussel,1904800,2146099,2022-09-01
TRANSFER,520479,Martin Moreau,1819600,1299121,Corinne Roussel,2146099,2666578,2022-09-22
CASH_IN,71870,Agence_mtn_Ouidah,300000,228130,Corinne Roussel,2666578,2738448,2022-09-26
TRANSFER,60098,René de la Delaunay,472900,412802,René de la Delaunay,472900,532998,2022-09-06
CASH_IN,132257,Agence_mtn_Abomey,300000,167743,René de la Delaunay,412802,545059,2022-09-14
CASH_IN,66871,Agence_mtn_Abomey,300000,233129,René de la Delaunay,545059,611930,2022-09-19
TRANSFER,499845,Clémence Dufour,556000,56155,René de la Delaunay,611930,1111775,2022-09-20
CASH_IN,214265,Agence_mtn_Cotonou,300000,85735,René de la Delaunay,1111775,1326040,2022-09-22
TRANSFER,887519,Raymond Simon,1751300,863781,Édouard Grondin du Fleury,66900,-820619,2022-09-02
CASH_OUT,829353,Raymond Simon,863781,34428,Agence_mtn_Ouidah,300000,-529353,2022-09-03
TRANSFER,10827,Raymond Simon,34428,23601,Laurent Marion,970400,959573,2022-09-19
CASH_OUT,11883,Raymond Simon,23601,11718,Agence_mtn_Ouidah,300000,288117,2022-09-20
CASH_OUT,6073,Raymond Simon,11718,5645,Agence_mtn_Cotonou,300000,293927,2022-09-24
TRANSFER,240700,Anouk Delahaye-Gimenez,665900,425200,Christophe Besnard-Diaz,349900,109200,2022-09-07
CASH_OUT,367719,Anouk Delahaye-Gimenez,425200,57481,Agence_mtn_Abomey,300000,-67719,2022-09-19
TRANSFER,1761976,Nathalie-Claire De Oliveira,1773200,11224,Anouk Delahaye-Gimenez,57481,1819457,2022-09-25
TRANSFER,483091,Anouk Delahaye-Gimenez,1819457,1336366,Martin Moreau,1299121,816030,2022-09-26
CASH_OUT,108349,Danielle-Henriette Tessier,1181700,1073351,Agence_mtn_Abomey,300000,191651,2022-09-02
TRANSFER,754142,Danielle-Henriette Tessier,1073351,319209,Élise Monnier,692800,-61342,2022-09-13
TRANSFER,72449,Christophe Besnard-Diaz,109200,36751,Danielle-Henriette Tessier,319209,391658,2022-09-14
TRANSFER,270408,Danielle-Henriette Tessier,391658,121250,Thibault-Julien Chevallier,531000,260592,2022-09-18
TRANSFER,90328,Danielle-Henriette Tessier,121250,30922,Éléonore Marin Le Morel,726900,636572,2022-09-22
TRANSFER,20531,Christophe Teixeira,159524,138993,Marine Labbé,837100,857631,2022-09-10
CASH_IN,297461,Agence_mtn_Abomey,300000,2539,Marine Labbé,857631,1155092,2022-09-19
TRANSFER,13966,Gérard Cordier,192700,178734,Marine Labbé,1155092,1169058,2022-09-20
CASH_IN,87720,Agence_mtn_Ouidah,300000,212280,Marine Labbé,1169058,1256778,2022-09-27
CASH_OUT,933349,Sophie-Anouk Boulanger,1539000,605651,Agence_mtn_Abomey,300000,-633349,2022-09-02
CASH_OUT,390910,Sophie-Anouk Boulanger,605651,214741,Agence_mtn_Abomey,300000,-90910,2022-09-03
CASH_IN,215869,Agence_mtn_Ouidah,300000,84131,Sophie-Anouk Boulanger,214741,430610,2022-09-07
CASH_OUT,121848,Marine Chevallier,141700,19852,Agence_mtn_Abomey,300000,178152,2022-09-07
CASH_IN,260245,Agence_mtn_Cotonou,300000,39755,Marine Chevallier,19852,280097,2022-09-18
CASH_IN,250743,Agence_mtn_Ouidah,300000,49257,Marine Chevallier,280097,530840,2022-09-20
CASH_OUT,29221,Marine Chevallier,530840,501619,Agence_mtn_Ouidah,300000,270779,2022-09-23
CASH_OUT,1468040,Raymond-Yves Boulanger,1562376,94336,Agence_mtn_Ouidah,300000,-1168040,2022-09-02
TRANSFER,46581,Raymond-Yves Boulanger,94336,47755,Guillaume de la Nguyen,802700,756119,2022-09-14
TRANSFER,4347,Nathalie-Claire De Oliveira,11224,6877,Raymond-Yves Boulanger,47755,52102,2022-09-25
CASH_IN,205505,Agence_mtn_Abomey,300000,94495,Raymond-Yves Boulanger,52102,257607,2022-09-25
CASH_OUT,329144,Olivier Benard,527000,197856,Agence_mtn_Abomey,300000,-29144,2022-09-07
CASH_IN,191810,Agence_mtn_Abomey,300000,108190,Olivier Benard,197856,389666,2022-09-18
CASH_IN,109687,Agence_mtn_Cotonou,300000,190313,Olivier Benard,389666,499353,2022-09-20
CASH_IN,198904,Agence_mtn_Abomey,300000,101096,Olivier Benard,499353,698257,2022-09-26
CASH_OUT,1089741,Louise-Aurore Payet,1412500,322759,Agence_mtn_Ouidah,300000,-789741,2022-09-01
TRANSFER,572285,Charles Guérin,724500,152215,Louise-Aurore Payet,322759,895044,2022-09-07
CASH_IN,75967,Agence_mtn_Ouidah,300000,224033,Louise-Aurore Payet,895044,971011,2022-09-25
TRANSFER,497414,Véronique Hardy,1104000,606586,Jacques Laporte de Blanchet,271165,-226249,2022-09-07
CASH_OUT,160673,Véronique Hardy,606586,445913,Agence_mtn_Cotonou,300000,139327,2022-09-11
TRANSFER,234255,Véronique Hardy,445913,211658,Madeleine Hardy,1691500,1457245,2022-09-17
CASH_OUT,82976,Véronique Hardy,211658,128682,Agence_mtn_Abomey,300000,217024,2022-09-19
TRANSFER,378801,Marc Costa-Daniel,505500,126699,Véronique Hardy,128682,507483,2022-09-21
CASH_OUT,767182,Céline-Inès Meunier,1608000,840818,Agence_mtn_Ouidah,300000,-467182,2022-09-03
CASH_IN,42805,Agence_mtn_Cotonou,300000,257195,Céline-Inès Meunier,840818,883623,2022-09-05
TRANSFER,69831,Marc Costa-Daniel,126699,56868,Céline-Inès Meunier,883623,953454,2022-09-05
CASH_IN,61666,Agence_mtn_Cotonou,300000,238334,Céline-Inès Meunier,953454,1015120,2022-09-07
CASH_IN,249692,Agence_mtn_Cotonou,300000,50308,Céline-Inès Meunier,1015120,1264812,2022-09-07
CASH_IN,278135,Agence_mtn_Abomey,300000,21865,Céline-Inès Meunier,1264812,1542947,2022-09-08
CASH_OUT,536419,Céline-Inès Meunier,1542947,1006528,Agence_mtn_Abomey,300000,-236419,2022-09-09
CASH_IN,94393,Agence_mtn_Abomey,300000,205607,Céline-Inès Meunier,1006528,1100921,2022-09-11
CASH_IN,275139,Agence_mtn_Abomey,300000,24861,Céline-Inès Meunier,1100921,1376060,2022-09-11
CASH_OUT,956296,Céline-Inès Meunier,1376060,419764,Agence_mtn_Abomey,300000,-656296,2022-09-12
CASH_IN,251016,Agence_mtn_Abomey,300000,48984,Céline-Inès Meunier,419764,670780,2022-09-13
CASH_OUT,314728,Céline-Inès Meunier,670780,356052,Agence_mtn_Abomey,300000,-14728,2022-09-13
TRANSFER,3004,Thérèse-Juliette Camus,3491,487,Céline-Inès Meunier,356052,359056,2022-09-14
CASH_OUT,236920,Céline-Inès Meunier,359056,122136,Agence_mtn_Ouidah,300000,63080,2022-09-15
CASH_IN,165003,Agence_mtn_Abomey,300000,134997,Céline-Inès Meunier,122136,287139,2022-09-15
CASH_IN,54249,Agence_mtn_Ouidah,300000,245751,Céline-Inès Meunier,287139,341388,2022-09-18
CASH_OUT,208738,Céline-Inès Meunier,341388,132650,Agence_mtn_Cotonou,300000,91262,2022-09-19
CASH_OUT,81214,Céline-Inès Meunier,132650,51436,Agence_mtn_Cotonou,300000,218786,2022-09-20
CASH_OUT,22775,Céline-Inès Meunier,51436,28661,Agence_mtn_Ouidah,300000,277225,2022-09-21
CASH_OUT,26593,Céline-Inès Meunier,28661,2068,Agence_mtn_Cotonou,300000,273407,2022-09-22
TRANSFER,123,Céline-Inès Meunier,2068,1945,Madeleine Philippe-Grondin,553400,553277,2022-09-24
CASH_OUT,389998,Clémence-Alice Ruiz,997700,607702,Agence_mtn_Abomey,300000,-89998,2022-09-02
TRANSFER,962004,Honoré Grégoire-Breton,1165200,203196,Clémence-Alice Ruiz,607702,1569706,2022-09-03
CASH_IN,213270,Agence_mtn_Abomey,300000,86730,Clémence-Alice Ruiz,1569706,1782976,2022-09-04
CASH_OUT,1515621,Clémence-Alice Ruiz,1782976,267355,Agence_mtn_Cotonou,300000,-1215621,2022-09-04
TRANSFER,60523,Clémence-Alice Ruiz,267355,206832,Jérôme Laporte Le Gauthier,884900,824377,2022-09-05
TRANSFER,608403,Jean Guilbert-Lenoir,1924400,1315997,Clémence-Alice Ruiz,206832,815235,2022-09-05
TRANSFER,56472,Martin Moreau,816030,759558,Clémence-Alice Ruiz,815235,871707,2022-09-06
CASH_IN,218396,Agence_mtn_Cotonou,300000,81604,Clémence-Alice Ruiz,871707,1090103,2022-09-06
CASH_IN,271324,Agence_mtn_Abomey,300000,28676,Clémence-Alice Ruiz,1090103,1361427,2022-09-07
CASH_OUT,769321,Clémence-Alice Ruiz,1361427,592106,Agence_mtn_Abomey,300000,-469321,2022-09-07
CASH_IN,142762,Agence_mtn_Cotonou,300000,157238,Clémence-Alice Ruiz,592106,734868,2022-09-08
CASH_IN,171526,Agence_mtn_Cotonou,300000,128474,Clémence-Alice Ruiz,734868,906394,2022-09-09
CASH_IN,211054,Agence_mtn_Abomey,300000,88946,Clémence-Alice Ruiz,906394,1117448,2022-09-10
CASH_OUT,30744,Clémence-Alice Ruiz,1117448,1086704,Agence_mtn_Cotonou,300000,269256,2022-09-10
TRANSFER,148423,Clémence-Alice Ruiz,1086704,938281,Nicolas Blin,1624500,1476077,2022-09-11
CASH_OUT,790986,Clémence-Alice Ruiz,938281,147295,Agence_mtn_Ouidah,300000,-490986,2022-09-13
TRANSFER,256532,Maurice de Brunet,338200,81668,Clémence-Alice Ruiz,147295,403827,2022-09-15
CASH_IN,31701,Agence_mtn_Ouidah,300000,268299,Clémence-Alice Ruiz,403827,435528,2022-09-15
CASH_IN,132688,Agence_mtn_Cotonou,300000,167312,Clémence-Alice Ruiz,435528,568216,2022-09-16
CASH_IN,105027,Agence_mtn_Cotonou,300000,194973,Clémence-Alice Ruiz,568216,673243,2022-09-17
CASH_IN,226259,Agence_mtn_Ouidah,300000,73741,Clémence-Alice Ruiz,673243,899502,2022-09-18
CASH_OUT,678274,Clémence-Alice Ruiz,899502,221228,Agence_mtn_Ouidah,300000,-378274,2022-09-19
CASH_IN,9004,Agence_mtn_Abomey,300000,290996,Clémence-Alice Ruiz,221228,230232,2022-09-20
CASH_IN,196751,Agence_mtn_Abomey,300000,103249,Clémence-Alice Ruiz,230232,426983,2022-09-23
CASH_OUT,46175,Clémence-Alice Ruiz,426983,380808,Agence_mtn_Ouidah,300000,253825,2022-09-25
CASH_IN,90022,Agence_mtn_Cotonou,300000,209978,Clémence-Alice Ruiz,380808,470830,2022-09-26
CASH_OUT,200533,Clémence-Alice Ruiz,470830,270297,Agence_mtn_Cotonou,300000,99467,2022-09-26
CASH_IN,274265,Agence_mtn_Abomey,300000,25735,Clémence-Alice Ruiz,270297,544562,2022-09-26
TRANSFER,32230,Clémence-Alice Ruiz,544562,512332,Sébastien Coste,222333,190103,2022-09-27
TRANSFER,1432009,Nathalie Da Silva,1461000,28991,Georges-Alfred Pruvost,1161112,2593121,2022-09-01
TRANSFER,1353006,Georges-Alfred Pruvost,2593121,1240115,Élisabeth Blot-Bruneau,473900,-879106,2022-09-01
CASH_IN,71355,Agence_mtn_Ouidah,300000,228645,Georges-Alfred Pruvost,1240115,1311470,2022-09-01
CASH_IN,102692,Agence_mtn_Ouidah,300000,197308,Georges-Alfred Pruvost,1311470,1414162,2022-09-05
TRANSFER,709347,Georges-Alfred Pruvost,1414162,704815,Martin Moreau,759558,50211,2022-09-05
CASH_IN,66240,Agence_mtn_Abomey,300000,233760,Georges-Alfred Pruvost,704815,771055,2022-09-07
CASH_OUT,530023,Georges-Alfred Pruvost,771055,241032,Agence_mtn_Abomey,300000,-230023,2022-09-07
CASH_IN,187155,Agence_mtn_Cotonou,300000,112845,Georges-Alfred Pruvost,241032,428187,2022-09-09
CASH_IN,249967,Agence_mtn_Ouidah,300000,50033,Georges-Alfred Pruvost,428187,678154,2022-09-09
TRANSFER,528084,Georges-Alfred Pruvost,678154,150070,Valérie-Claudine Marin,1717100,1189016,2022-09-11
TRANSFER,84390,Georges-Alfred Pruvost,150070,65680,Charlotte Perrier,367200,282810,2022-09-13
TRANSFER,21465,Georges-Alfred Pruvost,65680,44215,Julie Germain Le Vaillant,1627100,1605635,2022-09-13
CASH_IN,80131,Agence_mtn_Cotonou,300000,219869,Georges-Alfred Pruvost,44215,124346,2022-09-13
CASH_IN,151847,Agence_mtn_Abomey,300000,148153,Georges-Alfred Pruvost,124346,276193,2022-09-13
CASH_IN,72433,Agence_mtn_Cotonou,300000,227567,Georges-Alfred Pruvost,276193,348626,2022-09-13
CASH_IN,243327,Agence_mtn_Cotonou,300000,56673,Georges-Alfred Pruvost,348626,591953,2022-09-14
CASH_IN,278019,Agence_mtn_Ouidah,300000,21981,Georges-Alfred Pruvost,591953,869972,2022-09-15
CASH_OUT,537826,Georges-Alfred Pruvost,869972,332146,Agence_mtn_Cotonou,300000,-237826,2022-09-17
TRANSFER,6012,Georges-Alfred Pruvost,332146,326134,Roger-Roger Delmas,666900,660888,2022-09-18
CASH_OUT,105006,Georges-Alfred Pruvost,326134,221128,Agence_mtn_Ouidah,300000,194994,2022-09-20
CASH_OUT,182842,Georges-Alfred Pruvost,221128,38286,Agence_mtn_Cotonou,300000,117158,2022-09-22
CASH_IN,127103,Agence_mtn_Ouidah,300000,172897,Georges-Alfred Pruvost,38286,165389,2022-09-22
CASH_IN,31108,Agence_mtn_Abomey,300000,268892,Georges-Alfred Pruvost,165389,196497,2022-09-23
CASH_OUT,153721,Georges-Alfred Pruvost,196497,42776,Agence_mtn_Abomey,300000,146279,2022-09-24
CASH_OUT,32993,Georges-Alfred Pruvost,42776,9783,Agence_mtn_Ouidah,300000,267007,2022-09-26
TRANSFER,4468,Georges-Alfred Pruvost,9783,5315,Georges-Alfred Pruvost,9783,5315,2022-09-26
TRANSFER,555,Georges-Alfred Pruvost,5315,4760,Nathalie Da Silva,28991,28436,2022-09-26
CASH_OUT,2986,Georges-Alfred Pruvost,4760,1774,Agence_mtn_Cotonou,300000,297014,2022-09-27
CASH_IN,278247,Agence_mtn_Cotonou,300000,21753,Georges-Alfred Pruvost,1774,280021,2022-09-27
CASH_OUT,890867,Astrid Aubert-Thierry,1464200,573333,Agence_mtn_Cotonou,300000,-590867,2022-09-02
CASH_OUT,77336,Astrid Aubert-Thierry,573333,495997,Agence_mtn_Ouidah,300000,222664,2022-09-04
CASH_OUT,46940,Astrid Aubert-Thierry,495997,449057,Agence_mtn_Cotonou,300000,253060,2022-09-04
TRANSFER,311051,Astrid Aubert-Thierry,449057,138006,Éléonore Marin Le Morel,636572,325521,2022-09-05
TRANSFER,5781,Nathalie-Claire De Oliveira,6877,1096,Astrid Aubert-Thierry,138006,143787,2022-09-05
CASH_IN,34334,Agence_mtn_Cotonou,300000,265666,Astrid Aubert-Thierry,143787,178121,2022-09-05
TRANSFER,493693,Nicole-Renée Gay,548900,55207,Astrid Aubert-Thierry,178121,671814,2022-09-06
CASH_IN,168027,Agence_mtn_Cotonou,300000,131973,Astrid Aubert-Thierry,671814,839841,2022-09-07
CASH_OUT,606252,Astrid Aubert-Thierry,839841,233589,Agence_mtn_Abomey,300000,-306252,2022-09-08
CASH_OUT,109922,Astrid Aubert-Thierry,233589,123667,Agence_mtn_Abomey,300000,190078,2022-09-08
CASH_IN,24150,Agence_mtn_Cotonou,300000,275850,Astrid Aubert-Thierry,123667,147817,2022-09-09
CASH_OUT,64133,Astrid Aubert-Thierry,147817,83684,Agence_mtn_Ouidah,300000,235867,2022-09-09
TRANSFER,25299,Maurice de Brunet,81668,56369,Astrid Aubert-Thierry,83684,108983,2022-09-10
TRANSFER,527441,Jérôme Laporte Le Gauthier,824377,296936,Astrid Aubert-Thierry,108983,636424,2022-09-10
TRANSFER,320391,Astrid Aubert-Thierry,636424,316033,Sylvie Dupré,1599200,1278809,2022-09-11
TRANSFER,441,Thérèse-Juliette Camus,487,46,Astrid Aubert-Thierry,316033,316474,2022-09-14
TRANSFER,440024,Madeleine Hardy,1457245,1017221,Astrid Aubert-Thierry,316474,756498,2022-09-15
TRANSFER,242338,Emmanuel Legrand,1157400,915062,Astrid Aubert-Thierry,756498,998836,2022-09-17
CASH_OUT,514160,Astrid Aubert-Thierry,998836,484676,Agence_mtn_Abomey,300000,-214160,2022-09-22
CASH_IN,202209,Agence_mtn_Ouidah,300000,97791,Astrid Aubert-Thierry,484676,686885,2022-09-23
TRANSFER,656865,Thibault Martin,995900,339035,Astrid Aubert-Thierry,686885,1343750,2022-09-25
CASH_OUT,25005,Honoré Grégoire-Breton,203196,178191,Agence_mtn_Abomey,300000,274995,2022-09-02
CASH_OUT,145015,Honoré Grégoire-Breton,178191,33176,Agence_mtn_Abomey,300000,154985,2022-09-02
TRANSFER,7089,Nicole-Renée Gay,55207,48118,Honoré Grégoire-Breton,33176,40265,2022-09-03
CASH_IN,182884,Agence_mtn_Cotonou,300000,117116,Honoré Grégoire-Breton,40265,223149,2022-09-04
TRANSFER,179413,Gabrielle Hamon,198100,18687,Honoré Grégoire-Breton,223149,402562,2022-09-07
CASH_OUT,131089,Honoré Grégoire-Breton,402562,271473,Agence_mtn_Ouidah,300000,168911,2022-09-09
TRANSFER,63620,Michèle Faivre,123300,59680,Honoré Grégoire-Breton,271473,335093,2022-09-10
CASH_OUT,175301,Honoré Grégoire-Breton,335093,159792,Agence_mtn_Abomey,300000,124699,2022-09-10
CASH_OUT,103512,Honoré Grégoire-Breton,159792,56280,Agence_mtn_Cotonou,300000,196488,2022-09-10
TRANSFER,81160,Margot Julien,923000,841840,Honoré Grégoire-Breton,56280,137440,2022-09-10
CASH_OUT,77390,Honoré Grégoire-Breton,137440,60050,Agence_mtn_Ouidah,300000,222610,2022-09-11
CASH_IN,278601,Agence_mtn_Cotonou,300000,21399,Honoré Grégoire-Breton,60050,338651,2022-09-12
CASH_OUT,323485,Honoré Grégoire-Breton,338651,15166,Agence_mtn_Ouidah,300000,-23485,2022-09-12
CASH_IN,263461,Agence_mtn_Abomey,300000,36539,Honoré Grégoire-Breton,15166,278627,2022-09-16
TRANSFER,39640,Honoré Grégoire-Breton,278627,238987,Marc Baudry,1586500,1546860,2022-09-18
CASH_OUT,2106,Honoré Grégoire-Breton,238987,236881,Agence_mtn_Abomey,300000,297894,2022-09-18
CASH_OUT,8188,Honoré Grégoire-Breton,236881,228693,Agence_mtn_Abomey,300000,291812,2022-09-20
CASH_IN,217702,Agence_mtn_Abomey,300000,82298,Honoré Grégoire-Breton,228693,446395,2022-09-21
TRANSFER,302821,Honoré Grégoire-Breton,446395,143574,Marc Baudry,1546860,1244039,2022-09-23
CASH_IN,49231,Agence_mtn_Abomey,300000,250769,Honoré Grégoire-Breton,143574,192805,2022-09-23
TRANSFER,148420,Matthieu Cousin,165600,17180,Honoré Grégoire-Breton,192805,341225,2022-09-23
CASH_IN,184699,Agence_mtn_Cotonou,300000,115301,Honoré Grégoire-Breton,341225,525924,2022-09-23
CASH_OUT,323356,Honoré Grégoire-Breton,525924,202568,Agence_mtn_Abomey,300000,-23356,2022-09-25
TRANSFER,249035,Georges Muller,336900,87865,Honoré Grégoire-Breton,202568,451603,2022-09-25
TRANSFER,47211,Michèle Faivre,59680,12469,Honoré Grégoire-Breton,451603,498814,2022-09-25
CASH_IN,8393,Agence_mtn_Cotonou,300000,291607,Jérôme Laporte Le Gauthier,296936,305329,2022-09-02
CASH_OUT,39556,Jérôme Laporte Le Gauthier,305329,265773,Agence_mtn_Cotonou,300000,260444,2022-09-03
CASH_IN,217636,Agence_mtn_Abomey,300000,82364,Jérôme Laporte Le Gauthier,265773,483409,2022-09-03
CASH_OUT,282484,Jérôme Laporte Le Gauthier,483409,200925,Agence_mtn_Abomey,300000,17516,2022-09-06
CASH_IN,224847,Agence_mtn_Cotonou,300000,75153,Jérôme Laporte Le Gauthier,200925,425772,2022-09-07
CASH_IN,23593,Agence_mtn_Cotonou,300000,276407,Jérôme Laporte Le Gauthier,425772,449365,2022-09-07
TRANSFER,8431,Jérôme Laporte Le Gauthier,449365,440934,Élisabeth Delattre,2800,-5631,2022-09-08
CASH_IN,146052,Agence_mtn_Cotonou,300000,153948,Jérôme Laporte Le Gauthier,440934,586986,2022-09-08
TRANSFER,130145,Jérôme Laporte Le Gauthier,586986,456841,Charles Guérin,152215,22070,2022-09-10
CASH_IN,204118,Agence_mtn_Ouidah,300000,95882,Jérôme Laporte Le Gauthier,456841,660959,2022-09-11
CASH_IN,285038,Agence_mtn_Abomey,300000,14962,Jérôme Laporte Le Gauthier,660959,945997,2022-09-11
TRANSFER,179670,Zacharie Fabre,617201,437531,Jérôme Laporte Le Gauthier,945997,1125667,2022-09-13
CASH_IN,211458,Agence_mtn_Cotonou,300000,88542,Jérôme Laporte Le Gauthier,1125667,1337125,2022-09-14
CASH_IN,119123,Agence_mtn_Abomey,300000,180877,Jérôme Laporte Le Gauthier,1337125,1456248,2022-09-14
CASH_IN,293923,Agence_mtn_Abomey,300000,6077,Jérôme Laporte Le Gauthier,1456248,1750171,2022-09-14
TRANSFER,1238008,Jérôme Laporte Le Gauthier,1750171,512163,Georges Muller,87865,-1150143,2022-09-15
CASH_IN,4979,Agence_mtn_Abomey,300000,295021,Jérôme Laporte Le Gauthier,512163,517142,2022-09-16
CASH_IN,274462,Agence_mtn_Ouidah,300000,25538,Jérôme Laporte Le Gauthier,517142,791604,2022-09-17
CASH_OUT,246948,Jérôme Laporte Le Gauthier,791604,544656,Agence_mtn_Abomey,300000,53052,2022-09-17
CASH_OUT,218527,Jérôme Laporte Le Gauthier,544656,326129,Agence_mtn_Ouidah,300000,81473,2022-09-17
TRANSFER,272544,Margot Julien,841840,569296,Jérôme Laporte Le Gauthier,326129,598673,2022-09-18
TRANSFER,17365,Martin Moreau,50211,32846,Jérôme Laporte Le Gauthier,598673,616038,2022-09-20
TRANSFER,334080,Jérôme Laporte Le Gauthier,616038,281958,Augustin-Jérôme Merle,1977400,1643320,2022-09-22
CASH_IN,225228,Agence_mtn_Abomey,300000,74772,Jérôme Laporte Le Gauthier,281958,507186,2022-09-25
CASH_IN,25397,Agence_mtn_Ouidah,300000,274603,Jérôme Laporte Le Gauthier,507186,532583,2022-09-26
TRANSFER,1473681,Augustin-Jérôme Merle,1643320,169639,Jérôme Laporte Le Gauthier,532583,2006264,2022-09-26
CASH_OUT,245107,Gilbert Moulin,715400,470293,Agence_mtn_Ouidah,300000,54893,2022-09-02
CASH_IN,51766,Agence_mtn_Cotonou,300000,248234,Gilbert Moulin,470293,522059,2022-09-02
CASH_OUT,131839,Gilbert Moulin,522059,390220,Agence_mtn_Ouidah,300000,168161,2022-09-03
TRANSFER,359957,Gilbert Moulin,390220,30263,Marc Costa-Daniel,56868,-303089,2022-09-08
TRANSFER,25670,Gilbert Moulin,30263,4593,Sébastien Coste,190103,164433,2022-09-09
CASH_OUT,843,Gilbert Moulin,4593,3750,Agence_mtn_Abomey,300000,299157,2022-09-09
CASH_IN,198228,Agence_mtn_Cotonou,300000,101772,Gilbert Moulin,3750,201978,2022-09-09
TRANSFER,1048127,Julie Germain Le Vaillant,1605635,557508,Gilbert Moulin,201978,1250105,2022-09-10
CASH_IN,277600,Agence_mtn_Ouidah,300000,22400,Gilbert Moulin,1250105,1527705,2022-09-10
TRANSFER,978757,Gilbert Moulin,1527705,548948,Laurent Marion,959573,-19184,2022-09-10
TRANSFER,261989,Gilbert Moulin,548948,286959,Roger-Roger Delmas,660888,398899,2022-09-11
TRANSFER,146810,Gilbert Moulin,286959,140149,Thibault Martin,339035,192225,2022-09-12
CASH_OUT,114676,Gilbert Moulin,140149,25473,Agence_mtn_Cotonou,300000,185324,2022-09-15
CASH_IN,169971,Agence_mtn_Abomey,300000,130029,Gilbert Moulin,25473,195444,2022-09-17
CASH_OUT,68140,Gilbert Moulin,195444,127304,Agence_mtn_Cotonou,300000,231860,2022-09-17
CASH_OUT,116130,Gilbert Moulin,127304,11174,Agence_mtn_Abomey,300000,183870,2022-09-19
TRANSFER,9548,Gilbert Moulin,11174,1626,Michèle Faivre,12469,2921,2022-09-19
CASH_OUT,1183,Gilbert Moulin,1626,443,Agence_mtn_Cotonou,300000,298817,2022-09-19
CASH_OUT,381,Gilbert Moulin,443,62,Agence_mtn_Ouidah,300000,299619,2022-09-21
CASH_IN,77271,Agence_mtn_Cotonou,300000,222729,Gilbert Moulin,62,77333,2022-09-23
CASH_IN,151021,Agence_mtn_Ouidah,300000,148979,Gilbert Moulin,77333,228354,2022-09-25
CASH_IN,106423,Agence_mtn_Ouidah,300000,193577,Gilbert Moulin,228354,334777,2022-09-26
CASH_OUT,323639,Gilbert Moulin,334777,11138,Agence_mtn_Ouidah,300000,-23639,2022-09-27
CASH_IN,89093,Agence_mtn_Cotonou,300000,210907,Élise Monnier,-61342,27751,2022-09-01
CASH_OUT,3953,Élise Monnier,27751,23798,Agence_mtn_Abomey,300000,296047,2022-09-01
CASH_OUT,19267,Élise Monnier,23798,4531,Agence_mtn_Abomey,300000,280733,2022-09-01
TRANSFER,532684,Emmanuel Vallée,1852500,1319816,Élise Monnier,4531,537215,2022-09-02
TRANSFER,3439,Clémence Dufour,56155,52716,Élise Monnier,537215,540654,2022-09-03
CASH_IN,211173,Agence_mtn_Ouidah,300000,88827,Élise Monnier,540654,751827,2022-09-04
CASH_OUT,221502,Élise Monnier,751827,530325,Agence_mtn_Ouidah,300000,78498,2022-09-05
CASH_IN,297712,Agence_mtn_Cotonou,300000,2288,Élise Monnier,530325,828037,2022-09-05
CASH_IN,282660,Agence_mtn_Abomey,300000,17340,Élise Monnier,828037,1110697,2022-09-07
CASH_OUT,117061,Élise Monnier,1110697,993636,Agence_mtn_Abomey,300000,182939,2022-09-08
TRANSFER,19223,Christophe Besnard-Diaz,36751,17528,Élise Monnier,993636,1012859,2022-09-08
CASH_OUT,280597,Élise Monnier,1012859,732262,Agence_mtn_Abomey,300000,19403,2022-09-12
TRANSFER,109544,Élise Monnier,732262,622718,Hélène Alexandre de la Samson,293000,183456,2022-09-14
TRANSFER,63269,Élise Monnier,622718,559449,Éléonore Marin Le Morel,325521,262252,2022-09-16
TRANSFER,6736,Matthieu Cousin,17180,10444,Élise Monnier,559449,566185,2022-09-16
CASH_OUT,502757,Élise Monnier,566185,63428,Agence_mtn_Ouidah,300000,-202757,2022-09-16
CASH_IN,122047,Agence_mtn_Cotonou,300000,177953,Élise Monnier,63428,185475,2022-09-17
CASH_IN,186264,Agence_mtn_Cotonou,300000,113736,Élise Monnier,185475,371739,2022-09-19
TRANSFER,72787,Élise Monnier,371739,298952,Élise Monnier,371739,298952,2022-09-21
CASH_OUT,287118,Élise Monnier,298952,11834,Agence_mtn_Ouidah,300000,12882,2022-09-22
CASH_OUT,6110,Élise Monnier,11834,5724,Agence_mtn_Cotonou,300000,293890,2022-09-22
TRANSFER,5708,Élise Monnier,5724,16,Emmanuel Legrand,915062,909354,2022-09-22
CASH_IN,173007,Agence_mtn_Ouidah,300000,126993,Élise Monnier,16,173023,2022-09-22
CASH_IN,269251,Agence_mtn_Cotonou,300000,30749,Élise Monnier,173023,442274,2022-09-23
CASH_IN,274581,Agence_mtn_Ouidah,300000,25419,Élise Monnier,442274,716855,2022-09-24
CASH_IN,204844,Agence_mtn_Ouidah,300000,95156,Élise Monnier,716855,921699,2022-09-26
TRANSFER,672476,Élise Monnier,921699,249223,Sylvie Dupré,1278809,606333,2022-09-27
TRANSFER,19119,Charles Guérin,22070,2951,Augustin-Jérôme Merle,169639,188758,2022-09-01
CASH_IN,114339,Agence_mtn_Ouidah,300000,185661,Augustin-Jérôme Merle,188758,303097,2022-09-01
CASH_OUT,24460,Augustin-Jérôme Merle,303097,278637,Agence_mtn_Cotonou,300000,275540,2022-09-01
CASH_OUT,153189,Augustin-Jérôme Merle,278637,125448,Agence_mtn_Abomey,300000,146811,2022-09-02
TRANSFER,21428,Julie Germain Le Vaillant,557508,536080,Augustin-Jérôme Merle,125448,146876,2022-09-05
CASH_OUT,39422,Augustin-Jérôme Merle,146876,107454,Agence_mtn_Cotonou,300000,260578,2022-09-06
TRANSFER,103135,Roger-Roger Delmas,398899,295764,Augustin-Jérôme Merle,107454,210589,2022-09-09
TRANSFER,43016,Zacharie Fabre,437531,394515,Augustin-Jérôme Merle,210589,253605,2022-09-10
TRANSFER,944,Augustin-Jérôme Merle,253605,252661,Sylvie Dupré,606333,605389,2022-09-10
CASH_IN,269392,Agence_mtn_Ouidah,300000,30608,Augustin-Jérôme Merle,252661,522053,2022-09-11
CASH_OUT,454175,Augustin-Jérôme Merle,522053,67878,Agence_mtn_Ouidah,300000,-154175,2022-09-11
CASH_OUT,66120,Augustin-Jérôme Merle,67878,1758,Agence_mtn_Abomey,300000,233880,2022-09-12
CASH_IN,57606,Agence_mtn_Ouidah,300000,242394,Augustin-Jérôme Merle,1758,59364,2022-09-13
CASH_OUT,58283,Augustin-Jérôme Merle,59364,1081,Agence_mtn_Ouidah,300000,241717,2022-09-15
CASH_OUT,705,Augustin-Jérôme Merle,1081,376,Agence_mtn_Cotonou,300000,299295,2022-09-16
TRANSFER,13515,Thibault Martin,192225,178710,Augustin-Jérôme Merle,376,13891,2022-09-17
TRANSFER,491802,Nicole Huet,725900,234098,Augustin-Jérôme Merle,13891,505693,2022-09-18
CASH_IN,263340,Agence_mtn_Ouidah,300000,36660,Augustin-Jérôme Merle,505693,769033,2022-09-18
CASH_IN,70905,Agence_mtn_Ouidah,300000,229095,Augustin-Jérôme Merle,769033,839938,2022-09-18
CASH_OUT,366840,Augustin-Jérôme Merle,839938,473098,Agence_mtn_Abomey,300000,-66840,2022-09-21
CASH_IN,241597,Agence_mtn_Ouidah,300000,58403,Augustin-Jérôme Merle,473098,714695,2022-09-22
CASH_OUT,474389,Augustin-Jérôme Merle,714695,240306,Agence_mtn_Abomey,300000,-174389,2022-09-24
CASH_OUT,1098553,Jean Guilbert-Lenoir,1315997,217444,Agence_mtn_Cotonou,300000,-798553,2022-09-01
CASH_IN,267284,Agence_mtn_Cotonou,300000,32716,Jean Guilbert-Lenoir,217444,484728,2022-09-01
CASH_IN,105298,Agence_mtn_Cotonou,300000,194702,Jean Guilbert-Lenoir,484728,590026,2022-09-02
CASH_OUT,148542,Jean Guilbert-Lenoir,590026,441484,Agence_mtn_Cotonou,300000,151458,2022-09-02
CASH_OUT,433121,Jean Guilbert-Lenoir,441484,8363,Agence_mtn_Ouidah,300000,-133121,2022-09-03
CASH_IN,275307,Agence_mtn_Cotonou,300000,24693,Jean Guilbert-Lenoir,8363,283670,2022-09-04
CASH_OUT,79108,Jean Guilbert-Lenoir,283670,204562,Agence_mtn_Cotonou,300000,220892,2022-09-05
CASH_OUT,115489,Jean Guilbert-Lenoir,204562,89073,Agence_mtn_Ouidah,300000,184511,2022-09-05
CASH_IN,294739,Agence_mtn_Abomey,300000,5261,Jean Guilbert-Lenoir,89073,383812,2022-09-06
CASH_IN,193333,Agence_mtn_Abomey,300000,106667,Jean Guilbert-Lenoir,383812,577145,2022-09-07
TRANSFER,28829,Jean Guilbert-Lenoir,577145,548316,Maurice de Brunet,56369,27540,2022-09-08
CASH_IN,76116,Agence_mtn_Abomey,300000,223884,Jean Guilbert-Lenoir,548316,624432,2022-09-10
CASH_OUT,356060,Jean Guilbert-Lenoir,624432,268372,Agence_mtn_Abomey,300000,-56060,2022-09-10
TRANSFER,591528,Guillaume de la Nguyen,756119,164591,Jean Guilbert-Lenoir,268372,859900,2022-09-10
CASH_IN,101538,Agence_mtn_Ouidah,300000,198462,Jean Guilbert-Lenoir,859900,961438,2022-09-10
CASH_OUT,683897,Jean Guilbert-Lenoir,961438,277541,Agence_mtn_Cotonou,300000,-383897,2022-09-11
CASH_OUT,222686,Jean Guilbert-Lenoir,277541,54855,Agence_mtn_Cotonou,300000,77314,2022-09-11
CASH_IN,250588,Agence_mtn_Cotonou,300000,49412,Jean Guilbert-Lenoir,54855,305443,2022-09-13
TRANSFER,88367,Jean Guilbert-Lenoir,305443,217076,Julie Germain Le Vaillant,536080,447713,2022-09-16
CASH_IN,8189,Agence_mtn_Abomey,300000,291811,Jean Guilbert-Lenoir,217076,225265,2022-09-16
CASH_IN,259305,Agence_mtn_Abomey,300000,40695,Jean Guilbert-Lenoir,225265,484570,2022-09-18
TRANSFER,25880,Nicole-Renée Gay,48118,22238,Jean Guilbert-Lenoir,484570,510450,2022-09-19
TRANSFER,82742,Jean Guilbert-Lenoir,510450,427708,Sébastien Coste,164433,81691,2022-09-19
CASH_IN,85836,Agence_mtn_Cotonou,300000,214164,Jean Guilbert-Lenoir,427708,513544,2022-09-20
CASH_OUT,383825,Jean Guilbert-Lenoir,513544,129719,Agence_mtn_Abomey,300000,-83825,2022-09-22
CASH_OUT,54353,Jean Guilbert-Lenoir,129719,75366,Agence_mtn_Ouidah,300000,245647,2022-09-23
CASH_OUT,63345,Jean Guilbert-Lenoir,75366,12021,Agence_mtn_Abomey,300000,236655,2022-09-25
CASH_OUT,9619,Jean Guilbert-Lenoir,12021,2402,Agence_mtn_Cotonou,300000,290381,2022-09-26
TRANSFER,1743,Jean Guilbert-Lenoir,2402,659,Christophe Teixeira,138993,137250,2022-09-27
CASH_IN,155233,Agence_mtn_Ouidah,300000,144767,Clémence Dufour,52716,207949,2022-09-02
CASH_OUT,36778,Clémence Dufour,207949,171171,Agence_mtn_Cotonou,300000,263222,2022-09-02
TRANSFER,46367,Clémence Dufour,171171,124804,Christophe Teixeira,137250,90883,2022-09-03
CASH_OUT,53642,Clémence Dufour,124804,71162,Agence_mtn_Abomey,300000,246358,2022-09-03
TRANSFER,77283,Madeleine Hardy,1017221,939938,Clémence Dufour,71162,148445,2022-09-04
TRANSFER,47193,Thibault-Julien Chevallier,260592,213399,Clémence Dufour,148445,195638,2022-09-05
TRANSFER,74352,Clémence Dufour,195638,121286,Roger-Roger Delmas,295764,221412,2022-09-05
CASH_IN,294781,Agence_mtn_Ouidah,300000,5219,Clémence Dufour,121286,416067,2022-09-06
CASH_IN,57687,Agence_mtn_Abomey,300000,242313,Clémence Dufour,416067,473754,2022-09-06
CASH_IN,196453,Agence_mtn_Cotonou,300000,103547,Clémence Dufour,473754,670207,2022-09-08
TRANSFER,772,Michèle Faivre,2921,2149,Clémence Dufour,670207,670979,2022-09-08
CASH_OUT,297979,Clémence Dufour,670979,373000,Agence_mtn_Ouidah,300000,2021,2022-09-13
CASH_OUT,260543,Clémence Dufour,373000,112457,Agence_mtn_Ouidah,300000,39457,2022-09-13
CASH_IN,75804,Agence_mtn_Abomey,300000,224196,Clémence Dufour,112457,188261,2022-09-14
CASH_OUT,148257,Clémence Dufour,188261,40004,Agence_mtn_Cotonou,300000,151743,2022-09-16
CASH_OUT,29943,Clémence Dufour,40004,10061,Agence_mtn_Ouidah,300000,270057,2022-09-16
CASH_OUT,7336,Clémence Dufour,10061,2725,Agence_mtn_Ouidah,300000,292664,2022-09-18
TRANSFER,1074719,Valérie-Claudine Marin,1189016,114297,Clémence Dufour,2725,1077444,2022-09-20
CASH_OUT,792703,Clémence Dufour,1077444,284741,Agence_mtn_Abomey,300000,-492703,2022-09-21
TRANSFER,87568,Clémence Dufour,284741,197173,Sylvie Dupré,605389,517821,2022-09-22
CASH_IN,85703,Agence_mtn_Cotonou,300000,214297,Clémence Dufour,197173,282876,2022-09-23
CASH_OUT,75585,Clémence Dufour,282876,207291,Agence_mtn_Ouidah,300000,224415,2022-09-25
CASH_OUT,43985,Clémence Dufour,207291,163306,Agence_mtn_Cotonou,300000,256015,2022-09-25
CASH_IN,32145,Agence_mtn_Cotonou,300000,267855,Clémence Dufour,163306,195451,2022-09-26
CASH_IN,96499,Agence_mtn_Ouidah,300000,203501,Maurice de Brunet,27540,124039,2022-09-01
CASH_OUT,110546,Maurice de Brunet,124039,13493,Agence_mtn_Cotonou,300000,189454,2022-09-02
CASH_IN,290292,Agence_mtn_Cotonou,300000,9708,Maurice de Brunet,13493,303785,2022-09-03
CASH_IN,158778,Agence_mtn_Cotonou,300000,141222,Maurice de Brunet,303785,462563,2022-09-04
CASH_IN,232705,Agence_mtn_Abomey,300000,67295,Maurice de Brunet,462563,695268,2022-09-07
CASH_IN,266852,Agence_mtn_Abomey,300000,33148,Maurice de Brunet,695268,962120,2022-09-07
CASH_OUT,218557,Maurice de Brunet,962120,743563,Agence_mtn_Cotonou,300000,81443,2022-09-07
CASH_OUT,577366,Maurice de Brunet,743563,166197,Agence_mtn_Abomey,300000,-277366,2022-09-07
CASH_IN,91873,Agence_mtn_Abomey,300000,208127,Maurice de Brunet,166197,258070,2022-09-10
CASH_IN,266007,Agence_mtn_Cotonou,300000,33993,Maurice de Brunet,258070,524077,2022-09-10
CASH_OUT,431187,Maurice de Brunet,524077,92890,Agence_mtn_Abomey,300000,-131187,2022-09-10
TRANSFER,36628,Alexandre Delaunay,103100,66472,Maurice de Brunet,92890,129518,2022-09-12
CASH_IN,99303,Agence_mtn_Ouidah,300000,200697,Maurice de Brunet,129518,228821,2022-09-12
TRANSFER,141839,Guillaume de la Nguyen,164591,22752,Maurice de Brunet,228821,370660,2022-09-12
CASH_OUT,13926,Maurice de Brunet,370660,356734,Agence_mtn_Ouidah,300000,286074,2022-09-13
CASH_IN,209253,Agence_mtn_Cotonou,300000,90747,Maurice de Brunet,356734,565987,2022-09-14
CASH_OUT,385251,Maurice de Brunet,565987,180736,Agence_mtn_Ouidah,300000,-85251,2022-09-14
TRANSFER,87685,Maurice de Brunet,180736,93051,Marcel de la Buisson,78651,-9034,2022-09-17
CASH_OUT,72484,Maurice de Brunet,93051,20567,Agence_mtn_Abomey,300000,227516,2022-09-18
CASH_OUT,17441,Maurice de Brunet,20567,3126,Agence_mtn_Ouidah,300000,282559,2022-09-18
CASH_IN,113615,Agence_mtn_Abomey,300000,186385,Maurice de Brunet,3126,116741,2022-09-20
TRANSFER,873970,Maggie Barbier,1018900,144930,Maurice de Brunet,116741,990711,2022-09-22
CASH_OUT,860271,Maurice de Brunet,990711,130440,Agence_mtn_Cotonou,300000,-560271,2022-09-22
CASH_IN,62564,Agence_mtn_Abomey,300000,237436,Maurice de Brunet,130440,193004,2022-09-26
CASH_IN,263279,Agence_mtn_Abomey,300000,36721,Madeleine Hardy,939938,1203217,2022-09-01
CASH_IN,10704,Agence_mtn_Cotonou,300000,289296,Madeleine Hardy,1203217,1213921,2022-09-02
CASH_IN,14224,Agence_mtn_Abomey,300000,285776,Madeleine Hardy,1213921,1228145,2022-09-02
CASH_OUT,629047,Madeleine Hardy,1228145,599098,Agence_mtn_Ouidah,300000,-329047,2022-09-03
CASH_OUT,570926,Madeleine Hardy,599098,28172,Agence_mtn_Cotonou,300000,-270926,2022-09-03
CASH_IN,206971,Agence_mtn_Ouidah,300000,93029,Madeleine Hardy,28172,235143,2022-09-05
CASH_IN,140292,Agence_mtn_Ouidah,300000,159708,Madeleine Hardy,235143,375435,2022-09-05
TRANSFER,325021,Madeleine Hardy,375435,50414,Nathalie Da Silva,28436,-296585,2022-09-09
CASH_OUT,15492,Madeleine Hardy,50414,34922,Agence_mtn_Cotonou,300000,284508,2022-09-10
TRANSFER,32733,Madeleine Hardy,34922,2189,Gabrielle Hamon,18687,-14046,2022-09-11
CASH_IN,204403,Agence_mtn_Ouidah,300000,95597,Madeleine Hardy,2189,206592,2022-09-11
TRANSFER,813328,Emmanuelle Le Allain,1244600,431272,Madeleine Hardy,206592,1019920,2022-09-13
CASH_IN,245140,Agence_mtn_Ouidah,300000,54860,Madeleine Hardy,1019920,1265060,2022-09-14
CASH_IN,287207,Agence_mtn_Abomey,300000,12793,Madeleine Hardy,1265060,1552267,2022-09-15
CASH_IN,237812,Agence_mtn_Cotonou,300000,62188,Madeleine Hardy,1552267,1790079,2022-09-17
CASH_OUT,1667831,Madeleine Hardy,1790079,122248,Agence_mtn_Cotonou,300000,-1367831,2022-09-19
CASH_IN,215070,Agence_mtn_Cotonou,300000,84930,Madeleine Hardy,122248,337318,2022-09-19
TRANSFER,120108,Madeleine Hardy,337318,217210,Valérie-Claudine Marin,114297,-5811,2022-09-19
CASH_IN,98244,Agence_mtn_Cotonou,300000,201756,Madeleine Hardy,217210,315454,2022-09-23
CASH_OUT,84850,Madeleine Hardy,315454,230604,Agence_mtn_Ouidah,300000,215150,2022-09-25
CASH_OUT,6163,Madeleine Hardy,230604,224441,Agence_mtn_Cotonou,300000,293837,2022-09-26
CASH_IN,232172,Agence_mtn_Ouidah,300000,67828,Madeleine Hardy,224441,456613,2022-09-26
CASH_IN,260968,Agence_mtn_Abomey,300000,39032,Madeleine Philippe-Grondin,553277,814245,2022-09-02
CASH_OUT,335901,Madeleine Philippe-Grondin,814245,478344,Agence_mtn_Ouidah,300000,-35901,2022-09-05
CASH_OUT,180926,Madeleine Philippe-Grondin,478344,297418,Agence_mtn_Cotonou,300000,119074,2022-09-05
CASH_IN,214728,Agence_mtn_Cotonou,300000,85272,Madeleine Philippe-Grondin,297418,512146,2022-09-06
CASH_IN,211633,Agence_mtn_Cotonou,300000,88367,Madeleine Philippe-Grondin,512146,723779,2022-09-06
TRANSFER,470496,Madeleine Philippe-Grondin,723779,253283,Alexandre Delaunay,66472,-404024,2022-09-09
CASH_IN,86097,Agence_mtn_Cotonou,300000,213903,Madeleine Philippe-Grondin,253283,339380,2022-09-11
CASH_OUT,235822,Madeleine Philippe-Grondin,339380,103558,Agence_mtn_Ouidah,300000,64178,2022-09-11
CASH_IN,248548,Agence_mtn_Abomey,300000,51452,Madeleine Philippe-Grondin,103558,352106,2022-09-13
CASH_IN,134069,Agence_mtn_Cotonou,300000,165931,Madeleine Philippe-Grondin,352106,486175,2022-09-13
TRANSFER,393521,Madeleine Philippe-Grondin,486175,92654,Zacharie Fabre,394515,994,2022-09-15
TRANSFER,37980,Madeleine Philippe-Grondin,92654,54674,Hélène Alexandre de la Samson,183456,145476,2022-09-17
CASH_OUT,7009,Madeleine Philippe-Grondin,54674,47665,Agence_mtn_Abomey,300000,292991,2022-09-18
CASH_IN,271377,Agence_mtn_Cotonou,300000,28623,Madeleine Philippe-Grondin,47665,319042,2022-09-18
CASH_OUT,228286,Madeleine Philippe-Grondin,319042,90756,Agence_mtn_Abomey,300000,71714,2022-09-21
CASH_IN,145580,Agence_mtn_Cotonou,300000,154420,Madeleine Philippe-Grondin,90756,236336,2022-09-22
CASH_OUT,229386,Madeleine Philippe-Grondin,236336,6950,Agence_mtn_Abomey,300000,70614,2022-09-22
TRANSFER,1964,Madeleine Philippe-Grondin,6950,4986,Roger-Roger Delmas,221412,219448,2022-09-25
TRANSFER,58924,Sébastien Coste,81691,22767,Madeleine Philippe-Grondin,4986,63910,2022-09-26
TRANSFER,460,Nathalie-Claire De Oliveira,1096,636,Madeleine Philippe-Grondin,63910,64370,2022-09-26
CASH_OUT,34105,Madeleine Philippe-Grondin,64370,30265,Agence_mtn_Ouidah,300000,265895,2022-09-27
TRANSFER,12810,Sébastien Coste,22767,9957,Éléonore Marin Le Morel,262252,275062,2022-09-02
CASH_OUT,126599,Éléonore Marin Le Morel,275062,148463,Agence_mtn_Cotonou,300000,173401,2022-09-02
TRANSFER,48279,Maggie Barbier,144930,96651,Éléonore Marin Le Morel,148463,196742,2022-09-02
CASH_OUT,161534,Éléonore Marin Le Morel,196742,35208,Agence_mtn_Abomey,300000,138466,2022-09-04
TRANSFER,625,Nathalie-Claire De Oliveira,636,11,Éléonore Marin Le Morel,35208,35833,2022-09-04
CASH_IN,112711,Agence_mtn_Ouidah,300000,187289,Éléonore Marin Le Morel,35833,148544,2022-09-11
CASH_IN,257372,Agence_mtn_Cotonou,300000,42628,Éléonore Marin Le Morel,148544,405916,2022-09-11
TRANSFER,9116,Nicole-Renée Gay,22238,13122,Éléonore Marin Le Morel,405916,415032,2022-09-12
TRANSFER,71280,Charlotte Perrier,282810,211530,Éléonore Marin Le Morel,415032,486312,2022-09-12
CASH_OUT,352323,Éléonore Marin Le Morel,486312,133989,Agence_mtn_Abomey,300000,-52323,2022-09-12
TRANSFER,70689,Éléonore Marin Le Morel,133989,63300,Martin Moreau,32846,-37843,2022-09-12
CASH_IN,71512,Agence_mtn_Abomey,300000,228488,Éléonore Marin Le Morel,63300,134812,2022-09-12
CASH_OUT,11519,Éléonore Marin Le Morel,134812,123293,Agence_mtn_Cotonou,300000,288481,2022-09-14
TRANSFER,14542,Éléonore Marin Le Morel,123293,108751,Louis du Boyer,1180700,1166158,2022-09-14
CASH_IN,26651,Agence_mtn_Cotonou,300000,273349,Éléonore Marin Le Morel,108751,135402,2022-09-15
CASH_OUT,102775,Éléonore Marin Le Morel,135402,32627,Agence_mtn_Cotonou,300000,197225,2022-09-16
TRANSFER,13716,Éléonore Marin Le Morel,32627,18911,Gérard Cordier,178734,165018,2022-09-17
CASH_IN,239798,Agence_mtn_Ouidah,300000,60202,Éléonore Marin Le Morel,18911,258709,2022-09-18
CASH_IN,1480,Agence_mtn_Ouidah,300000,298520,Éléonore Marin Le Morel,258709,260189,2022-09-19
TRANSFER,11006,Éléonore Marin Le Morel,260189,249183,Emmanuel Vallée,1319816,1308810,2022-09-19
TRANSFER,128227,Éléonore Marin Le Morel,249183,120956,Michèle Faivre,2149,-126078,2022-09-19
CASH_IN,281670,Agence_mtn_Ouidah,300000,18330,Éléonore Marin Le Morel,120956,402626,2022-09-19
CASH_OUT,382591,Éléonore Marin Le Morel,402626,20035,Agence_mtn_Abomey,300000,-82591,2022-09-25
TRANSFER,169444,Thibault-Julien Chevallier,213399,43955,Éléonore Marin Le Morel,20035,189479,2022-09-25
TRANSFER,154794,Éléonore Marin Le Morel,189479,34685,Nicole Huet,234098,79304,2022-09-26
TRANSFER,5328,Éléonore Marin Le Morel,34685,29357,Jacques Marchand,734100,728772,2022-09-26
CASH_IN,214159,Agence_mtn_Ouidah,300000,85841,Alexandre Delaunay,-404024,-189865,2022-09-02
CASH_IN,130404,Agence_mtn_Abomey,300000,169596,Alexandre Delaunay,-189865,-59461,2022-09-02
CASH_IN,137548,Agence_mtn_Abomey,300000,162452,Alexandre Delaunay,-59461,78087,2022-09-04
CASH_IN,156940,Agence_mtn_Abomey,300000,143060,Alexandre Delaunay,78087,235027,2022-09-04
CASH_IN,221076,Agence_mtn_Cotonou,300000,78924,Alexandre Delaunay,235027,456103,2022-09-05
TRANSFER,84877,Alexandre Delaunay,456103,371226,Guillaume de la Nguyen,22752,-62125,2022-09-07
CASH_IN,110572,Agence_mtn_Abomey,300000,189428,Alexandre Delaunay,371226,481798,2022-09-07
CASH_OUT,448070,Alexandre Delaunay,481798,33728,Agence_mtn_Abomey,300000,-148070,2022-09-07
CASH_OUT,17479,Alexandre Delaunay,33728,16249,Agence_mtn_Abomey,300000,282521,2022-09-09
TRANSFER,661719,Marc Baudry,1244039,582320,Alexandre Delaunay,16249,677968,2022-09-11
TRANSFER,414362,Alexandre Delaunay,677968,263606,Nicole-Renée Gay,13122,-401240,2022-09-13
CASH_OUT,74661,Alexandre Delaunay,263606,188945,Agence_mtn_Ouidah,300000,225339,2022-09-17
CASH_OUT,150065,Alexandre Delaunay,188945,38880,Agence_mtn_Ouidah,300000,149935,2022-09-17
CASH_IN,24118,Agence_mtn_Cotonou,300000,275882,Alexandre Delaunay,38880,62998,2022-09-18
TRANSFER,48547,Maggie Barbier,96651,48104,Alexandre Delaunay,62998,111545,2022-09-19
TRANSFER,2324,Hélène Alexandre de la Samson,145476,143152,Alexandre Delaunay,111545,113869,2022-09-19
CASH_OUT,7716,Alexandre Delaunay,113869,106153,Agence_mtn_Cotonou,300000,292284,2022-09-19
TRANSFER,555,Sébastien Coste,9957,9402,Alexandre Delaunay,106153,106708,2022-09-20
CASH_IN,263355,Agence_mtn_Abomey,300000,36645,Alexandre Delaunay,106708,370063,2022-09-23
TRANSFER,305657,Alexandre Delaunay,370063,64406,Louis du Boyer,1166158,860501,2022-09-23
CASH_OUT,42853,Alexandre Delaunay,64406,21553,Agence_mtn_Cotonou,300000,257147,2022-09-23
CASH_IN,192065,Agence_mtn_Ouidah,300000,107935,Alexandre Delaunay,21553,213618,2022-09-24
CASH_IN,289936,Agence_mtn_Abomey,300000,10064,Alexandre Delaunay,213618,503554,2022-09-25
CASH_IN,167339,Agence_mtn_Cotonou,300000,132661,Alexandre Delaunay,503554,670893,2022-09-25
TRANSFER,135785,Jacques Marchand,728772,592987,Alexandre Delaunay,670893,806678,2022-09-27
TRANSFER,416579,Alexandre Delaunay,806678,390099,Christophe Teixeira,90883,-325696,2022-09-27
CASH_IN,179005,Agence_mtn_Cotonou,300000,120995,Simone du Allard,-111004,68001,2022-09-02
TRANSFER,9184,Sébastien Coste,9402,218,Simone du Allard,68001,77185,2022-09-02
TRANSFER,5037,Simone du Allard,77185,72148,Emmanuelle Le Allain,431272,426235,2022-09-04
TRANSFER,433683,Julie Germain Le Vaillant,447713,14030,Simone du Allard,72148,505831,2022-09-05
TRANSFER,141444,Simone du Allard,505831,364387,Julie Germain Le Vaillant,14030,-127414,2022-09-05
CASH_OUT,18407,Simone du Allard,364387,345980,Agence_mtn_Ouidah,300000,281593,2022-09-06
CASH_IN,249136,Agence_mtn_Abomey,300000,50864,Simone du Allard,345980,595116,2022-09-06
CASH_IN,139489,Agence_mtn_Abomey,300000,160511,Simone du Allard,595116,734605,2022-09-07
TRANSFER,182628,Simone du Allard,734605,551977,Margot Julien,569296,386668,2022-09-07
CASH_IN,270479,Agence_mtn_Ouidah,300000,29521,Simone du Allard,551977,822456,2022-09-10
CASH_IN,50845,Agence_mtn_Ouidah,300000,249155,Simone du Allard,822456,873301,2022-09-11
CASH_OUT,757049,Simone du Allard,873301,116252,Agence_mtn_Abomey,300000,-457049,2022-09-11
TRANSFER,779676,Guy-Augustin Pinto,1342688,563012,Simone du Allard,116252,895928,2022-09-13
CASH_IN,171618,Agence_mtn_Ouidah,300000,128382,Simone du Allard,895928,1067546,2022-09-13
CASH_OUT,825144,Simone du Allard,1067546,242402,Agence_mtn_Cotonou,300000,-525144,2022-09-15
CASH_OUT,198528,Simone du Allard,242402,43874,Agence_mtn_Cotonou,300000,101472,2022-09-17
CASH_OUT,41483,Simone du Allard,43874,2391,Agence_mtn_Cotonou,300000,258517,2022-09-17
CASH_IN,234149,Agence_mtn_Cotonou,300000,65851,Simone du Allard,2391,236540,2022-09-18
CASH_OUT,213759,Simone du Allard,236540,22781,Agence_mtn_Cotonou,300000,86241,2022-09-19
TRANSFER,13283,Simone du Allard,22781,9498,Charles Guérin,2951,-10332,2022-09-19
TRANSFER,152736,Guy-Augustin Pinto,563012,410276,Simone du Allard,9498,162234,2022-09-21
TRANSFER,725401,Maryse Delorme,889700,164299,Simone du Allard,162234,887635,2022-09-21
CASH_IN,267398,Agence_mtn_Ouidah,300000,32602,Simone du Allard,887635,1155033,2022-09-23
CASH_OUT,437217,Simone du Allard,1155033,717816,Agence_mtn_Cotonou,300000,-137217,2022-09-24
CASH_IN,103336,Agence_mtn_Ouidah,300000,196664,Simone du Allard,717816,821152,2022-09-24
CASH_OUT,230607,Simone du Allard,821152,590545,Agence_mtn_Cotonou,300000,69393,2022-09-25
CASH_IN,118698,Agence_mtn_Cotonou,300000,181302,Simone du Allard,590545,709243,2022-09-26
CASH_OUT,101757,Simone du Allard,709243,607486,Agence_mtn_Abomey,300000,198243,2022-09-27
TRANSFER,119720,Simone du Allard,607486,487766,Roland Huet,1945800,1826080,2022-09-27
CASH_IN,36039,Agence_mtn_Ouidah,300000,263961,Charles Guérin,-10332,25707,2022-09-01
CASH_OUT,19622,Charles Guérin,25707,6085,Agence_mtn_Cotonou,300000,280378,2022-09-01
TRANSFER,22544,Maggie Barbier,48104,25560,Charles Guérin,6085,28629,2022-09-03
CASH_IN,299076,Agence_mtn_Cotonou,300000,924,Charles Guérin,28629,327705,2022-09-03
CASH_IN,165093,Agence_mtn_Ouidah,300000,134907,Charles Guérin,327705,492798,2022-09-05
CASH_OUT,485727,Charles Guérin,492798,7071,Agence_mtn_Cotonou,300000,-185727,2022-09-05
CASH_OUT,2178,Charles Guérin,7071,4893,Agence_mtn_Abomey,300000,297822,2022-09-08
CASH_OUT,649,Charles Guérin,4893,4244,Agence_mtn_Abomey,300000,299351,2022-09-09
TRANSFER,352362,Aimé Bernier,356400,4038,Charles Guérin,4244,356606,2022-09-10
CASH_OUT,269698,Charles Guérin,356606,86908,Agence_mtn_Ouidah,300000,30302,2022-09-12
CASH_OUT,3101,Charles Guérin,86908,83807,Agence_mtn_Ouidah,300000,296899,2022-09-12
TRANSFER,44036,Charles Guérin,83807,39771,Roger-Roger Delmas,219448,175412,2022-09-14
CASH_IN,43192,Agence_mtn_Abomey,300000,256808,Charles Guérin,39771,82963,2022-09-14
TRANSFER,127750,Hélène Alexandre de la Samson,143152,15402,Charles Guérin,82963,210713,2022-09-14
CASH_OUT,172791,Charles Guérin,210713,37922,Agence_mtn_Abomey,300000,127209,2022-09-17
CASH_OUT,5149,Charles Guérin,37922,32773,Agence_mtn_Ouidah,300000,294851,2022-09-17
TRANSFER,58979,Emmanuel Legrand,909354,850375,Charles Guérin,32773,91752,2022-09-18
TRANSFER,156756,François Vaillant,618200,461444,Charles Guérin,91752,248508,2022-09-18
CASH_OUT,62388,Charles Guérin,248508,186120,Agence_mtn_Ouidah,300000,237612,2022-09-20
CASH_OUT,74745,Charles Guérin,186120,111375,Agence_mtn_Ouidah,300000,225255,2022-09-21
CASH_OUT,82180,Charles Guérin,111375,29195,Agence_mtn_Cotonou,300000,217820,2022-09-22
CASH_OUT,7904,Charles Guérin,29195,21291,Agence_mtn_Cotonou,300000,292096,2022-09-23
CASH_IN,124300,Agence_mtn_Ouidah,300000,175700,Charles Guérin,21291,145591,2022-09-24
CASH_OUT,108422,Charles Guérin,145591,37169,Agence_mtn_Cotonou,300000,191578,2022-09-25
CASH_OUT,1515,Charles Guérin,37169,35654,Agence_mtn_Abomey,300000,298485,2022-09-25
TRANSFER,12769,Charles Guérin,35654,22885,Aimé Bernier,4038,-8731,2022-09-25
TRANSFER,40305,Nicole Huet,79304,38999,Charles Guérin,22885,63190,2022-09-26
CASH_IN,151712,Agence_mtn_Cotonou,300000,148288,Charles Guérin,63190,214902,2022-09-27
CASH_IN,20190,Agence_mtn_Ouidah,300000,279810,Georges Muller,-1150143,-1129953,2022-09-02
CASH_IN,286257,Agence_mtn_Abomey,300000,13743,Georges Muller,-1129953,-843696,2022-09-03
CASH_IN,269618,Agence_mtn_Abomey,300000,30382,Georges Muller,-843696,-574078,2022-09-03
CASH_IN,168244,Agence_mtn_Abomey,300000,131756,Georges Muller,-574078,-405834,2022-09-03
CASH_IN,80103,Agence_mtn_Abomey,300000,219897,Georges Muller,-405834,-325731,2022-09-05
CASH_IN,158317,Agence_mtn_Abomey,300000,141683,Georges Muller,-325731,-167414,2022-09-07
CASH_IN,35149,Agence_mtn_Abomey,300000,264851,Georges Muller,-167414,-132265,2022-09-08
CASH_IN,299916,Agence_mtn_Ouidah,300000,84,Georges Muller,-132265,167651,2022-09-09
CASH_OUT,75711,Georges Muller,167651,91940,Agence_mtn_Ouidah,300000,224289,2022-09-09
CASH_IN,166982,Agence_mtn_Cotonou,300000,133018,Georges Muller,91940,258922,2022-09-10
CASH_OUT,100722,Georges Muller,258922,158200,Agence_mtn_Cotonou,300000,199278,2022-09-10
TRANSFER,55232,Georges Muller,158200,102968,Maryse Delorme,164299,109067,2022-09-10
CASH_OUT,67933,Georges Muller,102968,35035,Agence_mtn_Abomey,300000,232067,2022-09-14
CASH_OUT,13600,Georges Muller,35035,21435,Agence_mtn_Cotonou,300000,286400,2022-09-15
CASH_OUT,6112,Georges Muller,21435,15323,Agence_mtn_Cotonou,300000,293888,2022-09-16
CASH_IN,292368,Agence_mtn_Cotonou,300000,7632,Georges Muller,15323,307691,2022-09-17
CASH_IN,257030,Agence_mtn_Abomey,300000,42970,Georges Muller,307691,564721,2022-09-17
CASH_OUT,469872,Georges Muller,564721,94849,Agence_mtn_Abomey,300000,-169872,2022-09-18
CASH_IN,226205,Agence_mtn_Cotonou,300000,73795,Georges Muller,94849,321054,2022-09-18
CASH_OUT,197645,Georges Muller,321054,123409,Agence_mtn_Ouidah,300000,102355,2022-09-19
TRANSFER,1487393,Roland Huet,1826080,338687,Georges Muller,123409,1610802,2022-09-20
TRANSFER,147834,Roger-Roger Delmas,175412,27578,Georges Muller,1610802,1758636,2022-09-21
CASH_OUT,1429411,Georges Muller,1758636,329225,Agence_mtn_Ouidah,300000,-1129411,2022-09-21
CASH_IN,235748,Agence_mtn_Cotonou,300000,64252,Georges Muller,329225,564973,2022-09-22
CASH_IN,149501,Agence_mtn_Abomey,300000,150499,Georges Muller,564973,714474,2022-09-23
CASH_OUT,218718,Georges Muller,714474,495756,Agence_mtn_Cotonou,300000,81282,2022-09-25
CASH_OUT,231561,Georges Muller,495756,264195,Agence_mtn_Abomey,300000,68439,2022-09-25
TRANSFER,226967,Georges Muller,264195,37228,Gérard Cordier,165018,-61949,2022-09-26
CASH_OUT,31526,Georges Muller,37228,5702,Agence_mtn_Abomey,300000,268474,2022-09-26
CASH_IN,231957,Agence_mtn_Ouidah,300000,68043,Georges Muller,5702,237659,2022-09-26
CASH_OUT,216,Sébastien Coste,218,2,Agence_mtn_Cotonou,300000,299784,2022-09-03
CASH_IN,223833,Agence_mtn_Abomey,300000,76167,Sébastien Coste,2,223835,2022-09-04
CASH_IN,49831,Agence_mtn_Ouidah,300000,250169,Sébastien Coste,223835,273666,2022-09-07
CASH_OUT,20510,Sébastien Coste,273666,253156,Agence_mtn_Abomey,300000,279490,2022-09-07
CASH_IN,197456,Agence_mtn_Abomey,300000,102544,Sébastien Coste,253156,450612,2022-09-11
TRANSFER,377138,Sylvie Dupré,517821,140683,Sébastien Coste,450612,827750,2022-09-12
CASH_OUT,665465,Sébastien Coste,827750,162285,Agence_mtn_Abomey,300000,-365465,2022-09-16
TRANSFER,102040,Sébastien Coste,162285,60245,Jacques Marchand,592987,490947,2022-09-16
CASH_IN,205912,Agence_mtn_Abomey,300000,94088,Sébastien Coste,60245,266157,2022-09-17
CASH_OUT,75345,Sébastien Coste,266157,190812,Agence_mtn_Abomey,300000,224655,2022-09-17
TRANSFER,1193563,Honoré de la Prévost,1411000,217437,Sébastien Coste,190812,1384375,2022-09-19
CASH_OUT,1194335,Sébastien Coste,1384375,190040,Agence_mtn_Abomey,300000,-894335,2022-09-21
TRANSFER,16187,Sylvie Dupré,140683,124496,Sébastien Coste,190040,206227,2022-09-22
CASH_IN,217748,Agence_mtn_Cotonou,300000,82252,Sébastien Coste,206227,423975,2022-09-22
CASH_IN,230530,Agence_mtn_Cotonou,300000,69470,Sébastien Coste,423975,654505,2022-09-23
CASH_IN,46469,Agence_mtn_Ouidah,300000,253531,Sébastien Coste,654505,700974,2022-09-24
TRANSFER,35169,Sébastien Coste,700974,665805,Marc Baudry,582320,547151,2022-09-25
TRANSFER,337621,Sébastien Coste,665805,328184,Nicolas Blin,1476077,1138456,2022-09-27
CASH_IN,224846,Agence_mtn_Abomey,300000,75154,Sébastien Coste,328184,553030,2022-09-27
TRANSFER,312563,Sébastien Coste,553030,240467,Margot Julien,386668,74105,2022-09-27
TRANSFER,198290,Jacques Marchand,490947,292657,Sébastien Coste,240467,438757,2022-09-27
TRANSFER,376679,Sébastien Coste,438757,62078,Françoise Denis de Allard,876166,499487,2022-09-27
CASH_IN,184325,Agence_mtn_Abomey,300000,115675,Aimé Bernier,-8731,175594,2022-09-01
CASH_OUT,138497,Aimé Bernier,175594,37097,Agence_mtn_Cotonou,300000,161503,2022-09-04
CASH_IN,278377,Agence_mtn_Ouidah,300000,21623,Aimé Bernier,37097,315474,2022-09-08
CASH_IN,299966,Agence_mtn_Cotonou,300000,34,Aimé Bernier,315474,615440,2022-09-10
CASH_IN,22433,Agence_mtn_Ouidah,300000,277567,Aimé Bernier,615440,637873,2022-09-12
CASH_IN,142110,Agence_mtn_Abomey,300000,157890,Aimé Bernier,637873,779983,2022-09-12
CASH_IN,142503,Agence_mtn_Cotonou,300000,157497,Aimé Bernier,779983,922486,2022-09-13
CASH_IN,167947,Agence_mtn_Cotonou,300000,132053,Aimé Bernier,922486,1090433,2022-09-14
TRANSFER,620692,Aimé Bernier,1090433,469741,Sylvie Dupré,124496,-496196,2022-09-15
TRANSFER,10201,Thibault-Julien Chevallier,43955,33754,Aimé Bernier,469741,479942,2022-09-16
CASH_IN,255809,Agence_mtn_Abomey,300000,44191,Aimé Bernier,479942,735751,2022-09-20
CASH_OUT,708272,Aimé Bernier,735751,27479,Agence_mtn_Abomey,300000,-408272,2022-09-20
TRANSFER,12413,Aimé Bernier,27479,15066,Thibault Martin,178710,166297,2022-09-20
TRANSFER,9120,Aimé Bernier,15066,5946,Matthieu Cousin,10444,1324,2022-09-20
TRANSFER,630,Aimé Bernier,5946,5316,Roger-Roger Delmas,27578,26948,2022-09-20
CASH_IN,116258,Agence_mtn_Ouidah,300000,183742,Aimé Bernier,5316,121574,2022-09-21
TRANSFER,47126,Aimé Bernier,121574,74448,Margot Julien,74105,26979,2022-09-22
TRANSFER,525597,Marthe Perrin,1448200,922603,Aimé Bernier,74448,600045,2022-09-23
CASH_OUT,534457,Aimé Bernier,600045,65588,Agence_mtn_Abomey,300000,-234457,2022-09-25
CASH_OUT,12836,Aimé Bernier,65588,52752,Agence_mtn_Abomey,300000,287164,2022-09-27
CASH_OUT,17808,Nicole Huet,38999,21191,Agence_mtn_Cotonou,300000,282192,2022-09-02
CASH_IN,208778,Agence_mtn_Abomey,300000,91222,Nicole Huet,21191,229969,2022-09-07
TRANSFER,19551,Margot Julien,26979,7428,Nicole Huet,229969,249520,2022-09-07
CASH_OUT,37140,Nicole Huet,249520,212380,Agence_mtn_Cotonou,300000,262860,2022-09-09
CASH_IN,269571,Agence_mtn_Cotonou,300000,30429,Nicole Huet,212380,481951,2022-09-11
CASH_OUT,203567,Nicole Huet,481951,278384,Agence_mtn_Abomey,300000,96433,2022-09-11
CASH_OUT,180910,Nicole Huet,278384,97474,Agence_mtn_Abomey,300000,119090,2022-09-13
CASH_IN,177699,Agence_mtn_Ouidah,300000,122301,Nicole Huet,97474,275173,2022-09-15
CASH_OUT,221622,Nicole Huet,275173,53551,Agence_mtn_Abomey,300000,78378,2022-09-20
CASH_OUT,35253,Nicole Huet,53551,18298,Agence_mtn_Cotonou,300000,264747,2022-09-24
TRANSFER,6565,Nicole Huet,18298,11733,François Vaillant,461444,454879,2022-09-26
CASH_IN,221799,Agence_mtn_Ouidah,300000,78201,Nicole Huet,11733,233532,2022-09-27
CASH_IN,290911,Agence_mtn_Ouidah,300000,9089,Michèle Faivre,-126078,164833,2022-09-01
TRANSFER,207473,Roland Huet,338687,131214,Michèle Faivre,164833,372306,2022-09-05
CASH_IN,174670,Agence_mtn_Cotonou,300000,125330,Michèle Faivre,372306,546976,2022-09-11
CASH_OUT,65308,Michèle Faivre,546976,481668,Agence_mtn_Ouidah,300000,234692,2022-09-12
CASH_OUT,288094,Michèle Faivre,481668,193574,Agence_mtn_Ouidah,300000,11906,2022-09-18
CASH_OUT,53301,Michèle Faivre,193574,140273,Agence_mtn_Cotonou,300000,246699,2022-09-18
TRANSFER,27131,Michèle Faivre,140273,113142,Michèle Faivre,140273,167404,2022-09-19
CASH_OUT,55336,Michèle Faivre,113142,57806,Agence_mtn_Cotonou,300000,244664,2022-09-19
TRANSFER,135401,Marc Baudry,547151,411750,Michèle Faivre,57806,193207,2022-09-19
TRANSFER,81453,Michèle Faivre,193207,111754,Hélène Blanchard-Renault,1119600,1038147,2022-09-20
CASH_IN,107091,Agence_mtn_Ouidah,300000,192909,Michèle Faivre,111754,218845,2022-09-22
CASH_IN,42304,Agence_mtn_Abomey,300000,257696,Michèle Faivre,218845,261149,2022-09-22
CASH_OUT,119261,Michèle Faivre,261149,141888,Agence_mtn_Cotonou,300000,180739,2022-09-23
TRANSFER,260487,Emmanuelle Le Allain,426235,165748,Michèle Faivre,141888,402375,2022-09-24
CASH_OUT,43262,Michèle Faivre,402375,359113,Agence_mtn_Abomey,300000,256738,2022-09-24
TRANSFER,212171,Michèle Faivre,359113,146942,Roger-Roger Delmas,26948,-185223,2022-09-25
TRANSFER,96221,Michèle Faivre,146942,50721,Nicolas Blin,1138456,1042235,2022-09-26
CASH_OUT,43494,Michèle Faivre,50721,7227,Agence_mtn_Cotonou,300000,256506,2022-09-27
TRANSFER,744,Christophe Besnard-Diaz,17528,16784,François Vaillant,454879,454135,2022-09-03
TRANSFER,10706,Christophe Besnard-Diaz,16784,6078,Marc Baudry,411750,401044,2022-09-09
CASH_IN,78924,Agence_mtn_Ouidah,300000,221076,Christophe Besnard-Diaz,6078,85002,2022-09-10
CASH_IN,260172,Agence_mtn_Cotonou,300000,39828,Christophe Besnard-Diaz,85002,345174,2022-09-11
CASH_OUT,26833,Christophe Besnard-Diaz,345174,318341,Agence_mtn_Cotonou,300000,273167,2022-09-23
CASH_OUT,5913,Christophe Besnard-Diaz,318341,312428,Agence_mtn_Abomey,300000,294087,2022-09-24
CASH_IN,275744,Agence_mtn_Abomey,300000,24256,Christophe Besnard-Diaz,312428,588172,2022-09-25
TRANSFER,217772,Françoise Denis de Allard,499487,281715,Maryse Delorme,109067,-108705,2022-09-05
CASH_IN,273974,Agence_mtn_Cotonou,300000,26026,Françoise Denis de Allard,281715,555689,2022-09-07
CASH_IN,192253,Agence_mtn_Ouidah,300000,107747,Françoise Denis de Allard,555689,747942,2022-09-16
CASH_IN,80860,Agence_mtn_Abomey,300000,219140,Françoise Denis de Allard,747942,828802,2022-09-20
CASH_OUT,804736,Françoise Denis de Allard,828802,24066,Agence_mtn_Cotonou,300000,-504736,2022-09-20
TRANSFER,3362,Françoise Denis de Allard,24066,20704,Matthieu Cousin,1324,-2038,2022-09-24
CASH_OUT,5378,Françoise Denis de Allard,20704,15326,Agence_mtn_Cotonou,300000,294622,2022-09-26
CASH_IN,52144,Agence_mtn_Ouidah,300000,247856,Nicolas Blin,1042235,1094379,2022-09-03
CASH_OUT,677607,Nicolas Blin,1094379,416772,Agence_mtn_Cotonou,300000,-377607,2022-09-04
CASH_OUT,193590,Nicolas Blin,416772,223182,Agence_mtn_Ouidah,300000,106410,2022-09-04
CASH_IN,185462,Agence_mtn_Cotonou,300000,114538,Nicolas Blin,223182,408644,2022-09-04
CASH_IN,75580,Agence_mtn_Cotonou,300000,224420,Nicolas Blin,408644,484224,2022-09-05
CASH_OUT,298202,Nicolas Blin,484224,186022,Agence_mtn_Ouidah,300000,1798,2022-09-08
TRANSFER,70125,Nicolas Blin,186022,115897,Maggie Barbier,25560,-44565,2022-09-09
TRANSFER,280333,Guy-Augustin Pinto,410276,129943,Nicolas Blin,115897,396230,2022-09-13
CASH_IN,20483,Agence_mtn_Abomey,300000,279517,Nicolas Blin,396230,416713,2022-09-14
CASH_IN,192266,Agence_mtn_Ouidah,300000,107734,Nicolas Blin,416713,608979,2022-09-15
TRANSFER,64253,Jacques Marchand,292657,228404,Nicolas Blin,608979,673232,2022-09-16
CASH_OUT,493634,Nicolas Blin,673232,179598,Agence_mtn_Abomey,300000,-193634,2022-09-21
CASH_OUT,116007,Nicolas Blin,179598,63591,Agence_mtn_Ouidah,300000,183993,2022-09-22
CASH_IN,1705,Agence_mtn_Abomey,300000,298295,Nicolas Blin,63591,65296,2022-09-24
CASH_OUT,54131,Nicolas Blin,65296,11165,Agence_mtn_Cotonou,300000,245869,2022-09-24
CASH_OUT,4494,Nicolas Blin,11165,6671,Agence_mtn_Ouidah,300000,295506,2022-09-26
CASH_OUT,2854,Nicolas Blin,6671,3817,Agence_mtn_Cotonou,300000,297146,2022-09-27
CASH_IN,108626,Agence_mtn_Abomey,300000,191374,Nicolas Blin,3817,112443,2022-09-27
CASH_IN,80758,Agence_mtn_Ouidah,300000,219242,Louis du Boyer,860501,941259,2022-09-01
CASH_OUT,824693,Louis du Boyer,941259,116566,Agence_mtn_Abomey,300000,-524693,2022-09-02
TRANSFER,1373290,Henri de Didier,1632100,258810,Louis du Boyer,116566,1489856,2022-09-02
CASH_IN,193835,Agence_mtn_Ouidah,300000,106165,Louis du Boyer,1489856,1683691,2022-09-04
CASH_OUT,274048,Louis du Boyer,1683691,1409643,Agence_mtn_Ouidah,300000,25952,2022-09-04
TRANSFER,1231478,Louis du Boyer,1409643,178165,Thibault Martin,166297,-1065181,2022-09-05
TRANSFER,5618,Louis du Boyer,178165,172547,François Vaillant,454135,448517,2022-09-05
CASH_IN,113695,Agence_mtn_Ouidah,300000,186305,Louis du Boyer,172547,286242,2022-09-17
CASH_OUT,26889,Louis du Boyer,286242,259353,Agence_mtn_Ouidah,300000,273111,2022-09-18
CASH_IN,19488,Agence_mtn_Abomey,300000,280512,Louis du Boyer,259353,278841,2022-09-19
CASH_IN,2073,Agence_mtn_Cotonou,300000,297927,Louis du Boyer,278841,280914,2022-09-22
CASH_OUT,86206,Louis du Boyer,280914,194708,Agence_mtn_Abomey,300000,213794,2022-09-22
TRANSFER,100726,Louis du Boyer,194708,93982,Jacques Marchand,228404,127678,2022-09-23
CASH_OUT,83140,Louis du Boyer,93982,10842,Agence_mtn_Ouidah,300000,216860,2022-09-24
CASH_OUT,9623,Louis du Boyer,10842,1219,Agence_mtn_Cotonou,300000,290377,2022-09-25
CASH_IN,231694,Agence_mtn_Cotonou,300000,68306,Louis du Boyer,1219,232913,2022-09-27
TRANSFER,139518,Louis du Boyer,232913,93395,Guy-Augustin Pinto,129943,-9575,2022-09-27
CASH_IN,114191,Agence_mtn_Abomey,300000,185809,Maggie Barbier,-44565,69626,2022-09-01
CASH_IN,233057,Agence_mtn_Cotonou,300000,66943,Maggie Barbier,69626,302683,2022-09-01
CASH_OUT,190213,Maggie Barbier,302683,112470,Agence_mtn_Abomey,300000,109787,2022-09-04
TRANSFER,254708,Henri de Didier,258810,4102,Maggie Barbier,112470,367178,2022-09-05
CASH_IN,69821,Agence_mtn_Cotonou,300000,230179,Maggie Barbier,367178,436999,2022-09-07
TRANSFER,394223,Maggie Barbier,436999,42776,Maggie Barbier,436999,831222,2022-09-09
TRANSFER,102707,Honoré de la Prévost,217437,114730,Maggie Barbier,42776,145483,2022-09-14
TRANSFER,6915,Margot Julien,7428,513,Maggie Barbier,145483,152398,2022-09-15
TRANSFER,91815,Maggie Barbier,152398,60583,Emmanuel Vallée,1308810,1216995,2022-09-15
CASH_IN,226320,Agence_mtn_Ouidah,300000,73680,Maggie Barbier,60583,286903,2022-09-15
CASH_IN,137502,Agence_mtn_Abomey,300000,162498,Maggie Barbier,286903,424405,2022-09-17
CASH_OUT,389055,Maggie Barbier,424405,35350,Agence_mtn_Cotonou,300000,-89055,2022-09-19
CASH_IN,35506,Agence_mtn_Cotonou,300000,264494,Maggie Barbier,35350,70856,2022-09-19
CASH_IN,262078,Agence_mtn_Abomey,300000,37922,Maggie Barbier,70856,332934,2022-09-20
CASH_IN,147633,Agence_mtn_Abomey,300000,152367,Maggie Barbier,332934,480567,2022-09-21
CASH_IN,212443,Agence_mtn_Cotonou,300000,87557,Maggie Barbier,480567,693010,2022-09-22
TRANSFER,17658,Maggie Barbier,693010,675352,Thibault-Julien Chevallier,33754,16096,2022-09-23
CASH_IN,120098,Agence_mtn_Cotonou,300000,179902,Maggie Barbier,675352,795450,2022-09-26
TRANSFER,348111,Hélène Blanchard-Renault,1038147,690036,Maggie Barbier,795450,1143561,2022-09-26
CASH_OUT,28309,Jacques Marchand,127678,99369,Agence_mtn_Cotonou,300000,271691,2022-09-03
TRANSFER,46900,Jacques Marchand,99369,52469,Hélène Alexandre de la Samson,15402,-31498,2022-09-09
TRANSFER,77623,Emmanuelle Le Allain,165748,88125,Jacques Marchand,52469,130092,2022-09-10
TRANSFER,90477,Jacques Marchand,130092,39615,Emmanuelle Le Allain,88125,-2352,2022-09-10
CASH_OUT,31298,Jacques Marchand,39615,8317,Agence_mtn_Cotonou,300000,268702,2022-09-12
TRANSFER,2229,Jacques Marchand,8317,6088,Jacques Marchand,8317,6088,2022-09-14
CASH_IN,196975,Agence_mtn_Abomey,300000,103025,Jacques Marchand,6088,203063,2022-09-15
TRANSFER,171388,Hélène Blanchard-Renault,690036,518648,Jacques Marchand,203063,374451,2022-09-16
CASH_OUT,77351,Jacques Marchand,374451,297100,Agence_mtn_Abomey,300000,222649,2022-09-16
CASH_IN,286222,Agence_mtn_Ouidah,300000,13778,Jacques Marchand,297100,583322,2022-09-18
TRANSFER,351539,Jacques Marchand,583322,231783,Emmanuel Vallée,1216995,865456,2022-09-18
CASH_OUT,13561,Jacques Marchand,231783,218222,Agence_mtn_Cotonou,300000,286439,2022-09-18
CASH_IN,4936,Agence_mtn_Cotonou,300000,295064,Jacques Marchand,218222,223158,2022-09-18
CASH_IN,84088,Agence_mtn_Cotonou,300000,215912,Jacques Marchand,223158,307246,2022-09-20
TRANSFER,160752,Jacques Marchand,307246,146494,Honoré de la Prévost,114730,-46022,2022-09-24
CASH_OUT,769811,Emmanuel Legrand,850375,80564,Agence_mtn_Ouidah,300000,-469811,2022-09-09
TRANSFER,41299,Emmanuel Legrand,80564,39265,Emmanuel Legrand,80564,39265,2022-09-10
TRANSFER,201291,Charlotte Perrier,211530,10239,Emmanuel Legrand,39265,240556,2022-09-20
TRANSFER,30754,Emmanuel Legrand,240556,209802,Emmanuel Vallée,865456,834702,2022-09-21
CASH_IN,152901,Agence_mtn_Abomey,300000,147099,Emmanuel Legrand,209802,362703,2022-09-21
CASH_IN,174984,Agence_mtn_Cotonou,300000,125016,Emmanuel Legrand,362703,537687,2022-09-24
CASH_OUT,375464,Emmanuel Legrand,537687,162223,Agence_mtn_Abomey,300000,-75464,2022-09-26
CASH_IN,30167,Agence_mtn_Abomey,300000,269833,Guy-Augustin Pinto,-9575,20592,2022-09-03
TRANSFER,58799,François Vaillant,448517,389718,Guy-Augustin Pinto,20592,79391,2022-09-06
CASH_OUT,25190,Guy-Augustin Pinto,79391,54201,Agence_mtn_Abomey,300000,274810,2022-09-08
CASH_OUT,12871,Guy-Augustin Pinto,54201,41330,Agence_mtn_Ouidah,300000,287129,2022-09-09
TRANSFER,16459,Guy-Augustin Pinto,41330,24871,François Vaillant,389718,373259,2022-09-16
TRANSFER,11853,Guy-Augustin Pinto,24871,13018,Hélène Blanchard-Renault,518648,506795,2022-09-17
CASH_IN,84084,Agence_mtn_Abomey,300000,215916,Guy-Augustin Pinto,13018,97102,2022-09-21
CASH_IN,137283,Agence_mtn_Cotonou,300000,162717,Guy-Augustin Pinto,97102,234385,2022-09-23
CASH_OUT,135074,Guy-Augustin Pinto,234385,99311,Agence_mtn_Cotonou,300000,164926,2022-09-24
CASH_OUT,62627,Guy-Augustin Pinto,99311,36684,Agence_mtn_Abomey,300000,237373,2022-09-26
CASH_IN,191142,Agence_mtn_Ouidah,300000,108858,Thibault Martin,-1065181,-874039,2022-09-01
CASH_IN,163741,Agence_mtn_Abomey,300000,136259,Thibault Martin,-874039,-710298,2022-09-01
CASH_IN,101807,Agence_mtn_Abomey,300000,198193,Thibault Martin,-710298,-608491,2022-09-02
CASH_IN,210812,Agence_mtn_Ouidah,300000,89188,Thibault Martin,-608491,-397679,2022-09-02
CASH_IN,53614,Agence_mtn_Ouidah,300000,246386,Thibault Martin,-397679,-344065,2022-09-16
CASH_IN,236880,Agence_mtn_Abomey,300000,63120,Thibault Martin,-344065,-107185,2022-09-16
CASH_IN,276880,Agence_mtn_Abomey,300000,23120,Thibault Martin,-107185,169695,2022-09-19
CASH_IN,76116,Agence_mtn_Abomey,300000,223884,Thibault Martin,169695,245811,2022-09-20
TRANSFER,170,Margot Julien,513,343,Thibault Martin,245811,245981,2022-09-20
CASH_OUT,102704,Thibault Martin,245981,143277,Agence_mtn_Cotonou,300000,197296,2022-09-21
CASH_IN,110907,Agence_mtn_Ouidah,300000,189093,Thibault Martin,143277,254184,2022-09-22
CASH_OUT,199273,Thibault Martin,254184,54911,Agence_mtn_Ouidah,300000,100727,2022-09-24
TRANSFER,3812,Charlotte Perrier,10239,6427,Thibault Martin,54911,58723,2022-09-24
TRANSFER,16830,Thibault Martin,58723,41893,Thibault-Julien Chevallier,16096,-734,2022-09-24
CASH_IN,112976,Agence_mtn_Ouidah,300000,187024,Thibault Martin,41893,154869,2022-09-26
CASH_OUT,154109,Thibault Martin,154869,760,Agence_mtn_Cotonou,300000,145891,2022-09-27
CASH_IN,47442,Agence_mtn_Ouidah,300000,252558,Gérard Cordier,-61949,-14507,2022-09-01
CASH_IN,229582,Agence_mtn_Cotonou,300000,70418,Gérard Cordier,-14507,215075,2022-09-03
TRANSFER,370268,Emmanuel Vallée,834702,464434,Gérard Cordier,215075,585343,2022-09-14
TRANSFER,172868,Gérard Cordier,585343,412475,Gérard Cordier,585343,758211,2022-09-14
CASH_IN,76548,Agence_mtn_Ouidah,300000,223452,Gérard Cordier,412475,489023,2022-09-17
CASH_OUT,414444,Gérard Cordier,489023,74579,Agence_mtn_Cotonou,300000,-114444,2022-09-21
TRANSFER,227833,François Vaillant,373259,145426,Gérard Cordier,74579,302412,2022-09-23
CASH_OUT,189940,Gérard Cordier,302412,112472,Agence_mtn_Ouidah,300000,110060,2022-09-24
TRANSFER,198413,Marc Baudry,401044,202631,Gérard Cordier,112472,310885,2022-09-27
CASH_IN,45552,Agence_mtn_Ouidah,300000,254448,Laurent Marion,-19184,26368,2022-09-04
CASH_IN,82955,Agence_mtn_Cotonou,300000,217045,Laurent Marion,26368,109323,2022-09-05
CASH_OUT,103873,Laurent Marion,109323,5450,Agence_mtn_Abomey,300000,196127,2022-09-09
TRANSFER,957,Laurent Marion,5450,4493,Laurent Marion,5450,4493,2022-09-10
CASH_IN,134751,Agence_mtn_Cotonou,300000,165249,Laurent Marion,4493,139244,2022-09-16
TRANSFER,275391,Hélène Blanchard-Renault,506795,231404,Laurent Marion,139244,414635,2022-09-17
CASH_OUT,271891,Laurent Marion,414635,142744,Agence_mtn_Abomey,300000,28109,2022-09-27
CASH_IN,129530,Agence_mtn_Abomey,300000,170470,Hélène Alexandre de la Samson,-31498,98032,2022-09-02
TRANSFER,79688,François Vaillant,145426,65738,Hélène Alexandre de la Samson,98032,177720,2022-09-07
TRANSFER,162519,Hélène Blanchard-Renault,231404,68885,Hélène Alexandre de la Samson,177720,340239,2022-09-10
TRANSFER,328064,Hélène Alexandre de la Samson,340239,12175,François Vaillant,65738,-262326,2022-09-11
TRANSFER,15870,Hélène Blanchard-Renault,68885,53015,Hélène Alexandre de la Samson,12175,28045,2022-09-11
CASH_IN,47058,Agence_mtn_Abomey,300000,252942,Hélène Alexandre de la Samson,28045,75103,2022-09-12
CASH_OUT,28365,Hélène Alexandre de la Samson,75103,46738,Agence_mtn_Ouidah,300000,271635,2022-09-15
TRANSFER,95704,Marthe Perrin,922603,826899,Hélène Alexandre de la Samson,46738,142442,2022-09-16
CASH_IN,175005,Agence_mtn_Ouidah,300000,124995,Hélène Alexandre de la Samson,142442,317447,2022-09-16
TRANSFER,353127,Marthe Perrin,826899,473772,Hélène Alexandre de la Samson,317447,670574,2022-09-18
TRANSFER,458818,Hélène Alexandre de la Samson,670574,211756,Marthe Perrin,473772,14954,2022-09-19
CASH_OUT,133098,Hélène Alexandre de la Samson,211756,78658,Agence_mtn_Cotonou,300000,166902,2022-09-20
CASH_OUT,64166,Hélène Alexandre de la Samson,78658,14492,Agence_mtn_Abomey,300000,235834,2022-09-24
CASH_IN,124137,Agence_mtn_Ouidah,300000,175863,Guillaume de la Nguyen,-62125,62012,2022-09-01
TRANSFER,43872,Guillaume de la Nguyen,62012,18140,Zacharie Fabre,994,-42878,2022-09-02
CASH_IN,96696,Agence_mtn_Cotonou,300000,203304,Guillaume de la Nguyen,18140,114836,2022-09-07
CASH_IN,191786,Agence_mtn_Cotonou,300000,108214,Guillaume de la Nguyen,114836,306622,2022-09-10
TRANSFER,76531,Guillaume de la Nguyen,306622,230091,Henri de Didier,4102,-72429,2022-09-13
TRANSFER,66452,Guillaume de la Nguyen,230091,163639,Guillaume de la Nguyen,230091,163639,2022-09-13
CASH_IN,21997,Agence_mtn_Cotonou,300000,278003,Guillaume de la Nguyen,163639,185636,2022-09-13
CASH_IN,30016,Agence_mtn_Abomey,300000,269984,Guillaume de la Nguyen,185636,215652,2022-09-14
TRANSFER,331,Margot Julien,343,12,Guillaume de la Nguyen,215652,215983,2022-09-15
CASH_OUT,102806,Guillaume de la Nguyen,215983,113177,Agence_mtn_Abomey,300000,197194,2022-09-18
TRANSFER,82777,Guillaume de la Nguyen,113177,30400,Emmanuel Vallée,464434,381657,2022-09-20
TRANSFER,26676,Guillaume de la Nguyen,30400,3724,Marc Baudry,202631,175955,2022-09-20
CASH_OUT,2545,Guillaume de la Nguyen,3724,1179,Agence_mtn_Abomey,300000,297455,2022-09-23
TRANSFER,313,Guillaume de la Nguyen,1179,866,Emmanuel Vallée,381657,381344,2022-09-26
CASH_IN,24451,Agence_mtn_Abomey,300000,275549,Zacharie Fabre,-42878,-18427,2022-09-09
CASH_IN,78199,Agence_mtn_Abomey,300000,221801,Zacharie Fabre,-18427,59772,2022-09-10
CASH_OUT,19477,Zacharie Fabre,59772,40295,Agence_mtn_Ouidah,300000,280523,2022-09-18
TRANSFER,8699,Marc Baudry,175955,167256,Zacharie Fabre,40295,48994,2022-09-19
CASH_IN,270051,Agence_mtn_Abomey,300000,29949,Zacharie Fabre,48994,319045,2022-09-20
TRANSFER,115546,Roland Huet,131214,15668,Zacharie Fabre,319045,434591,2022-09-22
CASH_IN,186139,Agence_mtn_Cotonou,300000,113861,Zacharie Fabre,434591,620730,2022-09-26
CASH_IN,54013,Agence_mtn_Ouidah,300000,245987,Maryse Delorme,-108705,-54692,2022-09-01
CASH_IN,54583,Agence_mtn_Cotonou,300000,245417,Maryse Delorme,-54692,-109,2022-09-01
CASH_IN,141081,Agence_mtn_Cotonou,300000,158919,Maryse Delorme,-109,140972,2022-09-03
TRANSFER,109920,Emmanuel Vallée,381344,271424,Maryse Delorme,140972,250892,2022-09-05
CASH_IN,266222,Agence_mtn_Cotonou,300000,33778,Maryse Delorme,250892,517114,2022-09-07
TRANSFER,266756,Maryse Delorme,517114,250358,Marthe Perrin,14954,-251802,2022-09-10
TRANSFER,119192,Maryse Delorme,250358,131166,Maryse Delorme,250358,369550,2022-09-12
CASH_OUT,45029,Maryse Delorme,131166,86137,Agence_mtn_Abomey,300000,254971,2022-09-13
CASH_OUT,71997,Maryse Delorme,86137,14140,Agence_mtn_Ouidah,300000,228003,2022-09-14
CASH_IN,243062,Agence_mtn_Cotonou,300000,56938,Maryse Delorme,14140,257202,2022-09-15
CASH_OUT,28558,Maryse Delorme,257202,228644,Agence_mtn_Ouidah,300000,271442,2022-09-15
TRANSFER,105608,Maryse Delorme,228644,123036,Marc Baudry,167256,61648,2022-09-17
TRANSFER,2436,Charlotte Perrier,6427,3991,Maryse Delorme,123036,125472,2022-09-18
TRANSFER,46048,Maryse Delorme,125472,79424,Roland Huet,15668,-30380,2022-09-19
CASH_OUT,41008,Maryse Delorme,79424,38416,Agence_mtn_Cotonou,300000,258992,2022-09-20
CASH_IN,257851,Agence_mtn_Abomey,300000,42149,Maryse Delorme,38416,296267,2022-09-20
CASH_OUT,59219,Maryse Delorme,296267,237048,Agence_mtn_Cotonou,300000,240781,2022-09-24
CASH_OUT,162515,Maryse Delorme,237048,74533,Agence_mtn_Ouidah,300000,137485,2022-09-27
CASH_OUT,32895,Maryse Delorme,74533,41638,Agence_mtn_Abomey,300000,267105,2022-09-27
TRANSFER,2138,Charlotte Perrier,3991,1853,Charlotte Perrier,3991,6129,2022-09-02
TRANSFER,528,Charlotte Perrier,1853,1325,Charlotte Perrier,1853,2381,2022-09-03
CASH_IN,152709,Agence_mtn_Abomey,300000,147291,Charlotte Perrier,1325,154034,2022-09-03
CASH_IN,221885,Agence_mtn_Ouidah,300000,78115,Charlotte Perrier,154034,375919,2022-09-05
TRANSFER,116104,Charlotte Perrier,375919,259815,Charlotte Perrier,375919,259815,2022-09-06
TRANSFER,48587,Charlotte Perrier,259815,211228,Charlotte Perrier,259815,308402,2022-09-07
TRANSFER,22310,Charlotte Perrier,211228,188918,Marc Baudry,61648,39338,2022-09-10
CASH_OUT,44093,Charlotte Perrier,188918,144825,Agence_mtn_Abomey,300000,255907,2022-09-11
CASH_IN,220174,Agence_mtn_Cotonou,300000,79826,Charlotte Perrier,144825,364999,2022-09-12
CASH_IN,90313,Agence_mtn_Ouidah,300000,209687,Charlotte Perrier,364999,455312,2022-09-12
CASH_IN,278660,Agence_mtn_Cotonou,300000,21340,Charlotte Perrier,455312,733972,2022-09-16
CASH_IN,114057,Agence_mtn_Abomey,300000,185943,Charlotte Perrier,733972,848029,2022-09-16
CASH_OUT,20512,Charlotte Perrier,848029,827517,Agence_mtn_Ouidah,300000,279488,2022-09-16
TRANSFER,63828,Emmanuel Vallée,271424,207596,Charlotte Perrier,827517,891345,2022-09-18
CASH_OUT,30157,Charlotte Perrier,891345,861188,Agence_mtn_Cotonou,300000,269843,2022-09-18
TRANSFER,75766,Emmanuel Vallée,207596,131830,Charlotte Perrier,861188,936954,2022-09-22
CASH_IN,195016,Agence_mtn_Ouidah,300000,104984,Charlotte Perrier,936954,1131970,2022-09-22
CASH_IN,245129,Agence_mtn_Ouidah,300000,54871,Charlotte Perrier,1131970,1377099,2022-09-25
CASH_OUT,1196959,Charlotte Perrier,1377099,180140,Agence_mtn_Cotonou,300000,-896959,2022-09-26
CASH_OUT,108022,Charlotte Perrier,180140,72118,Agence_mtn_Abomey,300000,191978,2022-09-27
CASH_IN,3685,Agence_mtn_Ouidah,300000,296315,Julie Germain Le Vaillant,-127414,-123729,2022-09-01
CASH_IN,246674,Agence_mtn_Ouidah,300000,53326,Julie Germain Le Vaillant,-123729,122945,2022-09-03
TRANSFER,84224,Julie Germain Le Vaillant,122945,38721,Emmanuel Vallée,131830,47606,2022-09-07
CASH_IN,183790,Agence_mtn_Abomey,300000,116210,Julie Germain Le Vaillant,38721,222511,2022-09-08
CASH_IN,271389,Agence_mtn_Abomey,300000,28611,Julie Germain Le Vaillant,222511,493900,2022-09-08
CASH_IN,169884,Agence_mtn_Ouidah,300000,130116,Julie Germain Le Vaillant,493900,663784,2022-09-12
TRANSFER,611882,Julie Germain Le Vaillant,663784,51902,Marc Baudry,39338,-572544,2022-09-16
TRANSFER,40541,Emmanuel Vallée,47606,7065,Julie Germain Le Vaillant,51902,92443,2022-09-16
CASH_OUT,30615,Julie Germain Le Vaillant,92443,61828,Agence_mtn_Cotonou,300000,269385,2022-09-18
CASH_OUT,7911,Julie Germain Le Vaillant,61828,53917,Agence_mtn_Abomey,300000,292089,2022-09-21
CASH_OUT,38423,Julie Germain Le Vaillant,53917,15494,Agence_mtn_Abomey,300000,261577,2022-09-22
CASH_IN,280704,Agence_mtn_Cotonou,300000,19296,Julie Germain Le Vaillant,15494,296198,2022-09-24
TRANSFER,5199,Emmanuel Vallée,7065,1866,Julie Germain Le Vaillant,296198,301397,2022-09-27
CASH_IN,249843,Agence_mtn_Abomey,300000,50157,Roger-Roger Delmas,-185223,64620,2022-09-02
CASH_IN,84638,Agence_mtn_Ouidah,300000,215362,Roger-Roger Delmas,64620,149258,2022-09-04
CASH_IN,50443,Agence_mtn_Ouidah,300000,249557,Roger-Roger Delmas,149258,199701,2022-09-05
CASH_OUT,38820,Roger-Roger Delmas,199701,160881,Agence_mtn_Abomey,300000,261180,2022-09-05
TRANSFER,83928,Roger-Roger Delmas,160881,76953,Emmanuel Vallée,1866,-82062,2022-09-05
CASH_OUT,24939,Roger-Roger Delmas,76953,52014,Agence_mtn_Abomey,300000,275061,2022-09-09
CASH_IN,237619,Agence_mtn_Cotonou,300000,62381,Roger-Roger Delmas,52014,289633,2022-09-14
CASH_OUT,261387,Roger-Roger Delmas,289633,28246,Agence_mtn_Ouidah,300000,38613,2022-09-17
CASH_IN,149592,Agence_mtn_Ouidah,300000,150408,Roger-Roger Delmas,28246,177838,2022-09-23
CASH_OUT,79955,Roger-Roger Delmas,177838,97883,Agence_mtn_Abomey,300000,220045,2022-09-25
CASH_IN,161862,Agence_mtn_Abomey,300000,138138,Emmanuel Vallée,-82062,79800,2022-09-01
TRANSFER,15782,Emmanuel Vallée,79800,64018,Emmanuel Vallée,79800,64018,2022-09-02
CASH_IN,139857,Agence_mtn_Abomey,300000,160143,Emmanuel Vallée,64018,203875,2022-09-04
TRANSFER,76663,Emmanuel Vallée,203875,127212,Emmanuel Vallée,203875,127212,2022-09-04
CASH_IN,265063,Agence_mtn_Abomey,300000,34937,Emmanuel Vallée,127212,392275,2022-09-07
CASH_OUT,191348,Emmanuel Vallée,392275,200927,Agence_mtn_Abomey,300000,108652,2022-09-08
CASH_IN,21389,Agence_mtn_Ouidah,300000,278611,Emmanuel Vallée,200927,222316,2022-09-13
CASH_OUT,201567,Emmanuel Vallée,222316,20749,Agence_mtn_Abomey,300000,98433,2022-09-17
CASH_IN,201268,Agence_mtn_Ouidah,300000,98732,Emmanuel Vallée,20749,222017,2022-09-20
CASH_IN,132698,Agence_mtn_Cotonou,300000,167302,Emmanuel Vallée,222017,354715,2022-09-21
CASH_OUT,36424,Emmanuel Vallée,354715,318291,Agence_mtn_Abomey,300000,263576,2022-09-23
CASH_OUT,56204,Emmanuel Vallée,318291,262087,Agence_mtn_Cotonou,300000,243796,2022-09-26
CASH_IN,1436,Agence_mtn_Cotonou,300000,298564,Marc Costa-Daniel,-303089,-301653,2022-09-03
CASH_IN,99115,Agence_mtn_Abomey,300000,200885,Marc Costa-Daniel,-301653,-202538,2022-09-03
CASH_IN,113617,Agence_mtn_Abomey,300000,186383,Marc Costa-Daniel,-202538,-88921,2022-09-10
CASH_IN,119746,Agence_mtn_Abomey,300000,180254,Marc Costa-Daniel,-88921,30825,2022-09-15
CASH_IN,270970,Agence_mtn_Ouidah,300000,29030,Marc Costa-Daniel,30825,301795,2022-09-18
CASH_OUT,234511,Marc Costa-Daniel,301795,67284,Agence_mtn_Cotonou,300000,65489,2022-09-21
CASH_IN,30880,Agence_mtn_Cotonou,300000,269120,Marc Costa-Daniel,67284,98164,2022-09-22
CASH_OUT,63017,Marc Costa-Daniel,98164,35147,Agence_mtn_Cotonou,300000,236983,2022-09-23
CASH_IN,143655,Agence_mtn_Cotonou,300000,156345,Marc Costa-Daniel,35147,178802,2022-09-26
CASH_IN,106466,Agence_mtn_Ouidah,300000,193534,Élisabeth Delattre,-5631,100835,2022-09-01
TRANSFER,13155,Élisabeth Delattre,100835,87680,Élisabeth Delattre,100835,113990,2022-09-01
TRANSFER,27727,Élisabeth Delattre,87680,59953,Élisabeth Delattre,87680,59953,2022-09-02
TRANSFER,19060,Élisabeth Delattre,59953,40893,Élisabeth Delattre,59953,40893,2022-09-04
TRANSFER,37536,Élisabeth Delattre,40893,3357,Élisabeth Delattre,40893,78429,2022-09-04
CASH_OUT,3319,Élisabeth Delattre,3357,38,Agence_mtn_Abomey,300000,296681,2022-09-05
CASH_IN,132153,Agence_mtn_Ouidah,300000,167847,Élisabeth Delattre,38,132191,2022-09-15
CASH_OUT,6203,Élisabeth Delattre,132191,125988,Agence_mtn_Abomey,300000,293797,2022-09-19
CASH_IN,40793,Agence_mtn_Cotonou,300000,259207,Nicole-Renée Gay,-401240,-360447,2022-09-11
CASH_IN,12931,Agence_mtn_Abomey,300000,287069,Nicole-Renée Gay,-360447,-347516,2022-09-18
CASH_IN,289329,Agence_mtn_Ouidah,300000,10671,Nicole-Renée Gay,-347516,-58187,2022-09-18
CASH_IN,158035,Agence_mtn_Abomey,300000,141965,Nicole-Renée Gay,-58187,99848,2022-09-20
CASH_OUT,2492,Nicole-Renée Gay,99848,97356,Agence_mtn_Abomey,300000,297508,2022-09-20
CASH_IN,32693,Agence_mtn_Ouidah,300000,267307,Nicole-Renée Gay,97356,130049,2022-09-22
CASH_IN,68913,Agence_mtn_Ouidah,300000,231087,Nicole-Renée Gay,130049,198962,2022-09-26
CASH_IN,14948,Agence_mtn_Abomey,300000,285052,Henri de Didier,-72429,-57481,2022-09-01
CASH_IN,285952,Agence_mtn_Cotonou,300000,14048,Henri de Didier,-57481,228471,2022-09-10
CASH_IN,56986,Agence_mtn_Cotonou,300000,243014,Henri de Didier,228471,285457,2022-09-18
CASH_IN,162762,Agence_mtn_Cotonou,300000,137238,Henri de Didier,285457,448219,2022-09-24
CASH_OUT,399634,Henri de Didier,448219,48585,Agence_mtn_Ouidah,300000,-99634,2022-09-25
CASH_IN,180263,Agence_mtn_Cotonou,300000,119737,Margot Julien,12,180275,2022-09-01
CASH_IN,175574,Agence_mtn_Ouidah,300000,124426,Margot Julien,180275,355849,2022-09-02
CASH_OUT,152949,Margot Julien,355849,202900,Agence_mtn_Cotonou,300000,147051,2022-09-07
CASH_IN,154338,Agence_mtn_Cotonou,300000,145662,Margot Julien,202900,357238,2022-09-08
CASH_OUT,36332,Margot Julien,357238,320906,Agence_mtn_Abomey,300000,263668,2022-09-09
CASH_IN,9241,Agence_mtn_Cotonou,300000,290759,Margot Julien,320906,330147,2022-09-13
CASH_IN,117433,Agence_mtn_Ouidah,300000,182567,Margot Julien,330147,447580,2022-09-13
CASH_IN,101990,Agence_mtn_Ouidah,300000,198010,Margot Julien,447580,549570,2022-09-14
CASH_OUT,132356,Margot Julien,549570,417214,Agence_mtn_Ouidah,300000,167644,2022-09-15
CASH_OUT,397250,Margot Julien,417214,19964,Agence_mtn_Cotonou,300000,-97250,2022-09-20
CASH_IN,35618,Agence_mtn_Ouidah,300000,264382,Martin Moreau,-37843,-2225,2022-09-02
CASH_IN,283698,Agence_mtn_Ouidah,300000,16302,Martin Moreau,-2225,281473,2022-09-02
CASH_IN,259805,Agence_mtn_Cotonou,300000,40195,Martin Moreau,281473,541278,2022-09-03
TRANSFER,104289,Martin Moreau,541278,436989,Martin Moreau,541278,645567,2022-09-04
CASH_IN,156966,Agence_mtn_Ouidah,300000,143034,Martin Moreau,436989,593955,2022-09-14
TRANSFER,57213,Martin Moreau,593955,536742,Martin Moreau,593955,536742,2022-09-15
CASH_IN,26440,Agence_mtn_Abomey,300000,273560,Martin Moreau,536742,563182,2022-09-23
CASH_OUT,89257,Martin Moreau,563182,473925,Agence_mtn_Abomey,300000,210743,2022-09-25
CASH_OUT,417903,Martin Moreau,473925,56022,Agence_mtn_Abomey,300000,-117903,2022-09-27
CASH_IN,272104,Agence_mtn_Ouidah,300000,27896,Marthe Perrin,-251802,20302,2022-09-04
TRANSFER,12570,Marthe Perrin,20302,7732,Marthe Perrin,20302,7732,2022-09-05
CASH_IN,11443,Agence_mtn_Abomey,300000,288557,Marthe Perrin,7732,19175,2022-09-07
CASH_IN,104156,Agence_mtn_Abomey,300000,195844,Marthe Perrin,19175,123331,2022-09-08
CASH_OUT,100563,Marthe Perrin,123331,22768,Agence_mtn_Cotonou,300000,199437,2022-09-09
CASH_IN,176735,Agence_mtn_Cotonou,300000,123265,Marthe Perrin,22768,199503,2022-09-10
TRANSFER,162082,Marthe Perrin,199503,37421,Marthe Perrin,199503,361585,2022-09-10
CASH_OUT,30237,Marthe Perrin,37421,7184,Agence_mtn_Cotonou,300000,269763,2022-09-11
TRANSFER,2078,Marthe Perrin,7184,5106,Marthe Perrin,7184,5106,2022-09-13
TRANSFER,476,Marthe Perrin,5106,4630,Marthe Perrin,5106,5582,2022-09-14
CASH_IN,66504,Agence_mtn_Cotonou,300000,233496,Marthe Perrin,4630,71134,2022-09-14
CASH_IN,115124,Agence_mtn_Abomey,300000,184876,Marthe Perrin,71134,186258,2022-09-15
CASH_OUT,126589,Marthe Perrin,186258,59669,Agence_mtn_Ouidah,300000,173411,2022-09-15
CASH_OUT,22321,Marthe Perrin,59669,37348,Agence_mtn_Ouidah,300000,277679,2022-09-18
CASH_OUT,33005,Marthe Perrin,37348,4343,Agence_mtn_Ouidah,300000,266995,2022-09-22
CASH_IN,180968,Agence_mtn_Cotonou,300000,119032,Marthe Perrin,4343,185311,2022-09-22
CASH_IN,222219,Agence_mtn_Ouidah,300000,77781,Marthe Perrin,185311,407530,2022-09-23
CASH_IN,88109,Agence_mtn_Ouidah,300000,211891,Marc Baudry,-572544,-484435,2022-09-04
CASH_IN,183370,Agence_mtn_Cotonou,300000,116630,Marc Baudry,-484435,-301065,2022-09-06
CASH_IN,28000,Agence_mtn_Abomey,300000,272000,Marc Baudry,-301065,-273065,2022-09-07
CASH_IN,35217,Agence_mtn_Cotonou,300000,264783,Marc Baudry,-273065,-237848,2022-09-07
CASH_IN,8287,Agence_mtn_Cotonou,300000,291713,Marc Baudry,-237848,-229561,2022-09-09
CASH_IN,256992,Agence_mtn_Ouidah,300000,43008,Marc Baudry,-229561,27431,2022-09-10
TRANSFER,1684,Marc Baudry,27431,25747,Marc Baudry,27431,29115,2022-09-13
CASH_OUT,8204,Marc Baudry,25747,17543,Agence_mtn_Ouidah,300000,291796,2022-09-14
CASH_IN,60920,Agence_mtn_Abomey,300000,239080,Marc Baudry,17543,78463,2022-09-18
CASH_IN,103352,Agence_mtn_Cotonou,300000,196648,Marc Baudry,78463,181815,2022-09-18
CASH_IN,147023,Agence_mtn_Ouidah,300000,152977,Marc Baudry,181815,328838,2022-09-19
CASH_IN,256647,Agence_mtn_Abomey,300000,43353,Marc Baudry,328838,585485,2022-09-19
CASH_IN,130542,Agence_mtn_Cotonou,300000,169458,Marc Baudry,585485,716027,2022-09-20
CASH_IN,73499,Agence_mtn_Ouidah,300000,226501,Marc Baudry,716027,789526,2022-09-22
CASH_OUT,273613,Marc Baudry,789526,515913,Agence_mtn_Abomey,300000,26387,2022-09-26
CASH_OUT,400674,Marc Baudry,515913,115239,Agence_mtn_Cotonou,300000,-100674,2022-09-27
CASH_OUT,25919,Marc Baudry,115239,89320,Agence_mtn_Cotonou,300000,274081,2022-09-27
CASH_IN,224939,Agence_mtn_Cotonou,300000,75061,Pénélope Boulay,-109721,115218,2022-09-01
CASH_IN,257859,Agence_mtn_Cotonou,300000,42141,Pénélope Boulay,115218,373077,2022-09-01
CASH_IN,114736,Agence_mtn_Cotonou,300000,185264,Pénélope Boulay,373077,487813,2022-09-01
TRANSFER,326292,Pénélope Boulay,487813,161521,Pénélope Boulay,487813,814105,2022-09-05
CASH_OUT,29058,Pénélope Boulay,161521,132463,Agence_mtn_Cotonou,300000,270942,2022-09-05
CASH_OUT,95959,Pénélope Boulay,132463,36504,Agence_mtn_Ouidah,300000,204041,2022-09-06
CASH_OUT,32573,Pénélope Boulay,36504,3931,Agence_mtn_Cotonou,300000,267427,2022-09-06
CASH_OUT,2610,Pénélope Boulay,3931,1321,Agence_mtn_Ouidah,300000,297390,2022-09-08
CASH_OUT,158,Pénélope Boulay,1321,1163,Agence_mtn_Cotonou,300000,299842,2022-09-09
CASH_OUT,362,Pénélope Boulay,1163,801,Agence_mtn_Cotonou,300000,299638,2022-09-10
CASH_IN,23961,Agence_mtn_Cotonou,300000,276039,Pénélope Boulay,801,24762,2022-09-13
TRANSFER,9555,Pénélope Boulay,24762,15207,Pénélope Boulay,24762,15207,2022-09-13
TRANSFER,10575,Pénélope Boulay,15207,4632,Pénélope Boulay,15207,4632,2022-09-14
CASH_OUT,4343,Pénélope Boulay,4632,289,Agence_mtn_Cotonou,300000,295657,2022-09-16
CASH_IN,42108,Agence_mtn_Ouidah,300000,257892,Pénélope Boulay,289,42397,2022-09-17
CASH_IN,18419,Agence_mtn_Ouidah,300000,281581,Pénélope Boulay,42397,60816,2022-09-18
CASH_OUT,25924,Pénélope Boulay,60816,34892,Agence_mtn_Ouidah,300000,274076,2022-09-20
CASH_IN,94011,Agence_mtn_Ouidah,300000,205989,Sabine Perrier,-1217041,-1123030,2022-09-02
CASH_IN,88898,Agence_mtn_Cotonou,300000,211102,Sabine Perrier,-1123030,-1034132,2022-09-04
CASH_IN,255369,Agence_mtn_Abomey,300000,44631,Sabine Perrier,-1034132,-778763,2022-09-05
CASH_IN,16744,Agence_mtn_Abomey,300000,283256,Sabine Perrier,-778763,-762019,2022-09-06
CASH_IN,295703,Agence_mtn_Ouidah,300000,4297,Sabine Perrier,-762019,-466316,2022-09-10
CASH_IN,244653,Agence_mtn_Abomey,300000,55347,Sabine Perrier,-466316,-221663,2022-09-11
CASH_IN,185319,Agence_mtn_Cotonou,300000,114681,Sabine Perrier,-221663,-36344,2022-09-13
CASH_IN,230903,Agence_mtn_Abomey,300000,69097,Sabine Perrier,-36344,194559,2022-09-14
TRANSFER,16726,Sabine Perrier,194559,177833,Sabine Perrier,194559,211285,2022-09-16
TRANSFER,164950,Sabine Perrier,177833,12883,Sabine Perrier,177833,12883,2022-09-18
TRANSFER,10712,Sabine Perrier,12883,2171,Sabine Perrier,12883,23595,2022-09-20
CASH_IN,262438,Agence_mtn_Cotonou,300000,37562,Sabine Perrier,2171,264609,2022-09-21
CASH_IN,111670,Agence_mtn_Cotonou,300000,188330,Sabine Perrier,264609,376279,2022-09-21
CASH_IN,259298,Agence_mtn_Abomey,300000,40702,Sabine Perrier,376279,635577,2022-09-23
CASH_IN,247754,Agence_mtn_Abomey,300000,52246,Sabine Perrier,635577,883331,2022-09-24
CASH_IN,234434,Agence_mtn_Abomey,300000,65566,Matthieu Cousin,-2038,232396,2022-09-01
CASH_IN,292597,Agence_mtn_Ouidah,300000,7403,Matthieu Cousin,232396,524993,2022-09-08
CASH_OUT,36050,Matthieu Cousin,524993,488943,Agence_mtn_Abomey,300000,263950,2022-09-08
CASH_IN,211976,Agence_mtn_Cotonou,300000,88024,Matthieu Cousin,488943,700919,2022-09-09
TRANSFER,85199,Matthieu Cousin,700919,615720,Matthieu Cousin,700919,786118,2022-09-10
TRANSFER,203384,Matthieu Cousin,615720,412336,Matthieu Cousin,615720,819104,2022-09-11
TRANSFER,376065,Matthieu Cousin,412336,36271,Matthieu Cousin,412336,36271,2022-09-13
CASH_OUT,598,Matthieu Cousin,36271,35673,Agence_mtn_Abomey,300000,299402,2022-09-15
CASH_OUT,2338,Matthieu Cousin,35673,33335,Agence_mtn_Cotonou,300000,297662,2022-09-15
CASH_OUT,29126,Matthieu Cousin,33335,4209,Agence_mtn_Ouidah,300000,270874,2022-09-15
CASH_OUT,3735,Matthieu Cousin,4209,474,Agence_mtn_Cotonou,300000,296265,2022-09-17
CASH_IN,140966,Agence_mtn_Ouidah,300000,159034,Honoré de la Prévost,-46022,94944,2022-09-03
TRANSFER,78512,Honoré de la Prévost,94944,16432,Honoré de la Prévost,94944,173456,2022-09-04
TRANSFER,15137,Honoré de la Prévost,16432,1295,Honoré de la Prévost,16432,1295,2022-09-06
CASH_OUT,200,Honoré de la Prévost,1295,1095,Agence_mtn_Abomey,300000,299800,2022-09-06
CASH_IN,138358,Agence_mtn_Ouidah,300000,161642,Honoré de la Prévost,1095,139453,2022-09-06
CASH_OUT,131232,Honoré de la Prévost,139453,8221,Agence_mtn_Ouidah,300000,168768,2022-09-07
TRANSFER,3853,Honoré de la Prévost,8221,4368,Honoré de la Prévost,8221,4368,2022-09-09
CASH_IN,106694,Agence_mtn_Abomey,300000,193306,Honoré de la Prévost,4368,111062,2022-09-15
CASH_IN,293315,Agence_mtn_Ouidah,300000,6685,Honoré de la Prévost,111062,404377,2022-09-18
CASH_IN,240062,Agence_mtn_Abomey,300000,59938,Honoré de la Prévost,404377,644439,2022-09-20
CASH_IN,208619,Agence_mtn_Ouidah,300000,91381,Honoré de la Prévost,644439,853058,2022-09-23
CASH_OUT,69625,Honoré de la Prévost,853058,783433,Agence_mtn_Abomey,300000,230375,2022-09-27
CASH_IN,273778,Agence_mtn_Abomey,300000,26222,Nathalie Da Silva,-296585,-22807,2022-09-03
CASH_IN,10072,Agence_mtn_Abomey,300000,289928,Nathalie Da Silva,-22807,-12735,2022-09-04
CASH_IN,177612,Agence_mtn_Abomey,300000,122388,Nathalie Da Silva,-12735,164877,2022-09-05
CASH_IN,173604,Agence_mtn_Ouidah,300000,126396,Nathalie Da Silva,164877,338481,2022-09-05
CASH_IN,270850,Agence_mtn_Ouidah,300000,29150,Nathalie Da Silva,338481,609331,2022-09-06
CASH_OUT,549199,Nathalie Da Silva,609331,60132,Agence_mtn_Abomey,300000,-249199,2022-09-09
CASH_OUT,22662,Nathalie Da Silva,60132,37470,Agence_mtn_Abomey,300000,277338,2022-09-16
CASH_IN,171149,Agence_mtn_Abomey,300000,128851,Nathalie Da Silva,37470,208619,2022-09-18
CASH_IN,264757,Agence_mtn_Ouidah,300000,35243,Nathalie Da Silva,208619,473376,2022-09-19
CASH_IN,122496,Agence_mtn_Ouidah,300000,177504,Édouard Grondin du Fleury,-820619,-698123,2022-09-01
CASH_IN,297286,Agence_mtn_Ouidah,300000,2714,Édouard Grondin du Fleury,-698123,-400837,2022-09-04
CASH_IN,283046,Agence_mtn_Cotonou,300000,16954,Édouard Grondin du Fleury,-400837,-117791,2022-09-06
CASH_IN,72217,Agence_mtn_Abomey,300000,227783,Édouard Grondin du Fleury,-117791,-45574,2022-09-07
CASH_IN,255598,Agence_mtn_Ouidah,300000,44402,Édouard Grondin du Fleury,-45574,210024,2022-09-11
TRANSFER,168611,Édouard Grondin du Fleury,210024,41413,Édouard Grondin du Fleury,210024,41413,2022-09-13
CASH_IN,71441,Agence_mtn_Cotonou,300000,228559,Édouard Grondin du Fleury,41413,112854,2022-09-19
CASH_IN,818,Agence_mtn_Ouidah,300000,299182,Édouard Grondin du Fleury,112854,113672,2022-09-23
CASH_IN,61376,Agence_mtn_Abomey,300000,238624,Nathalie-Claire De Oliveira,11,61387,2022-09-01
CASH_OUT,34641,Nathalie-Claire De Oliveira,61387,26746,Agence_mtn_Ouidah,300000,265359,2022-09-05
TRANSFER,12274,Nathalie-Claire De Oliveira,26746,14472,Nathalie-Claire De Oliveira,26746,39020,2022-09-06
CASH_OUT,12866,Nathalie-Claire De Oliveira,14472,1606,Agence_mtn_Ouidah,300000,287134,2022-09-06
TRANSFER,1465,Nathalie-Claire De Oliveira,1606,141,Nathalie-Claire De Oliveira,1606,141,2022-09-09
CASH_OUT,103,Nathalie-Claire De Oliveira,141,38,Agence_mtn_Cotonou,300000,299897,2022-09-09
CASH_IN,182516,Agence_mtn_Cotonou,300000,117484,Nathalie-Claire De Oliveira,38,182554,2022-09-11
CASH_IN,272320,Agence_mtn_Abomey,300000,27680,Nathalie-Claire De Oliveira,182554,454874,2022-09-13
TRANSFER,415911,Nathalie-Claire De Oliveira,454874,38963,Nathalie-Claire De Oliveira,454874,38963,2022-09-14
TRANSFER,9062,Nathalie-Claire De Oliveira,38963,29901,Nathalie-Claire De Oliveira,38963,29901,2022-09-15
CASH_OUT,175,Nathalie-Claire De Oliveira,29901,29726,Agence_mtn_Abomey,300000,299825,2022-09-19
CASH_OUT,3763,Nathalie-Claire De Oliveira,29726,25963,Agence_mtn_Ouidah,300000,296237,2022-09-19
CASH_OUT,22949,Nathalie-Claire De Oliveira,25963,3014,Agence_mtn_Ouidah,300000,277051,2022-09-22
CASH_IN,200736,Agence_mtn_Cotonou,300000,99264,Nathalie-Claire De Oliveira,3014,203750,2022-09-22
CASH_IN,50856,Agence_mtn_Ouidah,300000,249144,Nathalie-Claire De Oliveira,203750,254606,2022-09-23
CASH_OUT,214294,Nathalie-Claire De Oliveira,254606,40312,Agence_mtn_Abomey,300000,85706,2022-09-24
CASH_IN,199940,Agence_mtn_Ouidah,300000,100060,Nathalie-Claire De Oliveira,40312,240252,2022-09-27
CASH_IN,242116,Agence_mtn_Abomey,300000,57884,Jacques Laporte de Blanchet,-226249,15867,2022-09-01
TRANSFER,10973,Jacques Laporte de Blanchet,15867,4894,Jacques Laporte de Blanchet,15867,4894,2022-09-02
CASH_OUT,246,Jacques Laporte de Blanchet,4894,4648,Agence_mtn_Cotonou,300000,299754,2022-09-02
CASH_IN,249130,Agence_mtn_Ouidah,300000,50870,Jacques Laporte de Blanchet,4648,253778,2022-09-03
CASH_IN,83376,Agence_mtn_Cotonou,300000,216624,Jacques Laporte de Blanchet,253778,337154,2022-09-03
CASH_OUT,25338,Jacques Laporte de Blanchet,337154,311816,Agence_mtn_Cotonou,300000,274662,2022-09-03
CASH_IN,86943,Agence_mtn_Ouidah,300000,213057,Jacques Laporte de Blanchet,311816,398759,2022-09-10
CASH_OUT,165450,Jacques Laporte de Blanchet,398759,233309,Agence_mtn_Abomey,300000,134550,2022-09-14
CASH_IN,124826,Agence_mtn_Abomey,300000,175174,Jacques Laporte de Blanchet,233309,358135,2022-09-15
TRANSFER,187538,Jacques Laporte de Blanchet,358135,170597,Jacques Laporte de Blanchet,358135,170597,2022-09-18
CASH_IN,35962,Agence_mtn_Cotonou,300000,264038,Jacques Laporte de Blanchet,170597,206559,2022-09-18
CASH_IN,55646,Agence_mtn_Ouidah,300000,244354,Jacques Laporte de Blanchet,206559,262205,2022-09-20
CASH_OUT,92526,Jacques Laporte de Blanchet,262205,169679,Agence_mtn_Cotonou,300000,207474,2022-09-21
CASH_IN,224795,Agence_mtn_Ouidah,300000,75205,Jacques Laporte de Blanchet,169679,394474,2022-09-21
CASH_IN,195916,Agence_mtn_Abomey,300000,104084,Jacques Laporte de Blanchet,394474,590390,2022-09-22
CASH_IN,31202,Agence_mtn_Ouidah,300000,268798,Jacques Laporte de Blanchet,590390,621592,2022-09-23
CASH_OUT,30234,Jacques Laporte de Blanchet,621592,591358,Agence_mtn_Abomey,300000,269766,2022-09-27
CASH_IN,242731,Agence_mtn_Ouidah,300000,57269,Emmanuelle Le Allain,-2352,240379,2022-09-02
CASH_IN,38996,Agence_mtn_Abomey,300000,261004,Emmanuelle Le Allain,240379,279375,2022-09-02
CASH_OUT,164139,Emmanuelle Le Allain,279375,115236,Agence_mtn_Ouidah,300000,135861,2022-09-02
TRANSFER,45805,Emmanuelle Le Allain,115236,69431,Emmanuelle Le Allain,115236,69431,2022-09-03
CASH_OUT,64593,Emmanuelle Le Allain,69431,4838,Agence_mtn_Ouidah,300000,235407,2022-09-03
CASH_OUT,724,Emmanuelle Le Allain,4838,4114,Agence_mtn_Ouidah,300000,299276,2022-09-07
TRANSFER,1630,Emmanuelle Le Allain,4114,2484,Emmanuelle Le Allain,4114,2484,2022-09-08
CASH_OUT,2019,Emmanuelle Le Allain,2484,465,Agence_mtn_Ouidah,300000,297981,2022-09-10
CASH_OUT,256,Emmanuelle Le Allain,465,209,Agence_mtn_Ouidah,300000,299744,2022-09-10
CASH_IN,205916,Agence_mtn_Ouidah,300000,94084,Emmanuelle Le Allain,209,206125,2022-09-12
CASH_IN,153792,Agence_mtn_Ouidah,300000,146208,Emmanuelle Le Allain,206125,359917,2022-09-16
CASH_OUT,114085,Emmanuelle Le Allain,359917,245832,Agence_mtn_Cotonou,300000,185915,2022-09-17
CASH_OUT,220612,Emmanuelle Le Allain,245832,25220,Agence_mtn_Abomey,300000,79388,2022-09-23
CASH_IN,218739,Agence_mtn_Cotonou,300000,81261,Emmanuelle Le Allain,25220,243959,2022-09-27
CASH_OUT,83762,Emmanuelle Le Allain,243959,160197,Agence_mtn_Cotonou,300000,216238,2022-09-27
CASH_IN,18303,Agence_mtn_Cotonou,300000,281697,Thibault-Julien Chevallier,-734,17569,2022-09-04
TRANSFER,17479,Thibault-Julien Chevallier,17569,90,Thibault-Julien Chevallier,17569,35048,2022-09-05
CASH_IN,126089,Agence_mtn_Ouidah,300000,173911,Thibault-Julien Chevallier,90,126179,2022-09-06
CASH_OUT,81465,Thibault-Julien Chevallier,126179,44714,Agence_mtn_Ouidah,300000,218535,2022-09-06
CASH_IN,65276,Agence_mtn_Cotonou,300000,234724,Thibault-Julien Chevallier,44714,109990,2022-09-12
CASH_IN,193155,Agence_mtn_Ouidah,300000,106845,Thibault-Julien Chevallier,109990,303145,2022-09-13
CASH_IN,97308,Agence_mtn_Ouidah,300000,202692,Thibault-Julien Chevallier,303145,400453,2022-09-14
CASH_OUT,236510,Thibault-Julien Chevallier,400453,163943,Agence_mtn_Abomey,300000,63490,2022-09-14
TRANSFER,61608,Thibault-Julien Chevallier,163943,102335,Thibault-Julien Chevallier,163943,102335,2022-09-14
CASH_IN,260707,Agence_mtn_Cotonou,300000,39293,Thibault-Julien Chevallier,102335,363042,2022-09-15
TRANSFER,32072,Thibault-Julien Chevallier,363042,330970,Thibault-Julien Chevallier,363042,395114,2022-09-15
CASH_OUT,294180,Thibault-Julien Chevallier,330970,36790,Agence_mtn_Cotonou,300000,5820,2022-09-17
CASH_OUT,21076,Thibault-Julien Chevallier,36790,15714,Agence_mtn_Abomey,300000,278924,2022-09-20
CASH_OUT,10228,Thibault-Julien Chevallier,15714,5486,Agence_mtn_Abomey,300000,289772,2022-09-24
CASH_IN,112703,Agence_mtn_Cotonou,300000,187297,Thérèse-Juliette Camus,46,112749,2022-09-05
CASH_OUT,79560,Thérèse-Juliette Camus,112749,33189,Agence_mtn_Cotonou,300000,220440,2022-09-09
CASH_IN,112173,Agence_mtn_Cotonou,300000,187827,Thérèse-Juliette Camus,33189,145362,2022-09-09
TRANSFER,51178,Thérèse-Juliette Camus,145362,94184,Thérèse-Juliette Camus,145362,94184,2022-09-10
TRANSFER,26889,Thérèse-Juliette Camus,94184,67295,Thérèse-Juliette Camus,94184,121073,2022-09-11
CASH_IN,149072,Agence_mtn_Ouidah,300000,150928,Thérèse-Juliette Camus,67295,216367,2022-09-12
CASH_OUT,162113,Thérèse-Juliette Camus,216367,54254,Agence_mtn_Ouidah,300000,137887,2022-09-13
CASH_OUT,26929,Thérèse-Juliette Camus,54254,27325,Agence_mtn_Cotonou,300000,273071,2022-09-13
CASH_OUT,19625,Thérèse-Juliette Camus,27325,7700,Agence_mtn_Abomey,300000,280375,2022-09-17
CASH_OUT,5893,Thérèse-Juliette Camus,7700,1807,Agence_mtn_Cotonou,300000,294107,2022-09-17
CASH_IN,22055,Agence_mtn_Ouidah,300000,277945,Thérèse-Juliette Camus,1807,23862,2022-09-18
CASH_OUT,19373,Thérèse-Juliette Camus,23862,4489,Agence_mtn_Abomey,300000,280627,2022-09-22
CASH_IN,298790,Agence_mtn_Cotonou,300000,1210,Gabrielle Hamon,-14046,284744,2022-09-01
CASH_IN,153208,Agence_mtn_Abomey,300000,146792,Gabrielle Hamon,284744,437952,2022-09-03
TRANSFER,162048,Gabrielle Hamon,437952,275904,Gabrielle Hamon,437952,600000,2022-09-03
CASH_OUT,259044,Gabrielle Hamon,275904,16860,Agence_mtn_Cotonou,300000,40956,2022-09-05
CASH_IN,287164,Agence_mtn_Cotonou,300000,12836,Gabrielle Hamon,16860,304024,2022-09-05
CASH_IN,135038,Agence_mtn_Abomey,300000,164962,Gabrielle Hamon,304024,439062,2022-09-06
TRANSFER,70842,Gabrielle Hamon,439062,368220,Gabrielle Hamon,439062,368220,2022-09-06
CASH_OUT,110791,Gabrielle Hamon,368220,257429,Agence_mtn_Abomey,300000,189209,2022-09-09
TRANSFER,49026,Gabrielle Hamon,257429,208403,Gabrielle Hamon,257429,208403,2022-09-11
CASH_OUT,39605,Gabrielle Hamon,208403,168798,Agence_mtn_Cotonou,300000,260395,2022-09-12
TRANSFER,95440,Gabrielle Hamon,168798,73358,Gabrielle Hamon,168798,73358,2022-09-14
CASH_IN,173420,Agence_mtn_Ouidah,300000,126580,Gabrielle Hamon,73358,246778,2022-09-18
TRANSFER,101350,Gabrielle Hamon,246778,145428,Gabrielle Hamon,246778,348128,2022-09-18
CASH_OUT,110116,Gabrielle Hamon,145428,35312,Agence_mtn_Ouidah,300000,189884,2022-09-18
CASH_OUT,13572,Gabrielle Hamon,35312,21740,Agence_mtn_Ouidah,300000,286428,2022-09-19
CASH_IN,247397,Agence_mtn_Ouidah,300000,52603,Gabrielle Hamon,21740,269137,2022-09-20
CASH_OUT,222816,Gabrielle Hamon,269137,46321,Agence_mtn_Ouidah,300000,77184,2022-09-22
CASH_OUT,29859,Gabrielle Hamon,46321,16462,Agence_mtn_Cotonou,300000,270141,2022-09-23
CASH_IN,163,Agence_mtn_Cotonou,300000,299837,Gabrielle Hamon,16462,16625,2022-09-25
CASH_IN,34208,Agence_mtn_Cotonou,300000,265792,François Vaillant,-262326,-228118,2022-09-02
CASH_IN,101880,Agence_mtn_Cotonou,300000,198120,François Vaillant,-228118,-126238,2022-09-06
CASH_IN,140431,Agence_mtn_Ouidah,300000,159569,François Vaillant,-126238,14193,2022-09-08
CASH_OUT,7236,François Vaillant,14193,6957,Agence_mtn_Ouidah,300000,292764,2022-09-08
CASH_IN,47973,Agence_mtn_Ouidah,300000,252027,François Vaillant,6957,54930,2022-09-08
CASH_IN,44485,Agence_mtn_Ouidah,300000,255515,François Vaillant,54930,99415,2022-09-14
CASH_IN,82331,Agence_mtn_Abomey,300000,217669,François Vaillant,99415,181746,2022-09-17
CASH_IN,212780,Agence_mtn_Cotonou,300000,87220,François Vaillant,181746,394526,2022-09-24
CASH_OUT,105061,François Vaillant,394526,289465,Agence_mtn_Ouidah,300000,194939,2022-09-25
CASH_IN,241585,Agence_mtn_Ouidah,300000,58415,François Vaillant,289465,531050,2022-09-26
CASH_OUT,236315,François Vaillant,531050,294735,Agence_mtn_Ouidah,300000,63685,2022-09-27
CASH_IN,172128,Agence_mtn_Cotonou,300000,127872,Roland Huet,-30380,141748,2022-09-01
TRANSFER,112531,Roland Huet,141748,29217,Roland Huet,141748,29217,2022-09-02
CASH_IN,52775,Agence_mtn_Cotonou,300000,247225,Roland Huet,29217,81992,2022-09-04
TRANSFER,53523,Roland Huet,81992,28469,Roland Huet,81992,135515,2022-09-07
CASH_IN,236972,Agence_mtn_Ouidah,300000,63028,Roland Huet,28469,265441,2022-09-07
CASH_OUT,120384,Roland Huet,265441,145057,Agence_mtn_Ouidah,300000,179616,2022-09-08
TRANSFER,19836,Roland Huet,145057,125221,Roland Huet,145057,164893,2022-09-08
TRANSFER,21200,Roland Huet,125221,104021,Roland Huet,125221,104021,2022-09-11
CASH_IN,295023,Agence_mtn_Ouidah,300000,4977,Roland Huet,104021,399044,2022-09-11
CASH_OUT,398624,Roland Huet,399044,420,Agence_mtn_Cotonou,300000,-98624,2022-09-12
CASH_IN,251281,Agence_mtn_Abomey,300000,48719,Roland Huet,420,251701,2022-09-13
CASH_IN,239986,Agence_mtn_Abomey,300000,60014,Roland Huet,251701,491687,2022-09-20
CASH_OUT,82405,Roland Huet,491687,409282,Agence_mtn_Ouidah,300000,217595,2022-09-22
CASH_OUT,314574,Roland Huet,409282,94708,Agence_mtn_Abomey,300000,-14574,2022-09-26
CASH_IN,255915,Agence_mtn_Cotonou,300000,44085,Marcel de la Buisson,-9034,246881,2022-09-02
CASH_OUT,159022,Marcel de la Buisson,246881,87859,Agence_mtn_Abomey,300000,140978,2022-09-02
CASH_OUT,15741,Marcel de la Buisson,87859,72118,Agence_mtn_Abomey,300000,284259,2022-09-03
CASH_OUT,51345,Marcel de la Buisson,72118,20773,Agence_mtn_Ouidah,300000,248655,2022-09-07
TRANSFER,488,Marcel de la Buisson,20773,20285,Marcel de la Buisson,20773,20285,2022-09-09
TRANSFER,18999,Marcel de la Buisson,20285,1286,Marcel de la Buisson,20285,39284,2022-09-11
CASH_OUT,253,Marcel de la Buisson,1286,1033,Agence_mtn_Cotonou,300000,299747,2022-09-11
CASH_IN,223793,Agence_mtn_Cotonou,300000,76207,Marcel de la Buisson,1033,224826,2022-09-13
CASH_IN,131689,Agence_mtn_Abomey,300000,168311,Marcel de la Buisson,224826,356515,2022-09-14
CASH_OUT,61699,Marcel de la Buisson,356515,294816,Agence_mtn_Ouidah,300000,238301,2022-09-14
CASH_OUT,154168,Marcel de la Buisson,294816,140648,Agence_mtn_Cotonou,300000,145832,2022-09-14
CASH_OUT,51877,Marcel de la Buisson,140648,88771,Agence_mtn_Abomey,300000,248123,2022-09-14
CASH_IN,8355,Agence_mtn_Abomey,300000,291645,Marcel de la Buisson,88771,97126,2022-09-19
CASH_IN,187570,Agence_mtn_Ouidah,300000,112430,Valérie-Claudine Marin,-5811,181759,2022-09-01
CASH_OUT,83313,Valérie-Claudine Marin,181759,98446,Agence_mtn_Ouidah,300000,216687,2022-09-02
CASH_IN,88599,Agence_mtn_Cotonou,300000,211401,Valérie-Claudine Marin,98446,187045,2022-09-02
CASH_IN,90079,Agence_mtn_Abomey,300000,209921,Valérie-Claudine Marin,187045,277124,2022-09-03
TRANSFER,107701,Valérie-Claudine Marin,277124,169423,Valérie-Claudine Marin,277124,384825,2022-09-04
TRANSFER,41686,Valérie-Claudine Marin,169423,127737,Valérie-Claudine Marin,169423,127737,2022-09-04
CASH_IN,191562,Agence_mtn_Ouidah,300000,108438,Sylvie Dupré,-496196,-304634,2022-09-02
CASH_IN,104795,Agence_mtn_Ouidah,300000,195205,Sylvie Dupré,-304634,-199839,2022-09-04
CASH_IN,97060,Agence_mtn_Cotonou,300000,202940,Sylvie Dupré,-199839,-102779,2022-09-04
CASH_IN,27788,Agence_mtn_Abomey,300000,272212,Sylvie Dupré,-102779,-74991,2022-09-05
CASH_IN,42267,Agence_mtn_Ouidah,300000,257733,Sylvie Dupré,-74991,-32724,2022-09-05
CASH_IN,136615,Agence_mtn_Cotonou,300000,163385,Sylvie Dupré,-32724,103891,2022-09-07
TRANSFER,83743,Sylvie Dupré,103891,20148,Sylvie Dupré,103891,187634,2022-09-07
CASH_IN,117185,Agence_mtn_Abomey,300000,182815,Sylvie Dupré,20148,137333,2022-09-08
CASH_OUT,39928,Sylvie Dupré,137333,97405,Agence_mtn_Cotonou,300000,260072,2022-09-16
CASH_OUT,19145,Sylvie Dupré,97405,78260,Agence_mtn_Ouidah,300000,280855,2022-09-17
CASH_OUT,76297,Sylvie Dupré,78260,1963,Agence_mtn_Abomey,300000,223703,2022-09-20
CASH_OUT,239,Sylvie Dupré,1963,1724,Agence_mtn_Cotonou,300000,299761,2022-09-22
CASH_OUT,1664,Sylvie Dupré,1724,60,Agence_mtn_Ouidah,300000,298336,2022-09-25
CASH_IN,241698,Agence_mtn_Abomey,300000,58302,Sylvie Dupré,60,241758,2022-09-26
CASH_IN,171019,Agence_mtn_Ouidah,300000,128981,Élisabeth Blot-Bruneau,-879106,-708087,2022-09-01
CASH_IN,167258,Agence_mtn_Abomey,300000,132742,Élisabeth Blot-Bruneau,-708087,-540829,2022-09-03
CASH_IN,201958,Agence_mtn_Ouidah,300000,98042,Élisabeth Blot-Bruneau,-540829,-338871,2022-09-07
CASH_IN,111455,Agence_mtn_Abomey,300000,188545,Élisabeth Blot-Bruneau,-338871,-227416,2022-09-11
CASH_IN,240438,Agence_mtn_Ouidah,300000,59562,Élisabeth Blot-Bruneau,-227416,13022,2022-09-11
CASH_OUT,11365,Élisabeth Blot-Bruneau,13022,1657,Agence_mtn_Abomey,300000,288635,2022-09-13
TRANSFER,1146,Élisabeth Blot-Bruneau,1657,511,Élisabeth Blot-Bruneau,1657,511,2022-09-17
CASH_IN,107810,Agence_mtn_Cotonou,300000,192190,Élisabeth Blot-Bruneau,511,108321,2022-09-25
CASH_OUT,385162,Michèle Faivre,393100,7938,Agence_mtn_Ouidah,300000,-85162,2022-10-07
TRANSFER,353383,Nicolas Blin,1440200,1086817,Michèle Faivre,7938,361321,2022-10-25
CASH_IN,237189,Agence_mtn_Ouidah,300000,62811,Michèle Faivre,361321,598510,2022-10-27
CASH_OUT,1326250,René de la Delaunay,1635700,309450,Agence_mtn_Abomey,300000,-1026250,2022-10-02
CASH_IN,240503,Agence_mtn_Cotonou,300000,59497,René de la Delaunay,309450,549953,2022-10-16
CASH_OUT,78510,René de la Delaunay,549953,471443,Agence_mtn_Cotonou,300000,221490,2022-10-17
TRANSFER,326071,Nicole-Renée Gay,449200,123129,René de la Delaunay,471443,797514,2022-10-25
CASH_OUT,1442344,Marc Costa-Daniel,1495100,52756,Agence_mtn_Ouidah,300000,-1142344,2022-10-07
TRANSFER,1060160,Zacharie Fabre,1191800,131640,Marc Costa-Daniel,52756,1112916,2022-10-22
CASH_IN,185872,Agence_mtn_Cotonou,300000,114128,Honoré Grégoire-Breton,1285000,1470872,2022-10-02
CASH_IN,262414,Agence_mtn_Cotonou,300000,37586,Honoré Grégoire-Breton,1470872,1733286,2022-10-07
CASH_IN,262345,Agence_mtn_Ouidah,300000,37655,Honoré Grégoire-Breton,1733286,1995631,2022-10-18
CASH_OUT,913128,Honoré Grégoire-Breton,1995631,1082503,Agence_mtn_Abomey,300000,-613128,2022-10-25
CASH_OUT,112536,Marc Baudry,877700,765164,Agence_mtn_Ouidah,300000,187464,2022-10-24
CASH_IN,69310,Agence_mtn_Ouidah,300000,230690,Marc Baudry,765164,834474,2022-10-25
CASH_OUT,306327,Marc Baudry,834474,528147,Agence_mtn_Cotonou,300000,-6327,2022-10-27
CASH_OUT,461645,Marc Baudry,528147,66502,Agence_mtn_Abomey,300000,-161645,2022-10-27
TRANSFER,1214628,Laurent Marion,1708800,494172,Hélène Alexandre de la Samson,1107800,2322428,2022-10-11
TRANSFER,1622077,Océane Faure,1679100,57023,Guillaume de la Nguyen,1047300,2669377,2022-10-04
TRANSFER,2341657,Guillaume de la Nguyen,2669377,327720,Emmanuelle Le Allain,1263300,-1078357,2022-10-14
CASH_IN,81642,Agence_mtn_Ouidah,300000,218358,Guillaume de la Nguyen,327720,409362,2022-10-18
CASH_IN,60685,Agence_mtn_Ouidah,300000,239315,Guillaume de la Nguyen,409362,470047,2022-10-19
TRANSFER,118825,Guillaume de la Nguyen,470047,351222,Jean Guilbert-Lenoir,417300,298475,2022-10-22
TRANSFER,564286,Raymond Simon,677200,112914,Élise Monnier,653700,89414,2022-10-03
TRANSFER,29573,Raymond Simon,112914,83341,Jean Guilbert-Lenoir,298475,268902,2022-10-14
CASH_OUT,75994,Raymond Simon,83341,7347,Agence_mtn_Abomey,300000,224006,2022-10-18
CASH_IN,167497,Agence_mtn_Ouidah,300000,132503,Raymond Simon,7347,174844,2022-10-21
TRANSFER,204693,Marine Chevallier,1714300,1509607,Jacques Marchand,1396400,1191707,2022-10-23
CASH_IN,52912,Agence_mtn_Abomey,300000,247088,Marine Chevallier,1509607,1562519,2022-10-23
CASH_OUT,795280,Jacques Laporte de Blanchet,1984700,1189420,Agence_mtn_Cotonou,300000,-495280,2022-10-02
CASH_IN,57560,Agence_mtn_Abomey,300000,242440,Jacques Laporte de Blanchet,1189420,1246980,2022-10-08
CASH_IN,149360,Agence_mtn_Cotonou,300000,150640,Jacques Laporte de Blanchet,1246980,1396340,2022-10-14
CASH_OUT,1121152,Jacques Laporte de Blanchet,1396340,275188,Agence_mtn_Ouidah,300000,-821152,2022-10-16
CASH_OUT,412756,Louis du Boyer,422100,9344,Agence_mtn_Abomey,300000,-112756,2022-10-06
CASH_OUT,7679,Louis du Boyer,9344,1665,Agence_mtn_Abomey,300000,292321,2022-10-10
TRANSFER,577587,Thibault Martin,1156300,578713,Louis du Boyer,1665,579252,2022-10-11
TRANSFER,575235,Louis du Boyer,579252,4017,Clémence Dufour,853800,278565,2022-10-14
TRANSFER,1044318,François Vaillant,1731200,686882,Julie Germain Le Vaillant,1641300,2685618,2022-10-01
CASH_IN,204197,Agence_mtn_Ouidah,300000,95803,Julie Germain Le Vaillant,2685618,2889815,2022-10-17
CASH_OUT,879639,Julie Germain Le Vaillant,2889815,2010176,Agence_mtn_Cotonou,300000,-579639,2022-10-21
CASH_OUT,270777,Élisabeth Delattre,1204100,933323,Agence_mtn_Cotonou,300000,29223,2022-10-03
TRANSFER,34469,Élisabeth Delattre,933323,898854,Alexandre Delaunay,1981300,1946831,2022-10-05
CASH_IN,236542,Agence_mtn_Ouidah,300000,63458,Élisabeth Delattre,898854,1135396,2022-10-14
CASH_OUT,87348,Élisabeth Delattre,1135396,1048048,Agence_mtn_Ouidah,300000,212652,2022-10-16
TRANSFER,1801340,Josette du Hamon,1967300,165960,Pénélope Boulay,117800,-1683540,2022-10-12
CASH_OUT,39364,Josette du Hamon,165960,126596,Agence_mtn_Ouidah,300000,260636,2022-10-15
CASH_OUT,112423,Josette du Hamon,126596,14173,Agence_mtn_Abomey,300000,187577,2022-10-27
CASH_IN,221540,Agence_mtn_Cotonou,300000,78460,Josette du Hamon,14173,235713,2022-10-27
CASH_IN,33589,Agence_mtn_Cotonou,300000,266411,Emmanuelle Le Allain,-1078357,-1044768,2022-10-10
CASH_IN,284856,Agence_mtn_Abomey,300000,15144,Emmanuelle Le Allain,-1044768,-759912,2022-10-12
CASH_IN,122228,Agence_mtn_Cotonou,300000,177772,Emmanuelle Le Allain,-759912,-637684,2022-10-26
CASH_IN,263006,Agence_mtn_Ouidah,300000,36994,Clémence-Alice Ruiz,882900,1145906,2022-10-10
CASH_OUT,76691,Clémence-Alice Ruiz,1145906,1069215,Agence_mtn_Ouidah,300000,223309,2022-10-13
CASH_IN,61921,Agence_mtn_Abomey,300000,238079,Clémence-Alice Ruiz,1069215,1131136,2022-10-22
CASH_IN,166383,Agence_mtn_Abomey,300000,133617,Clémence-Alice Ruiz,1131136,1297519,2022-10-24
TRANSFER,142346,Margot Julien,1065000,922654,Jean Guilbert-Lenoir,268902,411248,2022-10-08
CASH_IN,143776,Agence_mtn_Abomey,300000,156224,Jean Guilbert-Lenoir,411248,555024,2022-10-12
TRANSFER,340563,Gérard Cordier,608600,268037,Jean Guilbert-Lenoir,555024,895587,2022-10-13
CASH_OUT,104481,Jean Guilbert-Lenoir,895587,791106,Agence_mtn_Cotonou,300000,195519,2022-10-16
CASH_IN,107353,Agence_mtn_Ouidah,300000,192647,Christophe Besnard-Diaz,841600,948953,2022-10-15
CASH_OUT,659898,Christophe Besnard-Diaz,948953,289055,Agence_mtn_Abomey,300000,-359898,2022-10-20
CASH_OUT,91548,Christophe Besnard-Diaz,289055,197507,Agence_mtn_Abomey,300000,208452,2022-10-21
CASH_IN,224777,Agence_mtn_Ouidah,300000,75223,Christophe Besnard-Diaz,197507,422284,2022-10-23
CASH_OUT,68380,Christophe Besnard-Diaz,422284,353904,Agence_mtn_Cotonou,300000,231620,2022-10-27
CASH_IN,83902,Agence_mtn_Abomey,300000,216098,Simone du Allard,1952000,2035902,2022-10-01
TRANSFER,3125,Matthieu Cousin,3700,575,Simone du Allard,2035902,2039027,2022-10-08
TRANSFER,33825,Nicole-Renée Gay,123129,89304,Marthe Perrin,1655600,1689425,2022-10-11
CASH_IN,173019,Agence_mtn_Cotonou,300000,126981,Marthe Perrin,1689425,1862444,2022-10-11
CASH_IN,269325,Agence_mtn_Abomey,300000,30675,Marthe Perrin,1862444,2131769,2022-10-17
TRANSFER,25931,Michelle de la Daniel,586700,560769,Marthe Perrin,2131769,2157700,2022-10-20
CASH_OUT,969522,Olivier Benard,1998800,1029278,Agence_mtn_Cotonou,300000,-669522,2022-10-03
CASH_IN,116747,Agence_mtn_Cotonou,300000,183253,Olivier Benard,1029278,1146025,2022-10-06
TRANSFER,237069,Jacques Marchand,1191707,954638,Henri de Didier,55100,292169,2022-10-10
CASH_OUT,255052,Henri de Didier,292169,37117,Agence_mtn_Abomey,300000,44948,2022-10-24
CASH_IN,267976,Agence_mtn_Cotonou,300000,32024,Marcel de la Buisson,316100,584076,2022-10-01
TRANSFER,414720,Marcel de la Buisson,584076,169356,Margot Julien,922654,507934,2022-10-19
TRANSFER,30016,Marcel de la Buisson,169356,139340,Augustin-Jérôme Merle,1459300,1429284,2022-10-26
TRANSFER,1344402,Sabine Perrier,1645500,301098,Marcel de la Buisson,139340,1483742,2022-10-27
CASH_OUT,973262,Valérie-Claudine Marin,1757100,783838,Agence_mtn_Ouidah,300000,-673262,2022-10-06
CASH_IN,289213,Agence_mtn_Ouidah,300000,10787,Valérie-Claudine Marin,783838,1073051,2022-10-08
CASH_IN,9312,Agence_mtn_Ouidah,300000,290688,Valérie-Claudine Marin,1073051,1082363,2022-10-17
CASH_IN,208119,Agence_mtn_Cotonou,300000,91881,Valérie-Claudine Marin,1082363,1290482,2022-10-21
CASH_OUT,1123032,Valérie-Claudine Marin,1290482,167450,Agence_mtn_Ouidah,300000,-823032,2022-10-27
CASH_IN,105007,Agence_mtn_Cotonou,300000,194993,Nathalie-Claire De Oliveira,1615500,1720507,2022-10-01
CASH_OUT,1124532,Nathalie-Claire De Oliveira,1720507,595975,Agence_mtn_Abomey,300000,-824532,2022-10-01
TRANSFER,667280,Sylvie Dupré,1498200,830920,Nathalie-Claire De Oliveira,595975,1263255,2022-10-02
TRANSFER,220138,Nathalie-Claire De Oliveira,1263255,1043117,Augustin-Jérôme Merle,1429284,1209146,2022-10-04
CASH_IN,258384,Agence_mtn_Cotonou,300000,41616,Nathalie-Claire De Oliveira,1043117,1301501,2022-10-04
TRANSFER,512600,Nathalie-Claire De Oliveira,1301501,788901,Danielle-Henriette Tessier,1413500,900900,2022-10-05
CASH_OUT,491685,Nathalie-Claire De Oliveira,788901,297216,Agence_mtn_Ouidah,300000,-191685,2022-10-06
CASH_OUT,92741,Nathalie-Claire De Oliveira,297216,204475,Agence_mtn_Cotonou,300000,207259,2022-10-06
CASH_OUT,73119,Nathalie-Claire De Oliveira,204475,131356,Agence_mtn_Cotonou,300000,226881,2022-10-06
CASH_IN,127966,Agence_mtn_Cotonou,300000,172034,Nathalie-Claire De Oliveira,131356,259322,2022-10-08
CASH_OUT,146549,Nathalie-Claire De Oliveira,259322,112773,Agence_mtn_Cotonou,300000,153451,2022-10-09
TRANSFER,347549,Laurent Marion,494172,146623,Nathalie-Claire De Oliveira,112773,460322,2022-10-14
CASH_OUT,453077,Nathalie-Claire De Oliveira,460322,7245,Agence_mtn_Cotonou,300000,-153077,2022-10-14
CASH_OUT,6279,Nathalie-Claire De Oliveira,7245,966,Agence_mtn_Ouidah,300000,293721,2022-10-16
TRANSFER,115,Nathalie-Claire De Oliveira,966,851,Élisabeth Blot-Bruneau,511200,511085,2022-10-18
CASH_IN,288712,Agence_mtn_Abomey,300000,11288,Nathalie-Claire De Oliveira,851,289563,2022-10-19
CASH_OUT,30302,Nathalie-Claire De Oliveira,289563,259261,Agence_mtn_Ouidah,300000,269698,2022-10-19
TRANSFER,196721,Nathalie-Claire De Oliveira,259261,62540,Alexandre Delaunay,1946831,1750110,2022-10-20
CASH_OUT,14089,Nathalie-Claire De Oliveira,62540,48451,Agence_mtn_Ouidah,300000,285911,2022-10-20
CASH_IN,134602,Agence_mtn_Abomey,300000,165398,Nathalie-Claire De Oliveira,48451,183053,2022-10-20
CASH_IN,261226,Agence_mtn_Ouidah,300000,38774,Nathalie-Claire De Oliveira,183053,444279,2022-10-21
TRANSFER,1672973,Thérèse-Juliette Camus,1835800,162827,Nathalie-Claire De Oliveira,444279,2117252,2022-10-21
CASH_IN,49297,Agence_mtn_Cotonou,300000,250703,Nathalie-Claire De Oliveira,2117252,2166549,2022-10-24
TRANSFER,253173,Margot Julien,507934,254761,Nathalie-Claire De Oliveira,2166549,2419722,2022-10-25
TRANSFER,73298,Élise Monnier,89414,16116,Nathalie-Claire De Oliveira,2419722,2493020,2022-10-25
CASH_IN,268087,Agence_mtn_Abomey,300000,31913,Nathalie-Claire De Oliveira,2493020,2761107,2022-10-26
CASH_OUT,2624991,Nathalie-Claire De Oliveira,2761107,136116,Agence_mtn_Ouidah,300000,-2324991,2022-10-26
CASH_IN,29218,Agence_mtn_Abomey,300000,270782,Nathalie-Claire De Oliveira,136116,165334,2022-10-27
CASH_OUT,293453,Robert Henry-Poulain,1411300,1117847,Agence_mtn_Cotonou,300000,6547,2022-10-01
CASH_IN,110335,Agence_mtn_Cotonou,300000,189665,Robert Henry-Poulain,1117847,1228182,2022-10-01
CASH_IN,113653,Agence_mtn_Cotonou,300000,186347,Robert Henry-Poulain,1228182,1341835,2022-10-01
CASH_OUT,472651,Robert Henry-Poulain,1341835,869184,Agence_mtn_Ouidah,300000,-172651,2022-10-01
TRANSFER,666519,Robert Henry-Poulain,869184,202665,Maggie Barbier,1993500,1326981,2022-10-03
CASH_IN,38896,Agence_mtn_Abomey,300000,261104,Robert Henry-Poulain,202665,241561,2022-10-05
TRANSFER,224834,Robert Henry-Poulain,241561,16727,Madeleine Philippe-Grondin,1102600,877766,2022-10-07
CASH_OUT,2713,Robert Henry-Poulain,16727,14014,Agence_mtn_Cotonou,300000,297287,2022-10-08
CASH_OUT,4693,Robert Henry-Poulain,14014,9321,Agence_mtn_Abomey,300000,295307,2022-10-09
TRANSFER,392717,Nicolas Blin,1086817,694100,Robert Henry-Poulain,9321,402038,2022-10-10
CASH_IN,268297,Agence_mtn_Cotonou,300000,31703,Robert Henry-Poulain,402038,670335,2022-10-11
CASH_OUT,620267,Robert Henry-Poulain,670335,50068,Agence_mtn_Ouidah,300000,-320267,2022-10-14
CASH_IN,242230,Agence_mtn_Abomey,300000,57770,Robert Henry-Poulain,50068,292298,2022-10-16
CASH_IN,217280,Agence_mtn_Ouidah,300000,82720,Robert Henry-Poulain,292298,509578,2022-10-16
TRANSFER,47435,Robert Henry-Poulain,509578,462143,Clémence Dufour,278565,231130,2022-10-17
CASH_IN,168435,Agence_mtn_Ouidah,300000,131565,Robert Henry-Poulain,462143,630578,2022-10-18
CASH_OUT,1814,Robert Henry-Poulain,630578,628764,Agence_mtn_Ouidah,300000,298186,2022-10-18
CASH_IN,130963,Agence_mtn_Cotonou,300000,169037,Robert Henry-Poulain,628764,759727,2022-10-18
TRANSFER,612406,Robert Henry-Poulain,759727,147321,Maurice de Brunet,1654000,1041594,2022-10-20
TRANSFER,76367,Robert Henry-Poulain,147321,70954,Maurice de Brunet,1041594,965227,2022-10-21
TRANSFER,167468,Clémence Dufour,231130,63662,Robert Henry-Poulain,70954,238422,2022-10-21
CASH_OUT,125978,Robert Henry-Poulain,238422,112444,Agence_mtn_Abomey,300000,174022,2022-10-21
CASH_IN,106356,Agence_mtn_Cotonou,300000,193644,Robert Henry-Poulain,112444,218800,2022-10-21
CASH_IN,43096,Agence_mtn_Abomey,300000,256904,Robert Henry-Poulain,218800,261896,2022-10-23
CASH_OUT,95532,Robert Henry-Poulain,261896,166364,Agence_mtn_Cotonou,300000,204468,2022-10-23
TRANSFER,15334,Margot Julien,254761,239427,Robert Henry-Poulain,166364,181698,2022-10-23
CASH_OUT,101427,Robert Henry-Poulain,181698,80271,Agence_mtn_Ouidah,300000,198573,2022-10-25
CASH_OUT,47624,Robert Henry-Poulain,80271,32647,Agence_mtn_Abomey,300000,252376,2022-10-26
CASH_IN,259668,Agence_mtn_Abomey,300000,40332,Robert Henry-Poulain,32647,292315,2022-10-27
CASH_OUT,1064954,Marine Labbé,1793100,728146,Agence_mtn_Ouidah,300000,-764954,2022-10-02
CASH_IN,40339,Agence_mtn_Ouidah,300000,259661,Marine Labbé,728146,768485,2022-10-02
CASH_OUT,219166,Marine Labbé,768485,549319,Agence_mtn_Cotonou,300000,80834,2022-10-02
CASH_OUT,141250,Marine Labbé,549319,408069,Agence_mtn_Ouidah,300000,158750,2022-10-05
CASH_OUT,310120,Marine Labbé,408069,97949,Agence_mtn_Ouidah,300000,-10120,2022-10-07
CASH_IN,153001,Agence_mtn_Abomey,300000,146999,Marine Labbé,97949,250950,2022-10-12
CASH_IN,183187,Agence_mtn_Cotonou,300000,116813,Marine Labbé,250950,434137,2022-10-12
CASH_OUT,374065,Marine Labbé,434137,60072,Agence_mtn_Ouidah,300000,-74065,2022-10-15
CASH_OUT,42321,Marine Labbé,60072,17751,Agence_mtn_Abomey,300000,257679,2022-10-16
CASH_OUT,11780,Marine Labbé,17751,5971,Agence_mtn_Ouidah,300000,288220,2022-10-17
CASH_IN,177574,Agence_mtn_Cotonou,300000,122426,Marine Labbé,5971,183545,2022-10-17
TRANSFER,53208,Marine Labbé,183545,130337,Alfred Paris,1643700,1590492,2022-10-18
CASH_OUT,127643,Marine Labbé,130337,2694,Agence_mtn_Abomey,300000,172357,2022-10-19
CASH_OUT,428,Marine Labbé,2694,2266,Agence_mtn_Ouidah,300000,299572,2022-10-20
CASH_OUT,993,Marine Labbé,2266,1273,Agence_mtn_Ouidah,300000,299007,2022-10-20
CASH_IN,34211,Agence_mtn_Ouidah,300000,265789,Marine Labbé,1273,35484,2022-10-21
CASH_OUT,35282,Marine Labbé,35484,202,Agence_mtn_Abomey,300000,264718,2022-10-22
CASH_OUT,183,Marine Labbé,202,19,Agence_mtn_Ouidah,300000,299817,2022-10-22
CASH_IN,239302,Agence_mtn_Cotonou,300000,60698,Marine Labbé,19,239321,2022-10-23
TRANSFER,302617,Stéphanie Guichard,530800,228183,Marine Labbé,239321,541938,2022-10-23
TRANSFER,171541,Christine Rossi,854900,683359,Marine Labbé,541938,713479,2022-10-25
CASH_OUT,551867,Marine Labbé,713479,161612,Agence_mtn_Ouidah,300000,-251867,2022-10-25
CASH_OUT,55949,Marine Labbé,161612,105663,Agence_mtn_Ouidah,300000,244051,2022-10-27
TRANSFER,212435,Augustin-Jérôme Merle,1209146,996711,Sabine Perrier,301098,88663,2022-10-01
TRANSFER,113818,Thibault Martin,578713,464895,Augustin-Jérôme Merle,996711,1110529,2022-10-03
TRANSFER,409519,Éléonore Marin Le Morel,1156900,747381,Augustin-Jérôme Merle,1110529,1520048,2022-10-04
TRANSFER,464094,Augustin-Jérôme Merle,1520048,1055954,Madeleine Philippe-Grondin,877766,413672,2022-10-04
CASH_IN,112685,Agence_mtn_Abomey,300000,187315,Augustin-Jérôme Merle,1055954,1168639,2022-10-05
CASH_IN,7768,Agence_mtn_Ouidah,300000,292232,Augustin-Jérôme Merle,1168639,1176407,2022-10-08
TRANSFER,669474,Sophie-Anouk Boulanger,773800,104326,Augustin-Jérôme Merle,1176407,1845881,2022-10-09
CASH_IN,161400,Agence_mtn_Abomey,300000,138600,Augustin-Jérôme Merle,1845881,2007281,2022-10-10
CASH_IN,15692,Agence_mtn_Cotonou,300000,284308,Augustin-Jérôme Merle,2007281,2022973,2022-10-10
TRANSFER,372517,Augustin-Jérôme Merle,2022973,1650456,Valérie de Pottier,1810800,1438283,2022-10-11
CASH_IN,21545,Agence_mtn_Cotonou,300000,278455,Augustin-Jérôme Merle,1650456,1672001,2022-10-12
CASH_IN,299091,Agence_mtn_Cotonou,300000,909,Augustin-Jérôme Merle,1672001,1971092,2022-10-13
CASH_IN,106863,Agence_mtn_Cotonou,300000,193137,Augustin-Jérôme Merle,1971092,2077955,2022-10-14
CASH_IN,26462,Agence_mtn_Cotonou,300000,273538,Augustin-Jérôme Merle,2077955,2104417,2022-10-15
CASH_OUT,2074982,Augustin-Jérôme Merle,2104417,29435,Agence_mtn_Cotonou,300000,-1774982,2022-10-16
TRANSFER,283773,Nathalie Da Silva,1965300,1681527,Augustin-Jérôme Merle,29435,313208,2022-10-17
CASH_IN,282802,Agence_mtn_Abomey,300000,17198,Augustin-Jérôme Merle,313208,596010,2022-10-20
CASH_IN,24113,Agence_mtn_Ouidah,300000,275887,Augustin-Jérôme Merle,596010,620123,2022-10-20
CASH_OUT,295719,Augustin-Jérôme Merle,620123,324404,Agence_mtn_Ouidah,300000,4281,2022-10-22
CASH_IN,205303,Agence_mtn_Abomey,300000,94697,Augustin-Jérôme Merle,324404,529707,2022-10-23
TRANSFER,631469,Danielle-Henriette Tessier,900900,269431,Augustin-Jérôme Merle,529707,1161176,2022-10-26
TRANSFER,40697,Gérard Cordier,268037,227340,Astrid de Pascal,348400,307703,2022-10-02
CASH_OUT,59313,Gérard Cordier,227340,168027,Agence_mtn_Cotonou,300000,240687,2022-10-02
TRANSFER,860751,Georges-Alfred Pruvost,1834200,973449,Gérard Cordier,168027,1028778,2022-10-02
CASH_OUT,364635,Gérard Cordier,1028778,664143,Agence_mtn_Ouidah,300000,-64635,2022-10-04
CASH_OUT,314288,Gérard Cordier,664143,349855,Agence_mtn_Cotonou,300000,-14288,2022-10-05
CASH_IN,224749,Agence_mtn_Ouidah,300000,75251,Gérard Cordier,349855,574604,2022-10-06
CASH_IN,160007,Agence_mtn_Cotonou,300000,139993,Gérard Cordier,574604,734611,2022-10-09
TRANSFER,1088441,Gilbert Moulin,1891900,803459,Gérard Cordier,734611,1823052,2022-10-09
CASH_OUT,644123,Gérard Cordier,1823052,1178929,Agence_mtn_Abomey,300000,-344123,2022-10-10
CASH_OUT,30456,Gérard Cordier,1178929,1148473,Agence_mtn_Abomey,300000,269544,2022-10-11
CASH_IN,82897,Agence_mtn_Ouidah,300000,217103,Gérard Cordier,1148473,1231370,2022-10-12
TRANSFER,344128,Thibault Martin,464895,120767,Gérard Cordier,1231370,1575498,2022-10-12
CASH_IN,235910,Agence_mtn_Cotonou,300000,64090,Gérard Cordier,1575498,1811408,2022-10-13
TRANSFER,1604306,Gérard Cordier,1811408,207102,Nicolas Blin,694100,-910206,2022-10-16
TRANSFER,909357,Corinne Roussel,1426200,516843,Gérard Cordier,207102,1116459,2022-10-16
CASH_OUT,720344,Gérard Cordier,1116459,396115,Agence_mtn_Cotonou,300000,-420344,2022-10-16
CASH_OUT,125980,Gérard Cordier,396115,270135,Agence_mtn_Cotonou,300000,174020,2022-10-18
CASH_OUT,183919,Gérard Cordier,270135,86216,Agence_mtn_Ouidah,300000,116081,2022-10-18
TRANSFER,787066,Charles Guérin,1256400,469334,Gérard Cordier,86216,873282,2022-10-19
CASH_IN,79599,Agence_mtn_Cotonou,300000,220401,Gérard Cordier,873282,952881,2022-10-20
CASH_IN,205927,Agence_mtn_Ouidah,300000,94073,Gérard Cordier,952881,1158808,2022-10-22
TRANSFER,10619,Gérard Cordier,1158808,1148189,Madeleine Hardy,1284400,1273781,2022-10-23
CASH_OUT,1098628,Gérard Cordier,1148189,49561,Agence_mtn_Cotonou,300000,-798628,2022-10-25
CASH_OUT,18379,Gérard Cordier,49561,31182,Agence_mtn_Cotonou,300000,281621,2022-10-26
CASH_IN,208104,Agence_mtn_Abomey,300000,91896,Gérard Cordier,31182,239286,2022-10-27
CASH_OUT,4386,Élise Monnier,16116,11730,Agence_mtn_Ouidah,300000,295614,2022-10-02
TRANSFER,1616,Élise Monnier,11730,10114,Roger-Roger Delmas,725900,724284,2022-10-05
TRANSFER,305027,Astrid de Pascal,307703,2676,Élise Monnier,10114,315141,2022-10-05
TRANSFER,250834,Élise Monnier,315141,64307,Sophie-Anouk Boulanger,104326,-146508,2022-10-07
CASH_IN,216588,Agence_mtn_Cotonou,300000,83412,Élise Monnier,64307,280895,2022-10-07
TRANSFER,65827,Anouk Delahaye-Gimenez,132800,66973,Élise Monnier,280895,346722,2022-10-08
TRANSFER,31003,Élise Monnier,346722,315719,Madeleine Hardy,1273781,1242778,2022-10-09
TRANSFER,189842,Élise Monnier,315719,125877,Thibault-Julien Chevallier,1313100,1123258,2022-10-10
TRANSFER,635592,Martin Moreau,823000,187408,Élise Monnier,125877,761469,2022-10-10
TRANSFER,427385,Jacques Le Marion,713400,286015,Élise Monnier,761469,1188854,2022-10-11
CASH_OUT,263192,Élise Monnier,1188854,925662,Agence_mtn_Ouidah,300000,36808,2022-10-12
CASH_OUT,261666,Élise Monnier,925662,663996,Agence_mtn_Cotonou,300000,38334,2022-10-14
TRANSFER,483456,Élise Monnier,663996,180540,Nathalie Da Silva,1681527,1198071,2022-10-16
CASH_OUT,123715,Élise Monnier,180540,56825,Agence_mtn_Cotonou,300000,176285,2022-10-18
TRANSFER,738509,Georges-Alfred Pruvost,973449,234940,Élise Monnier,56825,795334,2022-10-18
CASH_IN,151280,Agence_mtn_Cotonou,300000,148720,Élise Monnier,795334,946614,2022-10-19
CASH_OUT,827072,Élise Monnier,946614,119542,Agence_mtn_Ouidah,300000,-527072,2022-10-19
TRANSFER,328601,Maryse Delorme,395600,66999,Élise Monnier,119542,448143,2022-10-20
TRANSFER,107446,Élise Monnier,448143,340697,Éléonore Marin Le Morel,747381,639935,2022-10-20
CASH_IN,201814,Agence_mtn_Abomey,300000,98186,Élise Monnier,340697,542511,2022-10-22
CASH_OUT,142851,Élise Monnier,542511,399660,Agence_mtn_Abomey,300000,157149,2022-10-23
TRANSFER,671680,Georges Muller,758900,87220,Élise Monnier,399660,1071340,2022-10-27
CASH_OUT,3960,Nathalie Da Silva,1198071,1194111,Agence_mtn_Cotonou,300000,296040,2022-10-01
TRANSFER,374331,Madeleine Philippe-Grondin,413672,39341,Nathalie Da Silva,1194111,1568442,2022-10-02
CASH_IN,271622,Agence_mtn_Abomey,300000,28378,Nathalie Da Silva,1568442,1840064,2022-10-05
CASH_IN,260118,Agence_mtn_Abomey,300000,39882,Nathalie Da Silva,1840064,2100182,2022-10-05
CASH_IN,79541,Agence_mtn_Ouidah,300000,220459,Nathalie Da Silva,2100182,2179723,2022-10-06
CASH_OUT,363044,Nathalie Da Silva,2179723,1816679,Agence_mtn_Abomey,300000,-63044,2022-10-10
CASH_OUT,465565,Nathalie Da Silva,1816679,1351114,Agence_mtn_Cotonou,300000,-165565,2022-10-13
CASH_OUT,372452,Nathalie Da Silva,1351114,978662,Agence_mtn_Abomey,300000,-72452,2022-10-13
TRANSFER,389228,François Vaillant,686882,297654,Nathalie Da Silva,978662,1367890,2022-10-13
TRANSFER,11520,Océane Faure,57023,45503,Nathalie Da Silva,1367890,1379410,2022-10-14
CASH_IN,226259,Agence_mtn_Ouidah,300000,73741,Nathalie Da Silva,1379410,1605669,2022-10-15
TRANSFER,99223,Laurent Marion,146623,47400,Nathalie Da Silva,1605669,1704892,2022-10-18
TRANSFER,23212,Raymond de Le Roux,417500,394288,Nathalie Da Silva,1704892,1728104,2022-10-19
CASH_OUT,168223,Nathalie Da Silva,1728104,1559881,Agence_mtn_Abomey,300000,131777,2022-10-19
CASH_IN,21241,Agence_mtn_Abomey,300000,278759,Nathalie Da Silva,1559881,1581122,2022-10-19
TRANSFER,479060,Édouard Grondin du Fleury,975800,496740,Nathalie Da Silva,1581122,2060182,2022-10-20
CASH_IN,178405,Agence_mtn_Ouidah,300000,121595,Nathalie Da Silva,2060182,2238587,2022-10-21
CASH_IN,123742,Agence_mtn_Ouidah,300000,176258,Nathalie Da Silva,2238587,2362329,2022-10-22
TRANSFER,2177670,Nathalie Da Silva,2362329,184659,Hélène Blanchard-Renault,160400,-2017270,2022-10-22
TRANSFER,357107,Véronique Hardy,1259900,902793,Nathalie Da Silva,184659,541766,2022-10-23
CASH_OUT,125144,Nathalie Da Silva,541766,416622,Agence_mtn_Ouidah,300000,174856,2022-10-23
TRANSFER,384256,Nathalie Da Silva,416622,32366,Anouk Delahaye-Gimenez,66973,-317283,2022-10-27
TRANSFER,128879,Édouard Grondin du Fleury,496740,367861,Margaud-Michelle Briand,35400,-93479,2022-10-02
CASH_OUT,342309,Édouard Grondin du Fleury,367861,25552,Agence_mtn_Cotonou,300000,-42309,2022-10-04
TRANSFER,81323,Jules-Marc Chauvet,130700,49377,Édouard Grondin du Fleury,25552,106875,2022-10-04
CASH_OUT,10150,Édouard Grondin du Fleury,106875,96725,Agence_mtn_Abomey,300000,289850,2022-10-05
CASH_IN,161748,Agence_mtn_Abomey,300000,138252,Édouard Grondin du Fleury,96725,258473,2022-10-06
CASH_IN,153047,Agence_mtn_Cotonou,300000,146953,Édouard Grondin du Fleury,258473,411520,2022-10-06
TRANSFER,224213,Édouard Grondin du Fleury,411520,187307,Danielle-Henriette Tessier,269431,45218,2022-10-08
TRANSFER,161747,Édouard Grondin du Fleury,187307,25560,Maggie Barbier,1326981,1165234,2022-10-09
CASH_OUT,631,Édouard Grondin du Fleury,25560,24929,Agence_mtn_Ouidah,300000,299369,2022-10-09
CASH_OUT,6094,Édouard Grondin du Fleury,24929,18835,Agence_mtn_Abomey,300000,293906,2022-10-09
TRANSFER,173919,Georges-Alfred Pruvost,234940,61021,Édouard Grondin du Fleury,18835,192754,2022-10-10
CASH_OUT,120900,Édouard Grondin du Fleury,192754,71854,Agence_mtn_Abomey,300000,179100,2022-10-10
CASH_OUT,17465,Édouard Grondin du Fleury,71854,54389,Agence_mtn_Cotonou,300000,282535,2022-10-10
CASH_OUT,31839,Édouard Grondin du Fleury,54389,22550,Agence_mtn_Cotonou,300000,268161,2022-10-11
CASH_IN,243431,Agence_mtn_Abomey,300000,56569,Édouard Grondin du Fleury,22550,265981,2022-10-12
TRANSFER,78082,Nicole-Renée Gay,89304,11222,Édouard Grondin du Fleury,265981,344063,2022-10-13
TRANSFER,43082,Stéphanie Guichard,228183,185101,Édouard Grondin du Fleury,344063,387145,2022-10-16
CASH_OUT,154732,Édouard Grondin du Fleury,387145,232413,Agence_mtn_Cotonou,300000,145268,2022-10-17
CASH_OUT,152484,Édouard Grondin du Fleury,232413,79929,Agence_mtn_Cotonou,300000,147516,2022-10-19
CASH_IN,226034,Agence_mtn_Cotonou,300000,73966,Édouard Grondin du Fleury,79929,305963,2022-10-20
TRANSFER,171456,Édouard Grondin du Fleury,305963,134507,Charlotte Perrier,1363300,1191844,2022-10-21
TRANSFER,70430,Édouard Grondin du Fleury,134507,64077,Jacques Le Marion,286015,215585,2022-10-22
CASH_OUT,13622,Édouard Grondin du Fleury,64077,50455,Agence_mtn_Cotonou,300000,286378,2022-10-23
CASH_OUT,6942,Édouard Grondin du Fleury,50455,43513,Agence_mtn_Cotonou,300000,293058,2022-10-23
TRANSFER,12009,Océane Faure,45503,33494,Édouard Grondin du Fleury,43513,55522,2022-10-23
CASH_OUT,29445,Édouard Grondin du Fleury,55522,26077,Agence_mtn_Cotonou,300000,270555,2022-10-24
CASH_OUT,9884,Édouard Grondin du Fleury,26077,16193,Agence_mtn_Ouidah,300000,290116,2022-10-25
CASH_IN,57074,Agence_mtn_Abomey,300000,242926,Édouard Grondin du Fleury,16193,73267,2022-10-27
CASH_OUT,153382,Madeleine Hardy,1242778,1089396,Agence_mtn_Abomey,300000,146618,2022-10-01
TRANSFER,1012109,Madeleine Hardy,1089396,77287,Corinne Roussel,516843,-495266,2022-10-02
CASH_OUT,71007,Madeleine Hardy,77287,6280,Agence_mtn_Abomey,300000,228993,2022-10-02
CASH_IN,136406,Agence_mtn_Cotonou,300000,163594,Madeleine Hardy,6280,142686,2022-10-06
TRANSFER,45829,Madeleine Hardy,142686,96857,Astrid Aubert-Thierry,26000,-19829,2022-10-09
CASH_IN,85888,Agence_mtn_Cotonou,300000,214112,Madeleine Hardy,96857,182745,2022-10-11
CASH_IN,278914,Agence_mtn_Abomey,300000,21086,Madeleine Hardy,182745,461659,2022-10-11
TRANSFER,151949,Nicole Huet,1274700,1122751,Madeleine Hardy,461659,613608,2022-10-11
TRANSFER,16788,Danielle-Henriette Tessier,45218,28430,Madeleine Hardy,613608,630396,2022-10-12
CASH_IN,299383,Agence_mtn_Abomey,300000,617,Madeleine Hardy,630396,929779,2022-10-12
CASH_IN,250145,Agence_mtn_Cotonou,300000,49855,Madeleine Hardy,929779,1179924,2022-10-12
CASH_OUT,502830,Madeleine Hardy,1179924,677094,Agence_mtn_Ouidah,300000,-202830,2022-10-16
CASH_OUT,482208,Madeleine Hardy,677094,194886,Agence_mtn_Cotonou,300000,-182208,2022-10-20
TRANSFER,89972,Madeleine Hardy,194886,104914,Emmanuel Vallée,1877300,1787328,2022-10-20
CASH_IN,259288,Agence_mtn_Abomey,300000,40712,Madeleine Hardy,104914,364202,2022-10-21
CASH_OUT,259143,Madeleine Hardy,364202,105059,Agence_mtn_Abomey,300000,40857,2022-10-22
TRANSFER,576503,Alexandre Delaunay,1750110,1173607,Madeleine Hardy,105059,681562,2022-10-22
CASH_OUT,90007,Madeleine Hardy,681562,591555,Agence_mtn_Ouidah,300000,209993,2022-10-22
TRANSFER,164999,Madeleine Hardy,591555,426556,Maggie Barbier,1165234,1000235,2022-10-22
CASH_OUT,50859,Madeleine Hardy,426556,375697,Agence_mtn_Cotonou,300000,249141,2022-10-22
CASH_IN,70504,Agence_mtn_Abomey,300000,229496,Madeleine Hardy,375697,446201,2022-10-23
CASH_IN,155704,Agence_mtn_Cotonou,300000,144296,Madeleine Hardy,446201,601905,2022-10-24
CASH_IN,26562,Agence_mtn_Abomey,300000,273438,Madeleine Hardy,601905,628467,2022-10-24
CASH_OUT,281755,Madeleine Hardy,628467,346712,Agence_mtn_Ouidah,300000,18245,2022-10-24
CASH_OUT,226597,Madeleine Hardy,346712,120115,Agence_mtn_Abomey,300000,73403,2022-10-26
CASH_IN,199427,Agence_mtn_Cotonou,300000,100573,Madeleine Hardy,120115,319542,2022-10-26
TRANSFER,80233,Madeleine Hardy,319542,239309,Christine Rossi,683359,603126,2022-10-26
CASH_IN,106683,Agence_mtn_Ouidah,300000,193317,Madeleine Hardy,239309,345992,2022-10-27
CASH_OUT,52819,Madeleine Hardy,345992,293173,Agence_mtn_Cotonou,300000,247181,2022-10-27
CASH_OUT,11381,Danielle-Henriette Tessier,28430,17049,Agence_mtn_Abomey,300000,288619,2022-10-01
TRANSFER,613520,Jacques Marchand,954638,341118,Danielle-Henriette Tessier,17049,630569,2022-10-01
CASH_IN,110972,Agence_mtn_Cotonou,300000,189028,Danielle-Henriette Tessier,630569,741541,2022-10-01
TRANSFER,709971,Danielle-Henriette Tessier,741541,31570,Alexandre Blanchard,328000,-381971,2022-10-03
TRANSFER,14961,Danielle-Henriette Tessier,31570,16609,Sabine Perrier,88663,73702,2022-10-04
TRANSFER,45406,Raymond de Le Roux,394288,348882,Danielle-Henriette Tessier,16609,62015,2022-10-06
CASH_OUT,33274,Danielle-Henriette Tessier,62015,28741,Agence_mtn_Abomey,300000,266726,2022-10-07
CASH_IN,107427,Agence_mtn_Abomey,300000,192573,Danielle-Henriette Tessier,28741,136168,2022-10-08
CASH_OUT,36118,Danielle-Henriette Tessier,136168,100050,Agence_mtn_Cotonou,300000,263882,2022-10-08
CASH_IN,96260,Agence_mtn_Abomey,300000,203740,Danielle-Henriette Tessier,100050,196310,2022-10-09
CASH_IN,252240,Agence_mtn_Abomey,300000,47760,Danielle-Henriette Tessier,196310,448550,2022-10-10
CASH_OUT,290108,Danielle-Henriette Tessier,448550,158442,Agence_mtn_Cotonou,300000,9892,2022-10-11
CASH_IN,210091,Agence_mtn_Abomey,300000,89909,Danielle-Henriette Tessier,158442,368533,2022-10-11
CASH_OUT,148939,Danielle-Henriette Tessier,368533,219594,Agence_mtn_Abomey,300000,151061,2022-10-13
CASH_OUT,55887,Danielle-Henriette Tessier,219594,163707,Agence_mtn_Cotonou,300000,244113,2022-10-16
CASH_IN,111145,Agence_mtn_Abomey,300000,188855,Danielle-Henriette Tessier,163707,274852,2022-10-18
CASH_OUT,20596,Danielle-Henriette Tessier,274852,254256,Agence_mtn_Abomey,300000,279404,2022-10-20
TRANSFER,13787,Alfred Paris,1590492,1576705,Danielle-Henriette Tessier,254256,268043,2022-10-20
CASH_IN,84002,Agence_mtn_Cotonou,300000,215998,Danielle-Henriette Tessier,268043,352045,2022-10-20
CASH_IN,224476,Agence_mtn_Cotonou,300000,75524,Danielle-Henriette Tessier,352045,576521,2022-10-20
CASH_OUT,428726,Danielle-Henriette Tessier,576521,147795,Agence_mtn_Ouidah,300000,-128726,2022-10-22
CASH_OUT,79660,Danielle-Henriette Tessier,147795,68135,Agence_mtn_Ouidah,300000,220340,2022-10-22
TRANSFER,13707,Danielle-Henriette Tessier,68135,54428,Sabine Perrier,73702,59995,2022-10-23
CASH_IN,158466,Agence_mtn_Cotonou,300000,141534,Danielle-Henriette Tessier,54428,212894,2022-10-25
CASH_OUT,29793,Danielle-Henriette Tessier,212894,183101,Agence_mtn_Cotonou,300000,270207,2022-10-25
CASH_OUT,122018,Danielle-Henriette Tessier,183101,61083,Agence_mtn_Cotonou,300000,177982,2022-10-25
CASH_OUT,45106,Danielle-Henriette Tessier,61083,15977,Agence_mtn_Abomey,300000,254894,2022-10-26
CASH_OUT,5217,Danielle-Henriette Tessier,15977,10760,Agence_mtn_Ouidah,300000,294783,2022-10-27
CASH_OUT,9196,Danielle-Henriette Tessier,10760,1564,Agence_mtn_Abomey,300000,290804,2022-10-27
CASH_OUT,222028,Christine Rossi,603126,381098,Agence_mtn_Abomey,300000,77972,2022-10-01
TRANSFER,1058520,Gabrielle Hamon,1258400,199880,Christine Rossi,381098,1439618,2022-10-02
TRANSFER,165247,Maurice de Brunet,965227,799980,Christine Rossi,1439618,1604865,2022-10-02
CASH_OUT,1258509,Christine Rossi,1604865,346356,Agence_mtn_Cotonou,300000,-958509,2022-10-02
TRANSFER,330668,Christine Rossi,346356,15688,Gérard Blot de Blanc,550500,219832,2022-10-04
TRANSFER,387402,Julien Devaux,1485200,1097798,Christine Rossi,15688,403090,2022-10-10
CASH_IN,77462,Agence_mtn_Ouidah,300000,222538,Christine Rossi,403090,480552,2022-10-11
TRANSFER,431624,Élisabeth Blot-Bruneau,511085,79461,Christine Rossi,480552,912176,2022-10-12
TRANSFER,683680,Christine Rossi,912176,228496,Valérie de Pottier,1438283,754603,2022-10-15
CASH_IN,155737,Agence_mtn_Abomey,300000,144263,Christine Rossi,228496,384233,2022-10-16
CASH_IN,107056,Agence_mtn_Abomey,300000,192944,Christine Rossi,384233,491289,2022-10-16
CASH_OUT,19559,Christine Rossi,491289,471730,Agence_mtn_Ouidah,300000,280441,2022-10-17
CASH_OUT,316465,Christine Rossi,471730,155265,Agence_mtn_Abomey,300000,-16465,2022-10-17
CASH_OUT,136247,Christine Rossi,155265,19018,Agence_mtn_Ouidah,300000,163753,2022-10-18
CASH_OUT,9776,Christine Rossi,19018,9242,Agence_mtn_Abomey,300000,290224,2022-10-18
CASH_OUT,4491,Christine Rossi,9242,4751,Agence_mtn_Cotonou,300000,295509,2022-10-18
TRANSFER,108235,Céline-Inès Meunier,307400,199165,Christine Rossi,4751,112986,2022-10-21
CASH_IN,129238,Agence_mtn_Abomey,300000,170762,Christine Rossi,112986,242224,2022-10-21
TRANSFER,127057,Christine Rossi,242224,115167,Laurent Marion,47400,-79657,2022-10-22
CASH_IN,39741,Agence_mtn_Abomey,300000,260259,Christine Rossi,115167,154908,2022-10-22
TRANSFER,134481,Jacques Le Marion,215585,81104,Christine Rossi,154908,289389,2022-10-23
CASH_IN,136082,Agence_mtn_Cotonou,300000,163918,Christine Rossi,289389,425471,2022-10-24
TRANSFER,32321,Christine Rossi,425471,393150,Martin Moreau,187408,155087,2022-10-25
CASH_IN,43993,Agence_mtn_Ouidah,300000,256007,Christine Rossi,393150,437143,2022-10-26
CASH_IN,261355,Agence_mtn_Abomey,300000,38645,Christine Rossi,437143,698498,2022-10-26
CASH_OUT,234127,Christine Rossi,698498,464371,Agence_mtn_Abomey,300000,65873,2022-10-26
CASH_OUT,209023,Christine Rossi,464371,255348,Agence_mtn_Ouidah,300000,90977,2022-10-27
CASH_OUT,884839,Julien Devaux,1097798,212959,Agence_mtn_Cotonou,300000,-584839,2022-10-01
CASH_IN,227743,Agence_mtn_Abomey,300000,72257,Julien Devaux,212959,440702,2022-10-03
TRANSFER,115903,Zacharie Fabre,131640,15737,Julien Devaux,440702,556605,2022-10-04
CASH_OUT,338483,Julien Devaux,556605,218122,Agence_mtn_Cotonou,300000,-38483,2022-10-04
TRANSFER,168317,Julien Devaux,218122,49805,Aimé Bernier,948100,779783,2022-10-04
CASH_IN,114349,Agence_mtn_Cotonou,300000,185651,Julien Devaux,49805,164154,2022-10-05
TRANSFER,117544,Julien Devaux,164154,46610,Louise-Aurore Payet,991200,873656,2022-10-05
TRANSFER,22758,Julien Devaux,46610,23852,Clémence Dufour,63662,40904,2022-10-07
TRANSFER,10214,Julien Devaux,23852,13638,Alfred Paris,1576705,1566491,2022-10-12
TRANSFER,286422,Jacques Marchand,341118,54696,Julien Devaux,13638,300060,2022-10-12
CASH_OUT,14918,Julien Devaux,300060,285142,Agence_mtn_Abomey,300000,285082,2022-10-12
CASH_IN,115588,Agence_mtn_Cotonou,300000,184412,Julien Devaux,285142,400730,2022-10-14
TRANSFER,15180,Jacques Marchand,54696,39516,Julien Devaux,400730,415910,2022-10-15
CASH_IN,108109,Agence_mtn_Ouidah,300000,191891,Julien Devaux,415910,524019,2022-10-15
TRANSFER,29352,Madeleine Philippe-Grondin,39341,9989,Julien Devaux,524019,553371,2022-10-16
TRANSFER,194422,Margot Julien,239427,45005,Julien Devaux,553371,747793,2022-10-17
TRANSFER,49077,Sabine Perrier,59995,10918,Julien Devaux,747793,796870,2022-10-23
CASH_IN,211024,Agence_mtn_Cotonou,300000,88976,Julien Devaux,796870,1007894,2022-10-24
CASH_OUT,384807,Julien Devaux,1007894,623087,Agence_mtn_Cotonou,300000,-84807,2022-10-24
CASH_IN,234323,Agence_mtn_Ouidah,300000,65677,Julien Devaux,623087,857410,2022-10-24
TRANSFER,162460,Gérard Blot de Blanc,219832,57372,Julien Devaux,857410,1019870,2022-10-26
CASH_IN,279927,Agence_mtn_Cotonou,300000,20073,Julien Devaux,1019870,1299797,2022-10-27
CASH_OUT,17884,Aimé Bernier,779783,761899,Agence_mtn_Ouidah,300000,282116,2022-10-01
CASH_OUT,696961,Aimé Bernier,761899,64938,Agence_mtn_Ouidah,300000,-396961,2022-10-02
CASH_IN,173677,Agence_mtn_Abomey,300000,126323,Aimé Bernier,64938,238615,2022-10-02
CASH_OUT,91722,Aimé Bernier,238615,146893,Agence_mtn_Abomey,300000,208278,2022-10-03
CASH_OUT,47268,Aimé Bernier,146893,99625,Agence_mtn_Abomey,300000,252732,2022-10-04
CASH_IN,82382,Agence_mtn_Abomey,300000,217618,Aimé Bernier,99625,182007,2022-10-05
CASH_IN,139681,Agence_mtn_Cotonou,300000,160319,Aimé Bernier,182007,321688,2022-10-05
CASH_OUT,213022,Aimé Bernier,321688,108666,Agence_mtn_Abomey,300000,86978,2022-10-05
CASH_IN,61529,Agence_mtn_Cotonou,300000,238471,Aimé Bernier,108666,170195,2022-10-12
CASH_OUT,61617,Aimé Bernier,170195,108578,Agence_mtn_Cotonou,300000,238383,2022-10-13
CASH_OUT,20814,Aimé Bernier,108578,87764,Agence_mtn_Abomey,300000,279186,2022-10-13
CASH_IN,233942,Agence_mtn_Ouidah,300000,66058,Aimé Bernier,87764,321706,2022-10-14
CASH_OUT,161561,Aimé Bernier,321706,160145,Agence_mtn_Ouidah,300000,138439,2022-10-15
CASH_OUT,132184,Aimé Bernier,160145,27961,Agence_mtn_Cotonou,300000,167816,2022-10-15
CASH_OUT,14478,Aimé Bernier,27961,13483,Agence_mtn_Ouidah,300000,285522,2022-10-15
TRANSFER,272195,Raymond-Yves Boulanger,469900,197705,Aimé Bernier,13483,285678,2022-10-15
CASH_IN,18528,Agence_mtn_Abomey,300000,281472,Aimé Bernier,285678,304206,2022-10-16
TRANSFER,207204,Aimé Bernier,304206,97002,Martin Moreau,155087,-52117,2022-10-17
CASH_OUT,96935,Aimé Bernier,97002,67,Agence_mtn_Cotonou,300000,203065,2022-10-17
CASH_IN,51532,Agence_mtn_Ouidah,300000,248468,Aimé Bernier,67,51599,2022-10-17
CASH_IN,8273,Agence_mtn_Abomey,300000,291727,Aimé Bernier,51599,59872,2022-10-19
TRANSFER,526715,Maggie Barbier,1000235,473520,Aimé Bernier,59872,586587,2022-10-19
CASH_IN,4785,Agence_mtn_Abomey,300000,295215,Aimé Bernier,586587,591372,2022-10-25
TRANSFER,329070,Aimé Bernier,591372,262302,Madeleine Philippe-Grondin,9989,-319081,2022-10-25
CASH_IN,225465,Agence_mtn_Abomey,300000,74535,Aimé Bernier,262302,487767,2022-10-27
CASH_IN,40357,Agence_mtn_Ouidah,300000,259643,Astrid Aubert-Thierry,-19829,20528,2022-10-02
CASH_OUT,3105,Astrid Aubert-Thierry,20528,17423,Agence_mtn_Cotonou,300000,296895,2022-10-04
CASH_OUT,10562,Astrid Aubert-Thierry,17423,6861,Agence_mtn_Abomey,300000,289438,2022-10-06
CASH_OUT,4782,Astrid Aubert-Thierry,6861,2079,Agence_mtn_Ouidah,300000,295218,2022-10-06
TRANSFER,345399,Roger-Roger Delmas,724284,378885,Astrid Aubert-Thierry,2079,347478,2022-10-07
CASH_IN,122026,Agence_mtn_Cotonou,300000,177974,Astrid Aubert-Thierry,347478,469504,2022-10-09
CASH_OUT,25040,Astrid Aubert-Thierry,469504,444464,Agence_mtn_Cotonou,300000,274960,2022-10-10
CASH_IN,210073,Agence_mtn_Ouidah,300000,89927,Astrid Aubert-Thierry,444464,654537,2022-10-12
CASH_IN,92190,Agence_mtn_Cotonou,300000,207810,Astrid Aubert-Thierry,654537,746727,2022-10-13
CASH_OUT,184203,Astrid Aubert-Thierry,746727,562524,Agence_mtn_Abomey,300000,115797,2022-10-13
CASH_IN,6867,Agence_mtn_Ouidah,300000,293133,Astrid Aubert-Thierry,562524,569391,2022-10-14
TRANSFER,388730,Charles Guérin,469334,80604,Astrid Aubert-Thierry,569391,958121,2022-10-15
TRANSFER,147821,Astrid Aubert-Thierry,958121,810300,Éléonore Marin Le Morel,639935,492114,2022-10-15
CASH_OUT,726647,Astrid Aubert-Thierry,810300,83653,Agence_mtn_Cotonou,300000,-426647,2022-10-16
CASH_OUT,10980,Astrid Aubert-Thierry,83653,72673,Agence_mtn_Ouidah,300000,289020,2022-10-16
CASH_IN,147479,Agence_mtn_Abomey,300000,152521,Astrid Aubert-Thierry,72673,220152,2022-10-16
TRANSFER,53201,Astrid Aubert-Thierry,220152,166951,Thérèse-Juliette Camus,162827,109626,2022-10-17
CASH_IN,292949,Agence_mtn_Cotonou,300000,7051,Astrid Aubert-Thierry,166951,459900,2022-10-19
CASH_OUT,306358,Astrid Aubert-Thierry,459900,153542,Agence_mtn_Ouidah,300000,-6358,2022-10-19
CASH_OUT,87598,Astrid Aubert-Thierry,153542,65944,Agence_mtn_Cotonou,300000,212402,2022-10-19
TRANSFER,16013,Astrid Aubert-Thierry,65944,49931,Jacques Marchand,39516,23503,2022-10-21
CASH_OUT,16414,Astrid Aubert-Thierry,49931,33517,Agence_mtn_Abomey,300000,283586,2022-10-21
TRANSFER,355457,Maggie Barbier,473520,118063,Astrid Aubert-Thierry,33517,388974,2022-10-22
TRANSFER,48776,Astrid Aubert-Thierry,388974,340198,Sébastien Coste,1694500,1645724,2022-10-23
CASH_OUT,161175,Astrid Aubert-Thierry,340198,179023,Agence_mtn_Abomey,300000,138825,2022-10-24
TRANSFER,75560,Céline-Inès Meunier,199165,123605,Astrid Aubert-Thierry,179023,254583,2022-10-25
CASH_OUT,26541,Astrid Aubert-Thierry,254583,228042,Agence_mtn_Abomey,300000,273459,2022-10-25
CASH_IN,36298,Agence_mtn_Ouidah,300000,263702,Astrid Aubert-Thierry,228042,264340,2022-10-25
TRANSFER,195981,Gabrielle Hamon,199880,3899,Astrid Aubert-Thierry,264340,460321,2022-10-26
TRANSFER,287015,Michelle de la Daniel,560769,273754,Éléonore Marin Le Morel,492114,779129,2022-10-01
TRANSFER,180602,Éléonore Marin Le Morel,779129,598527,Océane Faure,33494,-147108,2022-10-02
CASH_IN,180766,Agence_mtn_Abomey,300000,119234,Éléonore Marin Le Morel,598527,779293,2022-10-02
CASH_IN,216479,Agence_mtn_Ouidah,300000,83521,Éléonore Marin Le Morel,779293,995772,2022-10-05
CASH_OUT,138893,Éléonore Marin Le Morel,995772,856879,Agence_mtn_Cotonou,300000,161107,2022-10-08
CASH_OUT,103207,Éléonore Marin Le Morel,856879,753672,Agence_mtn_Cotonou,300000,196793,2022-10-11
TRANSFER,554805,Éléonore Marin Le Morel,753672,198867,Michelle de la Daniel,273754,-281051,2022-10-12
CASH_IN,115288,Agence_mtn_Cotonou,300000,184712,Éléonore Marin Le Morel,198867,314155,2022-10-13
TRANSFER,13960,Jacques Marchand,23503,9543,Éléonore Marin Le Morel,314155,328115,2022-10-13
TRANSFER,258622,Éléonore Marin Le Morel,328115,69493,Sébastien Coste,1645724,1387102,2022-10-16
CASH_OUT,22658,Éléonore Marin Le Morel,69493,46835,Agence_mtn_Abomey,300000,277342,2022-10-16
TRANSFER,27427,Gérard Blot de Blanc,57372,29945,Éléonore Marin Le Morel,46835,74262,2022-10-16
CASH_IN,120236,Agence_mtn_Abomey,300000,179764,Éléonore Marin Le Morel,74262,194498,2022-10-17
CASH_IN,64543,Agence_mtn_Cotonou,300000,235457,Éléonore Marin Le Morel,194498,259041,2022-10-17
CASH_IN,234034,Agence_mtn_Abomey,300000,65966,Éléonore Marin Le Morel,259041,493075,2022-10-18
CASH_IN,67630,Agence_mtn_Abomey,300000,232370,Éléonore Marin Le Morel,493075,560705,2022-10-18
TRANSFER,421749,Éléonore Marin Le Morel,560705,138956,Gilbert Moulin,803459,381710,2022-10-20
CASH_OUT,41433,Éléonore Marin Le Morel,138956,97523,Agence_mtn_Abomey,300000,258567,2022-10-22
CASH_IN,284486,Agence_mtn_Cotonou,300000,15514,Éléonore Marin Le Morel,97523,382009,2022-10-22
CASH_OUT,241005,Éléonore Marin Le Morel,382009,141004,Agence_mtn_Abomey,300000,58995,2022-10-24
CASH_IN,134948,Agence_mtn_Ouidah,300000,165052,Éléonore Marin Le Morel,141004,275952,2022-10-26
CASH_IN,227004,Agence_mtn_Abomey,300000,72996,Océane Faure,-147108,79896,2022-10-01
CASH_OUT,2781,Océane Faure,79896,77115,Agence_mtn_Abomey,300000,297219,2022-10-03
TRANSFER,1236246,Sébastien Coste,1387102,150856,Océane Faure,77115,1313361,2022-10-05
CASH_IN,60510,Agence_mtn_Abomey,300000,239490,Océane Faure,1313361,1373871,2022-10-05
TRANSFER,45234,Céline-Inès Meunier,123605,78371,Océane Faure,1373871,1419105,2022-10-05
CASH_IN,4642,Agence_mtn_Ouidah,300000,295358,Océane Faure,1419105,1423747,2022-10-07
CASH_OUT,1137661,Océane Faure,1423747,286086,Agence_mtn_Ouidah,300000,-837661,2022-10-07
CASH_IN,18743,Agence_mtn_Abomey,300000,281257,Océane Faure,286086,304829,2022-10-08
TRANSFER,299454,Océane Faure,304829,5375,Véronique Hardy,902793,603339,2022-10-09
CASH_OUT,2536,Océane Faure,5375,2839,Agence_mtn_Abomey,300000,297464,2022-10-12
TRANSFER,1968,Océane Faure,2839,871,Océane Faure,2839,4807,2022-10-14
TRANSFER,55084,Maggie Barbier,118063,62979,Océane Faure,871,55955,2022-10-14
CASH_IN,170234,Agence_mtn_Ouidah,300000,129766,Océane Faure,55955,226189,2022-10-15
TRANSFER,4944,Sabine Perrier,10918,5974,Océane Faure,226189,231133,2022-10-15
CASH_IN,153919,Agence_mtn_Ouidah,300000,146081,Océane Faure,231133,385052,2022-10-18
CASH_IN,241271,Agence_mtn_Abomey,300000,58729,Océane Faure,385052,626323,2022-10-21
TRANSFER,2843,Clémence Dufour,40904,38061,Océane Faure,626323,629166,2022-10-21
CASH_IN,61797,Agence_mtn_Abomey,300000,238203,Océane Faure,629166,690963,2022-10-21
CASH_OUT,631765,Océane Faure,690963,59198,Agence_mtn_Abomey,300000,-331765,2022-10-24
CASH_OUT,27437,Océane Faure,59198,31761,Agence_mtn_Ouidah,300000,272563,2022-10-26
TRANSFER,680488,Charlotte Perrier,1191844,511356,Océane Faure,31761,712249,2022-10-27
TRANSFER,681800,Louise-Aurore Payet,873656,191856,Gérard Blot de Blanc,29945,-651855,2022-10-02
CASH_IN,21099,Agence_mtn_Cotonou,300000,278901,Louise-Aurore Payet,191856,212955,2022-10-02
CASH_IN,251895,Agence_mtn_Abomey,300000,48105,Louise-Aurore Payet,212955,464850,2022-10-02
TRANSFER,111428,Stéphanie Guichard,185101,73673,Louise-Aurore Payet,464850,576278,2022-10-02
CASH_IN,82848,Agence_mtn_Cotonou,300000,217152,Louise-Aurore Payet,576278,659126,2022-10-02
CASH_OUT,189091,Louise-Aurore Payet,659126,470035,Agence_mtn_Cotonou,300000,110909,2022-10-04
CASH_OUT,46968,Louise-Aurore Payet,470035,423067,Agence_mtn_Cotonou,300000,253032,2022-10-04
CASH_IN,106030,Agence_mtn_Ouidah,300000,193970,Louise-Aurore Payet,423067,529097,2022-10-04
TRANSFER,23957,Clémence Dufour,38061,14104,Louise-Aurore Payet,529097,553054,2022-10-05
TRANSFER,49318,Jacques Le Marion,81104,31786,Louise-Aurore Payet,553054,602372,2022-10-07
CASH_OUT,85673,Louise-Aurore Payet,602372,516699,Agence_mtn_Cotonou,300000,214327,2022-10-09
TRANSFER,262399,Louise-Aurore Payet,516699,254300,Charles Guérin,80604,-181795,2022-10-10
CASH_OUT,157362,Louise-Aurore Payet,254300,96938,Agence_mtn_Ouidah,300000,142638,2022-10-11
TRANSFER,40217,Louise-Aurore Payet,96938,56721,Nicole-Renée Gay,11222,-28995,2022-10-13
CASH_OUT,38559,Louise-Aurore Payet,56721,18162,Agence_mtn_Ouidah,300000,261441,2022-10-13
CASH_OUT,1970,Louise-Aurore Payet,18162,16192,Agence_mtn_Ouidah,300000,298030,2022-10-14
CASH_OUT,3114,Louise-Aurore Payet,16192,13078,Agence_mtn_Abomey,300000,296886,2022-10-16
CASH_OUT,5090,Louise-Aurore Payet,13078,7988,Agence_mtn_Abomey,300000,294910,2022-10-18
TRANSFER,4999,Louise-Aurore Payet,7988,2989,Maurice de Brunet,799980,794981,2022-10-19
CASH_OUT,1806,Louise-Aurore Payet,2989,1183,Agence_mtn_Cotonou,300000,298194,2022-10-19
CASH_IN,195931,Agence_mtn_Abomey,300000,104069,Louise-Aurore Payet,1183,197114,2022-10-19
CASH_OUT,104078,Louise-Aurore Payet,197114,93036,Agence_mtn_Abomey,300000,195922,2022-10-19
TRANSFER,59374,Georges-Alfred Pruvost,61021,1647,Louise-Aurore Payet,93036,152410,2022-10-21
CASH_IN,278259,Agence_mtn_Cotonou,300000,21741,Louise-Aurore Payet,152410,430669,2022-10-23
CASH_IN,73649,Agence_mtn_Abomey,300000,226351,Louise-Aurore Payet,430669,504318,2022-10-24
CASH_OUT,139545,Louise-Aurore Payet,504318,364773,Agence_mtn_Cotonou,300000,160455,2022-10-26
TRANSFER,160475,Louise-Aurore Payet,364773,204298,Guy-Augustin Pinto,504500,344025,2022-10-26
CASH_OUT,102096,Louise-Aurore Payet,204298,102202,Agence_mtn_Cotonou,300000,197904,2022-10-26
CASH_OUT,85836,Louise-Aurore Payet,102202,16366,Agence_mtn_Ouidah,300000,214164,2022-10-27
CASH_IN,178491,Agence_mtn_Abomey,300000,121509,Alexandre Blanchard,-381971,-203480,2022-10-04
CASH_IN,107842,Agence_mtn_Ouidah,300000,192158,Alexandre Blanchard,-203480,-95638,2022-10-05
CASH_IN,281717,Agence_mtn_Ouidah,300000,18283,Alexandre Blanchard,-95638,186079,2022-10-06
CASH_IN,248291,Agence_mtn_Cotonou,300000,51709,Alexandre Blanchard,186079,434370,2022-10-07
CASH_OUT,179381,Alexandre Blanchard,434370,254989,Agence_mtn_Abomey,300000,120619,2022-10-09
CASH_OUT,118178,Alexandre Blanchard,254989,136811,Agence_mtn_Cotonou,300000,181822,2022-10-09
TRANSFER,811635,Nicole Huet,1122751,311116,Alexandre Blanchard,136811,948446,2022-10-10
CASH_OUT,592126,Alexandre Blanchard,948446,356320,Agence_mtn_Abomey,300000,-292126,2022-10-11
CASH_OUT,247681,Alexandre Blanchard,356320,108639,Agence_mtn_Abomey,300000,52319,2022-10-12
CASH_OUT,108043,Alexandre Blanchard,108639,596,Agence_mtn_Cotonou,300000,191957,2022-10-15
CASH_IN,181591,Agence_mtn_Cotonou,300000,118409,Alexandre Blanchard,596,182187,2022-10-15
CASH_IN,162037,Agence_mtn_Abomey,300000,137963,Alexandre Blanchard,182187,344224,2022-10-15
CASH_IN,206419,Agence_mtn_Abomey,300000,93581,Alexandre Blanchard,344224,550643,2022-10-21
TRANSFER,122,Matthieu Cousin,575,453,Alexandre Blanchard,550643,550765,2022-10-22
CASH_OUT,409700,Alexandre Blanchard,550765,141065,Agence_mtn_Abomey,300000,-109700,2022-10-23
TRANSFER,27887,Alexandre Blanchard,141065,113178,François Vaillant,297654,269767,2022-10-25
CASH_OUT,75746,Alexandre Blanchard,113178,37432,Agence_mtn_Ouidah,300000,224254,2022-10-25
TRANSFER,1794,Alexandre Blanchard,37432,35638,Maurice de Brunet,794981,793187,2022-10-25
TRANSFER,6091,Alexandre Blanchard,35638,29547,Élisabeth Blot-Bruneau,79461,73370,2022-10-26
CASH_OUT,29316,Alexandre Blanchard,29547,231,Agence_mtn_Abomey,300000,270684,2022-10-27
TRANSFER,119274,Guy-Augustin Pinto,344025,224751,Alexandre Blanchard,231,119505,2022-10-27
CASH_OUT,66080,Alexandre Blanchard,119505,53425,Agence_mtn_Cotonou,300000,233920,2022-10-27
CASH_IN,89494,Agence_mtn_Abomey,300000,210506,Raymond-Yves Boulanger,197705,287199,2022-10-02
CASH_IN,117167,Agence_mtn_Cotonou,300000,182833,Raymond-Yves Boulanger,287199,404366,2022-10-02
CASH_OUT,374211,Raymond-Yves Boulanger,404366,30155,Agence_mtn_Ouidah,300000,-74211,2022-10-03
CASH_OUT,27190,Raymond-Yves Boulanger,30155,2965,Agence_mtn_Ouidah,300000,272810,2022-10-04
CASH_OUT,2751,Raymond-Yves Boulanger,2965,214,Agence_mtn_Ouidah,300000,297249,2022-10-05
TRANSFER,133,Raymond-Yves Boulanger,214,81,Alexandre Delaunay,1173607,1173474,2022-10-06
CASH_IN,65382,Agence_mtn_Cotonou,300000,234618,Raymond-Yves Boulanger,81,65463,2022-10-09
TRANSFER,5932,Raymond-Yves Boulanger,65463,59531,Maryse Delorme,66999,61067,2022-10-10
TRANSFER,150674,Sébastien Coste,150856,182,Raymond-Yves Boulanger,59531,210205,2022-10-10
CASH_IN,163703,Agence_mtn_Abomey,300000,136297,Raymond-Yves Boulanger,210205,373908,2022-10-12
TRANSFER,16096,Jacques Le Marion,31786,15690,Raymond-Yves Boulanger,373908,390004,2022-10-13
CASH_IN,41229,Agence_mtn_Cotonou,300000,258771,Raymond-Yves Boulanger,390004,431233,2022-10-14
TRANSFER,41288,Raymond-Yves Boulanger,431233,389945,Élisabeth Blot-Bruneau,73370,32082,2022-10-15
CASH_OUT,287761,Raymond-Yves Boulanger,389945,102184,Agence_mtn_Ouidah,300000,12239,2022-10-17
CASH_OUT,98267,Raymond-Yves Boulanger,102184,3917,Agence_mtn_Ouidah,300000,201733,2022-10-19
TRANSFER,644,Raymond-Yves Boulanger,3917,3273,Raymond-Yves Boulanger,3917,3273,2022-10-20
CASH_OUT,2917,Raymond-Yves Boulanger,3273,356,Agence_mtn_Cotonou,300000,297083,2022-10-20
CASH_IN,60645,Agence_mtn_Ouidah,300000,239355,Raymond-Yves Boulanger,356,61001,2022-10-21
CASH_OUT,49707,Raymond-Yves Boulanger,61001,11294,Agence_mtn_Abomey,300000,250293,2022-10-21
CASH_IN,283980,Agence_mtn_Cotonou,300000,16020,Raymond-Yves Boulanger,11294,295274,2022-10-23
TRANSFER,10952,Clémence Dufour,14104,3152,Raymond-Yves Boulanger,295274,306226,2022-10-25
CASH_OUT,121969,Raymond-Yves Boulanger,306226,184257,Agence_mtn_Ouidah,300000,178031,2022-10-25
CASH_IN,90825,Agence_mtn_Cotonou,300000,209175,Raymond-Yves Boulanger,184257,275082,2022-10-25
TRANSFER,3295,Sabine Perrier,5974,2679,Guy-Augustin Pinto,224751,228046,2022-10-01
TRANSFER,103695,Guy-Augustin Pinto,228046,124351,Thibault Martin,120767,17072,2022-10-01
CASH_IN,220605,Agence_mtn_Ouidah,300000,79395,Guy-Augustin Pinto,124351,344956,2022-10-02
CASH_OUT,162884,Guy-Augustin Pinto,344956,182072,Agence_mtn_Cotonou,300000,137116,2022-10-04
CASH_IN,151223,Agence_mtn_Ouidah,300000,148777,Guy-Augustin Pinto,182072,333295,2022-10-04
CASH_IN,249950,Agence_mtn_Cotonou,300000,50050,Guy-Augustin Pinto,333295,583245,2022-10-04
CASH_OUT,183804,Guy-Augustin Pinto,583245,399441,Agence_mtn_Ouidah,300000,116196,2022-10-04
CASH_OUT,246098,Guy-Augustin Pinto,399441,153343,Agence_mtn_Ouidah,300000,53902,2022-10-05
CASH_OUT,132546,Guy-Augustin Pinto,153343,20797,Agence_mtn_Ouidah,300000,167454,2022-10-06
TRANSFER,8391,Guy-Augustin Pinto,20797,12406,Valérie de Pottier,754603,746212,2022-10-06
TRANSFER,280538,Sylvie Dupré,830920,550382,Guy-Augustin Pinto,12406,292944,2022-10-08
CASH_IN,131383,Agence_mtn_Abomey,300000,168617,Guy-Augustin Pinto,292944,424327,2022-10-08
TRANSFER,10260,Zacharie Fabre,15737,5477,Guy-Augustin Pinto,424327,434587,2022-10-10
CASH_IN,196571,Agence_mtn_Ouidah,300000,103429,Guy-Augustin Pinto,434587,631158,2022-10-13
CASH_OUT,369387,Guy-Augustin Pinto,631158,261771,Agence_mtn_Cotonou,300000,-69387,2022-10-14
TRANSFER,871,Gabrielle Hamon,3899,3028,Guy-Augustin Pinto,261771,262642,2022-10-14
TRANSFER,181492,Aurélie Maury,571700,390208,Guy-Augustin Pinto,262642,444134,2022-10-19
CASH_IN,254938,Agence_mtn_Abomey,300000,45062,Guy-Augustin Pinto,444134,699072,2022-10-23
CASH_IN,134897,Agence_mtn_Abomey,300000,165103,Guy-Augustin Pinto,699072,833969,2022-10-23
CASH_OUT,399834,Guy-Augustin Pinto,833969,434135,Agence_mtn_Ouidah,300000,-99834,2022-10-24
CASH_IN,270276,Agence_mtn_Ouidah,300000,29724,Guy-Augustin Pinto,434135,704411,2022-10-24
CASH_IN,52566,Agence_mtn_Ouidah,300000,247434,Guy-Augustin Pinto,704411,756977,2022-10-25
CASH_OUT,179649,Guy-Augustin Pinto,756977,577328,Agence_mtn_Cotonou,300000,120351,2022-10-26
CASH_OUT,331885,Guy-Augustin Pinto,577328,245443,Agence_mtn_Ouidah,300000,-31885,2022-10-26
CASH_OUT,219404,Guy-Augustin Pinto,245443,26039,Agence_mtn_Cotonou,300000,80596,2022-10-26
CASH_IN,82382,Agence_mtn_Cotonou,300000,217618,Margaud-Michelle Briand,-93479,-11097,2022-10-02
CASH_IN,4284,Agence_mtn_Abomey,300000,295716,Margaud-Michelle Briand,-11097,-6813,2022-10-03
CASH_IN,165155,Agence_mtn_Abomey,300000,134845,Margaud-Michelle Briand,-6813,158342,2022-10-04
CASH_IN,29315,Agence_mtn_Ouidah,300000,270685,Margaud-Michelle Briand,158342,187657,2022-10-05
CASH_IN,297371,Agence_mtn_Ouidah,300000,2629,Margaud-Michelle Briand,187657,485028,2022-10-05
CASH_OUT,176545,Margaud-Michelle Briand,485028,308483,Agence_mtn_Cotonou,300000,123455,2022-10-09
TRANSFER,549,Sabine Perrier,2679,2130,Margaud-Michelle Briand,308483,309032,2022-10-13
CASH_OUT,223864,Margaud-Michelle Briand,309032,85168,Agence_mtn_Cotonou,300000,76136,2022-10-14
CASH_OUT,71372,Margaud-Michelle Briand,85168,13796,Agence_mtn_Ouidah,300000,228628,2022-10-15
TRANSFER,7356,Margaud-Michelle Briand,13796,6440,Alexandre Delaunay,1173474,1166118,2022-10-15
TRANSFER,5087,Margaud-Michelle Briand,6440,1353,Margaud-Michelle Briand,6440,11527,2022-10-17
CASH_OUT,1090,Margaud-Michelle Briand,1353,263,Agence_mtn_Abomey,300000,298910,2022-10-19
TRANSFER,257405,Sylvie Dupré,550382,292977,Margaud-Michelle Briand,263,257668,2022-10-22
CASH_IN,64277,Agence_mtn_Cotonou,300000,235723,Margaud-Michelle Briand,257668,321945,2022-10-22
TRANSFER,40502,Margaud-Michelle Briand,321945,281443,Christophe Teixeira,894300,853798,2022-10-24
TRANSFER,38769,Margaud-Michelle Briand,281443,242674,Élisabeth Blot-Bruneau,32082,-6687,2022-10-26
CASH_OUT,65629,Margaud-Michelle Briand,242674,177045,Agence_mtn_Abomey,300000,234371,2022-10-27
CASH_IN,259955,Agence_mtn_Cotonou,300000,40045,Stéphanie Guichard,73673,333628,2022-10-03
CASH_IN,169659,Agence_mtn_Ouidah,300000,130341,Stéphanie Guichard,333628,503287,2022-10-04
TRANSFER,158,Sébastien Coste,182,24,Stéphanie Guichard,503287,503445,2022-10-05
CASH_IN,51136,Agence_mtn_Cotonou,300000,248864,Stéphanie Guichard,503445,554581,2022-10-09
CASH_OUT,226947,Stéphanie Guichard,554581,327634,Agence_mtn_Abomey,300000,73053,2022-10-11
CASH_OUT,177880,Stéphanie Guichard,327634,149754,Agence_mtn_Abomey,300000,122120,2022-10-12
CASH_IN,205280,Agence_mtn_Abomey,300000,94720,Stéphanie Guichard,149754,355034,2022-10-14
TRANSFER,37417,Sylvie Dupré,292977,255560,Stéphanie Guichard,355034,392451,2022-10-14
CASH_OUT,11986,Stéphanie Guichard,392451,380465,Agence_mtn_Cotonou,300000,288014,2022-10-15
CASH_OUT,231017,Stéphanie Guichard,380465,149448,Agence_mtn_Abomey,300000,68983,2022-10-16
CASH_OUT,132076,Stéphanie Guichard,149448,17372,Agence_mtn_Cotonou,300000,167924,2022-10-16
CASH_OUT,10789,Stéphanie Guichard,17372,6583,Agence_mtn_Abomey,300000,289211,2022-10-17
CASH_OUT,3997,Stéphanie Guichard,6583,2586,Agence_mtn_Ouidah,300000,296003,2022-10-19
CASH_OUT,972,Stéphanie Guichard,2586,1614,Agence_mtn_Cotonou,300000,299028,2022-10-22
CASH_IN,229132,Agence_mtn_Ouidah,300000,70868,Stéphanie Guichard,1614,230746,2022-10-24
CASH_OUT,197359,Stéphanie Guichard,230746,33387,Agence_mtn_Cotonou,300000,102641,2022-10-26
TRANSFER,16073,Stéphanie Guichard,33387,17314,Céline-Inès Meunier,78371,62298,2022-10-26
CASH_IN,107446,Agence_mtn_Abomey,300000,192554,Laurent Marion,-79657,27789,2022-10-03
TRANSFER,558218,Christophe Teixeira,853798,295580,Laurent Marion,27789,586007,2022-10-08
CASH_IN,170573,Agence_mtn_Cotonou,300000,129427,Laurent Marion,586007,756580,2022-10-11
TRANSFER,24404,Maryse Delorme,61067,36663,Laurent Marion,756580,780984,2022-10-11
CASH_OUT,131772,Laurent Marion,780984,649212,Agence_mtn_Ouidah,300000,168228,2022-10-14
CASH_IN,752,Agence_mtn_Cotonou,300000,299248,Laurent Marion,649212,649964,2022-10-16
CASH_IN,119600,Agence_mtn_Ouidah,300000,180400,Laurent Marion,649964,769564,2022-10-16
TRANSFER,501107,Laurent Marion,769564,268457,Alfred Paris,1566491,1065384,2022-10-19
CASH_OUT,317605,Charlotte Perrier,511356,193751,Agence_mtn_Cotonou,300000,-17605,2022-10-01
TRANSFER,65226,Charlotte Perrier,193751,128525,Jules-Marc Chauvet,49377,-15849,2022-10-03
CASH_IN,181634,Agence_mtn_Abomey,300000,118366,Charlotte Perrier,128525,310159,2022-10-04
CASH_IN,117317,Agence_mtn_Abomey,300000,182683,Charlotte Perrier,310159,427476,2022-10-05
CASH_OUT,159383,Charlotte Perrier,427476,268093,Agence_mtn_Cotonou,300000,140617,2022-10-07
CASH_OUT,21921,Charlotte Perrier,268093,246172,Agence_mtn_Ouidah,300000,278079,2022-10-07
CASH_OUT,45142,Charlotte Perrier,246172,201030,Agence_mtn_Abomey,300000,254858,2022-10-07
CASH_OUT,157512,Charlotte Perrier,201030,43518,Agence_mtn_Cotonou,300000,142488,2022-10-08
CASH_IN,158374,Agence_mtn_Cotonou,300000,141626,Charlotte Perrier,43518,201892,2022-10-08
TRANSFER,338695,Raymond de Le Roux,348882,10187,Charlotte Perrier,201892,540587,2022-10-09
TRANSFER,506277,Charlotte Perrier,540587,34310,Valérie de Pottier,746212,239935,2022-10-13
CASH_IN,259558,Agence_mtn_Abomey,300000,40442,Charlotte Perrier,34310,293868,2022-10-17
CASH_IN,258986,Agence_mtn_Abomey,300000,41014,Charlotte Perrier,293868,552854,2022-10-25
CASH_OUT,110153,Charlotte Perrier,552854,442701,Agence_mtn_Ouidah,300000,189847,2022-10-26
CASH_IN,51313,Agence_mtn_Ouidah,300000,248687,Nicolas Blin,-910206,-858893,2022-10-01
CASH_IN,136261,Agence_mtn_Ouidah,300000,163739,Nicolas Blin,-858893,-722632,2022-10-02
CASH_IN,266822,Agence_mtn_Cotonou,300000,33178,Nicolas Blin,-722632,-455810,2022-10-04
CASH_IN,164742,Agence_mtn_Abomey,300000,135258,Nicolas Blin,-455810,-291068,2022-10-08
CASH_IN,230248,Agence_mtn_Cotonou,300000,69752,Nicolas Blin,-291068,-60820,2022-10-10
CASH_IN,181357,Agence_mtn_Cotonou,300000,118643,Nicolas Blin,-60820,120537,2022-10-10
TRANSFER,73638,Nicolas Blin,120537,46899,Nicole Huet,311116,237478,2022-10-14
CASH_IN,180503,Agence_mtn_Cotonou,300000,119497,Nicolas Blin,46899,227402,2022-10-15
TRANSFER,37726,Nicolas Blin,227402,189676,Aurélie Maury,390208,352482,2022-10-16
CASH_OUT,75432,Nicolas Blin,189676,114244,Agence_mtn_Abomey,300000,224568,2022-10-18
CASH_OUT,52465,Nicolas Blin,114244,61779,Agence_mtn_Cotonou,300000,247535,2022-10-24
TRANSFER,67681,Thérèse-Juliette Camus,109626,41945,Sabine Perrier,2130,-65551,2022-10-01
CASH_OUT,30623,Thérèse-Juliette Camus,41945,11322,Agence_mtn_Ouidah,300000,269377,2022-10-02
CASH_OUT,4917,Thérèse-Juliette Camus,11322,6405,Agence_mtn_Cotonou,300000,295083,2022-10-04
CASH_IN,246268,Agence_mtn_Abomey,300000,53732,Thérèse-Juliette Camus,6405,252673,2022-10-05
CASH_IN,125795,Agence_mtn_Cotonou,300000,174205,Thérèse-Juliette Camus,252673,378468,2022-10-16
CASH_IN,269943,Agence_mtn_Cotonou,300000,30057,Thérèse-Juliette Camus,378468,648411,2022-10-18
CASH_OUT,302180,Thérèse-Juliette Camus,648411,346231,Agence_mtn_Abomey,300000,-2180,2022-10-25
CASH_IN,132141,Agence_mtn_Cotonou,300000,167859,Thérèse-Juliette Camus,346231,478372,2022-10-26
CASH_IN,180729,Agence_mtn_Abomey,300000,119271,Céline-Inès Meunier,62298,243027,2022-10-01
CASH_IN,63681,Agence_mtn_Cotonou,300000,236319,Céline-Inès Meunier,243027,306708,2022-10-02
TRANSFER,1213,Gabrielle Hamon,3028,1815,Céline-Inès Meunier,306708,307921,2022-10-05
TRANSFER,125002,Céline-Inès Meunier,307921,182919,Matthieu Cousin,453,-124549,2022-10-08
CASH_OUT,70695,Céline-Inès Meunier,182919,112224,Agence_mtn_Ouidah,300000,229305,2022-10-11
TRANSFER,110484,Céline-Inès Meunier,112224,1740,Emmanuel Vallée,1787328,1676844,2022-10-11
CASH_OUT,556,Céline-Inès Meunier,1740,1184,Agence_mtn_Ouidah,300000,299444,2022-10-13
TRANSFER,35082,Maggie Barbier,62979,27897,Céline-Inès Meunier,1184,36266,2022-10-14
TRANSFER,4409,Thibault Martin,17072,12663,Céline-Inès Meunier,36266,40675,2022-10-17
CASH_OUT,5226,Céline-Inès Meunier,40675,35449,Agence_mtn_Ouidah,300000,294774,2022-10-17
TRANSFER,31102,Céline-Inès Meunier,35449,4347,Astrid de Pascal,2676,-28426,2022-10-20
CASH_OUT,1058,Céline-Inès Meunier,4347,3289,Agence_mtn_Abomey,300000,298942,2022-10-24
TRANSFER,268330,Maurice de Brunet,793187,524857,Thibault-Julien Chevallier,1123258,1391588,2022-10-03
CASH_IN,2681,Agence_mtn_Ouidah,300000,297319,Thibault-Julien Chevallier,1391588,1394269,2022-10-08
CASH_OUT,255367,Thibault-Julien Chevallier,1394269,1138902,Agence_mtn_Ouidah,300000,44633,2022-10-09
CASH_OUT,173671,Thibault-Julien Chevallier,1138902,965231,Agence_mtn_Ouidah,300000,126329,2022-10-11
TRANSFER,1771,Maryse Delorme,36663,34892,Thibault-Julien Chevallier,965231,967002,2022-10-13
TRANSFER,923695,Thibault-Julien Chevallier,967002,43307,Aurélie Maury,352482,-571213,2022-10-17
TRANSFER,98772,Valérie de Pottier,239935,141163,Thibault-Julien Chevallier,43307,142079,2022-10-20
TRANSFER,87661,Thibault-Julien Chevallier,142079,54418,Roger-Roger Delmas,378885,291224,2022-10-21
TRANSFER,45417,Thibault-Julien Chevallier,54418,9001,Clémence Dufour,3152,-42265,2022-10-23
CASH_OUT,7506,Thibault-Julien Chevallier,9001,1495,Agence_mtn_Abomey,300000,292494,2022-10-26
CASH_IN,220185,Agence_mtn_Ouidah,300000,79815,Sabine Perrier,-65551,154634,2022-10-01
CASH_IN,112549,Agence_mtn_Abomey,300000,187451,Sabine Perrier,154634,267183,2022-10-04
CASH_IN,199591,Agence_mtn_Ouidah,300000,100409,Sabine Perrier,267183,466774,2022-10-08
CASH_IN,201323,Agence_mtn_Cotonou,300000,98677,Sabine Perrier,466774,668097,2022-10-09
CASH_OUT,224102,Sabine Perrier,668097,443995,Agence_mtn_Abomey,300000,75898,2022-10-11
CASH_OUT,305179,Sabine Perrier,443995,138816,Agence_mtn_Cotonou,300000,-5179,2022-10-15
TRANSFER,475482,Alexandre Delaunay,1166118,690636,Sabine Perrier,138816,614298,2022-10-18
TRANSFER,15091,Maggie Barbier,27897,12806,Sabine Perrier,614298,629389,2022-10-18
TRANSFER,213621,François Vaillant,269767,56146,Sabine Perrier,629389,843010,2022-10-18
CASH_IN,213552,Agence_mtn_Abomey,300000,86448,Sabine Perrier,843010,1056562,2022-10-21
TRANSFER,5425,Jacques Le Marion,15690,10265,Sabine Perrier,1056562,1061987,2022-10-23
CASH_OUT,132503,Sabine Perrier,1061987,929484,Agence_mtn_Ouidah,300000,167497,2022-10-24
TRANSFER,7113,Jacques Marchand,9543,2430,Sabine Perrier,929484,936597,2022-10-26
CASH_IN,71454,Agence_mtn_Cotonou,300000,228546,Valérie de Pottier,141163,212617,2022-10-01
CASH_OUT,17218,Valérie de Pottier,212617,195399,Agence_mtn_Abomey,300000,282782,2022-10-07
CASH_OUT,41174,Valérie de Pottier,195399,154225,Agence_mtn_Abomey,300000,258826,2022-10-10
TRANSFER,138661,Valérie de Pottier,154225,15564,Gilbert Moulin,381710,243049,2022-10-16
TRANSFER,6254,Raymond de Le Roux,10187,3933,Valérie de Pottier,15564,21818,2022-10-17
TRANSFER,50468,Roger-Roger Delmas,291224,240756,Valérie de Pottier,21818,72286,2022-10-17
CASH_OUT,44989,Valérie de Pottier,72286,27297,Agence_mtn_Ouidah,300000,255011,2022-10-19
TRANSFER,6950,Valérie de Pottier,27297,20347,Maryse Delorme,34892,27942,2022-10-22
TRANSFER,8877,Jacques Le Marion,10265,1388,Valérie de Pottier,20347,29224,2022-10-25
CASH_OUT,21232,Valérie de Pottier,29224,7992,Agence_mtn_Cotonou,300000,278768,2022-10-26
TRANSFER,3139,Raymond de Le Roux,3933,794,Valérie de Pottier,7992,11131,2022-10-27
CASH_IN,190126,Agence_mtn_Ouidah,300000,109874,Hélène Blanchard-Renault,-2017270,-1827144,2022-10-05
CASH_IN,91146,Agence_mtn_Abomey,300000,208854,Hélène Blanchard-Renault,-1827144,-1735998,2022-10-06
CASH_IN,299932,Agence_mtn_Ouidah,300000,68,Hélène Blanchard-Renault,-1735998,-1436066,2022-10-07
CASH_IN,145616,Agence_mtn_Cotonou,300000,154384,Hélène Blanchard-Renault,-1436066,-1290450,2022-10-11
CASH_IN,86620,Agence_mtn_Ouidah,300000,213380,Hélène Blanchard-Renault,-1290450,-1203830,2022-10-11
CASH_IN,150904,Agence_mtn_Abomey,300000,149096,Hélène Blanchard-Renault,-1203830,-1052926,2022-10-12
CASH_IN,175522,Agence_mtn_Cotonou,300000,124478,Hélène Blanchard-Renault,-1052926,-877404,2022-10-13
CASH_IN,226982,Agence_mtn_Abomey,300000,73018,Hélène Blanchard-Renault,-877404,-650422,2022-10-15
CASH_IN,135493,Agence_mtn_Abomey,300000,164507,Hélène Blanchard-Renault,-650422,-514929,2022-10-15
CASH_IN,130133,Agence_mtn_Abomey,300000,169867,Hélène Blanchard-Renault,-514929,-384796,2022-10-15
CASH_IN,297777,Agence_mtn_Ouidah,300000,2223,Hélène Blanchard-Renault,-384796,-87019,2022-10-15
CASH_IN,192529,Agence_mtn_Abomey,300000,107471,Hélène Blanchard-Renault,-87019,105510,2022-10-18
CASH_IN,123240,Agence_mtn_Ouidah,300000,176760,Hélène Blanchard-Renault,105510,228750,2022-10-18
CASH_IN,64992,Agence_mtn_Abomey,300000,235008,Hélène Blanchard-Renault,228750,293742,2022-10-19
CASH_IN,299031,Agence_mtn_Ouidah,300000,969,Hélène Blanchard-Renault,293742,592773,2022-10-20
CASH_IN,178370,Agence_mtn_Cotonou,300000,121630,Hélène Blanchard-Renault,592773,771143,2022-10-26
CASH_IN,40884,Agence_mtn_Abomey,300000,259116,Anouk Delahaye-Gimenez,-317283,-276399,2022-10-02
CASH_IN,204145,Agence_mtn_Abomey,300000,95855,Anouk Delahaye-Gimenez,-276399,-72254,2022-10-06
CASH_IN,160665,Agence_mtn_Ouidah,300000,139335,Anouk Delahaye-Gimenez,-72254,88411,2022-10-07
CASH_OUT,85573,Anouk Delahaye-Gimenez,88411,2838,Agence_mtn_Cotonou,300000,214427,2022-10-10
TRANSFER,168006,Gilbert Moulin,243049,75043,Anouk Delahaye-Gimenez,2838,170844,2022-10-11
TRANSFER,730,Jacques Le Marion,1388,658,Anouk Delahaye-Gimenez,170844,171574,2022-10-11
CASH_OUT,160990,Anouk Delahaye-Gimenez,171574,10584,Agence_mtn_Abomey,300000,139010,2022-10-11
CASH_OUT,3604,Anouk Delahaye-Gimenez,10584,6980,Agence_mtn_Cotonou,300000,296396,2022-10-11
TRANSFER,351307,Maurice de Brunet,524857,173550,Anouk Delahaye-Gimenez,6980,358287,2022-10-12
CASH_OUT,124480,Anouk Delahaye-Gimenez,358287,233807,Agence_mtn_Cotonou,300000,175520,2022-10-13
CASH_OUT,124940,Anouk Delahaye-Gimenez,233807,108867,Agence_mtn_Cotonou,300000,175060,2022-10-16
TRANSFER,720,Raymond de Le Roux,794,74,Anouk Delahaye-Gimenez,108867,109587,2022-10-20
CASH_IN,44085,Agence_mtn_Cotonou,300000,255915,Anouk Delahaye-Gimenez,109587,153672,2022-10-24
CASH_IN,197010,Agence_mtn_Ouidah,300000,102990,Anouk Delahaye-Gimenez,153672,350682,2022-10-26
CASH_OUT,119376,Anouk Delahaye-Gimenez,350682,231306,Agence_mtn_Cotonou,300000,180624,2022-10-27
CASH_IN,52208,Agence_mtn_Cotonou,300000,247792,Zacharie Fabre,5477,57685,2022-10-02
TRANSFER,44225,Zacharie Fabre,57685,13460,Alfred Paris,1065384,1021159,2022-10-05
CASH_IN,125849,Agence_mtn_Cotonou,300000,174151,Zacharie Fabre,13460,139309,2022-10-08
CASH_IN,291506,Agence_mtn_Cotonou,300000,8494,Zacharie Fabre,139309,430815,2022-10-09
CASH_IN,253358,Agence_mtn_Cotonou,300000,46642,Zacharie Fabre,430815,684173,2022-10-11
CASH_IN,116159,Agence_mtn_Abomey,300000,183841,Zacharie Fabre,684173,800332,2022-10-14
TRANSFER,12147,Maggie Barbier,12806,659,Zacharie Fabre,800332,812479,2022-10-16
CASH_OUT,356510,Zacharie Fabre,812479,455969,Agence_mtn_Abomey,300000,-56510,2022-10-19
CASH_OUT,287461,Zacharie Fabre,455969,168508,Agence_mtn_Ouidah,300000,12539,2022-10-20
CASH_IN,163467,Agence_mtn_Cotonou,300000,136533,Zacharie Fabre,168508,331975,2022-10-21
CASH_OUT,192798,Zacharie Fabre,331975,139177,Agence_mtn_Abomey,300000,107202,2022-10-22
CASH_IN,243939,Agence_mtn_Abomey,300000,56061,Zacharie Fabre,139177,383116,2022-10-26
CASH_IN,277436,Agence_mtn_Ouidah,300000,22564,Aurélie Maury,-571213,-293777,2022-10-02
CASH_IN,245313,Agence_mtn_Cotonou,300000,54687,Aurélie Maury,-293777,-48464,2022-10-03
CASH_IN,6711,Agence_mtn_Abomey,300000,293289,Aurélie Maury,-48464,-41753,2022-10-04
CASH_IN,171207,Agence_mtn_Ouidah,300000,128793,Aurélie Maury,-41753,129454,2022-10-09
TRANSFER,273813,Véronique Hardy,603339,329526,Aurélie Maury,129454,403267,2022-10-10
CASH_OUT,187081,Aurélie Maury,403267,216186,Agence_mtn_Abomey,300000,112919,2022-10-11
TRANSFER,192352,Aurélie Maury,216186,23834,Margot Julien,45005,-147347,2022-10-14
CASH_IN,194967,Agence_mtn_Ouidah,300000,105033,Aurélie Maury,23834,218801,2022-10-16
TRANSFER,8641,Aurélie Maury,218801,210160,Thibault Martin,12663,4022,2022-10-16
TRANSFER,754,Georges-Alfred Pruvost,1647,893,Aurélie Maury,210160,210914,2022-10-17
TRANSFER,2224,Jacques Marchand,2430,206,Aurélie Maury,210914,213138,2022-10-20
CASH_OUT,171992,Aurélie Maury,213138,41146,Agence_mtn_Ouidah,300000,128008,2022-10-21
CASH_IN,110412,Agence_mtn_Abomey,300000,189588,Aurélie Maury,41146,151558,2022-10-22
TRANSFER,495,Georges-Alfred Pruvost,893,398,Aurélie Maury,151558,152053,2022-10-23
CASH_OUT,138618,Aurélie Maury,152053,13435,Agence_mtn_Ouidah,300000,161382,2022-10-23
TRANSFER,270,Georges-Alfred Pruvost,398,128,Aurélie Maury,13435,13705,2022-10-23
CASH_OUT,4249,Aurélie Maury,13705,9456,Agence_mtn_Ouidah,300000,295751,2022-10-26
TRANSFER,6554,Aurélie Maury,9456,2902,Nicole Huet,237478,230924,2022-10-26
CASH_IN,80761,Agence_mtn_Abomey,300000,219239,Aurélie Maury,2902,83663,2022-10-26
TRANSFER,71940,Gilbert Moulin,75043,3103,Aurélie Maury,83663,155603,2022-10-27
CASH_IN,109045,Agence_mtn_Ouidah,300000,190955,Corinne Roussel,-495266,-386221,2022-10-02
CASH_IN,180285,Agence_mtn_Cotonou,300000,119715,Corinne Roussel,-386221,-205936,2022-10-04
CASH_IN,149722,Agence_mtn_Cotonou,300000,150278,Corinne Roussel,-205936,-56214,2022-10-05
CASH_IN,191501,Agence_mtn_Ouidah,300000,108499,Corinne Roussel,-56214,135287,2022-10-07
CASH_IN,221263,Agence_mtn_Abomey,300000,78737,Corinne Roussel,135287,356550,2022-10-07
TRANSFER,233812,Corinne Roussel,356550,122738,Sylvie Dupré,255560,21748,2022-10-11
TRANSFER,79997,Emmanuel Vallée,1676844,1596847,Alfred Paris,1021159,941162,2022-10-01
TRANSFER,24953,Roger-Roger Delmas,240756,215803,Emmanuel Vallée,1596847,1621800,2022-10-05
CASH_IN,84999,Agence_mtn_Abomey,300000,215001,Emmanuel Vallée,1621800,1706799,2022-10-08
TRANSFER,1706074,Emmanuel Vallée,1706799,725,Véronique Hardy,329526,-1376548,2022-10-09
CASH_IN,190715,Agence_mtn_Abomey,300000,109285,Emmanuel Vallée,725,191440,2022-10-13
CASH_IN,69954,Agence_mtn_Cotonou,300000,230046,Emmanuel Vallée,191440,261394,2022-10-13
CASH_IN,239138,Agence_mtn_Abomey,300000,60862,Emmanuel Vallée,261394,500532,2022-10-15
CASH_OUT,428214,Emmanuel Vallée,500532,72318,Agence_mtn_Ouidah,300000,-128214,2022-10-16
TRANSFER,60094,Emmanuel Vallée,72318,12224,Roger-Roger Delmas,215803,155709,2022-10-17
TRANSFER,512284,Alexandre Delaunay,690636,178352,Emmanuel Vallée,12224,524508,2022-10-17
TRANSFER,145640,Emmanuel Vallée,524508,378868,Gilbert Moulin,3103,-142537,2022-10-18
TRANSFER,2123,Maryse Delorme,27942,25819,Emmanuel Vallée,378868,380991,2022-10-22
CASH_IN,263743,Agence_mtn_Ouidah,300000,36257,Emmanuel Vallée,380991,644734,2022-10-24
CASH_IN,124264,Agence_mtn_Ouidah,300000,175736,Emmanuel Vallée,644734,768998,2022-10-26
TRANSFER,255997,Emmanuel Vallée,768998,513001,Alexandre Delaunay,178352,-77645,2022-10-26
CASH_IN,222535,Agence_mtn_Abomey,300000,77465,Emmanuel Vallée,513001,735536,2022-10-27
CASH_IN,29100,Agence_mtn_Abomey,300000,270900,Élisabeth Blot-Bruneau,-6687,22413,2022-10-01
CASH_IN,273778,Agence_mtn_Cotonou,300000,26222,Élisabeth Blot-Bruneau,22413,296191,2022-10-06
CASH_IN,296336,Agence_mtn_Cotonou,300000,3664,Élisabeth Blot-Bruneau,296191,592527,2022-10-12
CASH_OUT,523347,Élisabeth Blot-Bruneau,592527,69180,Agence_mtn_Abomey,300000,-223347,2022-10-15
CASH_IN,63786,Agence_mtn_Cotonou,300000,236214,Élisabeth Blot-Bruneau,69180,132966,2022-10-15
TRANSFER,611,Maggie Barbier,659,48,Élisabeth Blot-Bruneau,132966,133577,2022-10-15
CASH_IN,85044,Agence_mtn_Abomey,300000,214956,Élisabeth Blot-Bruneau,133577,218621,2022-10-15
CASH_OUT,31936,Élisabeth Blot-Bruneau,218621,186685,Agence_mtn_Ouidah,300000,268064,2022-10-16
CASH_OUT,175267,Élisabeth Blot-Bruneau,186685,11418,Agence_mtn_Ouidah,300000,124733,2022-10-22
TRANSFER,8210,Élisabeth Blot-Bruneau,11418,3208,Georges-Alfred Pruvost,128,-8082,2022-10-23
CASH_IN,193845,Agence_mtn_Cotonou,300000,106155,Élisabeth Blot-Bruneau,3208,197053,2022-10-23
CASH_OUT,203481,Nicole Huet,230924,27443,Agence_mtn_Cotonou,300000,96519,2022-10-05
CASH_OUT,25841,Nicole Huet,27443,1602,Agence_mtn_Ouidah,300000,274159,2022-10-07
CASH_IN,101273,Agence_mtn_Ouidah,300000,198727,Nicole Huet,1602,102875,2022-10-10
CASH_IN,56455,Agence_mtn_Abomey,300000,243545,Nicole Huet,102875,159330,2022-10-10
CASH_OUT,127085,Nicole Huet,159330,32245,Agence_mtn_Ouidah,300000,172915,2022-10-15
CASH_IN,5213,Agence_mtn_Cotonou,300000,294787,Nicole Huet,32245,37458,2022-10-23
CASH_IN,155951,Agence_mtn_Cotonou,300000,144049,Roger-Roger Delmas,155709,311660,2022-10-06
CASH_OUT,260923,Roger-Roger Delmas,311660,50737,Agence_mtn_Ouidah,300000,39077,2022-10-08
CASH_OUT,721,Roger-Roger Delmas,50737,50016,Agence_mtn_Ouidah,300000,299279,2022-10-09
CASH_OUT,19721,Roger-Roger Delmas,50016,30295,Agence_mtn_Ouidah,300000,280279,2022-10-09
TRANSFER,20674,Maryse Delorme,25819,5145,Roger-Roger Delmas,30295,50969,2022-10-10
CASH_IN,281810,Agence_mtn_Abomey,300000,18190,Roger-Roger Delmas,50969,332779,2022-10-10
CASH_OUT,68659,Roger-Roger Delmas,332779,264120,Agence_mtn_Abomey,300000,231341,2022-10-10
CASH_IN,198282,Agence_mtn_Cotonou,300000,101718,Roger-Roger Delmas,264120,462402,2022-10-11
TRANSFER,188545,Roger-Roger Delmas,462402,273857,François Vaillant,56146,-132399,2022-10-11
CASH_IN,107203,Agence_mtn_Cotonou,300000,192797,Roger-Roger Delmas,273857,381060,2022-10-13
CASH_IN,138830,Agence_mtn_Ouidah,300000,161170,Roger-Roger Delmas,381060,519890,2022-10-17
TRANSFER,515153,Roger-Roger Delmas,519890,4737,Jacques Marchand,206,-514947,2022-10-21
CASH_IN,37077,Agence_mtn_Abomey,300000,262923,Roger-Roger Delmas,4737,41814,2022-10-22
TRANSFER,1084,Maryse Delorme,5145,4061,Roger-Roger Delmas,41814,42898,2022-10-24
CASH_IN,298754,Agence_mtn_Ouidah,300000,1246,Roger-Roger Delmas,42898,341652,2022-10-24
TRANSFER,1802,Gabrielle Hamon,1815,13,Roger-Roger Delmas,341652,343454,2022-10-24
CASH_IN,225591,Agence_mtn_Abomey,300000,74409,Jacques Marchand,-514947,-289356,2022-10-01
CASH_IN,173151,Agence_mtn_Cotonou,300000,126849,Jacques Marchand,-289356,-116205,2022-10-05
CASH_IN,74038,Agence_mtn_Ouidah,300000,225962,Jacques Marchand,-116205,-42167,2022-10-12
CASH_IN,243268,Agence_mtn_Ouidah,300000,56732,Jacques Marchand,-42167,201101,2022-10-12
TRANSFER,101623,Jacques Marchand,201101,99478,Sylvie Dupré,21748,-79875,2022-10-12
CASH_OUT,60517,Jacques Marchand,99478,38961,Agence_mtn_Ouidah,300000,239483,2022-10-14
CASH_OUT,28915,Jacques Marchand,38961,10046,Agence_mtn_Cotonou,300000,271085,2022-10-18
CASH_OUT,7250,Jacques Marchand,10046,2796,Agence_mtn_Ouidah,300000,292750,2022-10-24
TRANSFER,77014,Georges Muller,87220,10206,Jacques Marchand,2796,79810,2022-10-25
CASH_IN,211123,Agence_mtn_Ouidah,300000,88877,Jacques Marchand,79810,290933,2022-10-27
CASH_OUT,62578,Jacques Marchand,290933,228355,Agence_mtn_Abomey,300000,237422,2022-10-27
CASH_IN,238790,Agence_mtn_Abomey,300000,61210,Gérard Blot de Blanc,-651855,-413065,2022-10-06
CASH_IN,71630,Agence_mtn_Ouidah,300000,228370,Gérard Blot de Blanc,-413065,-341435,2022-10-08
CASH_IN,213399,Agence_mtn_Ouidah,300000,86601,Gérard Blot de Blanc,-341435,-128036,2022-10-09
CASH_IN,10152,Agence_mtn_Cotonou,300000,289848,Gérard Blot de Blanc,-128036,-117884,2022-10-12
CASH_IN,216090,Agence_mtn_Ouidah,300000,83910,Gérard Blot de Blanc,-117884,98206,2022-10-12
CASH_OUT,27283,Gérard Blot de Blanc,98206,70923,Agence_mtn_Cotonou,300000,272717,2022-10-13
CASH_OUT,52394,Gérard Blot de Blanc,70923,18529,Agence_mtn_Cotonou,300000,247606,2022-10-16
CASH_OUT,17243,Gérard Blot de Blanc,18529,1286,Agence_mtn_Cotonou,300000,282757,2022-10-17
CASH_IN,99323,Agence_mtn_Abomey,300000,200677,Gérard Blot de Blanc,1286,100609,2022-10-22
CASH_OUT,91075,Gérard Blot de Blanc,100609,9534,Agence_mtn_Cotonou,300000,208925,2022-10-23
TRANSFER,172848,Christophe Teixeira,295580,122732,Gérard Blot de Blanc,9534,182382,2022-10-25
CASH_IN,117311,Agence_mtn_Cotonou,300000,182689,Pénélope Boulay,-1683540,-1566229,2022-10-01
CASH_IN,202944,Agence_mtn_Abomey,300000,97056,Pénélope Boulay,-1566229,-1363285,2022-10-02
CASH_IN,213201,Agence_mtn_Cotonou,300000,86799,Pénélope Boulay,-1363285,-1150084,2022-10-02
CASH_IN,106908,Agence_mtn_Cotonou,300000,193092,Pénélope Boulay,-1150084,-1043176,2022-10-05
CASH_IN,276958,Agence_mtn_Ouidah,300000,23042,Pénélope Boulay,-1043176,-766218,2022-10-07
CASH_IN,77876,Agence_mtn_Abomey,300000,222124,Pénélope Boulay,-766218,-688342,2022-10-09
CASH_IN,132584,Agence_mtn_Abomey,300000,167416,Pénélope Boulay,-688342,-555758,2022-10-10
CASH_IN,152796,Agence_mtn_Abomey,300000,147204,Pénélope Boulay,-555758,-402962,2022-10-12
CASH_IN,296292,Agence_mtn_Ouidah,300000,3708,Pénélope Boulay,-402962,-106670,2022-10-12
CASH_IN,215208,Agence_mtn_Abomey,300000,84792,Pénélope Boulay,-106670,108538,2022-10-13
TRANSFER,139195,Maurice de Brunet,173550,34355,Pénélope Boulay,108538,247733,2022-10-13
TRANSFER,379064,Alfred Paris,941162,562098,Pénélope Boulay,247733,626797,2022-10-15
CASH_OUT,263798,Pénélope Boulay,626797,362999,Agence_mtn_Abomey,300000,36202,2022-10-17
CASH_OUT,210039,Pénélope Boulay,362999,152960,Agence_mtn_Abomey,300000,89961,2022-10-20
CASH_IN,205647,Agence_mtn_Ouidah,300000,94353,Pénélope Boulay,152960,358607,2022-10-21
CASH_OUT,22395,Pénélope Boulay,358607,336212,Agence_mtn_Abomey,300000,277605,2022-10-22
CASH_OUT,135380,Pénélope Boulay,336212,200832,Agence_mtn_Abomey,300000,164620,2022-10-23
CASH_IN,214260,Agence_mtn_Cotonou,300000,85740,Gilbert Moulin,-142537,71723,2022-10-02
CASH_IN,134028,Agence_mtn_Abomey,300000,165972,Gilbert Moulin,71723,205751,2022-10-04
CASH_IN,182372,Agence_mtn_Abomey,300000,117628,Gilbert Moulin,205751,388123,2022-10-04
CASH_OUT,179755,Gilbert Moulin,388123,208368,Agence_mtn_Ouidah,300000,120245,2022-10-05
CASH_OUT,201702,Gilbert Moulin,208368,6666,Agence_mtn_Cotonou,300000,98298,2022-10-08
CASH_IN,294746,Agence_mtn_Abomey,300000,5254,Gilbert Moulin,6666,301412,2022-10-08
TRANSFER,231442,Gilbert Moulin,301412,69970,Maurice de Brunet,34355,-197087,2022-10-09
CASH_OUT,51960,Gilbert Moulin,69970,18010,Agence_mtn_Cotonou,300000,248040,2022-10-16
CASH_OUT,17366,Gilbert Moulin,18010,644,Agence_mtn_Cotonou,300000,282634,2022-10-16
CASH_IN,147941,Agence_mtn_Cotonou,300000,152059,Gilbert Moulin,644,148585,2022-10-16
CASH_IN,106407,Agence_mtn_Ouidah,300000,193593,Gilbert Moulin,148585,254992,2022-10-17
CASH_OUT,157999,Gilbert Moulin,254992,96993,Agence_mtn_Ouidah,300000,142001,2022-10-18
TRANSFER,24066,Gilbert Moulin,96993,72927,Thibault Martin,4022,-20044,2022-10-23
CASH_IN,270334,Agence_mtn_Abomey,300000,29666,Gilbert Moulin,72927,343261,2022-10-24
CASH_IN,187526,Agence_mtn_Abomey,300000,112474,Clémence Dufour,-42265,145261,2022-10-09
CASH_OUT,117772,Clémence Dufour,145261,27489,Agence_mtn_Ouidah,300000,182228,2022-10-10
TRANSFER,6423,Georges Muller,10206,3783,Clémence Dufour,27489,33912,2022-10-12
TRANSFER,8658,Clémence Dufour,33912,25254,Christophe Teixeira,122732,114074,2022-10-13
TRANSFER,22575,Clémence Dufour,25254,2679,Christophe Teixeira,114074,91499,2022-10-16
CASH_OUT,2157,Clémence Dufour,2679,522,Agence_mtn_Cotonou,300000,297843,2022-10-17
TRANSFER,2202,Maryse Delorme,4061,1859,Clémence Dufour,522,2724,2022-10-21
CASH_OUT,1639,Clémence Dufour,2724,1085,Agence_mtn_Ouidah,300000,298361,2022-10-22
CASH_OUT,870,Clémence Dufour,1085,215,Agence_mtn_Ouidah,300000,299130,2022-10-23
CASH_OUT,67983,Christophe Teixeira,91499,23516,Agence_mtn_Ouidah,300000,232017,2022-10-02
CASH_IN,176949,Agence_mtn_Ouidah,300000,123051,Christophe Teixeira,23516,200465,2022-10-03
CASH_IN,229970,Agence_mtn_Cotonou,300000,70030,Christophe Teixeira,200465,430435,2022-10-03
CASH_OUT,375173,Christophe Teixeira,430435,55262,Agence_mtn_Abomey,300000,-75173,2022-10-18
CASH_IN,214290,Agence_mtn_Abomey,300000,85710,Christophe Teixeira,55262,269552,2022-10-21
TRANSFER,1725,Maryse Delorme,1859,134,Christophe Teixeira,269552,271277,2022-10-23
CASH_IN,46333,Agence_mtn_Abomey,300000,253667,Alexandre Delaunay,-77645,-31312,2022-10-01
CASH_IN,129635,Agence_mtn_Cotonou,300000,170365,Alexandre Delaunay,-31312,98323,2022-10-01
CASH_IN,12875,Agence_mtn_Ouidah,300000,287125,Alexandre Delaunay,98323,111198,2022-10-01
CASH_OUT,53199,Alexandre Delaunay,111198,57999,Agence_mtn_Abomey,300000,246801,2022-10-05
CASH_OUT,32072,Alexandre Delaunay,57999,25927,Agence_mtn_Abomey,300000,267928,2022-10-07
TRANSFER,126,Maryse Delorme,134,8,Alexandre Delaunay,25927,26053,2022-10-08
TRANSFER,17946,Alexandre Delaunay,26053,8107,Alexandre Delaunay,26053,8107,2022-10-09
TRANSFER,499883,Alfred Paris,562098,62215,Alexandre Delaunay,8107,507990,2022-10-10
TRANSFER,2526,Georges Muller,3783,1257,Alexandre Delaunay,507990,510516,2022-10-11
CASH_IN,143846,Agence_mtn_Cotonou,300000,156154,Alexandre Delaunay,510516,654362,2022-10-11
CASH_OUT,429710,Alexandre Delaunay,654362,224652,Agence_mtn_Cotonou,300000,-129710,2022-10-12
CASH_OUT,27455,Alexandre Delaunay,224652,197197,Agence_mtn_Cotonou,300000,272545,2022-10-15
CASH_IN,47021,Agence_mtn_Ouidah,300000,252979,Alexandre Delaunay,197197,244218,2022-10-16
CASH_IN,103933,Agence_mtn_Cotonou,300000,196067,Alexandre Delaunay,244218,348151,2022-10-18
TRANSFER,296315,Alexandre Delaunay,348151,51836,Georges Muller,1257,-295058,2022-10-19
CASH_IN,110076,Agence_mtn_Abomey,300000,189924,Margot Julien,-147347,-37271,2022-10-01
CASH_IN,263554,Agence_mtn_Abomey,300000,36446,Margot Julien,-37271,226283,2022-10-02
CASH_OUT,49136,Margot Julien,226283,177147,Agence_mtn_Abomey,300000,250864,2022-10-03
CASH_OUT,131363,Margot Julien,177147,45784,Agence_mtn_Cotonou,300000,168637,2022-10-04
TRANSFER,37336,Margot Julien,45784,8448,Margot Julien,45784,83120,2022-10-09
TRANSFER,5750,Margot Julien,8448,2698,Margot Julien,8448,14198,2022-10-11
CASH_OUT,2585,Margot Julien,2698,113,Agence_mtn_Abomey,300000,297415,2022-10-14
CASH_IN,131187,Agence_mtn_Cotonou,300000,168813,Margot Julien,113,131300,2022-10-17
CASH_OUT,89605,Margot Julien,131300,41695,Agence_mtn_Abomey,300000,210395,2022-10-18
CASH_IN,163495,Agence_mtn_Ouidah,300000,136505,Margot Julien,41695,205190,2022-10-21
CASH_IN,86335,Agence_mtn_Abomey,300000,213665,Margot Julien,205190,291525,2022-10-27
CASH_OUT,230979,Margot Julien,291525,60546,Agence_mtn_Abomey,300000,69021,2022-10-27
CASH_IN,67910,Agence_mtn_Abomey,300000,232090,Raymond de Le Roux,74,67984,2022-10-04
TRANSFER,13590,Raymond de Le Roux,67984,54394,Raymond de Le Roux,67984,81574,2022-10-04
CASH_OUT,25001,Raymond de Le Roux,54394,29393,Agence_mtn_Abomey,300000,274999,2022-10-05
TRANSFER,13578,Raymond de Le Roux,29393,15815,Raymond de Le Roux,29393,15815,2022-10-06
CASH_OUT,8830,Raymond de Le Roux,15815,6985,Agence_mtn_Cotonou,300000,291170,2022-10-20
CASH_OUT,5388,Raymond de Le Roux,6985,1597,Agence_mtn_Abomey,300000,294612,2022-10-23
CASH_IN,174015,Agence_mtn_Ouidah,300000,125985,Raymond de Le Roux,1597,175612,2022-10-24
CASH_IN,161693,Agence_mtn_Cotonou,300000,138307,Thibault Martin,-20044,141649,2022-10-03
CASH_IN,131335,Agence_mtn_Cotonou,300000,168665,Thibault Martin,141649,272984,2022-10-06
TRANSFER,150910,Thibault Martin,272984,122074,Thibault Martin,272984,423894,2022-10-06
CASH_OUT,99673,Thibault Martin,122074,22401,Agence_mtn_Abomey,300000,200327,2022-10-19
CASH_IN,73322,Agence_mtn_Cotonou,300000,226678,Thibault Martin,22401,95723,2022-10-24
CASH_IN,85605,Agence_mtn_Abomey,300000,214395,Véronique Hardy,-1376548,-1290943,2022-10-01
CASH_IN,272078,Agence_mtn_Ouidah,300000,27922,Véronique Hardy,-1290943,-1018865,2022-10-04
CASH_IN,194962,Agence_mtn_Ouidah,300000,105038,Véronique Hardy,-1018865,-823903,2022-10-04
CASH_IN,69329,Agence_mtn_Abomey,300000,230671,Véronique Hardy,-823903,-754574,2022-10-06
CASH_IN,178557,Agence_mtn_Cotonou,300000,121443,Véronique Hardy,-754574,-576017,2022-10-06
CASH_IN,130009,Agence_mtn_Cotonou,300000,169991,Véronique Hardy,-576017,-446008,2022-10-09
CASH_IN,252331,Agence_mtn_Cotonou,300000,47669,Véronique Hardy,-446008,-193677,2022-10-11
CASH_IN,16294,Agence_mtn_Ouidah,300000,283706,Véronique Hardy,-193677,-177383,2022-10-13
CASH_IN,129814,Agence_mtn_Abomey,300000,170186,Véronique Hardy,-177383,-47569,2022-10-13
CASH_IN,73410,Agence_mtn_Cotonou,300000,226590,Véronique Hardy,-47569,25841,2022-10-15
TRANSFER,22717,Véronique Hardy,25841,3124,Véronique Hardy,25841,48558,2022-10-16
TRANSFER,2466,Véronique Hardy,3124,658,Véronique Hardy,3124,658,2022-10-17
CASH_OUT,121,Véronique Hardy,658,537,Agence_mtn_Ouidah,300000,299879,2022-10-17
CASH_OUT,411,Véronique Hardy,537,126,Agence_mtn_Cotonou,300000,299589,2022-10-18
CASH_OUT,124,Véronique Hardy,126,2,Agence_mtn_Ouidah,300000,299876,2022-10-18
CASH_IN,227884,Agence_mtn_Ouidah,300000,72116,Véronique Hardy,2,227886,2022-10-20
CASH_OUT,205445,Véronique Hardy,227886,22441,Agence_mtn_Cotonou,300000,94555,2022-10-22
CASH_IN,161817,Agence_mtn_Ouidah,300000,138183,Véronique Hardy,22441,184258,2022-10-25
CASH_IN,102083,Agence_mtn_Cotonou,300000,197917,Martin Moreau,-52117,49966,2022-10-05
TRANSFER,30227,Martin Moreau,49966,19739,Martin Moreau,49966,80193,2022-10-06
CASH_IN,126243,Agence_mtn_Abomey,300000,173757,Martin Moreau,19739,145982,2022-10-07
CASH_OUT,19971,Martin Moreau,145982,126011,Agence_mtn_Ouidah,300000,280029,2022-10-10
CASH_IN,186300,Agence_mtn_Ouidah,300000,113700,Martin Moreau,126011,312311,2022-10-23
CASH_IN,178271,Agence_mtn_Ouidah,300000,121729,Madeleine Philippe-Grondin,-319081,-140810,2022-10-02
CASH_IN,158701,Agence_mtn_Cotonou,300000,141299,Madeleine Philippe-Grondin,-140810,17891,2022-10-03
CASH_IN,251636,Agence_mtn_Ouidah,300000,48364,Madeleine Philippe-Grondin,17891,269527,2022-10-05
CASH_OUT,243521,Madeleine Philippe-Grondin,269527,26006,Agence_mtn_Cotonou,300000,56479,2022-10-05
CASH_IN,53812,Agence_mtn_Abomey,300000,246188,Madeleine Philippe-Grondin,26006,79818,2022-10-06
CASH_IN,28891,Agence_mtn_Ouidah,300000,271109,Madeleine Philippe-Grondin,79818,108709,2022-10-07
CASH_IN,250301,Agence_mtn_Ouidah,300000,49699,Madeleine Philippe-Grondin,108709,359010,2022-10-08
TRANSFER,224301,Madeleine Philippe-Grondin,359010,134709,Madeleine Philippe-Grondin,359010,134709,2022-10-10
TRANSFER,25019,Madeleine Philippe-Grondin,134709,109690,Madeleine Philippe-Grondin,134709,109690,2022-10-13
CASH_IN,173294,Agence_mtn_Ouidah,300000,126706,Madeleine Philippe-Grondin,109690,282984,2022-10-16
TRANSFER,202079,Madeleine Philippe-Grondin,282984,80905,Madeleine Philippe-Grondin,282984,485063,2022-10-17
CASH_IN,178339,Agence_mtn_Ouidah,300000,121661,Madeleine Philippe-Grondin,80905,259244,2022-10-18
CASH_IN,49710,Agence_mtn_Ouidah,300000,250290,Madeleine Philippe-Grondin,259244,308954,2022-10-22
CASH_IN,211316,Agence_mtn_Ouidah,300000,88684,Madeleine Philippe-Grondin,308954,520270,2022-10-23
CASH_IN,174315,Agence_mtn_Cotonou,300000,125685,Madeleine Philippe-Grondin,520270,694585,2022-10-25
CASH_IN,104889,Agence_mtn_Abomey,300000,195111,Maryse Delorme,8,104897,2022-10-02
CASH_IN,297824,Agence_mtn_Abomey,300000,2176,Maryse Delorme,104897,402721,2022-10-02
CASH_IN,253122,Agence_mtn_Abomey,300000,46878,Maryse Delorme,402721,655843,2022-10-02
TRANSFER,316367,Maryse Delorme,655843,339476,Maryse Delorme,655843,339476,2022-10-06
CASH_IN,71012,Agence_mtn_Abomey,300000,228988,Maryse Delorme,339476,410488,2022-10-08
TRANSFER,132292,Maryse Delorme,410488,278196,Maryse Delorme,410488,278196,2022-10-09
TRANSFER,220496,Maryse Delorme,278196,57700,Maryse Delorme,278196,57700,2022-10-10
CASH_IN,14968,Agence_mtn_Ouidah,300000,285032,Maryse Delorme,57700,72668,2022-10-11
CASH_IN,21404,Agence_mtn_Abomey,300000,278596,Maryse Delorme,72668,94072,2022-10-12
CASH_OUT,15860,Maryse Delorme,94072,78212,Agence_mtn_Ouidah,300000,284140,2022-10-12
CASH_OUT,44445,Maryse Delorme,78212,33767,Agence_mtn_Cotonou,300000,255555,2022-10-13
CASH_IN,265394,Agence_mtn_Cotonou,300000,34606,Maryse Delorme,33767,299161,2022-10-13
CASH_OUT,113567,Maryse Delorme,299161,185594,Agence_mtn_Cotonou,300000,186433,2022-10-21
CASH_OUT,146961,Maryse Delorme,185594,38633,Agence_mtn_Ouidah,300000,153039,2022-10-22
CASH_IN,139542,Agence_mtn_Cotonou,300000,160458,Maryse Delorme,38633,178175,2022-10-26
CASH_OUT,112466,Maryse Delorme,178175,65709,Agence_mtn_Ouidah,300000,187534,2022-10-26
CASH_IN,93478,Agence_mtn_Abomey,300000,206522,Georges Muller,-295058,-201580,2022-10-03
CASH_IN,281595,Agence_mtn_Ouidah,300000,18405,Georges Muller,-201580,80015,2022-10-04
CASH_OUT,22196,Georges Muller,80015,57819,Agence_mtn_Cotonou,300000,277804,2022-10-04
TRANSFER,45720,Georges Muller,57819,12099,Georges Muller,57819,103539,2022-10-08
CASH_IN,39746,Agence_mtn_Abomey,300000,260254,Georges Muller,12099,51845,2022-10-09
CASH_OUT,29860,Georges Muller,51845,21985,Agence_mtn_Cotonou,300000,270140,2022-10-11
TRANSFER,18341,Georges Muller,21985,3644,Georges Muller,21985,3644,2022-10-13
CASH_OUT,753,Georges Muller,3644,2891,Agence_mtn_Ouidah,300000,299247,2022-10-14
CASH_OUT,2380,Georges Muller,2891,511,Agence_mtn_Abomey,300000,297620,2022-10-18
CASH_IN,14972,Agence_mtn_Ouidah,300000,285028,Georges Muller,511,15483,2022-10-19
CASH_IN,132050,Agence_mtn_Abomey,300000,167950,Sophie-Anouk Boulanger,-146508,-14458,2022-10-02
CASH_IN,21557,Agence_mtn_Abomey,300000,278443,Sophie-Anouk Boulanger,-14458,7099,2022-10-08
CASH_OUT,4206,Sophie-Anouk Boulanger,7099,2893,Agence_mtn_Abomey,300000,295794,2022-10-10
TRANSFER,2114,Sophie-Anouk Boulanger,2893,779,Sophie-Anouk Boulanger,2893,779,2022-10-10
CASH_IN,19548,Agence_mtn_Abomey,300000,280452,Sophie-Anouk Boulanger,779,20327,2022-10-14
CASH_IN,203169,Agence_mtn_Ouidah,300000,96831,Sophie-Anouk Boulanger,20327,223496,2022-10-17
CASH_IN,191946,Agence_mtn_Abomey,300000,108054,Sophie-Anouk Boulanger,223496,415442,2022-10-19
TRANSFER,128000,Sophie-Anouk Boulanger,415442,287442,Sophie-Anouk Boulanger,415442,543442,2022-10-22
CASH_OUT,249478,Sophie-Anouk Boulanger,287442,37964,Agence_mtn_Abomey,300000,50522,2022-10-23
CASH_OUT,35316,Sophie-Anouk Boulanger,37964,2648,Agence_mtn_Cotonou,300000,264684,2022-10-25
CASH_IN,124391,Agence_mtn_Ouidah,300000,175609,Sophie-Anouk Boulanger,2648,127039,2022-10-26
CASH_IN,48309,Agence_mtn_Cotonou,300000,251691,Georges-Alfred Pruvost,-8082,40227,2022-10-03
TRANSFER,7743,Georges-Alfred Pruvost,40227,32484,Georges-Alfred Pruvost,40227,32484,2022-10-06
CASH_IN,244839,Agence_mtn_Cotonou,300000,55161,Georges-Alfred Pruvost,32484,277323,2022-10-11
TRANSFER,3565,Georges-Alfred Pruvost,277323,273758,Georges-Alfred Pruvost,277323,280888,2022-10-11
CASH_IN,1997,Agence_mtn_Cotonou,300000,298003,Georges-Alfred Pruvost,273758,275755,2022-10-13
CASH_IN,288985,Agence_mtn_Cotonou,300000,11015,Georges-Alfred Pruvost,275755,564740,2022-10-13
CASH_OUT,430538,Georges-Alfred Pruvost,564740,134202,Agence_mtn_Abomey,300000,-130538,2022-10-16
CASH_OUT,128435,Georges-Alfred Pruvost,134202,5767,Agence_mtn_Abomey,300000,171565,2022-10-17
CASH_IN,121406,Agence_mtn_Abomey,300000,178594,Georges-Alfred Pruvost,5767,127173,2022-10-19
CASH_IN,117892,Agence_mtn_Ouidah,300000,182108,Georges-Alfred Pruvost,127173,245065,2022-10-20
CASH_OUT,195697,Georges-Alfred Pruvost,245065,49368,Agence_mtn_Abomey,300000,104303,2022-10-21
CASH_IN,176602,Agence_mtn_Cotonou,300000,123398,Georges-Alfred Pruvost,49368,225970,2022-10-21
CASH_IN,192403,Agence_mtn_Ouidah,300000,107597,Georges-Alfred Pruvost,225970,418373,2022-10-25
CASH_OUT,394823,Georges-Alfred Pruvost,418373,23550,Agence_mtn_Cotonou,300000,-94823,2022-10-26
CASH_IN,19348,Agence_mtn_Cotonou,300000,280652,Gabrielle Hamon,13,19361,2022-10-01
CASH_IN,135122,Agence_mtn_Ouidah,300000,164878,Gabrielle Hamon,19361,154483,2022-10-05
CASH_IN,135207,Agence_mtn_Ouidah,300000,164793,Gabrielle Hamon,154483,289690,2022-10-05
TRANSFER,269663,Gabrielle Hamon,289690,20027,Gabrielle Hamon,289690,20027,2022-10-06
CASH_IN,224267,Agence_mtn_Abomey,300000,75733,Gabrielle Hamon,20027,244294,2022-10-09
CASH_IN,237719,Agence_mtn_Abomey,300000,62281,Gabrielle Hamon,244294,482013,2022-10-11
CASH_OUT,201085,Gabrielle Hamon,482013,280928,Agence_mtn_Ouidah,300000,98915,2022-10-13
CASH_OUT,219303,Gabrielle Hamon,280928,61625,Agence_mtn_Abomey,300000,80697,2022-10-14
CASH_OUT,5440,Gabrielle Hamon,61625,56185,Agence_mtn_Cotonou,300000,294560,2022-10-17
CASH_IN,68652,Agence_mtn_Abomey,300000,231348,Gabrielle Hamon,56185,124837,2022-10-18
CASH_IN,217809,Agence_mtn_Abomey,300000,82191,Gabrielle Hamon,124837,342646,2022-10-22
CASH_IN,1650,Agence_mtn_Abomey,300000,298350,Gabrielle Hamon,342646,344296,2022-10-23
CASH_OUT,83187,Gabrielle Hamon,344296,261109,Agence_mtn_Cotonou,300000,216813,2022-10-23
CASH_IN,229930,Agence_mtn_Cotonou,300000,70070,Gabrielle Hamon,261109,491039,2022-10-23
CASH_IN,20421,Agence_mtn_Abomey,300000,279579,Gabrielle Hamon,491039,511460,2022-10-26
CASH_IN,257284,Agence_mtn_Ouidah,300000,42716,Gabrielle Hamon,511460,768744,2022-10-27
CASH_OUT,491647,Gabrielle Hamon,768744,277097,Agence_mtn_Ouidah,300000,-191647,2022-10-27
CASH_IN,52747,Agence_mtn_Ouidah,300000,247253,Nicole-Renée Gay,-28995,23752,2022-10-02
TRANSFER,7708,Nicole-Renée Gay,23752,16044,Nicole-Renée Gay,23752,16044,2022-10-02
CASH_OUT,3460,Nicole-Renée Gay,16044,12584,Agence_mtn_Ouidah,300000,296540,2022-10-02
TRANSFER,5037,Nicole-Renée Gay,12584,7547,Nicole-Renée Gay,12584,17621,2022-10-03
CASH_OUT,2439,Nicole-Renée Gay,7547,5108,Agence_mtn_Abomey,300000,297561,2022-10-04
CASH_OUT,235,Nicole-Renée Gay,5108,4873,Agence_mtn_Abomey,300000,299765,2022-10-04
CASH_IN,168953,Agence_mtn_Abomey,300000,131047,Nicole-Renée Gay,4873,173826,2022-10-06
CASH_IN,41884,Agence_mtn_Cotonou,300000,258116,Nicole-Renée Gay,173826,215710,2022-10-08
CASH_OUT,54493,Nicole-Renée Gay,215710,161217,Agence_mtn_Abomey,300000,245507,2022-10-08
CASH_OUT,28460,Nicole-Renée Gay,161217,132757,Agence_mtn_Abomey,300000,271540,2022-10-09
CASH_IN,271069,Agence_mtn_Cotonou,300000,28931,Nicole-Renée Gay,132757,403826,2022-10-10
CASH_OUT,163110,Nicole-Renée Gay,403826,240716,Agence_mtn_Cotonou,300000,136890,2022-10-24
CASH_IN,132048,Agence_mtn_Cotonou,300000,167952,Sébastien Coste,24,132072,2022-10-01
TRANSFER,86726,Sébastien Coste,132072,45346,Sébastien Coste,132072,218798,2022-10-03
CASH_OUT,5353,Sébastien Coste,45346,39993,Agence_mtn_Ouidah,300000,294647,2022-10-06
CASH_IN,52163,Agence_mtn_Cotonou,300000,247837,Sébastien Coste,39993,92156,2022-10-08
CASH_IN,96571,Agence_mtn_Ouidah,300000,203429,Sébastien Coste,92156,188727,2022-10-10
CASH_IN,162431,Agence_mtn_Ouidah,300000,137569,Sébastien Coste,188727,351158,2022-10-10
TRANSFER,303016,Sébastien Coste,351158,48142,Sébastien Coste,351158,654174,2022-10-13
CASH_IN,5185,Agence_mtn_Abomey,300000,294815,Sébastien Coste,48142,53327,2022-10-14
CASH_OUT,51202,Sébastien Coste,53327,2125,Agence_mtn_Ouidah,300000,248798,2022-10-14
CASH_IN,64654,Agence_mtn_Abomey,300000,235346,Sébastien Coste,2125,66779,2022-10-18
CASH_IN,12170,Agence_mtn_Ouidah,300000,287830,Sébastien Coste,66779,78949,2022-10-18
CASH_OUT,22579,Sébastien Coste,78949,56370,Agence_mtn_Abomey,300000,277421,2022-10-19
CASH_OUT,31044,Sébastien Coste,56370,25326,Agence_mtn_Ouidah,300000,268956,2022-10-20
CASH_OUT,8338,Sébastien Coste,25326,16988,Agence_mtn_Cotonou,300000,291662,2022-10-27
CASH_IN,97058,Agence_mtn_Cotonou,300000,202942,Jules-Marc Chauvet,-15849,81209,2022-10-02
CASH_OUT,13533,Jules-Marc Chauvet,81209,67676,Agence_mtn_Abomey,300000,286467,2022-10-03
TRANSFER,56428,Jules-Marc Chauvet,67676,11248,Jules-Marc Chauvet,67676,11248,2022-10-05
CASH_OUT,945,Jules-Marc Chauvet,11248,10303,Agence_mtn_Cotonou,300000,299055,2022-10-06
TRANSFER,1025,Jules-Marc Chauvet,10303,9278,Jules-Marc Chauvet,10303,9278,2022-10-06
CASH_OUT,5355,Jules-Marc Chauvet,9278,3923,Agence_mtn_Ouidah,300000,294645,2022-10-07
TRANSFER,1196,Jules-Marc Chauvet,3923,2727,Jules-Marc Chauvet,3923,5119,2022-10-08
CASH_OUT,1245,Jules-Marc Chauvet,2727,1482,Agence_mtn_Cotonou,300000,298755,2022-10-10
CASH_OUT,915,Jules-Marc Chauvet,1482,567,Agence_mtn_Cotonou,300000,299085,2022-10-14
CASH_IN,144088,Agence_mtn_Abomey,300000,155912,Jules-Marc Chauvet,567,144655,2022-10-17
TRANSFER,106788,Jules-Marc Chauvet,144655,37867,Jules-Marc Chauvet,144655,251443,2022-10-20
CASH_IN,58092,Agence_mtn_Abomey,300000,241908,Jules-Marc Chauvet,37867,95959,2022-10-20
TRANSFER,92762,Jules-Marc Chauvet,95959,3197,Jules-Marc Chauvet,95959,3197,2022-10-21
CASH_OUT,2930,Jules-Marc Chauvet,3197,267,Agence_mtn_Cotonou,300000,297070,2022-10-22
CASH_OUT,252,Jules-Marc Chauvet,267,15,Agence_mtn_Ouidah,300000,299748,2022-10-22
CASH_IN,210457,Agence_mtn_Abomey,300000,89543,Jules-Marc Chauvet,15,210472,2022-10-23
CASH_IN,259566,Agence_mtn_Abomey,300000,40434,Jules-Marc Chauvet,210472,470038,2022-10-24
CASH_IN,156663,Agence_mtn_Abomey,300000,143337,Jules-Marc Chauvet,470038,626701,2022-10-27
CASH_IN,45180,Agence_mtn_Cotonou,300000,254820,Michelle de la Daniel,-281051,-235871,2022-10-01
CASH_IN,23330,Agence_mtn_Cotonou,300000,276670,Michelle de la Daniel,-235871,-212541,2022-10-01
CASH_IN,268958,Agence_mtn_Ouidah,300000,31042,Michelle de la Daniel,-212541,56417,2022-10-07
CASH_IN,283638,Agence_mtn_Ouidah,300000,16362,Michelle de la Daniel,56417,340055,2022-10-10
CASH_OUT,33473,Michelle de la Daniel,340055,306582,Agence_mtn_Ouidah,300000,266527,2022-10-15
TRANSFER,263673,Michelle de la Daniel,306582,42909,Michelle de la Daniel,306582,570255,2022-10-19
CASH_OUT,28460,Michelle de la Daniel,42909,14449,Agence_mtn_Abomey,300000,271540,2022-10-20
CASH_OUT,6039,Michelle de la Daniel,14449,8410,Agence_mtn_Cotonou,300000,293961,2022-10-27
CASH_IN,206032,Agence_mtn_Cotonou,300000,93968,Maggie Barbier,48,206080,2022-10-03
TRANSFER,154316,Maggie Barbier,206080,51764,Maggie Barbier,206080,360396,2022-10-04
CASH_IN,7617,Agence_mtn_Cotonou,300000,292383,Maggie Barbier,51764,59381,2022-10-05
TRANSFER,57833,Maggie Barbier,59381,1548,Maggie Barbier,59381,1548,2022-10-06
CASH_IN,238191,Agence_mtn_Abomey,300000,61809,Maggie Barbier,1548,239739,2022-10-08
CASH_IN,115400,Agence_mtn_Abomey,300000,184600,Maggie Barbier,239739,355139,2022-10-12
CASH_IN,167382,Agence_mtn_Abomey,300000,132618,Maggie Barbier,355139,522521,2022-10-12
CASH_IN,88041,Agence_mtn_Abomey,300000,211959,Maggie Barbier,522521,610562,2022-10-17
CASH_OUT,152189,Maggie Barbier,610562,458373,Agence_mtn_Abomey,300000,147811,2022-10-18
CASH_IN,166883,Agence_mtn_Abomey,300000,133117,Maggie Barbier,458373,625256,2022-10-21
CASH_OUT,298261,Maggie Barbier,625256,326995,Agence_mtn_Ouidah,300000,1739,2022-10-23
CASH_IN,197316,Agence_mtn_Abomey,300000,102684,Maggie Barbier,326995,524311,2022-10-24
CASH_OUT,405291,Maggie Barbier,524311,119020,Agence_mtn_Abomey,300000,-105291,2022-10-24
CASH_OUT,78741,Maggie Barbier,119020,40279,Agence_mtn_Abomey,300000,221259,2022-10-27
CASH_IN,9197,Agence_mtn_Cotonou,300000,290803,Maurice de Brunet,-197087,-187890,2022-10-01
CASH_IN,1476,Agence_mtn_Ouidah,300000,298524,Maurice de Brunet,-187890,-186414,2022-10-05
CASH_IN,36440,Agence_mtn_Abomey,300000,263560,Maurice de Brunet,-186414,-149974,2022-10-08
CASH_IN,55330,Agence_mtn_Ouidah,300000,244670,Maurice de Brunet,-149974,-94644,2022-10-08
CASH_IN,269186,Agence_mtn_Ouidah,300000,30814,Maurice de Brunet,-94644,174542,2022-10-10
TRANSFER,35803,Maurice de Brunet,174542,138739,Maurice de Brunet,174542,210345,2022-10-11
CASH_OUT,105400,Maurice de Brunet,138739,33339,Agence_mtn_Abomey,300000,194600,2022-10-11
TRANSFER,23658,Maurice de Brunet,33339,9681,Maurice de Brunet,33339,9681,2022-10-13
CASH_IN,193663,Agence_mtn_Cotonou,300000,106337,Maurice de Brunet,9681,203344,2022-10-14
CASH_OUT,143938,Maurice de Brunet,203344,59406,Agence_mtn_Abomey,300000,156062,2022-10-18
CASH_OUT,31857,Maurice de Brunet,59406,27549,Agence_mtn_Ouidah,300000,268143,2022-10-18
CASH_IN,114176,Agence_mtn_Ouidah,300000,185824,Maurice de Brunet,27549,141725,2022-10-24
CASH_IN,278145,Agence_mtn_Abomey,300000,21855,Maurice de Brunet,141725,419870,2022-10-26
CASH_IN,98912,Agence_mtn_Ouidah,300000,201088,Maurice de Brunet,419870,518782,2022-10-26
CASH_IN,231968,Agence_mtn_Ouidah,300000,68032,Astrid de Pascal,-28426,203542,2022-10-04
TRANSFER,127067,Astrid de Pascal,203542,76475,Astrid de Pascal,203542,330609,2022-10-07
CASH_IN,191251,Agence_mtn_Abomey,300000,108749,Astrid de Pascal,76475,267726,2022-10-21
CASH_IN,219260,Agence_mtn_Ouidah,300000,80740,Sylvie Dupré,-79875,139385,2022-10-01
CASH_OUT,1847,Sylvie Dupré,139385,137538,Agence_mtn_Abomey,300000,298153,2022-10-01
CASH_OUT,99759,Sylvie Dupré,137538,37779,Agence_mtn_Cotonou,300000,200241,2022-10-08
CASH_IN,201811,Agence_mtn_Abomey,300000,98189,Sylvie Dupré,37779,239590,2022-10-08
CASH_IN,193694,Agence_mtn_Cotonou,300000,106306,Sylvie Dupré,239590,433284,2022-10-12
TRANSFER,174053,Sylvie Dupré,433284,259231,Sylvie Dupré,433284,607337,2022-10-12
CASH_IN,54049,Agence_mtn_Cotonou,300000,245951,Sylvie Dupré,259231,313280,2022-10-14
TRANSFER,13276,Sylvie Dupré,313280,300004,Sylvie Dupré,313280,326556,2022-10-15
CASH_IN,11290,Agence_mtn_Abomey,300000,288710,Sylvie Dupré,300004,311294,2022-10-16
CASH_IN,75411,Agence_mtn_Abomey,300000,224589,Sylvie Dupré,311294,386705,2022-10-18
CASH_IN,57520,Agence_mtn_Abomey,300000,242480,Sylvie Dupré,386705,444225,2022-10-18
CASH_OUT,379146,Sylvie Dupré,444225,65079,Agence_mtn_Abomey,300000,-79146,2022-10-20
CASH_IN,93118,Agence_mtn_Abomey,300000,206882,Sylvie Dupré,65079,158197,2022-10-23
CASH_IN,57818,Agence_mtn_Ouidah,300000,242182,Sylvie Dupré,158197,216015,2022-10-23
CASH_OUT,4598,Sylvie Dupré,216015,211417,Agence_mtn_Ouidah,300000,295402,2022-10-23
CASH_OUT,257,Sylvie Dupré,211417,211160,Agence_mtn_Cotonou,300000,299743,2022-10-27
CASH_IN,117386,Agence_mtn_Ouidah,300000,182614,François Vaillant,-132399,-15013,2022-10-01
CASH_IN,97022,Agence_mtn_Abomey,300000,202978,François Vaillant,-15013,82009,2022-10-03
CASH_OUT,41313,François Vaillant,82009,40696,Agence_mtn_Ouidah,300000,258687,2022-10-03
CASH_IN,72879,Agence_mtn_Ouidah,300000,227121,François Vaillant,40696,113575,2022-10-06
CASH_OUT,108019,François Vaillant,113575,5556,Agence_mtn_Ouidah,300000,191981,2022-10-18
CASH_OUT,5035,François Vaillant,5556,521,Agence_mtn_Cotonou,300000,294965,2022-10-20
CASH_IN,121035,Agence_mtn_Abomey,300000,178965,François Vaillant,521,121556,2022-10-21
CASH_IN,89324,Agence_mtn_Cotonou,300000,210676,François Vaillant,121556,210880,2022-10-22
CASH_OUT,106713,François Vaillant,210880,104167,Agence_mtn_Ouidah,300000,193287,2022-10-23
CASH_IN,234607,Agence_mtn_Cotonou,300000,65393,François Vaillant,104167,338774,2022-10-24
CASH_IN,39943,Agence_mtn_Abomey,300000,260057,Charles Guérin,-181795,-141852,2022-10-02
CASH_IN,112510,Agence_mtn_Ouidah,300000,187490,Charles Guérin,-141852,-29342,2022-10-03
CASH_IN,281845,Agence_mtn_Cotonou,300000,18155,Charles Guérin,-29342,252503,2022-10-03
TRANSFER,242961,Charles Guérin,252503,9542,Charles Guérin,252503,495464,2022-10-03
CASH_OUT,8444,Charles Guérin,9542,1098,Agence_mtn_Cotonou,300000,291556,2022-10-03
TRANSFER,512,Charles Guérin,1098,586,Charles Guérin,1098,1610,2022-10-06
TRANSFER,423,Charles Guérin,586,163,Charles Guérin,586,1009,2022-10-07
TRANSFER,153,Charles Guérin,163,10,Charles Guérin,163,316,2022-10-11
CASH_IN,169101,Agence_mtn_Abomey,300000,130899,Charles Guérin,10,169111,2022-10-12
CASH_IN,60543,Agence_mtn_Cotonou,300000,239457,Charles Guérin,169111,229654,2022-10-15
CASH_IN,240877,Agence_mtn_Ouidah,300000,59123,Charles Guérin,229654,470531,2022-10-16
CASH_OUT,466977,Charles Guérin,470531,3554,Agence_mtn_Abomey,300000,-166977,2022-10-25
CASH_IN,40612,Agence_mtn_Abomey,300000,259388,Charles Guérin,3554,44166,2022-10-26
CASH_IN,274577,Agence_mtn_Cotonou,300000,25423,Matthieu Cousin,-124549,150028,2022-10-06
CASH_IN,192626,Agence_mtn_Cotonou,300000,107374,Matthieu Cousin,150028,342654,2022-10-07
TRANSFER,44119,Matthieu Cousin,342654,298535,Matthieu Cousin,342654,298535,2022-10-09
TRANSFER,59339,Matthieu Cousin,298535,239196,Matthieu Cousin,298535,357874,2022-10-12
CASH_IN,269298,Agence_mtn_Cotonou,300000,30702,Matthieu Cousin,239196,508494,2022-10-14
CASH_IN,239840,Agence_mtn_Ouidah,300000,60160,Matthieu Cousin,508494,748334,2022-10-16
CASH_IN,165473,Agence_mtn_Cotonou,300000,134527,Matthieu Cousin,748334,913807,2022-10-20
CASH_OUT,839758,Matthieu Cousin,913807,74049,Agence_mtn_Ouidah,300000,-539758,2022-10-22
CASH_IN,219173,Agence_mtn_Abomey,300000,80827,Matthieu Cousin,74049,293222,2022-10-22
CASH_IN,78977,Agence_mtn_Ouidah,300000,221023,Matthieu Cousin,293222,372199,2022-10-25
CASH_OUT,756028,Zacharie Fabre,1533900,777872,Agence_mtn_Cotonou,300000,-456028,2022-11-03
TRANSFER,71531,Zacharie Fabre,777872,706341,Clémence Dufour,339000,267469,2022-11-07
CASH_OUT,656420,Zacharie Fabre,706341,49921,Agence_mtn_Ouidah,300000,-356420,2022-11-07
CASH_IN,39252,Agence_mtn_Cotonou,300000,260748,Zacharie Fabre,49921,89173,2022-11-09
CASH_OUT,10240,Zacharie Fabre,89173,78933,Agence_mtn_Abomey,300000,289760,2022-11-18
CASH_OUT,127202,Laurent Marion,1091800,964598,Agence_mtn_Ouidah,300000,172798,2022-11-04
CASH_IN,154245,Agence_mtn_Abomey,300000,145755,Laurent Marion,964598,1118843,2022-11-15
CASH_IN,16469,Agence_mtn_Ouidah,300000,283531,Laurent Marion,1118843,1135312,2022-11-22
TRANSFER,771344,Gabrielle Hamon,1668600,897256,Laurent Marion,1135312,1906656,2022-11-23
TRANSFER,150085,Laurent Marion,1906656,1756571,Margaud-Michelle Briand,176400,26315,2022-11-27
CASH_IN,138837,Agence_mtn_Abomey,300000,161163,Sophie-Anouk Boulanger,1368500,1507337,2022-11-01
CASH_IN,53893,Agence_mtn_Abomey,300000,246107,Sophie-Anouk Boulanger,1507337,1561230,2022-11-04
TRANSFER,831168,Sophie-Anouk Boulanger,1561230,730062,Madeleine Philippe-Grondin,667500,-163668,2022-11-11
CASH_OUT,98713,Sophie-Anouk Boulanger,730062,631349,Agence_mtn_Cotonou,300000,201287,2022-11-18
CASH_IN,265890,Agence_mtn_Abomey,300000,34110,Sophie-Anouk Boulanger,631349,897239,2022-11-24
CASH_IN,273525,Agence_mtn_Cotonou,300000,26475,Maggie Barbier,1214700,1488225,2022-11-05
TRANSFER,217533,Martin Moreau,277600,60067,Maggie Barbier,1488225,1705758,2022-11-17
CASH_IN,120655,Agence_mtn_Ouidah,300000,179345,Maggie Barbier,1705758,1826413,2022-11-20
CASH_IN,138054,Agence_mtn_Abomey,300000,161946,Maggie Barbier,1826413,1964467,2022-11-22
CASH_IN,135802,Agence_mtn_Ouidah,300000,164198,Maggie Barbier,1964467,2100269,2022-11-23
CASH_OUT,689038,Sabine Perrier,691400,2362,Agence_mtn_Cotonou,300000,-389038,2022-11-01
CASH_OUT,2099,Sabine Perrier,2362,263,Agence_mtn_Cotonou,300000,297901,2022-11-03
CASH_IN,90539,Agence_mtn_Cotonou,300000,209461,Sabine Perrier,263,90802,2022-11-10
TRANSFER,39520,Sabine Perrier,90802,51282,Aimé Bernier,817500,777980,2022-11-24
CASH_OUT,41568,Sabine Perrier,51282,9714,Agence_mtn_Cotonou,300000,258432,2022-11-27
TRANSFER,319460,Nicolas Blin,557000,237540,Maryse Delorme,937000,617540,2022-11-05
CASH_OUT,211446,Nicolas Blin,237540,26094,Agence_mtn_Cotonou,300000,88554,2022-11-14
CASH_IN,151099,Agence_mtn_Abomey,300000,148901,Nicolas Blin,26094,177193,2022-11-15
CASH_IN,94704,Agence_mtn_Abomey,300000,205296,Hélène Blanchard-Renault,1539400,1634104,2022-11-18
CASH_OUT,841335,Charles Guérin,1101900,260565,Agence_mtn_Cotonou,300000,-541335,2022-11-07
CASH_IN,198136,Agence_mtn_Cotonou,300000,101864,Charles Guérin,260565,458701,2022-11-11
TRANSFER,516568,Aurélie Maury,742300,225732,Charles Guérin,458701,975269,2022-11-12
TRANSFER,92432,Charles Guérin,975269,882837,Édouard Grondin du Fleury,1172700,1080268,2022-11-19
TRANSFER,935339,Pénélope Boulay,1639000,703661,Clémence-Alice Ruiz,1980300,1044961,2022-11-07
TRANSFER,313124,Pénélope Boulay,703661,390537,Augustin-Jérôme Merle,1135200,822076,2022-11-09
CASH_OUT,339218,Pénélope Boulay,390537,51319,Agence_mtn_Ouidah,300000,-39218,2022-11-14
CASH_IN,143226,Agence_mtn_Abomey,300000,156774,Pénélope Boulay,51319,194545,2022-11-27
CASH_OUT,273917,Robert Henry-Poulain,341500,67583,Agence_mtn_Cotonou,300000,26083,2022-11-27
CASH_IN,212258,Agence_mtn_Cotonou,300000,87742,Matthieu Cousin,1023900,1236158,2022-11-21
CASH_OUT,53054,Alfred Paris,156100,103046,Agence_mtn_Abomey,300000,246946,2022-11-03
CASH_OUT,51309,Alfred Paris,103046,51737,Agence_mtn_Abomey,300000,248691,2022-11-04
TRANSFER,19677,Alfred Paris,51737,32060,Georges-Alfred Pruvost,481500,461823,2022-11-14
CASH_IN,89910,Agence_mtn_Ouidah,300000,210090,Christine Rossi,156600,246510,2022-11-05
CASH_OUT,92732,Marine Chevallier,1885800,1793068,Agence_mtn_Cotonou,300000,207268,2022-11-01
CASH_IN,122177,Agence_mtn_Abomey,300000,177823,Marine Chevallier,1793068,1915245,2022-11-04
CASH_OUT,1731011,Marine Chevallier,1915245,184234,Agence_mtn_Ouidah,300000,-1431011,2022-11-19
CASH_IN,205942,Agence_mtn_Cotonou,300000,94058,Marine Chevallier,184234,390176,2022-11-22
TRANSFER,89199,Marine Chevallier,390176,300977,Marthe Perrin,582500,493301,2022-11-24
TRANSFER,1717475,Anouk Delahaye-Gimenez,1833500,116025,Nicole-Renée Gay,1268200,2985675,2022-11-04
TRANSFER,164727,Valérie de Pottier,1653300,1488573,Nicole-Renée Gay,2985675,3150402,2022-11-06
CASH_OUT,1712769,Nicole-Renée Gay,3150402,1437633,Agence_mtn_Cotonou,300000,-1412769,2022-11-15
TRANSFER,392110,Nicole-Renée Gay,1437633,1045523,Marine Labbé,1534300,1142190,2022-11-21
CASH_IN,166603,Agence_mtn_Ouidah,300000,133397,Marc Baudry,1216000,1382603,2022-11-03
CASH_OUT,687158,Marc Baudry,1382603,695445,Agence_mtn_Abomey,300000,-387158,2022-11-03
CASH_IN,181362,Agence_mtn_Cotonou,300000,118638,Marc Baudry,695445,876807,2022-11-23
TRANSFER,325530,Jules-Marc Chauvet,608900,283370,Honoré de la Prévost,1450600,1125070,2022-11-07
CASH_IN,157985,Agence_mtn_Ouidah,300000,142015,Jules-Marc Chauvet,283370,441355,2022-11-09
CASH_IN,241439,Agence_mtn_Abomey,300000,58561,Jules-Marc Chauvet,441355,682794,2022-11-11
TRANSFER,501754,Jules-Marc Chauvet,682794,181040,Honoré de la Prévost,1125070,623316,2022-11-21
CASH_OUT,27377,Jules-Marc Chauvet,181040,153663,Agence_mtn_Ouidah,300000,272623,2022-11-24
TRANSFER,135434,Margot Julien,203800,68366,Jacques Le Marion,577400,441966,2022-11-24
TRANSFER,811129,Corinne Roussel,1723000,911871,Nicole Huet,641300,-169829,2022-11-10
TRANSFER,179206,Corinne Roussel,911871,732665,Élisabeth Blot-Bruneau,1911000,1731794,2022-11-10
CASH_OUT,360647,Corinne Roussel,732665,372018,Agence_mtn_Ouidah,300000,-60647,2022-11-21
TRANSFER,370216,Corinne Roussel,372018,1802,Marc Costa-Daniel,1579000,1208784,2022-11-24
TRANSFER,784410,Édouard Grondin du Fleury,1080268,295858,Charlotte Perrier,730000,1514410,2022-11-02
CASH_IN,102603,Agence_mtn_Cotonou,300000,197397,Charlotte Perrier,1514410,1617013,2022-11-03
CASH_OUT,698436,Charlotte Perrier,1617013,918577,Agence_mtn_Ouidah,300000,-398436,2022-11-07
CASH_OUT,342290,Charlotte Perrier,918577,576287,Agence_mtn_Ouidah,300000,-42290,2022-11-19
CASH_IN,148294,Agence_mtn_Ouidah,300000,151706,Élise Monnier,309200,457494,2022-11-22
CASH_IN,91746,Agence_mtn_Ouidah,300000,208254,Raymond Simon,1716700,1808446,2022-11-11
CASH_IN,245162,Agence_mtn_Ouidah,300000,54838,Raymond Simon,1808446,2053608,2022-11-12
TRANSFER,32287,Louis du Boyer,1302100,1269813,Aurélie Maury,225732,258019,2022-11-03
TRANSFER,1029768,Océane Faure,1827300,797532,Aurélie Maury,258019,1287787,2022-11-08
TRANSFER,23154,Honoré Grégoire-Breton,282000,258846,Aurélie Maury,1287787,1310941,2022-11-19
CASH_IN,282385,Agence_mtn_Cotonou,300000,17615,Aurélie Maury,1310941,1593326,2022-11-20
TRANSFER,980068,Julien Devaux,1432100,452032,Anouk Delahaye-Gimenez,116025,1096093,2022-11-01
CASH_IN,238781,Agence_mtn_Ouidah,300000,61219,Anouk Delahaye-Gimenez,1096093,1334874,2022-11-02
CASH_IN,132898,Agence_mtn_Cotonou,300000,167102,Anouk Delahaye-Gimenez,1334874,1467772,2022-11-03
CASH_OUT,872040,Anouk Delahaye-Gimenez,1467772,595732,Agence_mtn_Ouidah,300000,-572040,2022-11-04
CASH_IN,46604,Agence_mtn_Abomey,300000,253396,Anouk Delahaye-Gimenez,595732,642336,2022-11-06
CASH_IN,258462,Agence_mtn_Cotonou,300000,41538,Anouk Delahaye-Gimenez,642336,900798,2022-11-07
CASH_IN,252914,Agence_mtn_Abomey,300000,47086,Anouk Delahaye-Gimenez,900798,1153712,2022-11-07
CASH_IN,198399,Agence_mtn_Ouidah,300000,101601,Anouk Delahaye-Gimenez,1153712,1352111,2022-11-07
CASH_IN,183711,Agence_mtn_Abomey,300000,116289,Anouk Delahaye-Gimenez,1352111,1535822,2022-11-08
CASH_OUT,1338307,Anouk Delahaye-Gimenez,1535822,197515,Agence_mtn_Ouidah,300000,-1038307,2022-11-09
TRANSFER,813400,Augustin-Jérôme Merle,822076,8676,Anouk Delahaye-Gimenez,197515,1010915,2022-11-09
CASH_OUT,813318,Anouk Delahaye-Gimenez,1010915,197597,Agence_mtn_Abomey,300000,-513318,2022-11-11
TRANSFER,484558,Simone du Allard,1476700,992142,Anouk Delahaye-Gimenez,197597,682155,2022-11-11
CASH_IN,100772,Agence_mtn_Ouidah,300000,199228,Anouk Delahaye-Gimenez,682155,782927,2022-11-19
TRANSFER,123912,Thérèse-Juliette Camus,444000,320088,Anouk Delahaye-Gimenez,782927,906839,2022-11-21
TRANSFER,895630,Anouk Delahaye-Gimenez,906839,11209,Thérèse-Juliette Camus,320088,-575542,2022-11-23
CASH_OUT,9034,Anouk Delahaye-Gimenez,11209,2175,Agence_mtn_Abomey,300000,290966,2022-11-23
TRANSFER,1281,Anouk Delahaye-Gimenez,2175,894,Élisabeth Blot-Bruneau,1731794,1730513,2022-11-23
TRANSFER,511050,Élisabeth Delattre,725800,214750,Anouk Delahaye-Gimenez,894,511944,2022-11-24
CASH_OUT,357883,Anouk Delahaye-Gimenez,511944,154061,Agence_mtn_Ouidah,300000,-57883,2022-11-25
TRANSFER,40184,Honoré Grégoire-Breton,258846,218662,Anouk Delahaye-Gimenez,154061,194245,2022-11-26
CASH_IN,101497,Agence_mtn_Ouidah,300000,198503,Anouk Delahaye-Gimenez,194245,295742,2022-11-27
CASH_IN,96902,Agence_mtn_Cotonou,300000,203098,Anouk Delahaye-Gimenez,295742,392644,2022-11-27
CASH_IN,66900,Agence_mtn_Ouidah,300000,233100,Madeleine Philippe-Grondin,-163668,-96768,2022-11-01
CASH_IN,219840,Agence_mtn_Abomey,300000,80160,Madeleine Philippe-Grondin,-96768,123072,2022-11-03
TRANSFER,110654,Madeleine Philippe-Grondin,123072,12418,Honoré de la Prévost,623316,512662,2022-11-03
CASH_IN,123202,Agence_mtn_Ouidah,300000,176798,Madeleine Philippe-Grondin,12418,135620,2022-11-04
CASH_OUT,13312,Madeleine Philippe-Grondin,135620,122308,Agence_mtn_Abomey,300000,286688,2022-11-05
TRANSFER,98828,Gérard Blot de Blanc,417700,318872,Madeleine Philippe-Grondin,122308,221136,2022-11-05
CASH_OUT,71767,Madeleine Philippe-Grondin,221136,149369,Agence_mtn_Abomey,300000,228233,2022-11-06
CASH_OUT,70263,Madeleine Philippe-Grondin,149369,79106,Agence_mtn_Abomey,300000,229737,2022-11-07
CASH_OUT,56928,Madeleine Philippe-Grondin,79106,22178,Agence_mtn_Cotonou,300000,243072,2022-11-07
CASH_OUT,7469,Madeleine Philippe-Grondin,22178,14709,Agence_mtn_Ouidah,300000,292531,2022-11-07
CASH_IN,65636,Agence_mtn_Ouidah,300000,234364,Madeleine Philippe-Grondin,14709,80345,2022-11-09
CASH_IN,206095,Agence_mtn_Ouidah,300000,93905,Madeleine Philippe-Grondin,80345,286440,2022-11-12
TRANSFER,184203,Madeleine Philippe-Grondin,286440,102237,René de la Delaunay,1142000,957797,2022-11-12
CASH_OUT,27892,Madeleine Philippe-Grondin,102237,74345,Agence_mtn_Abomey,300000,272108,2022-11-14
TRANSFER,152687,François Vaillant,902800,750113,Madeleine Philippe-Grondin,74345,227032,2022-11-15
TRANSFER,134840,Madeleine Philippe-Grondin,227032,92192,Emmanuel Vallée,158100,23260,2022-11-18
CASH_OUT,23188,Madeleine Philippe-Grondin,92192,69004,Agence_mtn_Abomey,300000,276812,2022-11-19
CASH_IN,58275,Agence_mtn_Ouidah,300000,241725,Madeleine Philippe-Grondin,69004,127279,2022-11-22
CASH_IN,245388,Agence_mtn_Cotonou,300000,54612,Madeleine Philippe-Grondin,127279,372667,2022-11-23
CASH_IN,2406,Agence_mtn_Abomey,300000,297594,Madeleine Philippe-Grondin,372667,375073,2022-11-23
CASH_IN,133332,Agence_mtn_Cotonou,300000,166668,Madeleine Philippe-Grondin,375073,508405,2022-11-23
CASH_IN,230833,Agence_mtn_Cotonou,300000,69167,Madeleine Philippe-Grondin,508405,739238,2022-11-26
TRANSFER,100716,Océane Faure,797532,696816,Madeleine Philippe-Grondin,739238,839954,2022-11-26
TRANSFER,568849,Gérard Cordier,1278000,709151,Alexandre Delaunay,166300,735149,2022-11-01
CASH_IN,37782,Agence_mtn_Abomey,300000,262218,Alexandre Delaunay,735149,772931,2022-11-01
CASH_IN,14411,Agence_mtn_Ouidah,300000,285589,Alexandre Delaunay,772931,787342,2022-11-03
TRANSFER,78417,Alexandre Delaunay,787342,708925,Julien Devaux,452032,373615,2022-11-04
TRANSFER,301549,Alexandre Delaunay,708925,407376,Nathalie Da Silva,221100,-80449,2022-11-04
CASH_OUT,392611,Alexandre Delaunay,407376,14765,Agence_mtn_Cotonou,300000,-92611,2022-11-04
TRANSFER,1003843,Danielle-Henriette Tessier,1250400,246557,Alexandre Delaunay,14765,1018608,2022-11-05
CASH_OUT,454279,Alexandre Delaunay,1018608,564329,Agence_mtn_Cotonou,300000,-154279,2022-11-08
TRANSFER,1742604,Raymond-Yves Boulanger,1853500,110896,Alexandre Delaunay,564329,2306933,2022-11-09
TRANSFER,1262731,Maurice de Brunet,1481500,218769,Alexandre Delaunay,2306933,3569664,2022-11-10
TRANSFER,1347639,Alexandre Delaunay,3569664,2222025,Augustin-Jérôme Merle,8676,-1338963,2022-11-10
TRANSFER,337033,Julie Germain Le Vaillant,772100,435067,Alexandre Delaunay,2222025,2559058,2022-11-11
TRANSFER,1261715,Alexandre Delaunay,2559058,1297343,Édouard Grondin du Fleury,295858,-965857,2022-11-11
CASH_IN,33646,Agence_mtn_Abomey,300000,266354,Alexandre Delaunay,1297343,1330989,2022-11-12
CASH_OUT,546520,Alexandre Delaunay,1330989,784469,Agence_mtn_Ouidah,300000,-246520,2022-11-12
CASH_IN,41711,Agence_mtn_Abomey,300000,258289,Alexandre Delaunay,784469,826180,2022-11-13
TRANSFER,554804,Aimé Bernier,777980,223176,Alexandre Delaunay,826180,1380984,2022-11-16
CASH_OUT,776711,Alexandre Delaunay,1380984,604273,Agence_mtn_Abomey,300000,-476711,2022-11-17
TRANSFER,53170,Josette du Hamon,149800,96630,Alexandre Delaunay,604273,657443,2022-11-19
TRANSFER,179748,Alexandre Delaunay,657443,477695,Emmanuel Vallée,23260,-156488,2022-11-19
CASH_OUT,58853,Alexandre Delaunay,477695,418842,Agence_mtn_Ouidah,300000,241147,2022-11-19
CASH_IN,229021,Agence_mtn_Cotonou,300000,70979,Alexandre Delaunay,418842,647863,2022-11-20
TRANSFER,419298,Alexandre Delaunay,647863,228565,Gérard Cordier,709151,289853,2022-11-22
TRANSFER,193038,Alexandre Delaunay,228565,35527,Océane Faure,696816,503778,2022-11-23
CASH_IN,229989,Agence_mtn_Abomey,300000,70011,Alexandre Delaunay,35527,265516,2022-11-23
CASH_OUT,53019,Alexandre Delaunay,265516,212497,Agence_mtn_Cotonou,300000,246981,2022-11-26
CASH_IN,53579,Agence_mtn_Abomey,300000,246421,Alexandre Delaunay,212497,266076,2022-11-26
CASH_IN,185816,Agence_mtn_Cotonou,300000,114184,René de la Delaunay,957797,1143613,2022-11-03
CASH_OUT,1136199,René de la Delaunay,1143613,7414,Agence_mtn_Abomey,300000,-836199,2022-11-03
CASH_OUT,1128,René de la Delaunay,7414,6286,Agence_mtn_Abomey,300000,298872,2022-11-03
CASH_IN,196325,Agence_mtn_Ouidah,300000,103675,René de la Delaunay,6286,202611,2022-11-05
CASH_IN,24911,Agence_mtn_Ouidah,300000,275089,René de la Delaunay,202611,227522,2022-11-08
CASH_IN,55601,Agence_mtn_Cotonou,300000,244399,René de la Delaunay,227522,283123,2022-11-09
CASH_IN,97290,Agence_mtn_Ouidah,300000,202710,René de la Delaunay,283123,380413,2022-11-09
CASH_OUT,342676,René de la Delaunay,380413,37737,Agence_mtn_Abomey,300000,-42676,2022-11-12
CASH_IN,118269,Agence_mtn_Cotonou,300000,181731,René de la Delaunay,37737,156006,2022-11-12
CASH_IN,154356,Agence_mtn_Cotonou,300000,145644,René de la Delaunay,156006,310362,2022-11-13
TRANSFER,458105,Nathalie-Claire De Oliveira,1987100,1528995,René de la Delaunay,310362,768467,2022-11-13
TRANSFER,964015,Thibault-Julien Chevallier,1878200,914185,René de la Delaunay,768467,1732482,2022-11-16
CASH_OUT,515267,René de la Delaunay,1732482,1217215,Agence_mtn_Abomey,300000,-215267,2022-11-16
CASH_OUT,178166,René de la Delaunay,1217215,1039049,Agence_mtn_Cotonou,300000,121834,2022-11-17
TRANSFER,1017589,René de la Delaunay,1039049,21460,Véronique Hardy,1991000,973411,2022-11-18
TRANSFER,12370,René de la Delaunay,21460,9090,Josette du Hamon,96630,84260,2022-11-19
CASH_OUT,2887,René de la Delaunay,9090,6203,Agence_mtn_Abomey,300000,297113,2022-11-21
TRANSFER,389986,Gilbert Moulin,769000,379014,René de la Delaunay,6203,396189,2022-11-21
CASH_IN,199512,Agence_mtn_Ouidah,300000,100488,René de la Delaunay,396189,595701,2022-11-23
CASH_OUT,296828,René de la Delaunay,595701,298873,Agence_mtn_Abomey,300000,3172,2022-11-24
CASH_IN,118360,Agence_mtn_Ouidah,300000,181640,René de la Delaunay,298873,417233,2022-11-26
TRANSFER,51040,René de la Delaunay,417233,366193,Thibault-Julien Chevallier,914185,863145,2022-11-26
CASH_OUT,362311,René de la Delaunay,366193,3882,Agence_mtn_Abomey,300000,-62311,2022-11-27
CASH_OUT,1884,René de la Delaunay,3882,1998,Agence_mtn_Ouidah,300000,298116,2022-11-27
CASH_IN,250541,Agence_mtn_Cotonou,300000,49459,René de la Delaunay,1998,252539,2022-11-27
CASH_OUT,87045,René de la Delaunay,252539,165494,Agence_mtn_Cotonou,300000,212955,2022-11-27
TRANSFER,319805,Louise-Aurore Payet,725100,405295,Roland Huet,1063900,1383705,2022-11-03
CASH_OUT,65148,Roland Huet,1383705,1318557,Agence_mtn_Ouidah,300000,234852,2022-11-04
CASH_IN,15010,Agence_mtn_Ouidah,300000,284990,Roland Huet,1318557,1333567,2022-11-04
TRANSFER,109756,Roland Huet,1333567,1223811,Emmanuelle Le Allain,780000,670244,2022-11-05
CASH_IN,97129,Agence_mtn_Ouidah,300000,202871,Roland Huet,1223811,1320940,2022-11-07
CASH_IN,39711,Agence_mtn_Ouidah,300000,260289,Roland Huet,1320940,1360651,2022-11-07
CASH_OUT,174913,Roland Huet,1360651,1185738,Agence_mtn_Ouidah,300000,125087,2022-11-07
CASH_IN,95600,Agence_mtn_Ouidah,300000,204400,Roland Huet,1185738,1281338,2022-11-07
CASH_IN,134192,Agence_mtn_Cotonou,300000,165808,Roland Huet,1281338,1415530,2022-11-08
CASH_IN,156466,Agence_mtn_Abomey,300000,143534,Roland Huet,1415530,1571996,2022-11-08
CASH_OUT,1131024,Roland Huet,1571996,440972,Agence_mtn_Abomey,300000,-831024,2022-11-10
CASH_IN,229193,Agence_mtn_Ouidah,300000,70807,Roland Huet,440972,670165,2022-11-11
CASH_OUT,639360,Roland Huet,670165,30805,Agence_mtn_Abomey,300000,-339360,2022-11-12
CASH_IN,266800,Agence_mtn_Cotonou,300000,33200,Roland Huet,30805,297605,2022-11-13
TRANSFER,377277,Emmanuelle Le Allain,670244,292967,Roland Huet,297605,674882,2022-11-15
CASH_IN,43037,Agence_mtn_Cotonou,300000,256963,Roland Huet,674882,717919,2022-11-16
CASH_IN,23090,Agence_mtn_Ouidah,300000,276910,Roland Huet,717919,741009,2022-11-16
CASH_OUT,573424,Roland Huet,741009,167585,Agence_mtn_Abomey,300000,-273424,2022-11-17
TRANSFER,250477,Simone du Allard,992142,741665,Roland Huet,167585,418062,2022-11-18
CASH_OUT,1702,Roland Huet,418062,416360,Agence_mtn_Ouidah,300000,298298,2022-11-22
CASH_OUT,34359,Roland Huet,416360,382001,Agence_mtn_Cotonou,300000,265641,2022-11-22
CASH_IN,140590,Agence_mtn_Abomey,300000,159410,Roland Huet,382001,522591,2022-11-25
CASH_IN,27381,Agence_mtn_Cotonou,300000,272619,Roland Huet,522591,549972,2022-11-25
CASH_IN,228107,Agence_mtn_Cotonou,300000,71893,Roland Huet,549972,778079,2022-11-26
CASH_IN,92663,Agence_mtn_Cotonou,300000,207337,Roland Huet,778079,870742,2022-11-27
TRANSFER,364075,Valérie-Claudine Marin,445600,81525,Louise-Aurore Payet,405295,41220,2022-11-01
CASH_OUT,41355,Valérie-Claudine Marin,81525,40170,Agence_mtn_Abomey,300000,258645,2022-11-02
CASH_OUT,37891,Valérie-Claudine Marin,40170,2279,Agence_mtn_Cotonou,300000,262109,2022-11-02
CASH_OUT,1205,Valérie-Claudine Marin,2279,1074,Agence_mtn_Ouidah,300000,298795,2022-11-02
CASH_OUT,1010,Valérie-Claudine Marin,1074,64,Agence_mtn_Abomey,300000,298990,2022-11-03
CASH_IN,29183,Agence_mtn_Cotonou,300000,270817,Valérie-Claudine Marin,64,29247,2022-11-05
CASH_IN,265356,Agence_mtn_Ouidah,300000,34644,Valérie-Claudine Marin,29247,294603,2022-11-05
TRANSFER,142367,Valérie-Claudine Marin,294603,152236,Georges-Alfred Pruvost,461823,319456,2022-11-06
CASH_IN,277808,Agence_mtn_Ouidah,300000,22192,Valérie-Claudine Marin,152236,430044,2022-11-10
TRANSFER,12044,Martin Moreau,60067,48023,Valérie-Claudine Marin,430044,442088,2022-11-13
CASH_OUT,400508,Valérie-Claudine Marin,442088,41580,Agence_mtn_Abomey,300000,-100508,2022-11-14
CASH_OUT,3362,Valérie-Claudine Marin,41580,38218,Agence_mtn_Cotonou,300000,296638,2022-11-14
CASH_IN,141737,Agence_mtn_Ouidah,300000,158263,Valérie-Claudine Marin,38218,179955,2022-11-16
TRANSFER,179275,Valérie-Claudine Marin,179955,680,Françoise Denis de Allard,965400,786125,2022-11-17
CASH_OUT,227,Valérie-Claudine Marin,680,453,Agence_mtn_Abomey,300000,299773,2022-11-17
CASH_IN,235201,Agence_mtn_Abomey,300000,64799,Valérie-Claudine Marin,453,235654,2022-11-18
CASH_OUT,215357,Valérie-Claudine Marin,235654,20297,Agence_mtn_Abomey,300000,84643,2022-11-19
TRANSFER,1319,Valérie-Claudine Marin,20297,18978,Christophe Teixeira,983300,981981,2022-11-19
CASH_IN,176252,Agence_mtn_Cotonou,300000,123748,Valérie-Claudine Marin,18978,195230,2022-11-19
CASH_OUT,70227,Valérie-Claudine Marin,195230,125003,Agence_mtn_Cotonou,300000,229773,2022-11-20
TRANSFER,53934,Clémence Dufour,267469,213535,Valérie-Claudine Marin,125003,178937,2022-11-21
TRANSFER,65830,Valérie-Claudine Marin,178937,113107,Jacques Laporte de Blanchet,749400,683570,2022-11-22
TRANSFER,180759,Danielle-Henriette Tessier,246557,65798,Valérie-Claudine Marin,113107,293866,2022-11-25
CASH_IN,299565,Agence_mtn_Ouidah,300000,435,Valérie-Claudine Marin,293866,593431,2022-11-26
CASH_IN,78998,Agence_mtn_Abomey,300000,221002,Valérie-Claudine Marin,593431,672429,2022-11-27
CASH_OUT,427559,Astrid Aubert-Thierry,1879500,1451941,Agence_mtn_Cotonou,300000,-127559,2022-11-02
CASH_OUT,512013,Astrid Aubert-Thierry,1451941,939928,Agence_mtn_Cotonou,300000,-212013,2022-11-02
TRANSFER,839752,Astrid Aubert-Thierry,939928,100176,Louis du Boyer,1269813,430061,2022-11-03
CASH_IN,173516,Agence_mtn_Ouidah,300000,126484,Astrid Aubert-Thierry,100176,273692,2022-11-04
CASH_OUT,40100,Astrid Aubert-Thierry,273692,233592,Agence_mtn_Abomey,300000,259900,2022-11-04
CASH_IN,68129,Agence_mtn_Abomey,300000,231871,Astrid Aubert-Thierry,233592,301721,2022-11-04
CASH_OUT,156368,Astrid Aubert-Thierry,301721,145353,Agence_mtn_Cotonou,300000,143632,2022-11-05
TRANSFER,88964,Astrid Aubert-Thierry,145353,56389,Gilbert Moulin,379014,290050,2022-11-07
CASH_OUT,8993,Astrid Aubert-Thierry,56389,47396,Agence_mtn_Cotonou,300000,291007,2022-11-11
CASH_OUT,33048,Astrid Aubert-Thierry,47396,14348,Agence_mtn_Cotonou,300000,266952,2022-11-12
TRANSFER,7317,Astrid Aubert-Thierry,14348,7031,Julien Devaux,373615,366298,2022-11-13
TRANSFER,151,Astrid Aubert-Thierry,7031,6880,Marc Costa-Daniel,1208784,1208633,2022-11-15
CASH_IN,248481,Agence_mtn_Cotonou,300000,51519,Astrid Aubert-Thierry,6880,255361,2022-11-15
TRANSFER,193745,Astrid Aubert-Thierry,255361,61616,Louise-Aurore Payet,41220,-152525,2022-11-17
CASH_OUT,13583,Astrid Aubert-Thierry,61616,48033,Agence_mtn_Cotonou,300000,286417,2022-11-21
TRANSFER,33288,Astrid Aubert-Thierry,48033,14745,François Vaillant,750113,716825,2022-11-21
CASH_OUT,1990,Astrid Aubert-Thierry,14745,12755,Agence_mtn_Ouidah,300000,298010,2022-11-23
CASH_OUT,4280,Astrid Aubert-Thierry,12755,8475,Agence_mtn_Cotonou,300000,295720,2022-11-23
CASH_IN,273346,Agence_mtn_Abomey,300000,26654,Astrid Aubert-Thierry,8475,281821,2022-11-23
CASH_IN,153917,Agence_mtn_Cotonou,300000,146083,Astrid Aubert-Thierry,281821,435738,2022-11-23
CASH_OUT,147940,Astrid Aubert-Thierry,435738,287798,Agence_mtn_Ouidah,300000,152060,2022-11-24
TRANSFER,89167,Astrid Aubert-Thierry,287798,198631,Georges Muller,124600,35433,2022-11-24
CASH_OUT,160270,Astrid Aubert-Thierry,198631,38361,Agence_mtn_Cotonou,300000,139730,2022-11-25
TRANSFER,5445,Astrid Aubert-Thierry,38361,32916,Sylvie Dupré,787600,782155,2022-11-25
CASH_IN,211646,Agence_mtn_Ouidah,300000,88354,Astrid Aubert-Thierry,32916,244562,2022-11-25
CASH_OUT,2967,Astrid Aubert-Thierry,244562,241595,Agence_mtn_Abomey,300000,297033,2022-11-25
CASH_IN,130020,Agence_mtn_Abomey,300000,169980,Astrid Aubert-Thierry,241595,371615,2022-11-26
CASH_IN,63346,Agence_mtn_Abomey,300000,236654,Astrid Aubert-Thierry,371615,434961,2022-11-26
CASH_OUT,200121,Astrid Aubert-Thierry,434961,234840,Agence_mtn_Abomey,300000,99879,2022-11-27
TRANSFER,317160,Madeleine Hardy,1299500,982340,Astrid Aubert-Thierry,234840,552000,2022-11-27
TRANSFER,307392,Georges-Alfred Pruvost,319456,12064,Raymond-Yves Boulanger,110896,-196496,2022-11-02
CASH_IN,209166,Agence_mtn_Abomey,300000,90834,Georges-Alfred Pruvost,12064,221230,2022-11-04
CASH_OUT,69871,Georges-Alfred Pruvost,221230,151359,Agence_mtn_Abomey,300000,230129,2022-11-05
TRANSFER,136293,Georges-Alfred Pruvost,151359,15066,Christophe Besnard-Diaz,309600,173307,2022-11-06
CASH_IN,102836,Agence_mtn_Ouidah,300000,197164,Georges-Alfred Pruvost,15066,117902,2022-11-09
CASH_OUT,109381,Georges-Alfred Pruvost,117902,8521,Agence_mtn_Cotonou,300000,190619,2022-11-11
TRANSFER,1427,Georges-Alfred Pruvost,8521,7094,Hélène Alexandre de la Samson,898500,897073,2022-11-12
CASH_IN,130347,Agence_mtn_Ouidah,300000,169653,Georges-Alfred Pruvost,7094,137441,2022-11-12
CASH_IN,38652,Agence_mtn_Abomey,300000,261348,Georges-Alfred Pruvost,137441,176093,2022-11-14
TRANSFER,99922,Georges-Alfred Pruvost,176093,76171,Thibault-Julien Chevallier,863145,763223,2022-11-16
CASH_OUT,15634,Georges-Alfred Pruvost,76171,60537,Agence_mtn_Ouidah,300000,284366,2022-11-19
TRANSFER,46598,Georges-Alfred Pruvost,60537,13939,Clémence Dufour,213535,166937,2022-11-19
CASH_IN,173959,Agence_mtn_Ouidah,300000,126041,Georges-Alfred Pruvost,13939,187898,2022-11-22
CASH_OUT,160926,Georges-Alfred Pruvost,187898,26972,Agence_mtn_Ouidah,300000,139074,2022-11-22
TRANSFER,23483,Georges-Alfred Pruvost,26972,3489,Marthe Perrin,493301,469818,2022-11-22
CASH_IN,173416,Agence_mtn_Ouidah,300000,126584,Georges-Alfred Pruvost,3489,176905,2022-11-22
TRANSFER,54140,Georges-Alfred Pruvost,176905,122765,Clémence-Alice Ruiz,1044961,990821,2022-11-24
CASH_OUT,48612,Georges-Alfred Pruvost,122765,74153,Agence_mtn_Abomey,300000,251388,2022-11-25
CASH_IN,45380,Agence_mtn_Cotonou,300000,254620,Georges-Alfred Pruvost,74153,119533,2022-11-26
CASH_OUT,88753,Georges-Alfred Pruvost,119533,30780,Agence_mtn_Abomey,300000,211247,2022-11-26
CASH_OUT,15141,Georges-Alfred Pruvost,30780,15639,Agence_mtn_Cotonou,300000,284859,2022-11-27
TRANSFER,25786,Maurice de Brunet,218769,192983,Gérard Blot de Blanc,318872,293086,2022-11-04
CASH_OUT,163185,Maurice de Brunet,192983,29798,Agence_mtn_Abomey,300000,136815,2022-11-06
CASH_OUT,16917,Maurice de Brunet,29798,12881,Agence_mtn_Cotonou,300000,283083,2022-11-10
CASH_IN,46615,Agence_mtn_Abomey,300000,253385,Maurice de Brunet,12881,59496,2022-11-10
TRANSFER,849687,Michèle Faivre,1862200,1012513,Maurice de Brunet,59496,909183,2022-11-10
TRANSFER,552294,Maurice de Brunet,909183,356889,Jean Guilbert-Lenoir,63000,-489294,2022-11-12
CASH_IN,197746,Agence_mtn_Abomey,300000,102254,Maurice de Brunet,356889,554635,2022-11-12
TRANSFER,54563,Maurice de Brunet,554635,500072,Danielle-Henriette Tessier,65798,11235,2022-11-15
CASH_IN,197273,Agence_mtn_Cotonou,300000,102727,Maurice de Brunet,500072,697345,2022-11-17
CASH_OUT,470450,Maurice de Brunet,697345,226895,Agence_mtn_Abomey,300000,-170450,2022-11-17
CASH_IN,119523,Agence_mtn_Ouidah,300000,180477,Maurice de Brunet,226895,346418,2022-11-18
CASH_IN,283568,Agence_mtn_Abomey,300000,16432,Maurice de Brunet,346418,629986,2022-11-19
TRANSFER,538562,Maurice de Brunet,629986,91424,Simone du Allard,741665,203103,2022-11-19
CASH_OUT,41114,Maurice de Brunet,91424,50310,Agence_mtn_Cotonou,300000,258886,2022-11-19
TRANSFER,34225,Maurice de Brunet,50310,16085,Jacques Marchand,1640300,1606075,2022-11-21
TRANSFER,598681,Marine Labbé,1142190,543509,Maurice de Brunet,16085,614766,2022-11-22
CASH_OUT,490975,Maurice de Brunet,614766,123791,Agence_mtn_Cotonou,300000,-190975,2022-11-23
CASH_IN,58365,Agence_mtn_Cotonou,300000,241635,Maurice de Brunet,123791,182156,2022-11-23
CASH_IN,164252,Agence_mtn_Ouidah,300000,135748,Maurice de Brunet,182156,346408,2022-11-23
TRANSFER,181604,Emmanuelle Le Allain,292967,111363,Maurice de Brunet,346408,528012,2022-11-24
TRANSFER,449547,Maurice de Brunet,528012,78465,Marc Costa-Daniel,1208633,759086,2022-11-25
CASH_IN,86649,Agence_mtn_Ouidah,300000,213351,Maurice de Brunet,78465,165114,2022-11-26
CASH_IN,127355,Agence_mtn_Ouidah,300000,172645,Honoré de la Prévost,512662,640017,2022-11-03
TRANSFER,576104,Gabrielle Hamon,897256,321152,Honoré de la Prévost,640017,1216121,2022-11-03
TRANSFER,198537,Honoré de la Prévost,1216121,1017584,Françoise Denis de Allard,786125,587588,2022-11-05
CASH_IN,248149,Agence_mtn_Cotonou,300000,51851,Honoré de la Prévost,1017584,1265733,2022-11-06
CASH_OUT,597760,Honoré de la Prévost,1265733,667973,Agence_mtn_Abomey,300000,-297760,2022-11-07
CASH_IN,210540,Agence_mtn_Ouidah,300000,89460,Honoré de la Prévost,667973,878513,2022-11-07
CASH_IN,89924,Agence_mtn_Abomey,300000,210076,Honoré de la Prévost,878513,968437,2022-11-08
CASH_OUT,535608,Honoré de la Prévost,968437,432829,Agence_mtn_Abomey,300000,-235608,2022-11-09
CASH_OUT,179639,Honoré de la Prévost,432829,253190,Agence_mtn_Cotonou,300000,120361,2022-11-12
TRANSFER,1406482,Jacques Marchand,1606075,199593,Honoré de la Prévost,253190,1659672,2022-11-12
CASH_OUT,666062,Honoré de la Prévost,1659672,993610,Agence_mtn_Cotonou,300000,-366062,2022-11-14
CASH_OUT,702473,Honoré de la Prévost,993610,291137,Agence_mtn_Cotonou,300000,-402473,2022-11-14
CASH_IN,292106,Agence_mtn_Abomey,300000,7894,Honoré de la Prévost,291137,583243,2022-11-15
CASH_IN,49119,Agence_mtn_Cotonou,300000,250881,Honoré de la Prévost,583243,632362,2022-11-16
TRANSFER,404714,Jacques Laporte de Blanchet,683570,278856,Honoré de la Prévost,632362,1037076,2022-11-16
CASH_OUT,530820,Honoré de la Prévost,1037076,506256,Agence_mtn_Ouidah,300000,-230820,2022-11-18
CASH_IN,69858,Agence_mtn_Ouidah,300000,230142,Honoré de la Prévost,506256,576114,2022-11-18
CASH_IN,245219,Agence_mtn_Ouidah,300000,54781,Honoré de la Prévost,576114,821333,2022-11-19
TRANSFER,15217,Océane Faure,503778,488561,Honoré de la Prévost,821333,836550,2022-11-20
CASH_IN,92905,Agence_mtn_Ouidah,300000,207095,Honoré de la Prévost,836550,929455,2022-11-21
CASH_IN,124055,Agence_mtn_Ouidah,300000,175945,Honoré de la Prévost,929455,1053510,2022-11-22
CASH_IN,49718,Agence_mtn_Abomey,300000,250282,Honoré de la Prévost,1053510,1103228,2022-11-27
TRANSFER,397333,Christophe Teixeira,981981,584648,Honoré de la Prévost,1103228,1500561,2022-11-27
CASH_OUT,390420,Madeleine Hardy,982340,591920,Agence_mtn_Ouidah,300000,-90420,2022-11-01
CASH_IN,129947,Agence_mtn_Cotonou,300000,170053,Madeleine Hardy,591920,721867,2022-11-03
CASH_OUT,560991,Madeleine Hardy,721867,160876,Agence_mtn_Abomey,300000,-260991,2022-11-04
CASH_IN,16115,Agence_mtn_Cotonou,300000,283885,Madeleine Hardy,160876,176991,2022-11-05
CASH_IN,267218,Agence_mtn_Abomey,300000,32782,Madeleine Hardy,176991,444209,2022-11-05
CASH_IN,156257,Agence_mtn_Ouidah,300000,143743,Madeleine Hardy,444209,600466,2022-11-05
TRANSFER,10514,Danielle-Henriette Tessier,11235,721,Madeleine Hardy,600466,610980,2022-11-06
TRANSFER,18285,Margaud-Michelle Briand,26315,8030,Madeleine Hardy,610980,629265,2022-11-10
TRANSFER,311492,Madeleine Hardy,629265,317773,Madeleine Hardy,629265,317773,2022-11-10
CASH_IN,140980,Agence_mtn_Abomey,300000,159020,Madeleine Hardy,317773,458753,2022-11-10
CASH_IN,77892,Agence_mtn_Ouidah,300000,222108,Madeleine Hardy,458753,536645,2022-11-13
TRANSFER,924258,Stéphanie Guichard,1671100,746842,Madeleine Hardy,536645,1460903,2022-11-13
CASH_IN,256090,Agence_mtn_Ouidah,300000,43910,Madeleine Hardy,1460903,1716993,2022-11-14
CASH_IN,286656,Agence_mtn_Ouidah,300000,13344,Madeleine Hardy,1716993,2003649,2022-11-15
TRANSFER,365233,Michèle Faivre,1012513,647280,Madeleine Hardy,2003649,2368882,2022-11-18
TRANSFER,1219895,Madeleine Hardy,2368882,1148987,Thibault Martin,616500,-603395,2022-11-23
CASH_IN,267177,Agence_mtn_Ouidah,300000,32823,Madeleine Hardy,1148987,1416164,2022-11-24
CASH_OUT,1340338,Madeleine Hardy,1416164,75826,Agence_mtn_Ouidah,300000,-1040338,2022-11-24
CASH_OUT,25217,Madeleine Hardy,75826,50609,Agence_mtn_Cotonou,300000,274783,2022-11-25
CASH_OUT,19741,Madeleine Hardy,50609,30868,Agence_mtn_Abomey,300000,280259,2022-11-25
TRANSFER,18806,Madeleine Hardy,30868,12062,Margaud-Michelle Briand,8030,-10776,2022-11-26
CASH_OUT,2043,Madeleine Hardy,12062,10019,Agence_mtn_Ouidah,300000,297957,2022-11-27
TRANSFER,26525,Aimé Bernier,223176,196651,Madeleine Hardy,10019,36544,2022-11-27
TRANSFER,57028,Thibault-Julien Chevallier,763223,706195,Hélène Alexandre de la Samson,897073,954101,2022-11-01
CASH_IN,99564,Agence_mtn_Ouidah,300000,200436,Hélène Alexandre de la Samson,954101,1053665,2022-11-01
CASH_IN,124688,Agence_mtn_Ouidah,300000,175312,Hélène Alexandre de la Samson,1053665,1178353,2022-11-01
TRANSFER,533229,Hélène Alexandre de la Samson,1178353,645124,Jacques Laporte de Blanchet,278856,-254373,2022-11-02
CASH_IN,179749,Agence_mtn_Cotonou,300000,120251,Hélène Alexandre de la Samson,645124,824873,2022-11-03
TRANSFER,21477,Hélène Alexandre de la Samson,824873,803396,Véronique Hardy,973411,951934,2022-11-04
CASH_IN,168718,Agence_mtn_Abomey,300000,131282,Hélène Alexandre de la Samson,803396,972114,2022-11-04
TRANSFER,5397,Marc Costa-Daniel,759086,753689,Hélène Alexandre de la Samson,972114,977511,2022-11-05
CASH_OUT,148697,Hélène Alexandre de la Samson,977511,828814,Agence_mtn_Cotonou,300000,151303,2022-11-05
TRANSFER,16838,Hélène Alexandre de la Samson,828814,811976,Alexandre Blanchard,1796000,1779162,2022-11-08
CASH_IN,12684,Agence_mtn_Abomey,300000,287316,Hélène Alexandre de la Samson,811976,824660,2022-11-08
CASH_IN,75137,Agence_mtn_Abomey,300000,224863,Hélène Alexandre de la Samson,824660,899797,2022-11-09
CASH_IN,222351,Agence_mtn_Ouidah,300000,77649,Hélène Alexandre de la Samson,899797,1122148,2022-11-10
CASH_IN,281188,Agence_mtn_Abomey,300000,18812,Hélène Alexandre de la Samson,1122148,1403336,2022-11-12
CASH_IN,13923,Agence_mtn_Abomey,300000,286077,Hélène Alexandre de la Samson,1403336,1417259,2022-11-13
TRANSFER,1344290,Hélène Alexandre de la Samson,1417259,72969,Emmanuel Legrand,1746100,401810,2022-11-14
CASH_OUT,23843,Hélène Alexandre de la Samson,72969,49126,Agence_mtn_Abomey,300000,276157,2022-11-15
TRANSFER,71734,Josette du Hamon,84260,12526,Hélène Alexandre de la Samson,49126,120860,2022-11-15
TRANSFER,20603,Hélène Alexandre de la Samson,120860,100257,Emmanuel Legrand,401810,381207,2022-11-16
CASH_OUT,61582,Hélène Alexandre de la Samson,100257,38675,Agence_mtn_Ouidah,300000,238418,2022-11-17
CASH_OUT,4714,Hélène Alexandre de la Samson,38675,33961,Agence_mtn_Cotonou,300000,295286,2022-11-17
TRANSFER,30165,Hélène Alexandre de la Samson,33961,3796,Julie Germain Le Vaillant,435067,404902,2022-11-19
TRANSFER,2633,Hélène Alexandre de la Samson,3796,1163,Gérard Blot de Blanc,293086,290453,2022-11-19
CASH_OUT,541,Hélène Alexandre de la Samson,1163,622,Agence_mtn_Ouidah,300000,299459,2022-11-19
CASH_IN,140837,Agence_mtn_Abomey,300000,159163,Hélène Alexandre de la Samson,622,141459,2022-11-20
TRANSFER,36547,Julien Devaux,366298,329751,Hélène Alexandre de la Samson,141459,178006,2022-11-21
TRANSFER,6795,Hélène Alexandre de la Samson,178006,171211,Élisabeth Delattre,214750,207955,2022-11-23
TRANSFER,31733,Hélène Alexandre de la Samson,171211,139478,Marine Labbé,543509,511776,2022-11-24
CASH_IN,182726,Agence_mtn_Cotonou,300000,117274,Thibault Martin,-603395,-420669,2022-11-01
CASH_IN,270392,Agence_mtn_Ouidah,300000,29608,Thibault Martin,-420669,-150277,2022-11-03
CASH_IN,274436,Agence_mtn_Abomey,300000,25564,Thibault Martin,-150277,124159,2022-11-04
CASH_IN,255090,Agence_mtn_Cotonou,300000,44910,Thibault Martin,124159,379249,2022-11-05
CASH_IN,35802,Agence_mtn_Abomey,300000,264198,Thibault Martin,379249,415051,2022-11-05
TRANSFER,31560,Simone du Allard,203103,171543,Thibault Martin,415051,446611,2022-11-10
CASH_OUT,204829,Thibault Martin,446611,241782,Agence_mtn_Abomey,300000,95171,2022-11-10
TRANSFER,474178,Alexandre Blanchard,1779162,1304984,Thibault Martin,241782,715960,2022-11-10
CASH_OUT,609666,Thibault Martin,715960,106294,Agence_mtn_Abomey,300000,-309666,2022-11-11
CASH_IN,132454,Agence_mtn_Abomey,300000,167546,Thibault Martin,106294,238748,2022-11-11
CASH_IN,105735,Agence_mtn_Cotonou,300000,194265,Thibault Martin,238748,344483,2022-11-12
CASH_IN,21684,Agence_mtn_Abomey,300000,278316,Thibault Martin,344483,366167,2022-11-13
CASH_OUT,102883,Thibault Martin,366167,263284,Agence_mtn_Ouidah,300000,197117,2022-11-14
CASH_IN,212269,Agence_mtn_Cotonou,300000,87731,Thibault Martin,263284,475553,2022-11-15
CASH_OUT,433941,Thibault Martin,475553,41612,Agence_mtn_Ouidah,300000,-133941,2022-11-15
TRANSFER,42989,Jacques Marchand,199593,156604,Thibault Martin,41612,84601,2022-11-16
TRANSFER,88425,Gérard Cordier,289853,201428,Thibault Martin,84601,173026,2022-11-18
CASH_IN,217471,Agence_mtn_Ouidah,300000,82529,Thibault Martin,173026,390497,2022-11-20
CASH_OUT,341686,Thibault Martin,390497,48811,Agence_mtn_Ouidah,300000,-41686,2022-11-22
TRANSFER,179,Danielle-Henriette Tessier,721,542,Thibault Martin,48811,48990,2022-11-26
TRANSFER,14382,Thibault Martin,48990,34608,Marcel de la Buisson,1627300,1612918,2022-11-27
CASH_IN,214360,Agence_mtn_Abomey,300000,85640,Thibault Martin,34608,248968,2022-11-27
CASH_IN,149516,Agence_mtn_Abomey,300000,150484,Gabrielle Hamon,321152,470668,2022-11-02
TRANSFER,373635,Gabrielle Hamon,470668,97033,Aimé Bernier,196651,-176984,2022-11-02
CASH_OUT,21752,Gabrielle Hamon,97033,75281,Agence_mtn_Cotonou,300000,278248,2022-11-03
CASH_IN,1590,Agence_mtn_Ouidah,300000,298410,Gabrielle Hamon,75281,76871,2022-11-04
TRANSFER,821956,Élisabeth Blot-Bruneau,1730513,908557,Gabrielle Hamon,76871,898827,2022-11-04
TRANSFER,845836,Gabrielle Hamon,898827,52991,Guy-Augustin Pinto,1639300,793464,2022-11-06
TRANSFER,228987,François Vaillant,716825,487838,Gabrielle Hamon,52991,281978,2022-11-07
CASH_OUT,54454,Gabrielle Hamon,281978,227524,Agence_mtn_Cotonou,300000,245546,2022-11-08
CASH_OUT,101735,Gabrielle Hamon,227524,125789,Agence_mtn_Cotonou,300000,198265,2022-11-12
CASH_IN,108415,Agence_mtn_Abomey,300000,191585,Gabrielle Hamon,125789,234204,2022-11-13
CASH_OUT,75410,Gabrielle Hamon,234204,158794,Agence_mtn_Cotonou,300000,224590,2022-11-13
CASH_OUT,111390,Gabrielle Hamon,158794,47404,Agence_mtn_Abomey,300000,188610,2022-11-15
CASH_OUT,33352,Gabrielle Hamon,47404,14052,Agence_mtn_Abomey,300000,266648,2022-11-15
CASH_OUT,6687,Gabrielle Hamon,14052,7365,Agence_mtn_Cotonou,300000,293313,2022-11-15
CASH_OUT,6385,Gabrielle Hamon,7365,980,Agence_mtn_Cotonou,300000,293615,2022-11-18
CASH_OUT,693,Gabrielle Hamon,980,287,Agence_mtn_Ouidah,300000,299307,2022-11-18
TRANSFER,48287,Élisabeth Blot-Bruneau,908557,860270,Gabrielle Hamon,287,48574,2022-11-19
CASH_IN,233155,Agence_mtn_Abomey,300000,66845,Gabrielle Hamon,48574,281729,2022-11-20
CASH_OUT,162488,Gabrielle Hamon,281729,119241,Agence_mtn_Abomey,300000,137512,2022-11-20
TRANSFER,88742,Gabrielle Hamon,119241,30499,Françoise Denis de Allard,587588,498846,2022-11-22
CASH_IN,296508,Agence_mtn_Ouidah,300000,3492,Gabrielle Hamon,30499,327007,2022-11-23
CASH_IN,98559,Agence_mtn_Cotonou,300000,201441,Gabrielle Hamon,327007,425566,2022-11-23
CASH_OUT,267331,Gabrielle Hamon,425566,158235,Agence_mtn_Cotonou,300000,32669,2022-11-24
CASH_IN,11321,Agence_mtn_Abomey,300000,288679,Gabrielle Hamon,158235,169556,2022-11-26
CASH_OUT,107843,Gabrielle Hamon,169556,61713,Agence_mtn_Ouidah,300000,192157,2022-11-26
CASH_IN,193495,Agence_mtn_Abomey,300000,106505,Gabrielle Hamon,61713,255208,2022-11-27
TRANSFER,49434,Olivier Benard,661500,612066,Raymond de Le Roux,525600,476166,2022-11-01
CASH_OUT,432511,Olivier Benard,612066,179555,Agence_mtn_Cotonou,300000,-132511,2022-11-01
CASH_OUT,5857,Olivier Benard,179555,173698,Agence_mtn_Abomey,300000,294143,2022-11-03
TRANSFER,126959,Olivier Benard,173698,46739,Honoré Grégoire-Breton,218662,91703,2022-11-07
TRANSFER,17467,Olivier Benard,46739,29272,Océane Faure,488561,471094,2022-11-07
CASH_IN,236232,Agence_mtn_Abomey,300000,63768,Olivier Benard,29272,265504,2022-11-08
CASH_IN,280339,Agence_mtn_Abomey,300000,19661,Olivier Benard,265504,545843,2022-11-09
CASH_OUT,441816,Olivier Benard,545843,104027,Agence_mtn_Abomey,300000,-141816,2022-11-10
TRANSFER,373005,Julie Germain Le Vaillant,404902,31897,Olivier Benard,104027,477032,2022-11-13
TRANSFER,348,Danielle-Henriette Tessier,542,194,Olivier Benard,477032,477380,2022-11-15
CASH_OUT,305465,Olivier Benard,477380,171915,Agence_mtn_Abomey,300000,-5465,2022-11-15
CASH_IN,113223,Agence_mtn_Cotonou,300000,186777,Olivier Benard,171915,285138,2022-11-15
CASH_IN,121424,Agence_mtn_Abomey,300000,178576,Olivier Benard,285138,406562,2022-11-16
TRANSFER,139025,Raymond de Le Roux,476166,337141,Olivier Benard,406562,545587,2022-11-19
CASH_OUT,496806,Olivier Benard,545587,48781,Agence_mtn_Ouidah,300000,-196806,2022-11-20
CASH_IN,245885,Agence_mtn_Abomey,300000,54115,Olivier Benard,48781,294666,2022-11-21
CASH_IN,62605,Agence_mtn_Abomey,300000,237395,Olivier Benard,294666,357271,2022-11-22
CASH_IN,201951,Agence_mtn_Ouidah,300000,98049,Olivier Benard,357271,559222,2022-11-23
CASH_OUT,290209,Olivier Benard,559222,269013,Agence_mtn_Abomey,300000,9791,2022-11-23
CASH_IN,200449,Agence_mtn_Ouidah,300000,99551,Olivier Benard,269013,469462,2022-11-23
CASH_IN,129557,Agence_mtn_Ouidah,300000,170443,Olivier Benard,469462,599019,2022-11-24
CASH_IN,109326,Agence_mtn_Ouidah,300000,190674,Olivier Benard,599019,708345,2022-11-24
CASH_IN,61719,Agence_mtn_Cotonou,300000,238281,Olivier Benard,708345,770064,2022-11-25
TRANSFER,295212,Olivier Benard,770064,474852,Marine Labbé,511776,216564,2022-11-25
CASH_OUT,206974,Olivier Benard,474852,267878,Agence_mtn_Ouidah,300000,93026,2022-11-27
CASH_IN,146319,Agence_mtn_Cotonou,300000,153681,Élisabeth Delattre,207955,354274,2022-11-01
CASH_OUT,353012,Élisabeth Delattre,354274,1262,Agence_mtn_Ouidah,300000,-53012,2022-11-03
TRANSFER,1140488,Marcel de la Buisson,1612918,472430,Élisabeth Delattre,1262,1141750,2022-11-03
CASH_IN,207759,Agence_mtn_Abomey,300000,92241,Élisabeth Delattre,1141750,1349509,2022-11-06
TRANSFER,45017,Jérôme Laporte Le Gauthier,1079700,1034683,Élisabeth Delattre,1349509,1394526,2022-11-08
CASH_OUT,278354,Élisabeth Delattre,1394526,1116172,Agence_mtn_Cotonou,300000,21646,2022-11-09
CASH_OUT,739252,Élisabeth Delattre,1116172,376920,Agence_mtn_Cotonou,300000,-439252,2022-11-09
CASH_OUT,242858,Élisabeth Delattre,376920,134062,Agence_mtn_Abomey,300000,57142,2022-11-09
CASH_IN,45362,Agence_mtn_Cotonou,300000,254638,Élisabeth Delattre,134062,179424,2022-11-10
TRANSFER,36329,Élisabeth Delattre,179424,143095,Georges Muller,35433,-896,2022-11-11
TRANSFER,86467,Élisabeth Delattre,143095,56628,Michèle Faivre,647280,560813,2022-11-11
CASH_IN,169196,Agence_mtn_Ouidah,300000,130804,Élisabeth Delattre,56628,225824,2022-11-11
TRANSFER,163853,Élisabeth Delattre,225824,61971,Élisabeth Delattre,225824,61971,2022-11-12
CASH_IN,6782,Agence_mtn_Ouidah,300000,293218,Élisabeth Delattre,61971,68753,2022-11-12
CASH_IN,25864,Agence_mtn_Abomey,300000,274136,Élisabeth Delattre,68753,94617,2022-11-13
TRANSFER,157236,Clémence Dufour,166937,9701,Élisabeth Delattre,94617,251853,2022-11-16
TRANSFER,19591,Élisabeth Delattre,251853,232262,Marine Labbé,216564,196973,2022-11-16
TRANSFER,24757,Guy-Augustin Pinto,793464,768707,Élisabeth Delattre,232262,257019,2022-11-17
TRANSFER,19832,Élisabeth Delattre,257019,237187,Christophe Teixeira,584648,564816,2022-11-19
TRANSFER,63353,Marine Labbé,196973,133620,Élisabeth Delattre,237187,300540,2022-11-19
CASH_IN,76404,Agence_mtn_Abomey,300000,223596,Élisabeth Delattre,300540,376944,2022-11-20
CASH_IN,246995,Agence_mtn_Abomey,300000,53005,Élisabeth Delattre,376944,623939,2022-11-21
TRANSFER,50339,Stéphanie Guichard,746842,696503,Élisabeth Delattre,623939,674278,2022-11-21
CASH_OUT,57228,Élisabeth Delattre,674278,617050,Agence_mtn_Cotonou,300000,242772,2022-11-23
CASH_OUT,555100,Élisabeth Delattre,617050,61950,Agence_mtn_Abomey,300000,-255100,2022-11-24
CASH_IN,193363,Agence_mtn_Ouidah,300000,106637,Élisabeth Delattre,61950,255313,2022-11-25
CASH_OUT,29142,Élisabeth Delattre,255313,226171,Agence_mtn_Ouidah,300000,270858,2022-11-27
TRANSFER,408664,Océane Faure,471094,62430,Julie Germain Le Vaillant,31897,-376767,2022-11-01
CASH_IN,43380,Agence_mtn_Abomey,300000,256620,Océane Faure,62430,105810,2022-11-01
CASH_IN,26923,Agence_mtn_Cotonou,300000,273077,Océane Faure,105810,132733,2022-11-01
TRANSFER,115589,Océane Faure,132733,17144,Louis du Boyer,430061,314472,2022-11-02
CASH_IN,282620,Agence_mtn_Abomey,300000,17380,Océane Faure,17144,299764,2022-11-03
TRANSFER,73434,Océane Faure,299764,226330,Maryse Delorme,617540,544106,2022-11-03
TRANSFER,24516,Emmanuel Legrand,381207,356691,Océane Faure,226330,250846,2022-11-08
CASH_OUT,166920,Océane Faure,250846,83926,Agence_mtn_Abomey,300000,133080,2022-11-11
CASH_IN,180927,Agence_mtn_Ouidah,300000,119073,Océane Faure,83926,264853,2022-11-11
CASH_IN,279393,Agence_mtn_Cotonou,300000,20607,Océane Faure,264853,544246,2022-11-11
CASH_IN,144952,Agence_mtn_Abomey,300000,155048,Océane Faure,544246,689198,2022-11-12
TRANSFER,554899,Océane Faure,689198,134299,Françoise Denis de Allard,498846,-56053,2022-11-13
CASH_IN,62798,Agence_mtn_Abomey,300000,237202,Océane Faure,134299,197097,2022-11-15
TRANSFER,237628,Marcel de la Buisson,472430,234802,Océane Faure,197097,434725,2022-11-16
CASH_OUT,69547,Océane Faure,434725,365178,Agence_mtn_Ouidah,300000,230453,2022-11-16
TRANSFER,369742,Valérie de Pottier,1488573,1118831,Océane Faure,365178,734920,2022-11-16
CASH_OUT,65539,Océane Faure,734920,669381,Agence_mtn_Ouidah,300000,234461,2022-11-16
CASH_OUT,664836,Océane Faure,669381,4545,Agence_mtn_Cotonou,300000,-364836,2022-11-17
CASH_IN,218880,Agence_mtn_Abomey,300000,81120,Océane Faure,4545,223425,2022-11-18
TRANSFER,132910,Océane Faure,223425,90515,Océane Faure,223425,90515,2022-11-20
TRANSFER,10197,Thibault-Julien Chevallier,706195,695998,Océane Faure,90515,100712,2022-11-20
CASH_IN,20254,Agence_mtn_Cotonou,300000,279746,Océane Faure,100712,120966,2022-11-21
CASH_OUT,78555,Océane Faure,120966,42411,Agence_mtn_Abomey,300000,221445,2022-11-21
CASH_IN,18923,Agence_mtn_Ouidah,300000,281077,Océane Faure,42411,61334,2022-11-22
CASH_OUT,54582,Océane Faure,61334,6752,Agence_mtn_Abomey,300000,245418,2022-11-25
CASH_IN,201291,Agence_mtn_Ouidah,300000,98709,Océane Faure,6752,208043,2022-11-25
CASH_OUT,190768,Océane Faure,208043,17275,Agence_mtn_Ouidah,300000,109232,2022-11-27
CASH_IN,106956,Agence_mtn_Abomey,300000,193044,Martin Moreau,48023,154979,2022-11-04
CASH_OUT,121011,Martin Moreau,154979,33968,Agence_mtn_Ouidah,300000,178989,2022-11-05
CASH_OUT,17389,Martin Moreau,33968,16579,Agence_mtn_Cotonou,300000,282611,2022-11-07
TRANSFER,673357,Marc Costa-Daniel,753689,80332,Martin Moreau,16579,689936,2022-11-07
TRANSFER,403210,Martin Moreau,689936,286726,Alexandre Blanchard,1304984,901774,2022-11-07
CASH_OUT,131037,Martin Moreau,286726,155689,Agence_mtn_Abomey,300000,168963,2022-11-08
TRANSFER,117863,Martin Moreau,155689,37826,Thibault-Julien Chevallier,695998,578135,2022-11-09
CASH_IN,44778,Agence_mtn_Abomey,300000,255222,Martin Moreau,37826,82604,2022-11-09
TRANSFER,35669,Martin Moreau,82604,46935,Josette du Hamon,12526,-23143,2022-11-10
TRANSFER,254978,Gilbert Moulin,290050,35072,Martin Moreau,46935,301913,2022-11-12
CASH_OUT,132453,Martin Moreau,301913,169460,Agence_mtn_Cotonou,300000,167547,2022-11-13
CASH_OUT,11741,Martin Moreau,169460,157719,Agence_mtn_Ouidah,300000,288259,2022-11-13
TRANSFER,95436,Martin Moreau,157719,62283,Gilbert Moulin,35072,-60364,2022-11-13
TRANSFER,58804,Martin Moreau,62283,3479,Jérôme Laporte Le Gauthier,1034683,975879,2022-11-14
CASH_OUT,1046,Martin Moreau,3479,2433,Agence_mtn_Ouidah,300000,298954,2022-11-14
CASH_OUT,2101,Martin Moreau,2433,332,Agence_mtn_Ouidah,300000,297899,2022-11-14
CASH_IN,129331,Agence_mtn_Abomey,300000,170669,Martin Moreau,332,129663,2022-11-16
TRANSFER,106849,Jacques Le Marion,441966,335117,Martin Moreau,129663,236512,2022-11-17
CASH_IN,223911,Agence_mtn_Abomey,300000,76089,Martin Moreau,236512,460423,2022-11-17
TRANSFER,174464,Martin Moreau,460423,285959,Emmanuel Legrand,356691,182227,2022-11-17
CASH_IN,239763,Agence_mtn_Cotonou,300000,60237,Martin Moreau,285959,525722,2022-11-18
TRANSFER,510172,Michèle Faivre,560813,50641,Martin Moreau,525722,1035894,2022-11-20
TRANSFER,306465,Martin Moreau,1035894,729429,Jacques Marchand,156604,-149861,2022-11-24
TRANSFER,165173,Simone du Allard,171543,6370,Martin Moreau,729429,894602,2022-11-24
TRANSFER,120271,Jacques Le Marion,335117,214846,Martin Moreau,894602,1014873,2022-11-26
CASH_OUT,130555,Marine Labbé,133620,3065,Agence_mtn_Ouidah,300000,169445,2022-11-01
CASH_OUT,2680,Marine Labbé,3065,385,Agence_mtn_Ouidah,300000,297320,2022-11-03
CASH_IN,88933,Agence_mtn_Cotonou,300000,211067,Marine Labbé,385,89318,2022-11-04
CASH_IN,230620,Agence_mtn_Abomey,300000,69380,Marine Labbé,89318,319938,2022-11-06
CASH_OUT,317017,Marine Labbé,319938,2921,Agence_mtn_Abomey,300000,-17017,2022-11-07
CASH_OUT,1753,Marine Labbé,2921,1168,Agence_mtn_Cotonou,300000,298247,2022-11-07
TRANSFER,349900,Christophe Teixeira,564816,214916,Marine Labbé,1168,351068,2022-11-08
TRANSFER,24143,Marine Labbé,351068,326925,Gérard Cordier,201428,177285,2022-11-08
CASH_IN,296922,Agence_mtn_Ouidah,300000,3078,Marine Labbé,326925,623847,2022-11-09
CASH_IN,254811,Agence_mtn_Ouidah,300000,45189,Marine Labbé,623847,878658,2022-11-09
CASH_IN,21314,Agence_mtn_Ouidah,300000,278686,Marine Labbé,878658,899972,2022-11-11
CASH_OUT,148968,Marine Labbé,899972,751004,Agence_mtn_Ouidah,300000,151032,2022-11-14
CASH_OUT,49304,Marine Labbé,751004,701700,Agence_mtn_Ouidah,300000,250696,2022-11-16
CASH_IN,185727,Agence_mtn_Abomey,300000,114273,Marine Labbé,701700,887427,2022-11-17
CASH_IN,19821,Agence_mtn_Ouidah,300000,280179,Marine Labbé,887427,907248,2022-11-18
CASH_IN,129422,Agence_mtn_Cotonou,300000,170578,Marine Labbé,907248,1036670,2022-11-18
CASH_OUT,302378,Marine Labbé,1036670,734292,Agence_mtn_Cotonou,300000,-2378,2022-11-18
CASH_IN,186958,Agence_mtn_Abomey,300000,113042,Marine Labbé,734292,921250,2022-11-19
CASH_OUT,398820,Marine Labbé,921250,522430,Agence_mtn_Abomey,300000,-98820,2022-11-20
CASH_OUT,402462,Marine Labbé,522430,119968,Agence_mtn_Cotonou,300000,-102462,2022-11-21
CASH_IN,175082,Agence_mtn_Abomey,300000,124918,Marine Labbé,119968,295050,2022-11-23
TRANSFER,347971,Céline-Inès Meunier,709400,361429,Marine Labbé,295050,643021,2022-11-23
TRANSFER,702597,Nathalie-Claire De Oliveira,1528995,826398,Marine Labbé,643021,1345618,2022-11-24
TRANSFER,1032815,Marine Labbé,1345618,312803,Thibault-Julien Chevallier,578135,-454680,2022-11-26
CASH_IN,28304,Agence_mtn_Ouidah,300000,271696,Marine Labbé,312803,341107,2022-11-26
CASH_OUT,126595,Marcel de la Buisson,234802,108207,Agence_mtn_Abomey,300000,173405,2022-11-01
TRANSFER,35873,Marcel de la Buisson,108207,72334,Gérard Blot de Blanc,290453,254580,2022-11-01
CASH_OUT,3429,Marcel de la Buisson,72334,68905,Agence_mtn_Ouidah,300000,296571,2022-11-02
TRANSFER,42941,Honoré Grégoire-Breton,91703,48762,Marcel de la Buisson,68905,111846,2022-11-04
CASH_OUT,39601,Marcel de la Buisson,111846,72245,Agence_mtn_Ouidah,300000,260399,2022-11-05
CASH_IN,245365,Agence_mtn_Abomey,300000,54635,Marcel de la Buisson,72245,317610,2022-11-06
TRANSFER,248177,Marcel de la Buisson,317610,69433,Clémence-Alice Ruiz,990821,742644,2022-11-07
CASH_IN,170946,Agence_mtn_Abomey,300000,129054,Marcel de la Buisson,69433,240379,2022-11-11
TRANSFER,109118,Marcel de la Buisson,240379,131261,François Vaillant,487838,378720,2022-11-12
TRANSFER,208051,Guy-Augustin Pinto,768707,560656,Marcel de la Buisson,131261,339312,2022-11-12
CASH_IN,60156,Agence_mtn_Ouidah,300000,239844,Marcel de la Buisson,339312,399468,2022-11-12
CASH_IN,244247,Agence_mtn_Abomey,300000,55753,Marcel de la Buisson,399468,643715,2022-11-12
CASH_IN,158957,Agence_mtn_Abomey,300000,141043,Marcel de la Buisson,643715,802672,2022-11-13
CASH_OUT,511773,Marcel de la Buisson,802672,290899,Agence_mtn_Abomey,300000,-211773,2022-11-14
TRANSFER,202105,François Vaillant,378720,176615,Marcel de la Buisson,290899,493004,2022-11-14
CASH_OUT,483940,Marcel de la Buisson,493004,9064,Agence_mtn_Ouidah,300000,-183940,2022-11-15
CASH_IN,22215,Agence_mtn_Abomey,300000,277785,Marcel de la Buisson,9064,31279,2022-11-20
CASH_IN,276454,Agence_mtn_Cotonou,300000,23546,Marcel de la Buisson,31279,307733,2022-11-21
TRANSFER,241544,Marcel de la Buisson,307733,66189,Jérôme Laporte Le Gauthier,975879,734335,2022-11-21
CASH_IN,5810,Agence_mtn_Abomey,300000,294190,Marcel de la Buisson,66189,71999,2022-11-21
CASH_IN,120917,Agence_mtn_Cotonou,300000,179083,Marcel de la Buisson,71999,192916,2022-11-23
CASH_OUT,56464,Marcel de la Buisson,192916,136452,Agence_mtn_Abomey,300000,243536,2022-11-26
CASH_IN,242608,Agence_mtn_Ouidah,300000,57392,Marcel de la Buisson,136452,379060,2022-11-26
TRANSFER,314636,Marcel de la Buisson,379060,64424,Michèle Faivre,50641,-263995,2022-11-27
CASH_IN,196990,Agence_mtn_Abomey,300000,103010,Jean Guilbert-Lenoir,-489294,-292304,2022-11-03
CASH_IN,818,Agence_mtn_Cotonou,300000,299182,Jean Guilbert-Lenoir,-292304,-291486,2022-11-03
CASH_IN,31777,Agence_mtn_Abomey,300000,268223,Jean Guilbert-Lenoir,-291486,-259709,2022-11-05
CASH_IN,24205,Agence_mtn_Abomey,300000,275795,Jean Guilbert-Lenoir,-259709,-235504,2022-11-06
CASH_IN,66995,Agence_mtn_Cotonou,300000,233005,Jean Guilbert-Lenoir,-235504,-168509,2022-11-06
CASH_IN,214468,Agence_mtn_Cotonou,300000,85532,Jean Guilbert-Lenoir,-168509,45959,2022-11-08
CASH_OUT,6206,Jean Guilbert-Lenoir,45959,39753,Agence_mtn_Cotonou,300000,293794,2022-11-10
TRANSFER,29067,Jean Guilbert-Lenoir,39753,10686,Jacques Le Marion,214846,185779,2022-11-10
CASH_IN,186015,Agence_mtn_Ouidah,300000,113985,Jean Guilbert-Lenoir,10686,196701,2022-11-13
TRANSFER,242906,Julien Devaux,329751,86845,Jean Guilbert-Lenoir,196701,439607,2022-11-13
TRANSFER,118151,Jean Guilbert-Lenoir,439607,321456,Élisabeth Blot-Bruneau,860270,742119,2022-11-15
CASH_OUT,269241,Jean Guilbert-Lenoir,321456,52215,Agence_mtn_Ouidah,300000,30759,2022-11-15
TRANSFER,28079,Jean Guilbert-Lenoir,52215,24136,Gérard Cordier,177285,149206,2022-11-19
TRANSFER,53291,Christophe Teixeira,214916,161625,Jean Guilbert-Lenoir,24136,77427,2022-11-20
CASH_OUT,67389,Jean Guilbert-Lenoir,77427,10038,Agence_mtn_Abomey,300000,232611,2022-11-25
CASH_IN,284061,Agence_mtn_Cotonou,300000,15939,Jean Guilbert-Lenoir,10038,294099,2022-11-25
CASH_OUT,263012,Jean Guilbert-Lenoir,294099,31087,Agence_mtn_Ouidah,300000,36988,2022-11-25
TRANSFER,700324,Jérôme Laporte Le Gauthier,734335,34011,Jean Guilbert-Lenoir,31087,731411,2022-11-26
TRANSFER,397472,Jean Guilbert-Lenoir,731411,333939,Sylvie Dupré,782155,384683,2022-11-26
TRANSFER,5762,François Vaillant,176615,170853,Véronique Hardy,951934,946172,2022-11-03
CASH_IN,20190,Agence_mtn_Cotonou,300000,279810,François Vaillant,170853,191043,2022-11-05
CASH_OUT,77393,François Vaillant,191043,113650,Agence_mtn_Abomey,300000,222607,2022-11-10
CASH_OUT,33715,François Vaillant,113650,79935,Agence_mtn_Cotonou,300000,266285,2022-11-11
TRANSFER,53819,François Vaillant,79935,26116,Alexandre Blanchard,901774,847955,2022-11-14
CASH_IN,254819,Agence_mtn_Ouidah,300000,45181,François Vaillant,26116,280935,2022-11-17
CASH_IN,221502,Agence_mtn_Cotonou,300000,78498,François Vaillant,280935,502437,2022-11-21
TRANSFER,484644,François Vaillant,502437,17793,Jacques Le Marion,185779,-298865,2022-11-21
CASH_OUT,291,François Vaillant,17793,17502,Agence_mtn_Cotonou,300000,299709,2022-11-24
TRANSFER,230559,Céline-Inès Meunier,361429,130870,Clémence Dufour,9701,-220858,2022-11-04
CASH_OUT,24262,Céline-Inès Meunier,130870,106608,Agence_mtn_Abomey,300000,275738,2022-11-04
TRANSFER,88652,Céline-Inès Meunier,106608,17956,Clémence-Alice Ruiz,742644,653992,2022-11-08
CASH_OUT,12499,Céline-Inès Meunier,17956,5457,Agence_mtn_Abomey,300000,287501,2022-11-15
TRANSFER,5073,Céline-Inès Meunier,5457,384,Sylvie Dupré,384683,379610,2022-11-17
CASH_OUT,362,Céline-Inès Meunier,384,22,Agence_mtn_Abomey,300000,299638,2022-11-21
CASH_IN,242490,Agence_mtn_Cotonou,300000,57510,Céline-Inès Meunier,22,242512,2022-11-22
TRANSFER,43737,Céline-Inès Meunier,242512,198775,Valérie de Pottier,1118831,1075094,2022-11-22
CASH_OUT,172219,Céline-Inès Meunier,198775,26556,Agence_mtn_Cotonou,300000,127781,2022-11-26
CASH_IN,238144,Agence_mtn_Abomey,300000,61856,Emmanuelle Le Allain,111363,349507,2022-11-04
TRANSFER,41590,Gérard Blot de Blanc,254580,212990,Emmanuelle Le Allain,349507,391097,2022-11-06
CASH_OUT,20848,Emmanuelle Le Allain,391097,370249,Agence_mtn_Cotonou,300000,279152,2022-11-06
TRANSFER,149460,Christophe Teixeira,161625,12165,Emmanuelle Le Allain,370249,519709,2022-11-06
CASH_OUT,241170,Emmanuelle Le Allain,519709,278539,Agence_mtn_Cotonou,300000,58830,2022-11-06
CASH_OUT,253640,Emmanuelle Le Allain,278539,24899,Agence_mtn_Abomey,300000,46360,2022-11-07
CASH_OUT,17815,Emmanuelle Le Allain,24899,7084,Agence_mtn_Ouidah,300000,282185,2022-11-08
TRANSFER,24178,Julien Devaux,86845,62667,Emmanuelle Le Allain,7084,31262,2022-11-09
CASH_OUT,10250,Emmanuelle Le Allain,31262,21012,Agence_mtn_Abomey,300000,289750,2022-11-10
CASH_IN,200064,Agence_mtn_Ouidah,300000,99936,Emmanuelle Le Allain,21012,221076,2022-11-11
CASH_OUT,124465,Emmanuelle Le Allain,221076,96611,Agence_mtn_Cotonou,300000,175535,2022-11-18
CASH_OUT,45221,Emmanuelle Le Allain,96611,51390,Agence_mtn_Abomey,300000,254779,2022-11-21
TRANSFER,40806,Emmanuelle Le Allain,51390,10584,Nathalie-Claire De Oliveira,826398,785592,2022-11-22
CASH_OUT,8240,Emmanuelle Le Allain,10584,2344,Agence_mtn_Cotonou,300000,291760,2022-11-26
CASH_OUT,1179,Emmanuelle Le Allain,2344,1165,Agence_mtn_Abomey,300000,298821,2022-11-27
CASH_IN,122229,Agence_mtn_Cotonou,300000,177771,Louise-Aurore Payet,-152525,-30296,2022-11-02
CASH_IN,40209,Agence_mtn_Ouidah,300000,259791,Louise-Aurore Payet,-30296,9913,2022-11-06
CASH_IN,64194,Agence_mtn_Ouidah,300000,235806,Louise-Aurore Payet,9913,74107,2022-11-07
TRANSFER,4400,Simone du Allard,6370,1970,Louise-Aurore Payet,74107,78507,2022-11-11
TRANSFER,47582,Louise-Aurore Payet,78507,30925,Roger-Roger Delmas,838900,791318,2022-11-13
CASH_IN,297343,Agence_mtn_Cotonou,300000,2657,Louise-Aurore Payet,30925,328268,2022-11-16
TRANSFER,299278,Louise-Aurore Payet,328268,28990,Christophe Teixeira,12165,-287113,2022-11-16
TRANSFER,2406,Louise-Aurore Payet,28990,26584,Maryse Delorme,544106,541700,2022-11-16
CASH_IN,86077,Agence_mtn_Cotonou,300000,213923,Louise-Aurore Payet,26584,112661,2022-11-16
CASH_IN,215120,Agence_mtn_Cotonou,300000,84880,Louise-Aurore Payet,112661,327781,2022-11-17
TRANSFER,8528,Louise-Aurore Payet,327781,319253,Élisabeth Blot-Bruneau,742119,733591,2022-11-18
CASH_OUT,127123,Louise-Aurore Payet,319253,192130,Agence_mtn_Ouidah,300000,172877,2022-11-19
TRANSFER,172374,Christophe Besnard-Diaz,173307,933,Louise-Aurore Payet,192130,364504,2022-11-21
CASH_IN,282448,Agence_mtn_Abomey,300000,17552,Louise-Aurore Payet,364504,646952,2022-11-22
CASH_IN,92813,Agence_mtn_Cotonou,300000,207187,Louise-Aurore Payet,646952,739765,2022-11-24
CASH_IN,270481,Agence_mtn_Abomey,300000,29519,Louise-Aurore Payet,739765,1010246,2022-11-25
CASH_OUT,188292,Louise-Aurore Payet,1010246,821954,Agence_mtn_Abomey,300000,111708,2022-11-26
TRANSFER,611168,Louise-Aurore Payet,821954,210786,Jérôme Laporte Le Gauthier,34011,-577157,2022-11-27
CASH_IN,122987,Agence_mtn_Cotonou,300000,177013,Emmanuel Vallée,-156488,-33501,2022-11-02
CASH_IN,211359,Agence_mtn_Cotonou,300000,88641,Emmanuel Vallée,-33501,177858,2022-11-10
TRANSFER,43231,Marc Costa-Daniel,80332,37101,Emmanuel Vallée,177858,221089,2022-11-15
CASH_OUT,120387,Emmanuel Vallée,221089,100702,Agence_mtn_Ouidah,300000,179613,2022-11-19
CASH_OUT,78785,Emmanuel Vallée,100702,21917,Agence_mtn_Ouidah,300000,221215,2022-11-19
TRANSFER,19263,Emmanuel Vallée,21917,2654,Gérard Cordier,149206,129943,2022-11-22
CASH_IN,132105,Agence_mtn_Cotonou,300000,167895,Thérèse-Juliette Camus,-575542,-443437,2022-11-02
CASH_IN,240379,Agence_mtn_Abomey,300000,59621,Thérèse-Juliette Camus,-443437,-203058,2022-11-04
CASH_IN,206200,Agence_mtn_Abomey,300000,93800,Thérèse-Juliette Camus,-203058,3142,2022-11-07
CASH_OUT,207,Thérèse-Juliette Camus,3142,2935,Agence_mtn_Abomey,300000,299793,2022-11-13
CASH_IN,70853,Agence_mtn_Cotonou,300000,229147,Thérèse-Juliette Camus,2935,73788,2022-11-14
CASH_OUT,71253,Thérèse-Juliette Camus,73788,2535,Agence_mtn_Abomey,300000,228747,2022-11-16
CASH_IN,161362,Agence_mtn_Cotonou,300000,138638,Thérèse-Juliette Camus,2535,163897,2022-11-20
CASH_OUT,95705,Thérèse-Juliette Camus,163897,68192,Agence_mtn_Abomey,300000,204295,2022-11-23
CASH_IN,52621,Agence_mtn_Ouidah,300000,247379,Thérèse-Juliette Camus,68192,120813,2022-11-26
TRANSFER,63747,Thérèse-Juliette Camus,120813,57066,Gérard Blot de Blanc,212990,149243,2022-11-27
CASH_IN,38558,Agence_mtn_Abomey,300000,261442,Clémence-Alice Ruiz,653992,692550,2022-11-05
CASH_IN,20691,Agence_mtn_Abomey,300000,279309,Clémence-Alice Ruiz,692550,713241,2022-11-07
CASH_OUT,546188,Clémence-Alice Ruiz,713241,167053,Agence_mtn_Abomey,300000,-246188,2022-11-08
CASH_IN,164504,Agence_mtn_Abomey,300000,135496,Clémence-Alice Ruiz,167053,331557,2022-11-12
TRANSFER,20161,Clémence-Alice Ruiz,331557,311396,Roger-Roger Delmas,791318,771157,2022-11-13
CASH_OUT,266023,Clémence-Alice Ruiz,311396,45373,Agence_mtn_Ouidah,300000,33977,2022-11-14
TRANSFER,12889,Clémence-Alice Ruiz,45373,32484,Gérard Cordier,129943,117054,2022-11-16
CASH_OUT,25548,Clémence-Alice Ruiz,32484,6936,Agence_mtn_Abomey,300000,274452,2022-11-17
CASH_OUT,5429,Clémence-Alice Ruiz,6936,1507,Agence_mtn_Cotonou,300000,294571,2022-11-17
TRANSFER,1440,Clémence-Alice Ruiz,1507,67,Sylvie Dupré,379610,378170,2022-11-18
CASH_IN,121756,Agence_mtn_Abomey,300000,178244,Clémence-Alice Ruiz,67,121823,2022-11-19
CASH_OUT,37549,Clémence-Alice Ruiz,121823,84274,Agence_mtn_Ouidah,300000,262451,2022-11-20
CASH_OUT,40570,Clémence-Alice Ruiz,84274,43704,Agence_mtn_Ouidah,300000,259430,2022-11-20
TRANSFER,914302,Véronique Hardy,946172,31870,Clémence-Alice Ruiz,43704,958006,2022-11-21
CASH_OUT,9798,Clémence-Alice Ruiz,958006,948208,Agence_mtn_Ouidah,300000,290202,2022-11-25
CASH_OUT,79839,Clémence-Alice Ruiz,948208,868369,Agence_mtn_Abomey,300000,220161,2022-11-25
CASH_IN,166987,Agence_mtn_Cotonou,300000,133013,Simone du Allard,1970,168957,2022-11-04
CASH_OUT,37523,Simone du Allard,168957,131434,Agence_mtn_Abomey,300000,262477,2022-11-06
TRANSFER,23917,Véronique Hardy,31870,7953,Simone du Allard,131434,155351,2022-11-07
CASH_IN,159832,Agence_mtn_Abomey,300000,140168,Simone du Allard,155351,315183,2022-11-13
CASH_OUT,260072,Simone du Allard,315183,55111,Agence_mtn_Ouidah,300000,39928,2022-11-14
CASH_OUT,46640,Simone du Allard,55111,8471,Agence_mtn_Ouidah,300000,253360,2022-11-17
CASH_IN,228666,Agence_mtn_Cotonou,300000,71334,Simone du Allard,8471,237137,2022-11-18
TRANSFER,4265,Véronique Hardy,7953,3688,Simone du Allard,237137,241402,2022-11-20
CASH_IN,69480,Agence_mtn_Ouidah,300000,230520,Simone du Allard,241402,310882,2022-11-21
CASH_OUT,274720,Simone du Allard,310882,36162,Agence_mtn_Cotonou,300000,25280,2022-11-24
CASH_OUT,33894,Simone du Allard,36162,2268,Agence_mtn_Abomey,300000,266106,2022-11-24
CASH_OUT,575,Simone du Allard,2268,1693,Agence_mtn_Abomey,300000,299425,2022-11-26
CASH_IN,218757,Agence_mtn_Ouidah,300000,81243,Jacques Marchand,-149861,68896,2022-11-07
TRANSFER,639387,Roger-Roger Delmas,771157,131770,Jacques Marchand,68896,708283,2022-11-09
CASH_OUT,612330,Jacques Marchand,708283,95953,Agence_mtn_Cotonou,300000,-312330,2022-11-11
TRANSFER,57291,Jacques Marchand,95953,38662,Stéphanie Guichard,696503,639212,2022-11-13
TRANSFER,366430,Sylvie Dupré,378170,11740,Jacques Marchand,38662,405092,2022-11-22
CASH_OUT,204686,Jacques Marchand,405092,200406,Agence_mtn_Ouidah,300000,95314,2022-11-24
TRANSFER,445303,Maryse Delorme,541700,96397,Jacques Marchand,200406,645709,2022-11-26
CASH_IN,135738,Agence_mtn_Ouidah,300000,164262,Jacques Marchand,645709,781447,2022-11-26
CASH_IN,104265,Agence_mtn_Ouidah,300000,195735,Jacques Marchand,781447,885712,2022-11-27
CASH_OUT,585020,Jacques Marchand,885712,300692,Agence_mtn_Cotonou,300000,-285020,2022-11-27
CASH_IN,253650,Agence_mtn_Cotonou,300000,46350,Raymond-Yves Boulanger,-196496,57154,2022-11-01
TRANSFER,90568,Maryse Delorme,96397,5829,Raymond-Yves Boulanger,57154,147722,2022-11-01
TRANSFER,46985,Raymond-Yves Boulanger,147722,100737,Marthe Perrin,469818,422833,2022-11-02
CASH_OUT,74370,Raymond-Yves Boulanger,100737,26367,Agence_mtn_Ouidah,300000,225630,2022-11-04
CASH_IN,246260,Agence_mtn_Abomey,300000,53740,Raymond-Yves Boulanger,26367,272627,2022-11-07
CASH_IN,396,Agence_mtn_Ouidah,300000,299604,Raymond-Yves Boulanger,272627,273023,2022-11-12
CASH_IN,295725,Agence_mtn_Abomey,300000,4275,Raymond-Yves Boulanger,273023,568748,2022-11-14
CASH_IN,166906,Agence_mtn_Ouidah,300000,133094,Raymond-Yves Boulanger,568748,735654,2022-11-14
TRANSFER,163497,Emmanuel Legrand,182227,18730,Raymond-Yves Boulanger,735654,899151,2022-11-16
CASH_OUT,436952,Raymond-Yves Boulanger,899151,462199,Agence_mtn_Cotonou,300000,-136952,2022-11-18
CASH_IN,153805,Agence_mtn_Abomey,300000,146195,Raymond-Yves Boulanger,462199,616004,2022-11-19
CASH_OUT,435780,Raymond-Yves Boulanger,616004,180224,Agence_mtn_Ouidah,300000,-135780,2022-11-19
TRANSFER,18722,Honoré Grégoire-Breton,48762,30040,Raymond-Yves Boulanger,180224,198946,2022-11-22
CASH_OUT,113345,Raymond-Yves Boulanger,198946,85601,Agence_mtn_Cotonou,300000,186655,2022-11-24
CASH_IN,178804,Agence_mtn_Ouidah,300000,121196,Raymond-Yves Boulanger,85601,264405,2022-11-24
CASH_IN,186283,Agence_mtn_Abomey,300000,113717,Clémence Dufour,-220858,-34575,2022-11-02
CASH_IN,130472,Agence_mtn_Ouidah,300000,169528,Clémence Dufour,-34575,95897,2022-11-04
TRANSFER,45745,Gérard Blot de Blanc,149243,103498,Clémence Dufour,95897,141642,2022-11-04
CASH_OUT,68012,Clémence Dufour,141642,73630,Agence_mtn_Ouidah,300000,231988,2022-11-08
CASH_OUT,50556,Clémence Dufour,73630,23074,Agence_mtn_Cotonou,300000,249444,2022-11-13
CASH_OUT,9218,Clémence Dufour,23074,13856,Agence_mtn_Cotonou,300000,290782,2022-11-15
CASH_IN,86794,Agence_mtn_Abomey,300000,213206,Clémence Dufour,13856,100650,2022-11-15
CASH_OUT,44874,Clémence Dufour,100650,55776,Agence_mtn_Cotonou,300000,255126,2022-11-17
CASH_IN,16117,Agence_mtn_Cotonou,300000,283883,Clémence Dufour,55776,71893,2022-11-17
CASH_OUT,31774,Clémence Dufour,71893,40119,Agence_mtn_Cotonou,300000,268226,2022-11-18
CASH_OUT,5621,Clémence Dufour,40119,34498,Agence_mtn_Cotonou,300000,294379,2022-11-19
CASH_OUT,5849,Clémence Dufour,34498,28649,Agence_mtn_Ouidah,300000,294151,2022-11-19
CASH_IN,39149,Agence_mtn_Abomey,300000,260851,Clémence Dufour,28649,67798,2022-11-22
CASH_IN,108967,Agence_mtn_Abomey,300000,191033,Clémence Dufour,67798,176765,2022-11-22
CASH_OUT,46442,Clémence Dufour,176765,130323,Agence_mtn_Cotonou,300000,253558,2022-11-23
CASH_IN,190819,Agence_mtn_Cotonou,300000,109181,Clémence Dufour,130323,321142,2022-11-23
CASH_OUT,199991,Clémence Dufour,321142,121151,Agence_mtn_Ouidah,300000,100009,2022-11-24
CASH_IN,20253,Agence_mtn_Ouidah,300000,279747,Clémence Dufour,121151,141404,2022-11-24
TRANSFER,720767,Élisabeth Blot-Bruneau,733591,12824,Clémence Dufour,141404,862171,2022-11-26
TRANSFER,576,Élisabeth Blot-Bruneau,12824,12248,Clémence Dufour,862171,862747,2022-11-26
CASH_OUT,18889,Alexandre Blanchard,847955,829066,Agence_mtn_Cotonou,300000,281111,2022-11-05
CASH_OUT,413231,Alexandre Blanchard,829066,415835,Agence_mtn_Ouidah,300000,-113231,2022-11-08
CASH_IN,284942,Agence_mtn_Ouidah,300000,15058,Alexandre Blanchard,415835,700777,2022-11-12
TRANSFER,4613,Sylvie Dupré,11740,7127,Alexandre Blanchard,700777,705390,2022-11-14
TRANSFER,428918,Alexandre Blanchard,705390,276472,Louis du Boyer,314472,-114446,2022-11-19
CASH_IN,182981,Agence_mtn_Abomey,300000,117019,Alexandre Blanchard,276472,459453,2022-11-22
CASH_OUT,305935,Alexandre Blanchard,459453,153518,Agence_mtn_Abomey,300000,-5935,2022-11-23
CASH_IN,221732,Agence_mtn_Abomey,300000,78268,Alexandre Blanchard,153518,375250,2022-11-24
CASH_OUT,229460,Alexandre Blanchard,375250,145790,Agence_mtn_Cotonou,300000,70540,2022-11-25
TRANSFER,91429,Raymond de Le Roux,337141,245712,Alexandre Blanchard,145790,237219,2022-11-26
CASH_IN,48734,Agence_mtn_Cotonou,300000,251266,Alexandre Blanchard,237219,285953,2022-11-26
CASH_IN,66477,Agence_mtn_Cotonou,300000,233523,Gilbert Moulin,-60364,6113,2022-11-07
TRANSFER,1043,Gilbert Moulin,6113,5070,Emmanuel Legrand,18730,17687,2022-11-08
TRANSFER,126364,Guy-Augustin Pinto,560656,434292,Gilbert Moulin,5070,131434,2022-11-16
TRANSFER,115028,Gilbert Moulin,131434,16406,Sylvie Dupré,7127,-107901,2022-11-16
CASH_IN,239545,Agence_mtn_Cotonou,300000,60455,Gilbert Moulin,16406,255951,2022-11-20
CASH_IN,114702,Agence_mtn_Ouidah,300000,185298,Gilbert Moulin,255951,370653,2022-11-23
CASH_IN,225173,Agence_mtn_Abomey,300000,74827,Nicole Huet,-169829,55344,2022-11-03
CASH_IN,257691,Agence_mtn_Ouidah,300000,42309,Nicole Huet,55344,313035,2022-11-11
TRANSFER,134992,Nicole Huet,313035,178043,Gérard Blot de Blanc,103498,-31494,2022-11-12
TRANSFER,8121,Élisabeth Blot-Bruneau,12248,4127,Nicole Huet,178043,186164,2022-11-13
CASH_OUT,15033,Nicole Huet,186164,171131,Agence_mtn_Abomey,300000,284967,2022-11-20
CASH_OUT,144342,Nicole Huet,171131,26789,Agence_mtn_Ouidah,300000,155658,2022-11-26
CASH_IN,182645,Agence_mtn_Cotonou,300000,117355,Véronique Hardy,3688,186333,2022-11-02
CASH_IN,52729,Agence_mtn_Abomey,300000,247271,Véronique Hardy,186333,239062,2022-11-04
CASH_IN,70528,Agence_mtn_Ouidah,300000,229472,Véronique Hardy,239062,309590,2022-11-06
CASH_OUT,180203,Véronique Hardy,309590,129387,Agence_mtn_Ouidah,300000,119797,2022-11-06
CASH_IN,187558,Agence_mtn_Ouidah,300000,112442,Véronique Hardy,129387,316945,2022-11-07
TRANSFER,260512,Véronique Hardy,316945,56433,Emmanuel Legrand,17687,-242825,2022-11-08
TRANSFER,807,Christophe Besnard-Diaz,933,126,Véronique Hardy,56433,57240,2022-11-09
CASH_OUT,30864,Véronique Hardy,57240,26376,Agence_mtn_Ouidah,300000,269136,2022-11-11
CASH_OUT,568,Véronique Hardy,26376,25808,Agence_mtn_Cotonou,300000,299432,2022-11-11
CASH_OUT,20498,Véronique Hardy,25808,5310,Agence_mtn_Cotonou,300000,279502,2022-11-17
TRANSFER,2533,Véronique Hardy,5310,2777,Véronique Hardy,5310,2777,2022-11-18
CASH_IN,193724,Agence_mtn_Abomey,300000,106276,Véronique Hardy,2777,196501,2022-11-19
CASH_OUT,131024,Véronique Hardy,196501,65477,Agence_mtn_Ouidah,300000,168976,2022-11-20
CASH_IN,72563,Agence_mtn_Cotonou,300000,227437,Véronique Hardy,65477,138040,2022-11-21
CASH_OUT,57627,Véronique Hardy,138040,80413,Agence_mtn_Abomey,300000,242373,2022-11-21
CASH_OUT,18170,Véronique Hardy,80413,62243,Agence_mtn_Cotonou,300000,281830,2022-11-22
TRANSFER,17787,Véronique Hardy,62243,44456,Élisabeth Blot-Bruneau,4127,-13660,2022-11-25
CASH_OUT,35267,Véronique Hardy,44456,9189,Agence_mtn_Cotonou,300000,264733,2022-11-25
CASH_IN,129221,Agence_mtn_Ouidah,300000,170779,Véronique Hardy,9189,138410,2022-11-26
CASH_IN,134911,Agence_mtn_Abomey,300000,165089,Valérie de Pottier,1075094,1210005,2022-11-03
TRANSFER,262996,Valérie de Pottier,1210005,947009,Roger-Roger Delmas,131770,-131226,2022-11-05
TRANSFER,871943,Valérie de Pottier,947009,75066,Valérie de Pottier,947009,1818952,2022-11-05
TRANSFER,151512,Nathalie-Claire De Oliveira,785592,634080,Valérie de Pottier,75066,226578,2022-11-06
CASH_OUT,42960,Valérie de Pottier,226578,183618,Agence_mtn_Cotonou,300000,257040,2022-11-09
TRANSFER,62595,Valérie de Pottier,183618,121023,Marthe Perrin,422833,360238,2022-11-09
CASH_OUT,94944,Valérie de Pottier,121023,26079,Agence_mtn_Abomey,300000,205056,2022-11-09
TRANSFER,930,Valérie de Pottier,26079,25149,Stéphanie Guichard,639212,638282,2022-11-10
CASH_IN,109075,Agence_mtn_Abomey,300000,190925,Valérie de Pottier,25149,134224,2022-11-11
TRANSFER,96861,Valérie de Pottier,134224,37363,Raymond de Le Roux,245712,148851,2022-11-15
CASH_IN,81140,Agence_mtn_Abomey,300000,218860,Valérie de Pottier,37363,118503,2022-11-18
CASH_OUT,24302,Valérie de Pottier,118503,94201,Agence_mtn_Ouidah,300000,275698,2022-11-18
TRANSFER,242,Julien Devaux,62667,62425,Valérie de Pottier,94201,94443,2022-11-19
CASH_OUT,10661,Valérie de Pottier,94443,83782,Agence_mtn_Ouidah,300000,289339,2022-11-22
CASH_OUT,47024,Valérie de Pottier,83782,36758,Agence_mtn_Cotonou,300000,252976,2022-11-25
TRANSFER,154674,Marthe Perrin,360238,205564,Valérie de Pottier,36758,191432,2022-11-25
TRANSFER,68389,Valérie de Pottier,191432,123043,Marthe Perrin,205564,137175,2022-11-27
CASH_IN,264747,Agence_mtn_Abomey,300000,35253,Valérie de Pottier,123043,387790,2022-11-27
CASH_OUT,1637,Maryse Delorme,5829,4192,Agence_mtn_Cotonou,300000,298363,2022-11-01
CASH_OUT,1375,Maryse Delorme,4192,2817,Agence_mtn_Abomey,300000,298625,2022-11-02
CASH_IN,252599,Agence_mtn_Cotonou,300000,47401,Maryse Delorme,2817,255416,2022-11-03
CASH_OUT,222751,Maryse Delorme,255416,32665,Agence_mtn_Abomey,300000,77249,2022-11-05
CASH_IN,63162,Agence_mtn_Ouidah,300000,236838,Maryse Delorme,32665,95827,2022-11-09
CASH_OUT,50971,Maryse Delorme,95827,44856,Agence_mtn_Abomey,300000,249029,2022-11-09
CASH_IN,258174,Agence_mtn_Ouidah,300000,41826,Maryse Delorme,44856,303030,2022-11-12
CASH_IN,237636,Agence_mtn_Abomey,300000,62364,Maryse Delorme,303030,540666,2022-11-14
CASH_IN,163486,Agence_mtn_Cotonou,300000,136514,Maryse Delorme,540666,704152,2022-11-14
CASH_IN,231321,Agence_mtn_Abomey,300000,68679,Maryse Delorme,704152,935473,2022-11-15
TRANSFER,102,Christophe Besnard-Diaz,126,24,Maryse Delorme,935473,935575,2022-11-17
CASH_OUT,557275,Maryse Delorme,935575,378300,Agence_mtn_Ouidah,300000,-257275,2022-11-17
TRANSFER,176727,Maryse Delorme,378300,201573,Honoré Grégoire-Breton,30040,-146687,2022-11-19
CASH_OUT,100616,Maryse Delorme,201573,100957,Agence_mtn_Ouidah,300000,199384,2022-11-23
CASH_OUT,91645,Maryse Delorme,100957,9312,Agence_mtn_Abomey,300000,208355,2022-11-24
TRANSFER,57653,Raymond de Le Roux,148851,91198,Maryse Delorme,9312,66965,2022-11-25
CASH_IN,98154,Agence_mtn_Abomey,300000,201846,Maryse Delorme,66965,165119,2022-11-25
TRANSFER,44078,Raymond de Le Roux,91198,47120,Maryse Delorme,165119,209197,2022-11-26
CASH_OUT,72769,Maryse Delorme,209197,136428,Agence_mtn_Ouidah,300000,227231,2022-11-27
CASH_IN,196738,Agence_mtn_Ouidah,300000,103262,Roger-Roger Delmas,-131226,65512,2022-11-04
CASH_IN,4261,Agence_mtn_Ouidah,300000,295739,Roger-Roger Delmas,65512,69773,2022-11-07
CASH_IN,54073,Agence_mtn_Cotonou,300000,245927,Roger-Roger Delmas,69773,123846,2022-11-12
CASH_OUT,63796,Roger-Roger Delmas,123846,60050,Agence_mtn_Abomey,300000,236204,2022-11-13
CASH_IN,268224,Agence_mtn_Cotonou,300000,31776,Roger-Roger Delmas,60050,328274,2022-11-15
TRANSFER,305332,Roger-Roger Delmas,328274,22942,Marthe Perrin,137175,-168157,2022-11-19
CASH_OUT,3799,Roger-Roger Delmas,22942,19143,Agence_mtn_Cotonou,300000,296201,2022-11-21
CASH_IN,266586,Agence_mtn_Ouidah,300000,33414,Roger-Roger Delmas,19143,285729,2022-11-22
CASH_IN,156305,Agence_mtn_Cotonou,300000,143695,Roger-Roger Delmas,285729,442034,2022-11-24
CASH_OUT,147657,Roger-Roger Delmas,442034,294377,Agence_mtn_Abomey,300000,152343,2022-11-25
CASH_OUT,61875,Julien Devaux,62425,550,Agence_mtn_Abomey,300000,238125,2022-11-03
CASH_OUT,262,Julien Devaux,550,288,Agence_mtn_Cotonou,300000,299738,2022-11-03
CASH_OUT,109,Julien Devaux,288,179,Agence_mtn_Abomey,300000,299891,2022-11-03
CASH_IN,138931,Agence_mtn_Cotonou,300000,161069,Julien Devaux,179,139110,2022-11-04
CASH_IN,133656,Agence_mtn_Ouidah,300000,166344,Julien Devaux,139110,272766,2022-11-05
CASH_OUT,63612,Julien Devaux,272766,209154,Agence_mtn_Abomey,300000,236388,2022-11-05
CASH_IN,98042,Agence_mtn_Cotonou,300000,201958,Julien Devaux,209154,307196,2022-11-08
TRANSFER,144514,Julien Devaux,307196,162682,Guy-Augustin Pinto,434292,289778,2022-11-08
TRANSFER,43528,Raymond de Le Roux,47120,3592,Julien Devaux,162682,206210,2022-11-09
TRANSFER,23249,Julien Devaux,206210,182961,Stéphanie Guichard,638282,615033,2022-11-10
CASH_IN,34449,Agence_mtn_Ouidah,300000,265551,Julien Devaux,182961,217410,2022-11-11
CASH_OUT,139672,Julien Devaux,217410,77738,Agence_mtn_Cotonou,300000,160328,2022-11-16
CASH_OUT,41680,Julien Devaux,77738,36058,Agence_mtn_Abomey,300000,258320,2022-11-16
CASH_IN,204488,Agence_mtn_Abomey,300000,95512,Julien Devaux,36058,240546,2022-11-18
CASH_IN,159991,Agence_mtn_Cotonou,300000,140009,Julien Devaux,240546,400537,2022-11-20
TRANSFER,79132,Julien Devaux,400537,321405,Stéphanie Guichard,615033,535901,2022-11-21
CASH_IN,145039,Agence_mtn_Cotonou,300000,154961,Julien Devaux,321405,466444,2022-11-22
CASH_IN,37999,Agence_mtn_Ouidah,300000,262001,Julien Devaux,466444,504443,2022-11-25
CASH_OUT,147528,Julien Devaux,504443,356915,Agence_mtn_Cotonou,300000,152472,2022-11-27
CASH_IN,125416,Agence_mtn_Cotonou,300000,174584,Christophe Teixeira,-287113,-161697,2022-11-03
CASH_IN,223344,Agence_mtn_Ouidah,300000,76656,Christophe Teixeira,-161697,61647,2022-11-03
CASH_IN,18524,Agence_mtn_Cotonou,300000,281476,Christophe Teixeira,61647,80171,2022-11-03
CASH_IN,13529,Agence_mtn_Abomey,300000,286471,Christophe Teixeira,80171,93700,2022-11-05
CASH_IN,40620,Agence_mtn_Cotonou,300000,259380,Christophe Teixeira,93700,134320,2022-11-06
CASH_IN,8472,Agence_mtn_Ouidah,300000,291528,Christophe Teixeira,134320,142792,2022-11-06
CASH_IN,129997,Agence_mtn_Cotonou,300000,170003,Christophe Teixeira,142792,272789,2022-11-08
TRANSFER,91761,Christophe Teixeira,272789,181028,Nathalie-Claire De Oliveira,634080,542319,2022-11-08
TRANSFER,403967,Stéphanie Guichard,535901,131934,Christophe Teixeira,181028,584995,2022-11-09
CASH_IN,39245,Agence_mtn_Cotonou,300000,260755,Christophe Teixeira,584995,624240,2022-11-10
CASH_IN,48336,Agence_mtn_Cotonou,300000,251664,Christophe Teixeira,624240,672576,2022-11-13
TRANSFER,24517,Christophe Teixeira,672576,648059,Nathalie-Claire De Oliveira,542319,517802,2022-11-15
TRANSFER,611401,Christophe Teixeira,648059,36658,Nathalie-Claire De Oliveira,517802,-93599,2022-11-16
TRANSFER,29456,Christophe Teixeira,36658,7202,Stéphanie Guichard,131934,102478,2022-11-18
TRANSFER,96622,Guy-Augustin Pinto,289778,193156,Christophe Teixeira,7202,103824,2022-11-19
CASH_OUT,27547,Christophe Teixeira,103824,76277,Agence_mtn_Cotonou,300000,272453,2022-11-19
CASH_OUT,16813,Christophe Teixeira,76277,59464,Agence_mtn_Cotonou,300000,283187,2022-11-22
CASH_IN,269267,Agence_mtn_Abomey,300000,30733,Christophe Teixeira,59464,328731,2022-11-26
CASH_IN,205589,Agence_mtn_Cotonou,300000,94411,Nathalie Da Silva,-80449,125140,2022-11-04
CASH_OUT,32890,Nathalie Da Silva,125140,92250,Agence_mtn_Abomey,300000,267110,2022-11-04
TRANSFER,31460,Stéphanie Guichard,102478,71018,Nathalie Da Silva,92250,123710,2022-11-09
TRANSFER,13374,Guy-Augustin Pinto,193156,179782,Nathalie Da Silva,123710,137084,2022-11-09
CASH_OUT,58939,Nathalie Da Silva,137084,78145,Agence_mtn_Abomey,300000,241061,2022-11-15
CASH_IN,48876,Agence_mtn_Ouidah,300000,251124,Nathalie Da Silva,78145,127021,2022-11-16
CASH_OUT,3623,Nathalie Da Silva,127021,123398,Agence_mtn_Cotonou,300000,296377,2022-11-16
TRANSFER,30459,Stéphanie Guichard,71018,40559,Nathalie Da Silva,123398,153857,2022-11-20
CASH_IN,153805,Agence_mtn_Cotonou,300000,146195,Nathalie Da Silva,153857,307662,2022-11-20
CASH_IN,281134,Agence_mtn_Abomey,300000,18866,Nathalie Da Silva,307662,588796,2022-11-20
CASH_IN,30465,Agence_mtn_Ouidah,300000,269535,Nathalie Da Silva,588796,619261,2022-11-21
CASH_IN,233335,Agence_mtn_Cotonou,300000,66665,Nathalie Da Silva,619261,852596,2022-11-22
CASH_IN,185276,Agence_mtn_Abomey,300000,114724,Nathalie Da Silva,852596,1037872,2022-11-23
CASH_OUT,660000,Nathalie Da Silva,1037872,377872,Agence_mtn_Abomey,300000,-360000,2022-11-24
CASH_OUT,207352,Nathalie Da Silva,377872,170520,Agence_mtn_Abomey,300000,92648,2022-11-26
CASH_IN,290126,Agence_mtn_Cotonou,300000,9874,Nathalie Da Silva,170520,460646,2022-11-26
CASH_OUT,271485,Nathalie Da Silva,460646,189161,Agence_mtn_Cotonou,300000,28515,2022-11-27
CASH_IN,9946,Agence_mtn_Cotonou,300000,290054,Édouard Grondin du Fleury,-965857,-955911,2022-11-01
CASH_IN,146892,Agence_mtn_Ouidah,300000,153108,Édouard Grondin du Fleury,-955911,-809019,2022-11-02
CASH_IN,264614,Agence_mtn_Cotonou,300000,35386,Édouard Grondin du Fleury,-809019,-544405,2022-11-03
CASH_IN,228938,Agence_mtn_Ouidah,300000,71062,Édouard Grondin du Fleury,-544405,-315467,2022-11-03
CASH_IN,176990,Agence_mtn_Abomey,300000,123010,Édouard Grondin du Fleury,-315467,-138477,2022-11-03
CASH_IN,283848,Agence_mtn_Abomey,300000,16152,Édouard Grondin du Fleury,-138477,145371,2022-11-03
TRANSFER,165225,Guy-Augustin Pinto,179782,14557,Édouard Grondin du Fleury,145371,310596,2022-11-07
CASH_OUT,208554,Édouard Grondin du Fleury,310596,102042,Agence_mtn_Ouidah,300000,91446,2022-11-07
TRANSFER,73209,Édouard Grondin du Fleury,102042,28833,Guy-Augustin Pinto,14557,-58652,2022-11-10
TRANSFER,9887,Édouard Grondin du Fleury,28833,18946,Édouard Grondin du Fleury,28833,18946,2022-11-13
CASH_OUT,15316,Édouard Grondin du Fleury,18946,3630,Agence_mtn_Ouidah,300000,284684,2022-11-14
CASH_OUT,228,Édouard Grondin du Fleury,3630,3402,Agence_mtn_Abomey,300000,299772,2022-11-15
CASH_OUT,2037,Édouard Grondin du Fleury,3402,1365,Agence_mtn_Ouidah,300000,297963,2022-11-16
CASH_OUT,718,Édouard Grondin du Fleury,1365,647,Agence_mtn_Cotonou,300000,299282,2022-11-18
TRANSFER,238,Édouard Grondin du Fleury,647,409,Édouard Grondin du Fleury,647,885,2022-11-21
CASH_IN,120736,Agence_mtn_Abomey,300000,179264,Édouard Grondin du Fleury,409,121145,2022-11-23
CASH_IN,66364,Agence_mtn_Ouidah,300000,233636,Édouard Grondin du Fleury,121145,187509,2022-11-23
CASH_OUT,82191,Édouard Grondin du Fleury,187509,105318,Agence_mtn_Cotonou,300000,217809,2022-11-25
CASH_IN,128263,Agence_mtn_Abomey,300000,171737,Édouard Grondin du Fleury,105318,233581,2022-11-27
CASH_IN,178941,Agence_mtn_Abomey,300000,121059,Sylvie Dupré,-107901,71040,2022-11-01
CASH_IN,261635,Agence_mtn_Abomey,300000,38365,Sylvie Dupré,71040,332675,2022-11-02
TRANSFER,4470,Sylvie Dupré,332675,328205,Stéphanie Guichard,40559,36089,2022-11-02
CASH_IN,263948,Agence_mtn_Ouidah,300000,36052,Sylvie Dupré,328205,592153,2022-11-04
CASH_IN,19286,Agence_mtn_Abomey,300000,280714,Sylvie Dupré,592153,611439,2022-11-05
TRANSFER,504819,Sylvie Dupré,611439,106620,Stéphanie Guichard,36089,-468730,2022-11-06
TRANSFER,10761,Sylvie Dupré,106620,95859,Sylvie Dupré,106620,117381,2022-11-07
CASH_IN,188827,Agence_mtn_Ouidah,300000,111173,Sylvie Dupré,95859,284686,2022-11-09
CASH_OUT,124476,Sylvie Dupré,284686,160210,Agence_mtn_Abomey,300000,175524,2022-11-11
CASH_OUT,117244,Sylvie Dupré,160210,42966,Agence_mtn_Abomey,300000,182756,2022-11-23
CASH_IN,15714,Agence_mtn_Cotonou,300000,284286,Sylvie Dupré,42966,58680,2022-11-25
CASH_IN,131831,Agence_mtn_Abomey,300000,168169,Michèle Faivre,-263995,-132164,2022-11-06
CASH_IN,32415,Agence_mtn_Abomey,300000,267585,Michèle Faivre,-132164,-99749,2022-11-06
CASH_IN,11680,Agence_mtn_Cotonou,300000,288320,Michèle Faivre,-99749,-88069,2022-11-07
CASH_IN,267393,Agence_mtn_Cotonou,300000,32607,Michèle Faivre,-88069,179324,2022-11-08
CASH_IN,276659,Agence_mtn_Abomey,300000,23341,Michèle Faivre,179324,455983,2022-11-09
CASH_OUT,194553,Michèle Faivre,455983,261430,Agence_mtn_Ouidah,300000,105447,2022-11-10
TRANSFER,64531,Michèle Faivre,261430,196899,Michèle Faivre,261430,325961,2022-11-10
CASH_OUT,36779,Michèle Faivre,196899,160120,Agence_mtn_Cotonou,300000,263221,2022-11-13
CASH_OUT,67510,Michèle Faivre,160120,92610,Agence_mtn_Abomey,300000,232490,2022-11-16
CASH_IN,97859,Agence_mtn_Cotonou,300000,202141,Michèle Faivre,92610,190469,2022-11-18
CASH_OUT,40742,Michèle Faivre,190469,149727,Agence_mtn_Ouidah,300000,259258,2022-11-21
CASH_OUT,75004,Michèle Faivre,149727,74723,Agence_mtn_Ouidah,300000,224996,2022-11-22
CASH_OUT,14267,Michèle Faivre,74723,60456,Agence_mtn_Abomey,300000,285733,2022-11-26
CASH_OUT,37384,Michèle Faivre,60456,23072,Agence_mtn_Cotonou,300000,262616,2022-11-27
CASH_IN,257138,Agence_mtn_Cotonou,300000,42862,Georges Muller,-896,256242,2022-11-04
CASH_IN,201059,Agence_mtn_Cotonou,300000,98941,Georges Muller,256242,457301,2022-11-09
CASH_OUT,83492,Georges Muller,457301,373809,Agence_mtn_Ouidah,300000,216508,2022-11-10
TRANSFER,319109,Georges Muller,373809,54700,Georges Muller,373809,54700,2022-11-12
CASH_OUT,44378,Georges Muller,54700,10322,Agence_mtn_Cotonou,300000,255622,2022-11-14
TRANSFER,6968,Georges Muller,10322,3354,Georges Muller,10322,17290,2022-11-15
CASH_IN,14390,Agence_mtn_Ouidah,300000,285610,Georges Muller,3354,17744,2022-11-15
CASH_OUT,1956,Georges Muller,17744,15788,Agence_mtn_Cotonou,300000,298044,2022-11-18
CASH_OUT,13482,Georges Muller,15788,2306,Agence_mtn_Abomey,300000,286518,2022-11-22
CASH_IN,269195,Agence_mtn_Cotonou,300000,30805,Georges Muller,2306,271501,2022-11-22
CASH_IN,198121,Agence_mtn_Cotonou,300000,101879,Thibault-Julien Chevallier,-454680,-256559,2022-11-02
CASH_IN,138280,Agence_mtn_Abomey,300000,161720,Thibault-Julien Chevallier,-256559,-118279,2022-11-03
CASH_IN,187724,Agence_mtn_Ouidah,300000,112276,Thibault-Julien Chevallier,-118279,69445,2022-11-04
CASH_OUT,3707,Thibault-Julien Chevallier,69445,65738,Agence_mtn_Cotonou,300000,296293,2022-11-04
CASH_OUT,2973,Thibault-Julien Chevallier,65738,62765,Agence_mtn_Cotonou,300000,297027,2022-11-05
TRANSFER,27034,Thibault-Julien Chevallier,62765,35731,Thibault-Julien Chevallier,62765,35731,2022-11-08
CASH_OUT,12397,Thibault-Julien Chevallier,35731,23334,Agence_mtn_Abomey,300000,287603,2022-11-13
CASH_OUT,17982,Thibault-Julien Chevallier,23334,5352,Agence_mtn_Ouidah,300000,282018,2022-11-15
CASH_OUT,1862,Thibault-Julien Chevallier,5352,3490,Agence_mtn_Ouidah,300000,298138,2022-11-21
CASH_OUT,266,Thibault-Julien Chevallier,3490,3224,Agence_mtn_Abomey,300000,299734,2022-11-22
CASH_OUT,1567,Thibault-Julien Chevallier,3224,1657,Agence_mtn_Abomey,300000,298433,2022-11-26
CASH_IN,11045,Agence_mtn_Cotonou,300000,288955,Josette du Hamon,-23143,-12098,2022-11-02
CASH_IN,129004,Agence_mtn_Cotonou,300000,170996,Josette du Hamon,-12098,116906,2022-11-04
TRANSFER,47129,Josette du Hamon,116906,69777,Josette du Hamon,116906,69777,2022-11-07
CASH_IN,204492,Agence_mtn_Cotonou,300000,95508,Josette du Hamon,69777,274269,2022-11-08
CASH_IN,24809,Agence_mtn_Ouidah,300000,275191,Josette du Hamon,274269,299078,2022-11-08
CASH_IN,72216,Agence_mtn_Abomey,300000,227784,Josette du Hamon,299078,371294,2022-11-11
TRANSFER,344916,Josette du Hamon,371294,26378,Josette du Hamon,371294,26378,2022-11-11
CASH_IN,99611,Agence_mtn_Cotonou,300000,200389,Josette du Hamon,26378,125989,2022-11-13
CASH_IN,205145,Agence_mtn_Ouidah,300000,94855,Josette du Hamon,125989,331134,2022-11-14
CASH_OUT,289347,Josette du Hamon,331134,41787,Agence_mtn_Abomey,300000,10653,2022-11-24
CASH_IN,445,Agence_mtn_Ouidah,300000,299555,Josette du Hamon,41787,42232,2022-11-27
CASH_OUT,4010,Josette du Hamon,42232,38222,Agence_mtn_Cotonou,300000,295990,2022-11-27
CASH_IN,30754,Agence_mtn_Cotonou,300000,269246,Christophe Besnard-Diaz,24,30778,2022-11-05
TRANSFER,24656,Christophe Besnard-Diaz,30778,6122,Christophe Besnard-Diaz,30778,6122,2022-11-07
CASH_OUT,5665,Christophe Besnard-Diaz,6122,457,Agence_mtn_Cotonou,300000,294335,2022-11-08
CASH_IN,94587,Agence_mtn_Cotonou,300000,205413,Christophe Besnard-Diaz,457,95044,2022-11-11
TRANSFER,73002,Christophe Besnard-Diaz,95044,22042,Christophe Besnard-Diaz,95044,22042,2022-11-15
CASH_OUT,4145,Christophe Besnard-Diaz,22042,17897,Agence_mtn_Ouidah,300000,295855,2022-11-16
TRANSFER,11890,Christophe Besnard-Diaz,17897,6007,Christophe Besnard-Diaz,17897,29787,2022-11-22
CASH_IN,206983,Agence_mtn_Cotonou,300000,93017,Christophe Besnard-Diaz,6007,212990,2022-11-24
CASH_IN,125132,Agence_mtn_Abomey,300000,174868,Christophe Besnard-Diaz,212990,338122,2022-11-25
CASH_IN,76250,Agence_mtn_Cotonou,300000,223750,Christophe Besnard-Diaz,338122,414372,2022-11-26
CASH_IN,57522,Agence_mtn_Cotonou,300000,242478,Christophe Besnard-Diaz,414372,471894,2022-11-26
CASH_IN,104949,Agence_mtn_Cotonou,300000,195051,Christophe Besnard-Diaz,471894,576843,2022-11-27
CASH_IN,196803,Agence_mtn_Ouidah,300000,103197,Julie Germain Le Vaillant,-376767,-179964,2022-11-02
CASH_IN,182001,Agence_mtn_Abomey,300000,117999,Julie Germain Le Vaillant,-179964,2037,2022-11-02
CASH_OUT,707,Julie Germain Le Vaillant,2037,1330,Agence_mtn_Abomey,300000,299293,2022-11-04
CASH_IN,147526,Agence_mtn_Ouidah,300000,152474,Julie Germain Le Vaillant,1330,148856,2022-11-04
CASH_OUT,101885,Julie Germain Le Vaillant,148856,46971,Agence_mtn_Abomey,300000,198115,2022-11-05
CASH_OUT,950,Julie Germain Le Vaillant,46971,46021,Agence_mtn_Ouidah,300000,299050,2022-11-06
CASH_OUT,37089,Julie Germain Le Vaillant,46021,8932,Agence_mtn_Cotonou,300000,262911,2022-11-09
TRANSFER,6227,Julie Germain Le Vaillant,8932,2705,Julie Germain Le Vaillant,8932,15159,2022-11-10
TRANSFER,2340,Julie Germain Le Vaillant,2705,365,Julie Germain Le Vaillant,2705,365,2022-11-11
CASH_OUT,357,Julie Germain Le Vaillant,365,8,Agence_mtn_Abomey,300000,299643,2022-11-16
CASH_IN,119629,Agence_mtn_Ouidah,300000,180371,Julie Germain Le Vaillant,8,119637,2022-11-17
CASH_OUT,110916,Julie Germain Le Vaillant,119637,8721,Agence_mtn_Cotonou,300000,189084,2022-11-19
CASH_IN,149546,Agence_mtn_Cotonou,300000,150454,Julie Germain Le Vaillant,8721,158267,2022-11-21
CASH_IN,96226,Agence_mtn_Abomey,300000,203774,Julie Germain Le Vaillant,158267,254493,2022-11-25
CASH_IN,293691,Agence_mtn_Abomey,300000,6309,Nathalie-Claire De Oliveira,-93599,200092,2022-11-01
CASH_OUT,102228,Nathalie-Claire De Oliveira,200092,97864,Agence_mtn_Abomey,300000,197772,2022-11-03
CASH_OUT,26271,Nathalie-Claire De Oliveira,97864,71593,Agence_mtn_Ouidah,300000,273729,2022-11-07
CASH_OUT,30786,Nathalie-Claire De Oliveira,71593,40807,Agence_mtn_Ouidah,300000,269214,2022-11-08
CASH_OUT,7427,Nathalie-Claire De Oliveira,40807,33380,Agence_mtn_Ouidah,300000,292573,2022-11-11
CASH_OUT,20754,Nathalie-Claire De Oliveira,33380,12626,Agence_mtn_Ouidah,300000,279246,2022-11-13
CASH_IN,101365,Agence_mtn_Cotonou,300000,198635,Nathalie-Claire De Oliveira,12626,113991,2022-11-17
CASH_IN,299734,Agence_mtn_Abomey,300000,266,Nathalie-Claire De Oliveira,113991,413725,2022-11-18
CASH_IN,86131,Agence_mtn_Ouidah,300000,213869,Nathalie-Claire De Oliveira,413725,499856,2022-11-22
CASH_OUT,302004,Nathalie-Claire De Oliveira,499856,197852,Agence_mtn_Ouidah,300000,-2004,2022-11-25
CASH_IN,40544,Agence_mtn_Abomey,300000,259456,Françoise Denis de Allard,-56053,-15509,2022-11-05
CASH_IN,201383,Agence_mtn_Abomey,300000,98617,Françoise Denis de Allard,-15509,185874,2022-11-05
TRANSFER,155911,Françoise Denis de Allard,185874,29963,Françoise Denis de Allard,185874,341785,2022-11-05
CASH_OUT,9273,Françoise Denis de Allard,29963,20690,Agence_mtn_Abomey,300000,290727,2022-11-06
CASH_OUT,18066,Françoise Denis de Allard,20690,2624,Agence_mtn_Ouidah,300000,281934,2022-11-10
CASH_OUT,2496,Françoise Denis de Allard,2624,128,Agence_mtn_Abomey,300000,297504,2022-11-10
CASH_IN,283880,Agence_mtn_Abomey,300000,16120,Françoise Denis de Allard,128,284008,2022-11-11
CASH_IN,189594,Agence_mtn_Ouidah,300000,110406,Françoise Denis de Allard,284008,473602,2022-11-11
CASH_IN,20118,Agence_mtn_Ouidah,300000,279882,Françoise Denis de Allard,473602,493720,2022-11-13
TRANSFER,443337,Françoise Denis de Allard,493720,50383,Françoise Denis de Allard,493720,937057,2022-11-16
CASH_OUT,33576,Françoise Denis de Allard,50383,16807,Agence_mtn_Abomey,300000,266424,2022-11-17
TRANSFER,8966,Françoise Denis de Allard,16807,7841,Françoise Denis de Allard,16807,7841,2022-11-17
CASH_IN,221004,Agence_mtn_Abomey,300000,78996,Françoise Denis de Allard,7841,228845,2022-11-19
CASH_OUT,94824,Françoise Denis de Allard,228845,134021,Agence_mtn_Cotonou,300000,205176,2022-11-22
CASH_IN,280549,Agence_mtn_Cotonou,300000,19451,Françoise Denis de Allard,134021,414570,2022-11-25
CASH_OUT,310310,Françoise Denis de Allard,414570,104260,Agence_mtn_Ouidah,300000,-10310,2022-11-27
CASH_IN,93894,Agence_mtn_Abomey,300000,206106,Honoré Grégoire-Breton,-146687,-52793,2022-11-05
CASH_IN,155429,Agence_mtn_Abomey,300000,144571,Honoré Grégoire-Breton,-52793,102636,2022-11-15
CASH_OUT,65886,Honoré Grégoire-Breton,102636,36750,Agence_mtn_Cotonou,300000,234114,2022-11-17
CASH_IN,204881,Agence_mtn_Ouidah,300000,95119,Honoré Grégoire-Breton,36750,241631,2022-11-18
CASH_IN,137363,Agence_mtn_Cotonou,300000,162637,Honoré Grégoire-Breton,241631,378994,2022-11-23
CASH_OUT,67490,Honoré Grégoire-Breton,378994,311504,Agence_mtn_Ouidah,300000,232510,2022-11-27
CASH_IN,68140,Agence_mtn_Abomey,300000,231860,Jérôme Laporte Le Gauthier,-577157,-509017,2022-11-02
CASH_IN,197246,Agence_mtn_Abomey,300000,102754,Jérôme Laporte Le Gauthier,-509017,-311771,2022-11-09
CASH_IN,31941,Agence_mtn_Ouidah,300000,268059,Jérôme Laporte Le Gauthier,-311771,-279830,2022-11-09
CASH_IN,30330,Agence_mtn_Cotonou,300000,269670,Jérôme Laporte Le Gauthier,-279830,-249500,2022-11-10
CASH_IN,59463,Agence_mtn_Abomey,300000,240537,Jérôme Laporte Le Gauthier,-249500,-190037,2022-11-10
CASH_IN,38104,Agence_mtn_Cotonou,300000,261896,Jérôme Laporte Le Gauthier,-190037,-151933,2022-11-11
CASH_IN,184673,Agence_mtn_Cotonou,300000,115327,Jérôme Laporte Le Gauthier,-151933,32740,2022-11-18
CASH_OUT,17968,Jérôme Laporte Le Gauthier,32740,14772,Agence_mtn_Ouidah,300000,282032,2022-11-19
CASH_OUT,14192,Jérôme Laporte Le Gauthier,14772,580,Agence_mtn_Ouidah,300000,285808,2022-11-20
CASH_IN,129647,Agence_mtn_Abomey,300000,170353,Jérôme Laporte Le Gauthier,580,130227,2022-11-23
CASH_IN,120314,Agence_mtn_Cotonou,300000,179686,Marthe Perrin,-168157,-47843,2022-11-04
CASH_IN,164954,Agence_mtn_Ouidah,300000,135046,Marthe Perrin,-47843,117111,2022-11-04
TRANSFER,37216,Marthe Perrin,117111,79895,Marthe Perrin,117111,79895,2022-11-07
TRANSFER,14202,Marthe Perrin,79895,65693,Marthe Perrin,79895,65693,2022-11-10
CASH_IN,239361,Agence_mtn_Cotonou,300000,60639,Marthe Perrin,65693,305054,2022-11-10
CASH_IN,198178,Agence_mtn_Ouidah,300000,101822,Marthe Perrin,305054,503232,2022-11-12
CASH_IN,19958,Agence_mtn_Ouidah,300000,280042,Marthe Perrin,503232,523190,2022-11-22
CASH_IN,32528,Agence_mtn_Ouidah,300000,267472,Marthe Perrin,523190,555718,2022-11-25
CASH_IN,68101,Agence_mtn_Ouidah,300000,231899,Guy-Augustin Pinto,-58652,9449,2022-11-01
TRANSFER,5823,Guy-Augustin Pinto,9449,3626,Guy-Augustin Pinto,9449,3626,2022-11-03
CASH_OUT,816,Guy-Augustin Pinto,3626,2810,Agence_mtn_Abomey,300000,299184,2022-11-04
CASH_OUT,970,Guy-Augustin Pinto,2810,1840,Agence_mtn_Cotonou,300000,299030,2022-11-06
CASH_IN,298112,Agence_mtn_Cotonou,300000,1888,Guy-Augustin Pinto,1840,299952,2022-11-11
CASH_IN,210050,Agence_mtn_Ouidah,300000,89950,Guy-Augustin Pinto,299952,510002,2022-11-18
CASH_OUT,506958,Guy-Augustin Pinto,510002,3044,Agence_mtn_Ouidah,300000,-206958,2022-11-24
CASH_IN,194799,Agence_mtn_Cotonou,300000,105201,Guy-Augustin Pinto,3044,197843,2022-11-24
CASH_OUT,40939,Guy-Augustin Pinto,197843,156904,Agence_mtn_Ouidah,300000,259061,2022-11-26
CASH_IN,278195,Agence_mtn_Ouidah,300000,21805,Jacques Le Marion,-298865,-20670,2022-11-02
CASH_IN,277594,Agence_mtn_Abomey,300000,22406,Jacques Le Marion,-20670,256924,2022-11-03
TRANSFER,107111,Jacques Le Marion,256924,149813,Jacques Le Marion,256924,364035,2022-11-04
TRANSFER,134614,Jacques Le Marion,149813,15199,Jacques Le Marion,149813,284427,2022-11-06
CASH_OUT,14956,Jacques Le Marion,15199,243,Agence_mtn_Ouidah,300000,285044,2022-11-08
CASH_OUT,194,Jacques Le Marion,243,49,Agence_mtn_Abomey,300000,299806,2022-11-09
CASH_IN,6984,Agence_mtn_Ouidah,300000,293016,Jacques Le Marion,49,7033,2022-11-10
CASH_IN,52554,Agence_mtn_Ouidah,300000,247446,Jacques Le Marion,7033,59587,2022-11-11
CASH_IN,112133,Agence_mtn_Abomey,300000,187867,Jacques Le Marion,59587,171720,2022-11-12
TRANSFER,39919,Jacques Le Marion,171720,131801,Jacques Le Marion,171720,211639,2022-11-13
CASH_IN,244012,Agence_mtn_Abomey,300000,55988,Jacques Le Marion,131801,375813,2022-11-19
CASH_OUT,149803,Jacques Le Marion,375813,226010,Agence_mtn_Ouidah,300000,150197,2022-11-20
CASH_IN,208132,Agence_mtn_Cotonou,300000,91868,Jacques Le Marion,226010,434142,2022-11-21
CASH_OUT,20005,Jacques Le Marion,434142,414137,Agence_mtn_Abomey,300000,279995,2022-11-26
CASH_IN,108389,Agence_mtn_Ouidah,300000,191611,Jacques Le Marion,414137,522526,2022-11-27
CASH_IN,296491,Agence_mtn_Ouidah,300000,3509,Augustin-Jérôme Merle,-1338963,-1042472,2022-11-02
CASH_IN,112491,Agence_mtn_Abomey,300000,187509,Augustin-Jérôme Merle,-1042472,-929981,2022-11-03
CASH_IN,214194,Agence_mtn_Cotonou,300000,85806,Augustin-Jérôme Merle,-929981,-715787,2022-11-03
CASH_IN,74053,Agence_mtn_Ouidah,300000,225947,Augustin-Jérôme Merle,-715787,-641734,2022-11-03
CASH_IN,211864,Agence_mtn_Cotonou,300000,88136,Augustin-Jérôme Merle,-641734,-429870,2022-11-10
CASH_IN,102946,Agence_mtn_Cotonou,300000,197054,Augustin-Jérôme Merle,-429870,-326924,2022-11-13
CASH_IN,121983,Agence_mtn_Cotonou,300000,178017,Augustin-Jérôme Merle,-326924,-204941,2022-11-17
CASH_IN,114711,Agence_mtn_Cotonou,300000,185289,Augustin-Jérôme Merle,-204941,-90230,2022-11-18
CASH_IN,208795,Agence_mtn_Ouidah,300000,91205,Augustin-Jérôme Merle,-90230,118565,2022-11-20
CASH_IN,227040,Agence_mtn_Cotonou,300000,72960,Augustin-Jérôme Merle,118565,345605,2022-11-21
CASH_IN,248199,Agence_mtn_Abomey,300000,51801,Augustin-Jérôme Merle,345605,593804,2022-11-21
CASH_OUT,270065,Augustin-Jérôme Merle,593804,323739,Agence_mtn_Abomey,300000,29935,2022-11-21
CASH_IN,107461,Agence_mtn_Abomey,300000,192539,Augustin-Jérôme Merle,323739,431200,2022-11-22
CASH_OUT,325772,Augustin-Jérôme Merle,431200,105428,Agence_mtn_Abomey,300000,-25772,2022-11-23
TRANSFER,76001,Augustin-Jérôme Merle,105428,29427,Augustin-Jérôme Merle,105428,29427,2022-11-23
CASH_OUT,27961,Augustin-Jérôme Merle,29427,1466,Agence_mtn_Cotonou,300000,272039,2022-11-23
CASH_IN,102024,Agence_mtn_Ouidah,300000,197976,Louis du Boyer,-114446,-12422,2022-11-01
CASH_IN,219329,Agence_mtn_Cotonou,300000,80671,Louis du Boyer,-12422,206907,2022-11-05
TRANSFER,47224,Louis du Boyer,206907,159683,Louis du Boyer,206907,159683,2022-11-05
CASH_OUT,145228,Louis du Boyer,159683,14455,Agence_mtn_Abomey,300000,154772,2022-11-07
CASH_OUT,1190,Louis du Boyer,14455,13265,Agence_mtn_Ouidah,300000,298810,2022-11-07
CASH_IN,246080,Agence_mtn_Cotonou,300000,53920,Louis du Boyer,13265,259345,2022-11-07
TRANSFER,16666,Louis du Boyer,259345,242679,Louis du Boyer,259345,242679,2022-11-08
TRANSFER,56690,Louis du Boyer,242679,185989,Louis du Boyer,242679,299369,2022-11-09
CASH_IN,289641,Agence_mtn_Abomey,300000,10359,Louis du Boyer,185989,475630,2022-11-14
CASH_OUT,158998,Louis du Boyer,475630,316632,Agence_mtn_Cotonou,300000,141002,2022-11-16
TRANSFER,233890,Louis du Boyer,316632,82742,Louis du Boyer,316632,82742,2022-11-18
CASH_IN,97798,Agence_mtn_Cotonou,300000,202202,Louis du Boyer,82742,180540,2022-11-18
CASH_IN,113671,Agence_mtn_Ouidah,300000,186329,Louis du Boyer,180540,294211,2022-11-18
CASH_OUT,155738,Louis du Boyer,294211,138473,Agence_mtn_Abomey,300000,144262,2022-11-19
CASH_OUT,78492,Louis du Boyer,138473,59981,Agence_mtn_Abomey,300000,221508,2022-11-20
CASH_IN,103555,Agence_mtn_Abomey,300000,196445,Louis du Boyer,59981,163536,2022-11-21
CASH_OUT,95222,Louis du Boyer,163536,68314,Agence_mtn_Ouidah,300000,204778,2022-11-21
CASH_IN,77159,Agence_mtn_Ouidah,300000,222841,Louis du Boyer,68314,145473,2022-11-26
CASH_IN,47771,Agence_mtn_Cotonou,300000,252229,Louis du Boyer,145473,193244,2022-11-27
CASH_IN,131676,Agence_mtn_Ouidah,300000,168324,Emmanuel Legrand,-242825,-111149,2022-11-01
CASH_IN,167085,Agence_mtn_Ouidah,300000,132915,Emmanuel Legrand,-111149,55936,2022-11-04
CASH_OUT,14138,Emmanuel Legrand,55936,41798,Agence_mtn_Abomey,300000,285862,2022-11-04
CASH_IN,282892,Agence_mtn_Abomey,300000,17108,Emmanuel Legrand,41798,324690,2022-11-05
CASH_IN,294439,Agence_mtn_Abomey,300000,5561,Emmanuel Legrand,324690,619129,2022-11-19
CASH_OUT,150481,Emmanuel Legrand,619129,468648,Agence_mtn_Cotonou,300000,149519,2022-11-20
CASH_IN,99133,Agence_mtn_Cotonou,300000,200867,Emmanuel Legrand,468648,567781,2022-11-22
CASH_OUT,410562,Emmanuel Legrand,567781,157219,Agence_mtn_Ouidah,300000,-110562,2022-11-23
CASH_IN,44068,Agence_mtn_Abomey,300000,255932,Jacques Laporte de Blanchet,-254373,-210305,2022-11-02
CASH_IN,195072,Agence_mtn_Abomey,300000,104928,Jacques Laporte de Blanchet,-210305,-15233,2022-11-03
CASH_IN,158879,Agence_mtn_Abomey,300000,141121,Jacques Laporte de Blanchet,-15233,143646,2022-11-04
TRANSFER,141382,Jacques Laporte de Blanchet,143646,2264,Jacques Laporte de Blanchet,143646,285028,2022-11-05
CASH_OUT,814,Jacques Laporte de Blanchet,2264,1450,Agence_mtn_Abomey,300000,299186,2022-11-05
TRANSFER,176,Jacques Laporte de Blanchet,1450,1274,Jacques Laporte de Blanchet,1450,1626,2022-11-06
TRANSFER,293,Jacques Laporte de Blanchet,1274,981,Jacques Laporte de Blanchet,1274,981,2022-11-06
CASH_OUT,876,Jacques Laporte de Blanchet,981,105,Agence_mtn_Cotonou,300000,299124,2022-11-07
CASH_IN,180821,Agence_mtn_Ouidah,300000,119179,Jacques Laporte de Blanchet,105,180926,2022-11-09
CASH_IN,278994,Agence_mtn_Ouidah,300000,21006,Jacques Laporte de Blanchet,180926,459920,2022-11-16
CASH_OUT,221107,Jacques Laporte de Blanchet,459920,238813,Agence_mtn_Ouidah,300000,78893,2022-11-18
CASH_IN,110778,Agence_mtn_Ouidah,300000,189222,Jacques Laporte de Blanchet,238813,349591,2022-11-19
CASH_IN,286912,Agence_mtn_Abomey,300000,13088,Jacques Laporte de Blanchet,349591,636503,2022-11-19
CASH_IN,13799,Agence_mtn_Cotonou,300000,286201,Stéphanie Guichard,-468730,-454931,2022-11-02
CASH_IN,47613,Agence_mtn_Cotonou,300000,252387,Stéphanie Guichard,-454931,-407318,2022-11-02
CASH_IN,146409,Agence_mtn_Cotonou,300000,153591,Stéphanie Guichard,-407318,-260909,2022-11-03
CASH_IN,70202,Agence_mtn_Cotonou,300000,229798,Stéphanie Guichard,-260909,-190707,2022-11-05
CASH_IN,150075,Agence_mtn_Cotonou,300000,149925,Stéphanie Guichard,-190707,-40632,2022-11-07
CASH_IN,196089,Agence_mtn_Cotonou,300000,103911,Stéphanie Guichard,-40632,155457,2022-11-08
TRANSFER,119839,Stéphanie Guichard,155457,35618,Stéphanie Guichard,155457,35618,2022-11-08
CASH_OUT,28385,Stéphanie Guichard,35618,7233,Agence_mtn_Ouidah,300000,271615,2022-11-19
CASH_OUT,2104,Stéphanie Guichard,7233,5129,Agence_mtn_Cotonou,300000,297896,2022-11-20
CASH_IN,175682,Agence_mtn_Abomey,300000,124318,Stéphanie Guichard,5129,180811,2022-11-21
CASH_OUT,51365,Stéphanie Guichard,180811,129446,Agence_mtn_Cotonou,300000,248635,2022-11-21
CASH_OUT,48639,Stéphanie Guichard,129446,80807,Agence_mtn_Ouidah,300000,251361,2022-11-25
CASH_OUT,32958,Stéphanie Guichard,80807,47849,Agence_mtn_Abomey,300000,267042,2022-11-25
CASH_IN,14505,Agence_mtn_Abomey,300000,285495,Stéphanie Guichard,47849,62354,2022-11-27
CASH_OUT,48119,Stéphanie Guichard,62354,14235,Agence_mtn_Cotonou,300000,251881,2022-11-27
CASH_IN,167714,Agence_mtn_Ouidah,300000,132286,Aimé Bernier,-176984,-9270,2022-11-06
CASH_IN,173781,Agence_mtn_Abomey,300000,126219,Aimé Bernier,-9270,164511,2022-11-06
CASH_IN,220050,Agence_mtn_Cotonou,300000,79950,Aimé Bernier,164511,384561,2022-11-06
CASH_IN,47435,Agence_mtn_Cotonou,300000,252565,Aimé Bernier,384561,431996,2022-11-07
TRANSFER,215312,Aimé Bernier,431996,216684,Aimé Bernier,431996,216684,2022-11-08
CASH_OUT,97187,Aimé Bernier,216684,119497,Agence_mtn_Abomey,300000,202813,2022-11-10
CASH_IN,108102,Agence_mtn_Abomey,300000,191898,Aimé Bernier,119497,227599,2022-11-22
CASH_IN,113525,Agence_mtn_Cotonou,300000,186475,Aimé Bernier,227599,341124,2022-11-26
CASH_IN,31064,Agence_mtn_Cotonou,300000,268936,Élisabeth Blot-Bruneau,-13660,17404,2022-11-03
CASH_IN,139114,Agence_mtn_Cotonou,300000,160886,Élisabeth Blot-Bruneau,17404,156518,2022-11-03
CASH_OUT,133218,Élisabeth Blot-Bruneau,156518,23300,Agence_mtn_Ouidah,300000,166782,2022-11-05
TRANSFER,13410,Élisabeth Blot-Bruneau,23300,9890,Élisabeth Blot-Bruneau,23300,36710,2022-11-07
CASH_OUT,1422,Élisabeth Blot-Bruneau,9890,8468,Agence_mtn_Abomey,300000,298578,2022-11-08
CASH_OUT,3621,Élisabeth Blot-Bruneau,8468,4847,Agence_mtn_Ouidah,300000,296379,2022-11-11
CASH_OUT,1835,Élisabeth Blot-Bruneau,4847,3012,Agence_mtn_Ouidah,300000,298165,2022-11-15
CASH_OUT,2412,Élisabeth Blot-Bruneau,3012,600,Agence_mtn_Ouidah,300000,297588,2022-11-18
CASH_IN,6140,Agence_mtn_Cotonou,300000,293860,Élisabeth Blot-Bruneau,600,6740,2022-11-19
CASH_IN,40192,Agence_mtn_Ouidah,300000,259808,Élisabeth Blot-Bruneau,6740,46932,2022-11-24
CASH_IN,25049,Agence_mtn_Abomey,300000,274951,Margaud-Michelle Briand,-10776,14273,2022-11-01
CASH_OUT,3216,Margaud-Michelle Briand,14273,11057,Agence_mtn_Abomey,300000,296784,2022-11-05
CASH_IN,225920,Agence_mtn_Abomey,300000,74080,Margaud-Michelle Briand,11057,236977,2022-11-07
CASH_OUT,233684,Margaud-Michelle Briand,236977,3293,Agence_mtn_Cotonou,300000,66316,2022-11-07
TRANSFER,3280,Margaud-Michelle Briand,3293,13,Margaud-Michelle Briand,3293,6573,2022-11-08
CASH_IN,295738,Agence_mtn_Cotonou,300000,4262,Margaud-Michelle Briand,13,295751,2022-11-09
CASH_IN,110925,Agence_mtn_Cotonou,300000,189075,Margaud-Michelle Briand,295751,406676,2022-11-11
TRANSFER,99633,Margaud-Michelle Briand,406676,307043,Margaud-Michelle Briand,406676,506309,2022-11-12
CASH_IN,30254,Agence_mtn_Cotonou,300000,269746,Margaud-Michelle Briand,307043,337297,2022-11-25
CASH_OUT,73110,Margaud-Michelle Briand,337297,264187,Agence_mtn_Cotonou,300000,226890,2022-11-26
CASH_OUT,95417,Margaud-Michelle Briand,264187,168770,Agence_mtn_Ouidah,300000,204583,2022-11-27
CASH_IN,167062,Agence_mtn_Ouidah,300000,132938,Gérard Blot de Blanc,-31494,135568,2022-11-01
TRANSFER,15672,Gérard Blot de Blanc,135568,119896,Gérard Blot de Blanc,135568,151240,2022-11-02
CASH_OUT,17047,Gérard Blot de Blanc,119896,102849,Agence_mtn_Ouidah,300000,282953,2022-11-08
CASH_IN,45616,Agence_mtn_Ouidah,300000,254384,Gérard Blot de Blanc,102849,148465,2022-11-12
CASH_OUT,111281,Gérard Blot de Blanc,148465,37184,Agence_mtn_Abomey,300000,188719,2022-11-25
CASH_IN,135559,Agence_mtn_Abomey,300000,164441,Astrid Aubert-Thierry,1267400,1402959,2022-12-04
CASH_IN,124778,Agence_mtn_Cotonou,300000,175222,Astrid Aubert-Thierry,1402959,1527737,2022-12-14
CASH_OUT,1377159,Astrid Aubert-Thierry,1527737,150578,Agence_mtn_Abomey,300000,-1077159,2022-12-15
CASH_IN,258867,Agence_mtn_Abomey,300000,41133,Astrid Aubert-Thierry,150578,409445,2022-12-18
CASH_OUT,1126538,Margaud-Michelle Briand,1231100,104562,Agence_mtn_Abomey,300000,-826538,2022-12-15
CASH_OUT,47901,Margaud-Michelle Briand,104562,56661,Agence_mtn_Abomey,300000,252099,2022-12-15
CASH_IN,174646,Agence_mtn_Ouidah,300000,125354,Édouard Grondin du Fleury,291500,466146,2022-12-22
TRANSFER,32722,Clémence-Alice Ruiz,138300,105578,Édouard Grondin du Fleury,466146,498868,2022-12-23
CASH_IN,147150,Agence_mtn_Cotonou,300000,152850,Stéphanie Guichard,1893400,2040550,2022-12-08
CASH_OUT,1079239,Stéphanie Guichard,2040550,961311,Agence_mtn_Ouidah,300000,-779239,2022-12-09
CASH_OUT,852146,Stéphanie Guichard,961311,109165,Agence_mtn_Cotonou,300000,-552146,2022-12-26
CASH_OUT,14369,Olivier Benard,64600,50231,Agence_mtn_Cotonou,300000,285631,2022-12-07
CASH_OUT,39338,Olivier Benard,50231,10893,Agence_mtn_Ouidah,300000,260662,2022-12-20
TRANSFER,1714288,Marine Labbé,1770900,56612,Olivier Benard,10893,1725181,2022-12-25
CASH_IN,133817,Agence_mtn_Ouidah,300000,166183,Olivier Benard,1725181,1858998,2022-12-26
CASH_IN,293078,Agence_mtn_Ouidah,300000,6922,Charlotte Perrier,25800,318878,2022-12-13
TRANSFER,63471,Danielle-Henriette Tessier,199700,136229,Charlotte Perrier,318878,382349,2022-12-14
CASH_OUT,56593,Charlotte Perrier,382349,325756,Agence_mtn_Abomey,300000,243407,2022-12-19
CASH_OUT,231345,Charlotte Perrier,325756,94411,Agence_mtn_Ouidah,300000,68655,2022-12-21
TRANSFER,34538,Thérèse-Juliette Camus,160400,125862,Charlotte Perrier,94411,128949,2022-12-23
CASH_OUT,100989,Valérie-Claudine Marin,361000,260011,Agence_mtn_Ouidah,300000,199011,2022-12-02
TRANSFER,188291,Valérie-Claudine Marin,260011,71720,Honoré Grégoire-Breton,9800,-178491,2022-12-02
CASH_IN,212881,Agence_mtn_Abomey,300000,87119,Valérie-Claudine Marin,71720,284601,2022-12-06
CASH_IN,147200,Agence_mtn_Abomey,300000,152800,Valérie-Claudine Marin,284601,431801,2022-12-09
CASH_OUT,168365,Valérie-Claudine Marin,431801,263436,Agence_mtn_Abomey,300000,131635,2022-12-10
TRANSFER,1044685,Thibault-Julien Chevallier,1652800,608115,Louis du Boyer,550600,1595285,2022-12-17
TRANSFER,53422,Jacques Laporte de Blanchet,618700,565278,Gilbert Moulin,1129900,1183322,2022-12-15
TRANSFER,849222,Sabine Perrier,1531100,681878,Margot Julien,1011600,162378,2022-12-06
CASH_OUT,319959,Sabine Perrier,681878,361919,Agence_mtn_Ouidah,300000,-19959,2022-12-07
TRANSFER,488096,Louise-Aurore Payet,692700,204604,Sabine Perrier,361919,850015,2022-12-09
CASH_OUT,690892,Sabine Perrier,850015,159123,Agence_mtn_Cotonou,300000,-390892,2022-12-27
CASH_IN,264841,Agence_mtn_Cotonou,300000,35159,Roland Huet,1909400,2174241,2022-12-07
CASH_IN,42066,Agence_mtn_Cotonou,300000,257934,Roland Huet,2174241,2216307,2022-12-12
CASH_OUT,312413,Roland Huet,2216307,1903894,Agence_mtn_Ouidah,300000,-12413,2022-12-15
CASH_IN,130724,Agence_mtn_Abomey,300000,169276,Roland Huet,1903894,2034618,2022-12-17
TRANSFER,503352,Nicolas Blin,621400,118048,Roland Huet,2034618,2537970,2022-12-18
CASH_IN,200232,Agence_mtn_Abomey,300000,99768,Georges Muller,1987800,2188032,2022-12-02
CASH_IN,7592,Agence_mtn_Ouidah,300000,292408,Georges Muller,2188032,2195624,2022-12-27
TRANSFER,226998,Alfred Paris,642400,415402,Sophie-Anouk Boulanger,1234100,1007102,2022-12-10
CASH_IN,32454,Agence_mtn_Cotonou,300000,267546,Alfred Paris,415402,447856,2022-12-13
CASH_IN,106758,Agence_mtn_Ouidah,300000,193242,Alfred Paris,447856,554614,2022-12-13
TRANSFER,93453,Alfred Paris,554614,461161,Marcel de la Buisson,1345900,1252447,2022-12-23
CASH_IN,227708,Agence_mtn_Ouidah,300000,72292,Alfred Paris,461161,688869,2022-12-23
CASH_OUT,563307,Emmanuelle Le Allain,1564300,1000993,Agence_mtn_Cotonou,300000,-263307,2022-12-02
CASH_IN,258429,Agence_mtn_Abomey,300000,41571,Martin Moreau,706500,964929,2022-12-11
CASH_OUT,550344,Martin Moreau,964929,414585,Agence_mtn_Abomey,300000,-250344,2022-12-11
TRANSFER,303105,Julie Germain Le Vaillant,545700,242595,Martin Moreau,414585,717690,2022-12-20
CASH_IN,226822,Agence_mtn_Abomey,300000,73178,Jean Guilbert-Lenoir,351600,578422,2022-12-06
CASH_OUT,181496,Jean Guilbert-Lenoir,578422,396926,Agence_mtn_Abomey,300000,118504,2022-12-08
CASH_IN,51305,Agence_mtn_Ouidah,300000,248695,Jean Guilbert-Lenoir,396926,448231,2022-12-12
TRANSFER,275198,Jean Guilbert-Lenoir,448231,173033,Emmanuel Vallée,1929900,1654702,2022-12-13
TRANSFER,96618,Jean Guilbert-Lenoir,173033,76415,Guillaume de la Nguyen,1848300,1751682,2022-12-14
CASH_OUT,286938,Madeleine Philippe-Grondin,1974600,1687662,Agence_mtn_Ouidah,300000,13062,2022-12-04
CASH_OUT,1414066,Madeleine Philippe-Grondin,1687662,273596,Agence_mtn_Cotonou,300000,-1114066,2022-12-04
TRANSFER,1231802,Élisabeth Blot-Bruneau,1365900,134098,Madeleine Philippe-Grondin,273596,1505398,2022-12-09
CASH_IN,83719,Agence_mtn_Cotonou,300000,216281,Madeleine Philippe-Grondin,1505398,1589117,2022-12-10
CASH_OUT,150062,Madeleine Philippe-Grondin,1589117,1439055,Agence_mtn_Cotonou,300000,149938,2022-12-20
CASH_OUT,265973,Jacques Le Marion,574500,308527,Agence_mtn_Abomey,300000,34027,2022-12-01
TRANSFER,121948,Sylvie Dupré,1290100,1168152,Astrid de Pascal,494700,616648,2022-12-11
TRANSFER,71071,Astrid de Pascal,616648,545577,Josette du Hamon,1456500,1385429,2022-12-19
TRANSFER,16886,Louise-Aurore Payet,204604,187718,Marcel de la Buisson,1252447,1235561,2022-12-03
CASH_IN,60078,Agence_mtn_Abomey,300000,239922,Louise-Aurore Payet,187718,247796,2022-12-07
TRANSFER,178982,Louise-Aurore Payet,247796,68814,Julien Devaux,323800,144818,2022-12-20
CASH_OUT,878848,Marc Baudry,1046000,167152,Agence_mtn_Abomey,300000,-578848,2022-12-01
CASH_IN,202494,Agence_mtn_Abomey,300000,97506,Marc Baudry,167152,369646,2022-12-03
TRANSFER,126577,Élisabeth Blot-Bruneau,134098,7521,Véronique Hardy,715000,841577,2022-12-04
TRANSFER,81795,Véronique Hardy,841577,759782,Véronique Hardy,841577,923372,2022-12-14
CASH_OUT,57295,Véronique Hardy,759782,702487,Agence_mtn_Cotonou,300000,242705,2022-12-15
CASH_OUT,392691,Véronique Hardy,702487,309796,Agence_mtn_Abomey,300000,-92691,2022-12-27
TRANSFER,557556,Anouk Delahaye-Gimenez,911500,353944,Raymond de Le Roux,749000,191444,2022-12-01
TRANSFER,126484,Anouk Delahaye-Gimenez,353944,227460,Marcel de la Buisson,1235561,1109077,2022-12-10
CASH_OUT,22430,Anouk Delahaye-Gimenez,227460,205030,Agence_mtn_Abomey,300000,277570,2022-12-19
CASH_IN,237208,Agence_mtn_Cotonou,300000,62792,Anouk Delahaye-Gimenez,205030,442238,2022-12-23
CASH_IN,18296,Agence_mtn_Abomey,300000,281704,Honoré de la Prévost,1597300,1615596,2022-12-01
CASH_OUT,1398588,Honoré de la Prévost,1615596,217008,Agence_mtn_Abomey,300000,-1098588,2022-12-06
TRANSFER,1859058,Christophe Teixeira,1863500,4442,Honoré de la Prévost,217008,2076066,2022-12-13
CASH_OUT,1121724,Honoré de la Prévost,2076066,954342,Agence_mtn_Abomey,300000,-821724,2022-12-18
TRANSFER,400190,Honoré de la Prévost,954342,554152,Simone du Allard,1894700,1494510,2022-12-27
TRANSFER,927284,Maryse Delorme,1213200,285916,Georges-Alfred Pruvost,766600,1693884,2022-12-05
CASH_IN,141572,Agence_mtn_Cotonou,300000,158428,Georges-Alfred Pruvost,1693884,1835456,2022-12-18
CASH_IN,7850,Agence_mtn_Abomey,300000,292150,Georges-Alfred Pruvost,1835456,1843306,2022-12-20
TRANSFER,335449,Georges-Alfred Pruvost,1843306,1507857,Maryse Delorme,285916,-49533,2022-12-25
CASH_OUT,442589,Laurent Marion,1019100,576511,Agence_mtn_Abomey,300000,-142589,2022-12-05
CASH_IN,104451,Agence_mtn_Ouidah,300000,195549,Laurent Marion,576511,680962,2022-12-15
CASH_OUT,542633,Laurent Marion,680962,138329,Agence_mtn_Cotonou,300000,-242633,2022-12-17
CASH_IN,204108,Agence_mtn_Ouidah,300000,95892,Laurent Marion,138329,342437,2022-12-26
CASH_IN,270608,Agence_mtn_Cotonou,300000,29392,Laurent Marion,342437,613045,2022-12-27
CASH_OUT,138116,René de la Delaunay,170300,32184,Agence_mtn_Ouidah,300000,161884,2022-12-08
CASH_IN,164439,Agence_mtn_Cotonou,300000,135561,René de la Delaunay,32184,196623,2022-12-08
CASH_OUT,69764,Marine Chevallier,128300,58536,Agence_mtn_Abomey,300000,230236,2022-12-01
CASH_OUT,22072,Marine Chevallier,58536,36464,Agence_mtn_Ouidah,300000,277928,2022-12-01
CASH_OUT,8841,Marine Chevallier,36464,27623,Agence_mtn_Cotonou,300000,291159,2022-12-02
CASH_OUT,24113,Marine Chevallier,27623,3510,Agence_mtn_Abomey,300000,275887,2022-12-05
CASH_IN,182724,Agence_mtn_Cotonou,300000,117276,Marine Chevallier,3510,186234,2022-12-05
CASH_IN,261638,Agence_mtn_Ouidah,300000,38362,Marine Chevallier,186234,447872,2022-12-06
CASH_IN,159806,Agence_mtn_Abomey,300000,140194,Marine Chevallier,447872,607678,2022-12-06
TRANSFER,344427,Marine Chevallier,607678,263251,Michelle de la Daniel,785600,441173,2022-12-08
CASH_IN,146661,Agence_mtn_Abomey,300000,153339,Marine Chevallier,263251,409912,2022-12-11
CASH_OUT,140677,Marine Chevallier,409912,269235,Agence_mtn_Cotonou,300000,159323,2022-12-11
CASH_IN,17280,Agence_mtn_Cotonou,300000,282720,Marine Chevallier,269235,286515,2022-12-13
CASH_OUT,226721,Marine Chevallier,286515,59794,Agence_mtn_Cotonou,300000,73279,2022-12-15
CASH_IN,248406,Agence_mtn_Cotonou,300000,51594,Marine Chevallier,59794,308200,2022-12-15
CASH_OUT,141331,Marine Chevallier,308200,166869,Agence_mtn_Ouidah,300000,158669,2022-12-16
CASH_IN,110758,Agence_mtn_Abomey,300000,189242,Marine Chevallier,166869,277627,2022-12-17
TRANSFER,1272958,Guillaume de la Nguyen,1751682,478724,Marine Chevallier,277627,1550585,2022-12-18
TRANSFER,1214101,Marine Chevallier,1550585,336484,Henri de Didier,1765000,550899,2022-12-18
CASH_OUT,14483,Marine Chevallier,336484,322001,Agence_mtn_Cotonou,300000,285517,2022-12-21
CASH_IN,180190,Agence_mtn_Cotonou,300000,119810,Marine Chevallier,322001,502191,2022-12-21
CASH_OUT,488597,Marine Chevallier,502191,13594,Agence_mtn_Abomey,300000,-188597,2022-12-23
TRANSFER,12808,Marine Chevallier,13594,786,Marthe Perrin,1782200,1769392,2022-12-23
CASH_OUT,654,Marine Chevallier,786,132,Agence_mtn_Ouidah,300000,299346,2022-12-24
CASH_OUT,106,Marine Chevallier,132,26,Agence_mtn_Abomey,300000,299894,2022-12-26
CASH_IN,237248,Agence_mtn_Abomey,300000,62752,Marine Chevallier,26,237274,2022-12-26
TRANSFER,93270,Marine Chevallier,237274,144004,Clémence Dufour,66300,-26970,2022-12-27
TRANSFER,239265,Nathalie Da Silva,939400,700135,Nathalie-Claire De Oliveira,889400,1128665,2022-12-01
TRANSFER,1039998,Nathalie-Claire De Oliveira,1128665,88667,Louis de la Imbert,51100,-988898,2022-12-01
TRANSFER,66406,Thérèse-Juliette Camus,125862,59456,Nathalie-Claire De Oliveira,88667,155073,2022-12-02
TRANSFER,670383,Jérôme Laporte Le Gauthier,821400,151017,Nathalie-Claire De Oliveira,155073,825456,2022-12-02
TRANSFER,377654,Nathalie-Claire De Oliveira,825456,447802,Alexandre Delaunay,248100,-129554,2022-12-04
CASH_OUT,425038,Nathalie-Claire De Oliveira,447802,22764,Agence_mtn_Abomey,300000,-125038,2022-12-05
CASH_IN,77875,Agence_mtn_Abomey,300000,222125,Nathalie-Claire De Oliveira,22764,100639,2022-12-08
TRANSFER,35082,Nathalie-Claire De Oliveira,100639,65557,Jacques Marchand,1082800,1047718,2022-12-10
CASH_OUT,11931,Nathalie-Claire De Oliveira,65557,53626,Agence_mtn_Cotonou,300000,288069,2022-12-11
CASH_OUT,50791,Nathalie-Claire De Oliveira,53626,2835,Agence_mtn_Ouidah,300000,249209,2022-12-15
CASH_IN,139325,Agence_mtn_Cotonou,300000,160675,Nathalie-Claire De Oliveira,2835,142160,2022-12-15
TRANSFER,100346,Nathalie-Claire De Oliveira,142160,41814,Nicole Huet,1867600,1767254,2022-12-16
CASH_OUT,1982,Nathalie-Claire De Oliveira,41814,39832,Agence_mtn_Ouidah,300000,298018,2022-12-17
CASH_OUT,35637,Nathalie-Claire De Oliveira,39832,4195,Agence_mtn_Abomey,300000,264363,2022-12-19
CASH_IN,153732,Agence_mtn_Cotonou,300000,146268,Nathalie-Claire De Oliveira,4195,157927,2022-12-19
TRANSFER,144425,Nathalie-Claire De Oliveira,157927,13502,Alexandre Blanchard,1542800,1398375,2022-12-20
CASH_OUT,11995,Nathalie-Claire De Oliveira,13502,1507,Agence_mtn_Abomey,300000,288005,2022-12-20
CASH_OUT,1496,Nathalie-Claire De Oliveira,1507,11,Agence_mtn_Ouidah,300000,298504,2022-12-22
CASH_IN,79222,Agence_mtn_Ouidah,300000,220778,Nathalie-Claire De Oliveira,11,79233,2022-12-23
TRANSFER,23361,Nathalie-Claire De Oliveira,79233,55872,Thibault-Julien Chevallier,608115,584754,2022-12-25
TRANSFER,978982,Emmanuel Vallée,1654702,675720,Nathalie-Claire De Oliveira,55872,1034854,2022-12-26
CASH_IN,298722,Agence_mtn_Abomey,300000,1278,Nathalie-Claire De Oliveira,1034854,1333576,2022-12-26
CASH_OUT,588215,Nathalie-Claire De Oliveira,1333576,745361,Agence_mtn_Ouidah,300000,-288215,2022-12-26
CASH_OUT,53356,Raymond Simon,64900,11544,Agence_mtn_Ouidah,300000,246644,2022-12-04
TRANSFER,8138,Raymond Simon,11544,3406,Josette du Hamon,1385429,1377291,2022-12-04
CASH_IN,228192,Agence_mtn_Cotonou,300000,71808,Raymond Simon,3406,231598,2022-12-05
TRANSFER,22167,Jérôme Laporte Le Gauthier,151017,128850,Raymond Simon,231598,253765,2022-12-06
CASH_OUT,4665,Raymond Simon,253765,249100,Agence_mtn_Abomey,300000,295335,2022-12-06
CASH_OUT,98891,Raymond Simon,249100,150209,Agence_mtn_Abomey,300000,201109,2022-12-07
CASH_OUT,108706,Raymond Simon,150209,41503,Agence_mtn_Cotonou,300000,191294,2022-12-08
CASH_IN,226094,Agence_mtn_Ouidah,300000,73906,Raymond Simon,41503,267597,2022-12-10
TRANSFER,152309,Raymond Simon,267597,115288,Margot Julien,162378,10069,2022-12-10
CASH_OUT,26611,Raymond Simon,115288,88677,Agence_mtn_Ouidah,300000,273389,2022-12-11
CASH_IN,122884,Agence_mtn_Abomey,300000,177116,Raymond Simon,88677,211561,2022-12-11
CASH_OUT,24650,Raymond Simon,211561,186911,Agence_mtn_Cotonou,300000,275350,2022-12-12
TRANSFER,380065,Emmanuel Vallée,675720,295655,Raymond Simon,186911,566976,2022-12-12
CASH_OUT,23414,Raymond Simon,566976,543562,Agence_mtn_Abomey,300000,276586,2022-12-13
TRANSFER,328210,Josette du Hamon,1377291,1049081,Raymond Simon,543562,871772,2022-12-13
CASH_OUT,218976,Raymond Simon,871772,652796,Agence_mtn_Abomey,300000,81024,2022-12-14
CASH_IN,132549,Agence_mtn_Cotonou,300000,167451,Raymond Simon,652796,785345,2022-12-15
CASH_OUT,254109,Raymond Simon,785345,531236,Agence_mtn_Abomey,300000,45891,2022-12-15
CASH_OUT,355181,Raymond Simon,531236,176055,Agence_mtn_Abomey,300000,-55181,2022-12-16
CASH_IN,35191,Agence_mtn_Ouidah,300000,264809,Raymond Simon,176055,211246,2022-12-19
TRANSFER,104216,Michelle de la Daniel,441173,336957,Raymond Simon,211246,315462,2022-12-21
CASH_OUT,240379,Raymond Simon,315462,75083,Agence_mtn_Cotonou,300000,59621,2022-12-22
CASH_OUT,37826,Raymond Simon,75083,37257,Agence_mtn_Abomey,300000,262174,2022-12-23
CASH_IN,29855,Agence_mtn_Abomey,300000,270145,Raymond Simon,37257,67112,2022-12-23
CASH_OUT,32974,Raymond Simon,67112,34138,Agence_mtn_Cotonou,300000,267026,2022-12-23
CASH_IN,197110,Agence_mtn_Cotonou,300000,102890,Raymond Simon,34138,231248,2022-12-24
CASH_IN,294894,Agence_mtn_Cotonou,300000,5106,Raymond Simon,231248,526142,2022-12-25
CASH_IN,169891,Agence_mtn_Abomey,300000,130109,Raymond Simon,526142,696033,2022-12-26
CASH_IN,166984,Agence_mtn_Abomey,300000,133016,Honoré Grégoire-Breton,-178491,-11507,2022-12-01
CASH_IN,274778,Agence_mtn_Abomey,300000,25222,Honoré Grégoire-Breton,-11507,263271,2022-12-01
CASH_OUT,254790,Honoré Grégoire-Breton,263271,8481,Agence_mtn_Cotonou,300000,45210,2022-12-01
TRANSFER,2660,Christophe Teixeira,4442,1782,Honoré Grégoire-Breton,8481,11141,2022-12-02
CASH_IN,17032,Agence_mtn_Abomey,300000,282968,Honoré Grégoire-Breton,11141,28173,2022-12-07
CASH_IN,173757,Agence_mtn_Cotonou,300000,126243,Honoré Grégoire-Breton,28173,201930,2022-12-07
CASH_OUT,118904,Honoré Grégoire-Breton,201930,83026,Agence_mtn_Abomey,300000,181096,2022-12-08
CASH_IN,154951,Agence_mtn_Abomey,300000,145049,Honoré Grégoire-Breton,83026,237977,2022-12-08
CASH_IN,166490,Agence_mtn_Cotonou,300000,133510,Honoré Grégoire-Breton,237977,404467,2022-12-09
CASH_OUT,259659,Honoré Grégoire-Breton,404467,144808,Agence_mtn_Ouidah,300000,40341,2022-12-11
CASH_IN,97089,Agence_mtn_Ouidah,300000,202911,Honoré Grégoire-Breton,144808,241897,2022-12-13
CASH_OUT,217800,Honoré Grégoire-Breton,241897,24097,Agence_mtn_Ouidah,300000,82200,2022-12-14
CASH_OUT,5448,Honoré Grégoire-Breton,24097,18649,Agence_mtn_Ouidah,300000,294552,2022-12-15
CASH_OUT,10708,Honoré Grégoire-Breton,18649,7941,Agence_mtn_Ouidah,300000,289292,2022-12-16
CASH_OUT,2957,Honoré Grégoire-Breton,7941,4984,Agence_mtn_Ouidah,300000,297043,2022-12-16
CASH_OUT,2352,Honoré Grégoire-Breton,4984,2632,Agence_mtn_Abomey,300000,297648,2022-12-17
CASH_OUT,843,Honoré Grégoire-Breton,2632,1789,Agence_mtn_Abomey,300000,299157,2022-12-18
CASH_OUT,341,Honoré Grégoire-Breton,1789,1448,Agence_mtn_Cotonou,300000,299659,2022-12-19
CASH_OUT,1091,Honoré Grégoire-Breton,1448,357,Agence_mtn_Abomey,300000,298909,2022-12-20
TRANSFER,182,Honoré Grégoire-Breton,357,175,Nicole Huet,1767254,1767072,2022-12-20
CASH_IN,39470,Agence_mtn_Abomey,300000,260530,Honoré Grégoire-Breton,175,39645,2022-12-22
CASH_OUT,24864,Honoré Grégoire-Breton,39645,14781,Agence_mtn_Cotonou,300000,275136,2022-12-22
TRANSFER,739488,Aurélie Maury,1103700,364212,Honoré Grégoire-Breton,14781,754269,2022-12-22
TRANSFER,456549,Marcel de la Buisson,1109077,652528,Honoré Grégoire-Breton,754269,1210818,2022-12-23
CASH_IN,175142,Agence_mtn_Ouidah,300000,124858,Honoré Grégoire-Breton,1210818,1385960,2022-12-27
CASH_IN,136376,Agence_mtn_Abomey,300000,163624,Éléonore Marin Le Morel,340300,476676,2022-12-01
CASH_OUT,355047,Éléonore Marin Le Morel,476676,121629,Agence_mtn_Cotonou,300000,-55047,2022-12-02
TRANSFER,101933,Éléonore Marin Le Morel,121629,19696,Roger-Roger Delmas,736900,634967,2022-12-03
CASH_IN,232047,Agence_mtn_Abomey,300000,67953,Éléonore Marin Le Morel,19696,251743,2022-12-05
CASH_IN,29425,Agence_mtn_Cotonou,300000,270575,Éléonore Marin Le Morel,251743,281168,2022-12-05
TRANSFER,93519,Emmanuel Legrand,202600,109081,Éléonore Marin Le Morel,281168,374687,2022-12-05
CASH_OUT,203460,Éléonore Marin Le Morel,374687,171227,Agence_mtn_Abomey,300000,96540,2022-12-06
CASH_IN,277190,Agence_mtn_Abomey,300000,22810,Éléonore Marin Le Morel,171227,448417,2022-12-07
CASH_IN,228467,Agence_mtn_Abomey,300000,71533,Éléonore Marin Le Morel,448417,676884,2022-12-08
CASH_IN,94177,Agence_mtn_Abomey,300000,205823,Éléonore Marin Le Morel,676884,771061,2022-12-10
TRANSFER,492393,Éléonore Marin Le Morel,771061,278668,Jérôme Laporte Le Gauthier,128850,-363543,2022-12-11
CASH_IN,36624,Agence_mtn_Ouidah,300000,263376,Éléonore Marin Le Morel,278668,315292,2022-12-13
CASH_OUT,256475,Éléonore Marin Le Morel,315292,58817,Agence_mtn_Ouidah,300000,43525,2022-12-15
CASH_IN,292363,Agence_mtn_Abomey,300000,7637,Éléonore Marin Le Morel,58817,351180,2022-12-15
TRANSFER,14794,Aurélie Maury,364212,349418,Éléonore Marin Le Morel,351180,365974,2022-12-16
CASH_IN,158607,Agence_mtn_Ouidah,300000,141393,Éléonore Marin Le Morel,365974,524581,2022-12-16
CASH_OUT,503726,Éléonore Marin Le Morel,524581,20855,Agence_mtn_Ouidah,300000,-203726,2022-12-16
CASH_IN,205703,Agence_mtn_Ouidah,300000,94297,Éléonore Marin Le Morel,20855,226558,2022-12-17
CASH_IN,174390,Agence_mtn_Cotonou,300000,125610,Éléonore Marin Le Morel,226558,400948,2022-12-17
TRANSFER,829706,Zacharie Fabre,1752200,922494,Éléonore Marin Le Morel,400948,1230654,2022-12-18
CASH_IN,230692,Agence_mtn_Abomey,300000,69308,Éléonore Marin Le Morel,1230654,1461346,2022-12-20
CASH_OUT,1059174,Éléonore Marin Le Morel,1461346,402172,Agence_mtn_Abomey,300000,-759174,2022-12-21
CASH_IN,216389,Agence_mtn_Cotonou,300000,83611,Éléonore Marin Le Morel,402172,618561,2022-12-25
CASH_IN,203639,Agence_mtn_Abomey,300000,96361,Éléonore Marin Le Morel,618561,822200,2022-12-25
CASH_IN,205385,Agence_mtn_Abomey,300000,94615,Éléonore Marin Le Morel,822200,1027585,2022-12-26
CASH_OUT,7852,Margot Julien,10069,2217,Agence_mtn_Ouidah,300000,292148,2022-12-01
CASH_OUT,2030,Margot Julien,2217,187,Agence_mtn_Cotonou,300000,297970,2022-12-01
CASH_IN,135542,Agence_mtn_Cotonou,300000,164458,Margot Julien,187,135729,2022-12-01
TRANSFER,19016,Margot Julien,135729,116713,Matthieu Cousin,1087300,1068284,2022-12-02
TRANSFER,33794,Margot Julien,116713,82919,Guy-Augustin Pinto,544200,510406,2022-12-02
CASH_OUT,72868,Margot Julien,82919,10051,Agence_mtn_Cotonou,300000,227132,2022-12-04
CASH_IN,76151,Agence_mtn_Abomey,300000,223849,Margot Julien,10051,86202,2022-12-04
CASH_IN,180966,Agence_mtn_Cotonou,300000,119034,Margot Julien,86202,267168,2022-12-06
TRANSFER,100671,Margot Julien,267168,166497,Clémence-Alice Ruiz,105578,4907,2022-12-07
TRANSFER,303001,Josette du Hamon,1049081,746080,Margot Julien,166497,469498,2022-12-07
CASH_IN,236149,Agence_mtn_Abomey,300000,63851,Margot Julien,469498,705647,2022-12-08
TRANSFER,301220,Maurice de Brunet,772200,470980,Margot Julien,705647,1006867,2022-12-09
CASH_IN,239539,Agence_mtn_Ouidah,300000,60461,Margot Julien,1006867,1246406,2022-12-09
CASH_IN,234489,Agence_mtn_Cotonou,300000,65511,Margot Julien,1246406,1480895,2022-12-11
CASH_IN,73130,Agence_mtn_Ouidah,300000,226870,Margot Julien,1480895,1554025,2022-12-13
CASH_OUT,1411877,Margot Julien,1554025,142148,Agence_mtn_Cotonou,300000,-1111877,2022-12-13
CASH_IN,31037,Agence_mtn_Ouidah,300000,268963,Margot Julien,142148,173185,2022-12-13
TRANSFER,464921,Hélène Alexandre de la Samson,1422600,957679,Margot Julien,173185,638106,2022-12-14
TRANSFER,456390,Valérie de Pottier,598400,142010,Margot Julien,638106,1094496,2022-12-15
TRANSFER,345026,Margot Julien,1094496,749470,Thibault Martin,18300,-326726,2022-12-16
CASH_OUT,466545,Margot Julien,749470,282925,Agence_mtn_Cotonou,300000,-166545,2022-12-16
TRANSFER,199585,Margot Julien,282925,83340,Christophe Teixeira,1782,-197803,2022-12-17
CASH_OUT,56255,Margot Julien,83340,27085,Agence_mtn_Ouidah,300000,243745,2022-12-17
CASH_OUT,19941,Margot Julien,27085,7144,Agence_mtn_Abomey,300000,280059,2022-12-19
CASH_IN,102044,Agence_mtn_Cotonou,300000,197956,Margot Julien,7144,109188,2022-12-22
TRANSFER,95173,Margot Julien,109188,14015,Guillaume de la Nguyen,478724,383551,2022-12-24
TRANSFER,12598,Margot Julien,14015,1417,Marine Labbé,56612,44014,2022-12-25
TRANSFER,103,Margot Julien,1417,1314,Pénélope Boulay,1839400,1839297,2022-12-26
CASH_OUT,1002,Margot Julien,1314,312,Agence_mtn_Cotonou,300000,298998,2022-12-27
TRANSFER,2232,Clémence-Alice Ruiz,4907,2675,Zacharie Fabre,922494,920262,2022-12-01
TRANSFER,2093,Clémence-Alice Ruiz,2675,582,Danielle-Henriette Tessier,136229,134136,2022-12-02
TRANSFER,164,Clémence-Alice Ruiz,582,418,Julien Devaux,144818,144654,2022-12-03
CASH_IN,209532,Agence_mtn_Cotonou,300000,90468,Clémence-Alice Ruiz,418,209950,2022-12-05
TRANSFER,569734,Corinne Roussel,1754400,1184666,Clémence-Alice Ruiz,209950,779684,2022-12-08
CASH_IN,299781,Agence_mtn_Ouidah,300000,219,Clémence-Alice Ruiz,779684,1079465,2022-12-09
CASH_OUT,77791,Clémence-Alice Ruiz,1079465,1001674,Agence_mtn_Cotonou,300000,222209,2022-12-10
CASH_OUT,581396,Clémence-Alice Ruiz,1001674,420278,Agence_mtn_Abomey,300000,-281396,2022-12-10
TRANSFER,222288,Matthieu Cousin,1068284,845996,Clémence-Alice Ruiz,420278,642566,2022-12-12
CASH_OUT,617435,Clémence-Alice Ruiz,642566,25131,Agence_mtn_Abomey,300000,-317435,2022-12-13
TRANSFER,88581,Guy-Augustin Pinto,510406,421825,Clémence-Alice Ruiz,25131,113712,2022-12-14
CASH_IN,186687,Agence_mtn_Ouidah,300000,113313,Clémence-Alice Ruiz,113712,300399,2022-12-18
TRANSFER,263374,Clémence-Alice Ruiz,300399,37025,Simone du Allard,1494510,1231136,2022-12-19
CASH_OUT,25176,Clémence-Alice Ruiz,37025,11849,Agence_mtn_Cotonou,300000,274824,2022-12-20
CASH_IN,203805,Agence_mtn_Ouidah,300000,96195,Clémence-Alice Ruiz,11849,215654,2022-12-20
CASH_OUT,23369,Clémence-Alice Ruiz,215654,192285,Agence_mtn_Cotonou,300000,276631,2022-12-21
CASH_IN,61244,Agence_mtn_Abomey,300000,238756,Clémence-Alice Ruiz,192285,253529,2022-12-22
CASH_OUT,67380,Clémence-Alice Ruiz,253529,186149,Agence_mtn_Cotonou,300000,232620,2022-12-22
CASH_IN,104887,Agence_mtn_Abomey,300000,195113,Clémence-Alice Ruiz,186149,291036,2022-12-23
TRANSFER,501398,Marc Costa-Daniel,1031600,530202,Clémence-Alice Ruiz,291036,792434,2022-12-24
CASH_OUT,522590,Clémence-Alice Ruiz,792434,269844,Agence_mtn_Ouidah,300000,-222590,2022-12-27
CASH_OUT,236456,Clémence-Alice Ruiz,269844,33388,Agence_mtn_Abomey,300000,63544,2022-12-27
CASH_IN,43722,Agence_mtn_Ouidah,300000,256278,Christine Rossi,68800,112522,2022-12-02
TRANSFER,129593,Josette du Hamon,746080,616487,Christine Rossi,112522,242115,2022-12-04
CASH_OUT,51830,Christine Rossi,242115,190285,Agence_mtn_Cotonou,300000,248170,2022-12-05
CASH_OUT,69748,Christine Rossi,190285,120537,Agence_mtn_Abomey,300000,230252,2022-12-06
CASH_OUT,65374,Christine Rossi,120537,55163,Agence_mtn_Abomey,300000,234626,2022-12-06
CASH_OUT,1045,Christine Rossi,55163,54118,Agence_mtn_Abomey,300000,298955,2022-12-08
CASH_OUT,33467,Christine Rossi,54118,20651,Agence_mtn_Cotonou,300000,266533,2022-12-09
CASH_OUT,18199,Christine Rossi,20651,2452,Agence_mtn_Cotonou,300000,281801,2022-12-09
TRANSFER,1261,Christine Rossi,2452,1191,Guillaume de la Nguyen,383551,382290,2022-12-13
CASH_OUT,723,Christine Rossi,1191,468,Agence_mtn_Ouidah,300000,299277,2022-12-13
TRANSFER,375,Christine Rossi,468,93,Sébastien Coste,1157600,1157225,2022-12-16
CASH_IN,283293,Agence_mtn_Cotonou,300000,16707,Christine Rossi,93,283386,2022-12-16
CASH_OUT,274534,Christine Rossi,283386,8852,Agence_mtn_Abomey,300000,25466,2022-12-18
CASH_IN,246901,Agence_mtn_Abomey,300000,53099,Christine Rossi,8852,255753,2022-12-19
CASH_IN,65987,Agence_mtn_Abomey,300000,234013,Christine Rossi,255753,321740,2022-12-20
CASH_OUT,102842,Christine Rossi,321740,218898,Agence_mtn_Cotonou,300000,197158,2022-12-22
CASH_IN,260557,Agence_mtn_Ouidah,300000,39443,Christine Rossi,218898,479455,2022-12-22
TRANSFER,454535,Thibault-Julien Chevallier,584754,130219,Christine Rossi,479455,933990,2022-12-24
TRANSFER,789210,Nicole-Renée Gay,958500,169290,Christine Rossi,933990,1723200,2022-12-24
CASH_OUT,1719379,Christine Rossi,1723200,3821,Agence_mtn_Ouidah,300000,-1419379,2022-12-25
TRANSFER,1387,Christine Rossi,3821,2434,Danielle-Henriette Tessier,134136,132749,2022-12-26
CASH_OUT,784909,Gérard Cordier,948800,163891,Agence_mtn_Abomey,300000,-484909,2022-12-01
CASH_OUT,88846,Gérard Cordier,163891,75045,Agence_mtn_Cotonou,300000,211154,2022-12-03
CASH_IN,118209,Agence_mtn_Ouidah,300000,181791,Gérard Cordier,75045,193254,2022-12-04
TRANSFER,849468,Madeleine Hardy,1380300,530832,Gérard Cordier,193254,1042722,2022-12-04
TRANSFER,1189445,Robert Henry-Poulain,1343900,154455,Gérard Cordier,1042722,2232167,2022-12-06
TRANSFER,1627500,Gérard Cordier,2232167,604667,Françoise Denis de Allard,326100,-1301400,2022-12-09
CASH_OUT,390415,Gérard Cordier,604667,214252,Agence_mtn_Abomey,300000,-90415,2022-12-11
CASH_OUT,154162,Gérard Cordier,214252,60090,Agence_mtn_Ouidah,300000,145838,2022-12-13
CASH_IN,41216,Agence_mtn_Ouidah,300000,258784,Gérard Cordier,60090,101306,2022-12-14
CASH_IN,126161,Agence_mtn_Abomey,300000,173839,Gérard Cordier,101306,227467,2022-12-14
TRANSFER,219217,Aurélie Maury,349418,130201,Gérard Cordier,227467,446684,2022-12-15
CASH_IN,238362,Agence_mtn_Ouidah,300000,61638,Gérard Cordier,446684,685046,2022-12-16
CASH_OUT,75391,Gérard Cordier,685046,609655,Agence_mtn_Abomey,300000,224609,2022-12-18
CASH_OUT,289561,Gérard Cordier,609655,320094,Agence_mtn_Cotonou,300000,10439,2022-12-18
CASH_IN,231175,Agence_mtn_Abomey,300000,68825,Gérard Cordier,320094,551269,2022-12-18
TRANSFER,561790,Roger-Roger Delmas,634967,73177,Gérard Cordier,551269,1113059,2022-12-19
CASH_OUT,121411,Gérard Cordier,1113059,991648,Agence_mtn_Ouidah,300000,178589,2022-12-19
TRANSFER,103951,Thibault-Julien Chevallier,130219,26268,Gérard Cordier,991648,1095599,2022-12-20
CASH_OUT,522880,Gérard Cordier,1095599,572719,Agence_mtn_Cotonou,300000,-222880,2022-12-20
CASH_IN,268897,Agence_mtn_Cotonou,300000,31103,Gérard Cordier,572719,841616,2022-12-22
CASH_OUT,464950,Gérard Cordier,841616,376666,Agence_mtn_Cotonou,300000,-164950,2022-12-22
TRANSFER,134856,Michelle de la Daniel,336957,202101,Gérard Cordier,376666,511522,2022-12-24
CASH_IN,1080,Agence_mtn_Ouidah,300000,298920,Gérard Cordier,511522,512602,2022-12-24
CASH_OUT,431743,Gérard Cordier,512602,80859,Agence_mtn_Abomey,300000,-131743,2022-12-25
TRANSFER,160926,Julie Germain Le Vaillant,242595,81669,Gérard Cordier,80859,241785,2022-12-25
CASH_IN,103377,Agence_mtn_Abomey,300000,196623,Gérard Cordier,241785,345162,2022-12-25
TRANSFER,253069,Gérard Cordier,345162,92093,Jacques Marchand,1047718,794649,2022-12-25
CASH_OUT,22669,Gérard Cordier,92093,69424,Agence_mtn_Cotonou,300000,277331,2022-12-25
CASH_IN,91996,Agence_mtn_Ouidah,300000,208004,Gérard Cordier,69424,161420,2022-12-26
CASH_IN,207502,Agence_mtn_Abomey,300000,92498,Clémence Dufour,-26970,180532,2022-12-01
CASH_OUT,56203,Clémence Dufour,180532,124329,Agence_mtn_Abomey,300000,243797,2022-12-01
CASH_IN,186856,Agence_mtn_Abomey,300000,113144,Clémence Dufour,124329,311185,2022-12-02
CASH_OUT,117779,Clémence Dufour,311185,193406,Agence_mtn_Cotonou,300000,182221,2022-12-02
CASH_OUT,69645,Clémence Dufour,193406,123761,Agence_mtn_Ouidah,300000,230355,2022-12-08
TRANSFER,61872,Raymond-Yves Boulanger,261600,199728,Clémence Dufour,123761,185633,2022-12-08
CASH_IN,126491,Agence_mtn_Cotonou,300000,173509,Clémence Dufour,185633,312124,2022-12-13
TRANSFER,408209,Sylvie Dupré,1168152,759943,Clémence Dufour,312124,720333,2022-12-14
CASH_IN,100378,Agence_mtn_Abomey,300000,199622,Clémence Dufour,720333,820711,2022-12-14
TRANSFER,235387,Clémence Dufour,820711,585324,Marthe Perrin,1769392,1534005,2022-12-15
CASH_OUT,415084,Clémence Dufour,585324,170240,Agence_mtn_Ouidah,300000,-115084,2022-12-15
TRANSFER,91696,Julien Devaux,144654,52958,Clémence Dufour,170240,261936,2022-12-17
CASH_IN,60089,Agence_mtn_Cotonou,300000,239911,Clémence Dufour,261936,322025,2022-12-18
CASH_OUT,132603,Clémence Dufour,322025,189422,Agence_mtn_Ouidah,300000,167397,2022-12-18
CASH_OUT,103670,Clémence Dufour,189422,85752,Agence_mtn_Ouidah,300000,196330,2022-12-19
CASH_OUT,75957,Clémence Dufour,85752,9795,Agence_mtn_Ouidah,300000,224043,2022-12-20
CASH_OUT,2355,Clémence Dufour,9795,7440,Agence_mtn_Cotonou,300000,297645,2022-12-21
CASH_IN,287663,Agence_mtn_Cotonou,300000,12337,Clémence Dufour,7440,295103,2022-12-22
TRANSFER,102078,Robert Henry-Poulain,154455,52377,Clémence Dufour,295103,397181,2022-12-25
CASH_IN,246402,Agence_mtn_Cotonou,300000,53598,Clémence Dufour,397181,643583,2022-12-25
CASH_OUT,453421,Clémence Dufour,643583,190162,Agence_mtn_Ouidah,300000,-153421,2022-12-27
CASH_OUT,119734,Michelle de la Daniel,202101,82367,Agence_mtn_Abomey,300000,180266,2022-12-02
CASH_IN,231573,Agence_mtn_Ouidah,300000,68427,Michelle de la Daniel,82367,313940,2022-12-03
TRANSFER,17896,Thibault-Julien Chevallier,26268,8372,Michelle de la Daniel,313940,331836,2022-12-03
CASH_OUT,206494,Michelle de la Daniel,331836,125342,Agence_mtn_Cotonou,300000,93506,2022-12-03
TRANSFER,45108,Michelle de la Daniel,125342,80234,Gérard Blot de Blanc,1719200,1674092,2022-12-04
CASH_IN,114256,Agence_mtn_Cotonou,300000,185744,Michelle de la Daniel,80234,194490,2022-12-05
CASH_OUT,7967,Michelle de la Daniel,194490,186523,Agence_mtn_Abomey,300000,292033,2022-12-07
TRANSFER,122615,Hélène Alexandre de la Samson,957679,835064,Michelle de la Daniel,186523,309138,2022-12-10
TRANSFER,52756,Michelle de la Daniel,309138,256382,Élisabeth Blot-Bruneau,7521,-45235,2022-12-11
TRANSFER,942882,Corinne Roussel,1184666,241784,Michelle de la Daniel,256382,1199264,2022-12-11
CASH_OUT,524757,Michelle de la Daniel,1199264,674507,Agence_mtn_Ouidah,300000,-224757,2022-12-13
CASH_IN,68730,Agence_mtn_Ouidah,300000,231270,Michelle de la Daniel,674507,743237,2022-12-15
CASH_IN,142072,Agence_mtn_Ouidah,300000,157928,Michelle de la Daniel,743237,885309,2022-12-15
CASH_IN,124182,Agence_mtn_Abomey,300000,175818,Michelle de la Daniel,885309,1009491,2022-12-15
CASH_OUT,865766,Michelle de la Daniel,1009491,143725,Agence_mtn_Ouidah,300000,-565766,2022-12-16
CASH_IN,74691,Agence_mtn_Abomey,300000,225309,Michelle de la Daniel,143725,218416,2022-12-16
TRANSFER,13299,Michelle de la Daniel,218416,205117,Nathalie Da Silva,700135,686836,2022-12-17
CASH_IN,25755,Agence_mtn_Abomey,300000,274245,Michelle de la Daniel,205117,230872,2022-12-18
TRANSFER,55331,Michelle de la Daniel,230872,175541,Guy-Augustin Pinto,421825,366494,2022-12-19
TRANSFER,55336,Michelle de la Daniel,175541,120205,Michelle de la Daniel,175541,230877,2022-12-22
TRANSFER,63761,Michelle de la Daniel,120205,56444,Hélène Blanchard-Renault,841200,777439,2022-12-22
CASH_IN,103675,Agence_mtn_Cotonou,300000,196325,Michelle de la Daniel,56444,160119,2022-12-23
TRANSFER,135894,François Vaillant,196600,60706,Michelle de la Daniel,160119,296013,2022-12-23
TRANSFER,336439,Guy-Augustin Pinto,366494,30055,Michelle de la Daniel,296013,632452,2022-12-24
CASH_OUT,14813,Michelle de la Daniel,632452,617639,Agence_mtn_Abomey,300000,285187,2022-12-24
TRANSFER,608224,Maggie Barbier,1877400,1269176,Michelle de la Daniel,617639,1225863,2022-12-25
CASH_IN,224585,Agence_mtn_Ouidah,300000,75415,Thibault-Julien Chevallier,8372,232957,2022-12-03
CASH_IN,235903,Agence_mtn_Abomey,300000,64097,Thibault-Julien Chevallier,232957,468860,2022-12-03
CASH_OUT,309720,Thibault-Julien Chevallier,468860,159140,Agence_mtn_Ouidah,300000,-9720,2022-12-06
CASH_OUT,79194,Thibault-Julien Chevallier,159140,79946,Agence_mtn_Abomey,300000,220806,2022-12-06
CASH_OUT,62251,Thibault-Julien Chevallier,79946,17695,Agence_mtn_Abomey,300000,237749,2022-12-07
TRANSFER,17640,Thibault-Julien Chevallier,17695,55,Jacques Laporte de Blanchet,565278,547638,2022-12-08
CASH_IN,254673,Agence_mtn_Ouidah,300000,45327,Thibault-Julien Chevallier,55,254728,2022-12-10
CASH_OUT,195820,Thibault-Julien Chevallier,254728,58908,Agence_mtn_Cotonou,300000,104180,2022-12-11
TRANSFER,160123,Guillaume de la Nguyen,382290,222167,Thibault-Julien Chevallier,58908,219031,2022-12-13
TRANSFER,198478,Thibault-Julien Chevallier,219031,20553,Valérie de Pottier,142010,-56468,2022-12-14
TRANSFER,639337,Nathalie Da Silva,686836,47499,Thibault-Julien Chevallier,20553,659890,2022-12-14
CASH_OUT,459302,Thibault-Julien Chevallier,659890,200588,Agence_mtn_Cotonou,300000,-159302,2022-12-14
TRANSFER,5379,Julien Devaux,52958,47579,Thibault-Julien Chevallier,200588,205967,2022-12-15
CASH_OUT,198040,Thibault-Julien Chevallier,205967,7927,Agence_mtn_Ouidah,300000,101960,2022-12-16
TRANSFER,6871,Thibault-Julien Chevallier,7927,1056,Charles Guérin,1766300,1759429,2022-12-16
CASH_OUT,641,Thibault-Julien Chevallier,1056,415,Agence_mtn_Ouidah,300000,299359,2022-12-16
CASH_IN,12287,Agence_mtn_Abomey,300000,287713,Thibault-Julien Chevallier,415,12702,2022-12-17
TRANSFER,386089,Charles Guérin,1759429,1373340,Thibault-Julien Chevallier,12702,398791,2022-12-17
CASH_IN,156120,Agence_mtn_Ouidah,300000,143880,Thibault-Julien Chevallier,398791,554911,2022-12-18
TRANSFER,501651,Élisabeth Delattre,679400,177749,Thibault-Julien Chevallier,554911,1056562,2022-12-21
CASH_OUT,878252,Thibault-Julien Chevallier,1056562,178310,Agence_mtn_Ouidah,300000,-578252,2022-12-22
TRANSFER,81562,Thibault-Julien Chevallier,178310,96748,Simone du Allard,1231136,1149574,2022-12-24
TRANSFER,1494171,Nicole Huet,1767072,272901,Thibault-Julien Chevallier,96748,1590919,2022-12-26
TRANSFER,1377969,Thibault-Julien Chevallier,1590919,212950,Robert Henry-Poulain,52377,-1325592,2022-12-27
CASH_IN,84591,Agence_mtn_Cotonou,300000,215409,Élisabeth Delattre,177749,262340,2022-12-01
CASH_IN,179031,Agence_mtn_Abomey,300000,120969,Élisabeth Delattre,262340,441371,2022-12-04
CASH_IN,115549,Agence_mtn_Abomey,300000,184451,Élisabeth Delattre,441371,556920,2022-12-04
CASH_IN,76013,Agence_mtn_Ouidah,300000,223987,Élisabeth Delattre,556920,632933,2022-12-07
CASH_IN,122783,Agence_mtn_Cotonou,300000,177217,Élisabeth Delattre,632933,755716,2022-12-09
CASH_OUT,118211,Élisabeth Delattre,755716,637505,Agence_mtn_Cotonou,300000,181789,2022-12-10
CASH_OUT,274965,Élisabeth Delattre,637505,362540,Agence_mtn_Abomey,300000,25035,2022-12-12
CASH_OUT,86783,Élisabeth Delattre,362540,275757,Agence_mtn_Cotonou,300000,213217,2022-12-13
CASH_IN,54957,Agence_mtn_Cotonou,300000,245043,Élisabeth Delattre,275757,330714,2022-12-14
CASH_OUT,245453,Élisabeth Delattre,330714,85261,Agence_mtn_Abomey,300000,54547,2022-12-16
TRANSFER,55931,Augustin-Jérôme Merle,821300,765369,Élisabeth Delattre,85261,141192,2022-12-18
CASH_OUT,109342,Élisabeth Delattre,141192,31850,Agence_mtn_Cotonou,300000,190658,2022-12-18
CASH_IN,46973,Agence_mtn_Cotonou,300000,253027,Élisabeth Delattre,31850,78823,2022-12-19
TRANSFER,76319,Nicole-Renée Gay,169290,92971,Élisabeth Delattre,78823,155142,2022-12-19
CASH_OUT,115347,Élisabeth Delattre,155142,39795,Agence_mtn_Cotonou,300000,184653,2022-12-19
CASH_IN,35196,Agence_mtn_Ouidah,300000,264804,Élisabeth Delattre,39795,74991,2022-12-20
CASH_IN,147809,Agence_mtn_Ouidah,300000,152191,Élisabeth Delattre,74991,222800,2022-12-20
TRANSFER,198069,Nicole Huet,272901,74832,Élisabeth Delattre,222800,420869,2022-12-22
TRANSFER,254982,Élisabeth Delattre,420869,165887,Élisabeth Delattre,420869,675851,2022-12-23
CASH_IN,86132,Agence_mtn_Abomey,300000,213868,Élisabeth Delattre,165887,252019,2022-12-23
TRANSFER,635855,Céline-Inès Meunier,1732900,1097045,Élisabeth Delattre,252019,887874,2022-12-26
CASH_IN,279071,Agence_mtn_Cotonou,300000,20929,Valérie de Pottier,-56468,222603,2022-12-02
CASH_OUT,77274,Valérie de Pottier,222603,145329,Agence_mtn_Ouidah,300000,222726,2022-12-02
CASH_OUT,53392,Valérie de Pottier,145329,91937,Agence_mtn_Cotonou,300000,246608,2022-12-03
CASH_IN,55358,Agence_mtn_Abomey,300000,244642,Valérie de Pottier,91937,147295,2022-12-04
CASH_OUT,111891,Valérie de Pottier,147295,35404,Agence_mtn_Cotonou,300000,188109,2022-12-07
CASH_IN,106539,Agence_mtn_Cotonou,300000,193461,Valérie de Pottier,35404,141943,2022-12-07
CASH_OUT,131687,Valérie de Pottier,141943,10256,Agence_mtn_Abomey,300000,168313,2022-12-10
TRANSFER,8677,Valérie de Pottier,10256,1579,François Vaillant,60706,52029,2022-12-10
TRANSFER,1388,Valérie de Pottier,1579,191,Marcel de la Buisson,652528,651140,2022-12-10
CASH_OUT,168,Valérie de Pottier,191,23,Agence_mtn_Cotonou,300000,299832,2022-12-13
CASH_IN,221915,Agence_mtn_Abomey,300000,78085,Valérie de Pottier,23,221938,2022-12-13
CASH_IN,197096,Agence_mtn_Ouidah,300000,102904,Valérie de Pottier,221938,419034,2022-12-14
CASH_OUT,5328,Valérie de Pottier,419034,413706,Agence_mtn_Cotonou,300000,294672,2022-12-14
CASH_IN,24241,Agence_mtn_Ouidah,300000,275759,Valérie de Pottier,413706,437947,2022-12-15
CASH_IN,275984,Agence_mtn_Abomey,300000,24016,Valérie de Pottier,437947,713931,2022-12-15
TRANSFER,1072554,Céline-Inès Meunier,1097045,24491,Valérie de Pottier,713931,1786485,2022-12-18
TRANSFER,1055756,Valérie de Pottier,1786485,730729,Emmanuel Vallée,295655,-760101,2022-12-18
CASH_OUT,443917,Valérie de Pottier,730729,286812,Agence_mtn_Abomey,300000,-143917,2022-12-20
CASH_IN,29522,Agence_mtn_Abomey,300000,270478,Valérie de Pottier,286812,316334,2022-12-20
TRANSFER,240012,Valérie de Pottier,316334,76322,Hélène Alexandre de la Samson,835064,595052,2022-12-20
TRANSFER,31951,Nicole Huet,74832,42881,Valérie de Pottier,76322,108273,2022-12-21
CASH_IN,227427,Agence_mtn_Ouidah,300000,72573,Valérie de Pottier,108273,335700,2022-12-22
TRANSFER,250702,Valérie de Pottier,335700,84998,Julien Devaux,47579,-203123,2022-12-24
TRANSFER,708398,Christophe Besnard-Diaz,929500,221102,Valérie de Pottier,84998,793396,2022-12-25
CASH_OUT,636149,Valérie de Pottier,793396,157247,Agence_mtn_Ouidah,300000,-336149,2022-12-26
TRANSFER,150528,Valérie de Pottier,157247,6719,Nicole Huet,42881,-107647,2022-12-26
CASH_IN,20060,Agence_mtn_Cotonou,300000,279940,Robert Henry-Poulain,-1325592,-1305532,2022-12-01
CASH_IN,2524,Agence_mtn_Ouidah,300000,297476,Robert Henry-Poulain,-1305532,-1303008,2022-12-02
CASH_IN,97345,Agence_mtn_Cotonou,300000,202655,Robert Henry-Poulain,-1303008,-1205663,2022-12-02
CASH_IN,2616,Agence_mtn_Ouidah,300000,297384,Robert Henry-Poulain,-1205663,-1203047,2022-12-03
CASH_IN,13162,Agence_mtn_Ouidah,300000,286838,Robert Henry-Poulain,-1203047,-1189885,2022-12-04
CASH_IN,147020,Agence_mtn_Abomey,300000,152980,Robert Henry-Poulain,-1189885,-1042865,2022-12-06
CASH_IN,272313,Agence_mtn_Abomey,300000,27687,Robert Henry-Poulain,-1042865,-770552,2022-12-07
CASH_IN,181569,Agence_mtn_Abomey,300000,118431,Robert Henry-Poulain,-770552,-588983,2022-12-07
CASH_IN,31951,Agence_mtn_Ouidah,300000,268049,Robert Henry-Poulain,-588983,-557032,2022-12-08
CASH_IN,276929,Agence_mtn_Ouidah,300000,23071,Robert Henry-Poulain,-557032,-280103,2022-12-09
CASH_IN,136954,Agence_mtn_Cotonou,300000,163046,Robert Henry-Poulain,-280103,-143149,2022-12-10
CASH_IN,261180,Agence_mtn_Abomey,300000,38820,Robert Henry-Poulain,-143149,118031,2022-12-10
CASH_OUT,65994,Robert Henry-Poulain,118031,52037,Agence_mtn_Abomey,300000,234006,2022-12-11
CASH_IN,59740,Agence_mtn_Ouidah,300000,240260,Robert Henry-Poulain,52037,111777,2022-12-12
CASH_IN,38395,Agence_mtn_Cotonou,300000,261605,Robert Henry-Poulain,111777,150172,2022-12-15
CASH_IN,286700,Agence_mtn_Ouidah,300000,13300,Robert Henry-Poulain,150172,436872,2022-12-15
TRANSFER,425999,Robert Henry-Poulain,436872,10873,Madeleine Hardy,530832,104833,2022-12-15
TRANSFER,9324,Robert Henry-Poulain,10873,1549,Marc Costa-Daniel,530202,520878,2022-12-15
TRANSFER,1334,Robert Henry-Poulain,1549,215,Raymond-Yves Boulanger,199728,198394,2022-12-20
TRANSFER,657810,Aimé Bernier,1229100,571290,Robert Henry-Poulain,215,658025,2022-12-20
TRANSFER,65045,Robert Henry-Poulain,658025,592980,Alexandre Blanchard,1398375,1333330,2022-12-21
CASH_OUT,313714,Robert Henry-Poulain,592980,279266,Agence_mtn_Cotonou,300000,-13714,2022-12-22
CASH_IN,148677,Agence_mtn_Abomey,300000,151323,Robert Henry-Poulain,279266,427943,2022-12-22
CASH_OUT,389336,Robert Henry-Poulain,427943,38607,Agence_mtn_Ouidah,300000,-89336,2022-12-22
CASH_OUT,34681,Robert Henry-Poulain,38607,3926,Agence_mtn_Cotonou,300000,265319,2022-12-23
CASH_IN,137151,Agence_mtn_Abomey,300000,162849,Robert Henry-Poulain,3926,141077,2022-12-23
TRANSFER,552708,Marthe Perrin,1534005,981297,Robert Henry-Poulain,141077,693785,2022-12-23
TRANSFER,3033,Nathalie Da Silva,47499,44466,Hélène Blanchard-Renault,777439,780472,2022-12-01
CASH_OUT,62281,Hélène Blanchard-Renault,780472,718191,Agence_mtn_Abomey,300000,237719,2022-12-02
CASH_IN,3099,Agence_mtn_Abomey,300000,296901,Hélène Blanchard-Renault,718191,721290,2022-12-08
CASH_OUT,452720,Hélène Blanchard-Renault,721290,268570,Agence_mtn_Cotonou,300000,-152720,2022-12-09
TRANSFER,13731,Charles Guérin,1373340,1359609,Hélène Blanchard-Renault,268570,282301,2022-12-09
CASH_IN,168626,Agence_mtn_Ouidah,300000,131374,Hélène Blanchard-Renault,282301,450927,2022-12-10
CASH_IN,24474,Agence_mtn_Abomey,300000,275526,Hélène Blanchard-Renault,450927,475401,2022-12-11
CASH_IN,52266,Agence_mtn_Cotonou,300000,247734,Hélène Blanchard-Renault,475401,527667,2022-12-11
CASH_OUT,423655,Hélène Blanchard-Renault,527667,104012,Agence_mtn_Ouidah,300000,-123655,2022-12-12
CASH_IN,144397,Agence_mtn_Abomey,300000,155603,Hélène Blanchard-Renault,104012,248409,2022-12-12
CASH_OUT,62965,Hélène Blanchard-Renault,248409,185444,Agence_mtn_Ouidah,300000,237035,2022-12-13
CASH_OUT,54534,Hélène Blanchard-Renault,185444,130910,Agence_mtn_Ouidah,300000,245466,2022-12-13
TRANSFER,2568,Marine Labbé,44014,41446,Hélène Blanchard-Renault,130910,133478,2022-12-13
CASH_IN,267590,Agence_mtn_Cotonou,300000,32410,Hélène Blanchard-Renault,133478,401068,2022-12-13
CASH_OUT,110325,Hélène Blanchard-Renault,401068,290743,Agence_mtn_Cotonou,300000,189675,2022-12-13
CASH_IN,239406,Agence_mtn_Abomey,300000,60594,Hélène Blanchard-Renault,290743,530149,2022-12-15
CASH_IN,66288,Agence_mtn_Cotonou,300000,233712,Hélène Blanchard-Renault,530149,596437,2022-12-16
CASH_IN,256772,Agence_mtn_Cotonou,300000,43228,Hélène Blanchard-Renault,596437,853209,2022-12-18
CASH_OUT,449666,Hélène Blanchard-Renault,853209,403543,Agence_mtn_Ouidah,300000,-149666,2022-12-19
CASH_IN,64553,Agence_mtn_Cotonou,300000,235447,Hélène Blanchard-Renault,403543,468096,2022-12-20
CASH_OUT,369740,Hélène Blanchard-Renault,468096,98356,Agence_mtn_Cotonou,300000,-69740,2022-12-20
TRANSFER,9016,Hélène Blanchard-Renault,98356,89340,Jules-Marc Chauvet,668500,659484,2022-12-21
CASH_OUT,6560,Hélène Blanchard-Renault,89340,82780,Agence_mtn_Cotonou,300000,293440,2022-12-22
TRANSFER,51217,Hélène Blanchard-Renault,82780,31563,Guillaume de la Nguyen,222167,170950,2022-12-24
TRANSFER,8935,Hélène Blanchard-Renault,31563,22628,Jacques Laporte de Blanchet,547638,538703,2022-12-24
TRANSFER,5745,Hélène Blanchard-Renault,22628,16883,Michèle Faivre,1599400,1593655,2022-12-26
CASH_IN,71548,Agence_mtn_Cotonou,300000,228452,Hélène Blanchard-Renault,16883,88431,2022-12-26
TRANSFER,44066,Hélène Blanchard-Renault,88431,44365,Guillaume de la Nguyen,170950,126884,2022-12-26
CASH_IN,94381,Agence_mtn_Abomey,300000,205619,Hélène Blanchard-Renault,44365,138746,2022-12-27
CASH_IN,188310,Agence_mtn_Ouidah,300000,111690,Hélène Blanchard-Renault,138746,327056,2022-12-27
CASH_IN,186168,Agence_mtn_Abomey,300000,113832,Maryse Delorme,-49533,136635,2022-12-01
TRANSFER,55748,Maryse Delorme,136635,80887,Henri de Didier,550899,495151,2022-12-02
CASH_IN,149151,Agence_mtn_Abomey,300000,150849,Maryse Delorme,80887,230038,2022-12-02
CASH_IN,119164,Agence_mtn_Ouidah,300000,180836,Maryse Delorme,230038,349202,2022-12-03
CASH_OUT,143075,Maryse Delorme,349202,206127,Agence_mtn_Ouidah,300000,156925,2022-12-04
CASH_OUT,171022,Maryse Delorme,206127,35105,Agence_mtn_Ouidah,300000,128978,2022-12-04
TRANSFER,21401,Céline-Inès Meunier,24491,3090,Maryse Delorme,35105,56506,2022-12-05
CASH_IN,291572,Agence_mtn_Abomey,300000,8428,Maryse Delorme,56506,348078,2022-12-07
TRANSFER,179905,Raymond de Le Roux,191444,11539,Maryse Delorme,348078,527983,2022-12-07
TRANSFER,297967,Maryse Delorme,527983,230016,Jacques Marchand,794649,496682,2022-12-07
TRANSFER,198692,Maryse Delorme,230016,31324,Aurélie Maury,130201,-68491,2022-12-09
TRANSFER,6514,Maryse Delorme,31324,24810,Zacharie Fabre,920262,913748,2022-12-09
CASH_OUT,1990,Maryse Delorme,24810,22820,Agence_mtn_Abomey,300000,298010,2022-12-09
CASH_IN,279410,Agence_mtn_Abomey,300000,20590,Maryse Delorme,22820,302230,2022-12-12
CASH_OUT,262647,Maryse Delorme,302230,39583,Agence_mtn_Ouidah,300000,37353,2022-12-12
TRANSFER,616113,Sylvie Dupré,759943,143830,Maryse Delorme,39583,655696,2022-12-13
CASH_IN,166411,Agence_mtn_Abomey,300000,133589,Maryse Delorme,655696,822107,2022-12-15
CASH_OUT,339712,Maryse Delorme,822107,482395,Agence_mtn_Cotonou,300000,-39712,2022-12-15
CASH_OUT,22542,Maryse Delorme,482395,459853,Agence_mtn_Cotonou,300000,277458,2022-12-16
CASH_IN,215609,Agence_mtn_Cotonou,300000,84391,Maryse Delorme,459853,675462,2022-12-16
TRANSFER,63305,Maryse Delorme,675462,612157,Danielle-Henriette Tessier,132749,69444,2022-12-16
TRANSFER,526764,Hélène Alexandre de la Samson,595052,68288,Maryse Delorme,612157,1138921,2022-12-19
TRANSFER,1056175,Charles Guérin,1359609,303434,Maryse Delorme,1138921,2195096,2022-12-21
TRANSFER,1804501,Maryse Delorme,2195096,390595,Maurice de Brunet,470980,-1333521,2022-12-21
CASH_OUT,111,Maryse Delorme,390595,390484,Agence_mtn_Abomey,300000,299889,2022-12-23
TRANSFER,33607,Maryse Delorme,390484,356877,François Vaillant,52029,18422,2022-12-23
TRANSFER,14138,Nathalie Da Silva,44466,30328,Maryse Delorme,356877,371015,2022-12-25
TRANSFER,251669,Marc Costa-Daniel,520878,269209,Maryse Delorme,371015,622684,2022-12-25
TRANSFER,434060,Josette du Hamon,616487,182427,Maryse Delorme,622684,1056744,2022-12-27
CASH_OUT,37230,Hélène Alexandre de la Samson,68288,31058,Agence_mtn_Ouidah,300000,262770,2022-12-06
CASH_IN,156369,Agence_mtn_Cotonou,300000,143631,Hélène Alexandre de la Samson,31058,187427,2022-12-06
CASH_OUT,175978,Hélène Alexandre de la Samson,187427,11449,Agence_mtn_Abomey,300000,124022,2022-12-06
CASH_IN,254300,Agence_mtn_Abomey,300000,45700,Hélène Alexandre de la Samson,11449,265749,2022-12-08
CASH_OUT,258596,Hélène Alexandre de la Samson,265749,7153,Agence_mtn_Cotonou,300000,41404,2022-12-09
TRANSFER,26558,Matthieu Cousin,845996,819438,Hélène Alexandre de la Samson,7153,33711,2022-12-11
TRANSFER,6081,Hélène Alexandre de la Samson,33711,27630,Zacharie Fabre,913748,907667,2022-12-11
TRANSFER,3052,Hélène Alexandre de la Samson,27630,24578,Nicole-Renée Gay,92971,89919,2022-12-13
CASH_OUT,20767,Hélène Alexandre de la Samson,24578,3811,Agence_mtn_Ouidah,300000,279233,2022-12-14
TRANSFER,304,Hélène Alexandre de la Samson,3811,3507,François Vaillant,18422,18118,2022-12-15
CASH_OUT,1447,Hélène Alexandre de la Samson,3507,2060,Agence_mtn_Abomey,300000,298553,2022-12-15
CASH_OUT,244,Hélène Alexandre de la Samson,2060,1816,Agence_mtn_Ouidah,300000,299756,2022-12-16
TRANSFER,314,Hélène Alexandre de la Samson,1816,1502,François Vaillant,18118,17804,2022-12-16
CASH_IN,101323,Agence_mtn_Ouidah,300000,198677,Hélène Alexandre de la Samson,1502,102825,2022-12-17
CASH_IN,73040,Agence_mtn_Abomey,300000,226960,Hélène Alexandre de la Samson,102825,175865,2022-12-19
TRANSFER,750548,Augustin-Jérôme Merle,765369,14821,Hélène Alexandre de la Samson,175865,926413,2022-12-19
TRANSFER,117182,Christophe Besnard-Diaz,221102,103920,Hélène Alexandre de la Samson,926413,1043595,2022-12-19
CASH_OUT,595245,Hélène Alexandre de la Samson,1043595,448350,Agence_mtn_Abomey,300000,-295245,2022-12-22
CASH_IN,221652,Agence_mtn_Ouidah,300000,78348,Hélène Alexandre de la Samson,448350,670002,2022-12-23
TRANSFER,544825,Aimé Bernier,571290,26465,Hélène Alexandre de la Samson,670002,1214827,2022-12-24
CASH_OUT,863529,Hélène Alexandre de la Samson,1214827,351298,Agence_mtn_Abomey,300000,-563529,2022-12-25
TRANSFER,763178,Simone du Allard,1149574,386396,Hélène Alexandre de la Samson,351298,1114476,2022-12-26
CASH_IN,61400,Agence_mtn_Abomey,300000,238600,Hélène Alexandre de la Samson,1114476,1175876,2022-12-26
CASH_OUT,275959,Hélène Alexandre de la Samson,1175876,899917,Agence_mtn_Cotonou,300000,24041,2022-12-27
TRANSFER,464606,Hélène Alexandre de la Samson,899917,435311,Raymond-Yves Boulanger,198394,-266212,2022-12-27
CASH_IN,201372,Agence_mtn_Cotonou,300000,98628,Hélène Alexandre de la Samson,435311,636683,2022-12-27
CASH_OUT,86921,Zacharie Fabre,907667,820746,Agence_mtn_Cotonou,300000,213079,2022-12-01
TRANSFER,718473,Zacharie Fabre,820746,102273,Henri de Didier,495151,-223322,2022-12-02
CASH_OUT,26992,Zacharie Fabre,102273,75281,Agence_mtn_Ouidah,300000,273008,2022-12-02
TRANSFER,50732,Zacharie Fabre,75281,24549,Marine Labbé,41446,-9286,2022-12-05
TRANSFER,206895,Marc Costa-Daniel,269209,62314,Zacharie Fabre,24549,231444,2022-12-08
CASH_IN,75244,Agence_mtn_Ouidah,300000,224756,Zacharie Fabre,231444,306688,2022-12-08
TRANSFER,75227,Christophe Besnard-Diaz,103920,28693,Zacharie Fabre,306688,381915,2022-12-08
CASH_IN,283723,Agence_mtn_Cotonou,300000,16277,Zacharie Fabre,381915,665638,2022-12-09
TRANSFER,458128,Zacharie Fabre,665638,207510,Danielle-Henriette Tessier,69444,-388684,2022-12-09
CASH_OUT,66798,Zacharie Fabre,207510,140712,Agence_mtn_Cotonou,300000,233202,2022-12-17
CASH_OUT,57338,Zacharie Fabre,140712,83374,Agence_mtn_Abomey,300000,242662,2022-12-18
TRANSFER,28774,Zacharie Fabre,83374,54600,Zacharie Fabre,83374,54600,2022-12-18
CASH_OUT,42108,Zacharie Fabre,54600,12492,Agence_mtn_Cotonou,300000,257892,2022-12-19
TRANSFER,10277,Zacharie Fabre,12492,2215,Nicolas Blin,118048,107771,2022-12-19
CASH_IN,295079,Agence_mtn_Cotonou,300000,4921,Zacharie Fabre,2215,297294,2022-12-19
CASH_IN,289431,Agence_mtn_Cotonou,300000,10569,Zacharie Fabre,297294,586725,2022-12-20
TRANSFER,208198,Zacharie Fabre,586725,378527,François Vaillant,17804,-190394,2022-12-20
CASH_IN,205517,Agence_mtn_Cotonou,300000,94483,Zacharie Fabre,378527,584044,2022-12-23
TRANSFER,23022,Zacharie Fabre,584044,561022,Sophie-Anouk Boulanger,1007102,984080,2022-12-23
TRANSFER,282300,Marcel de la Buisson,651140,368840,Zacharie Fabre,561022,843322,2022-12-24
TRANSFER,403683,Zacharie Fabre,843322,439639,Christophe Besnard-Diaz,28693,-374990,2022-12-25
CASH_IN,166592,Agence_mtn_Cotonou,300000,133408,Zacharie Fabre,439639,606231,2022-12-27
CASH_IN,140741,Agence_mtn_Abomey,300000,159259,Christophe Teixeira,-197803,-57062,2022-12-03
CASH_IN,50262,Agence_mtn_Cotonou,300000,249738,Christophe Teixeira,-57062,-6800,2022-12-04
CASH_IN,168878,Agence_mtn_Ouidah,300000,131122,Christophe Teixeira,-6800,162078,2022-12-04
CASH_IN,184271,Agence_mtn_Abomey,300000,115729,Christophe Teixeira,162078,346349,2022-12-08
CASH_OUT,29109,Christophe Teixeira,346349,317240,Agence_mtn_Abomey,300000,270891,2022-12-09
TRANSFER,35650,Christophe Teixeira,317240,281590,Jacques Laporte de Blanchet,538703,503053,2022-12-09
TRANSFER,69029,Nicolas Blin,107771,38742,Christophe Teixeira,281590,350619,2022-12-11
TRANSFER,167560,Charles Guérin,303434,135874,Christophe Teixeira,350619,518179,2022-12-11
TRANSFER,887715,Sébastien Coste,1157225,269510,Christophe Teixeira,518179,1405894,2022-12-12
CASH_IN,216160,Agence_mtn_Ouidah,300000,83840,Christophe Teixeira,1405894,1622054,2022-12-15
CASH_OUT,670907,Christophe Teixeira,1622054,951147,Agence_mtn_Ouidah,300000,-370907,2022-12-16
TRANSFER,586329,Matthieu Cousin,819438,233109,Christophe Teixeira,951147,1537476,2022-12-16
TRANSFER,266535,Maggie Barbier,1269176,1002641,Christophe Teixeira,1537476,1804011,2022-12-19
TRANSFER,26052,Nathalie Da Silva,30328,4276,Christophe Teixeira,1804011,1830063,2022-12-19
TRANSFER,1535672,Christophe Teixeira,1830063,294391,Sébastien Coste,269510,-1266162,2022-12-21
CASH_OUT,37272,Christophe Teixeira,294391,257119,Agence_mtn_Cotonou,300000,262728,2022-12-23
TRANSFER,24375,Christophe Teixeira,257119,232744,Matthieu Cousin,233109,208734,2022-12-23
CASH_IN,18734,Agence_mtn_Cotonou,300000,281266,Christophe Teixeira,232744,251478,2022-12-24
CASH_IN,36299,Agence_mtn_Cotonou,300000,263701,Christophe Teixeira,251478,287777,2022-12-26
CASH_OUT,52802,Christophe Teixeira,287777,234975,Agence_mtn_Cotonou,300000,247198,2022-12-27
CASH_IN,159861,Agence_mtn_Cotonou,300000,140139,Christophe Teixeira,234975,394836,2022-12-27
TRANSFER,2572,Thérèse-Juliette Camus,59456,56884,Christophe Teixeira,394836,397408,2022-12-27
CASH_IN,237047,Agence_mtn_Abomey,300000,62953,Nicole Huet,-107647,129400,2022-12-09
TRANSFER,29606,Nicole Huet,129400,99794,Jules-Marc Chauvet,659484,629878,2022-12-09
CASH_IN,72866,Agence_mtn_Ouidah,300000,227134,Nicole Huet,99794,172660,2022-12-10
TRANSFER,38668,Nicole Huet,172660,133992,Corinne Roussel,241784,203116,2022-12-13
CASH_IN,239763,Agence_mtn_Abomey,300000,60237,Nicole Huet,133992,373755,2022-12-14
TRANSFER,931,Nicole Huet,373755,372824,Pénélope Boulay,1839297,1838366,2022-12-15
CASH_OUT,167171,Nicole Huet,372824,205653,Agence_mtn_Abomey,300000,132829,2022-12-15
CASH_OUT,189118,Nicole Huet,205653,16535,Agence_mtn_Cotonou,300000,110882,2022-12-16
CASH_OUT,11919,Nicole Huet,16535,4616,Agence_mtn_Ouidah,300000,288081,2022-12-19
TRANSFER,1226,Nicole Huet,4616,3390,Céline-Inès Meunier,3090,1864,2022-12-20
CASH_IN,295613,Agence_mtn_Abomey,300000,4387,Nicole Huet,3390,299003,2022-12-23
TRANSFER,1195,Céline-Inès Meunier,1864,669,Nicole Huet,299003,300198,2022-12-24
CASH_OUT,808000,Michèle Faivre,1593655,785655,Agence_mtn_Cotonou,300000,-508000,2022-12-01
CASH_IN,2985,Agence_mtn_Abomey,300000,297015,Michèle Faivre,785655,788640,2022-12-03
CASH_IN,200707,Agence_mtn_Ouidah,300000,99293,Michèle Faivre,788640,989347,2022-12-03
CASH_OUT,47620,Michèle Faivre,989347,941727,Agence_mtn_Ouidah,300000,252380,2022-12-04
CASH_IN,138752,Agence_mtn_Ouidah,300000,161248,Michèle Faivre,941727,1080479,2022-12-05
CASH_OUT,66236,Michèle Faivre,1080479,1014243,Agence_mtn_Abomey,300000,233764,2022-12-06
CASH_OUT,733741,Michèle Faivre,1014243,280502,Agence_mtn_Ouidah,300000,-433741,2022-12-07
CASH_IN,170174,Agence_mtn_Cotonou,300000,129826,Michèle Faivre,280502,450676,2022-12-07
CASH_OUT,181841,Michèle Faivre,450676,268835,Agence_mtn_Ouidah,300000,118159,2022-12-13
TRANSFER,51740,Marc Costa-Daniel,62314,10574,Michèle Faivre,268835,320575,2022-12-13
TRANSFER,356,Guy-Augustin Pinto,30055,29699,Michèle Faivre,320575,320931,2022-12-15
CASH_OUT,266358,Michèle Faivre,320931,54573,Agence_mtn_Ouidah,300000,33642,2022-12-16
CASH_IN,169076,Agence_mtn_Cotonou,300000,130924,Michèle Faivre,54573,223649,2022-12-17
CASH_OUT,156957,Michèle Faivre,223649,66692,Agence_mtn_Ouidah,300000,143043,2022-12-18
CASH_IN,241073,Agence_mtn_Cotonou,300000,58927,Michèle Faivre,66692,307765,2022-12-18
CASH_IN,40437,Agence_mtn_Abomey,300000,259563,Michèle Faivre,307765,348202,2022-12-20
TRANSFER,17181,Michèle Faivre,348202,331021,Céline-Inès Meunier,669,-16512,2022-12-20
CASH_IN,204541,Agence_mtn_Cotonou,300000,95459,Michèle Faivre,331021,535562,2022-12-21
TRANSFER,247952,Jules-Marc Chauvet,629878,381926,Michèle Faivre,535562,783514,2022-12-23
TRANSFER,22877,Aimé Bernier,26465,3588,Michèle Faivre,783514,806391,2022-12-26
CASH_IN,57403,Agence_mtn_Ouidah,300000,242597,Jérôme Laporte Le Gauthier,-363543,-306140,2022-12-04
CASH_IN,217999,Agence_mtn_Cotonou,300000,82001,Jérôme Laporte Le Gauthier,-306140,-88141,2022-12-08
CASH_IN,157999,Agence_mtn_Abomey,300000,142001,Jérôme Laporte Le Gauthier,-88141,69858,2022-12-08
TRANSFER,68002,Jérôme Laporte Le Gauthier,69858,1856,Emmanuel Legrand,109081,41079,2022-12-09
TRANSFER,1237,Aimé Bernier,3588,2351,Jérôme Laporte Le Gauthier,1856,3093,2022-12-09
TRANSFER,2739,Jérôme Laporte Le Gauthier,3093,354,Jacques Laporte de Blanchet,503053,500314,2022-12-09
CASH_IN,259730,Agence_mtn_Ouidah,300000,40270,Jérôme Laporte Le Gauthier,354,260084,2022-12-10
TRANSFER,127095,Jérôme Laporte Le Gauthier,260084,132989,Sophie-Anouk Boulanger,984080,856985,2022-12-11
CASH_IN,60718,Agence_mtn_Ouidah,300000,239282,Jérôme Laporte Le Gauthier,132989,193707,2022-12-11
CASH_IN,107109,Agence_mtn_Ouidah,300000,192891,Jérôme Laporte Le Gauthier,193707,300816,2022-12-13
TRANSFER,256182,Jérôme Laporte Le Gauthier,300816,44634,Augustin-Jérôme Merle,14821,-241361,2022-12-15
CASH_IN,81553,Agence_mtn_Cotonou,300000,218447,Jérôme Laporte Le Gauthier,44634,126187,2022-12-15
CASH_OUT,10300,Jérôme Laporte Le Gauthier,126187,115887,Agence_mtn_Ouidah,300000,289700,2022-12-18
CASH_OUT,16543,Jérôme Laporte Le Gauthier,115887,99344,Agence_mtn_Cotonou,300000,283457,2022-12-18
CASH_OUT,99100,Jérôme Laporte Le Gauthier,99344,244,Agence_mtn_Ouidah,300000,200900,2022-12-19
CASH_OUT,244,Jérôme Laporte Le Gauthier,244,0,Agence_mtn_Abomey,300000,299756,2022-12-23
CASH_IN,53826,Agence_mtn_Ouidah,300000,246174,Jérôme Laporte Le Gauthier,0,53826,2022-12-24
CASH_IN,205557,Agence_mtn_Cotonou,300000,94443,Jérôme Laporte Le Gauthier,53826,259383,2022-12-25
TRANSFER,139504,Jérôme Laporte Le Gauthier,259383,119879,Marthe Perrin,981297,841793,2022-12-26
CASH_IN,37760,Agence_mtn_Abomey,300000,262240,Élisabeth Blot-Bruneau,-45235,-7475,2022-12-01
CASH_IN,241054,Agence_mtn_Abomey,300000,58946,Élisabeth Blot-Bruneau,-7475,233579,2022-12-02
CASH_IN,126633,Agence_mtn_Abomey,300000,173367,Élisabeth Blot-Bruneau,233579,360212,2022-12-08
CASH_IN,246655,Agence_mtn_Abomey,300000,53345,Élisabeth Blot-Bruneau,360212,606867,2022-12-08
CASH_OUT,395485,Élisabeth Blot-Bruneau,606867,211382,Agence_mtn_Cotonou,300000,-95485,2022-12-08
CASH_OUT,5664,Élisabeth Blot-Bruneau,211382,205718,Agence_mtn_Ouidah,300000,294336,2022-12-09
CASH_OUT,178766,Élisabeth Blot-Bruneau,205718,26952,Agence_mtn_Ouidah,300000,121234,2022-12-09
CASH_OUT,12370,Élisabeth Blot-Bruneau,26952,14582,Agence_mtn_Cotonou,300000,287630,2022-12-11
CASH_IN,239237,Agence_mtn_Cotonou,300000,60763,Élisabeth Blot-Bruneau,14582,253819,2022-12-12
CASH_OUT,97171,Élisabeth Blot-Bruneau,253819,156648,Agence_mtn_Abomey,300000,202829,2022-12-16
TRANSFER,229360,Jacques Laporte de Blanchet,500314,270954,Élisabeth Blot-Bruneau,156648,386008,2022-12-17
CASH_IN,170285,Agence_mtn_Abomey,300000,129715,Élisabeth Blot-Bruneau,386008,556293,2022-12-17
TRANSFER,273289,Maggie Barbier,1002641,729352,Élisabeth Blot-Bruneau,556293,829582,2022-12-19
CASH_OUT,748689,Élisabeth Blot-Bruneau,829582,80893,Agence_mtn_Cotonou,300000,-448689,2022-12-19
TRANSFER,90525,Madeleine Hardy,104833,14308,Élisabeth Blot-Bruneau,80893,171418,2022-12-20
TRANSFER,17053,Élisabeth Blot-Bruneau,171418,154365,Sylvie Dupré,143830,126777,2022-12-21
CASH_IN,278758,Agence_mtn_Cotonou,300000,21242,Élisabeth Blot-Bruneau,154365,433123,2022-12-21
CASH_OUT,8762,Élisabeth Blot-Bruneau,433123,424361,Agence_mtn_Cotonou,300000,291238,2022-12-22
TRANSFER,1312080,Alexandre Blanchard,1333330,21250,Élisabeth Blot-Bruneau,424361,1736441,2022-12-24
CASH_IN,237461,Agence_mtn_Cotonou,300000,62539,Élisabeth Blot-Bruneau,1736441,1973902,2022-12-26
CASH_OUT,45308,Corinne Roussel,203116,157808,Agence_mtn_Ouidah,300000,254692,2022-12-05
TRANSFER,72283,Corinne Roussel,157808,85525,Marc Costa-Daniel,10574,-61709,2022-12-07
CASH_OUT,55620,Corinne Roussel,85525,29905,Agence_mtn_Abomey,300000,244380,2022-12-09
CASH_OUT,23449,Corinne Roussel,29905,6456,Agence_mtn_Abomey,300000,276551,2022-12-09
CASH_OUT,1000,Corinne Roussel,6456,5456,Agence_mtn_Ouidah,300000,299000,2022-12-09
CASH_OUT,2518,Corinne Roussel,5456,2938,Agence_mtn_Abomey,300000,297482,2022-12-23
TRANSFER,2563,Corinne Roussel,2938,375,Charles Guérin,135874,133311,2022-12-26
CASH_IN,141833,Agence_mtn_Cotonou,300000,158167,Marine Labbé,-9286,132547,2022-12-03
CASH_OUT,75361,Marine Labbé,132547,57186,Agence_mtn_Cotonou,300000,224639,2022-12-03
TRANSFER,3763,Alexandre Blanchard,21250,17487,Marine Labbé,57186,60949,2022-12-06
CASH_IN,140669,Agence_mtn_Cotonou,300000,159331,Marine Labbé,60949,201618,2022-12-06
TRANSFER,328999,Maggie Barbier,729352,400353,Marine Labbé,201618,530617,2022-12-07
CASH_OUT,76962,Marine Labbé,530617,453655,Agence_mtn_Cotonou,300000,223038,2022-12-08
CASH_IN,144805,Agence_mtn_Ouidah,300000,155195,Marine Labbé,453655,598460,2022-12-09
TRANSFER,234239,Marine Labbé,598460,364221,Sylvie Dupré,126777,-107462,2022-12-13
CASH_IN,25097,Agence_mtn_Cotonou,300000,274903,Marine Labbé,364221,389318,2022-12-15
CASH_IN,146522,Agence_mtn_Cotonou,300000,153478,Marine Labbé,389318,535840,2022-12-16
TRANSFER,473633,Marine Labbé,535840,62207,Marine Labbé,535840,62207,2022-12-16
CASH_OUT,42740,Marine Labbé,62207,19467,Agence_mtn_Ouidah,300000,257260,2022-12-17
CASH_OUT,10810,Marine Labbé,19467,8657,Agence_mtn_Ouidah,300000,289190,2022-12-18
TRANSFER,6800,Marine Labbé,8657,1857,Marine Labbé,8657,15457,2022-12-19
TRANSFER,955,Marine Labbé,1857,902,Aimé Bernier,2351,1396,2022-12-21
CASH_IN,240255,Agence_mtn_Cotonou,300000,59745,Marine Labbé,902,241157,2022-12-23
CASH_IN,241475,Agence_mtn_Ouidah,300000,58525,Marine Labbé,241157,482632,2022-12-23
TRANSFER,352282,Marine Labbé,482632,130350,Pénélope Boulay,1838366,1486084,2022-12-26
TRANSFER,644748,Sophie-Anouk Boulanger,856985,212237,Marine Labbé,130350,775098,2022-12-26
TRANSFER,171425,Marine Labbé,775098,603673,Alexandre Blanchard,17487,-153938,2022-12-27
CASH_IN,149707,Agence_mtn_Cotonou,300000,150293,Guy-Augustin Pinto,29699,179406,2022-12-08
CASH_OUT,79909,Guy-Augustin Pinto,179406,99497,Agence_mtn_Cotonou,300000,220091,2022-12-13
CASH_IN,265332,Agence_mtn_Abomey,300000,34668,Guy-Augustin Pinto,99497,364829,2022-12-13
TRANSFER,79745,Julie Germain Le Vaillant,81669,1924,Guy-Augustin Pinto,364829,444574,2022-12-14
CASH_OUT,92086,Guy-Augustin Pinto,444574,352488,Agence_mtn_Ouidah,300000,207914,2022-12-22
CASH_OUT,165222,Guy-Augustin Pinto,352488,187266,Agence_mtn_Abomey,300000,134778,2022-12-24
CASH_IN,33834,Agence_mtn_Abomey,300000,266166,Nathalie Da Silva,4276,38110,2022-12-01
CASH_IN,131977,Agence_mtn_Cotonou,300000,168023,Nathalie Da Silva,38110,170087,2022-12-01
CASH_IN,149329,Agence_mtn_Cotonou,300000,150671,Nathalie Da Silva,170087,319416,2022-12-01
CASH_IN,150586,Agence_mtn_Abomey,300000,149414,Nathalie Da Silva,319416,470002,2022-12-05
TRANSFER,1607,Julie Germain Le Vaillant,1924,317,Nathalie Da Silva,470002,471609,2022-12-07
CASH_OUT,161283,Nathalie Da Silva,471609,310326,Agence_mtn_Abomey,300000,138717,2022-12-08
CASH_IN,269146,Agence_mtn_Abomey,300000,30854,Nathalie Da Silva,310326,579472,2022-12-09
CASH_IN,39558,Agence_mtn_Abomey,300000,260442,Nathalie Da Silva,579472,619030,2022-12-10
CASH_OUT,394352,Nathalie Da Silva,619030,224678,Agence_mtn_Abomey,300000,-94352,2022-12-10
CASH_IN,276102,Agence_mtn_Abomey,300000,23898,Nathalie Da Silva,224678,500780,2022-12-10
CASH_OUT,206252,Nathalie Da Silva,500780,294528,Agence_mtn_Abomey,300000,93748,2022-12-10
CASH_OUT,269677,Nathalie Da Silva,294528,24851,Agence_mtn_Ouidah,300000,30323,2022-12-11
CASH_OUT,3025,Nathalie Da Silva,24851,21826,Agence_mtn_Ouidah,300000,296975,2022-12-11
CASH_OUT,11033,Nathalie Da Silva,21826,10793,Agence_mtn_Cotonou,300000,288967,2022-12-16
CASH_OUT,2988,Nathalie Da Silva,10793,7805,Agence_mtn_Abomey,300000,297012,2022-12-17
CASH_OUT,2080,Nathalie Da Silva,7805,5725,Agence_mtn_Cotonou,300000,297920,2022-12-18
CASH_OUT,1765,Nathalie Da Silva,5725,3960,Agence_mtn_Ouidah,300000,298235,2022-12-18
TRANSFER,575,Nathalie Da Silva,3960,3385,Roger-Roger Delmas,73177,72602,2022-12-19
TRANSFER,2838,Nathalie Da Silva,3385,547,Raymond de Le Roux,11539,8701,2022-12-24
CASH_IN,189018,Agence_mtn_Cotonou,300000,110982,Nathalie Da Silva,547,189565,2022-12-27
TRANSFER,644134,Pénélope Boulay,1486084,841950,Nicole-Renée Gay,89919,-554215,2022-12-04
CASH_IN,154069,Agence_mtn_Cotonou,300000,145931,Pénélope Boulay,841950,996019,2022-12-04
TRANSFER,969111,Pénélope Boulay,996019,26908,Gérard Blot de Blanc,1674092,704981,2022-12-05
CASH_OUT,18514,Pénélope Boulay,26908,8394,Agence_mtn_Cotonou,300000,281486,2022-12-08
CASH_IN,156203,Agence_mtn_Cotonou,300000,143797,Pénélope Boulay,8394,164597,2022-12-10
CASH_IN,145180,Agence_mtn_Cotonou,300000,154820,Pénélope Boulay,164597,309777,2022-12-10
TRANSFER,238103,Pénélope Boulay,309777,71674,Matthieu Cousin,208734,-29369,2022-12-11
TRANSFER,1080,Aimé Bernier,1396,316,Pénélope Boulay,71674,72754,2022-12-12
CASH_IN,87866,Agence_mtn_Cotonou,300000,212134,Pénélope Boulay,72754,160620,2022-12-13
TRANSFER,139523,Pénélope Boulay,160620,21097,Julie Germain Le Vaillant,317,-139206,2022-12-13
CASH_OUT,4994,Pénélope Boulay,21097,16103,Agence_mtn_Cotonou,300000,295006,2022-12-15
CASH_OUT,12476,Pénélope Boulay,16103,3627,Agence_mtn_Ouidah,300000,287524,2022-12-17
TRANSFER,37486,Emmanuel Legrand,41079,3593,Pénélope Boulay,3627,41113,2022-12-17
TRANSFER,27655,Marthe Perrin,841793,814138,Pénélope Boulay,41113,68768,2022-12-18
CASH_IN,121800,Agence_mtn_Abomey,300000,178200,Pénélope Boulay,68768,190568,2022-12-21
CASH_IN,248854,Agence_mtn_Abomey,300000,51146,Pénélope Boulay,190568,439422,2022-12-22
CASH_OUT,378510,Pénélope Boulay,439422,60912,Agence_mtn_Cotonou,300000,-78510,2022-12-22
CASH_OUT,54487,Pénélope Boulay,60912,6425,Agence_mtn_Abomey,300000,245513,2022-12-22
TRANSFER,5858,Pénélope Boulay,6425,567,Jacques Laporte de Blanchet,270954,265096,2022-12-24
CASH_IN,177543,Agence_mtn_Cotonou,300000,122457,Pénélope Boulay,567,178110,2022-12-25
CASH_IN,141265,Agence_mtn_Cotonou,300000,158735,Nicole-Renée Gay,-554215,-412950,2022-12-05
CASH_IN,286480,Agence_mtn_Abomey,300000,13520,Nicole-Renée Gay,-412950,-126470,2022-12-05
CASH_IN,140078,Agence_mtn_Cotonou,300000,159922,Nicole-Renée Gay,-126470,13608,2022-12-14
CASH_OUT,7455,Nicole-Renée Gay,13608,6153,Agence_mtn_Cotonou,300000,292545,2022-12-15
CASH_IN,143178,Agence_mtn_Abomey,300000,156822,Nicole-Renée Gay,6153,149331,2022-12-16
CASH_IN,5670,Agence_mtn_Cotonou,300000,294330,Nicole-Renée Gay,149331,155001,2022-12-18
CASH_OUT,31619,Nicole-Renée Gay,155001,123382,Agence_mtn_Abomey,300000,268381,2022-12-20
CASH_IN,176029,Agence_mtn_Cotonou,300000,123971,Nicole-Renée Gay,123382,299411,2022-12-21
CASH_IN,255560,Agence_mtn_Abomey,300000,44440,Nicole-Renée Gay,299411,554971,2022-12-21
CASH_OUT,122411,Nicole-Renée Gay,554971,432560,Agence_mtn_Cotonou,300000,177589,2022-12-22
TRANSFER,203,Emmanuel Legrand,3593,3390,Nicole-Renée Gay,432560,432763,2022-12-24
TRANSFER,497,Emmanuel Legrand,3390,2893,Sophie-Anouk Boulanger,212237,211740,2022-12-01
TRANSFER,2232,Emmanuel Legrand,2893,661,Jacques Laporte de Blanchet,265096,262864,2022-12-03
CASH_OUT,381,Emmanuel Legrand,661,280,Agence_mtn_Cotonou,300000,299619,2022-12-06
CASH_OUT,273,Emmanuel Legrand,280,7,Agence_mtn_Ouidah,300000,299727,2022-12-14
CASH_IN,206450,Agence_mtn_Abomey,300000,93550,Emmanuel Legrand,7,206457,2022-12-18
CASH_IN,121748,Agence_mtn_Abomey,300000,178252,Emmanuel Legrand,206457,328205,2022-12-21
TRANSFER,120289,Emmanuel Legrand,328205,207916,Maggie Barbier,400353,280064,2022-12-21
CASH_IN,95692,Agence_mtn_Cotonou,300000,204308,Raymond de Le Roux,8701,104393,2022-12-06
CASH_OUT,47100,Raymond de Le Roux,104393,57293,Agence_mtn_Ouidah,300000,252900,2022-12-07
CASH_IN,260835,Agence_mtn_Cotonou,300000,39165,Raymond de Le Roux,57293,318128,2022-12-09
CASH_IN,136326,Agence_mtn_Abomey,300000,163674,Raymond de Le Roux,318128,454454,2022-12-11
CASH_IN,54849,Agence_mtn_Abomey,300000,245151,Raymond de Le Roux,454454,509303,2022-12-11
CASH_OUT,62924,Raymond de Le Roux,509303,446379,Agence_mtn_Abomey,300000,237076,2022-12-11
TRANSFER,394463,Raymond de Le Roux,446379,51916,Marcel de la Buisson,368840,-25623,2022-12-16
CASH_IN,124520,Agence_mtn_Abomey,300000,175480,Raymond de Le Roux,51916,176436,2022-12-16
CASH_IN,159404,Agence_mtn_Cotonou,300000,140596,Raymond de Le Roux,176436,335840,2022-12-18
CASH_OUT,25876,Raymond de Le Roux,335840,309964,Agence_mtn_Abomey,300000,274124,2022-12-23
CASH_IN,176473,Agence_mtn_Abomey,300000,123527,Christophe Besnard-Diaz,-374990,-198517,2022-12-02
CASH_IN,102287,Agence_mtn_Ouidah,300000,197713,Christophe Besnard-Diaz,-198517,-96230,2022-12-03
CASH_IN,217008,Agence_mtn_Cotonou,300000,82992,Christophe Besnard-Diaz,-96230,120778,2022-12-03
TRANSFER,209106,Jacques Laporte de Blanchet,262864,53758,Christophe Besnard-Diaz,120778,329884,2022-12-04
CASH_IN,293987,Agence_mtn_Cotonou,300000,6013,Christophe Besnard-Diaz,329884,623871,2022-12-05
TRANSFER,264776,Jules-Marc Chauvet,381926,117150,Christophe Besnard-Diaz,623871,888647,2022-12-06
CASH_IN,236883,Agence_mtn_Cotonou,300000,63117,Christophe Besnard-Diaz,888647,1125530,2022-12-06
CASH_OUT,115557,Christophe Besnard-Diaz,1125530,1009973,Agence_mtn_Abomey,300000,184443,2022-12-07
TRANSFER,33931,Guillaume de la Nguyen,126884,92953,Christophe Besnard-Diaz,1009973,1043904,2022-12-08
TRANSFER,853636,Christophe Besnard-Diaz,1043904,190268,Jacques Laporte de Blanchet,53758,-799878,2022-12-09
TRANSFER,64795,Roger-Roger Delmas,72602,7807,Christophe Besnard-Diaz,190268,255063,2022-12-09
TRANSFER,152173,Maggie Barbier,280064,127891,Christophe Besnard-Diaz,255063,407236,2022-12-10
TRANSFER,350155,Marthe Perrin,814138,463983,Christophe Besnard-Diaz,407236,757391,2022-12-10
CASH_OUT,312550,Christophe Besnard-Diaz,757391,444841,Agence_mtn_Abomey,300000,-12550,2022-12-13
CASH_IN,82285,Agence_mtn_Ouidah,300000,217715,Christophe Besnard-Diaz,444841,527126,2022-12-14
TRANSFER,388250,Christophe Besnard-Diaz,527126,138876,Josette du Hamon,182427,-205823,2022-12-15
CASH_IN,71410,Agence_mtn_Ouidah,300000,228590,Christophe Besnard-Diaz,138876,210286,2022-12-21
CASH_OUT,149088,Christophe Besnard-Diaz,210286,61198,Agence_mtn_Ouidah,300000,150912,2022-12-23
TRANSFER,42383,Maggie Barbier,127891,85508,Christophe Besnard-Diaz,61198,103581,2022-12-24
CASH_OUT,10428,Christophe Besnard-Diaz,103581,93153,Agence_mtn_Ouidah,300000,289572,2022-12-27
CASH_IN,195914,Agence_mtn_Ouidah,300000,104086,Aurélie Maury,-68491,127423,2022-12-01
CASH_IN,35423,Agence_mtn_Abomey,300000,264577,Aurélie Maury,127423,162846,2022-12-02
TRANSFER,155277,Aurélie Maury,162846,7569,Jacques Marchand,496682,341405,2022-12-03
CASH_OUT,6853,Aurélie Maury,7569,716,Agence_mtn_Ouidah,300000,293147,2022-12-03
CASH_IN,8424,Agence_mtn_Cotonou,300000,291576,Aurélie Maury,716,9140,2022-12-04
CASH_OUT,732,Aurélie Maury,9140,8408,Agence_mtn_Cotonou,300000,299268,2022-12-05
CASH_IN,286521,Agence_mtn_Abomey,300000,13479,Aurélie Maury,8408,294929,2022-12-05
CASH_OUT,109095,Aurélie Maury,294929,185834,Agence_mtn_Cotonou,300000,190905,2022-12-07
TRANSFER,28155,Sophie-Anouk Boulanger,211740,183585,Aurélie Maury,185834,213989,2022-12-08
CASH_OUT,203211,Aurélie Maury,213989,10778,Agence_mtn_Ouidah,300000,96789,2022-12-09
CASH_IN,7239,Agence_mtn_Abomey,300000,292761,Aurélie Maury,10778,18017,2022-12-19
CASH_OUT,1756,Aurélie Maury,18017,16261,Agence_mtn_Abomey,300000,298244,2022-12-21
CASH_IN,217163,Agence_mtn_Cotonou,300000,82837,Aurélie Maury,16261,233424,2022-12-24
CASH_IN,33268,Agence_mtn_Cotonou,300000,266732,Aurélie Maury,233424,266692,2022-12-26
CASH_IN,55832,Agence_mtn_Abomey,300000,244168,Jacques Laporte de Blanchet,-799878,-744046,2022-12-01
CASH_IN,223517,Agence_mtn_Ouidah,300000,76483,Jacques Laporte de Blanchet,-744046,-520529,2022-12-02
CASH_IN,198298,Agence_mtn_Ouidah,300000,101702,Jacques Laporte de Blanchet,-520529,-322231,2022-12-04
CASH_IN,91017,Agence_mtn_Abomey,300000,208983,Jacques Laporte de Blanchet,-322231,-231214,2022-12-05
CASH_IN,20495,Agence_mtn_Abomey,300000,279505,Jacques Laporte de Blanchet,-231214,-210719,2022-12-08
CASH_IN,126989,Agence_mtn_Abomey,300000,173011,Jacques Laporte de Blanchet,-210719,-83730,2022-12-08
CASH_IN,23970,Agence_mtn_Ouidah,300000,276030,Jacques Laporte de Blanchet,-83730,-59760,2022-12-09
CASH_IN,272955,Agence_mtn_Cotonou,300000,27045,Jacques Laporte de Blanchet,-59760,213195,2022-12-11
CASH_IN,211897,Agence_mtn_Abomey,300000,88103,Jacques Laporte de Blanchet,213195,425092,2022-12-12
CASH_OUT,17437,Jacques Laporte de Blanchet,425092,407655,Agence_mtn_Abomey,300000,282563,2022-12-13
CASH_IN,180400,Agence_mtn_Cotonou,300000,119600,Jacques Laporte de Blanchet,407655,588055,2022-12-14
TRANSFER,259595,Jacques Laporte de Blanchet,588055,328460,Aimé Bernier,316,-259279,2022-12-17
CASH_IN,184614,Agence_mtn_Abomey,300000,115386,Jacques Laporte de Blanchet,328460,513074,2022-12-19
CASH_OUT,375659,Jacques Laporte de Blanchet,513074,137415,Agence_mtn_Abomey,300000,-75659,2022-12-19
CASH_OUT,28970,Jacques Laporte de Blanchet,137415,108445,Agence_mtn_Abomey,300000,271030,2022-12-19
CASH_OUT,104373,Jacques Laporte de Blanchet,108445,4072,Agence_mtn_Ouidah,300000,195627,2022-12-21
TRANSFER,46615,Maggie Barbier,85508,38893,Jacques Laporte de Blanchet,4072,50687,2022-12-24
CASH_OUT,8312,Jacques Laporte de Blanchet,50687,42375,Agence_mtn_Cotonou,300000,291688,2022-12-26
TRANSFER,320335,Simone du Allard,386396,66061,Jacques Laporte de Blanchet,42375,362710,2022-12-27
TRANSFER,192403,Jacques Laporte de Blanchet,362710,170307,Marthe Perrin,463983,271580,2022-12-27
TRANSFER,236059,Marthe Perrin,271580,35521,Gérard Blot de Blanc,704981,468922,2022-12-01
CASH_OUT,25022,Marthe Perrin,35521,10499,Agence_mtn_Abomey,300000,274978,2022-12-01
TRANSFER,69625,Sophie-Anouk Boulanger,183585,113960,Marthe Perrin,10499,80124,2022-12-10
CASH_IN,120459,Agence_mtn_Abomey,300000,179541,Marthe Perrin,80124,200583,2022-12-11
CASH_IN,106540,Agence_mtn_Cotonou,300000,193460,Marthe Perrin,200583,307123,2022-12-12
TRANSFER,46931,Simone du Allard,66061,19130,Marthe Perrin,307123,354054,2022-12-14
CASH_IN,209241,Agence_mtn_Cotonou,300000,90759,Marthe Perrin,354054,563295,2022-12-16
TRANSFER,532687,Marthe Perrin,563295,30608,Roger-Roger Delmas,7807,-524880,2022-12-16
TRANSFER,17891,Marthe Perrin,30608,12717,Marthe Perrin,30608,48499,2022-12-17
CASH_IN,180490,Agence_mtn_Cotonou,300000,119510,Marthe Perrin,12717,193207,2022-12-19
TRANSFER,27236,Maggie Barbier,38893,11657,Marthe Perrin,193207,220443,2022-12-19
CASH_OUT,168914,Marthe Perrin,220443,51529,Agence_mtn_Cotonou,300000,131086,2022-12-22
CASH_OUT,6025,Marthe Perrin,51529,45504,Agence_mtn_Ouidah,300000,293975,2022-12-24
CASH_IN,233438,Agence_mtn_Ouidah,300000,66562,Marthe Perrin,45504,278942,2022-12-24
CASH_IN,232947,Agence_mtn_Ouidah,300000,67053,Marthe Perrin,278942,511889,2022-12-24
CASH_IN,297899,Agence_mtn_Ouidah,300000,2101,Marthe Perrin,511889,809788,2022-12-27
CASH_IN,158011,Agence_mtn_Ouidah,300000,141989,Julien Devaux,-203123,-45112,2022-12-08
CASH_IN,71092,Agence_mtn_Ouidah,300000,228908,Julien Devaux,-45112,25980,2022-12-09
CASH_OUT,21121,Julien Devaux,25980,4859,Agence_mtn_Cotonou,300000,278879,2022-12-11
CASH_OUT,3927,Julien Devaux,4859,932,Agence_mtn_Abomey,300000,296073,2022-12-11
TRANSFER,422,Julien Devaux,932,510,Thérèse-Juliette Camus,56884,56462,2022-12-12
CASH_IN,193327,Agence_mtn_Cotonou,300000,106673,Julien Devaux,510,193837,2022-12-26
CASH_OUT,15359,Guillaume de la Nguyen,92953,77594,Agence_mtn_Cotonou,300000,284641,2022-12-01
CASH_OUT,64984,Guillaume de la Nguyen,77594,12610,Agence_mtn_Cotonou,300000,235016,2022-12-02
CASH_OUT,9306,Guillaume de la Nguyen,12610,3304,Agence_mtn_Cotonou,300000,290694,2022-12-02
CASH_OUT,635,Guillaume de la Nguyen,3304,2669,Agence_mtn_Abomey,300000,299365,2022-12-03
CASH_OUT,490,Guillaume de la Nguyen,2669,2179,Agence_mtn_Ouidah,300000,299510,2022-12-05
CASH_IN,70541,Agence_mtn_Cotonou,300000,229459,Guillaume de la Nguyen,2179,72720,2022-12-05
CASH_IN,276466,Agence_mtn_Cotonou,300000,23534,Guillaume de la Nguyen,72720,349186,2022-12-06
CASH_IN,164845,Agence_mtn_Abomey,300000,135155,Guillaume de la Nguyen,349186,514031,2022-12-07
CASH_IN,101464,Agence_mtn_Cotonou,300000,198536,Guillaume de la Nguyen,514031,615495,2022-12-07
CASH_IN,117533,Agence_mtn_Cotonou,300000,182467,Guillaume de la Nguyen,615495,733028,2022-12-10
TRANSFER,9189,Guillaume de la Nguyen,733028,723839,Thérèse-Juliette Camus,56462,47273,2022-12-13
TRANSFER,434678,Guillaume de la Nguyen,723839,289161,Simone du Allard,19130,-415548,2022-12-14
CASH_IN,27655,Agence_mtn_Ouidah,300000,272345,Guillaume de la Nguyen,289161,316816,2022-12-16
CASH_IN,170202,Agence_mtn_Ouidah,300000,129798,Guillaume de la Nguyen,316816,487018,2022-12-18
CASH_IN,152547,Agence_mtn_Abomey,300000,147453,Alexandre Blanchard,-153938,-1391,2022-12-01
CASH_IN,25035,Agence_mtn_Abomey,300000,274965,Alexandre Blanchard,-1391,23644,2022-12-03
CASH_IN,291158,Agence_mtn_Abomey,300000,8842,Alexandre Blanchard,23644,314802,2022-12-04
CASH_OUT,15181,Alexandre Blanchard,314802,299621,Agence_mtn_Abomey,300000,284819,2022-12-06
CASH_IN,261533,Agence_mtn_Ouidah,300000,38467,Alexandre Blanchard,299621,561154,2022-12-07
TRANSFER,30818,Nicolas Blin,38742,7924,Alexandre Blanchard,561154,591972,2022-12-10
TRANSFER,93878,Alexandre Blanchard,591972,498094,Jules-Marc Chauvet,117150,23272,2022-12-11
TRANSFER,4955,Nicolas Blin,7924,2969,Alexandre Blanchard,498094,503049,2022-12-14
CASH_OUT,290474,Alexandre Blanchard,503049,212575,Agence_mtn_Cotonou,300000,9526,2022-12-16
CASH_IN,259102,Agence_mtn_Abomey,300000,40898,Alexandre Blanchard,212575,471677,2022-12-16
CASH_OUT,248059,Alexandre Blanchard,471677,223618,Agence_mtn_Cotonou,300000,51941,2022-12-17
CASH_OUT,190737,Alexandre Blanchard,223618,32881,Agence_mtn_Ouidah,300000,109263,2022-12-20
TRANSFER,1261,Alexandre Blanchard,32881,31620,Jacques Marchand,341405,340144,2022-12-20
CASH_IN,183268,Agence_mtn_Abomey,300000,116732,Alexandre Blanchard,31620,214888,2022-12-21
TRANSFER,138980,Alexandre Blanchard,214888,75908,Alexandre Blanchard,214888,75908,2022-12-23
CASH_IN,224498,Agence_mtn_Cotonou,300000,75502,Alexandre Blanchard,75908,300406,2022-12-23
CASH_IN,153980,Agence_mtn_Cotonou,300000,146020,Alexandre Blanchard,300406,454386,2022-12-24
CASH_OUT,351669,Alexandre Blanchard,454386,102717,Agence_mtn_Abomey,300000,-51669,2022-12-26
TRANSFER,3146,Jules-Marc Chauvet,23272,20126,Alexandre Blanchard,102717,105863,2022-12-26
TRANSFER,7029,Alexandre Blanchard,105863,98834,Thérèse-Juliette Camus,47273,40244,2022-12-27
CASH_IN,139602,Agence_mtn_Abomey,300000,160398,Jules-Marc Chauvet,20126,159728,2022-12-04
CASH_OUT,95841,Jules-Marc Chauvet,159728,63887,Agence_mtn_Abomey,300000,204159,2022-12-07
TRANSFER,421,Thérèse-Juliette Camus,40244,39823,Jules-Marc Chauvet,63887,64308,2022-12-07
TRANSFER,52822,Jules-Marc Chauvet,64308,11486,Jules-Marc Chauvet,64308,11486,2022-12-08
CASH_IN,191462,Agence_mtn_Ouidah,300000,108538,Jules-Marc Chauvet,11486,202948,2022-12-10
CASH_OUT,112111,Jules-Marc Chauvet,202948,90837,Agence_mtn_Abomey,300000,187889,2022-12-11
CASH_OUT,47332,Jules-Marc Chauvet,90837,43505,Agence_mtn_Ouidah,300000,252668,2022-12-11
TRANSFER,19319,Jules-Marc Chauvet,43505,24186,Sophie-Anouk Boulanger,113960,94641,2022-12-15
TRANSFER,81186,Sophie-Anouk Boulanger,94641,13455,Jules-Marc Chauvet,24186,105372,2022-12-16
TRANSFER,62605,Jules-Marc Chauvet,105372,42767,Nicolas Blin,2969,-59636,2022-12-17
CASH_IN,144666,Agence_mtn_Abomey,300000,155334,Jules-Marc Chauvet,42767,187433,2022-12-20
TRANSFER,12193,Sophie-Anouk Boulanger,13455,1262,Jules-Marc Chauvet,187433,199626,2022-12-21
CASH_OUT,102535,Jules-Marc Chauvet,199626,97091,Agence_mtn_Ouidah,300000,197465,2022-12-25
CASH_IN,112915,Agence_mtn_Abomey,300000,187085,Jules-Marc Chauvet,97091,210006,2022-12-26
CASH_OUT,17043,Jules-Marc Chauvet,210006,192963,Agence_mtn_Abomey,300000,282957,2022-12-26
TRANSFER,149831,Jules-Marc Chauvet,192963,43132,Madeleine Hardy,14308,-135523,2022-12-27
CASH_IN,95946,Agence_mtn_Cotonou,300000,204054,Françoise Denis de Allard,-1301400,-1205454,2022-12-02
CASH_IN,26512,Agence_mtn_Abomey,300000,273488,Françoise Denis de Allard,-1205454,-1178942,2022-12-08
CASH_IN,139982,Agence_mtn_Abomey,300000,160018,Françoise Denis de Allard,-1178942,-1038960,2022-12-09
CASH_IN,125341,Agence_mtn_Ouidah,300000,174659,Françoise Denis de Allard,-1038960,-913619,2022-12-12
CASH_IN,141545,Agence_mtn_Ouidah,300000,158455,Françoise Denis de Allard,-913619,-772074,2022-12-15
CASH_IN,2398,Agence_mtn_Cotonou,300000,297602,Françoise Denis de Allard,-772074,-769676,2022-12-16
CASH_IN,209752,Agence_mtn_Ouidah,300000,90248,Françoise Denis de Allard,-769676,-559924,2022-12-20
CASH_IN,164746,Agence_mtn_Abomey,300000,135254,Françoise Denis de Allard,-559924,-395178,2022-12-20
CASH_IN,165238,Agence_mtn_Cotonou,300000,134762,Maurice de Brunet,-1333521,-1168283,2022-12-03
CASH_IN,212737,Agence_mtn_Abomey,300000,87263,Maurice de Brunet,-1168283,-955546,2022-12-04
CASH_IN,83970,Agence_mtn_Cotonou,300000,216030,Maurice de Brunet,-955546,-871576,2022-12-04
CASH_IN,38460,Agence_mtn_Cotonou,300000,261540,Maurice de Brunet,-871576,-833116,2022-12-09
CASH_IN,117383,Agence_mtn_Ouidah,300000,182617,Maurice de Brunet,-833116,-715733,2022-12-09
CASH_IN,37601,Agence_mtn_Ouidah,300000,262399,Maurice de Brunet,-715733,-678132,2022-12-10
CASH_IN,195272,Agence_mtn_Ouidah,300000,104728,Maurice de Brunet,-678132,-482860,2022-12-11
CASH_IN,49435,Agence_mtn_Ouidah,300000,250565,Maurice de Brunet,-482860,-433425,2022-12-12
CASH_IN,278364,Agence_mtn_Cotonou,300000,21636,Maurice de Brunet,-433425,-155061,2022-12-13
CASH_IN,31229,Agence_mtn_Cotonou,300000,268771,Maurice de Brunet,-155061,-123832,2022-12-19
CASH_IN,273138,Agence_mtn_Abomey,300000,26862,Maurice de Brunet,-123832,149306,2022-12-23
CASH_OUT,111188,Maurice de Brunet,149306,38118,Agence_mtn_Abomey,300000,188812,2022-12-24
CASH_IN,18485,Agence_mtn_Abomey,300000,281515,Maurice de Brunet,38118,56603,2022-12-24
CASH_IN,100719,Agence_mtn_Cotonou,300000,199281,Céline-Inès Meunier,-16512,84207,2022-12-01
CASH_IN,110867,Agence_mtn_Abomey,300000,189133,Céline-Inès Meunier,84207,195074,2022-12-01
CASH_OUT,191068,Céline-Inès Meunier,195074,4006,Agence_mtn_Abomey,300000,108932,2022-12-02
CASH_IN,137503,Agence_mtn_Ouidah,300000,162497,Céline-Inès Meunier,4006,141509,2022-12-06
CASH_IN,240759,Agence_mtn_Ouidah,300000,59241,Céline-Inès Meunier,141509,382268,2022-12-07
TRANSFER,318794,Céline-Inès Meunier,382268,63474,Céline-Inès Meunier,382268,701062,2022-12-08
CASH_IN,267042,Agence_mtn_Cotonou,300000,32958,Céline-Inès Meunier,63474,330516,2022-12-10
TRANSFER,135851,Jacques Marchand,340144,204293,Céline-Inès Meunier,330516,466367,2022-12-11
CASH_OUT,440456,Céline-Inès Meunier,466367,25911,Agence_mtn_Ouidah,300000,-140456,2022-12-14
TRANSFER,25303,Céline-Inès Meunier,25911,608,Sophie-Anouk Boulanger,1262,-24041,2022-12-14
CASH_IN,221880,Agence_mtn_Abomey,300000,78120,Céline-Inès Meunier,608,222488,2022-12-15
CASH_IN,150908,Agence_mtn_Ouidah,300000,149092,Céline-Inès Meunier,222488,373396,2022-12-21
CASH_IN,223208,Agence_mtn_Ouidah,300000,76792,Céline-Inès Meunier,373396,596604,2022-12-21
CASH_OUT,593764,Céline-Inès Meunier,596604,2840,Agence_mtn_Cotonou,300000,-293764,2022-12-22
CASH_OUT,977,Céline-Inès Meunier,2840,1863,Agence_mtn_Ouidah,300000,299023,2022-12-24
TRANSFER,64291,Gérard Blot de Blanc,468922,404631,Céline-Inès Meunier,1863,66154,2022-12-24
TRANSFER,31390,Thérèse-Juliette Camus,39823,8433,Céline-Inès Meunier,66154,97544,2022-12-25
CASH_IN,102980,Agence_mtn_Ouidah,300000,197020,Céline-Inès Meunier,97544,200524,2022-12-26
CASH_IN,86579,Agence_mtn_Cotonou,300000,213421,Julie Germain Le Vaillant,-139206,-52627,2022-12-01
CASH_IN,49452,Agence_mtn_Abomey,300000,250548,Julie Germain Le Vaillant,-52627,-3175,2022-12-01
CASH_IN,286423,Agence_mtn_Abomey,300000,13577,Julie Germain Le Vaillant,-3175,283248,2022-12-03
CASH_IN,74466,Agence_mtn_Ouidah,300000,225534,Julie Germain Le Vaillant,283248,357714,2022-12-04
CASH_IN,237177,Agence_mtn_Abomey,300000,62823,Julie Germain Le Vaillant,357714,594891,2022-12-08
CASH_OUT,394414,Julie Germain Le Vaillant,594891,200477,Agence_mtn_Cotonou,300000,-94414,2022-12-10
TRANSFER,7920,Maggie Barbier,11657,3737,Julie Germain Le Vaillant,200477,208397,2022-12-18
TRANSFER,138089,Julie Germain Le Vaillant,208397,70308,Maggie Barbier,3737,-134352,2022-12-22
CASH_IN,183365,Agence_mtn_Cotonou,300000,116635,Julie Germain Le Vaillant,70308,253673,2022-12-22
CASH_IN,175217,Agence_mtn_Ouidah,300000,124783,Julie Germain Le Vaillant,253673,428890,2022-12-24
CASH_IN,27398,Agence_mtn_Cotonou,300000,272602,Josette du Hamon,-205823,-178425,2022-12-05
CASH_IN,266029,Agence_mtn_Cotonou,300000,33971,Josette du Hamon,-178425,87604,2022-12-11
CASH_IN,107992,Agence_mtn_Abomey,300000,192008,Josette du Hamon,87604,195596,2022-12-13
TRANSFER,102019,Josette du Hamon,195596,93577,Thérèse-Juliette Camus,8433,-93586,2022-12-17
CASH_OUT,39838,Josette du Hamon,93577,53739,Agence_mtn_Abomey,300000,260162,2022-12-19
CASH_IN,221558,Agence_mtn_Abomey,300000,78442,Josette du Hamon,53739,275297,2022-12-19
CASH_IN,40337,Agence_mtn_Abomey,300000,259663,Josette du Hamon,275297,315634,2022-12-20
TRANSFER,101744,Josette du Hamon,315634,213890,Gérard Blot de Blanc,404631,302887,2022-12-24
CASH_IN,103141,Agence_mtn_Cotonou,300000,196859,Danielle-Henriette Tessier,-388684,-285543,2022-12-01
CASH_IN,138394,Agence_mtn_Ouidah,300000,161606,Danielle-Henriette Tessier,-285543,-147149,2022-12-02
CASH_IN,290575,Agence_mtn_Abomey,300000,9425,Danielle-Henriette Tessier,-147149,143426,2022-12-06
CASH_IN,164685,Agence_mtn_Ouidah,300000,135315,Danielle-Henriette Tessier,143426,308111,2022-12-08
CASH_OUT,147741,Danielle-Henriette Tessier,308111,160370,Agence_mtn_Abomey,300000,152259,2022-12-08
TRANSFER,79537,Danielle-Henriette Tessier,160370,80833,Jacques Marchand,204293,124756,2022-12-09
CASH_IN,229102,Agence_mtn_Ouidah,300000,70898,Danielle-Henriette Tessier,80833,309935,2022-12-11
CASH_IN,135047,Agence_mtn_Ouidah,300000,164953,Danielle-Henriette Tessier,309935,444982,2022-12-13
CASH_IN,258147,Agence_mtn_Cotonou,300000,41853,Danielle-Henriette Tessier,444982,703129,2022-12-16
CASH_IN,116594,Agence_mtn_Ouidah,300000,183406,Danielle-Henriette Tessier,703129,819723,2022-12-16
CASH_OUT,759921,Danielle-Henriette Tessier,819723,59802,Agence_mtn_Abomey,300000,-459921,2022-12-16
TRANSFER,55745,Danielle-Henriette Tessier,59802,4057,Gérard Blot de Blanc,302887,247142,2022-12-21
CASH_IN,56552,Agence_mtn_Cotonou,300000,243448,Danielle-Henriette Tessier,4057,60609,2022-12-22
TRANSFER,5685,Gérard Blot de Blanc,247142,241457,Danielle-Henriette Tessier,60609,66294,2022-12-27
CASH_IN,113158,Agence_mtn_Ouidah,300000,186842,Roger-Roger Delmas,-524880,-411722,2022-12-02
CASH_IN,197903,Agence_mtn_Ouidah,300000,102097,Roger-Roger Delmas,-411722,-213819,2022-12-04
CASH_IN,96860,Agence_mtn_Cotonou,300000,203140,Roger-Roger Delmas,-213819,-116959,2022-12-04
CASH_IN,121022,Agence_mtn_Cotonou,300000,178978,Roger-Roger Delmas,-116959,4063,2022-12-11
TRANSFER,3739,Roger-Roger Delmas,4063,324,Jacques Marchand,124756,121017,2022-12-14
CASH_OUT,178,Roger-Roger Delmas,324,146,Agence_mtn_Ouidah,300000,299822,2022-12-14
CASH_IN,207476,Agence_mtn_Ouidah,300000,92524,Roger-Roger Delmas,146,207622,2022-12-20
CASH_OUT,162555,Roger-Roger Delmas,207622,45067,Agence_mtn_Abomey,300000,137445,2022-12-21
CASH_IN,55359,Agence_mtn_Abomey,300000,244641,Marcel de la Buisson,-25623,29736,2022-12-02
CASH_IN,94534,Agence_mtn_Cotonou,300000,205466,Marcel de la Buisson,29736,124270,2022-12-06
CASH_OUT,5914,Marcel de la Buisson,124270,118356,Agence_mtn_Cotonou,300000,294086,2022-12-06
TRANSFER,39318,Marcel de la Buisson,118356,79038,Marcel de la Buisson,118356,157674,2022-12-08
TRANSFER,26615,Marcel de la Buisson,79038,52423,Jacques Marchand,121017,94402,2022-12-10
TRANSFER,25409,Marcel de la Buisson,52423,27014,Marcel de la Buisson,52423,77832,2022-12-11
TRANSFER,124590,Gérard Blot de Blanc,241457,116867,Marcel de la Buisson,27014,151604,2022-12-12
TRANSFER,131109,Marcel de la Buisson,151604,20495,Gérard Blot de Blanc,116867,-14242,2022-12-12
TRANSFER,19706,Jacques Marchand,94402,74696,Marcel de la Buisson,20495,40201,2022-12-15
CASH_IN,99337,Agence_mtn_Ouidah,300000,200663,Marcel de la Buisson,40201,139538,2022-12-19
CASH_OUT,127544,Marcel de la Buisson,139538,11994,Agence_mtn_Ouidah,300000,172456,2022-12-22
TRANSFER,1283,Jacques Marchand,74696,73413,Marcel de la Buisson,11994,13277,2022-12-23
CASH_OUT,13236,Marcel de la Buisson,13277,41,Agence_mtn_Abomey,300000,286764,2022-12-23
CASH_IN,264951,Agence_mtn_Ouidah,300000,35049,Marcel de la Buisson,41,264992,2022-12-23
TRANSFER,41094,Jacques Marchand,73413,32319,Marcel de la Buisson,264992,306086,2022-12-24
CASH_IN,2762,Agence_mtn_Ouidah,300000,297238,Marcel de la Buisson,306086,308848,2022-12-27
CASH_IN,161029,Agence_mtn_Abomey,300000,138971,Matthieu Cousin,-29369,131660,2022-12-02
CASH_OUT,129613,Matthieu Cousin,131660,2047,Agence_mtn_Ouidah,300000,170387,2022-12-05
CASH_IN,285559,Agence_mtn_Ouidah,300000,14441,Matthieu Cousin,2047,287606,2022-12-10
TRANSFER,273759,Matthieu Cousin,287606,13847,Matthieu Cousin,287606,561365,2022-12-12
TRANSFER,12885,Matthieu Cousin,13847,962,Jacques Marchand,32319,19434,2022-12-17
CASH_OUT,632,Matthieu Cousin,962,330,Agence_mtn_Abomey,300000,299368,2022-12-21
CASH_OUT,271,Matthieu Cousin,330,59,Agence_mtn_Abomey,300000,299729,2022-12-21
CASH_IN,76573,Agence_mtn_Ouidah,300000,223427,Matthieu Cousin,59,76632,2022-12-22
CASH_OUT,52967,Matthieu Cousin,76632,23665,Agence_mtn_Ouidah,300000,247033,2022-12-25
CASH_OUT,6973,Matthieu Cousin,23665,16692,Agence_mtn_Cotonou,300000,293027,2022-12-27
CASH_IN,264502,Agence_mtn_Cotonou,300000,35498,François Vaillant,-190394,74108,2022-12-01
CASH_OUT,19909,François Vaillant,74108,54199,Agence_mtn_Cotonou,300000,280091,2022-12-02
CASH_IN,227754,Agence_mtn_Cotonou,300000,72246,François Vaillant,54199,281953,2022-12-02
TRANSFER,169603,François Vaillant,281953,112350,François Vaillant,281953,451556,2022-12-03
CASH_OUT,110398,François Vaillant,112350,1952,Agence_mtn_Cotonou,300000,189602,2022-12-09
CASH_IN,41398,Agence_mtn_Ouidah,300000,258602,François Vaillant,1952,43350,2022-12-13
CASH_OUT,27275,François Vaillant,43350,16075,Agence_mtn_Abomey,300000,272725,2022-12-13
CASH_OUT,14122,François Vaillant,16075,1953,Agence_mtn_Cotonou,300000,285878,2022-12-17
TRANSFER,257,François Vaillant,1953,1696,Jacques Marchand,19434,19177,2022-12-17
CASH_IN,258474,Agence_mtn_Cotonou,300000,41526,François Vaillant,1696,260170,2022-12-18
CASH_OUT,175858,François Vaillant,260170,84312,Agence_mtn_Ouidah,300000,124142,2022-12-19
CASH_OUT,19560,François Vaillant,84312,64752,Agence_mtn_Ouidah,300000,280440,2022-12-19
TRANSFER,23218,François Vaillant,64752,41534,Jacques Marchand,19177,-4041,2022-12-21
CASH_OUT,27662,François Vaillant,41534,13872,Agence_mtn_Ouidah,300000,272338,2022-12-27
CASH_IN,19281,Agence_mtn_Cotonou,300000,280719,Henri de Didier,-223322,-204041,2022-12-02
CASH_IN,244106,Agence_mtn_Ouidah,300000,55894,Henri de Didier,-204041,40065,2022-12-04
CASH_OUT,33842,Henri de Didier,40065,6223,Agence_mtn_Ouidah,300000,266158,2022-12-05
CASH_IN,244605,Agence_mtn_Ouidah,300000,55395,Henri de Didier,6223,250828,2022-12-07
TRANSFER,109907,Henri de Didier,250828,140921,Henri de Didier,250828,360735,2022-12-11
CASH_OUT,48950,Henri de Didier,140921,91971,Agence_mtn_Abomey,300000,251050,2022-12-12
CASH_OUT,83274,Henri de Didier,91971,8697,Agence_mtn_Abomey,300000,216726,2022-12-14
TRANSFER,5211,Henri de Didier,8697,3486,Henri de Didier,8697,3486,2022-12-16
CASH_OUT,2392,Henri de Didier,3486,1094,Agence_mtn_Abomey,300000,297608,2022-12-19
CASH_OUT,442,Henri de Didier,1094,652,Agence_mtn_Cotonou,300000,299558,2022-12-19
CASH_OUT,512,Henri de Didier,652,140,Agence_mtn_Cotonou,300000,299488,2022-12-26
CASH_OUT,107,Henri de Didier,140,33,Agence_mtn_Cotonou,300000,299893,2022-12-27
CASH_IN,201344,Agence_mtn_Cotonou,300000,98656,Raymond-Yves Boulanger,-266212,-64868,2022-12-05
CASH_IN,113420,Agence_mtn_Ouidah,300000,186580,Raymond-Yves Boulanger,-64868,48552,2022-12-08
CASH_IN,184520,Agence_mtn_Abomey,300000,115480,Raymond-Yves Boulanger,48552,233072,2022-12-10
CASH_OUT,56048,Raymond-Yves Boulanger,233072,177024,Agence_mtn_Abomey,300000,243952,2022-12-11
TRANSFER,113731,Raymond-Yves Boulanger,177024,63293,Raymond-Yves Boulanger,177024,290755,2022-12-11
CASH_IN,102468,Agence_mtn_Ouidah,300000,197532,Raymond-Yves Boulanger,63293,165761,2022-12-12
CASH_OUT,87037,Raymond-Yves Boulanger,165761,78724,Agence_mtn_Abomey,300000,212963,2022-12-13
CASH_OUT,27327,Raymond-Yves Boulanger,78724,51397,Agence_mtn_Abomey,300000,272673,2022-12-14
CASH_IN,189753,Agence_mtn_Cotonou,300000,110247,Raymond-Yves Boulanger,51397,241150,2022-12-17
CASH_OUT,175699,Raymond-Yves Boulanger,241150,65451,Agence_mtn_Cotonou,300000,124301,2022-12-19
CASH_OUT,1582,Raymond-Yves Boulanger,65451,63869,Agence_mtn_Ouidah,300000,298418,2022-12-27
CASH_IN,158162,Agence_mtn_Abomey,300000,141838,Thérèse-Juliette Camus,-93586,64576,2022-12-01
CASH_IN,242653,Agence_mtn_Ouidah,300000,57347,Thérèse-Juliette Camus,64576,307229,2022-12-02
CASH_IN,204579,Agence_mtn_Cotonou,300000,95421,Thérèse-Juliette Camus,307229,511808,2022-12-04
TRANSFER,384647,Thérèse-Juliette Camus,511808,127161,Thérèse-Juliette Camus,511808,896455,2022-12-05
TRANSFER,22516,Thérèse-Juliette Camus,127161,104645,Thérèse-Juliette Camus,127161,104645,2022-12-06
CASH_IN,82286,Agence_mtn_Ouidah,300000,217714,Thérèse-Juliette Camus,104645,186931,2022-12-07
TRANSFER,81922,Thérèse-Juliette Camus,186931,105009,Thérèse-Juliette Camus,186931,105009,2022-12-07
CASH_OUT,103887,Thérèse-Juliette Camus,105009,1122,Agence_mtn_Cotonou,300000,196113,2022-12-13
CASH_IN,56087,Agence_mtn_Cotonou,300000,243913,Thérèse-Juliette Camus,1122,57209,2022-12-17
CASH_OUT,17086,Thérèse-Juliette Camus,57209,40123,Agence_mtn_Ouidah,300000,282914,2022-12-21
CASH_OUT,25648,Thérèse-Juliette Camus,40123,14475,Agence_mtn_Cotonou,300000,274352,2022-12-23
CASH_IN,30235,Agence_mtn_Abomey,300000,269765,Thérèse-Juliette Camus,14475,44710,2022-12-26
CASH_IN,10071,Agence_mtn_Cotonou,300000,289929,Thérèse-Juliette Camus,44710,54781,2022-12-27
CASH_IN,245171,Agence_mtn_Cotonou,300000,54829,Sophie-Anouk Boulanger,-24041,221130,2022-12-01
CASH_IN,114095,Agence_mtn_Abomey,300000,185905,Sophie-Anouk Boulanger,221130,335225,2022-12-04
CASH_OUT,126373,Sophie-Anouk Boulanger,335225,208852,Agence_mtn_Cotonou,300000,173627,2022-12-05
CASH_IN,273323,Agence_mtn_Abomey,300000,26677,Sophie-Anouk Boulanger,208852,482175,2022-12-06
TRANSFER,412131,Sophie-Anouk Boulanger,482175,70044,Sophie-Anouk Boulanger,482175,894306,2022-12-06
CASH_IN,260236,Agence_mtn_Ouidah,300000,39764,Sophie-Anouk Boulanger,70044,330280,2022-12-07
CASH_OUT,251763,Sophie-Anouk Boulanger,330280,78517,Agence_mtn_Abomey,300000,48237,2022-12-12
CASH_OUT,16670,Sophie-Anouk Boulanger,78517,61847,Agence_mtn_Ouidah,300000,283330,2022-12-13
CASH_IN,103142,Agence_mtn_Abomey,300000,196858,Sophie-Anouk Boulanger,61847,164989,2022-12-18
CASH_OUT,164927,Sophie-Anouk Boulanger,164989,62,Agence_mtn_Abomey,300000,135073,2022-12-20
CASH_IN,228788,Agence_mtn_Ouidah,300000,71212,Sophie-Anouk Boulanger,62,228850,2022-12-21
CASH_OUT,157372,Sophie-Anouk Boulanger,228850,71478,Agence_mtn_Abomey,300000,142628,2022-12-23
CASH_OUT,68026,Sophie-Anouk Boulanger,71478,3452,Agence_mtn_Abomey,300000,231974,2022-12-25
CASH_IN,115665,Agence_mtn_Abomey,300000,184335,Simone du Allard,-415548,-299883,2022-12-01
CASH_IN,148082,Agence_mtn_Ouidah,300000,151918,Simone du Allard,-299883,-151801,2022-12-02
CASH_IN,175972,Agence_mtn_Cotonou,300000,124028,Simone du Allard,-151801,24171,2022-12-03
TRANSFER,10216,Simone du Allard,24171,13955,Simone du Allard,24171,13955,2022-12-05
CASH_OUT,12730,Simone du Allard,13955,1225,Agence_mtn_Abomey,300000,287270,2022-12-05
TRANSFER,315,Simone du Allard,1225,910,Simone du Allard,1225,1540,2022-12-07
CASH_OUT,354,Simone du Allard,910,556,Agence_mtn_Abomey,300000,299646,2022-12-09
CASH_OUT,463,Simone du Allard,556,93,Agence_mtn_Abomey,300000,299537,2022-12-09
CASH_IN,89365,Agence_mtn_Abomey,300000,210635,Simone du Allard,93,89458,2022-12-11
TRANSFER,22280,Simone du Allard,89458,67178,Simone du Allard,89458,67178,2022-12-12
CASH_IN,149153,Agence_mtn_Ouidah,300000,150847,Simone du Allard,67178,216331,2022-12-13
CASH_OUT,42243,Simone du Allard,216331,174088,Agence_mtn_Abomey,300000,257757,2022-12-18
CASH_IN,149733,Agence_mtn_Cotonou,300000,150267,Simone du Allard,174088,323821,2022-12-18
CASH_OUT,111408,Simone du Allard,323821,212413,Agence_mtn_Cotonou,300000,188592,2022-12-20
CASH_IN,27175,Agence_mtn_Cotonou,300000,272825,Simone du Allard,212413,239588,2022-12-24
CASH_OUT,145461,Simone du Allard,239588,94127,Agence_mtn_Cotonou,300000,154539,2022-12-26
CASH_IN,263077,Agence_mtn_Cotonou,300000,36923,Simone du Allard,94127,357204,2022-12-27
CASH_IN,186366,Agence_mtn_Cotonou,300000,113634,Jacques Marchand,-4041,182325,2022-12-01
CASH_IN,25763,Agence_mtn_Ouidah,300000,274237,Jacques Marchand,182325,208088,2022-12-01
CASH_IN,25406,Agence_mtn_Abomey,300000,274594,Jacques Marchand,208088,233494,2022-12-02
CASH_OUT,7501,Jacques Marchand,233494,225993,Agence_mtn_Ouidah,300000,292499,2022-12-04
CASH_OUT,198304,Jacques Marchand,225993,27689,Agence_mtn_Ouidah,300000,101696,2022-12-05
CASH_IN,267970,Agence_mtn_Cotonou,300000,32030,Jacques Marchand,27689,295659,2022-12-06
CASH_OUT,112390,Jacques Marchand,295659,183269,Agence_mtn_Ouidah,300000,187610,2022-12-07
CASH_OUT,13698,Jacques Marchand,183269,169571,Agence_mtn_Cotonou,300000,286302,2022-12-09
CASH_IN,205774,Agence_mtn_Ouidah,300000,94226,Jacques Marchand,169571,375345,2022-12-11
CASH_OUT,192684,Jacques Marchand,375345,182661,Agence_mtn_Ouidah,300000,107316,2022-12-16
CASH_IN,135687,Agence_mtn_Cotonou,300000,164313,Jacques Marchand,182661,318348,2022-12-17
CASH_IN,130271,Agence_mtn_Cotonou,300000,169729,Jacques Marchand,318348,448619,2022-12-17
CASH_IN,119150,Agence_mtn_Ouidah,300000,180850,Jacques Marchand,448619,567769,2022-12-18
CASH_IN,116197,Agence_mtn_Cotonou,300000,183803,Jacques Marchand,567769,683966,2022-12-24
CASH_IN,240787,Agence_mtn_Ouidah,300000,59213,Jacques Marchand,683966,924753,2022-12-26
CASH_IN,126278,Agence_mtn_Ouidah,300000,173722,Louis de la Imbert,-988898,-862620,2022-12-02
CASH_IN,234973,Agence_mtn_Ouidah,300000,65027,Louis de la Imbert,-862620,-627647,2022-12-03
CASH_IN,192104,Agence_mtn_Abomey,300000,107896,Louis de la Imbert,-627647,-435543,2022-12-06
CASH_IN,20843,Agence_mtn_Abomey,300000,279157,Louis de la Imbert,-435543,-414700,2022-12-07
CASH_IN,36712,Agence_mtn_Abomey,300000,263288,Louis de la Imbert,-414700,-377988,2022-12-09
CASH_IN,269680,Agence_mtn_Abomey,300000,30320,Louis de la Imbert,-377988,-108308,2022-12-09
CASH_IN,208411,Agence_mtn_Abomey,300000,91589,Louis de la Imbert,-108308,100103,2022-12-09
CASH_IN,262608,Agence_mtn_Abomey,300000,37392,Louis de la Imbert,100103,362711,2022-12-09
CASH_IN,268139,Agence_mtn_Abomey,300000,31861,Louis de la Imbert,362711,630850,2022-12-10
TRANSFER,224790,Louis de la Imbert,630850,406060,Louis de la Imbert,630850,855640,2022-12-11
CASH_OUT,205736,Louis de la Imbert,406060,200324,Agence_mtn_Ouidah,300000,94264,2022-12-11
CASH_OUT,197629,Louis de la Imbert,200324,2695,Agence_mtn_Cotonou,300000,102371,2022-12-11
CASH_IN,171015,Agence_mtn_Ouidah,300000,128985,Louis de la Imbert,2695,173710,2022-12-13
CASH_OUT,50633,Louis de la Imbert,173710,123077,Agence_mtn_Ouidah,300000,249367,2022-12-15
TRANSFER,68650,Louis de la Imbert,123077,54427,Louis de la Imbert,123077,191727,2022-12-15
CASH_IN,42853,Agence_mtn_Ouidah,300000,257147,Louis de la Imbert,54427,97280,2022-12-16
CASH_OUT,72250,Louis de la Imbert,97280,25030,Agence_mtn_Ouidah,300000,227750,2022-12-17
CASH_OUT,5607,Louis de la Imbert,25030,19423,Agence_mtn_Ouidah,300000,294393,2022-12-20
CASH_OUT,17466,Louis de la Imbert,19423,1957,Agence_mtn_Ouidah,300000,282534,2022-12-22
CASH_IN,127175,Agence_mtn_Cotonou,300000,172825,Aimé Bernier,-259279,-132104,2022-12-04
CASH_IN,190623,Agence_mtn_Abomey,300000,109377,Aimé Bernier,-132104,58519,2022-12-10
CASH_IN,75770,Agence_mtn_Cotonou,300000,224230,Aimé Bernier,58519,134289,2022-12-14
TRANSFER,6869,Aimé Bernier,134289,127420,Aimé Bernier,134289,141158,2022-12-14
CASH_IN,141332,Agence_mtn_Abomey,300000,158668,Aimé Bernier,127420,268752,2022-12-16
CASH_OUT,28932,Aimé Bernier,268752,239820,Agence_mtn_Abomey,300000,271068,2022-12-18
CASH_IN,75999,Agence_mtn_Abomey,300000,224001,Aimé Bernier,239820,315819,2022-12-18
CASH_IN,79989,Agence_mtn_Abomey,300000,220011,Aimé Bernier,315819,395808,2022-12-20
CASH_IN,129987,Agence_mtn_Cotonou,300000,170013,Aimé Bernier,395808,525795,2022-12-27
CASH_IN,114550,Agence_mtn_Ouidah,300000,185450,Maggie Barbier,-134352,-19802,2022-12-05
CASH_IN,29411,Agence_mtn_Abomey,300000,270589,Maggie Barbier,-19802,9609,2022-12-05
CASH_OUT,1046,Maggie Barbier,9609,8563,Agence_mtn_Abomey,300000,298954,2022-12-06
CASH_IN,155600,Agence_mtn_Abomey,300000,144400,Maggie Barbier,8563,164163,2022-12-06
CASH_IN,104174,Agence_mtn_Ouidah,300000,195826,Maggie Barbier,164163,268337,2022-12-07
CASH_OUT,239947,Maggie Barbier,268337,28390,Agence_mtn_Ouidah,300000,60053,2022-12-08
CASH_OUT,16913,Maggie Barbier,28390,11477,Agence_mtn_Cotonou,300000,283087,2022-12-10
CASH_OUT,8221,Maggie Barbier,11477,3256,Agence_mtn_Cotonou,300000,291779,2022-12-10
CASH_IN,263424,Agence_mtn_Ouidah,300000,36576,Maggie Barbier,3256,266680,2022-12-10
CASH_OUT,182797,Maggie Barbier,266680,83883,Agence_mtn_Abomey,300000,117203,2022-12-19
CASH_IN,284902,Agence_mtn_Cotonou,300000,15098,Maggie Barbier,83883,368785,2022-12-23
CASH_IN,276869,Agence_mtn_Abomey,300000,23131,Maggie Barbier,368785,645654,2022-12-24
CASH_IN,82579,Agence_mtn_Ouidah,300000,217421,Maggie Barbier,645654,728233,2022-12-25
CASH_OUT,212058,Maggie Barbier,728233,516175,Agence_mtn_Abomey,300000,87942,2022-12-25
CASH_IN,228561,Agence_mtn_Ouidah,300000,71439,Madeleine Hardy,-135523,93038,2022-12-02
TRANSFER,36292,Madeleine Hardy,93038,56746,Madeleine Hardy,93038,56746,2022-12-03
CASH_IN,210715,Agence_mtn_Ouidah,300000,89285,Madeleine Hardy,56746,267461,2022-12-06
TRANSFER,213999,Madeleine Hardy,267461,53462,Madeleine Hardy,267461,53462,2022-12-08
CASH_OUT,35894,Madeleine Hardy,53462,17568,Agence_mtn_Ouidah,300000,264106,2022-12-14
CASH_IN,196808,Agence_mtn_Cotonou,300000,103192,Madeleine Hardy,17568,214376,2022-12-14
CASH_IN,5553,Agence_mtn_Cotonou,300000,294447,Madeleine Hardy,214376,219929,2022-12-18
CASH_IN,86612,Agence_mtn_Ouidah,300000,213388,Madeleine Hardy,219929,306541,2022-12-21
CASH_IN,140484,Agence_mtn_Abomey,300000,159516,Madeleine Hardy,306541,447025,2022-12-27
CASH_IN,74585,Agence_mtn_Ouidah,300000,225415,Thibault Martin,-326726,-252141,2022-12-01
CASH_IN,115085,Agence_mtn_Ouidah,300000,184915,Thibault Martin,-252141,-137056,2022-12-03
CASH_IN,237855,Agence_mtn_Ouidah,300000,62145,Thibault Martin,-137056,100799,2022-12-04
CASH_IN,104324,Agence_mtn_Cotonou,300000,195676,Thibault Martin,100799,205123,2022-12-04
CASH_IN,48740,Agence_mtn_Cotonou,300000,251260,Thibault Martin,205123,253863,2022-12-08
CASH_IN,203982,Agence_mtn_Abomey,300000,96018,Thibault Martin,253863,457845,2022-12-11
CASH_OUT,334977,Thibault Martin,457845,122868,Agence_mtn_Cotonou,300000,-34977,2022-12-11
TRANSFER,73715,Thibault Martin,122868,49153,Thibault Martin,122868,196583,2022-12-16
CASH_IN,212388,Agence_mtn_Abomey,300000,87612,Thibault Martin,49153,261541,2022-12-16
TRANSFER,250566,Thibault Martin,261541,10975,Thibault Martin,261541,10975,2022-12-17
TRANSFER,6753,Thibault Martin,10975,4222,Thibault Martin,10975,17728,2022-12-19
CASH_OUT,1141,Thibault Martin,4222,3081,Agence_mtn_Abomey,300000,298859,2022-12-20
CASH_IN,14192,Agence_mtn_Cotonou,300000,285808,Thibault Martin,3081,17273,2022-12-25
CASH_OUT,127,Thibault Martin,17273,17146,Agence_mtn_Ouidah,300000,299873,2022-12-25
CASH_IN,21923,Agence_mtn_Ouidah,300000,278077,Thibault Martin,17146,39069,2022-12-26
CASH_IN,181784,Agence_mtn_Ouidah,300000,118216,Marc Costa-Daniel,-61709,120075,2022-12-01
CASH_OUT,62752,Marc Costa-Daniel,120075,57323,Agence_mtn_Ouidah,300000,237248,2022-12-02
CASH_OUT,41184,Marc Costa-Daniel,57323,16139,Agence_mtn_Ouidah,300000,258816,2022-12-02
CASH_IN,35971,Agence_mtn_Cotonou,300000,264029,Marc Costa-Daniel,16139,52110,2022-12-03
CASH_IN,155545,Agence_mtn_Ouidah,300000,144455,Marc Costa-Daniel,52110,207655,2022-12-03
CASH_OUT,197807,Marc Costa-Daniel,207655,9848,Agence_mtn_Cotonou,300000,102193,2022-12-08
TRANSFER,8705,Marc Costa-Daniel,9848,1143,Marc Costa-Daniel,9848,18553,2022-12-10
CASH_OUT,246,Marc Costa-Daniel,1143,897,Agence_mtn_Abomey,300000,299754,2022-12-15
CASH_IN,295163,Agence_mtn_Cotonou,300000,4837,Marc Costa-Daniel,897,296060,2022-12-18
CASH_IN,44105,Agence_mtn_Cotonou,300000,255895,Marc Costa-Daniel,296060,340165,2022-12-23
CASH_OUT,250105,Marc Costa-Daniel,340165,90060,Agence_mtn_Ouidah,300000,49895,2022-12-24
CASH_IN,225376,Agence_mtn_Ouidah,300000,74624,Augustin-Jérôme Merle,-241361,-15985,2022-12-01
CASH_IN,254691,Agence_mtn_Cotonou,300000,45309,Augustin-Jérôme Merle,-15985,238706,2022-12-04
CASH_IN,103622,Agence_mtn_Ouidah,300000,196378,Augustin-Jérôme Merle,238706,342328,2022-12-06
CASH_OUT,238863,Augustin-Jérôme Merle,342328,103465,Agence_mtn_Ouidah,300000,61137,2022-12-06
CASH_OUT,40381,Augustin-Jérôme Merle,103465,63084,Agence_mtn_Cotonou,300000,259619,2022-12-08
CASH_IN,107633,Agence_mtn_Ouidah,300000,192367,Augustin-Jérôme Merle,63084,170717,2022-12-09
TRANSFER,42874,Augustin-Jérôme Merle,170717,127843,Augustin-Jérôme Merle,170717,127843,2022-12-10
CASH_IN,264930,Agence_mtn_Abomey,300000,35070,Augustin-Jérôme Merle,127843,392773,2022-12-11
TRANSFER,189637,Augustin-Jérôme Merle,392773,203136,Augustin-Jérôme Merle,392773,203136,2022-12-15
CASH_IN,37362,Agence_mtn_Cotonou,300000,262638,Augustin-Jérôme Merle,203136,240498,2022-12-18
CASH_IN,268723,Agence_mtn_Ouidah,300000,31277,Augustin-Jérôme Merle,240498,509221,2022-12-19
CASH_OUT,474527,Augustin-Jérôme Merle,509221,34694,Agence_mtn_Cotonou,300000,-174527,2022-12-22
CASH_OUT,1739,Augustin-Jérôme Merle,34694,32955,Agence_mtn_Cotonou,300000,298261,2022-12-26
CASH_IN,112327,Agence_mtn_Ouidah,300000,187673,Gérard Blot de Blanc,-14242,98085,2022-12-03
TRANSFER,18216,Gérard Blot de Blanc,98085,79869,Gérard Blot de Blanc,98085,116301,2022-12-05
CASH_IN,235116,Agence_mtn_Ouidah,300000,64884,Gérard Blot de Blanc,79869,314985,2022-12-08
CASH_IN,14208,Agence_mtn_Ouidah,300000,285792,Gérard Blot de Blanc,314985,329193,2022-12-09
CASH_IN,89296,Agence_mtn_Ouidah,300000,210704,Gérard Blot de Blanc,329193,418489,2022-12-10
CASH_IN,85742,Agence_mtn_Cotonou,300000,214258,Gérard Blot de Blanc,418489,504231,2022-12-13
CASH_IN,5056,Agence_mtn_Cotonou,300000,294944,Gérard Blot de Blanc,504231,509287,2022-12-13
TRANSFER,420593,Gérard Blot de Blanc,509287,88694,Gérard Blot de Blanc,509287,929880,2022-12-14
CASH_OUT,69859,Gérard Blot de Blanc,88694,18835,Agence_mtn_Ouidah,300000,230141,2022-12-17
CASH_OUT,4596,Gérard Blot de Blanc,18835,14239,Agence_mtn_Abomey,300000,295404,2022-12-19
CASH_IN,167603,Agence_mtn_Abomey,300000,132397,Gérard Blot de Blanc,14239,181842,2022-12-19
CASH_OUT,177579,Gérard Blot de Blanc,181842,4263,Agence_mtn_Abomey,300000,122421,2022-12-21
CASH_IN,41451,Agence_mtn_Ouidah,300000,258549,Gérard Blot de Blanc,4263,45714,2022-12-26
CASH_IN,115264,Agence_mtn_Ouidah,300000,184736,Emmanuel Vallée,-760101,-644837,2022-12-01
CASH_IN,67901,Agence_mtn_Abomey,300000,232099,Emmanuel Vallée,-644837,-576936,2022-12-01
CASH_IN,147070,Agence_mtn_Cotonou,300000,152930,Emmanuel Vallée,-576936,-429866,2022-12-01
CASH_IN,245504,Agence_mtn_Abomey,300000,54496,Emmanuel Vallée,-429866,-184362,2022-12-04
CASH_IN,284781,Agence_mtn_Cotonou,300000,15219,Emmanuel Vallée,-184362,100419,2022-12-05
CASH_IN,196320,Agence_mtn_Abomey,300000,103680,Emmanuel Vallée,100419,296739,2022-12-06
CASH_IN,276747,Agence_mtn_Ouidah,300000,23253,Emmanuel Vallée,296739,573486,2022-12-10
CASH_OUT,192280,Emmanuel Vallée,573486,381206,Agence_mtn_Abomey,300000,107720,2022-12-10
TRANSFER,244697,Emmanuel Vallée,381206,136509,Emmanuel Vallée,381206,625903,2022-12-15
CASH_OUT,11537,Emmanuel Vallée,136509,124972,Agence_mtn_Abomey,300000,288463,2022-12-16
TRANSFER,90419,Emmanuel Vallée,124972,34553,Emmanuel Vallée,124972,215391,2022-12-17
CASH_OUT,3737,Emmanuel Vallée,34553,30816,Agence_mtn_Abomey,300000,296263,2022-12-18
CASH_OUT,27119,Emmanuel Vallée,30816,3697,Agence_mtn_Cotonou,300000,272881,2022-12-19
CASH_OUT,2836,Emmanuel Vallée,3697,861,Agence_mtn_Abomey,300000,297164,2022-12-21
CASH_OUT,769,Emmanuel Vallée,861,92,Agence_mtn_Cotonou,300000,299231,2022-12-25
CASH_IN,23512,Agence_mtn_Abomey,300000,276488,Emmanuel Vallée,92,23604,2022-12-26
CASH_IN,246421,Agence_mtn_Cotonou,300000,53579,Alexandre Delaunay,-129554,116867,2022-12-01
CASH_IN,18832,Agence_mtn_Cotonou,300000,281168,Alexandre Delaunay,116867,135699,2022-12-04
TRANSFER,63873,Alexandre Delaunay,135699,71826,Alexandre Delaunay,135699,71826,2022-12-05
CASH_IN,173814,Agence_mtn_Abomey,300000,126186,Alexandre Delaunay,71826,245640,2022-12-06
CASH_IN,245684,Agence_mtn_Cotonou,300000,54316,Alexandre Delaunay,245640,491324,2022-12-10
CASH_IN,287527,Agence_mtn_Abomey,300000,12473,Alexandre Delaunay,491324,778851,2022-12-11
TRANSFER,99807,Alexandre Delaunay,778851,679044,Alexandre Delaunay,778851,878658,2022-12-11
TRANSFER,230174,Alexandre Delaunay,679044,448870,Alexandre Delaunay,679044,909218,2022-12-12
CASH_OUT,311162,Alexandre Delaunay,448870,137708,Agence_mtn_Cotonou,300000,-11162,2022-12-14
CASH_OUT,20306,Alexandre Delaunay,137708,117402,Agence_mtn_Ouidah,300000,279694,2022-12-15
TRANSFER,112983,Alexandre Delaunay,117402,4419,Alexandre Delaunay,117402,230385,2022-12-16
CASH_OUT,725,Alexandre Delaunay,4419,3694,Agence_mtn_Abomey,300000,299275,2022-12-20
CASH_OUT,837,Alexandre Delaunay,3694,2857,Agence_mtn_Cotonou,300000,299163,2022-12-25
CASH_IN,37079,Agence_mtn_Abomey,300000,262921,Alexandre Delaunay,2857,39936,2022-12-27
CASH_IN,226876,Agence_mtn_Abomey,300000,73124,Sylvie Dupré,-107462,119414,2022-12-03
TRANSFER,35210,Sylvie Dupré,119414,84204,Sylvie Dupré,119414,154624,2022-12-04
TRANSFER,19686,Sylvie Dupré,84204,64518,Sylvie Dupré,84204,103890,2022-12-05
CASH_OUT,8923,Sylvie Dupré,64518,55595,Agence_mtn_Cotonou,300000,291077,2022-12-05
CASH_IN,139645,Agence_mtn_Ouidah,300000,160355,Sylvie Dupré,55595,195240,2022-12-19
CASH_OUT,78587,Sylvie Dupré,195240,116653,Agence_mtn_Cotonou,300000,221413,2022-12-22
CASH_IN,252187,Agence_mtn_Cotonou,300000,47813,Sébastien Coste,-1266162,-1013975,2022-12-01
CASH_IN,93302,Agence_mtn_Ouidah,300000,206698,Sébastien Coste,-1013975,-920673,2022-12-02
CASH_IN,82976,Agence_mtn_Ouidah,300000,217024,Sébastien Coste,-920673,-837697,2022-12-03
CASH_IN,268721,Agence_mtn_Abomey,300000,31279,Sébastien Coste,-837697,-568976,2022-12-06
CASH_IN,275135,Agence_mtn_Ouidah,300000,24865,Sébastien Coste,-568976,-293841,2022-12-06
CASH_IN,24020,Agence_mtn_Cotonou,300000,275980,Sébastien Coste,-293841,-269821,2022-12-09
CASH_IN,123214,Agence_mtn_Cotonou,300000,176786,Sébastien Coste,-269821,-146607,2022-12-16
CASH_IN,184066,Agence_mtn_Ouidah,300000,115934,Sébastien Coste,-146607,37459,2022-12-18
CASH_OUT,30149,Sébastien Coste,37459,7310,Agence_mtn_Abomey,300000,269851,2022-12-19
CASH_IN,245450,Agence_mtn_Ouidah,300000,54550,Sébastien Coste,7310,252760,2022-12-21
CASH_IN,256484,Agence_mtn_Ouidah,300000,43516,Sébastien Coste,252760,509244,2022-12-22
CASH_OUT,153304,Sébastien Coste,509244,355940,Agence_mtn_Ouidah,300000,146696,2022-12-25
CASH_OUT,18539,Sébastien Coste,355940,337401,Agence_mtn_Ouidah,300000,281461,2022-12-26
