Type,Montant,Nom_src,Ancien_solde_src,Nouveau_solde_src,Nom_dest,Ancien_solde_dest,Nouveau_solde_dest,Date
TRANSFER,63924,Robert-Louis Gosselin,66700,2776,Anastasie Cousin,908400,972324,2022-01-01
TRANSFER,547774,Anastasie Cousin,972324,424550,Nath Loiseau,1022100,474326,2022-01-05
CASH_IN,120034,Agence_moov_Abomey,300000,179966,Anastasie Cousin,424550,544584,2022-01-07
CASH_IN,143224,Agence_moov_Abomey,300000,156776,Anastasie Cousin,544584,687808,2022-01-16
TRANSFER,1453992,Stéphane Munoz,1954800,500808,Anastasie Cousin,687808,2141800,2022-01-26
CASH_IN,220719,Agence_moov_Ouidah,300000,79281,Paulette Loiseau,1966500,2187219,2022-01-05
CASH_IN,160414,Agence_moov_Cotonou,300000,139586,Paulette Loiseau,2187219,2347633,2022-01-12
CASH_OUT,2167674,Paulette Loiseau,2347633,179959,Agence_moov_Cotonou,300000,-1867674,2022-01-23
CASH_OUT,342521,Adèle Da Silva-Klein,429600,87079,Agence_moov_Abomey,300000,-42521,2022-01-02
CASH_IN,182711,Agence_moov_Ouidah,300000,117289,Adèle Da Silva-Klein,87079,269790,2022-01-08
CASH_OUT,86617,Adèle Da Silva-Klein,269790,183173,Agence_moov_Cotonou,300000,213383,2022-01-14
TRANSFER,56756,Adèle Da Silva-Klein,183173,126417,Vincent de la Dumont,1542000,1485244,2022-01-17
CASH_OUT,17504,Émilie du Allain,136600,119096,Agence_moov_Cotonou,300000,282496,2022-01-16
CASH_IN,42895,Agence_moov_Abomey,300000,257105,Émilie du Allain,119096,161991,2022-01-17
CASH_IN,10046,Agence_moov_Cotonou,300000,289954,Émilie du Allain,161991,172037,2022-01-18
TRANSFER,892845,Matthieu-Matthieu Bigot,999000,106155,Émilie du Allain,172037,1064882,2022-01-20
TRANSFER,299423,Émilie du Allain,1064882,765459,Mathilde Picard du Delmas,161500,-137923,2022-01-25
CASH_IN,263669,Agence_moov_Abomey,300000,36331,Hélène Le Chauvin,1563400,1827069,2022-01-05
TRANSFER,534811,Simone Muller de la Brun,598700,63889,Hélène Le Chauvin,1827069,2361880,2022-01-05
CASH_OUT,885537,Hélène Le Chauvin,2361880,1476343,Agence_moov_Ouidah,300000,-585537,2022-01-26
TRANSFER,28658,Thérèse Hubert,487800,459142,Noël Bourgeois,840300,811642,2022-01-10
CASH_OUT,214939,Thérèse Hubert,459142,244203,Agence_moov_Abomey,300000,85061,2022-01-16
CASH_OUT,61255,Thérèse Hubert,244203,182948,Agence_moov_Ouidah,300000,238745,2022-01-18
TRANSFER,171516,Thérèse Hubert,182948,11432,Paul Perez,830400,658884,2022-01-25
CASH_OUT,1261313,Robert Laroche,1829200,567887,Agence_moov_Abomey,300000,-961313,2022-01-02
CASH_IN,276590,Agence_moov_Cotonou,300000,23410,Robert Laroche,567887,844477,2022-01-02
TRANSFER,795560,Robert Laroche,844477,48917,Thérèse François,1171300,375740,2022-01-05
TRANSFER,27494,Robert Laroche,48917,21423,Victor Michel,662300,634806,2022-01-13
CASH_IN,135096,Agence_moov_Abomey,300000,164904,Manon Chevalier,462300,597396,2022-01-06
TRANSFER,265561,Manon Chevalier,597396,331835,Thomas Dupont,338000,72439,2022-01-14
TRANSFER,216815,Stéphane Munoz,500808,283993,Manon Chevalier,331835,548650,2022-01-23
CASH_IN,145646,Agence_moov_Cotonou,300000,154354,Robert Clerc,1944000,2089646,2022-01-07
CASH_IN,230598,Agence_moov_Cotonou,300000,69402,Robert Clerc,2089646,2320244,2022-01-11
TRANSFER,1312718,Marc Leleu,1335900,23182,Emmanuel Grégoire,1313100,382,2022-01-16
CASH_IN,217630,Agence_moov_Cotonou,300000,82370,Mathilde Picard du Delmas,-137923,79707,2022-01-15
TRANSFER,61808,Richard Michel,128700,66892,Mathilde Picard du Delmas,79707,141515,2022-01-23
TRANSFER,47447,Léon Da Costa,99000,51553,Tristan Delahaye,695700,743147,2022-01-17
CASH_IN,46010,Agence_moov_Ouidah,300000,253990,Tristan Delahaye,743147,789157,2022-01-23
CASH_OUT,194672,Thibaut de la Roy,1000900,806228,Agence_moov_Abomey,300000,105328,2022-01-04
CASH_IN,134313,Agence_moov_Abomey,300000,165687,Matthieu-Matthieu Bigot,106155,240468,2022-01-05
CASH_IN,180653,Agence_moov_Ouidah,300000,119347,Matthieu-Matthieu Bigot,240468,421121,2022-01-07
TRANSFER,710347,Vincent de la Dumont,1485244,774897,Matthieu-Matthieu Bigot,421121,1131468,2022-01-13
TRANSFER,467562,Anne Peltier-Raynaud,1667400,1199838,Matthieu-Matthieu Bigot,1131468,1599030,2022-01-21
CASH_OUT,1244040,Matthieu-Matthieu Bigot,1599030,354990,Agence_moov_Cotonou,300000,-944040,2022-01-26
CASH_OUT,976926,Colette Merle Le Robert,1027100,50174,Agence_moov_Cotonou,300000,-676926,2022-01-14
CASH_OUT,616818,Bernadette de Jourdan,1087700,470882,Agence_moov_Abomey,300000,-316818,2022-01-05
CASH_IN,133035,Agence_moov_Cotonou,300000,166965,Bernadette de Jourdan,470882,603917,2022-01-13
CASH_IN,287377,Agence_moov_Ouidah,300000,12623,Bernadette de Jourdan,603917,891294,2022-01-16
CASH_OUT,105458,Bernadette de Jourdan,891294,785836,Agence_moov_Ouidah,300000,194542,2022-01-21
CASH_IN,68712,Agence_moov_Cotonou,300000,231288,Michelle-Dorothée Lévêque,1101300,1170012,2022-01-02
TRANSFER,182823,Virginie Bouvet,373000,190177,Michelle-Dorothée Lévêque,1170012,1352835,2022-01-03
TRANSFER,33497,Marthe Gilles,48200,14703,Michelle-Dorothée Lévêque,1352835,1386332,2022-01-23
CASH_IN,274158,Agence_moov_Cotonou,300000,25842,Céline Collin-Hervé,1711900,1986058,2022-01-01
CASH_OUT,1743977,Céline Collin-Hervé,1986058,242081,Agence_moov_Ouidah,300000,-1443977,2022-01-04
TRANSFER,514651,Maggie Martinez,528600,13949,Céline Collin-Hervé,242081,756732,2022-01-19
CASH_OUT,194201,Céline Collin-Hervé,756732,562531,Agence_moov_Abomey,300000,105799,2022-01-22
CASH_IN,38503,Agence_moov_Abomey,300000,261497,Céline Collin-Hervé,562531,601034,2022-01-25
TRANSFER,162315,Frédérique Fernandes du Bouchet,1287100,1124785,Jules Fernandes,654400,816715,2022-01-07
TRANSFER,688088,Jules Fernandes,816715,128627,Andrée-Thérèse Mendès,969900,281812,2022-01-12
TRANSFER,100066,Jules Fernandes,128627,28561,Virginie Bouvet,190177,90111,2022-01-19
CASH_OUT,717359,Philippe Philippe,1264100,546741,Agence_moov_Ouidah,300000,-417359,2022-01-07
CASH_OUT,451933,Thomas-Robert Morvan,1274900,822967,Agence_moov_Cotonou,300000,-151933,2022-01-01
CASH_IN,77354,Agence_moov_Ouidah,300000,222646,Thomas-Robert Morvan,822967,900321,2022-01-05
CASH_IN,13924,Agence_moov_Cotonou,300000,286076,Thomas-Robert Morvan,900321,914245,2022-01-09
CASH_IN,9401,Agence_moov_Abomey,300000,290599,Thomas-Robert Morvan,914245,923646,2022-01-17
CASH_OUT,124047,Thomas-Robert Morvan,923646,799599,Agence_moov_Abomey,300000,175953,2022-01-24
CASH_OUT,10482,Lucy Lamy,40400,29918,Agence_moov_Cotonou,300000,289518,2022-01-01
TRANSFER,1305,Lucy Lamy,29918,28613,Lucy Lamy,29918,31223,2022-01-18
TRANSFER,65396,Martine Aubert,797000,731604,Lucy Lamy,28613,94009,2022-01-21
CASH_IN,299558,Agence_moov_Ouidah,300000,442,Lucy Lamy,94009,393567,2022-01-22
TRANSFER,40093,Thomas Guichard du Renault,510900,470807,Constance Guillon,1383800,1423893,2022-01-18
TRANSFER,27796,Noël Bourgeois,811642,783846,Constance Guillon,1423893,1451689,2022-01-21
CASH_IN,150025,Agence_moov_Ouidah,300000,149975,Constance Guillon,1451689,1601714,2022-01-24
TRANSFER,718913,Véronique Martins de Fleury,1458900,739987,Stéphane Munoz,283993,-434920,2022-01-01
TRANSFER,988528,Camille Prévost,1800200,811672,Véronique Martins de Fleury,739987,1728515,2022-01-03
CASH_OUT,147543,Véronique Martins de Fleury,1728515,1580972,Agence_moov_Abomey,300000,152457,2022-01-05
CASH_OUT,229437,Véronique Martins de Fleury,1580972,1351535,Agence_moov_Ouidah,300000,70563,2022-01-14
TRANSFER,245283,Timothée-René Blanchard,383900,138617,Gérard de la Martinez,1560000,1805283,2022-01-09
CASH_IN,263478,Agence_moov_Ouidah,300000,36522,Gérard de la Martinez,1805283,2068761,2022-01-10
TRANSFER,37970,Thomas Dupont,72439,34469,Gérard de la Martinez,2068761,2106731,2022-01-11
CASH_IN,154144,Agence_moov_Ouidah,300000,145856,Gérard de la Martinez,2106731,2260875,2022-01-14
TRANSFER,996794,Frédérique Fernandes du Bouchet,1124785,127991,Gérard de la Martinez,2260875,3257669,2022-01-17
CASH_OUT,72399,Virginie Bouvet,90111,17712,Agence_moov_Abomey,300000,227601,2022-01-03
CASH_OUT,221,Virginie Bouvet,17712,17491,Agence_moov_Abomey,300000,299779,2022-01-11
TRANSFER,39075,Sabine Pineau,439000,399925,Virginie Bouvet,17491,56566,2022-01-22
CASH_OUT,54847,Noémi Bouvier,1753800,1698953,Agence_moov_Ouidah,300000,245153,2022-01-01
CASH_IN,295152,Agence_moov_Ouidah,300000,4848,Noémi Bouvier,1698953,1994105,2022-01-02
CASH_OUT,428849,Noémi Bouvier,1994105,1565256,Agence_moov_Cotonou,300000,-128849,2022-01-02
TRANSFER,481422,Noémi Bouvier,1565256,1083834,Thomas Dupont,34469,-446953,2022-01-03
CASH_OUT,476502,Noémi Bouvier,1083834,607332,Agence_moov_Abomey,300000,-176502,2022-01-08
CASH_IN,80298,Agence_moov_Ouidah,300000,219702,Noémi Bouvier,607332,687630,2022-01-09
CASH_OUT,535945,Noémi Bouvier,687630,151685,Agence_moov_Cotonou,300000,-235945,2022-01-09
TRANSFER,67123,Noémi Bouvier,151685,84562,Clémence-Véronique Munoz,626800,559677,2022-01-12
CASH_IN,81498,Agence_moov_Ouidah,300000,218502,Noémi Bouvier,84562,166060,2022-01-12
CASH_IN,226849,Agence_moov_Ouidah,300000,73151,Noémi Bouvier,166060,392909,2022-01-13
CASH_IN,81676,Agence_moov_Ouidah,300000,218324,Noémi Bouvier,392909,474585,2022-01-13
CASH_OUT,71052,Noémi Bouvier,474585,403533,Agence_moov_Ouidah,300000,228948,2022-01-15
TRANSFER,81280,Noémi Bouvier,403533,322253,Nathalie Bonnin-Joubert,1208700,1127420,2022-01-15
CASH_OUT,238394,Noémi Bouvier,322253,83859,Agence_moov_Abomey,300000,61606,2022-01-20
TRANSFER,19962,Noémi Bouvier,83859,63897,Colette-Sophie Prévost,370500,350538,2022-01-20
CASH_OUT,32603,Noémi Bouvier,63897,31294,Agence_moov_Abomey,300000,267397,2022-01-21
CASH_IN,118989,Agence_moov_Abomey,300000,181011,Noémi Bouvier,31294,150283,2022-01-22
CASH_IN,39227,Agence_moov_Ouidah,300000,260773,Noémi Bouvier,150283,189510,2022-01-25
TRANSFER,642080,Renée Rousseau-Henry,1375500,733420,Noémi Bouvier,189510,831590,2022-01-25
TRANSFER,248252,Noémi Bouvier,831590,583338,Agnès Le Giraud,1492000,1243748,2022-01-26
TRANSFER,441882,Noémi Bouvier,583338,141456,Hélène de la Gérard,1742000,1300118,2022-01-26
CASH_OUT,96331,Noémi Bouvier,141456,45125,Agence_moov_Ouidah,300000,203669,2022-01-27
CASH_OUT,879470,Émile-René Baudry,1886100,1006630,Agence_moov_Abomey,300000,-579470,2022-01-01
CASH_OUT,721019,Émile-René Baudry,1006630,285611,Agence_moov_Cotonou,300000,-421019,2022-01-03
CASH_IN,21559,Agence_moov_Abomey,300000,278441,Émile-René Baudry,285611,307170,2022-01-04
CASH_OUT,287594,Émile-René Baudry,307170,19576,Agence_moov_Cotonou,300000,12406,2022-01-06
TRANSFER,8518,Émile-René Baudry,19576,11058,Richard Michel,66892,58374,2022-01-07
CASH_OUT,278,Émile-René Baudry,11058,10780,Agence_moov_Cotonou,300000,299722,2022-01-09
TRANSFER,5861,Émile-René Baudry,10780,4919,Constance Bourdon-Millet,1482100,1476239,2022-01-10
TRANSFER,510555,Manon Valette,1676700,1166145,Émile-René Baudry,4919,515474,2022-01-11
CASH_IN,157136,Agence_moov_Ouidah,300000,142864,Émile-René Baudry,515474,672610,2022-01-12
CASH_IN,20375,Agence_moov_Ouidah,300000,279625,Émile-René Baudry,672610,692985,2022-01-13
CASH_OUT,25660,Émile-René Baudry,692985,667325,Agence_moov_Cotonou,300000,274340,2022-01-16
CASH_OUT,172847,Émile-René Baudry,667325,494478,Agence_moov_Cotonou,300000,127153,2022-01-17
CASH_IN,250571,Agence_moov_Ouidah,300000,49429,Émile-René Baudry,494478,745049,2022-01-17
TRANSFER,96538,Émile-René Baudry,745049,648511,Thomas Guichard du Renault,470807,374269,2022-01-18
CASH_OUT,343987,Émile-René Baudry,648511,304524,Agence_moov_Ouidah,300000,-43987,2022-01-18
TRANSFER,51827,Émile-René Baudry,304524,252697,Alix Barbe,1692800,1640973,2022-01-20
CASH_OUT,109163,Émile-René Baudry,252697,143534,Agence_moov_Ouidah,300000,190837,2022-01-20
CASH_OUT,81534,Émile-René Baudry,143534,62000,Agence_moov_Abomey,300000,218466,2022-01-21
CASH_IN,74368,Agence_moov_Ouidah,300000,225632,Émile-René Baudry,62000,136368,2022-01-21
TRANSFER,11363,Andrée-Thérèse Mendès,281812,270449,Émile-René Baudry,136368,147731,2022-01-21
CASH_IN,276570,Agence_moov_Abomey,300000,23430,Émile-René Baudry,147731,424301,2022-01-21
TRANSFER,1013824,Alphonse Gomes,1211700,197876,Émile-René Baudry,424301,1438125,2022-01-21
CASH_IN,194482,Agence_moov_Ouidah,300000,105518,Émile-René Baudry,1438125,1632607,2022-01-22
TRANSFER,735538,Émile-René Baudry,1632607,897069,Michel Bouchet,1577200,841662,2022-01-24
CASH_IN,1335,Agence_moov_Ouidah,300000,298665,Émile-René Baudry,897069,898404,2022-01-24
CASH_OUT,201139,Émile-René Baudry,898404,697265,Agence_moov_Abomey,300000,98861,2022-01-25
TRANSFER,171489,Alphonse Gomes,197876,26387,Émile-René Baudry,697265,868754,2022-01-25
CASH_OUT,655807,Émile-René Baudry,868754,212947,Agence_moov_Abomey,300000,-355807,2022-01-26
CASH_OUT,208794,Émile-René Baudry,212947,4153,Agence_moov_Ouidah,300000,91206,2022-01-26
TRANSFER,151081,Christine Texier,915000,763919,Vincent de la Dumont,774897,925978,2022-01-01
TRANSFER,34686,Simone Muller de la Brun,63889,29203,Vincent de la Dumont,925978,960664,2022-01-02
CASH_IN,88771,Agence_moov_Cotonou,300000,211229,Vincent de la Dumont,960664,1049435,2022-01-03
CASH_IN,134565,Agence_moov_Abomey,300000,165435,Vincent de la Dumont,1049435,1184000,2022-01-03
TRANSFER,471587,Camille Morvan,668800,197213,Vincent de la Dumont,1184000,1655587,2022-01-05
CASH_IN,149007,Agence_moov_Cotonou,300000,150993,Vincent de la Dumont,1655587,1804594,2022-01-07
CASH_OUT,666471,Vincent de la Dumont,1804594,1138123,Agence_moov_Abomey,300000,-366471,2022-01-08
CASH_OUT,409629,Vincent de la Dumont,1138123,728494,Agence_moov_Ouidah,300000,-109629,2022-01-08
TRANSFER,1117176,Gabriel Bègue,1204200,87024,Vincent de la Dumont,728494,1845670,2022-01-09
TRANSFER,18394,Richard Michel,58374,39980,Vincent de la Dumont,1845670,1864064,2022-01-09
CASH_IN,293354,Agence_moov_Ouidah,300000,6646,Vincent de la Dumont,1864064,2157418,2022-01-11
CASH_IN,77424,Agence_moov_Abomey,300000,222576,Vincent de la Dumont,2157418,2234842,2022-01-12
CASH_OUT,1048347,Vincent de la Dumont,2234842,1186495,Agence_moov_Abomey,300000,-748347,2022-01-16
CASH_OUT,567900,Vincent de la Dumont,1186495,618595,Agence_moov_Abomey,300000,-267900,2022-01-17
TRANSFER,497684,Vincent de la Dumont,618595,120911,Vincent Joubert,1753600,1255916,2022-01-18
CASH_OUT,52901,Vincent de la Dumont,120911,68010,Agence_moov_Ouidah,300000,247099,2022-01-20
CASH_IN,100115,Agence_moov_Abomey,300000,199885,Vincent de la Dumont,68010,168125,2022-01-21
CASH_OUT,37804,Vincent de la Dumont,168125,130321,Agence_moov_Abomey,300000,262196,2022-01-23
CASH_OUT,109891,Vincent de la Dumont,130321,20430,Agence_moov_Cotonou,300000,190109,2022-01-23
CASH_IN,254409,Agence_moov_Cotonou,300000,45591,Vincent de la Dumont,20430,274839,2022-01-23
CASH_IN,170648,Agence_moov_Abomey,300000,129352,Vincent de la Dumont,274839,445487,2022-01-24
CASH_IN,151186,Agence_moov_Cotonou,300000,148814,Vincent de la Dumont,445487,596673,2022-01-24
CASH_IN,12897,Agence_moov_Ouidah,300000,287103,Vincent de la Dumont,596673,609570,2022-01-25
CASH_IN,142610,Agence_moov_Abomey,300000,157390,Vincent de la Dumont,609570,752180,2022-01-26
CASH_OUT,366623,Vincent de la Dumont,752180,385557,Agence_moov_Ouidah,300000,-66623,2022-01-27
CASH_IN,278055,Agence_moov_Ouidah,300000,21945,Vincent de la Dumont,385557,663612,2022-01-27
TRANSFER,450286,Vincent de la Dumont,663612,213326,Antoinette de Dupuis,27500,-422786,2022-01-27
TRANSFER,37249,Richard Michel,39980,2731,Théodore Joseph-Lefebvre,1509500,1472251,2022-01-01
TRANSFER,338221,Colette-Sophie Prévost,350538,12317,Richard Michel,2731,340952,2022-01-02
CASH_IN,67794,Agence_moov_Cotonou,300000,232206,Richard Michel,340952,408746,2022-01-03
TRANSFER,218860,Richard Michel,408746,189886,Audrey Julien de Leleu,1696400,1477540,2022-01-06
TRANSFER,208256,Christine Texier,763919,555663,Richard Michel,189886,398142,2022-01-08
CASH_OUT,114805,Richard Michel,398142,283337,Agence_moov_Ouidah,300000,185195,2022-01-10
TRANSFER,244544,Richard Michel,283337,38793,Tristan Bousquet-Gros,518900,274356,2022-01-11
TRANSFER,3565,Richard Michel,38793,35228,Christine Texier,555663,552098,2022-01-11
CASH_OUT,7186,Richard Michel,35228,28042,Agence_moov_Abomey,300000,292814,2022-01-13
CASH_OUT,13941,Richard Michel,28042,14101,Agence_moov_Abomey,300000,286059,2022-01-14
CASH_OUT,4851,Richard Michel,14101,9250,Agence_moov_Ouidah,300000,295149,2022-01-15
TRANSFER,164319,Camille Morvan,197213,32894,Richard Michel,9250,173569,2022-01-15
CASH_IN,203803,Agence_moov_Abomey,300000,96197,Richard Michel,173569,377372,2022-01-16
TRANSFER,226255,Constance Bourdon-Millet,1476239,1249984,Richard Michel,377372,603627,2022-01-16
CASH_OUT,311125,Richard Michel,603627,292502,Agence_moov_Ouidah,300000,-11125,2022-01-17
CASH_IN,205486,Agence_moov_Abomey,300000,94514,Richard Michel,292502,497988,2022-01-17
TRANSFER,175366,Richard Michel,497988,322622,Andrée-Thérèse Mendès,270449,95083,2022-01-21
CASH_IN,249628,Agence_moov_Abomey,300000,50372,Richard Michel,322622,572250,2022-01-23
CASH_IN,71105,Agence_moov_Cotonou,300000,228895,Richard Michel,572250,643355,2022-01-23
CASH_IN,243392,Agence_moov_Abomey,300000,56608,Richard Michel,643355,886747,2022-01-25
CASH_IN,14544,Agence_moov_Abomey,300000,285456,Richard Michel,886747,901291,2022-01-27
CASH_IN,267804,Agence_moov_Cotonou,300000,32196,Raymond Lévy,409600,677404,2022-01-03
TRANSFER,200526,Raymond Lévy,677404,476878,Lucie Aubert,1227700,1027174,2022-01-04
TRANSFER,595811,Martine Aubert,731604,135793,Raymond Lévy,476878,1072689,2022-01-04
CASH_OUT,264815,Raymond Lévy,1072689,807874,Agence_moov_Abomey,300000,35185,2022-01-04
CASH_IN,253923,Agence_moov_Cotonou,300000,46077,Raymond Lévy,807874,1061797,2022-01-05
CASH_IN,182639,Agence_moov_Ouidah,300000,117361,Raymond Lévy,1061797,1244436,2022-01-05
CASH_OUT,909458,Raymond Lévy,1244436,334978,Agence_moov_Cotonou,300000,-609458,2022-01-06
CASH_IN,37391,Agence_moov_Cotonou,300000,262609,Raymond Lévy,334978,372369,2022-01-10
TRANSFER,368249,Raymond Lévy,372369,4120,Colette-Sophie Prévost,12317,-355932,2022-01-10
TRANSFER,59523,Luc Lévêque-Carre,1174800,1115277,Raymond Lévy,4120,63643,2022-01-12
TRANSFER,298394,Bernard Maurice,651300,352906,Raymond Lévy,63643,362037,2022-01-13
CASH_IN,4776,Agence_moov_Ouidah,300000,295224,Raymond Lévy,362037,366813,2022-01-13
CASH_OUT,318507,Raymond Lévy,366813,48306,Agence_moov_Ouidah,300000,-18507,2022-01-14
CASH_OUT,3472,Raymond Lévy,48306,44834,Agence_moov_Abomey,300000,296528,2022-01-15
TRANSFER,10292,Raymond Lévy,44834,34542,Andrée-Thérèse Mendès,95083,84791,2022-01-15
CASH_OUT,31040,Raymond Lévy,34542,3502,Agence_moov_Ouidah,300000,268960,2022-01-16
CASH_IN,117293,Agence_moov_Ouidah,300000,182707,Raymond Lévy,3502,120795,2022-01-17
CASH_OUT,95996,Raymond Lévy,120795,24799,Agence_moov_Abomey,300000,204004,2022-01-17
CASH_OUT,24586,Raymond Lévy,24799,213,Agence_moov_Ouidah,300000,275414,2022-01-20
TRANSFER,195,Raymond Lévy,213,18,Frédéric Guillou,1322000,1321805,2022-01-20
CASH_IN,111598,Agence_moov_Abomey,300000,188402,Raymond Lévy,18,111616,2022-01-21
TRANSFER,48888,Raymond Lévy,111616,62728,Anne Peltier-Raynaud,1199838,1150950,2022-01-21
CASH_OUT,46068,Raymond Lévy,62728,16660,Agence_moov_Ouidah,300000,253932,2022-01-21
CASH_OUT,16321,Raymond Lévy,16660,339,Agence_moov_Cotonou,300000,283679,2022-01-21
TRANSFER,54032,Vincent Joubert,1255916,1201884,Raymond Lévy,339,54371,2022-01-22
TRANSFER,78076,Thibaut de la Lombard,847300,769224,Raymond Lévy,54371,132447,2022-01-24
CASH_OUT,4537,Raymond Lévy,132447,127910,Agence_moov_Ouidah,300000,295463,2022-01-24
TRANSFER,534345,Aurore Charrier,601600,67255,Raymond Lévy,127910,662255,2022-01-25
CASH_OUT,121631,Raymond Lévy,662255,540624,Agence_moov_Abomey,300000,178369,2022-01-26
CASH_IN,293169,Agence_moov_Ouidah,300000,6831,Raymond Lévy,540624,833793,2022-01-26
CASH_IN,84708,Agence_moov_Ouidah,300000,215292,Colette-Sophie Prévost,-355932,-271224,2022-01-01
CASH_IN,200448,Agence_moov_Cotonou,300000,99552,Colette-Sophie Prévost,-271224,-70776,2022-01-01
CASH_IN,78933,Agence_moov_Abomey,300000,221067,Colette-Sophie Prévost,-70776,8157,2022-01-02
CASH_OUT,4124,Colette-Sophie Prévost,8157,4033,Agence_moov_Cotonou,300000,295876,2022-01-03
CASH_OUT,3570,Colette-Sophie Prévost,4033,463,Agence_moov_Abomey,300000,296430,2022-01-03
TRANSFER,161,Colette-Sophie Prévost,463,302,Michelle de Étienne,1150500,1150339,2022-01-04
TRANSFER,243,Colette-Sophie Prévost,302,59,Martine Aubert,135793,135550,2022-01-04
CASH_IN,150705,Agence_moov_Cotonou,300000,149295,Colette-Sophie Prévost,59,150764,2022-01-04
CASH_IN,6026,Agence_moov_Abomey,300000,293974,Colette-Sophie Prévost,150764,156790,2022-01-08
TRANSFER,23879,Simone Muller de la Brun,29203,5324,Colette-Sophie Prévost,156790,180669,2022-01-09
TRANSFER,24531,Colette-Sophie Prévost,180669,156138,Clémence-Véronique Munoz,559677,535146,2022-01-10
CASH_OUT,66843,Colette-Sophie Prévost,156138,89295,Agence_moov_Abomey,300000,233157,2022-01-12
TRANSFER,27739,Manon Lebon,38100,10361,Colette-Sophie Prévost,89295,117034,2022-01-13
CASH_OUT,96305,Colette-Sophie Prévost,117034,20729,Agence_moov_Cotonou,300000,203695,2022-01-13
TRANSFER,7050,Colette-Sophie Prévost,20729,13679,Jules-Roland Bousquet,1476700,1469650,2022-01-14
CASH_OUT,11815,Colette-Sophie Prévost,13679,1864,Agence_moov_Cotonou,300000,288185,2022-01-15
CASH_IN,5041,Agence_moov_Abomey,300000,294959,Colette-Sophie Prévost,1864,6905,2022-01-15
CASH_OUT,1093,Colette-Sophie Prévost,6905,5812,Agence_moov_Ouidah,300000,298907,2022-01-15
CASH_IN,68019,Agence_moov_Abomey,300000,231981,Colette-Sophie Prévost,5812,73831,2022-01-16
TRANSFER,8777,Colette-Sophie Prévost,73831,65054,Agnès Le Giraud,1243748,1234971,2022-01-17
TRANSFER,23406,Colette-Sophie Prévost,65054,41648,Anastasie Richard-Neveu,795300,771894,2022-01-17
TRANSFER,14976,Colette-Sophie Prévost,41648,26672,Michelle de Étienne,1150339,1135363,2022-01-18
CASH_OUT,20731,Colette-Sophie Prévost,26672,5941,Agence_moov_Abomey,300000,279269,2022-01-18
TRANSFER,19495,Martine Aubert,135550,116055,Colette-Sophie Prévost,5941,25436,2022-01-20
CASH_IN,94584,Agence_moov_Ouidah,300000,205416,Colette-Sophie Prévost,25436,120020,2022-01-21
CASH_IN,131239,Agence_moov_Abomey,300000,168761,Colette-Sophie Prévost,120020,251259,2022-01-22
CASH_OUT,2205,Colette-Sophie Prévost,251259,249054,Agence_moov_Ouidah,300000,297795,2022-01-22
CASH_OUT,198242,Colette-Sophie Prévost,249054,50812,Agence_moov_Abomey,300000,101758,2022-01-26
TRANSFER,538956,Nathalie Bonnin-Joubert,1127420,588464,Colette-Sophie Prévost,50812,589768,2022-01-26
CASH_OUT,105137,Colette-Sophie Prévost,589768,484631,Agence_moov_Abomey,300000,194863,2022-01-26
TRANSFER,18332,Aurore Charrier,67255,48923,Mathilde de la Samson,387600,405932,2022-01-02
TRANSFER,319699,Thérèse François,375740,56041,Mathilde de la Samson,405932,725631,2022-01-04
CASH_OUT,224383,Mathilde de la Samson,725631,501248,Agence_moov_Cotonou,300000,75617,2022-01-05
CASH_OUT,196151,Mathilde de la Samson,501248,305097,Agence_moov_Abomey,300000,103849,2022-01-06
CASH_OUT,25310,Mathilde de la Samson,305097,279787,Agence_moov_Cotonou,300000,274690,2022-01-07
TRANSFER,7504,Manon Lebon,10361,2857,Mathilde de la Samson,279787,287291,2022-01-07
CASH_OUT,68713,Mathilde de la Samson,287291,218578,Agence_moov_Cotonou,300000,231287,2022-01-09
TRANSFER,83657,Mathilde de la Samson,218578,134921,Martine Aubert,116055,32398,2022-01-09
CASH_OUT,17426,Mathilde de la Samson,134921,117495,Agence_moov_Ouidah,300000,282574,2022-01-10
CASH_OUT,21476,Mathilde de la Samson,117495,96019,Agence_moov_Ouidah,300000,278524,2022-01-10
CASH_IN,207574,Agence_moov_Abomey,300000,92426,Mathilde de la Samson,96019,303593,2022-01-13
CASH_OUT,106832,Mathilde de la Samson,303593,196761,Agence_moov_Ouidah,300000,193168,2022-01-13
CASH_OUT,57150,Mathilde de la Samson,196761,139611,Agence_moov_Cotonou,300000,242850,2022-01-13
CASH_IN,67270,Agence_moov_Cotonou,300000,232730,Mathilde de la Samson,139611,206881,2022-01-13
CASH_IN,204787,Agence_moov_Ouidah,300000,95213,Mathilde de la Samson,206881,411668,2022-01-14
TRANSFER,267248,Mathilde de la Samson,411668,144420,Nathalie Bonnin-Joubert,588464,321216,2022-01-15
CASH_OUT,87263,Mathilde de la Samson,144420,57157,Agence_moov_Cotonou,300000,212737,2022-01-15
CASH_IN,835,Agence_moov_Cotonou,300000,299165,Mathilde de la Samson,57157,57992,2022-01-15
TRANSFER,19131,Aurore Charrier,48923,29792,Mathilde de la Samson,57992,77123,2022-01-15
CASH_IN,249249,Agence_moov_Abomey,300000,50751,Mathilde de la Samson,77123,326372,2022-01-16
TRANSFER,273612,Mathilde de la Samson,326372,52760,Astrid Lecoq,1963700,1690088,2022-01-19
TRANSFER,51904,Mathilde de la Samson,52760,856,Hélène de la Gérard,1300118,1248214,2022-01-20
CASH_IN,15735,Agence_moov_Ouidah,300000,284265,Mathilde de la Samson,856,16591,2022-01-20
CASH_OUT,14575,Mathilde de la Samson,16591,2016,Agence_moov_Ouidah,300000,285425,2022-01-20
CASH_OUT,515,Mathilde de la Samson,2016,1501,Agence_moov_Cotonou,300000,299485,2022-01-22
CASH_OUT,259,Mathilde de la Samson,1501,1242,Agence_moov_Ouidah,300000,299741,2022-01-22
CASH_OUT,1181,Mathilde de la Samson,1242,61,Agence_moov_Cotonou,300000,298819,2022-01-25
CASH_IN,125853,Agence_moov_Cotonou,300000,174147,Mathilde de la Samson,61,125914,2022-01-25
CASH_OUT,50634,Mathilde de la Samson,125914,75280,Agence_moov_Abomey,300000,249366,2022-01-26
CASH_IN,197987,Agence_moov_Abomey,300000,102013,Mathilde de la Samson,75280,273267,2022-01-27
CASH_IN,168375,Agence_moov_Cotonou,300000,131625,Aimé Pages,1586000,1754375,2022-01-01
TRANSFER,2111,Simone Muller de la Brun,5324,3213,Aimé Pages,1754375,1756486,2022-01-02
CASH_IN,52983,Agence_moov_Cotonou,300000,247017,Aimé Pages,1756486,1809469,2022-01-02
CASH_IN,245511,Agence_moov_Cotonou,300000,54489,Aimé Pages,1809469,2054980,2022-01-02
TRANSFER,1579231,Aimé Pages,2054980,475749,Vincent Joubert,1201884,-377347,2022-01-05
CASH_OUT,286253,Aimé Pages,475749,189496,Agence_moov_Abomey,300000,13747,2022-01-06
CASH_IN,108738,Agence_moov_Abomey,300000,191262,Aimé Pages,189496,298234,2022-01-07
CASH_OUT,153091,Aimé Pages,298234,145143,Agence_moov_Abomey,300000,146909,2022-01-08
TRANSFER,23303,Thérèse François,56041,32738,Aimé Pages,145143,168446,2022-01-08
CASH_IN,226195,Agence_moov_Abomey,300000,73805,Aimé Pages,168446,394641,2022-01-08
CASH_OUT,293878,Aimé Pages,394641,100763,Agence_moov_Ouidah,300000,6122,2022-01-10
TRANSFER,245738,Victor Michel,634806,389068,Aimé Pages,100763,346501,2022-01-12
CASH_IN,73070,Agence_moov_Abomey,300000,226930,Aimé Pages,346501,419571,2022-01-16
TRANSFER,263094,Aimé Pages,419571,156477,Théodore Joseph-Lefebvre,1472251,1209157,2022-01-18
CASH_OUT,3000,Aimé Pages,156477,153477,Agence_moov_Cotonou,300000,297000,2022-01-18
TRANSFER,211943,Michelle de Étienne,1135363,923420,Aimé Pages,153477,365420,2022-01-18
TRANSFER,259938,Aimé Pages,365420,105482,Timothée-René Blanchard,138617,-121321,2022-01-19
CASH_OUT,73018,Aimé Pages,105482,32464,Agence_moov_Cotonou,300000,226982,2022-01-21
TRANSFER,314151,Nath Loiseau,474326,160175,Aimé Pages,32464,346615,2022-01-22
CASH_IN,51570,Agence_moov_Abomey,300000,248430,Aimé Pages,346615,398185,2022-01-24
CASH_IN,182164,Agence_moov_Ouidah,300000,117836,Aimé Pages,398185,580349,2022-01-24
TRANSFER,292151,Paul Rocher-Maillet,881300,589149,Aimé Pages,580349,872500,2022-01-24
CASH_IN,75415,Agence_moov_Cotonou,300000,224585,Aimé Pages,872500,947915,2022-01-24
CASH_OUT,609053,Aimé Pages,947915,338862,Agence_moov_Abomey,300000,-309053,2022-01-25
CASH_IN,88779,Agence_moov_Ouidah,300000,211221,Aimé Pages,338862,427641,2022-01-25
CASH_IN,19941,Agence_moov_Cotonou,300000,280059,Aimé Pages,427641,447582,2022-01-26
CASH_IN,172353,Agence_moov_Abomey,300000,127647,Aimé Pages,447582,619935,2022-01-26
CASH_IN,66290,Agence_moov_Cotonou,300000,233710,Aimé Pages,619935,686225,2022-01-27
CASH_IN,34024,Agence_moov_Cotonou,300000,265976,Gabriel Bègue,87024,121048,2022-01-01
CASH_OUT,10362,Gabriel Bègue,121048,110686,Agence_moov_Ouidah,300000,289638,2022-01-02
TRANSFER,276873,Michelle de Étienne,923420,646547,Gabriel Bègue,110686,387559,2022-01-02
CASH_OUT,53615,Gabriel Bègue,387559,333944,Agence_moov_Cotonou,300000,246385,2022-01-02
CASH_OUT,47051,Gabriel Bègue,333944,286893,Agence_moov_Ouidah,300000,252949,2022-01-10
CASH_OUT,87631,Gabriel Bègue,286893,199262,Agence_moov_Ouidah,300000,212369,2022-01-10
CASH_IN,126982,Agence_moov_Abomey,300000,173018,Gabriel Bègue,199262,326244,2022-01-12
TRANSFER,339,Emmanuel Grégoire,382,43,Gabriel Bègue,326244,326583,2022-01-13
CASH_IN,271442,Agence_moov_Ouidah,300000,28558,Gabriel Bègue,326583,598025,2022-01-14
TRANSFER,28019,Camille Morvan,32894,4875,Gabriel Bègue,598025,626044,2022-01-16
CASH_IN,36691,Agence_moov_Abomey,300000,263309,Gabriel Bègue,626044,662735,2022-01-20
CASH_IN,171144,Agence_moov_Abomey,300000,128856,Gabriel Bègue,662735,833879,2022-01-21
CASH_OUT,775619,Gabriel Bègue,833879,58260,Agence_moov_Abomey,300000,-475619,2022-01-23
TRANSFER,23342,Gabriel Bègue,58260,34918,Marcelle-Valentine Guibert,243800,220458,2022-01-23
CASH_IN,250315,Agence_moov_Cotonou,300000,49685,Gabriel Bègue,34918,285233,2022-01-23
CASH_OUT,226810,Gabriel Bègue,285233,58423,Agence_moov_Ouidah,300000,73190,2022-01-23
CASH_IN,209513,Agence_moov_Abomey,300000,90487,Gabriel Bègue,58423,267936,2022-01-26
TRANSFER,169331,Gabriel Bègue,267936,98605,Thomas de Blin,1867800,1698469,2022-01-26
CASH_OUT,3599,Gabriel Bègue,98605,95006,Agence_moov_Ouidah,300000,296401,2022-01-27
CASH_OUT,51789,Gabriel Bègue,95006,43217,Agence_moov_Abomey,300000,248211,2022-01-27
CASH_OUT,43127,Gabriel Bègue,43217,90,Agence_moov_Cotonou,300000,256873,2022-01-27
CASH_OUT,1612794,Thomas de Blin,1698469,85675,Agence_moov_Cotonou,300000,-1312794,2022-01-01
CASH_IN,184973,Agence_moov_Ouidah,300000,115027,Thomas de Blin,85675,270648,2022-01-02
CASH_OUT,209224,Thomas de Blin,270648,61424,Agence_moov_Ouidah,300000,90776,2022-01-04
CASH_OUT,136,Thomas de Blin,61424,61288,Agence_moov_Ouidah,300000,299864,2022-01-05
CASH_OUT,17688,Thomas de Blin,61288,43600,Agence_moov_Abomey,300000,282312,2022-01-07
CASH_IN,267931,Agence_moov_Ouidah,300000,32069,Thomas de Blin,43600,311531,2022-01-09
CASH_OUT,91880,Thomas de Blin,311531,219651,Agence_moov_Abomey,300000,208120,2022-01-10
CASH_IN,81195,Agence_moov_Ouidah,300000,218805,Thomas de Blin,219651,300846,2022-01-11
CASH_IN,112805,Agence_moov_Cotonou,300000,187195,Thomas de Blin,300846,413651,2022-01-14
CASH_OUT,377256,Thomas de Blin,413651,36395,Agence_moov_Abomey,300000,-77256,2022-01-15
CASH_IN,54922,Agence_moov_Abomey,300000,245078,Thomas de Blin,36395,91317,2022-01-15
CASH_IN,237812,Agence_moov_Ouidah,300000,62188,Thomas de Blin,91317,329129,2022-01-16
CASH_OUT,911,Thomas de Blin,329129,328218,Agence_moov_Abomey,300000,299089,2022-01-16
CASH_OUT,204793,Thomas de Blin,328218,123425,Agence_moov_Cotonou,300000,95207,2022-01-18
CASH_OUT,114712,Thomas de Blin,123425,8713,Agence_moov_Cotonou,300000,185288,2022-01-20
CASH_OUT,1839,Thomas de Blin,8713,6874,Agence_moov_Abomey,300000,298161,2022-01-22
TRANSFER,249517,Victor Michel,389068,139551,Thomas de Blin,6874,256391,2022-01-22
CASH_OUT,69611,Thomas de Blin,256391,186780,Agence_moov_Ouidah,300000,230389,2022-01-23
TRANSFER,37159,Thomas de Blin,186780,149621,Thibaut de la Lombard,769224,732065,2022-01-24
TRANSFER,10303,Léon Da Costa,51553,41250,Thomas de Blin,149621,159924,2022-01-25
CASH_IN,278955,Agence_moov_Ouidah,300000,21045,Thomas de Blin,159924,438879,2022-01-25
CASH_OUT,277968,Thomas de Blin,438879,160911,Agence_moov_Abomey,300000,22032,2022-01-26
CASH_IN,148526,Agence_moov_Cotonou,300000,151474,Thomas de Blin,160911,309437,2022-01-27
CASH_OUT,126949,Thomas de Blin,309437,182488,Agence_moov_Abomey,300000,173051,2022-01-27
TRANSFER,83754,Thomas de Blin,182488,98734,André Renault,739200,655446,2022-01-27
CASH_IN,95318,Agence_moov_Abomey,300000,204682,Rémy Grondin,1609200,1704518,2022-01-01
CASH_IN,38795,Agence_moov_Abomey,300000,261205,Rémy Grondin,1704518,1743313,2022-01-03
CASH_OUT,782780,Rémy Grondin,1743313,960533,Agence_moov_Abomey,300000,-482780,2022-01-04
TRANSFER,601390,Rémy Grondin,960533,359143,Noël Bourgeois,783846,182456,2022-01-04
TRANSFER,223528,Rémy Grondin,359143,135615,Clémence-Véronique Munoz,535146,311618,2022-01-06
CASH_IN,144207,Agence_moov_Cotonou,300000,155793,Rémy Grondin,135615,279822,2022-01-07
CASH_IN,173990,Agence_moov_Ouidah,300000,126010,Rémy Grondin,279822,453812,2022-01-10
TRANSFER,112421,Rémy Grondin,453812,341391,Michelle de Étienne,646547,534126,2022-01-11
TRANSFER,212829,Rémy Grondin,341391,128562,Françoise Morin,1901300,1688471,2022-01-12
CASH_IN,64482,Agence_moov_Abomey,300000,235518,Rémy Grondin,128562,193044,2022-01-14
CASH_IN,71238,Agence_moov_Cotonou,300000,228762,Rémy Grondin,193044,264282,2022-01-15
CASH_IN,155712,Agence_moov_Cotonou,300000,144288,Rémy Grondin,264282,419994,2022-01-15
CASH_OUT,289911,Rémy Grondin,419994,130083,Agence_moov_Abomey,300000,10089,2022-01-16
CASH_OUT,110227,Rémy Grondin,130083,19856,Agence_moov_Abomey,300000,189773,2022-01-16
CASH_IN,84568,Agence_moov_Ouidah,300000,215432,Rémy Grondin,19856,104424,2022-01-17
CASH_OUT,52621,Rémy Grondin,104424,51803,Agence_moov_Cotonou,300000,247379,2022-01-18
CASH_IN,163119,Agence_moov_Abomey,300000,136881,Rémy Grondin,51803,214922,2022-01-19
CASH_OUT,128912,Rémy Grondin,214922,86010,Agence_moov_Ouidah,300000,171088,2022-01-19
CASH_OUT,83045,Rémy Grondin,86010,2965,Agence_moov_Abomey,300000,216955,2022-01-19
TRANSFER,1960,Rémy Grondin,2965,1005,Camille Prévost,811672,809712,2022-01-21
CASH_IN,160991,Agence_moov_Cotonou,300000,139009,Rémy Grondin,1005,161996,2022-01-22
CASH_OUT,35250,Rémy Grondin,161996,126746,Agence_moov_Cotonou,300000,264750,2022-01-23
TRANSFER,19955,Rémy Grondin,126746,106791,Christine Texier,552098,532143,2022-01-23
CASH_IN,133668,Agence_moov_Cotonou,300000,166332,Rémy Grondin,106791,240459,2022-01-24
TRANSFER,15999,Alphonse Gomes,26387,10388,Rémy Grondin,240459,256458,2022-01-25
CASH_IN,78353,Agence_moov_Ouidah,300000,221647,Rémy Grondin,256458,334811,2022-01-26
CASH_OUT,779596,Luc Lévêque-Carre,1115277,335681,Agence_moov_Abomey,300000,-479596,2022-01-01
CASH_OUT,146576,Luc Lévêque-Carre,335681,189105,Agence_moov_Ouidah,300000,153424,2022-01-01
CASH_OUT,101281,Luc Lévêque-Carre,189105,87824,Agence_moov_Abomey,300000,198719,2022-01-02
TRANSFER,62890,Luc Lévêque-Carre,87824,24934,Tristan Gomez,58500,-4390,2022-01-02
CASH_IN,106288,Agence_moov_Ouidah,300000,193712,Luc Lévêque-Carre,24934,131222,2022-01-03
CASH_IN,287797,Agence_moov_Abomey,300000,12203,Luc Lévêque-Carre,131222,419019,2022-01-05
CASH_OUT,276295,Luc Lévêque-Carre,419019,142724,Agence_moov_Ouidah,300000,23705,2022-01-06
CASH_IN,153545,Agence_moov_Ouidah,300000,146455,Luc Lévêque-Carre,142724,296269,2022-01-07
CASH_IN,132504,Agence_moov_Abomey,300000,167496,Luc Lévêque-Carre,296269,428773,2022-01-08
TRANSFER,208386,Luc Lévêque-Carre,428773,220387,Sabine Pineau,399925,191539,2022-01-09
TRANSFER,72361,Luc Lévêque-Carre,220387,148026,Nath Loiseau,160175,87814,2022-01-11
CASH_IN,289065,Agence_moov_Ouidah,300000,10935,Luc Lévêque-Carre,148026,437091,2022-01-11
CASH_IN,291814,Agence_moov_Cotonou,300000,8186,Luc Lévêque-Carre,437091,728905,2022-01-12
CASH_OUT,509755,Luc Lévêque-Carre,728905,219150,Agence_moov_Ouidah,300000,-209755,2022-01-13
TRANSFER,619716,Renée Rousseau-Henry,733420,113704,Luc Lévêque-Carre,219150,838866,2022-01-13
CASH_IN,81936,Agence_moov_Ouidah,300000,218064,Luc Lévêque-Carre,838866,920802,2022-01-14
CASH_IN,61759,Agence_moov_Cotonou,300000,238241,Luc Lévêque-Carre,920802,982561,2022-01-15
CASH_OUT,392170,Luc Lévêque-Carre,982561,590391,Agence_moov_Cotonou,300000,-92170,2022-01-16
TRANSFER,219847,Marcelle-Valentine Guibert,220458,611,Luc Lévêque-Carre,590391,810238,2022-01-17
TRANSFER,1151935,Richard Le Lévêque,1187700,35765,Luc Lévêque-Carre,810238,1962173,2022-01-19
TRANSFER,239375,Luc Lévêque-Carre,1962173,1722798,Sabine Pineau,191539,-47836,2022-01-19
CASH_IN,280478,Agence_moov_Cotonou,300000,19522,Luc Lévêque-Carre,1722798,2003276,2022-01-22
CASH_OUT,1394480,Luc Lévêque-Carre,2003276,608796,Agence_moov_Abomey,300000,-1094480,2022-01-23
CASH_OUT,321277,Luc Lévêque-Carre,608796,287519,Agence_moov_Ouidah,300000,-21277,2022-01-24
CASH_IN,91868,Agence_moov_Abomey,300000,208132,Luc Lévêque-Carre,287519,379387,2022-01-24
CASH_OUT,269214,Luc Lévêque-Carre,379387,110173,Agence_moov_Cotonou,300000,30786,2022-01-24
CASH_IN,295386,Agence_moov_Cotonou,300000,4614,Luc Lévêque-Carre,110173,405559,2022-01-25
CASH_OUT,72664,Luc Lévêque-Carre,405559,332895,Agence_moov_Abomey,300000,227336,2022-01-26
TRANSFER,82097,Luc Lévêque-Carre,332895,250798,Luc Lévêque-Carre,332895,414992,2022-01-27
CASH_IN,164405,Agence_moov_Cotonou,300000,135595,Luc Lévêque-Carre,250798,415203,2022-01-27
CASH_IN,142523,Agence_moov_Cotonou,300000,157477,Alphonse Gomes,10388,152911,2022-01-02
CASH_OUT,141524,Alphonse Gomes,152911,11387,Agence_moov_Abomey,300000,158476,2022-01-03
CASH_OUT,8109,Alphonse Gomes,11387,3278,Agence_moov_Cotonou,300000,291891,2022-01-03
CASH_OUT,1540,Alphonse Gomes,3278,1738,Agence_moov_Cotonou,300000,298460,2022-01-05
CASH_IN,8629,Agence_moov_Ouidah,300000,291371,Alphonse Gomes,1738,10367,2022-01-06
CASH_IN,14561,Agence_moov_Cotonou,300000,285439,Alphonse Gomes,10367,24928,2022-01-06
CASH_IN,212682,Agence_moov_Cotonou,300000,87318,Alphonse Gomes,24928,237610,2022-01-07
CASH_OUT,127574,Alphonse Gomes,237610,110036,Agence_moov_Cotonou,300000,172426,2022-01-07
TRANSFER,24280,Alphonse Gomes,110036,85756,Alphonse Gomes,110036,85756,2022-01-07
CASH_IN,162483,Agence_moov_Cotonou,300000,137517,Alphonse Gomes,85756,248239,2022-01-08
CASH_OUT,126615,Alphonse Gomes,248239,121624,Agence_moov_Abomey,300000,173385,2022-01-08
CASH_IN,57011,Agence_moov_Cotonou,300000,242989,Alphonse Gomes,121624,178635,2022-01-09
CASH_OUT,170350,Alphonse Gomes,178635,8285,Agence_moov_Cotonou,300000,129650,2022-01-09
CASH_OUT,7147,Alphonse Gomes,8285,1138,Agence_moov_Cotonou,300000,292853,2022-01-10
CASH_IN,82746,Agence_moov_Abomey,300000,217254,Alphonse Gomes,1138,83884,2022-01-10
TRANSFER,562587,Paul Rocher-Maillet,589149,26562,Alphonse Gomes,83884,646471,2022-01-13
CASH_OUT,628935,Alphonse Gomes,646471,17536,Agence_moov_Ouidah,300000,-328935,2022-01-13
TRANSFER,83210,Victor Michel,139551,56341,Alphonse Gomes,17536,100746,2022-01-13
TRANSFER,1374144,Astrid Lecoq,1690088,315944,Alphonse Gomes,100746,1474890,2022-01-14
CASH_OUT,1016050,Alphonse Gomes,1474890,458840,Agence_moov_Cotonou,300000,-716050,2022-01-14
CASH_OUT,246337,Alphonse Gomes,458840,212503,Agence_moov_Ouidah,300000,53663,2022-01-17
TRANSFER,154409,Alphonse Gomes,212503,58094,Anne Peltier-Raynaud,1150950,996541,2022-01-18
CASH_IN,173205,Agence_moov_Abomey,300000,126795,Alphonse Gomes,58094,231299,2022-01-19
TRANSFER,108030,Alphonse Gomes,231299,123269,Victor Michel,56341,-51689,2022-01-20
CASH_OUT,117029,Alphonse Gomes,123269,6240,Agence_moov_Ouidah,300000,182971,2022-01-22
CASH_IN,266470,Agence_moov_Ouidah,300000,33530,Alphonse Gomes,6240,272710,2022-01-24
CASH_OUT,272600,Alphonse Gomes,272710,110,Agence_moov_Cotonou,300000,27400,2022-01-24
CASH_OUT,103,Alphonse Gomes,110,7,Agence_moov_Ouidah,300000,299897,2022-01-24
CASH_IN,190401,Agence_moov_Abomey,300000,109599,Alphonse Gomes,7,190408,2022-01-24
CASH_IN,118941,Agence_moov_Cotonou,300000,181059,Victor Michel,-51689,67252,2022-01-01
CASH_IN,209043,Agence_moov_Ouidah,300000,90957,Victor Michel,67252,276295,2022-01-01
CASH_IN,189976,Agence_moov_Ouidah,300000,110024,Victor Michel,276295,466271,2022-01-01
CASH_IN,206611,Agence_moov_Cotonou,300000,93389,Victor Michel,466271,672882,2022-01-01
CASH_IN,100104,Agence_moov_Ouidah,300000,199896,Victor Michel,672882,772986,2022-01-03
CASH_IN,11133,Agence_moov_Ouidah,300000,288867,Victor Michel,772986,784119,2022-01-03
TRANSFER,94835,Michelle Samson,1946300,1851465,Victor Michel,784119,878954,2022-01-04
TRANSFER,638991,Victor Michel,878954,239963,Marcelle-Valentine Guibert,611,-638380,2022-01-04
CASH_OUT,103670,Victor Michel,239963,136293,Agence_moov_Abomey,300000,196330,2022-01-04
CASH_OUT,56537,Victor Michel,136293,79756,Agence_moov_Cotonou,300000,243463,2022-01-04
CASH_OUT,62763,Victor Michel,79756,16993,Agence_moov_Abomey,300000,237237,2022-01-06
CASH_OUT,9049,Victor Michel,16993,7944,Agence_moov_Abomey,300000,290951,2022-01-10
CASH_IN,266785,Agence_moov_Abomey,300000,33215,Victor Michel,7944,274729,2022-01-11
CASH_IN,276391,Agence_moov_Abomey,300000,23609,Victor Michel,274729,551120,2022-01-13
TRANSFER,326740,Victor Michel,551120,224380,Richard Le Lévêque,35765,-290975,2022-01-13
CASH_IN,133633,Agence_moov_Ouidah,300000,166367,Victor Michel,224380,358013,2022-01-14
CASH_OUT,313519,Victor Michel,358013,44494,Agence_moov_Ouidah,300000,-13519,2022-01-14
CASH_IN,167652,Agence_moov_Ouidah,300000,132348,Victor Michel,44494,212146,2022-01-14
TRANSFER,26247,Christine Texier,532143,505896,Victor Michel,212146,238393,2022-01-17
CASH_IN,71743,Agence_moov_Cotonou,300000,228257,Victor Michel,238393,310136,2022-01-18
TRANSFER,267395,Victor Michel,310136,42741,Robert-Louis Gosselin,2776,-264619,2022-01-18
CASH_OUT,39487,Victor Michel,42741,3254,Agence_moov_Abomey,300000,260513,2022-01-20
TRANSFER,1402,Victor Michel,3254,1852,Noël Bourgeois,182456,181054,2022-01-20
CASH_IN,219321,Agence_moov_Cotonou,300000,80679,Victor Michel,1852,221173,2022-01-21
CASH_IN,28086,Agence_moov_Abomey,300000,271914,Victor Michel,221173,249259,2022-01-22
CASH_OUT,127176,Victor Michel,249259,122083,Agence_moov_Cotonou,300000,172824,2022-01-23
CASH_OUT,120225,Victor Michel,122083,1858,Agence_moov_Abomey,300000,179775,2022-01-25
CASH_IN,243182,Agence_moov_Ouidah,300000,56818,Victor Michel,1858,245040,2022-01-26
CASH_OUT,507019,Manon Valette,1166145,659126,Agence_moov_Cotonou,300000,-207019,2022-01-01
CASH_IN,130510,Agence_moov_Cotonou,300000,169490,Manon Valette,659126,789636,2022-01-02
TRANSFER,397356,Manon Valette,789636,392280,Nicolas Salmon Le Hamon,1082600,685244,2022-01-02
CASH_IN,43838,Agence_moov_Cotonou,300000,256162,Manon Valette,392280,436118,2022-01-02
CASH_OUT,288887,Manon Valette,436118,147231,Agence_moov_Cotonou,300000,11113,2022-01-04
TRANSFER,26951,Andrée-Thérèse Mendès,84791,57840,Manon Valette,147231,174182,2022-01-08
CASH_OUT,136404,Manon Valette,174182,37778,Agence_moov_Ouidah,300000,163596,2022-01-09
CASH_OUT,37143,Manon Valette,37778,635,Agence_moov_Ouidah,300000,262857,2022-01-10
CASH_OUT,523,Manon Valette,635,112,Agence_moov_Ouidah,300000,299477,2022-01-12
CASH_OUT,112,Manon Valette,112,0,Agence_moov_Abomey,300000,299888,2022-01-12
CASH_IN,14774,Agence_moov_Cotonou,300000,285226,Manon Valette,0,14774,2022-01-13
CASH_OUT,5816,Manon Valette,14774,8958,Agence_moov_Ouidah,300000,294184,2022-01-14
CASH_IN,129480,Agence_moov_Abomey,300000,170520,Manon Valette,8958,138438,2022-01-14
CASH_OUT,129064,Manon Valette,138438,9374,Agence_moov_Ouidah,300000,170936,2022-01-16
CASH_IN,185140,Agence_moov_Cotonou,300000,114860,Manon Valette,9374,194514,2022-01-16
CASH_OUT,107466,Manon Valette,194514,87048,Agence_moov_Ouidah,300000,192534,2022-01-17
TRANSFER,36929,Manon Valette,87048,50119,Renée Rousseau-Henry,113704,76775,2022-01-19
CASH_IN,282099,Agence_moov_Ouidah,300000,17901,Manon Valette,50119,332218,2022-01-21
CASH_IN,86665,Agence_moov_Abomey,300000,213335,Manon Valette,332218,418883,2022-01-22
CASH_IN,140438,Agence_moov_Cotonou,300000,159562,Manon Valette,418883,559321,2022-01-23
CASH_IN,59587,Agence_moov_Ouidah,300000,240413,Manon Valette,559321,618908,2022-01-24
TRANSFER,178546,Manon Valette,618908,440362,Bertrand Regnier,818500,639954,2022-01-25
CASH_OUT,343425,Manon Valette,440362,96937,Agence_moov_Abomey,300000,-43425,2022-01-25
CASH_IN,5444,Agence_moov_Abomey,300000,294556,Manon Valette,96937,102381,2022-01-25
TRANSFER,207409,Astrid Lecoq,315944,108535,Nathalie Bonnin-Joubert,321216,528625,2022-01-04
TRANSFER,13736,Nathalie Bonnin-Joubert,528625,514889,Simone Muller de la Brun,3213,-10523,2022-01-05
CASH_OUT,132656,Nathalie Bonnin-Joubert,514889,382233,Agence_moov_Ouidah,300000,167344,2022-01-05
CASH_OUT,152674,Nathalie Bonnin-Joubert,382233,229559,Agence_moov_Cotonou,300000,147326,2022-01-06
CASH_IN,299164,Agence_moov_Ouidah,300000,836,Nathalie Bonnin-Joubert,229559,528723,2022-01-06
TRANSFER,275411,Nathalie Bonnin-Joubert,528723,253312,Nath Loiseau,87814,-187597,2022-01-07
TRANSFER,216062,Nathalie Bonnin-Joubert,253312,37250,Théodore Joseph-Lefebvre,1209157,993095,2022-01-07
CASH_OUT,6896,Nathalie Bonnin-Joubert,37250,30354,Agence_moov_Ouidah,300000,293104,2022-01-09
CASH_OUT,7641,Nathalie Bonnin-Joubert,30354,22713,Agence_moov_Cotonou,300000,292359,2022-01-10
CASH_IN,159887,Agence_moov_Abomey,300000,140113,Nathalie Bonnin-Joubert,22713,182600,2022-01-10
CASH_IN,106683,Agence_moov_Ouidah,300000,193317,Nathalie Bonnin-Joubert,182600,289283,2022-01-10
TRANSFER,217166,Nathalie Bonnin-Joubert,289283,72117,Camille Morvan,4875,-212291,2022-01-12
CASH_OUT,59502,Nathalie Bonnin-Joubert,72117,12615,Agence_moov_Abomey,300000,240498,2022-01-12
TRANSFER,3336,Paul Rocher-Maillet,26562,23226,Nathalie Bonnin-Joubert,12615,15951,2022-01-13
CASH_IN,289354,Agence_moov_Ouidah,300000,10646,Nathalie Bonnin-Joubert,15951,305305,2022-01-14
TRANSFER,216734,Michel Bouchet,841662,624928,Nathalie Bonnin-Joubert,305305,522039,2022-01-14
CASH_IN,160259,Agence_moov_Abomey,300000,139741,Nathalie Bonnin-Joubert,522039,682298,2022-01-16
CASH_IN,89987,Agence_moov_Ouidah,300000,210013,Nathalie Bonnin-Joubert,682298,772285,2022-01-17
CASH_IN,35137,Agence_moov_Cotonou,300000,264863,Nathalie Bonnin-Joubert,772285,807422,2022-01-18
CASH_OUT,2489,Nathalie Bonnin-Joubert,807422,804933,Agence_moov_Cotonou,300000,297511,2022-01-20
TRANSFER,39723,Andrée-Thérèse Mendès,57840,18117,Nathalie Bonnin-Joubert,804933,844656,2022-01-21
CASH_OUT,286143,Nathalie Bonnin-Joubert,844656,558513,Agence_moov_Ouidah,300000,13857,2022-01-22
CASH_OUT,134183,Nathalie Bonnin-Joubert,558513,424330,Agence_moov_Ouidah,300000,165817,2022-01-23
CASH_IN,90297,Agence_moov_Ouidah,300000,209703,Nathalie Bonnin-Joubert,424330,514627,2022-01-23
CASH_IN,250125,Agence_moov_Cotonou,300000,49875,Nathalie Bonnin-Joubert,514627,764752,2022-01-23
TRANSFER,24937,Léon Da Costa,41250,16313,Nathalie Bonnin-Joubert,764752,789689,2022-01-25
CASH_IN,116043,Agence_moov_Abomey,300000,183957,Nathalie Bonnin-Joubert,789689,905732,2022-01-26
CASH_OUT,329412,Nathalie Bonnin-Joubert,905732,576320,Agence_moov_Ouidah,300000,-29412,2022-01-26
CASH_OUT,91535,Nathalie Bonnin-Joubert,576320,484785,Agence_moov_Abomey,300000,208465,2022-01-27
TRANSFER,1675275,Françoise Morin,1688471,13196,Nathalie Bonnin-Joubert,484785,2160060,2022-01-27
CASH_IN,57853,Agence_moov_Cotonou,300000,242147,Lucie Aubert,1027174,1085027,2022-01-01
TRANSFER,862451,Lucie Aubert,1085027,222576,Frédéric Guillou,1321805,459354,2022-01-01
CASH_IN,132614,Agence_moov_Ouidah,300000,167386,Lucie Aubert,222576,355190,2022-01-02
CASH_IN,182448,Agence_moov_Abomey,300000,117552,Lucie Aubert,355190,537638,2022-01-02
TRANSFER,9297,Renée Rousseau-Henry,76775,67478,Lucie Aubert,537638,546935,2022-01-03
TRANSFER,411892,Lucie Aubert,546935,135043,Christine Texier,505896,94004,2022-01-03
CASH_OUT,119768,Lucie Aubert,135043,15275,Agence_moov_Cotonou,300000,180232,2022-01-06
TRANSFER,8598,Lucie Aubert,15275,6677,Hélène de la Gérard,1248214,1239616,2022-01-08
TRANSFER,730993,Camille Prévost,809712,78719,Lucie Aubert,6677,737670,2022-01-12
CASH_OUT,646700,Lucie Aubert,737670,90970,Agence_moov_Abomey,300000,-346700,2022-01-13
TRANSFER,545715,Thibaut de la Lombard,732065,186350,Lucie Aubert,90970,636685,2022-01-13
CASH_OUT,111351,Lucie Aubert,636685,525334,Agence_moov_Ouidah,300000,188649,2022-01-17
CASH_OUT,469013,Lucie Aubert,525334,56321,Agence_moov_Cotonou,300000,-169013,2022-01-18
TRANSFER,1303,Théodore Joseph-Lefebvre,993095,991792,Lucie Aubert,56321,57624,2022-01-19
CASH_IN,34243,Agence_moov_Abomey,300000,265757,Lucie Aubert,57624,91867,2022-01-20
CASH_IN,293237,Agence_moov_Abomey,300000,6763,Lucie Aubert,91867,385104,2022-01-20
CASH_OUT,107863,Lucie Aubert,385104,277241,Agence_moov_Ouidah,300000,192137,2022-01-20
TRANSFER,84037,Lucie Aubert,277241,193204,Renée Rousseau-Henry,67478,-16559,2022-01-20
TRANSFER,97859,Lucie Aubert,193204,95345,Léon Da Costa,16313,-81546,2022-01-21
CASH_IN,61302,Agence_moov_Cotonou,300000,238698,Lucie Aubert,95345,156647,2022-01-22
CASH_IN,160126,Agence_moov_Abomey,300000,139874,Lucie Aubert,156647,316773,2022-01-23
TRANSFER,744050,Anne Peltier-Raynaud,996541,252491,Lucie Aubert,316773,1060823,2022-01-24
TRANSFER,687,Thérèse François,32738,32051,Lucie Aubert,1060823,1061510,2022-01-24
CASH_IN,181985,Agence_moov_Cotonou,300000,118015,Lucie Aubert,1061510,1243495,2022-01-25
CASH_IN,126743,Agence_moov_Abomey,300000,173257,Lucie Aubert,1243495,1370238,2022-01-27
TRANSFER,583070,Théodore Joseph-Lefebvre,991792,408722,Lucie Aubert,1370238,1953308,2022-01-27
CASH_OUT,188740,Anastasie Richard-Neveu,771894,583154,Agence_moov_Cotonou,300000,111260,2022-01-01
TRANSFER,189483,Clémence-Véronique Munoz,311618,122135,Anastasie Richard-Neveu,583154,772637,2022-01-02
TRANSFER,302058,Michelle Samson,1851465,1549407,Anastasie Richard-Neveu,772637,1074695,2022-01-02
CASH_OUT,100271,Anastasie Richard-Neveu,1074695,974424,Agence_moov_Cotonou,300000,199729,2022-01-05
TRANSFER,177425,Nicolas Salmon Le Hamon,685244,507819,Anastasie Richard-Neveu,974424,1151849,2022-01-06
CASH_OUT,267290,Anastasie Richard-Neveu,1151849,884559,Agence_moov_Abomey,300000,32710,2022-01-10
CASH_IN,203978,Agence_moov_Abomey,300000,96022,Anastasie Richard-Neveu,884559,1088537,2022-01-10
CASH_OUT,765730,Anastasie Richard-Neveu,1088537,322807,Agence_moov_Abomey,300000,-465730,2022-01-10
CASH_IN,54964,Agence_moov_Abomey,300000,245036,Anastasie Richard-Neveu,322807,377771,2022-01-10
CASH_IN,77585,Agence_moov_Cotonou,300000,222415,Anastasie Richard-Neveu,377771,455356,2022-01-10
CASH_OUT,49326,Anastasie Richard-Neveu,455356,406030,Agence_moov_Cotonou,300000,250674,2022-01-12
CASH_IN,237626,Agence_moov_Cotonou,300000,62374,Anastasie Richard-Neveu,406030,643656,2022-01-14
CASH_OUT,356600,Anastasie Richard-Neveu,643656,287056,Agence_moov_Ouidah,300000,-56600,2022-01-16
CASH_OUT,221262,Anastasie Richard-Neveu,287056,65794,Agence_moov_Cotonou,300000,78738,2022-01-16
TRANSFER,25650,Anastasie Richard-Neveu,65794,40144,Bertrand Regnier,639954,614304,2022-01-17
CASH_OUT,4693,Anastasie Richard-Neveu,40144,35451,Agence_moov_Abomey,300000,295307,2022-01-18
CASH_OUT,16851,Anastasie Richard-Neveu,35451,18600,Agence_moov_Abomey,300000,283149,2022-01-19
CASH_IN,240310,Agence_moov_Ouidah,300000,59690,Anastasie Richard-Neveu,18600,258910,2022-01-19
TRANSFER,206407,Anastasie Richard-Neveu,258910,52503,Noël Bourgeois,181054,-25353,2022-01-20
TRANSFER,49666,Anastasie Richard-Neveu,52503,2837,Suzanne Bodin,711900,662234,2022-01-21
CASH_OUT,2395,Anastasie Richard-Neveu,2837,442,Agence_moov_Abomey,300000,297605,2022-01-21
TRANSFER,442,Anastasie Richard-Neveu,442,0,Anastasie Richard-Neveu,442,0,2022-01-21
CASH_IN,59519,Agence_moov_Cotonou,300000,240481,Anastasie Richard-Neveu,0,59519,2022-01-23
TRANSFER,69440,Thibaut de la Lombard,186350,116910,Anastasie Richard-Neveu,59519,128959,2022-01-23
CASH_IN,137506,Agence_moov_Abomey,300000,162494,Anastasie Richard-Neveu,128959,266465,2022-01-24
CASH_IN,173723,Agence_moov_Ouidah,300000,126277,Anastasie Richard-Neveu,266465,440188,2022-01-26
CASH_IN,200417,Agence_moov_Ouidah,300000,99583,Thérèse François,32051,232468,2022-01-04
CASH_OUT,59742,Thérèse François,232468,172726,Agence_moov_Abomey,300000,240258,2022-01-06
CASH_IN,129609,Agence_moov_Ouidah,300000,170391,Thérèse François,172726,302335,2022-01-06
CASH_OUT,217522,Thérèse François,302335,84813,Agence_moov_Abomey,300000,82478,2022-01-07
CASH_IN,46038,Agence_moov_Abomey,300000,253962,Thérèse François,84813,130851,2022-01-09
TRANSFER,55296,Thérèse François,130851,75555,Thérèse François,130851,186147,2022-01-10
CASH_IN,228669,Agence_moov_Abomey,300000,71331,Thérèse François,75555,304224,2022-01-13
CASH_IN,287706,Agence_moov_Cotonou,300000,12294,Thérèse François,304224,591930,2022-01-14
TRANSFER,962509,Agnès Le Giraud,1234971,272462,Thérèse François,591930,1554439,2022-01-14
CASH_IN,140671,Agence_moov_Ouidah,300000,159329,Thérèse François,1554439,1695110,2022-01-16
CASH_OUT,374083,Thérèse François,1695110,1321027,Agence_moov_Ouidah,300000,-74083,2022-01-17
CASH_IN,60272,Agence_moov_Ouidah,300000,239728,Thérèse François,1321027,1381299,2022-01-19
TRANSFER,9783,Martine Aubert,32398,22615,Thérèse François,1381299,1391082,2022-01-21
CASH_OUT,739714,Thérèse François,1391082,651368,Agence_moov_Ouidah,300000,-439714,2022-01-22
CASH_OUT,600469,Thérèse François,651368,50899,Agence_moov_Cotonou,300000,-300469,2022-01-24
CASH_IN,224544,Agence_moov_Ouidah,300000,75456,Thérèse François,50899,275443,2022-01-24
CASH_OUT,184196,Thérèse François,275443,91247,Agence_moov_Abomey,300000,115804,2022-01-25
CASH_IN,251726,Agence_moov_Abomey,300000,48274,Thérèse François,91247,342973,2022-01-26
TRANSFER,56749,Thomas Guichard du Renault,374269,317520,Thérèse François,342973,399722,2022-01-27
CASH_IN,254856,Agence_moov_Abomey,300000,45144,Thérèse François,399722,654578,2022-01-27
TRANSFER,353315,Thérèse François,654578,301263,Marthe Gilles,14703,-338612,2022-01-27
CASH_IN,233794,Agence_moov_Ouidah,300000,66206,Vincent Joubert,-377347,-143553,2022-01-02
CASH_IN,31812,Agence_moov_Ouidah,300000,268188,Vincent Joubert,-143553,-111741,2022-01-02
CASH_IN,198964,Agence_moov_Ouidah,300000,101036,Vincent Joubert,-111741,87223,2022-01-02
CASH_IN,147246,Agence_moov_Ouidah,300000,152754,Vincent Joubert,87223,234469,2022-01-02
CASH_OUT,210824,Vincent Joubert,234469,23645,Agence_moov_Cotonou,300000,89176,2022-01-03
CASH_OUT,7668,Vincent Joubert,23645,15977,Agence_moov_Ouidah,300000,292332,2022-01-03
CASH_IN,38673,Agence_moov_Ouidah,300000,261327,Vincent Joubert,15977,54650,2022-01-03
CASH_OUT,16454,Vincent Joubert,54650,38196,Agence_moov_Cotonou,300000,283546,2022-01-03
CASH_OUT,7904,Vincent Joubert,38196,30292,Agence_moov_Ouidah,300000,292096,2022-01-05
TRANSFER,10668,Vincent Joubert,30292,19624,Paul Rocher-Maillet,23226,12558,2022-01-07
CASH_IN,53185,Agence_moov_Cotonou,300000,246815,Vincent Joubert,19624,72809,2022-01-07
CASH_IN,31034,Agence_moov_Abomey,300000,268966,Vincent Joubert,72809,103843,2022-01-08
CASH_IN,179198,Agence_moov_Ouidah,300000,120802,Vincent Joubert,103843,283041,2022-01-09
CASH_OUT,267537,Vincent Joubert,283041,15504,Agence_moov_Ouidah,300000,32463,2022-01-10
CASH_OUT,7320,Vincent Joubert,15504,8184,Agence_moov_Abomey,300000,292680,2022-01-10
CASH_IN,18547,Agence_moov_Cotonou,300000,281453,Vincent Joubert,8184,26731,2022-01-12
CASH_IN,8668,Agence_moov_Ouidah,300000,291332,Vincent Joubert,26731,35399,2022-01-12
CASH_IN,23573,Agence_moov_Cotonou,300000,276427,Vincent Joubert,35399,58972,2022-01-13
CASH_OUT,5271,Vincent Joubert,58972,53701,Agence_moov_Abomey,300000,294729,2022-01-13
CASH_OUT,13325,Vincent Joubert,53701,40376,Agence_moov_Ouidah,300000,286675,2022-01-15
TRANSFER,389529,Frédéric Guillou,459354,69825,Vincent Joubert,40376,429905,2022-01-16
CASH_OUT,386510,Vincent Joubert,429905,43395,Agence_moov_Ouidah,300000,-86510,2022-01-16
CASH_OUT,20024,Vincent Joubert,43395,23371,Agence_moov_Abomey,300000,279976,2022-01-16
CASH_OUT,17432,Vincent Joubert,23371,5939,Agence_moov_Cotonou,300000,282568,2022-01-20
CASH_IN,141255,Agence_moov_Cotonou,300000,158745,Vincent Joubert,5939,147194,2022-01-20
TRANSFER,478461,Michelle de Étienne,534126,55665,Vincent Joubert,147194,625655,2022-01-23
CASH_IN,282408,Agence_moov_Ouidah,300000,17592,Vincent Joubert,625655,908063,2022-01-24
TRANSFER,543418,Bertrand Regnier,614304,70886,Vincent Joubert,908063,1451481,2022-01-24
TRANSFER,1414739,Michelle Samson,1549407,134668,Vincent Joubert,1451481,2866220,2022-01-24
TRANSFER,91640,Frédérique Fernandes du Bouchet,127991,36351,Alix Barbe,1640973,1732613,2022-01-05
TRANSFER,7971,Paul Rocher-Maillet,12558,4587,Alix Barbe,1732613,1740584,2022-01-10
TRANSFER,152919,Théodore Joseph-Lefebvre,408722,255803,Alix Barbe,1740584,1893503,2022-01-15
TRANSFER,172470,Jules-Roland Bousquet,1469650,1297180,Alix Barbe,1893503,2065973,2022-01-23
CASH_IN,207355,Agence_moov_Ouidah,300000,92645,Alix Barbe,2065973,2273328,2022-01-24
CASH_OUT,845595,Alix Barbe,2273328,1427733,Agence_moov_Ouidah,300000,-545595,2022-01-26
CASH_IN,280579,Agence_moov_Abomey,300000,19421,Alix Barbe,1427733,1708312,2022-01-26
CASH_IN,88528,Agence_moov_Cotonou,300000,211472,Emmanuel Grégoire,43,88571,2022-01-02
CASH_IN,183483,Agence_moov_Cotonou,300000,116517,Emmanuel Grégoire,88571,272054,2022-01-15
TRANSFER,104696,Emmanuel Grégoire,272054,167358,Thibaut de la Lombard,116910,12214,2022-01-17
CASH_OUT,83059,Emmanuel Grégoire,167358,84299,Agence_moov_Ouidah,300000,216941,2022-01-17
CASH_IN,240015,Agence_moov_Cotonou,300000,59985,Emmanuel Grégoire,84299,324314,2022-01-20
CASH_OUT,183074,Emmanuel Grégoire,324314,141240,Agence_moov_Abomey,300000,116926,2022-01-22
CASH_OUT,430089,Constance Bourdon-Millet,1249984,819895,Agence_moov_Cotonou,300000,-130089,2022-01-01
CASH_OUT,564318,Constance Bourdon-Millet,819895,255577,Agence_moov_Cotonou,300000,-264318,2022-01-01
CASH_IN,28131,Agence_moov_Abomey,300000,271869,Constance Bourdon-Millet,255577,283708,2022-01-06
TRANSFER,262262,Constance Bourdon-Millet,283708,21446,Françoise Morin,13196,-249066,2022-01-07
CASH_IN,166712,Agence_moov_Cotonou,300000,133288,Constance Bourdon-Millet,21446,188158,2022-01-15
CASH_IN,151312,Agence_moov_Cotonou,300000,148688,Constance Bourdon-Millet,188158,339470,2022-01-21
CASH_IN,132901,Agence_moov_Ouidah,300000,167099,Constance Bourdon-Millet,339470,472371,2022-01-27
CASH_IN,243948,Agence_moov_Ouidah,300000,56052,Timothée-René Blanchard,-121321,122627,2022-01-01
CASH_IN,4180,Agence_moov_Cotonou,300000,295820,Timothée-René Blanchard,122627,126807,2022-01-06
TRANSFER,82217,Timothée-René Blanchard,126807,44590,Camille Prévost,78719,-3498,2022-01-10
CASH_IN,226651,Agence_moov_Abomey,300000,73349,Timothée-René Blanchard,44590,271241,2022-01-11
CASH_OUT,208470,Timothée-René Blanchard,271241,62771,Agence_moov_Cotonou,300000,91530,2022-01-12
CASH_OUT,26701,Timothée-René Blanchard,62771,36070,Agence_moov_Abomey,300000,273299,2022-01-16
CASH_IN,269583,Agence_moov_Abomey,300000,30417,Timothée-René Blanchard,36070,305653,2022-01-20
CASH_IN,58134,Agence_moov_Abomey,300000,241866,Timothée-René Blanchard,305653,363787,2022-01-25
CASH_IN,202669,Agence_moov_Cotonou,300000,97331,Paul Rocher-Maillet,4587,207256,2022-01-07
CASH_OUT,207242,Paul Rocher-Maillet,207256,14,Agence_moov_Cotonou,300000,92758,2022-01-09
CASH_IN,28900,Agence_moov_Cotonou,300000,271100,Paul Rocher-Maillet,14,28914,2022-01-10
CASH_IN,240932,Agence_moov_Abomey,300000,59068,Paul Rocher-Maillet,28914,269846,2022-01-10
CASH_OUT,96413,Paul Rocher-Maillet,269846,173433,Agence_moov_Cotonou,300000,203587,2022-01-11
CASH_OUT,65392,Paul Rocher-Maillet,173433,108041,Agence_moov_Cotonou,300000,234608,2022-01-21
TRANSFER,102814,Paul Rocher-Maillet,108041,5227,Thomas Guichard du Renault,317520,214706,2022-01-27
CASH_IN,249307,Agence_moov_Cotonou,300000,50693,Nath Loiseau,-187597,61710,2022-01-04
CASH_OUT,48712,Nath Loiseau,61710,12998,Agence_moov_Abomey,300000,251288,2022-01-06
TRANSFER,241121,Anne Peltier-Raynaud,252491,11370,Nath Loiseau,12998,254119,2022-01-06
TRANSFER,83824,Nath Loiseau,254119,170295,Tristan Bousquet-Gros,274356,190532,2022-01-06
CASH_IN,71946,Agence_moov_Cotonou,300000,228054,Nath Loiseau,170295,242241,2022-01-09
CASH_IN,59804,Agence_moov_Cotonou,300000,240196,Nath Loiseau,242241,302045,2022-01-09
CASH_OUT,2247,Nath Loiseau,302045,299798,Agence_moov_Ouidah,300000,297753,2022-01-11
CASH_OUT,51209,Nath Loiseau,299798,248589,Agence_moov_Abomey,300000,248791,2022-01-12
CASH_IN,178948,Agence_moov_Abomey,300000,121052,Nath Loiseau,248589,427537,2022-01-12
CASH_OUT,27195,Nath Loiseau,427537,400342,Agence_moov_Ouidah,300000,272805,2022-01-14
TRANSFER,130117,Michelle Samson,134668,4551,Nath Loiseau,400342,530459,2022-01-16
TRANSFER,11342,Aurore Charrier,29792,18450,Nath Loiseau,530459,541801,2022-01-17
CASH_OUT,150898,Nath Loiseau,541801,390903,Agence_moov_Ouidah,300000,149102,2022-01-23
CASH_IN,2843,Agence_moov_Ouidah,300000,297157,Sabine Pineau,-47836,-44993,2022-01-03
CASH_IN,253303,Agence_moov_Ouidah,300000,46697,Sabine Pineau,-44993,208310,2022-01-04
CASH_IN,269771,Agence_moov_Cotonou,300000,30229,Sabine Pineau,208310,478081,2022-01-06
CASH_IN,183321,Agence_moov_Abomey,300000,116679,Sabine Pineau,478081,661402,2022-01-06
CASH_OUT,532311,Sabine Pineau,661402,129091,Agence_moov_Ouidah,300000,-232311,2022-01-08
TRANSFER,30889,Clémence-Véronique Munoz,122135,91246,Sabine Pineau,129091,159980,2022-01-10
TRANSFER,183197,Nicolas Salmon Le Hamon,507819,324622,Sabine Pineau,159980,343177,2022-01-12
CASH_IN,286957,Agence_moov_Cotonou,300000,13043,Sabine Pineau,343177,630134,2022-01-12
CASH_OUT,81097,Sabine Pineau,630134,549037,Agence_moov_Cotonou,300000,218903,2022-01-13
CASH_OUT,443122,Sabine Pineau,549037,105915,Agence_moov_Abomey,300000,-143122,2022-01-15
CASH_OUT,11924,Sabine Pineau,105915,93991,Agence_moov_Abomey,300000,288076,2022-01-16
CASH_OUT,23155,Sabine Pineau,93991,70836,Agence_moov_Ouidah,300000,276845,2022-01-16
CASH_IN,289356,Agence_moov_Ouidah,300000,10644,Sabine Pineau,70836,360192,2022-01-17
CASH_OUT,273129,Sabine Pineau,360192,87063,Agence_moov_Ouidah,300000,26871,2022-01-20
TRANSFER,29052,Sabine Pineau,87063,58011,Thibaut de la Lombard,12214,-16838,2022-01-21
TRANSFER,52636,Sabine Pineau,58011,5375,Martine Aubert,22615,-30021,2022-01-23
TRANSFER,732,Bernard Maurice,352906,352174,Manon Lebon,2857,3589,2022-01-05
CASH_IN,140701,Agence_moov_Cotonou,300000,159299,Manon Lebon,3589,144290,2022-01-05
TRANSFER,16135,Thomas Guichard du Renault,214706,198571,Manon Lebon,144290,160425,2022-01-12
CASH_OUT,44808,Manon Lebon,160425,115617,Agence_moov_Cotonou,300000,255192,2022-01-18
CASH_IN,189693,Agence_moov_Abomey,300000,110307,Manon Lebon,115617,305310,2022-01-18
CASH_OUT,98638,Manon Lebon,305310,206672,Agence_moov_Ouidah,300000,201362,2022-01-21
TRANSFER,131409,Manon Lebon,206672,75263,Audrey Julien de Leleu,1477540,1346131,2022-01-22
CASH_IN,44319,Agence_moov_Abomey,300000,255681,Manon Lebon,75263,119582,2022-01-24
CASH_IN,68520,Agence_moov_Abomey,300000,231480,Manon Lebon,119582,188102,2022-01-24
TRANSFER,193479,Agnès Le Giraud,272462,78983,Manon Lebon,188102,381581,2022-01-26
CASH_IN,196637,Agence_moov_Abomey,300000,103363,Thomas Guichard du Renault,198571,395208,2022-01-04
TRANSFER,2999,Maggie Martinez,13949,10950,Thomas Guichard du Renault,395208,398207,2022-01-06
CASH_OUT,320778,Thomas Guichard du Renault,398207,77429,Agence_moov_Abomey,300000,-20778,2022-01-09
TRANSFER,36474,Thomas Guichard du Renault,77429,40955,Andrée-Thérèse Mendès,18117,-18357,2022-01-16
TRANSFER,38792,Thomas Guichard du Renault,40955,2163,Jules-Roland Bousquet,1297180,1258388,2022-01-20
TRANSFER,1165,Thomas Guichard du Renault,2163,998,Michelle de Étienne,55665,54500,2022-01-25
CASH_IN,20905,Agence_moov_Ouidah,300000,279095,Jules-Roland Bousquet,1258388,1279293,2022-01-02
TRANSFER,1077055,Jules-Roland Bousquet,1279293,202238,Frédéric Guillou,69825,-1007230,2022-01-03
CASH_IN,108209,Agence_moov_Abomey,300000,191791,Jules-Roland Bousquet,202238,310447,2022-01-04
TRANSFER,4989,Jules-Roland Bousquet,310447,305458,André Renault,655446,650457,2022-01-04
CASH_OUT,285019,Jules-Roland Bousquet,305458,20439,Agence_moov_Cotonou,300000,14981,2022-01-07
CASH_OUT,12475,Jules-Roland Bousquet,20439,7964,Agence_moov_Cotonou,300000,287525,2022-01-08
TRANSFER,567441,Michel Bouchet,624928,57487,Jules-Roland Bousquet,7964,575405,2022-01-08
CASH_OUT,195641,Jules-Roland Bousquet,575405,379764,Agence_moov_Cotonou,300000,104359,2022-01-10
CASH_OUT,374401,Jules-Roland Bousquet,379764,5363,Agence_moov_Ouidah,300000,-74401,2022-01-12
CASH_OUT,162,Jules-Roland Bousquet,5363,5201,Agence_moov_Ouidah,300000,299838,2022-01-13
TRANSFER,1368,Jules-Roland Bousquet,5201,3833,Astrid Lecoq,108535,107167,2022-01-14
CASH_IN,195423,Agence_moov_Abomey,300000,104577,Jules-Roland Bousquet,3833,199256,2022-01-15
CASH_OUT,74134,Jules-Roland Bousquet,199256,125122,Agence_moov_Cotonou,300000,225866,2022-01-16
CASH_OUT,99235,Jules-Roland Bousquet,125122,25887,Agence_moov_Ouidah,300000,200765,2022-01-20
CASH_OUT,10213,Jules-Roland Bousquet,25887,15674,Agence_moov_Ouidah,300000,289787,2022-01-20
CASH_OUT,287051,Suzanne Bodin,662234,375183,Agence_moov_Ouidah,300000,12949,2022-01-01
CASH_IN,261251,Agence_moov_Ouidah,300000,38749,Suzanne Bodin,375183,636434,2022-01-01
CASH_OUT,483303,Suzanne Bodin,636434,153131,Agence_moov_Cotonou,300000,-183303,2022-01-03
CASH_IN,49797,Agence_moov_Abomey,300000,250203,Suzanne Bodin,153131,202928,2022-01-04
CASH_IN,49815,Agence_moov_Abomey,300000,250185,Suzanne Bodin,202928,252743,2022-01-04
CASH_IN,40876,Agence_moov_Ouidah,300000,259124,Suzanne Bodin,252743,293619,2022-01-05
CASH_IN,186535,Agence_moov_Cotonou,300000,113465,Suzanne Bodin,293619,480154,2022-01-06
CASH_OUT,117677,Suzanne Bodin,480154,362477,Agence_moov_Ouidah,300000,182323,2022-01-07
TRANSFER,2693,Michelle Samson,4551,1858,Suzanne Bodin,362477,365170,2022-01-10
TRANSFER,322430,Suzanne Bodin,365170,42740,Clémence-Véronique Munoz,91246,-231184,2022-01-11
CASH_IN,134925,Agence_moov_Ouidah,300000,165075,Suzanne Bodin,42740,177665,2022-01-15
CASH_IN,216013,Agence_moov_Ouidah,300000,83987,Suzanne Bodin,177665,393678,2022-01-23
CASH_OUT,72871,Suzanne Bodin,393678,320807,Agence_moov_Ouidah,300000,227129,2022-01-24
CASH_IN,16287,Agence_moov_Ouidah,300000,283713,Suzanne Bodin,320807,337094,2022-01-24
TRANSFER,254252,Suzanne Bodin,337094,82842,Michel Bouchet,57487,-196765,2022-01-26
TRANSFER,5597,Maggie Martinez,10950,5353,Tristan Bousquet-Gros,190532,196129,2022-01-06
CASH_OUT,162502,Tristan Bousquet-Gros,196129,33627,Agence_moov_Ouidah,300000,137498,2022-01-09
CASH_OUT,26380,Tristan Bousquet-Gros,33627,7247,Agence_moov_Abomey,300000,273620,2022-01-10
TRANSFER,508579,André Renault,650457,141878,Tristan Bousquet-Gros,7247,515826,2022-01-11
CASH_OUT,340529,Tristan Bousquet-Gros,515826,175297,Agence_moov_Cotonou,300000,-40529,2022-01-15
CASH_IN,299870,Agence_moov_Abomey,300000,130,Tristan Bousquet-Gros,175297,475167,2022-01-20
CASH_OUT,414897,Tristan Bousquet-Gros,475167,60270,Agence_moov_Cotonou,300000,-114897,2022-01-21
CASH_OUT,48872,Tristan Bousquet-Gros,60270,11398,Agence_moov_Ouidah,300000,251128,2022-01-22
CASH_IN,193971,Agence_moov_Abomey,300000,106029,Tristan Bousquet-Gros,11398,205369,2022-01-26
CASH_OUT,524578,Hélène de la Gérard,1239616,715038,Agence_moov_Ouidah,300000,-224578,2022-01-02
CASH_OUT,564253,Hélène de la Gérard,715038,150785,Agence_moov_Abomey,300000,-264253,2022-01-06
CASH_IN,129993,Agence_moov_Ouidah,300000,170007,Hélène de la Gérard,150785,280778,2022-01-07
CASH_IN,39963,Agence_moov_Cotonou,300000,260037,Hélène de la Gérard,280778,320741,2022-01-07
TRANSFER,288609,Hélène de la Gérard,320741,32132,Astrid Lecoq,107167,-181442,2022-01-13
CASH_IN,85973,Agence_moov_Ouidah,300000,214027,Hélène de la Gérard,32132,118105,2022-01-13
CASH_IN,115481,Agence_moov_Cotonou,300000,184519,Hélène de la Gérard,118105,233586,2022-01-13
TRANSFER,92606,Hélène de la Gérard,233586,140980,Agnès Le Giraud,78983,-13623,2022-01-15
TRANSFER,122919,Hélène de la Gérard,140980,18061,Bertrand Regnier,70886,-52033,2022-01-16
CASH_IN,6511,Agence_moov_Abomey,300000,293489,Hélène de la Gérard,18061,24572,2022-01-16
CASH_IN,161512,Agence_moov_Abomey,300000,138488,Hélène de la Gérard,24572,186084,2022-01-18
TRANSFER,98785,Hélène de la Gérard,186084,87299,Bernard Maurice,352174,253389,2022-01-20
CASH_IN,234715,Agence_moov_Cotonou,300000,65285,Hélène de la Gérard,87299,322014,2022-01-20
CASH_OUT,30789,Hélène de la Gérard,322014,291225,Agence_moov_Ouidah,300000,269211,2022-01-21
CASH_IN,291082,Agence_moov_Abomey,300000,8918,Hélène de la Gérard,291225,582307,2022-01-22
CASH_IN,213846,Agence_moov_Cotonou,300000,86154,Hélène de la Gérard,582307,796153,2022-01-27
TRANSFER,206180,Nicolas Salmon Le Hamon,324622,118442,Hélène de la Gérard,796153,1002333,2022-01-27
CASH_OUT,720,Michelle Samson,1858,1138,Agence_moov_Ouidah,300000,299280,2022-01-03
CASH_IN,177172,Agence_moov_Cotonou,300000,122828,Michelle Samson,1138,178310,2022-01-07
TRANSFER,7508,Aurore Charrier,18450,10942,Michelle Samson,178310,185818,2022-01-07
CASH_OUT,120594,Michelle Samson,185818,65224,Agence_moov_Ouidah,300000,179406,2022-01-07
CASH_IN,126863,Agence_moov_Cotonou,300000,173137,Michelle Samson,65224,192087,2022-01-08
CASH_OUT,157987,Michelle Samson,192087,34100,Agence_moov_Cotonou,300000,142013,2022-01-08
TRANSFER,5925,Aurore Charrier,10942,5017,Michelle Samson,34100,40025,2022-01-10
CASH_OUT,39656,Michelle Samson,40025,369,Agence_moov_Ouidah,300000,260344,2022-01-11
TRANSFER,19106,Frédérique Fernandes du Bouchet,36351,17245,Michelle Samson,369,19475,2022-01-14
TRANSFER,1904,Michelle Samson,19475,17571,Bernard Maurice,253389,251485,2022-01-14
TRANSFER,4188,Michelle Samson,17571,13383,Bernard Maurice,251485,247297,2022-01-14
CASH_IN,54378,Agence_moov_Abomey,300000,245622,Michelle Samson,13383,67761,2022-01-15
CASH_OUT,41885,Michelle Samson,67761,25876,Agence_moov_Ouidah,300000,258115,2022-01-17
CASH_IN,263043,Agence_moov_Cotonou,300000,36957,Michelle Samson,25876,288919,2022-01-17
CASH_IN,251603,Agence_moov_Ouidah,300000,48397,Michelle Samson,288919,540522,2022-01-18
CASH_OUT,297514,Michelle Samson,540522,243008,Agence_moov_Ouidah,300000,2486,2022-01-23
TRANSFER,146973,Michelle Samson,243008,96035,Frédérique Fernandes du Bouchet,17245,-129728,2022-01-27
CASH_IN,210646,Agence_moov_Cotonou,300000,89354,Richard Le Lévêque,-290975,-80329,2022-01-01
CASH_IN,95777,Agence_moov_Cotonou,300000,204223,Richard Le Lévêque,-80329,15448,2022-01-03
CASH_OUT,14691,Richard Le Lévêque,15448,757,Agence_moov_Ouidah,300000,285309,2022-01-04
TRANSFER,79814,Nicolas Salmon Le Hamon,118442,38628,Richard Le Lévêque,757,80571,2022-01-11
CASH_OUT,27702,Richard Le Lévêque,80571,52869,Agence_moov_Abomey,300000,272298,2022-01-15
CASH_OUT,590,Richard Le Lévêque,52869,52279,Agence_moov_Abomey,300000,299410,2022-01-19
CASH_OUT,51765,Richard Le Lévêque,52279,514,Agence_moov_Ouidah,300000,248235,2022-01-22
TRANSFER,5873,Bernard Maurice,247297,241424,Richard Le Lévêque,514,6387,2022-01-24
CASH_OUT,4586,Richard Le Lévêque,6387,1801,Agence_moov_Ouidah,300000,295414,2022-01-26
CASH_IN,193115,Agence_moov_Abomey,300000,106885,Richard Le Lévêque,1801,194916,2022-01-27
CASH_OUT,75017,Bernard Maurice,241424,166407,Agence_moov_Cotonou,300000,224983,2022-01-08
CASH_IN,92572,Agence_moov_Abomey,300000,207428,Bernard Maurice,166407,258979,2022-01-08
CASH_IN,294704,Agence_moov_Ouidah,300000,5296,Bernard Maurice,258979,553683,2022-01-11
CASH_OUT,243527,Bernard Maurice,553683,310156,Agence_moov_Cotonou,300000,56473,2022-01-12
TRANSFER,89691,André Renault,141878,52187,Bernard Maurice,310156,399847,2022-01-12
TRANSFER,303282,Bernard Maurice,399847,96565,Bernard Maurice,399847,703129,2022-01-16
CASH_IN,3504,Agence_moov_Ouidah,300000,296496,Bernard Maurice,96565,100069,2022-01-17
TRANSFER,30617,Nicolas Salmon Le Hamon,38628,8011,Bernard Maurice,100069,130686,2022-01-17
TRANSFER,447387,Alphonse Joly,1102400,655013,Bernard Maurice,130686,578073,2022-01-21
TRANSFER,4805,Aurore Charrier,5017,212,Bernard Maurice,578073,582878,2022-01-22
CASH_OUT,410013,Bernard Maurice,582878,172865,Agence_moov_Ouidah,300000,-110013,2022-01-23
CASH_OUT,43299,Bernard Maurice,172865,129566,Agence_moov_Cotonou,300000,256701,2022-01-23
TRANSFER,13420,Bernard Maurice,129566,116146,Alphonse Joly,655013,641593,2022-01-25
TRANSFER,1289,Anne Peltier-Raynaud,11370,10081,Bernard Maurice,116146,117435,2022-01-26
CASH_OUT,45172,Bernard Maurice,117435,72263,Agence_moov_Cotonou,300000,254828,2022-01-27
CASH_IN,240867,Agence_moov_Abomey,300000,59133,Renée Rousseau-Henry,-16559,224308,2022-01-05
TRANSFER,555931,Alphonse Joly,641593,85662,Renée Rousseau-Henry,224308,780239,2022-01-17
TRANSFER,11875,Alphonse Joly,85662,73787,Renée Rousseau-Henry,780239,792114,2022-01-18
CASH_OUT,128108,Renée Rousseau-Henry,792114,664006,Agence_moov_Ouidah,300000,171892,2022-01-23
CASH_IN,135197,Agence_moov_Cotonou,300000,164803,Renée Rousseau-Henry,664006,799203,2022-01-24
TRANSFER,130,Aurore Charrier,212,82,Renée Rousseau-Henry,799203,799333,2022-01-27
CASH_IN,223678,Agence_moov_Cotonou,300000,76322,Noël Bourgeois,-25353,198325,2022-01-01
TRANSFER,48978,Noël Bourgeois,198325,149347,Anne Peltier-Raynaud,10081,-38897,2022-01-04
CASH_OUT,58455,Noël Bourgeois,149347,90892,Agence_moov_Cotonou,300000,241545,2022-01-05
TRANSFER,45320,André Renault,52187,6867,Noël Bourgeois,90892,136212,2022-01-10
CASH_IN,82396,Agence_moov_Cotonou,300000,217604,Noël Bourgeois,136212,218608,2022-01-10
CASH_OUT,87051,Noël Bourgeois,218608,131557,Agence_moov_Cotonou,300000,212949,2022-01-15
TRANSFER,87385,Noël Bourgeois,131557,44172,Alphonse Joly,73787,-13598,2022-01-16
CASH_OUT,32934,Noël Bourgeois,44172,11238,Agence_moov_Cotonou,300000,267066,2022-01-16
CASH_IN,64397,Agence_moov_Ouidah,300000,235603,Noël Bourgeois,11238,75635,2022-01-17
CASH_IN,97976,Agence_moov_Cotonou,300000,202024,Noël Bourgeois,75635,173611,2022-01-18
TRANSFER,140922,Noël Bourgeois,173611,32689,Noël Bourgeois,173611,314533,2022-01-19
CASH_IN,257019,Agence_moov_Abomey,300000,42981,Noël Bourgeois,32689,289708,2022-01-20
CASH_OUT,230770,Noël Bourgeois,289708,58938,Agence_moov_Abomey,300000,69230,2022-01-20
CASH_IN,217647,Agence_moov_Cotonou,300000,82353,Noël Bourgeois,58938,276585,2022-01-21
CASH_IN,239564,Agence_moov_Cotonou,300000,60436,Noël Bourgeois,276585,516149,2022-01-26
CASH_IN,103670,Agence_moov_Cotonou,300000,196330,Noël Bourgeois,516149,619819,2022-01-27
CASH_IN,63526,Agence_moov_Abomey,300000,236474,Bertrand Regnier,-52033,11493,2022-01-03
CASH_OUT,3872,Bertrand Regnier,11493,7621,Agence_moov_Ouidah,300000,296128,2022-01-08
CASH_IN,256823,Agence_moov_Ouidah,300000,43177,Bertrand Regnier,7621,264444,2022-01-11
CASH_OUT,34647,Bertrand Regnier,264444,229797,Agence_moov_Abomey,300000,265353,2022-01-12
CASH_IN,102657,Agence_moov_Cotonou,300000,197343,Bertrand Regnier,229797,332454,2022-01-18
CASH_OUT,319525,Bertrand Regnier,332454,12929,Agence_moov_Abomey,300000,-19525,2022-01-19
TRANSFER,2934,Nicolas Salmon Le Hamon,8011,5077,Bertrand Regnier,12929,15863,2022-01-24
CASH_IN,175762,Agence_moov_Abomey,300000,124238,Nicolas Salmon Le Hamon,5077,180839,2022-01-04
TRANSFER,371992,Audrey Julien de Leleu,1346131,974139,Nicolas Salmon Le Hamon,180839,552831,2022-01-04
CASH_IN,268990,Agence_moov_Ouidah,300000,31010,Nicolas Salmon Le Hamon,552831,821821,2022-01-04
TRANSFER,769989,Nicolas Salmon Le Hamon,821821,51832,André Renault,6867,-763122,2022-01-05
TRANSFER,120872,Audrey Julien de Leleu,974139,853267,Nicolas Salmon Le Hamon,51832,172704,2022-01-09
TRANSFER,44508,Nicolas Salmon Le Hamon,172704,128196,Nicolas Salmon Le Hamon,172704,217212,2022-01-17
TRANSFER,168205,Audrey Julien de Leleu,853267,685062,Nicolas Salmon Le Hamon,128196,296401,2022-01-18
CASH_IN,294305,Agence_moov_Ouidah,300000,5695,Nicolas Salmon Le Hamon,296401,590706,2022-01-21
TRANSFER,206520,Nicolas Salmon Le Hamon,590706,384186,Maggie Martinez,5353,-201167,2022-01-21
CASH_OUT,333192,Nicolas Salmon Le Hamon,384186,50994,Agence_moov_Abomey,300000,-33192,2022-01-23
TRANSFER,509309,Audrey Julien de Leleu,685062,175753,Nicolas Salmon Le Hamon,50994,560303,2022-01-24
TRANSFER,2213,Audrey Julien de Leleu,175753,173540,Nicolas Salmon Le Hamon,560303,562516,2022-01-25
CASH_OUT,42548,Nicolas Salmon Le Hamon,562516,519968,Agence_moov_Abomey,300000,257452,2022-01-27
CASH_IN,93588,Agence_moov_Cotonou,300000,206412,Martine Aubert,-30021,63567,2022-01-01
TRANSFER,1241,Martine Aubert,63567,62326,Audrey Julien de Leleu,173540,172299,2022-01-03
TRANSFER,26186,Martine Aubert,62326,36140,Audrey Julien de Leleu,172299,146113,2022-01-07
CASH_IN,270468,Agence_moov_Ouidah,300000,29532,Martine Aubert,36140,306608,2022-01-08
CASH_OUT,222144,Martine Aubert,306608,84464,Agence_moov_Abomey,300000,77856,2022-01-18
CASH_OUT,47152,Martine Aubert,84464,37312,Agence_moov_Cotonou,300000,252848,2022-01-20
CASH_OUT,21433,Martine Aubert,37312,15879,Agence_moov_Cotonou,300000,278567,2022-01-20
CASH_IN,143381,Agence_moov_Ouidah,300000,156619,Martine Aubert,15879,159260,2022-01-23
CASH_IN,169383,Agence_moov_Cotonou,300000,130617,Camille Morvan,-212291,-42908,2022-01-02
CASH_IN,213985,Agence_moov_Cotonou,300000,86015,Camille Morvan,-42908,171077,2022-01-03
CASH_IN,166086,Agence_moov_Cotonou,300000,133914,Camille Morvan,171077,337163,2022-01-06
CASH_IN,40061,Agence_moov_Cotonou,300000,259939,Camille Morvan,337163,377224,2022-01-10
CASH_IN,88328,Agence_moov_Abomey,300000,211672,Camille Morvan,377224,465552,2022-01-12
CASH_OUT,226700,Camille Morvan,465552,238852,Agence_moov_Abomey,300000,73300,2022-01-22
CASH_IN,69534,Agence_moov_Abomey,300000,230466,Frédérique Fernandes du Bouchet,-129728,-60194,2022-01-02
CASH_IN,63238,Agence_moov_Abomey,300000,236762,Frédérique Fernandes du Bouchet,-60194,3044,2022-01-05
CASH_IN,189901,Agence_moov_Cotonou,300000,110099,Frédérique Fernandes du Bouchet,3044,192945,2022-01-06
CASH_OUT,175256,Frédérique Fernandes du Bouchet,192945,17689,Agence_moov_Abomey,300000,124744,2022-01-14
CASH_IN,227970,Agence_moov_Ouidah,300000,72030,Frédérique Fernandes du Bouchet,17689,245659,2022-01-18
CASH_OUT,217652,Frédérique Fernandes du Bouchet,245659,28007,Agence_moov_Cotonou,300000,82348,2022-01-19
CASH_IN,180821,Agence_moov_Abomey,300000,119179,Stéphane Munoz,-434920,-254099,2022-01-01
CASH_IN,18868,Agence_moov_Cotonou,300000,281132,Stéphane Munoz,-254099,-235231,2022-01-14
CASH_IN,155837,Agence_moov_Abomey,300000,144163,Stéphane Munoz,-235231,-79394,2022-01-15
CASH_IN,197569,Agence_moov_Cotonou,300000,102431,Stéphane Munoz,-79394,118175,2022-01-19
CASH_IN,214555,Agence_moov_Abomey,300000,85445,Aurore Charrier,82,214637,2022-01-02
CASH_IN,156549,Agence_moov_Ouidah,300000,143451,Aurore Charrier,214637,371186,2022-01-03
TRANSFER,159144,Aurore Charrier,371186,212042,Aurore Charrier,371186,530330,2022-01-03
TRANSFER,43273,Aurore Charrier,212042,168769,Aurore Charrier,212042,255315,2022-01-04
CASH_IN,179383,Agence_moov_Cotonou,300000,120617,Aurore Charrier,168769,348152,2022-01-05
CASH_IN,80346,Agence_moov_Abomey,300000,219654,Aurore Charrier,348152,428498,2022-01-06
CASH_OUT,282855,Aurore Charrier,428498,145643,Agence_moov_Abomey,300000,17145,2022-01-13
CASH_OUT,108893,Aurore Charrier,145643,36750,Agence_moov_Cotonou,300000,191107,2022-01-16
CASH_IN,79162,Agence_moov_Cotonou,300000,220838,Aurore Charrier,36750,115912,2022-01-16
CASH_IN,21573,Agence_moov_Cotonou,300000,278427,Aurore Charrier,115912,137485,2022-01-16
CASH_OUT,125919,Aurore Charrier,137485,11566,Agence_moov_Ouidah,300000,174081,2022-01-20
CASH_OUT,7003,Aurore Charrier,11566,4563,Agence_moov_Cotonou,300000,292997,2022-01-22
CASH_IN,249943,Agence_moov_Abomey,300000,50057,Aurore Charrier,4563,254506,2022-01-25
CASH_OUT,156562,Aurore Charrier,254506,97944,Agence_moov_Ouidah,300000,143438,2022-01-26
CASH_IN,299332,Agence_moov_Abomey,300000,668,Astrid Lecoq,-181442,117890,2022-01-03
CASH_IN,93535,Agence_moov_Cotonou,300000,206465,Astrid Lecoq,117890,211425,2022-01-03
CASH_OUT,15860,Astrid Lecoq,211425,195565,Agence_moov_Ouidah,300000,284140,2022-01-04
CASH_IN,102612,Agence_moov_Ouidah,300000,197388,Astrid Lecoq,195565,298177,2022-01-09
CASH_OUT,203372,Astrid Lecoq,298177,94805,Agence_moov_Abomey,300000,96628,2022-01-10
CASH_IN,55902,Agence_moov_Abomey,300000,244098,Astrid Lecoq,94805,150707,2022-01-12
CASH_IN,28029,Agence_moov_Abomey,300000,271971,Astrid Lecoq,150707,178736,2022-01-22
CASH_IN,6637,Agence_moov_Ouidah,300000,293363,Astrid Lecoq,178736,185373,2022-01-24
CASH_IN,180096,Agence_moov_Ouidah,300000,119904,Astrid Lecoq,185373,365469,2022-01-27
CASH_IN,84806,Agence_moov_Cotonou,300000,215194,André Renault,-763122,-678316,2022-01-01
CASH_IN,12961,Agence_moov_Ouidah,300000,287039,André Renault,-678316,-665355,2022-01-03
CASH_IN,200270,Agence_moov_Abomey,300000,99730,André Renault,-665355,-465085,2022-01-06
CASH_IN,215110,Agence_moov_Abomey,300000,84890,André Renault,-465085,-249975,2022-01-07
CASH_IN,154564,Agence_moov_Abomey,300000,145436,André Renault,-249975,-95411,2022-01-08
CASH_IN,105299,Agence_moov_Abomey,300000,194701,André Renault,-95411,9888,2022-01-09
CASH_IN,114019,Agence_moov_Abomey,300000,185981,André Renault,9888,123907,2022-01-10
TRANSFER,110757,André Renault,123907,13150,André Renault,123907,13150,2022-01-13
CASH_IN,101979,Agence_moov_Cotonou,300000,198021,André Renault,13150,115129,2022-01-14
TRANSFER,78645,André Renault,115129,36484,André Renault,115129,193774,2022-01-14
CASH_IN,248555,Agence_moov_Cotonou,300000,51445,André Renault,36484,285039,2022-01-14
CASH_OUT,111674,André Renault,285039,173365,Agence_moov_Abomey,300000,188326,2022-01-18
CASH_OUT,109549,André Renault,173365,63816,Agence_moov_Abomey,300000,190451,2022-01-21
CASH_OUT,1017,André Renault,63816,62799,Agence_moov_Ouidah,300000,298983,2022-01-22
CASH_OUT,28089,André Renault,62799,34710,Agence_moov_Ouidah,300000,271911,2022-01-22
CASH_OUT,21319,André Renault,34710,13391,Agence_moov_Abomey,300000,278681,2022-01-24
CASH_OUT,6879,André Renault,13391,6512,Agence_moov_Abomey,300000,293121,2022-01-24
CASH_IN,110034,Agence_moov_Abomey,300000,189966,Anne Peltier-Raynaud,-38897,71137,2022-01-03
CASH_IN,264906,Agence_moov_Ouidah,300000,35094,Anne Peltier-Raynaud,71137,336043,2022-01-20
CASH_OUT,328156,Anne Peltier-Raynaud,336043,7887,Agence_moov_Cotonou,300000,-28156,2022-01-20
CASH_OUT,1032,Anne Peltier-Raynaud,7887,6855,Agence_moov_Abomey,300000,298968,2022-01-24
CASH_IN,118902,Agence_moov_Cotonou,300000,181098,Clémence-Véronique Munoz,-231184,-112282,2022-01-02
CASH_IN,169790,Agence_moov_Cotonou,300000,130210,Clémence-Véronique Munoz,-112282,57508,2022-01-03
CASH_OUT,4509,Clémence-Véronique Munoz,57508,52999,Agence_moov_Ouidah,300000,295491,2022-01-10
CASH_IN,78556,Agence_moov_Ouidah,300000,221444,Clémence-Véronique Munoz,52999,131555,2022-01-11
CASH_IN,101328,Agence_moov_Cotonou,300000,198672,Clémence-Véronique Munoz,131555,232883,2022-01-13
TRANSFER,1816,Clémence-Véronique Munoz,232883,231067,Clémence-Véronique Munoz,232883,231067,2022-01-14
CASH_IN,242675,Agence_moov_Cotonou,300000,57325,Clémence-Véronique Munoz,231067,473742,2022-01-22
CASH_IN,125144,Agence_moov_Cotonou,300000,174856,Clémence-Véronique Munoz,473742,598886,2022-01-24
CASH_OUT,240063,Clémence-Véronique Munoz,598886,358823,Agence_moov_Ouidah,300000,59937,2022-01-25
CASH_OUT,350942,Clémence-Véronique Munoz,358823,7881,Agence_moov_Abomey,300000,-50942,2022-01-26
CASH_IN,29739,Agence_moov_Cotonou,300000,270261,Clémence-Véronique Munoz,7881,37620,2022-01-27
CASH_IN,241440,Agence_moov_Cotonou,300000,58560,Léon Da Costa,-81546,159894,2022-01-02
CASH_IN,157733,Agence_moov_Ouidah,300000,142267,Léon Da Costa,159894,317627,2022-01-04
CASH_IN,192709,Agence_moov_Cotonou,300000,107291,Léon Da Costa,317627,510336,2022-01-05
CASH_IN,233173,Agence_moov_Abomey,300000,66827,Léon Da Costa,510336,743509,2022-01-07
CASH_IN,205450,Agence_moov_Abomey,300000,94550,Léon Da Costa,743509,948959,2022-01-12
CASH_OUT,19613,Léon Da Costa,948959,929346,Agence_moov_Ouidah,300000,280387,2022-01-14
TRANSFER,151413,Léon Da Costa,929346,777933,Léon Da Costa,929346,1080759,2022-01-19
CASH_IN,216760,Agence_moov_Abomey,300000,83240,Léon Da Costa,777933,994693,2022-01-23
CASH_IN,223741,Agence_moov_Abomey,300000,76259,Léon Da Costa,994693,1218434,2022-01-25
CASH_IN,270488,Agence_moov_Cotonou,300000,29512,Tristan Gomez,-4390,266098,2022-01-07
CASH_OUT,143848,Tristan Gomez,266098,122250,Agence_moov_Cotonou,300000,156152,2022-01-09
TRANSFER,79825,Tristan Gomez,122250,42425,Tristan Gomez,122250,42425,2022-01-16
CASH_OUT,17660,Tristan Gomez,42425,24765,Agence_moov_Cotonou,300000,282340,2022-01-17
CASH_OUT,24252,Tristan Gomez,24765,513,Agence_moov_Ouidah,300000,275748,2022-01-20
TRANSFER,269,Tristan Gomez,513,244,Tristan Gomez,513,244,2022-01-21
CASH_OUT,129,Tristan Gomez,244,115,Agence_moov_Ouidah,300000,299871,2022-01-23
CASH_OUT,112,Tristan Gomez,115,3,Agence_moov_Cotonou,300000,299888,2022-01-24
CASH_IN,289115,Agence_moov_Abomey,300000,10885,Tristan Gomez,3,289118,2022-01-25
CASH_IN,152254,Agence_moov_Abomey,300000,147746,Marthe Gilles,-338612,-186358,2022-01-03
CASH_IN,67701,Agence_moov_Abomey,300000,232299,Marthe Gilles,-186358,-118657,2022-01-04
CASH_IN,68647,Agence_moov_Cotonou,300000,231353,Marthe Gilles,-118657,-50010,2022-01-08
CASH_IN,141937,Agence_moov_Abomey,300000,158063,Marthe Gilles,-50010,91927,2022-01-08
CASH_OUT,82922,Marthe Gilles,91927,9005,Agence_moov_Cotonou,300000,217078,2022-01-09
CASH_IN,233894,Agence_moov_Abomey,300000,66106,Marthe Gilles,9005,242899,2022-01-11
TRANSFER,143656,Marthe Gilles,242899,99243,Marthe Gilles,242899,386555,2022-01-14
CASH_IN,29965,Agence_moov_Cotonou,300000,270035,Marthe Gilles,99243,129208,2022-01-22
CASH_OUT,71704,Marthe Gilles,129208,57504,Agence_moov_Ouidah,300000,228296,2022-01-23
CASH_OUT,38281,Marthe Gilles,57504,19223,Agence_moov_Cotonou,300000,261719,2022-01-26
CASH_OUT,7601,Marthe Gilles,19223,11622,Agence_moov_Abomey,300000,292399,2022-01-26
CASH_IN,148388,Agence_moov_Abomey,300000,151612,Françoise Morin,-249066,-100678,2022-01-06
CASH_IN,237751,Agence_moov_Ouidah,300000,62249,Françoise Morin,-100678,137073,2022-01-09
TRANSFER,1529,Françoise Morin,137073,135544,Françoise Morin,137073,138602,2022-01-09
CASH_OUT,99120,Françoise Morin,135544,36424,Agence_moov_Ouidah,300000,200880,2022-01-10
TRANSFER,15347,Françoise Morin,36424,21077,Françoise Morin,36424,51771,2022-01-12
TRANSFER,12599,Françoise Morin,21077,8478,Françoise Morin,21077,8478,2022-01-12
TRANSFER,2211,Françoise Morin,8478,6267,Françoise Morin,8478,10689,2022-01-14
CASH_IN,119314,Agence_moov_Ouidah,300000,180686,Françoise Morin,6267,125581,2022-01-16
CASH_IN,157798,Agence_moov_Ouidah,300000,142202,Françoise Morin,125581,283379,2022-01-19
CASH_IN,291613,Agence_moov_Cotonou,300000,8387,Françoise Morin,283379,574992,2022-01-24
CASH_IN,227364,Agence_moov_Ouidah,300000,72636,Antoinette de Dupuis,-422786,-195422,2022-01-01
CASH_IN,180488,Agence_moov_Cotonou,300000,119512,Antoinette de Dupuis,-195422,-14934,2022-01-02
CASH_IN,241532,Agence_moov_Abomey,300000,58468,Antoinette de Dupuis,-14934,226598,2022-01-02
CASH_IN,53602,Agence_moov_Ouidah,300000,246398,Antoinette de Dupuis,226598,280200,2022-01-02
CASH_IN,107958,Agence_moov_Abomey,300000,192042,Antoinette de Dupuis,280200,388158,2022-01-03
CASH_IN,64008,Agence_moov_Cotonou,300000,235992,Antoinette de Dupuis,388158,452166,2022-01-04
CASH_OUT,302375,Antoinette de Dupuis,452166,149791,Agence_moov_Ouidah,300000,-2375,2022-01-04
CASH_OUT,72246,Antoinette de Dupuis,149791,77545,Agence_moov_Abomey,300000,227754,2022-01-08
TRANSFER,30689,Antoinette de Dupuis,77545,46856,Antoinette de Dupuis,77545,46856,2022-01-10
CASH_OUT,24373,Antoinette de Dupuis,46856,22483,Agence_moov_Ouidah,300000,275627,2022-01-10
CASH_OUT,18816,Antoinette de Dupuis,22483,3667,Agence_moov_Cotonou,300000,281184,2022-01-10
TRANSFER,794,Antoinette de Dupuis,3667,2873,Antoinette de Dupuis,3667,4461,2022-01-17
CASH_OUT,1788,Antoinette de Dupuis,2873,1085,Agence_moov_Ouidah,300000,298212,2022-01-17
TRANSFER,598,Antoinette de Dupuis,1085,487,Antoinette de Dupuis,1085,1683,2022-01-19
CASH_IN,273663,Agence_moov_Ouidah,300000,26337,Antoinette de Dupuis,487,274150,2022-01-20
CASH_OUT,66486,Antoinette de Dupuis,274150,207664,Agence_moov_Abomey,300000,233514,2022-01-22
CASH_OUT,109599,Antoinette de Dupuis,207664,98065,Agence_moov_Ouidah,300000,190401,2022-01-23
CASH_IN,238541,Agence_moov_Abomey,300000,61459,Antoinette de Dupuis,98065,336606,2022-01-26
CASH_IN,231244,Agence_moov_Ouidah,300000,68756,Robert-Louis Gosselin,-264619,-33375,2022-01-01
CASH_IN,235641,Agence_moov_Cotonou,300000,64359,Robert-Louis Gosselin,-33375,202266,2022-01-06
CASH_OUT,6207,Robert-Louis Gosselin,202266,196059,Agence_moov_Cotonou,300000,293793,2022-01-06
CASH_IN,154872,Agence_moov_Abomey,300000,145128,Robert-Louis Gosselin,196059,350931,2022-01-08
TRANSFER,22319,Robert-Louis Gosselin,350931,328612,Robert-Louis Gosselin,350931,328612,2022-01-11
TRANSFER,50603,Robert-Louis Gosselin,328612,278009,Robert-Louis Gosselin,328612,278009,2022-01-12
TRANSFER,182654,Robert-Louis Gosselin,278009,95355,Robert-Louis Gosselin,278009,460663,2022-01-13
TRANSFER,68972,Robert-Louis Gosselin,95355,26383,Robert-Louis Gosselin,95355,26383,2022-01-14
CASH_OUT,8117,Robert-Louis Gosselin,26383,18266,Agence_moov_Abomey,300000,291883,2022-01-15
CASH_IN,187337,Agence_moov_Ouidah,300000,112663,Robert-Louis Gosselin,18266,205603,2022-01-16
CASH_IN,156951,Agence_moov_Cotonou,300000,143049,Robert-Louis Gosselin,205603,362554,2022-01-19
CASH_IN,141894,Agence_moov_Ouidah,300000,158106,Robert-Louis Gosselin,362554,504448,2022-01-22
CASH_IN,205001,Agence_moov_Ouidah,300000,94999,Agnès Le Giraud,-13623,191378,2022-01-03
CASH_OUT,84996,Agnès Le Giraud,191378,106382,Agence_moov_Cotonou,300000,215004,2022-01-07
CASH_OUT,93588,Agnès Le Giraud,106382,12794,Agence_moov_Abomey,300000,206412,2022-01-11
TRANSFER,2816,Agnès Le Giraud,12794,9978,Agnès Le Giraud,12794,9978,2022-01-12
TRANSFER,4319,Agnès Le Giraud,9978,5659,Agnès Le Giraud,9978,5659,2022-01-13
CASH_IN,178081,Agence_moov_Ouidah,300000,121919,Agnès Le Giraud,5659,183740,2022-01-15
TRANSFER,164418,Agnès Le Giraud,183740,19322,Agnès Le Giraud,183740,19322,2022-01-16
CASH_OUT,12152,Agnès Le Giraud,19322,7170,Agence_moov_Abomey,300000,287848,2022-01-16
CASH_IN,208015,Agence_moov_Abomey,300000,91985,Agnès Le Giraud,7170,215185,2022-01-17
CASH_IN,252478,Agence_moov_Abomey,300000,47522,Agnès Le Giraud,215185,467663,2022-01-21
CASH_OUT,44656,Agnès Le Giraud,467663,423007,Agence_moov_Cotonou,300000,255344,2022-01-22
CASH_OUT,152110,Agnès Le Giraud,423007,270897,Agence_moov_Ouidah,300000,147890,2022-01-22
CASH_IN,238970,Agence_moov_Cotonou,300000,61030,Agnès Le Giraud,270897,509867,2022-01-24
CASH_IN,197850,Agence_moov_Abomey,300000,102150,Agnès Le Giraud,509867,707717,2022-01-26
CASH_OUT,393408,Agnès Le Giraud,707717,314309,Agence_moov_Abomey,300000,-93408,2022-01-27
CASH_IN,282653,Agence_moov_Abomey,300000,17347,Simone Muller de la Brun,-10523,272130,2022-01-01
CASH_IN,111505,Agence_moov_Ouidah,300000,188495,Simone Muller de la Brun,272130,383635,2022-01-04
CASH_IN,149140,Agence_moov_Cotonou,300000,150860,Simone Muller de la Brun,383635,532775,2022-01-04
CASH_OUT,394226,Simone Muller de la Brun,532775,138549,Agence_moov_Cotonou,300000,-94226,2022-01-07
TRANSFER,86050,Simone Muller de la Brun,138549,52499,Simone Muller de la Brun,138549,224599,2022-01-08
CASH_OUT,22304,Simone Muller de la Brun,52499,30195,Agence_moov_Abomey,300000,277696,2022-01-09
CASH_OUT,9700,Simone Muller de la Brun,30195,20495,Agence_moov_Abomey,300000,290300,2022-01-10
TRANSFER,11535,Simone Muller de la Brun,20495,8960,Simone Muller de la Brun,20495,32030,2022-01-12
CASH_IN,8301,Agence_moov_Cotonou,300000,291699,Simone Muller de la Brun,8960,17261,2022-01-14
CASH_OUT,10120,Simone Muller de la Brun,17261,7141,Agence_moov_Ouidah,300000,289880,2022-01-15
CASH_OUT,4364,Simone Muller de la Brun,7141,2777,Agence_moov_Cotonou,300000,295636,2022-01-25
CASH_OUT,1594,Simone Muller de la Brun,2777,1183,Agence_moov_Cotonou,300000,298406,2022-01-25
CASH_IN,123676,Agence_moov_Ouidah,300000,176324,Simone Muller de la Brun,1183,124859,2022-01-26
CASH_IN,287941,Agence_moov_Abomey,300000,12059,Camille Prévost,-3498,284443,2022-01-06
CASH_IN,66849,Agence_moov_Abomey,300000,233151,Camille Prévost,284443,351292,2022-01-07
CASH_OUT,223904,Camille Prévost,351292,127388,Agence_moov_Cotonou,300000,76096,2022-01-07
TRANSFER,86084,Camille Prévost,127388,41304,Camille Prévost,127388,213472,2022-01-10
CASH_OUT,9289,Camille Prévost,41304,32015,Agence_moov_Cotonou,300000,290711,2022-01-11
CASH_OUT,5846,Camille Prévost,32015,26169,Agence_moov_Ouidah,300000,294154,2022-01-12
CASH_IN,267644,Agence_moov_Ouidah,300000,32356,Camille Prévost,26169,293813,2022-01-13
CASH_IN,116575,Agence_moov_Abomey,300000,183425,Camille Prévost,293813,410388,2022-01-14
TRANSFER,1226,Camille Prévost,410388,409162,Camille Prévost,410388,411614,2022-01-14
CASH_OUT,159944,Camille Prévost,409162,249218,Agence_moov_Ouidah,300000,140056,2022-01-15
CASH_IN,113384,Agence_moov_Cotonou,300000,186616,Camille Prévost,249218,362602,2022-01-15
CASH_IN,62307,Agence_moov_Cotonou,300000,237693,Camille Prévost,362602,424909,2022-01-15
CASH_OUT,19258,Camille Prévost,424909,405651,Agence_moov_Cotonou,300000,280742,2022-01-18
CASH_IN,216735,Agence_moov_Ouidah,300000,83265,Camille Prévost,405651,622386,2022-01-20
CASH_IN,38848,Agence_moov_Abomey,300000,261152,Camille Prévost,622386,661234,2022-01-25
CASH_IN,265411,Agence_moov_Cotonou,300000,34589,Camille Prévost,661234,926645,2022-01-26
CASH_IN,150532,Agence_moov_Abomey,300000,149468,Michel Bouchet,-196765,-46233,2022-01-02
CASH_IN,276015,Agence_moov_Abomey,300000,23985,Michel Bouchet,-46233,229782,2022-01-04
TRANSFER,30034,Michel Bouchet,229782,199748,Michel Bouchet,229782,199748,2022-01-05
CASH_OUT,179007,Michel Bouchet,199748,20741,Agence_moov_Ouidah,300000,120993,2022-01-05
CASH_IN,287802,Agence_moov_Ouidah,300000,12198,Michel Bouchet,20741,308543,2022-01-06
TRANSFER,93823,Michel Bouchet,308543,214720,Michel Bouchet,308543,402366,2022-01-07
TRANSFER,189583,Michel Bouchet,214720,25137,Michel Bouchet,214720,25137,2022-01-08
CASH_OUT,3871,Michel Bouchet,25137,21266,Agence_moov_Ouidah,300000,296129,2022-01-09
CASH_OUT,16688,Michel Bouchet,21266,4578,Agence_moov_Cotonou,300000,283312,2022-01-13
TRANSFER,536,Michel Bouchet,4578,4042,Michel Bouchet,4578,4042,2022-01-13
TRANSFER,231,Michel Bouchet,4042,3811,Michel Bouchet,4042,4273,2022-01-15
CASH_OUT,2990,Michel Bouchet,3811,821,Agence_moov_Abomey,300000,297010,2022-01-18
CASH_OUT,248,Michel Bouchet,821,573,Agence_moov_Ouidah,300000,299752,2022-01-22
CASH_OUT,242,Michel Bouchet,573,331,Agence_moov_Cotonou,300000,299758,2022-01-23
CASH_IN,244479,Agence_moov_Ouidah,300000,55521,Michel Bouchet,331,244810,2022-01-25
CASH_OUT,51521,Michel Bouchet,244810,193289,Agence_moov_Abomey,300000,248479,2022-01-25
CASH_OUT,32929,Michel Bouchet,193289,160360,Agence_moov_Abomey,300000,267071,2022-01-27
CASH_IN,290191,Agence_moov_Abomey,300000,9809,Thibaut de la Lombard,-16838,273353,2022-01-02
TRANSFER,130882,Thibaut de la Lombard,273353,142471,Thibaut de la Lombard,273353,142471,2022-01-03
CASH_IN,283716,Agence_moov_Ouidah,300000,16284,Thibaut de la Lombard,142471,426187,2022-01-04
CASH_OUT,240840,Thibaut de la Lombard,426187,185347,Agence_moov_Cotonou,300000,59160,2022-01-09
CASH_OUT,47100,Thibaut de la Lombard,185347,138247,Agence_moov_Abomey,300000,252900,2022-01-19
CASH_OUT,4600,Thibaut de la Lombard,138247,133647,Agence_moov_Ouidah,300000,295400,2022-01-23
CASH_IN,81080,Agence_moov_Ouidah,300000,218920,Thibaut de la Lombard,133647,214727,2022-01-26
CASH_IN,10747,Agence_moov_Abomey,300000,289253,Andrée-Thérèse Mendès,-18357,-7610,2022-01-01
CASH_IN,267356,Agence_moov_Ouidah,300000,32644,Andrée-Thérèse Mendès,-7610,259746,2022-01-01
TRANSFER,76510,Andrée-Thérèse Mendès,259746,183236,Andrée-Thérèse Mendès,259746,336256,2022-01-04
TRANSFER,138821,Andrée-Thérèse Mendès,183236,44415,Andrée-Thérèse Mendès,183236,44415,2022-01-08
CASH_IN,166081,Agence_moov_Ouidah,300000,133919,Andrée-Thérèse Mendès,44415,210496,2022-01-08
CASH_OUT,173299,Andrée-Thérèse Mendès,210496,37197,Agence_moov_Ouidah,300000,126701,2022-01-10
CASH_OUT,14360,Andrée-Thérèse Mendès,37197,22837,Agence_moov_Cotonou,300000,285640,2022-01-10
TRANSFER,8484,Andrée-Thérèse Mendès,22837,14353,Andrée-Thérèse Mendès,22837,14353,2022-01-10
CASH_IN,55345,Agence_moov_Ouidah,300000,244655,Andrée-Thérèse Mendès,14353,69698,2022-01-14
CASH_IN,171291,Agence_moov_Cotonou,300000,128709,Andrée-Thérèse Mendès,69698,240989,2022-01-15
CASH_OUT,233358,Andrée-Thérèse Mendès,240989,7631,Agence_moov_Abomey,300000,66642,2022-01-18
CASH_IN,106176,Agence_moov_Abomey,300000,193824,Andrée-Thérèse Mendès,7631,113807,2022-01-19
CASH_IN,18457,Agence_moov_Abomey,300000,281543,Andrée-Thérèse Mendès,113807,132264,2022-01-20
CASH_IN,130776,Agence_moov_Abomey,300000,169224,Andrée-Thérèse Mendès,132264,263040,2022-01-22
CASH_OUT,35275,Andrée-Thérèse Mendès,263040,227765,Agence_moov_Abomey,300000,264725,2022-01-22
CASH_OUT,146351,Andrée-Thérèse Mendès,227765,81414,Agence_moov_Cotonou,300000,153649,2022-01-27
CASH_IN,209655,Agence_moov_Cotonou,300000,90345,Frédéric Guillou,-1007230,-797575,2022-01-02
CASH_IN,59677,Agence_moov_Abomey,300000,240323,Frédéric Guillou,-797575,-737898,2022-01-02
CASH_IN,23564,Agence_moov_Abomey,300000,276436,Frédéric Guillou,-737898,-714334,2022-01-03
CASH_IN,195873,Agence_moov_Cotonou,300000,104127,Frédéric Guillou,-714334,-518461,2022-01-04
CASH_IN,237498,Agence_moov_Abomey,300000,62502,Frédéric Guillou,-518461,-280963,2022-01-04
CASH_IN,78258,Agence_moov_Ouidah,300000,221742,Frédéric Guillou,-280963,-202705,2022-01-06
CASH_IN,211726,Agence_moov_Abomey,300000,88274,Frédéric Guillou,-202705,9021,2022-01-09
CASH_IN,162096,Agence_moov_Ouidah,300000,137904,Frédéric Guillou,9021,171117,2022-01-11
TRANSFER,79619,Frédéric Guillou,171117,91498,Frédéric Guillou,171117,91498,2022-01-12
TRANSFER,19105,Frédéric Guillou,91498,72393,Frédéric Guillou,91498,110603,2022-01-14
CASH_IN,33075,Agence_moov_Ouidah,300000,266925,Frédéric Guillou,72393,105468,2022-01-19
CASH_OUT,69505,Frédéric Guillou,105468,35963,Agence_moov_Abomey,300000,230495,2022-01-22
CASH_IN,149593,Agence_moov_Cotonou,300000,150407,Frédéric Guillou,35963,185556,2022-01-22
CASH_OUT,54616,Frédéric Guillou,185556,130940,Agence_moov_Ouidah,300000,245384,2022-01-23
CASH_OUT,87276,Frédéric Guillou,130940,43664,Agence_moov_Ouidah,300000,212724,2022-01-24
CASH_IN,104218,Agence_moov_Cotonou,300000,195782,Maggie Martinez,-201167,-96949,2022-01-01
CASH_IN,161919,Agence_moov_Cotonou,300000,138081,Maggie Martinez,-96949,64970,2022-01-03
CASH_OUT,31493,Maggie Martinez,64970,33477,Agence_moov_Ouidah,300000,268507,2022-01-09
CASH_IN,113118,Agence_moov_Ouidah,300000,186882,Maggie Martinez,33477,146595,2022-01-09
TRANSFER,124679,Maggie Martinez,146595,21916,Maggie Martinez,146595,21916,2022-01-09
CASH_IN,38909,Agence_moov_Abomey,300000,261091,Maggie Martinez,21916,60825,2022-01-13
CASH_IN,298629,Agence_moov_Ouidah,300000,1371,Maggie Martinez,60825,359454,2022-01-14
TRANSFER,34545,Maggie Martinez,359454,324909,Maggie Martinez,359454,324909,2022-01-17
TRANSFER,124955,Maggie Martinez,324909,199954,Maggie Martinez,324909,449864,2022-01-21
CASH_IN,72455,Agence_moov_Cotonou,300000,227545,Maggie Martinez,199954,272409,2022-01-22
CASH_OUT,83959,Maggie Martinez,272409,188450,Agence_moov_Cotonou,300000,216041,2022-01-22
CASH_IN,247133,Agence_moov_Ouidah,300000,52867,Maggie Martinez,188450,435583,2022-01-27
CASH_IN,252660,Agence_moov_Ouidah,300000,47340,Alphonse Joly,-13598,239062,2022-01-03
CASH_OUT,131888,Alphonse Joly,239062,107174,Agence_moov_Ouidah,300000,168112,2022-01-06
CASH_OUT,23793,Alphonse Joly,107174,83381,Agence_moov_Cotonou,300000,276207,2022-01-10
CASH_IN,252379,Agence_moov_Abomey,300000,47621,Alphonse Joly,83381,335760,2022-01-14
CASH_IN,219547,Agence_moov_Abomey,300000,80453,Alphonse Joly,335760,555307,2022-01-20
CASH_OUT,269287,Alphonse Joly,555307,286020,Agence_moov_Abomey,300000,30713,2022-01-23
CASH_OUT,78436,Alphonse Joly,286020,207584,Agence_moov_Abomey,300000,221564,2022-01-26
CASH_OUT,72985,Alphonse Joly,207584,134599,Agence_moov_Abomey,300000,227015,2022-01-27
CASH_IN,233913,Agence_moov_Abomey,300000,66087,Marcelle-Valentine Guibert,-638380,-404467,2022-01-01
CASH_IN,190631,Agence_moov_Cotonou,300000,109369,Marcelle-Valentine Guibert,-404467,-213836,2022-01-02
CASH_IN,145127,Agence_moov_Cotonou,300000,154873,Marcelle-Valentine Guibert,-213836,-68709,2022-01-04
CASH_IN,25654,Agence_moov_Abomey,300000,274346,Marcelle-Valentine Guibert,-68709,-43055,2022-01-05
CASH_IN,6069,Agence_moov_Abomey,300000,293931,Marcelle-Valentine Guibert,-43055,-36986,2022-01-05
CASH_IN,231735,Agence_moov_Cotonou,300000,68265,Marcelle-Valentine Guibert,-36986,194749,2022-01-06
CASH_OUT,4370,Marcelle-Valentine Guibert,194749,190379,Agence_moov_Cotonou,300000,295630,2022-01-07
CASH_OUT,107568,Marcelle-Valentine Guibert,190379,82811,Agence_moov_Cotonou,300000,192432,2022-01-08
CASH_IN,15626,Agence_moov_Abomey,300000,284374,Marcelle-Valentine Guibert,82811,98437,2022-01-09
CASH_OUT,48327,Marcelle-Valentine Guibert,98437,50110,Agence_moov_Cotonou,300000,251673,2022-01-09
CASH_IN,291907,Agence_moov_Cotonou,300000,8093,Marcelle-Valentine Guibert,50110,342017,2022-01-12
CASH_OUT,319379,Marcelle-Valentine Guibert,342017,22638,Agence_moov_Abomey,300000,-19379,2022-01-16
TRANSFER,2799,Marcelle-Valentine Guibert,22638,19839,Marcelle-Valentine Guibert,22638,19839,2022-01-17
TRANSFER,19803,Marcelle-Valentine Guibert,19839,36,Marcelle-Valentine Guibert,19839,36,2022-01-17
CASH_IN,193271,Agence_moov_Cotonou,300000,106729,Marcelle-Valentine Guibert,36,193307,2022-01-20
CASH_OUT,101741,Marcelle-Valentine Guibert,193307,91566,Agence_moov_Ouidah,300000,198259,2022-01-27
CASH_IN,281768,Agence_moov_Abomey,300000,18232,Thomas Dupont,-446953,-165185,2022-01-02
CASH_IN,87865,Agence_moov_Cotonou,300000,212135,Thomas Dupont,-165185,-77320,2022-01-07
CASH_IN,267070,Agence_moov_Abomey,300000,32930,Thomas Dupont,-77320,189750,2022-01-07
CASH_IN,91238,Agence_moov_Abomey,300000,208762,Thomas Dupont,189750,280988,2022-01-09
TRANSFER,254029,Thomas Dupont,280988,26959,Thomas Dupont,280988,535017,2022-01-10
CASH_OUT,13362,Thomas Dupont,26959,13597,Agence_moov_Ouidah,300000,286638,2022-01-11
CASH_OUT,3384,Thomas Dupont,13597,10213,Agence_moov_Cotonou,300000,296616,2022-01-14
TRANSFER,5491,Thomas Dupont,10213,4722,Thomas Dupont,10213,15704,2022-01-14
CASH_OUT,2876,Thomas Dupont,4722,1846,Agence_moov_Cotonou,300000,297124,2022-01-15
CASH_IN,215632,Agence_moov_Ouidah,300000,84368,Thomas Dupont,1846,217478,2022-01-17
CASH_OUT,185765,Thomas Dupont,217478,31713,Agence_moov_Ouidah,300000,114235,2022-01-19
CASH_OUT,6743,Thomas Dupont,31713,24970,Agence_moov_Abomey,300000,293257,2022-01-22
CASH_IN,206862,Agence_moov_Abomey,300000,93138,Thomas Dupont,24970,231832,2022-01-22
CASH_OUT,208365,Thomas Dupont,231832,23467,Agence_moov_Abomey,300000,91635,2022-01-24
CASH_IN,63867,Agence_moov_Ouidah,300000,236133,Thomas Dupont,23467,87334,2022-01-26
CASH_IN,51210,Agence_moov_Ouidah,300000,248790,Gérard de la Martinez,1110900,1162110,2022-02-19
CASH_OUT,961779,Anne Peltier-Raynaud,1241700,279921,Agence_moov_Abomey,300000,-661779,2022-02-05
TRANSFER,84494,Anne Peltier-Raynaud,279921,195427,Mathilde Picard du Delmas,1383000,1298506,2022-02-12
CASH_IN,280448,Agence_moov_Abomey,300000,19552,Anne Peltier-Raynaud,195427,475875,2022-02-23
CASH_OUT,157207,Simone Muller de la Brun,736100,578893,Agence_moov_Abomey,300000,142793,2022-02-08
TRANSFER,485145,Simone Muller de la Brun,578893,93748,Manon Lebon,600300,115155,2022-02-12
CASH_OUT,77893,Simone Muller de la Brun,93748,15855,Agence_moov_Cotonou,300000,222107,2022-02-19
TRANSFER,61404,Astrid Lecoq,1362000,1300596,Tristan Bousquet-Gros,338900,400304,2022-02-03
TRANSFER,183362,Tristan Bousquet-Gros,400304,216942,Michelle-Dorothée Lévêque,105900,-77462,2022-02-06
CASH_OUT,35197,Tristan Bousquet-Gros,216942,181745,Agence_moov_Cotonou,300000,264803,2022-02-17
CASH_IN,58088,Agence_moov_Ouidah,300000,241912,Tristan Bousquet-Gros,181745,239833,2022-02-18
TRANSFER,16426,Tristan Bousquet-Gros,239833,223407,Thérèse Hubert,592300,575874,2022-02-20
CASH_OUT,324809,Noémi Bouvier,880400,555591,Agence_moov_Cotonou,300000,-24809,2022-02-02
CASH_OUT,270068,Noémi Bouvier,555591,285523,Agence_moov_Ouidah,300000,29932,2022-02-03
TRANSFER,202344,Noémi Bouvier,285523,83179,Victor Michel,398200,195856,2022-02-08
CASH_OUT,39304,Noémi Bouvier,83179,43875,Agence_moov_Ouidah,300000,260696,2022-02-20
TRANSFER,27769,Manon Lebon,115155,87386,André Renault,394700,366931,2022-02-04
TRANSFER,471802,Thérèse Hubert,575874,104072,Manon Lebon,87386,559188,2022-02-06
TRANSFER,843807,Thomas Dupont,1233500,389693,Manon Lebon,559188,1402995,2022-02-20
CASH_OUT,1137193,Robert Clerc,1168000,30807,Agence_moov_Abomey,300000,-837193,2022-02-06
CASH_IN,251089,Agence_moov_Ouidah,300000,48911,Robert Clerc,30807,281896,2022-02-08
CASH_IN,52384,Agence_moov_Ouidah,300000,247616,Robert Clerc,281896,334280,2022-02-26
TRANSFER,1505886,Thomas de Blin,1788000,282114,Thomas de Blin,1788000,3293886,2022-02-04
CASH_OUT,150124,Thomas de Blin,282114,131990,Agence_moov_Cotonou,300000,149876,2022-02-04
TRANSFER,124225,Thomas de Blin,131990,7765,Nathalie Bonnin-Joubert,1256200,1131975,2022-02-12
TRANSFER,5999,Thomas de Blin,7765,1766,Céline Collin-Hervé,1708900,1702901,2022-02-22
CASH_OUT,1613,Thomas de Blin,1766,153,Agence_moov_Ouidah,300000,298387,2022-02-25
TRANSFER,196026,Michelle de Étienne,255900,59874,Robert Laroche,1255200,1059174,2022-02-04
CASH_IN,41689,Agence_moov_Ouidah,300000,258311,Luc Lévêque-Carre,865600,907289,2022-02-03
TRANSFER,269493,Anastasie Cousin,939500,670007,Luc Lévêque-Carre,907289,1176782,2022-02-10
CASH_IN,267141,Agence_moov_Ouidah,300000,32859,Luc Lévêque-Carre,1176782,1443923,2022-02-15
CASH_IN,278834,Agence_moov_Abomey,300000,21166,Rémy Grondin,460700,739534,2022-02-06
CASH_IN,207912,Agence_moov_Cotonou,300000,92088,Rémy Grondin,739534,947446,2022-02-21
CASH_IN,45363,Agence_moov_Abomey,300000,254637,Rémy Grondin,947446,992809,2022-02-22
CASH_OUT,597344,Benoît Guyot,637200,39856,Agence_moov_Abomey,300000,-297344,2022-02-17
TRANSFER,406089,Antoinette de Dupuis,845400,439311,Benoît Guyot,39856,445945,2022-02-19
TRANSFER,213498,Benoît Guyot,445945,232447,Colette-Sophie Prévost,1952300,1738802,2022-02-20
TRANSFER,833999,Christine Texier,909800,75801,Hélène de la Gérard,1178200,2012199,2022-02-05
TRANSFER,254642,Hélène de la Gérard,2012199,1757557,Manon Chevalier,1496100,1241458,2022-02-10
CASH_IN,65917,Agence_moov_Abomey,300000,234083,Aimé Pages,1378700,1444617,2022-02-07
TRANSFER,813159,Vincent de la Dumont,1749500,936341,Aimé Pages,1444617,2257776,2022-02-09
TRANSFER,608483,Tristan Gomez,627000,18517,Aimé Pages,2257776,2866259,2022-02-09
TRANSFER,123245,Audrey Julien de Leleu,282600,159355,Aimé Pages,2866259,2989504,2022-02-26
CASH_IN,284696,Agence_moov_Ouidah,300000,15304,Agnès Le Giraud,922700,1207396,2022-02-06
CASH_OUT,125875,Renée Rousseau-Henry,205800,79925,Agence_moov_Cotonou,300000,174125,2022-02-04
CASH_OUT,57911,Renée Rousseau-Henry,79925,22014,Agence_moov_Cotonou,300000,242089,2022-02-05
CASH_IN,200687,Agence_moov_Abomey,300000,99313,Renée Rousseau-Henry,22014,222701,2022-02-19
CASH_OUT,130319,Renée Rousseau-Henry,222701,92382,Agence_moov_Ouidah,300000,169681,2022-02-26
CASH_OUT,155527,Alphonse Gomes,282200,126673,Agence_moov_Cotonou,300000,144473,2022-02-18
CASH_IN,164464,Agence_moov_Cotonou,300000,135536,Robert Laroche,1059174,1223638,2022-02-02
CASH_IN,127202,Agence_moov_Ouidah,300000,172798,Robert Laroche,1223638,1350840,2022-02-06
CASH_IN,151291,Agence_moov_Cotonou,300000,148709,Robert Laroche,1350840,1502131,2022-02-19
TRANSFER,224551,Bernadette de Jourdan,540800,316249,Timothée-René Blanchard,561400,336849,2022-02-19
CASH_IN,185756,Agence_moov_Ouidah,300000,114244,Camille Morvan,915800,1101556,2022-02-10
CASH_OUT,516009,Vincent de la Dumont,936341,420332,Agence_moov_Ouidah,300000,-216009,2022-02-15
TRANSFER,307011,Thomas Dupont,389693,82682,Vincent de la Dumont,420332,727343,2022-02-19
CASH_OUT,78455,Sabine Pineau,1152500,1074045,Agence_moov_Cotonou,300000,221545,2022-02-05
CASH_IN,41317,Agence_moov_Ouidah,300000,258683,Sabine Pineau,1074045,1115362,2022-02-21
TRANSFER,163698,Timothée-René Blanchard,336849,173151,Sabine Pineau,1115362,1279060,2022-02-23
CASH_IN,245765,Agence_moov_Cotonou,300000,54235,Thibaut de la Roy,972400,1218165,2022-02-01
CASH_IN,65897,Agence_moov_Cotonou,300000,234103,Thibaut de la Roy,1218165,1284062,2022-02-07
CASH_OUT,40195,Thibaut de la Roy,1284062,1243867,Agence_moov_Ouidah,300000,259805,2022-02-25
CASH_IN,41649,Agence_moov_Abomey,300000,258351,Matthieu-Matthieu Bigot,1326500,1368149,2022-02-01
CASH_IN,226678,Agence_moov_Abomey,300000,73322,Matthieu-Matthieu Bigot,1368149,1594827,2022-02-03
CASH_OUT,575538,Matthieu-Matthieu Bigot,1594827,1019289,Agence_moov_Cotonou,300000,-275538,2022-02-03
CASH_OUT,708643,Matthieu-Matthieu Bigot,1019289,310646,Agence_moov_Ouidah,300000,-408643,2022-02-04
CASH_IN,287904,Agence_moov_Ouidah,300000,12096,Matthieu-Matthieu Bigot,310646,598550,2022-02-04
CASH_OUT,503986,Matthieu-Matthieu Bigot,598550,94564,Agence_moov_Abomey,300000,-203986,2022-02-04
CASH_OUT,43657,Matthieu-Matthieu Bigot,94564,50907,Agence_moov_Cotonou,300000,256343,2022-02-05
CASH_OUT,23130,Matthieu-Matthieu Bigot,50907,27777,Agence_moov_Cotonou,300000,276870,2022-02-05
CASH_OUT,19373,Matthieu-Matthieu Bigot,27777,8404,Agence_moov_Ouidah,300000,280627,2022-02-07
CASH_IN,246719,Agence_moov_Cotonou,300000,53281,Matthieu-Matthieu Bigot,8404,255123,2022-02-09
CASH_IN,141564,Agence_moov_Ouidah,300000,158436,Matthieu-Matthieu Bigot,255123,396687,2022-02-10
CASH_IN,182218,Agence_moov_Abomey,300000,117782,Matthieu-Matthieu Bigot,396687,578905,2022-02-10
TRANSFER,656697,Alphonse Joly,959000,302303,Matthieu-Matthieu Bigot,578905,1235602,2022-02-13
CASH_IN,85892,Agence_moov_Abomey,300000,214108,Matthieu-Matthieu Bigot,1235602,1321494,2022-02-17
TRANSFER,505877,Matthieu-Matthieu Bigot,1321494,815617,Véronique Martins de Fleury,1097200,591323,2022-02-17
CASH_IN,11029,Agence_moov_Abomey,300000,288971,Matthieu-Matthieu Bigot,815617,826646,2022-02-19
TRANSFER,225910,Anastasie Cousin,670007,444097,Matthieu-Matthieu Bigot,826646,1052556,2022-02-21
CASH_IN,183609,Agence_moov_Cotonou,300000,116391,Matthieu-Matthieu Bigot,1052556,1236165,2022-02-22
TRANSFER,499836,Alix Barbe,729100,229264,Matthieu-Matthieu Bigot,1236165,1736001,2022-02-22
CASH_OUT,1548828,Matthieu-Matthieu Bigot,1736001,187173,Agence_moov_Abomey,300000,-1248828,2022-02-25
CASH_IN,9942,Agence_moov_Abomey,300000,290058,Matthieu-Matthieu Bigot,187173,197115,2022-02-26
CASH_IN,200118,Agence_moov_Ouidah,300000,99882,Suzanne Bodin,1280800,1480918,2022-02-01
CASH_IN,208816,Agence_moov_Cotonou,300000,91184,Suzanne Bodin,1480918,1689734,2022-02-02
CASH_IN,25486,Agence_moov_Cotonou,300000,274514,Suzanne Bodin,1689734,1715220,2022-02-02
CASH_IN,9696,Agence_moov_Abomey,300000,290304,Suzanne Bodin,1715220,1724916,2022-02-04
TRANSFER,444031,Anastasie Cousin,444097,66,Suzanne Bodin,1724916,2168947,2022-02-04
TRANSFER,1033711,Suzanne Bodin,2168947,1135236,Philippe Philippe,129800,-903911,2022-02-04
CASH_OUT,108995,Suzanne Bodin,1135236,1026241,Agence_moov_Ouidah,300000,191005,2022-02-05
CASH_OUT,489676,Suzanne Bodin,1026241,536565,Agence_moov_Ouidah,300000,-189676,2022-02-08
TRANSFER,383124,Suzanne Bodin,536565,153441,Vincent Joubert,638100,254976,2022-02-11
CASH_IN,124583,Agence_moov_Ouidah,300000,175417,Suzanne Bodin,153441,278024,2022-02-13
CASH_IN,268052,Agence_moov_Abomey,300000,31948,Suzanne Bodin,278024,546076,2022-02-13
TRANSFER,195622,Alphonse Joly,302303,106681,Suzanne Bodin,546076,741698,2022-02-16
TRANSFER,355157,Constance Bourdon-Millet,381400,26243,Suzanne Bodin,741698,1096855,2022-02-16
TRANSFER,110064,Timothée-René Blanchard,173151,63087,Suzanne Bodin,1096855,1206919,2022-02-16
CASH_OUT,266849,Suzanne Bodin,1206919,940070,Agence_moov_Abomey,300000,33151,2022-02-17
CASH_IN,108828,Agence_moov_Cotonou,300000,191172,Suzanne Bodin,940070,1048898,2022-02-18
TRANSFER,22687,Suzanne Bodin,1048898,1026211,Colette-Sophie Prévost,1738802,1716115,2022-02-18
CASH_IN,124863,Agence_moov_Cotonou,300000,175137,Suzanne Bodin,1026211,1151074,2022-02-20
CASH_OUT,892003,Suzanne Bodin,1151074,259071,Agence_moov_Ouidah,300000,-592003,2022-02-21
TRANSFER,188661,Suzanne Bodin,259071,70410,Andrée-Thérèse Mendès,1888300,1699639,2022-02-22
TRANSFER,22713,Suzanne Bodin,70410,47697,Frédérique Fernandes du Bouchet,989200,966487,2022-02-22
CASH_IN,169351,Agence_moov_Cotonou,300000,130649,Suzanne Bodin,47697,217048,2022-02-24
TRANSFER,138284,Suzanne Bodin,217048,78764,Nathalie Bonnin-Joubert,1131975,993691,2022-02-24
CASH_IN,188176,Agence_moov_Abomey,300000,111824,Lucie Aubert,995000,1183176,2022-02-02
CASH_OUT,579123,Lucie Aubert,1183176,604053,Agence_moov_Abomey,300000,-279123,2022-02-04
CASH_OUT,128186,Lucie Aubert,604053,475867,Agence_moov_Abomey,300000,171814,2022-02-05
CASH_OUT,158474,Lucie Aubert,475867,317393,Agence_moov_Ouidah,300000,141526,2022-02-05
TRANSFER,53125,Thomas Dupont,82682,29557,Lucie Aubert,317393,370518,2022-02-06
CASH_OUT,280774,Lucie Aubert,370518,89744,Agence_moov_Abomey,300000,19226,2022-02-07
CASH_OUT,65988,Lucie Aubert,89744,23756,Agence_moov_Ouidah,300000,234012,2022-02-08
TRANSFER,485365,Robert-Louis Gosselin,920800,435435,Lucie Aubert,23756,509121,2022-02-09
CASH_IN,156823,Agence_moov_Cotonou,300000,143177,Lucie Aubert,509121,665944,2022-02-10
CASH_IN,219056,Agence_moov_Abomey,300000,80944,Lucie Aubert,665944,885000,2022-02-11
CASH_IN,50911,Agence_moov_Cotonou,300000,249089,Lucie Aubert,885000,935911,2022-02-12
CASH_IN,167787,Agence_moov_Ouidah,300000,132213,Lucie Aubert,935911,1103698,2022-02-12
CASH_OUT,318122,Lucie Aubert,1103698,785576,Agence_moov_Ouidah,300000,-18122,2022-02-14
CASH_IN,146820,Agence_moov_Ouidah,300000,153180,Lucie Aubert,785576,932396,2022-02-14
CASH_OUT,173171,Lucie Aubert,932396,759225,Agence_moov_Cotonou,300000,126829,2022-02-14
TRANSFER,767638,Nathalie Bonnin-Joubert,993691,226053,Lucie Aubert,759225,1526863,2022-02-14
CASH_OUT,976425,Lucie Aubert,1526863,550438,Agence_moov_Abomey,300000,-676425,2022-02-15
CASH_OUT,489868,Lucie Aubert,550438,60570,Agence_moov_Abomey,300000,-189868,2022-02-16
CASH_OUT,56521,Lucie Aubert,60570,4049,Agence_moov_Abomey,300000,243479,2022-02-17
CASH_IN,80171,Agence_moov_Abomey,300000,219829,Lucie Aubert,4049,84220,2022-02-17
TRANSFER,514366,Marthe Gilles,940700,426334,Lucie Aubert,84220,598586,2022-02-19
CASH_OUT,185082,Lucie Aubert,598586,413504,Agence_moov_Ouidah,300000,114918,2022-02-20
CASH_IN,76793,Agence_moov_Cotonou,300000,223207,Lucie Aubert,413504,490297,2022-02-21
TRANSFER,182598,Thomas-Robert Morvan,1192300,1009702,Lucie Aubert,490297,672895,2022-02-22
CASH_OUT,612454,Lucie Aubert,672895,60441,Agence_moov_Cotonou,300000,-312454,2022-02-26
CASH_OUT,31106,Lucie Aubert,60441,29335,Agence_moov_Abomey,300000,268894,2022-02-26
CASH_IN,273264,Agence_moov_Ouidah,300000,26736,Thérèse François,1546000,1819264,2022-02-01
CASH_OUT,609841,Thérèse François,1819264,1209423,Agence_moov_Abomey,300000,-309841,2022-02-01
TRANSFER,112258,Thérèse François,1209423,1097165,Stéphane Munoz,1560700,1448442,2022-02-02
TRANSFER,657710,Thérèse François,1097165,439455,Françoise Morin,1483700,825990,2022-02-03
CASH_IN,46054,Agence_moov_Cotonou,300000,253946,Thérèse François,439455,485509,2022-02-05
CASH_IN,231290,Agence_moov_Cotonou,300000,68710,Thérèse François,485509,716799,2022-02-05
CASH_OUT,322673,Thérèse François,716799,394126,Agence_moov_Abomey,300000,-22673,2022-02-07
TRANSFER,122927,Thibaut de la Lombard,926800,803873,Thérèse François,394126,517053,2022-02-08
CASH_OUT,295416,Thérèse François,517053,221637,Agence_moov_Abomey,300000,4584,2022-02-09
CASH_IN,290702,Agence_moov_Cotonou,300000,9298,Thérèse François,221637,512339,2022-02-11
TRANSFER,173660,Thérèse François,512339,338679,Thibaut de la Lombard,803873,630213,2022-02-12
CASH_IN,79680,Agence_moov_Ouidah,300000,220320,Thérèse François,338679,418359,2022-02-14
CASH_IN,101841,Agence_moov_Abomey,300000,198159,Thérèse François,418359,520200,2022-02-15
TRANSFER,433265,Thérèse François,520200,86935,Bertrand Regnier,827400,394135,2022-02-15
CASH_IN,164636,Agence_moov_Cotonou,300000,135364,Thérèse François,86935,251571,2022-02-15
TRANSFER,104888,Thérèse François,251571,146683,Colette-Sophie Prévost,1716115,1611227,2022-02-15
CASH_OUT,30759,Thérèse François,146683,115924,Agence_moov_Ouidah,300000,269241,2022-02-17
CASH_IN,98447,Agence_moov_Ouidah,300000,201553,Thérèse François,115924,214371,2022-02-18
TRANSFER,197000,Jules Fernandes,206700,9700,Thérèse François,214371,411371,2022-02-18
TRANSFER,192657,Andrée-Thérèse Mendès,1699639,1506982,Thérèse François,411371,604028,2022-02-19
TRANSFER,410852,Thérèse François,604028,193176,Constance Bourdon-Millet,26243,-384609,2022-02-19
CASH_OUT,78540,Thérèse François,193176,114636,Agence_moov_Abomey,300000,221460,2022-02-21
CASH_OUT,105652,Thérèse François,114636,8984,Agence_moov_Abomey,300000,194348,2022-02-22
CASH_OUT,5949,Thérèse François,8984,3035,Agence_moov_Cotonou,300000,294051,2022-02-24
CASH_OUT,1716,Thérèse François,3035,1319,Agence_moov_Abomey,300000,298284,2022-02-27
CASH_OUT,518735,Céline Collin-Hervé,1702901,1184166,Agence_moov_Cotonou,300000,-218735,2022-02-01
TRANSFER,51551,Noël Bourgeois,95300,43749,Céline Collin-Hervé,1184166,1235717,2022-02-01
TRANSFER,730461,Frédérique Fernandes du Bouchet,966487,236026,Céline Collin-Hervé,1235717,1966178,2022-02-01
TRANSFER,77835,Alphonse Joly,106681,28846,Céline Collin-Hervé,1966178,2044013,2022-02-02
TRANSFER,1431595,Céline Collin-Hervé,2044013,612418,Marthe Gilles,426334,-1005261,2022-02-03
CASH_IN,54167,Agence_moov_Ouidah,300000,245833,Céline Collin-Hervé,612418,666585,2022-02-04
TRANSFER,542816,Céline Collin-Hervé,666585,123769,Thomas Dupont,29557,-513259,2022-02-06
TRANSFER,112906,Martine Aubert,1733100,1620194,Céline Collin-Hervé,123769,236675,2022-02-06
CASH_OUT,16119,Céline Collin-Hervé,236675,220556,Agence_moov_Cotonou,300000,283881,2022-02-07
TRANSFER,106433,Céline Collin-Hervé,220556,114123,Alphonse Joly,28846,-77587,2022-02-10
CASH_OUT,4852,Céline Collin-Hervé,114123,109271,Agence_moov_Cotonou,300000,295148,2022-02-12
TRANSFER,860593,Mathilde Picard du Delmas,1298506,437913,Céline Collin-Hervé,109271,969864,2022-02-13
TRANSFER,1352705,Colette Merle Le Robert,1449800,97095,Céline Collin-Hervé,969864,2322569,2022-02-13
CASH_OUT,1277034,Céline Collin-Hervé,2322569,1045535,Agence_moov_Ouidah,300000,-977034,2022-02-14
CASH_IN,143150,Agence_moov_Ouidah,300000,156850,Céline Collin-Hervé,1045535,1188685,2022-02-14
CASH_OUT,139909,Céline Collin-Hervé,1188685,1048776,Agence_moov_Abomey,300000,160091,2022-02-14
CASH_IN,156679,Agence_moov_Cotonou,300000,143321,Céline Collin-Hervé,1048776,1205455,2022-02-16
CASH_OUT,929792,Céline Collin-Hervé,1205455,275663,Agence_moov_Ouidah,300000,-629792,2022-02-17
TRANSFER,244068,Gabriel Bègue,1366200,1122132,Céline Collin-Hervé,275663,519731,2022-02-18
CASH_IN,106552,Agence_moov_Ouidah,300000,193448,Céline Collin-Hervé,519731,626283,2022-02-23
CASH_OUT,480983,Céline Collin-Hervé,626283,145300,Agence_moov_Ouidah,300000,-180983,2022-02-23
CASH_IN,183875,Agence_moov_Ouidah,300000,116125,Céline Collin-Hervé,145300,329175,2022-02-26
CASH_OUT,143503,Céline Collin-Hervé,329175,185672,Agence_moov_Abomey,300000,156497,2022-02-27
CASH_IN,208818,Agence_moov_Cotonou,300000,91182,Richard Le Lévêque,848700,1057518,2022-02-01
TRANSFER,590545,Richard Le Lévêque,1057518,466973,Raymond Lévy,1749800,1159255,2022-02-02
CASH_IN,4501,Agence_moov_Ouidah,300000,295499,Richard Le Lévêque,466973,471474,2022-02-03
CASH_OUT,206345,Richard Le Lévêque,471474,265129,Agence_moov_Cotonou,300000,93655,2022-02-05
TRANSFER,109928,Nicolas Salmon Le Hamon,1664300,1554372,Richard Le Lévêque,265129,375057,2022-02-05
CASH_IN,1671,Agence_moov_Ouidah,300000,298329,Richard Le Lévêque,375057,376728,2022-02-07
CASH_OUT,192235,Richard Le Lévêque,376728,184493,Agence_moov_Abomey,300000,107765,2022-02-11
CASH_IN,69089,Agence_moov_Abomey,300000,230911,Richard Le Lévêque,184493,253582,2022-02-11
TRANSFER,880203,Mathilde de la Samson,1418300,538097,Richard Le Lévêque,253582,1133785,2022-02-12
CASH_OUT,700545,Richard Le Lévêque,1133785,433240,Agence_moov_Cotonou,300000,-400545,2022-02-12
TRANSFER,14264,Richard Le Lévêque,433240,418976,Frédéric Guillou,102100,87836,2022-02-13
TRANSFER,204113,Richard Le Lévêque,418976,214863,Aurore Charrier,1567300,1363187,2022-02-14
TRANSFER,202056,Richard Le Lévêque,214863,12807,Constance Guillon,187900,-14156,2022-02-14
TRANSFER,3125,Richard Le Lévêque,12807,9682,Colette Merle Le Robert,97095,93970,2022-02-15
CASH_IN,179930,Agence_moov_Cotonou,300000,120070,Richard Le Lévêque,9682,189612,2022-02-16
TRANSFER,179763,Alix Barbe,229264,49501,Richard Le Lévêque,189612,369375,2022-02-18
CASH_IN,251975,Agence_moov_Abomey,300000,48025,Richard Le Lévêque,369375,621350,2022-02-22
CASH_IN,185622,Agence_moov_Abomey,300000,114378,Richard Le Lévêque,621350,806972,2022-02-23
CASH_OUT,225536,Richard Le Lévêque,806972,581436,Agence_moov_Cotonou,300000,74464,2022-02-24
CASH_OUT,433370,Richard Le Lévêque,581436,148066,Agence_moov_Ouidah,300000,-133370,2022-02-26
CASH_IN,202631,Agence_moov_Cotonou,300000,97369,Richard Le Lévêque,148066,350697,2022-02-26
TRANSFER,599106,Manon Valette,1272700,673594,Richard Le Lévêque,350697,949803,2022-02-26
CASH_IN,134120,Agence_moov_Abomey,300000,165880,Martine Aubert,1620194,1754314,2022-02-02
CASH_OUT,1445096,Martine Aubert,1754314,309218,Agence_moov_Ouidah,300000,-1145096,2022-02-03
CASH_IN,35818,Agence_moov_Cotonou,300000,264182,Martine Aubert,309218,345036,2022-02-04
CASH_IN,26745,Agence_moov_Cotonou,300000,273255,Martine Aubert,345036,371781,2022-02-05
TRANSFER,184760,Martine Aubert,371781,187021,Adèle Da Silva-Klein,451100,266340,2022-02-05
TRANSFER,73215,Martine Aubert,187021,113806,Bertrand Regnier,394135,320920,2022-02-06
CASH_OUT,3998,Martine Aubert,113806,109808,Agence_moov_Cotonou,300000,296002,2022-02-06
CASH_OUT,17082,Martine Aubert,109808,92726,Agence_moov_Abomey,300000,282918,2022-02-09
TRANSFER,223764,Hélène Le Chauvin,396000,172236,Martine Aubert,92726,316490,2022-02-10
TRANSFER,10770,Tristan Gomez,18517,7747,Martine Aubert,316490,327260,2022-02-11
CASH_OUT,166677,Martine Aubert,327260,160583,Agence_moov_Ouidah,300000,133323,2022-02-11
CASH_IN,17835,Agence_moov_Cotonou,300000,282165,Martine Aubert,160583,178418,2022-02-12
CASH_OUT,171789,Martine Aubert,178418,6629,Agence_moov_Ouidah,300000,128211,2022-02-14
TRANSFER,2616,Martine Aubert,6629,4013,Émilie du Allain,7900,5284,2022-02-15
TRANSFER,657731,Gabriel Bègue,1122132,464401,Martine Aubert,4013,661744,2022-02-15
CASH_OUT,625623,Martine Aubert,661744,36121,Agence_moov_Cotonou,300000,-325623,2022-02-16
CASH_IN,156490,Agence_moov_Abomey,300000,143510,Martine Aubert,36121,192611,2022-02-16
TRANSFER,109663,Martine Aubert,192611,82948,Audrey Julien de Leleu,159355,49692,2022-02-17
CASH_OUT,3119,Martine Aubert,82948,79829,Agence_moov_Abomey,300000,296881,2022-02-17
CASH_IN,205248,Agence_moov_Cotonou,300000,94752,Martine Aubert,79829,285077,2022-02-17
CASH_IN,63783,Agence_moov_Ouidah,300000,236217,Martine Aubert,285077,348860,2022-02-24
TRANSFER,297632,Andrée-Thérèse Mendès,1506982,1209350,Martine Aubert,348860,646492,2022-02-27
TRANSFER,617463,Richard Michel,1208900,591437,Mathilde de la Samson,538097,1155560,2022-02-01
CASH_IN,167448,Agence_moov_Cotonou,300000,132552,Mathilde de la Samson,1155560,1323008,2022-02-06
CASH_OUT,998983,Mathilde de la Samson,1323008,324025,Agence_moov_Cotonou,300000,-698983,2022-02-06
CASH_OUT,191006,Mathilde de la Samson,324025,133019,Agence_moov_Ouidah,300000,108994,2022-02-06
TRANSFER,135438,Nathalie Bonnin-Joubert,226053,90615,Mathilde de la Samson,133019,268457,2022-02-07
CASH_OUT,107962,Mathilde de la Samson,268457,160495,Agence_moov_Ouidah,300000,192038,2022-02-07
CASH_OUT,157690,Mathilde de la Samson,160495,2805,Agence_moov_Abomey,300000,142310,2022-02-07
TRANSFER,2526,Tristan Gomez,7747,5221,Mathilde de la Samson,2805,5331,2022-02-08
TRANSFER,1462,Mathilde de la Samson,5331,3869,Tristan Gomez,5221,3759,2022-02-11
CASH_IN,216674,Agence_moov_Cotonou,300000,83326,Mathilde de la Samson,3869,220543,2022-02-14
CASH_IN,163582,Agence_moov_Ouidah,300000,136418,Mathilde de la Samson,220543,384125,2022-02-15
CASH_OUT,78321,Mathilde de la Samson,384125,305804,Agence_moov_Ouidah,300000,221679,2022-02-16
CASH_IN,787,Agence_moov_Ouidah,300000,299213,Mathilde de la Samson,305804,306591,2022-02-16
CASH_IN,5068,Agence_moov_Ouidah,300000,294932,Mathilde de la Samson,306591,311659,2022-02-16
TRANSFER,160612,Clémence-Véronique Munoz,428000,267388,Mathilde de la Samson,311659,472271,2022-02-17
TRANSFER,97303,Thomas Guichard du Renault,349100,251797,Mathilde de la Samson,472271,569574,2022-02-20
CASH_IN,231916,Agence_moov_Cotonou,300000,68084,Mathilde de la Samson,569574,801490,2022-02-21
CASH_OUT,65491,Mathilde de la Samson,801490,735999,Agence_moov_Cotonou,300000,234509,2022-02-21
TRANSFER,534171,Mathilde de la Samson,735999,201828,Andrée-Thérèse Mendès,1209350,675179,2022-02-22
CASH_OUT,104734,Mathilde de la Samson,201828,97094,Agence_moov_Abomey,300000,195266,2022-02-25
TRANSFER,62037,Mathilde de la Samson,97094,35057,Tristan Delahaye,1378300,1316263,2022-02-25
CASH_OUT,15623,Mathilde de la Samson,35057,19434,Agence_moov_Abomey,300000,284377,2022-02-26
CASH_OUT,3765,Mathilde de la Samson,19434,15669,Agence_moov_Ouidah,300000,296235,2022-02-26
CASH_OUT,6078,Mathilde de la Samson,15669,9591,Agence_moov_Ouidah,300000,293922,2022-02-27
TRANSFER,8038,Mathilde de la Samson,9591,1553,Jules-Roland Bousquet,1037100,1029062,2022-02-27
CASH_OUT,77821,Nathalie Bonnin-Joubert,90615,12794,Agence_moov_Ouidah,300000,222179,2022-02-02
CASH_IN,149570,Agence_moov_Abomey,300000,150430,Nathalie Bonnin-Joubert,12794,162364,2022-02-03
TRANSFER,60335,Nathalie Bonnin-Joubert,162364,102029,Françoise Morin,825990,765655,2022-02-04
TRANSFER,315,Nathalie Bonnin-Joubert,102029,101714,Nathalie Bonnin-Joubert,102029,101714,2022-02-04
CASH_OUT,26024,Nathalie Bonnin-Joubert,101714,75690,Agence_moov_Ouidah,300000,273976,2022-02-05
TRANSFER,53348,Théodore Joseph-Lefebvre,58600,5252,Nathalie Bonnin-Joubert,75690,129038,2022-02-06
CASH_OUT,73877,Nathalie Bonnin-Joubert,129038,55161,Agence_moov_Cotonou,300000,226123,2022-02-07
TRANSFER,48116,Nathalie Bonnin-Joubert,55161,7045,Noël Bourgeois,43749,-4367,2022-02-08
CASH_IN,194394,Agence_moov_Cotonou,300000,105606,Nathalie Bonnin-Joubert,7045,201439,2022-02-09
CASH_IN,140567,Agence_moov_Ouidah,300000,159433,Nathalie Bonnin-Joubert,201439,342006,2022-02-10
TRANSFER,641834,Thomas-Robert Morvan,1009702,367868,Nathalie Bonnin-Joubert,342006,983840,2022-02-11
CASH_IN,112397,Agence_moov_Cotonou,300000,187603,Nathalie Bonnin-Joubert,983840,1096237,2022-02-12
CASH_IN,174599,Agence_moov_Ouidah,300000,125401,Nathalie Bonnin-Joubert,1096237,1270836,2022-02-14
CASH_IN,5700,Agence_moov_Cotonou,300000,294300,Nathalie Bonnin-Joubert,1270836,1276536,2022-02-14
CASH_IN,226388,Agence_moov_Ouidah,300000,73612,Nathalie Bonnin-Joubert,1276536,1502924,2022-02-14
CASH_OUT,529718,Nathalie Bonnin-Joubert,1502924,973206,Agence_moov_Ouidah,300000,-229718,2022-02-16
TRANSFER,717958,Nathalie Bonnin-Joubert,973206,255248,Thomas-Robert Morvan,367868,-350090,2022-02-17
CASH_OUT,98977,Nathalie Bonnin-Joubert,255248,156271,Agence_moov_Cotonou,300000,201023,2022-02-17
TRANSFER,120754,Nathalie Bonnin-Joubert,156271,35517,Timothée-René Blanchard,63087,-57667,2022-02-19
CASH_IN,259263,Agence_moov_Abomey,300000,40737,Nathalie Bonnin-Joubert,35517,294780,2022-02-20
CASH_IN,95116,Agence_moov_Cotonou,300000,204884,Nathalie Bonnin-Joubert,294780,389896,2022-02-21
TRANSFER,33287,Gabriel Bègue,464401,431114,Nathalie Bonnin-Joubert,389896,423183,2022-02-22
CASH_OUT,280915,Nathalie Bonnin-Joubert,423183,142268,Agence_moov_Abomey,300000,19085,2022-02-23
CASH_IN,190376,Agence_moov_Abomey,300000,109624,Nathalie Bonnin-Joubert,142268,332644,2022-02-24
TRANSFER,127941,Thomas Guichard du Renault,251797,123856,Nathalie Bonnin-Joubert,332644,460585,2022-02-25
CASH_IN,184153,Agence_moov_Cotonou,300000,115847,Victor Michel,195856,380009,2022-02-01
TRANSFER,133647,Victor Michel,380009,246362,Frédéric Guillou,87836,-45811,2022-02-05
CASH_IN,140419,Agence_moov_Ouidah,300000,159581,Victor Michel,246362,386781,2022-02-05
TRANSFER,705987,Léon Da Costa,723700,17713,Victor Michel,386781,1092768,2022-02-05
CASH_IN,128019,Agence_moov_Ouidah,300000,171981,Victor Michel,1092768,1220787,2022-02-05
CASH_IN,33119,Agence_moov_Cotonou,300000,266881,Victor Michel,1220787,1253906,2022-02-06
CASH_OUT,771316,Victor Michel,1253906,482590,Agence_moov_Abomey,300000,-471316,2022-02-07
CASH_IN,287784,Agence_moov_Cotonou,300000,12216,Victor Michel,482590,770374,2022-02-08
CASH_IN,204621,Agence_moov_Ouidah,300000,95379,Victor Michel,770374,974995,2022-02-09
TRANSFER,179945,Antoinette de Dupuis,439311,259366,Victor Michel,974995,1154940,2022-02-09
TRANSFER,225956,Raymond Lévy,1159255,933299,Victor Michel,1154940,1380896,2022-02-11
CASH_IN,50319,Agence_moov_Abomey,300000,249681,Victor Michel,1380896,1431215,2022-02-11
TRANSFER,404656,Véronique Martins de Fleury,591323,186667,Victor Michel,1431215,1835871,2022-02-12
CASH_OUT,1646107,Victor Michel,1835871,189764,Agence_moov_Abomey,300000,-1346107,2022-02-16
CASH_OUT,132398,Victor Michel,189764,57366,Agence_moov_Ouidah,300000,167602,2022-02-17
CASH_IN,242596,Agence_moov_Ouidah,300000,57404,Victor Michel,57366,299962,2022-02-20
CASH_IN,122134,Agence_moov_Abomey,300000,177866,Victor Michel,299962,422096,2022-02-22
TRANSFER,90241,Émile-René Baudry,1966300,1876059,Victor Michel,422096,512337,2022-02-22
CASH_IN,76944,Agence_moov_Ouidah,300000,223056,Victor Michel,512337,589281,2022-02-23
TRANSFER,407092,Lucy Lamy,690500,283408,Victor Michel,589281,996373,2022-02-23
TRANSFER,554931,Bernard Maurice,633000,78069,Victor Michel,996373,1551304,2022-02-23
CASH_IN,197085,Agence_moov_Cotonou,300000,102915,Victor Michel,1551304,1748389,2022-02-26
TRANSFER,965519,Manon Chevalier,1241458,275939,Victor Michel,1748389,2713908,2022-02-26
CASH_OUT,245757,Victor Michel,2713908,2468151,Agence_moov_Cotonou,300000,54243,2022-02-27
CASH_IN,158614,Agence_moov_Cotonou,300000,141386,Andrée-Thérèse Mendès,675179,833793,2022-02-04
TRANSFER,676506,Andrée-Thérèse Mendès,833793,157287,Adèle Da Silva-Klein,266340,-410166,2022-02-04
TRANSFER,129278,Andrée-Thérèse Mendès,157287,28009,André Renault,366931,237653,2022-02-05
TRANSFER,16681,Andrée-Thérèse Mendès,28009,11328,Astrid Lecoq,1300596,1283915,2022-02-05
TRANSFER,3105,Émilie du Allain,5284,2179,Andrée-Thérèse Mendès,11328,14433,2022-02-06
CASH_IN,158756,Agence_moov_Cotonou,300000,141244,Andrée-Thérèse Mendès,14433,173189,2022-02-06
CASH_OUT,114815,Andrée-Thérèse Mendès,173189,58374,Agence_moov_Ouidah,300000,185185,2022-02-07
CASH_OUT,30413,Andrée-Thérèse Mendès,58374,27961,Agence_moov_Ouidah,300000,269587,2022-02-08
CASH_IN,261885,Agence_moov_Abomey,300000,38115,Andrée-Thérèse Mendès,27961,289846,2022-02-09
TRANSFER,6818,Colette Merle Le Robert,93970,87152,Andrée-Thérèse Mendès,289846,296664,2022-02-09
CASH_OUT,9184,Andrée-Thérèse Mendès,296664,287480,Agence_moov_Cotonou,300000,290816,2022-02-09
TRANSFER,225024,Andrée-Thérèse Mendès,287480,62456,Paul Perez,118500,-106524,2022-02-13
TRANSFER,52933,Andrée-Thérèse Mendès,62456,9523,Maggie Martinez,1453600,1400667,2022-02-13
CASH_IN,282748,Agence_moov_Abomey,300000,17252,Andrée-Thérèse Mendès,9523,292271,2022-02-13
CASH_OUT,231772,Andrée-Thérèse Mendès,292271,60499,Agence_moov_Abomey,300000,68228,2022-02-15
CASH_OUT,9721,Andrée-Thérèse Mendès,60499,50778,Agence_moov_Abomey,300000,290279,2022-02-17
TRANSFER,42265,Andrée-Thérèse Mendès,50778,8513,Thibaut de la Lombard,630213,587948,2022-02-17
CASH_IN,273881,Agence_moov_Ouidah,300000,26119,Andrée-Thérèse Mendès,8513,282394,2022-02-18
CASH_IN,181848,Agence_moov_Cotonou,300000,118152,Andrée-Thérèse Mendès,282394,464242,2022-02-18
TRANSFER,994122,Anastasie Richard-Neveu,1099600,105478,Andrée-Thérèse Mendès,464242,1458364,2022-02-19
CASH_IN,57447,Agence_moov_Abomey,300000,242553,Andrée-Thérèse Mendès,1458364,1515811,2022-02-19
TRANSFER,1013394,Marcelle-Valentine Guibert,1669900,656506,Andrée-Thérèse Mendès,1515811,2529205,2022-02-19
TRANSFER,79627,Frédérique Fernandes du Bouchet,236026,156399,Andrée-Thérèse Mendès,2529205,2608832,2022-02-21
CASH_OUT,1023971,Andrée-Thérèse Mendès,2608832,1584861,Agence_moov_Abomey,300000,-723971,2022-02-26
CASH_OUT,550804,Andrée-Thérèse Mendès,1584861,1034057,Agence_moov_Ouidah,300000,-250804,2022-02-26
TRANSFER,222647,Émile-René Baudry,1876059,1653412,Théodore Joseph-Lefebvre,5252,227899,2022-02-01
CASH_IN,64737,Agence_moov_Abomey,300000,235263,Théodore Joseph-Lefebvre,227899,292636,2022-02-01
CASH_IN,133522,Agence_moov_Cotonou,300000,166478,Théodore Joseph-Lefebvre,292636,426158,2022-02-01
CASH_OUT,29442,Théodore Joseph-Lefebvre,426158,396716,Agence_moov_Abomey,300000,270558,2022-02-02
TRANSFER,41982,Théodore Joseph-Lefebvre,396716,354734,Jules-Roland Bousquet,1029062,987080,2022-02-03
CASH_IN,205833,Agence_moov_Cotonou,300000,94167,Théodore Joseph-Lefebvre,354734,560567,2022-02-04
CASH_OUT,443371,Théodore Joseph-Lefebvre,560567,117196,Agence_moov_Ouidah,300000,-143371,2022-02-05
CASH_OUT,78571,Théodore Joseph-Lefebvre,117196,38625,Agence_moov_Cotonou,300000,221429,2022-02-05
CASH_OUT,32701,Théodore Joseph-Lefebvre,38625,5924,Agence_moov_Abomey,300000,267299,2022-02-06
TRANSFER,1330,Théodore Joseph-Lefebvre,5924,4594,Colette Merle Le Robert,87152,85822,2022-02-07
TRANSFER,1998,Théodore Joseph-Lefebvre,4594,2596,Anastasie Richard-Neveu,105478,103480,2022-02-08
CASH_IN,286189,Agence_moov_Ouidah,300000,13811,Théodore Joseph-Lefebvre,2596,288785,2022-02-08
TRANSFER,274742,Théodore Joseph-Lefebvre,288785,14043,Thibaut de la Lombard,587948,313206,2022-02-09
CASH_OUT,13346,Théodore Joseph-Lefebvre,14043,697,Agence_moov_Abomey,300000,286654,2022-02-09
TRANSFER,605,Théodore Joseph-Lefebvre,697,92,Maggie Martinez,1400667,1400062,2022-02-11
CASH_IN,64158,Agence_moov_Cotonou,300000,235842,Théodore Joseph-Lefebvre,92,64250,2022-02-11
CASH_OUT,49769,Théodore Joseph-Lefebvre,64250,14481,Agence_moov_Cotonou,300000,250231,2022-02-12
CASH_IN,285164,Agence_moov_Abomey,300000,14836,Théodore Joseph-Lefebvre,14481,299645,2022-02-17
CASH_IN,170030,Agence_moov_Ouidah,300000,129970,Théodore Joseph-Lefebvre,299645,469675,2022-02-17
TRANSFER,49708,Marcelle-Valentine Guibert,656506,606798,Théodore Joseph-Lefebvre,469675,519383,2022-02-20
CASH_IN,263186,Agence_moov_Abomey,300000,36814,Théodore Joseph-Lefebvre,519383,782569,2022-02-20
CASH_OUT,625990,Théodore Joseph-Lefebvre,782569,156579,Agence_moov_Abomey,300000,-325990,2022-02-22
TRANSFER,17648,Théodore Joseph-Lefebvre,156579,138931,Robert-Louis Gosselin,435435,417787,2022-02-24
CASH_OUT,123307,Théodore Joseph-Lefebvre,138931,15624,Agence_moov_Ouidah,300000,176693,2022-02-25
CASH_OUT,9799,Théodore Joseph-Lefebvre,15624,5825,Agence_moov_Abomey,300000,290201,2022-02-25
TRANSFER,359787,Michel Bouchet,787700,427913,Théodore Joseph-Lefebvre,5825,365612,2022-02-25
TRANSFER,250281,Théodore Joseph-Lefebvre,365612,115331,Michel Bouchet,427913,177632,2022-02-27
CASH_IN,1616,Agence_moov_Ouidah,300000,298384,Tristan Gomez,3759,5375,2022-02-01
CASH_IN,95561,Agence_moov_Ouidah,300000,204439,Tristan Gomez,5375,100936,2022-02-02
CASH_IN,249966,Agence_moov_Abomey,300000,50034,Tristan Gomez,100936,350902,2022-02-03
CASH_OUT,338120,Tristan Gomez,350902,12782,Agence_moov_Cotonou,300000,-38120,2022-02-03
CASH_OUT,11835,Tristan Gomez,12782,947,Agence_moov_Ouidah,300000,288165,2022-02-04
CASH_IN,124997,Agence_moov_Cotonou,300000,175003,Tristan Gomez,947,125944,2022-02-04
CASH_IN,126131,Agence_moov_Ouidah,300000,173869,Tristan Gomez,125944,252075,2022-02-04
CASH_OUT,208443,Tristan Gomez,252075,43632,Agence_moov_Ouidah,300000,91557,2022-02-05
CASH_IN,152301,Agence_moov_Ouidah,300000,147699,Tristan Gomez,43632,195933,2022-02-08
CASH_OUT,37930,Tristan Gomez,195933,158003,Agence_moov_Abomey,300000,262070,2022-02-08
CASH_IN,106308,Agence_moov_Abomey,300000,193692,Tristan Gomez,158003,264311,2022-02-08
CASH_OUT,14307,Tristan Gomez,264311,250004,Agence_moov_Abomey,300000,285693,2022-02-09
CASH_OUT,126480,Tristan Gomez,250004,123524,Agence_moov_Ouidah,300000,173520,2022-02-09
TRANSFER,422488,Marcelle-Valentine Guibert,606798,184310,Tristan Gomez,123524,546012,2022-02-10
TRANSFER,166392,Tristan Gomez,546012,379620,Émile-René Baudry,1653412,1487020,2022-02-13
CASH_IN,205703,Agence_moov_Ouidah,300000,94297,Tristan Gomez,379620,585323,2022-02-13
CASH_OUT,30694,Tristan Gomez,585323,554629,Agence_moov_Ouidah,300000,269306,2022-02-14
CASH_IN,225590,Agence_moov_Abomey,300000,74410,Tristan Gomez,554629,780219,2022-02-16
TRANSFER,509459,Tristan Gomez,780219,270760,Bernard Maurice,78069,-431390,2022-02-16
CASH_OUT,233980,Tristan Gomez,270760,36780,Agence_moov_Ouidah,300000,66020,2022-02-16
TRANSFER,192658,Clémence-Véronique Munoz,267388,74730,Tristan Gomez,36780,229438,2022-02-17
TRANSFER,1057,Tristan Gomez,229438,228381,Hélène Le Chauvin,172236,171179,2022-02-19
CASH_IN,232249,Agence_moov_Abomey,300000,67751,Tristan Gomez,228381,460630,2022-02-20
CASH_IN,42692,Agence_moov_Cotonou,300000,257308,Tristan Gomez,460630,503322,2022-02-20
CASH_IN,38134,Agence_moov_Ouidah,300000,261866,Tristan Gomez,503322,541456,2022-02-21
CASH_OUT,266480,Tristan Gomez,541456,274976,Agence_moov_Abomey,300000,33520,2022-02-23
CASH_OUT,259931,Tristan Gomez,274976,15045,Agence_moov_Cotonou,300000,40069,2022-02-23
CASH_IN,91310,Agence_moov_Cotonou,300000,208690,Thomas-Robert Morvan,-350090,-258780,2022-02-03
CASH_IN,273034,Agence_moov_Ouidah,300000,26966,Thomas-Robert Morvan,-258780,14254,2022-02-03
TRANSFER,11035,Thomas-Robert Morvan,14254,3219,Gabriel Bègue,431114,420079,2022-02-05
CASH_OUT,1530,Thomas-Robert Morvan,3219,1689,Agence_moov_Ouidah,300000,298470,2022-02-07
CASH_OUT,1350,Thomas-Robert Morvan,1689,339,Agence_moov_Ouidah,300000,298650,2022-02-09
CASH_IN,234877,Agence_moov_Cotonou,300000,65123,Thomas-Robert Morvan,339,235216,2022-02-09
TRANSFER,194824,Thomas-Robert Morvan,235216,40392,Camille Prévost,1611600,1416776,2022-02-10
CASH_OUT,10891,Thomas-Robert Morvan,40392,29501,Agence_moov_Abomey,300000,289109,2022-02-11
CASH_IN,292723,Agence_moov_Abomey,300000,7277,Thomas-Robert Morvan,29501,322224,2022-02-11
CASH_OUT,210702,Thomas-Robert Morvan,322224,111522,Agence_moov_Ouidah,300000,89298,2022-02-11
CASH_OUT,93010,Thomas-Robert Morvan,111522,18512,Agence_moov_Cotonou,300000,206990,2022-02-13
CASH_IN,5274,Agence_moov_Cotonou,300000,294726,Thomas-Robert Morvan,18512,23786,2022-02-15
TRANSFER,714416,Nicolas Salmon Le Hamon,1554372,839956,Thomas-Robert Morvan,23786,738202,2022-02-16
CASH_IN,53975,Agence_moov_Cotonou,300000,246025,Thomas-Robert Morvan,738202,792177,2022-02-18
CASH_IN,52217,Agence_moov_Cotonou,300000,247783,Thomas-Robert Morvan,792177,844394,2022-02-18
TRANSFER,443154,Thomas-Robert Morvan,844394,401240,Colette-Sophie Prévost,1611227,1168073,2022-02-19
CASH_IN,258649,Agence_moov_Abomey,300000,41351,Thomas-Robert Morvan,401240,659889,2022-02-20
CASH_OUT,522046,Thomas-Robert Morvan,659889,137843,Agence_moov_Abomey,300000,-222046,2022-02-22
CASH_OUT,117727,Thomas-Robert Morvan,137843,20116,Agence_moov_Ouidah,300000,182273,2022-02-22
CASH_IN,134601,Agence_moov_Abomey,300000,165399,Thomas-Robert Morvan,20116,154717,2022-02-23
CASH_IN,266007,Agence_moov_Ouidah,300000,33993,Thomas-Robert Morvan,154717,420724,2022-02-25
TRANSFER,644463,Jules-Roland Bousquet,987080,342617,Thomas-Robert Morvan,420724,1065187,2022-02-25
CASH_IN,185942,Agence_moov_Cotonou,300000,114058,Thomas-Robert Morvan,1065187,1251129,2022-02-25
CASH_IN,190749,Agence_moov_Abomey,300000,109251,Jules-Roland Bousquet,342617,533366,2022-02-01
TRANSFER,268918,Maggie Martinez,1400062,1131144,Jules-Roland Bousquet,533366,802284,2022-02-02
CASH_IN,256751,Agence_moov_Abomey,300000,43249,Jules-Roland Bousquet,802284,1059035,2022-02-05
TRANSFER,82705,Vincent Joubert,254976,172271,Jules-Roland Bousquet,1059035,1141740,2022-02-06
CASH_IN,62136,Agence_moov_Ouidah,300000,237864,Jules-Roland Bousquet,1141740,1203876,2022-02-06
CASH_OUT,1093884,Jules-Roland Bousquet,1203876,109992,Agence_moov_Ouidah,300000,-793884,2022-02-10
TRANSFER,98773,Thomas Guichard du Renault,123856,25083,Jules-Roland Bousquet,109992,208765,2022-02-11
CASH_OUT,17044,Jules-Roland Bousquet,208765,191721,Agence_moov_Ouidah,300000,282956,2022-02-13
TRANSFER,160607,Jules-Roland Bousquet,191721,31114,Jules-Roland Bousquet,191721,352328,2022-02-13
TRANSFER,5188,Jules Fernandes,9700,4512,Jules-Roland Bousquet,31114,36302,2022-02-16
CASH_IN,27009,Agence_moov_Abomey,300000,272991,Jules-Roland Bousquet,36302,63311,2022-02-16
CASH_IN,116544,Agence_moov_Abomey,300000,183456,Jules-Roland Bousquet,63311,179855,2022-02-16
CASH_IN,241842,Agence_moov_Ouidah,300000,58158,Jules-Roland Bousquet,179855,421697,2022-02-17
CASH_OUT,2093,Jules-Roland Bousquet,421697,419604,Agence_moov_Ouidah,300000,297907,2022-02-17
CASH_OUT,113646,Jules-Roland Bousquet,419604,305958,Agence_moov_Abomey,300000,186354,2022-02-19
TRANSFER,101411,André Renault,237653,136242,Jules-Roland Bousquet,305958,407369,2022-02-21
TRANSFER,265375,Jules-Roland Bousquet,407369,141994,Jules-Roland Bousquet,407369,672744,2022-02-21
TRANSFER,28303,Jules-Roland Bousquet,141994,113691,Nicolas Salmon Le Hamon,839956,811653,2022-02-22
TRANSFER,9792,Marcelle-Valentine Guibert,184310,174518,Jules-Roland Bousquet,113691,123483,2022-02-22
CASH_IN,238077,Agence_moov_Abomey,300000,61923,Jules-Roland Bousquet,123483,361560,2022-02-24
CASH_IN,167559,Agence_moov_Ouidah,300000,132441,Jules-Roland Bousquet,361560,529119,2022-02-25
CASH_IN,160585,Agence_moov_Abomey,300000,139415,Jules-Roland Bousquet,529119,689704,2022-02-25
CASH_IN,154782,Agence_moov_Ouidah,300000,145218,Jules-Roland Bousquet,689704,844486,2022-02-26
TRANSFER,9255,Colette Merle Le Robert,85822,76567,Jules-Roland Bousquet,844486,853741,2022-02-26
CASH_IN,43316,Agence_moov_Ouidah,300000,256684,Bernard Maurice,-431390,-388074,2022-02-01
CASH_IN,290035,Agence_moov_Abomey,300000,9965,Bernard Maurice,-388074,-98039,2022-02-01
CASH_IN,261516,Agence_moov_Abomey,300000,38484,Bernard Maurice,-98039,163477,2022-02-03
CASH_OUT,9683,Bernard Maurice,163477,153794,Agence_moov_Ouidah,300000,290317,2022-02-03
CASH_OUT,110324,Bernard Maurice,153794,43470,Agence_moov_Abomey,300000,189676,2022-02-03
CASH_OUT,29947,Bernard Maurice,43470,13523,Agence_moov_Abomey,300000,270053,2022-02-03
TRANSFER,1110,Bernard Maurice,13523,12413,Astrid Lecoq,1283915,1282805,2022-02-04
CASH_IN,151334,Agence_moov_Abomey,300000,148666,Bernard Maurice,12413,163747,2022-02-04
CASH_IN,152003,Agence_moov_Ouidah,300000,147997,Bernard Maurice,163747,315750,2022-02-05
CASH_IN,278658,Agence_moov_Abomey,300000,21342,Bernard Maurice,315750,594408,2022-02-06
CASH_IN,57354,Agence_moov_Abomey,300000,242646,Bernard Maurice,594408,651762,2022-02-07
CASH_OUT,432990,Bernard Maurice,651762,218772,Agence_moov_Abomey,300000,-132990,2022-02-09
CASH_OUT,183137,Bernard Maurice,218772,35635,Agence_moov_Ouidah,300000,116863,2022-02-10
CASH_OUT,4229,Bernard Maurice,35635,31406,Agence_moov_Abomey,300000,295771,2022-02-11
CASH_OUT,7797,Bernard Maurice,31406,23609,Agence_moov_Ouidah,300000,292203,2022-02-12
TRANSFER,65921,Françoise Morin,765655,699734,Bernard Maurice,23609,89530,2022-02-14
CASH_OUT,47936,Bernard Maurice,89530,41594,Agence_moov_Ouidah,300000,252064,2022-02-15
CASH_OUT,36870,Bernard Maurice,41594,4724,Agence_moov_Ouidah,300000,263130,2022-02-15
CASH_OUT,4229,Bernard Maurice,4724,495,Agence_moov_Ouidah,300000,295771,2022-02-16
TRANSFER,35014,Clémence-Véronique Munoz,74730,39716,Bernard Maurice,495,35509,2022-02-18
CASH_OUT,16399,Bernard Maurice,35509,19110,Agence_moov_Cotonou,300000,283601,2022-02-19
CASH_OUT,4181,Bernard Maurice,19110,14929,Agence_moov_Cotonou,300000,295819,2022-02-23
TRANSFER,5868,Bernard Maurice,14929,9061,Mathilde Picard du Delmas,437913,432045,2022-02-23
CASH_OUT,467,Bernard Maurice,9061,8594,Agence_moov_Abomey,300000,299533,2022-02-25
TRANSFER,2201,Bernard Maurice,8594,6393,Michelle Samson,1062000,1059799,2022-02-27
CASH_IN,45608,Agence_moov_Cotonou,300000,254392,Adèle Da Silva-Klein,-410166,-364558,2022-02-01
CASH_IN,215193,Agence_moov_Abomey,300000,84807,Adèle Da Silva-Klein,-364558,-149365,2022-02-02
CASH_IN,8935,Agence_moov_Abomey,300000,291065,Adèle Da Silva-Klein,-149365,-140430,2022-02-02
CASH_IN,14657,Agence_moov_Ouidah,300000,285343,Adèle Da Silva-Klein,-140430,-125773,2022-02-02
CASH_IN,182656,Agence_moov_Ouidah,300000,117344,Adèle Da Silva-Klein,-125773,56883,2022-02-02
CASH_OUT,39887,Adèle Da Silva-Klein,56883,16996,Agence_moov_Ouidah,300000,260113,2022-02-02
CASH_IN,277911,Agence_moov_Ouidah,300000,22089,Adèle Da Silva-Klein,16996,294907,2022-02-03
CASH_IN,76982,Agence_moov_Cotonou,300000,223018,Adèle Da Silva-Klein,294907,371889,2022-02-04
TRANSFER,224147,Adèle Da Silva-Klein,371889,147742,Marc Leleu,1491300,1267153,2022-02-05
CASH_IN,281590,Agence_moov_Cotonou,300000,18410,Adèle Da Silva-Klein,147742,429332,2022-02-08
CASH_IN,261397,Agence_moov_Cotonou,300000,38603,Adèle Da Silva-Klein,429332,690729,2022-02-08
TRANSFER,594130,Adèle Da Silva-Klein,690729,96599,Raymond Lévy,933299,339169,2022-02-08
CASH_IN,68685,Agence_moov_Cotonou,300000,231315,Adèle Da Silva-Klein,96599,165284,2022-02-10
CASH_IN,286796,Agence_moov_Cotonou,300000,13204,Adèle Da Silva-Klein,165284,452080,2022-02-11
TRANSFER,41832,Adèle Da Silva-Klein,452080,410248,Mathilde Picard du Delmas,432045,390213,2022-02-11
TRANSFER,162484,Émile-René Baudry,1487020,1324536,Adèle Da Silva-Klein,410248,572732,2022-02-12
TRANSFER,686462,Stéphane Munoz,1448442,761980,Adèle Da Silva-Klein,572732,1259194,2022-02-13
CASH_IN,178920,Agence_moov_Ouidah,300000,121080,Adèle Da Silva-Klein,1259194,1438114,2022-02-13
CASH_OUT,281323,Adèle Da Silva-Klein,1438114,1156791,Agence_moov_Ouidah,300000,18677,2022-02-14
TRANSFER,628287,Adèle Da Silva-Klein,1156791,528504,Hélène Le Chauvin,171179,-457108,2022-02-15
CASH_IN,275444,Agence_moov_Abomey,300000,24556,Adèle Da Silva-Klein,528504,803948,2022-02-15
TRANSFER,19777,Clémence-Véronique Munoz,39716,19939,Adèle Da Silva-Klein,803948,823725,2022-02-15
CASH_IN,112286,Agence_moov_Cotonou,300000,187714,Adèle Da Silva-Klein,823725,936011,2022-02-17
CASH_OUT,364366,Adèle Da Silva-Klein,936011,571645,Agence_moov_Abomey,300000,-64366,2022-02-18
CASH_OUT,512914,Adèle Da Silva-Klein,571645,58731,Agence_moov_Ouidah,300000,-212914,2022-02-19
CASH_IN,282550,Agence_moov_Cotonou,300000,17450,Adèle Da Silva-Klein,58731,341281,2022-02-19
CASH_IN,143863,Agence_moov_Abomey,300000,156137,Adèle Da Silva-Klein,341281,485144,2022-02-21
CASH_OUT,99645,Adèle Da Silva-Klein,485144,385499,Agence_moov_Abomey,300000,200355,2022-02-26
CASH_IN,164205,Agence_moov_Abomey,300000,135795,Alix Barbe,49501,213706,2022-02-01
TRANSFER,1081,Émilie du Allain,2179,1098,Alix Barbe,213706,214787,2022-02-02
TRANSFER,17324,Léon Da Costa,17713,389,Alix Barbe,214787,232111,2022-02-03
CASH_OUT,192668,Alix Barbe,232111,39443,Agence_moov_Ouidah,300000,107332,2022-02-06
TRANSFER,692,Alix Barbe,39443,38751,Jules Fernandes,4512,3820,2022-02-06
TRANSFER,24654,Alix Barbe,38751,14097,Françoise Morin,699734,675080,2022-02-07
CASH_IN,45998,Agence_moov_Cotonou,300000,254002,Alix Barbe,14097,60095,2022-02-10
CASH_OUT,58492,Alix Barbe,60095,1603,Agence_moov_Cotonou,300000,241508,2022-02-11
CASH_IN,265720,Agence_moov_Ouidah,300000,34280,Alix Barbe,1603,267323,2022-02-12
TRANSFER,129804,Alix Barbe,267323,137519,Gabriel Bègue,420079,290275,2022-02-14
CASH_OUT,49252,Alix Barbe,137519,88267,Agence_moov_Cotonou,300000,250748,2022-02-14
TRANSFER,123449,Mathilde Picard du Delmas,390213,266764,Alix Barbe,88267,211716,2022-02-16
CASH_OUT,30089,Alix Barbe,211716,181627,Agence_moov_Abomey,300000,269911,2022-02-16
CASH_OUT,32428,Alix Barbe,181627,149199,Agence_moov_Cotonou,300000,267572,2022-02-17
CASH_IN,122459,Agence_moov_Ouidah,300000,177541,Alix Barbe,149199,271658,2022-02-20
CASH_IN,71648,Agence_moov_Cotonou,300000,228352,Alix Barbe,271658,343306,2022-02-20
CASH_OUT,133645,Alix Barbe,343306,209661,Agence_moov_Cotonou,300000,166355,2022-02-21
CASH_OUT,148140,Alix Barbe,209661,61521,Agence_moov_Ouidah,300000,151860,2022-02-23
CASH_IN,247485,Agence_moov_Cotonou,300000,52515,Alix Barbe,61521,309006,2022-02-24
TRANSFER,227661,Alix Barbe,309006,81345,Gabriel Bègue,290275,62614,2022-02-24
CASH_IN,285215,Agence_moov_Ouidah,300000,14785,Alix Barbe,81345,366560,2022-02-24
CASH_IN,101146,Agence_moov_Ouidah,300000,198854,Alix Barbe,366560,467706,2022-02-25
TRANSFER,132450,Mathilde Picard du Delmas,266764,134314,Alix Barbe,467706,600156,2022-02-25
CASH_OUT,554369,Alix Barbe,600156,45787,Agence_moov_Cotonou,300000,-254369,2022-02-26
CASH_IN,27756,Agence_moov_Ouidah,300000,272244,Astrid Lecoq,1282805,1310561,2022-02-02
CASH_IN,73874,Agence_moov_Abomey,300000,226126,Astrid Lecoq,1310561,1384435,2022-02-04
CASH_OUT,260740,Astrid Lecoq,1384435,1123695,Agence_moov_Cotonou,300000,39260,2022-02-07
CASH_IN,294320,Agence_moov_Abomey,300000,5680,Astrid Lecoq,1123695,1418015,2022-02-07
TRANSFER,833433,Astrid Lecoq,1418015,584582,Thomas Guichard du Renault,25083,-808350,2022-02-09
CASH_IN,77265,Agence_moov_Abomey,300000,222735,Astrid Lecoq,584582,661847,2022-02-10
CASH_IN,288139,Agence_moov_Abomey,300000,11861,Astrid Lecoq,661847,949986,2022-02-12
CASH_IN,280640,Agence_moov_Ouidah,300000,19360,Astrid Lecoq,949986,1230626,2022-02-12
CASH_IN,150537,Agence_moov_Ouidah,300000,149463,Astrid Lecoq,1230626,1381163,2022-02-14
CASH_IN,44440,Agence_moov_Cotonou,300000,255560,Astrid Lecoq,1381163,1425603,2022-02-15
TRANSFER,631608,Astrid Lecoq,1425603,793995,Audrey Julien de Leleu,49692,-581916,2022-02-15
CASH_OUT,255655,Astrid Lecoq,793995,538340,Agence_moov_Cotonou,300000,44345,2022-02-15
CASH_IN,224947,Agence_moov_Cotonou,300000,75053,Astrid Lecoq,538340,763287,2022-02-16
TRANSFER,262078,Astrid Lecoq,763287,501209,Nicolas Salmon Le Hamon,811653,549575,2022-02-16
CASH_IN,155968,Agence_moov_Ouidah,300000,144032,Astrid Lecoq,501209,657177,2022-02-17
CASH_IN,50806,Agence_moov_Ouidah,300000,249194,Astrid Lecoq,657177,707983,2022-02-17
TRANSFER,179099,Astrid Lecoq,707983,528884,Nicolas Salmon Le Hamon,549575,370476,2022-02-17
CASH_IN,137059,Agence_moov_Abomey,300000,162941,Astrid Lecoq,528884,665943,2022-02-17
CASH_IN,3426,Agence_moov_Cotonou,300000,296574,Astrid Lecoq,665943,669369,2022-02-18
CASH_OUT,58359,Astrid Lecoq,669369,611010,Agence_moov_Abomey,300000,241641,2022-02-18
CASH_IN,261881,Agence_moov_Abomey,300000,38119,Astrid Lecoq,611010,872891,2022-02-19
CASH_OUT,365778,Astrid Lecoq,872891,507113,Agence_moov_Ouidah,300000,-65778,2022-02-20
TRANSFER,217707,Astrid Lecoq,507113,289406,Clémence-Véronique Munoz,19939,-197768,2022-02-20
CASH_OUT,152083,Astrid Lecoq,289406,137323,Agence_moov_Abomey,300000,147917,2022-02-21
CASH_IN,159800,Agence_moov_Cotonou,300000,140200,Astrid Lecoq,137323,297123,2022-02-22
CASH_IN,117930,Agence_moov_Ouidah,300000,182070,Astrid Lecoq,297123,415053,2022-02-22
CASH_OUT,335628,Astrid Lecoq,415053,79425,Agence_moov_Ouidah,300000,-35628,2022-02-22
CASH_OUT,43466,Astrid Lecoq,79425,35959,Agence_moov_Abomey,300000,256534,2022-02-25
CASH_IN,150679,Agence_moov_Cotonou,300000,149321,Astrid Lecoq,35959,186638,2022-02-25
TRANSFER,67481,Astrid Lecoq,186638,119157,Colette-Sophie Prévost,1168073,1100592,2022-02-27
CASH_OUT,425873,Colette-Sophie Prévost,1100592,674719,Agence_moov_Abomey,300000,-125873,2022-02-01
TRANSFER,99390,Michel Bouchet,177632,78242,Colette-Sophie Prévost,674719,774109,2022-02-03
TRANSFER,483428,Colette-Sophie Prévost,774109,290681,Lucy Lamy,283408,-200020,2022-02-04
CASH_OUT,217747,Colette-Sophie Prévost,290681,72934,Agence_moov_Ouidah,300000,82253,2022-02-04
TRANSFER,39120,Colette-Sophie Prévost,72934,33814,Emmanuel Grégoire,1009300,970180,2022-02-05
CASH_OUT,29911,Colette-Sophie Prévost,33814,3903,Agence_moov_Abomey,300000,270089,2022-02-06
CASH_OUT,1343,Colette-Sophie Prévost,3903,2560,Agence_moov_Abomey,300000,298657,2022-02-06
TRANSFER,2061,Colette-Sophie Prévost,2560,499,Mathilde Picard du Delmas,134314,132253,2022-02-06
CASH_IN,208029,Agence_moov_Abomey,300000,91971,Colette-Sophie Prévost,499,208528,2022-02-07
TRANSFER,145802,Colette-Sophie Prévost,208528,62726,Vincent Joubert,172271,26469,2022-02-08
CASH_IN,275525,Agence_moov_Ouidah,300000,24475,Colette-Sophie Prévost,62726,338251,2022-02-08
CASH_OUT,181273,Colette-Sophie Prévost,338251,156978,Agence_moov_Ouidah,300000,118727,2022-02-09
CASH_IN,230420,Agence_moov_Abomey,300000,69580,Colette-Sophie Prévost,156978,387398,2022-02-09
CASH_IN,281693,Agence_moov_Abomey,300000,18307,Colette-Sophie Prévost,387398,669091,2022-02-10
CASH_IN,212119,Agence_moov_Abomey,300000,87881,Colette-Sophie Prévost,669091,881210,2022-02-11
CASH_OUT,387768,Colette-Sophie Prévost,881210,493442,Agence_moov_Abomey,300000,-87768,2022-02-19
TRANSFER,40394,Colette-Sophie Prévost,493442,453048,Nicolas Salmon Le Hamon,370476,330082,2022-02-20
CASH_OUT,76247,Colette-Sophie Prévost,453048,376801,Agence_moov_Cotonou,300000,223753,2022-02-20
CASH_OUT,347100,Colette-Sophie Prévost,376801,29701,Agence_moov_Abomey,300000,-47100,2022-02-21
TRANSFER,10728,Colette-Sophie Prévost,29701,18973,Aurore Charrier,1363187,1352459,2022-02-22
CASH_OUT,10445,Colette-Sophie Prévost,18973,8528,Agence_moov_Ouidah,300000,289555,2022-02-22
CASH_OUT,6206,Colette-Sophie Prévost,8528,2322,Agence_moov_Ouidah,300000,293794,2022-02-25
CASH_IN,186628,Agence_moov_Abomey,300000,113372,Colette-Sophie Prévost,2322,188950,2022-02-25
TRANSFER,106959,Antoinette de Dupuis,259366,152407,Colette-Sophie Prévost,188950,295909,2022-02-25
CASH_OUT,12088,Colette-Sophie Prévost,295909,283821,Agence_moov_Abomey,300000,287912,2022-02-25
CASH_OUT,123624,Colette-Sophie Prévost,283821,160197,Agence_moov_Cotonou,300000,176376,2022-02-26
CASH_OUT,152884,Colette-Sophie Prévost,160197,7313,Agence_moov_Cotonou,300000,147116,2022-02-26
TRANSFER,2302,Colette-Sophie Prévost,7313,5011,Colette Merle Le Robert,76567,74265,2022-02-27
TRANSFER,466095,Manon Valette,673594,207499,Colette-Sophie Prévost,5011,471106,2022-02-27
TRANSFER,15264,Colette-Sophie Prévost,471106,455842,Richard Michel,591437,576173,2022-02-27
TRANSFER,279704,Nicolas Salmon Le Hamon,330082,50378,Émilie du Allain,1098,-278606,2022-02-03
TRANSFER,44340,Nicolas Salmon Le Hamon,50378,6038,Manon Valette,207499,163159,2022-02-04
TRANSFER,91619,Thibaut de la Lombard,313206,221587,Nicolas Salmon Le Hamon,6038,97657,2022-02-04
TRANSFER,56195,Anastasie Richard-Neveu,103480,47285,Nicolas Salmon Le Hamon,97657,153852,2022-02-05
CASH_OUT,11526,Nicolas Salmon Le Hamon,153852,142326,Agence_moov_Cotonou,300000,288474,2022-02-06
TRANSFER,268636,Françoise Morin,675080,406444,Nicolas Salmon Le Hamon,142326,410962,2022-02-07
CASH_OUT,169096,Nicolas Salmon Le Hamon,410962,241866,Agence_moov_Abomey,300000,130904,2022-02-10
TRANSFER,65075,Nicolas Salmon Le Hamon,241866,176791,Vincent Joubert,26469,-38606,2022-02-10
CASH_OUT,109451,Nicolas Salmon Le Hamon,176791,67340,Agence_moov_Abomey,300000,190549,2022-02-11
CASH_IN,9876,Agence_moov_Cotonou,300000,290124,Nicolas Salmon Le Hamon,67340,77216,2022-02-11
CASH_IN,131937,Agence_moov_Cotonou,300000,168063,Nicolas Salmon Le Hamon,77216,209153,2022-02-16
CASH_IN,167544,Agence_moov_Abomey,300000,132456,Nicolas Salmon Le Hamon,209153,376697,2022-02-20
CASH_IN,155593,Agence_moov_Cotonou,300000,144407,Nicolas Salmon Le Hamon,376697,532290,2022-02-20
TRANSFER,854037,Emmanuel Grégoire,970180,116143,Nicolas Salmon Le Hamon,532290,1386327,2022-02-25
TRANSFER,1339394,Nicolas Salmon Le Hamon,1386327,46933,Camille Prévost,1416776,77382,2022-02-27
TRANSFER,28092,Nicolas Salmon Le Hamon,46933,18841,Aurore Charrier,1352459,1324367,2022-02-27
CASH_IN,94399,Agence_moov_Cotonou,300000,205601,Marc Leleu,1267153,1361552,2022-02-02
CASH_OUT,549486,Marc Leleu,1361552,812066,Agence_moov_Ouidah,300000,-249486,2022-02-05
TRANSFER,59256,Thibaut de la Lombard,221587,162331,Marc Leleu,812066,871322,2022-02-06
TRANSFER,462047,Aurore Charrier,1324367,862320,Marc Leleu,871322,1333369,2022-02-08
CASH_OUT,1187115,Marc Leleu,1333369,146254,Agence_moov_Abomey,300000,-887115,2022-02-16
CASH_IN,77586,Agence_moov_Ouidah,300000,222414,Marc Leleu,146254,223840,2022-02-19
TRANSFER,38982,Françoise Morin,406444,367462,Marc Leleu,223840,262822,2022-02-19
CASH_OUT,33426,Marc Leleu,262822,229396,Agence_moov_Cotonou,300000,266574,2022-02-21
TRANSFER,453095,Maggie Martinez,1131144,678049,Marc Leleu,229396,682491,2022-02-24
TRANSFER,12024,Anastasie Richard-Neveu,47285,35261,Marc Leleu,682491,694515,2022-02-26
CASH_OUT,119744,Marc Leleu,694515,574771,Agence_moov_Ouidah,300000,180256,2022-02-27
CASH_IN,54973,Agence_moov_Abomey,300000,245027,Timothée-René Blanchard,-57667,-2694,2022-02-11
CASH_IN,24568,Agence_moov_Cotonou,300000,275432,Timothée-René Blanchard,-2694,21874,2022-02-12
CASH_OUT,2115,Timothée-René Blanchard,21874,19759,Agence_moov_Ouidah,300000,297885,2022-02-16
TRANSFER,5733,Timothée-René Blanchard,19759,14026,Françoise Morin,367462,361729,2022-02-23
CASH_OUT,9798,Timothée-René Blanchard,14026,4228,Agence_moov_Abomey,300000,290202,2022-02-24
TRANSFER,711,Timothée-René Blanchard,4228,3517,Emmanuel Grégoire,116143,115432,2022-02-25
TRANSFER,790,Timothée-René Blanchard,3517,2727,Véronique Martins de Fleury,186667,185877,2022-02-26
CASH_IN,118542,Agence_moov_Abomey,300000,181458,Constance Guillon,-14156,104386,2022-02-01
CASH_OUT,11769,Constance Guillon,104386,92617,Agence_moov_Ouidah,300000,288231,2022-02-01
CASH_OUT,11671,Constance Guillon,92617,80946,Agence_moov_Cotonou,300000,288329,2022-02-03
TRANSFER,76740,Constance Guillon,80946,4206,Émile-René Baudry,1324536,1247796,2022-02-07
CASH_IN,240584,Agence_moov_Abomey,300000,59416,Constance Guillon,4206,244790,2022-02-10
TRANSFER,92360,Constance Guillon,244790,152430,Tristan Delahaye,1316263,1223903,2022-02-12
CASH_OUT,16244,Constance Guillon,152430,136186,Agence_moov_Abomey,300000,283756,2022-02-13
CASH_OUT,1832,Constance Guillon,136186,134354,Agence_moov_Cotonou,300000,298168,2022-02-14
TRANSFER,57815,Constance Guillon,134354,76539,Anastasie Richard-Neveu,35261,-22554,2022-02-23
CASH_IN,56296,Agence_moov_Abomey,300000,243704,Constance Guillon,76539,132835,2022-02-23
CASH_OUT,86482,Constance Guillon,132835,46353,Agence_moov_Cotonou,300000,213518,2022-02-24
CASH_OUT,26350,Constance Guillon,46353,20003,Agence_moov_Cotonou,300000,273650,2022-02-26
CASH_IN,83664,Agence_moov_Cotonou,300000,216336,Clémence-Véronique Munoz,-197768,-114104,2022-02-01
CASH_IN,208603,Agence_moov_Cotonou,300000,91397,Clémence-Véronique Munoz,-114104,94499,2022-02-05
TRANSFER,207991,Michelle Samson,1059799,851808,Clémence-Véronique Munoz,94499,302490,2022-02-09
CASH_IN,122868,Agence_moov_Cotonou,300000,177132,Clémence-Véronique Munoz,302490,425358,2022-02-09
TRANSFER,409297,Clémence-Véronique Munoz,425358,16061,Paul Rocher-Maillet,13700,-395597,2022-02-16
TRANSFER,14508,Clémence-Véronique Munoz,16061,1553,Manon Valette,163159,148651,2022-02-18
TRANSFER,1370,Clémence-Véronique Munoz,1553,183,Camille Prévost,77382,76012,2022-02-18
TRANSFER,15924,Marcelle-Valentine Guibert,174518,158594,Clémence-Véronique Munoz,183,16107,2022-02-20
CASH_OUT,11715,Clémence-Véronique Munoz,16107,4392,Agence_moov_Cotonou,300000,288285,2022-02-20
CASH_OUT,2983,Clémence-Véronique Munoz,4392,1409,Agence_moov_Ouidah,300000,297017,2022-02-21
CASH_OUT,1202,Clémence-Véronique Munoz,1409,207,Agence_moov_Ouidah,300000,298798,2022-02-22
CASH_OUT,198,Clémence-Véronique Munoz,207,9,Agence_moov_Cotonou,300000,299802,2022-02-22
CASH_IN,98836,Agence_moov_Abomey,300000,201164,Clémence-Véronique Munoz,9,98845,2022-02-25
CASH_IN,179237,Agence_moov_Cotonou,300000,120763,Clémence-Véronique Munoz,98845,278082,2022-02-26
TRANSFER,139371,Clémence-Véronique Munoz,278082,138711,Robert-Louis Gosselin,417787,278416,2022-02-27
CASH_IN,153909,Agence_moov_Ouidah,300000,146091,Clémence-Véronique Munoz,138711,292620,2022-02-27
CASH_IN,214495,Agence_moov_Abomey,300000,85505,Clémence-Véronique Munoz,292620,507115,2022-02-27
TRANSFER,55127,Gabriel Bègue,62614,7487,Stéphane Munoz,761980,706853,2022-02-02
CASH_IN,212862,Agence_moov_Ouidah,300000,87138,Gabriel Bègue,7487,220349,2022-02-08
CASH_IN,140110,Agence_moov_Abomey,300000,159890,Gabriel Bègue,220349,360459,2022-02-09
CASH_IN,165785,Agence_moov_Ouidah,300000,134215,Gabriel Bègue,360459,526244,2022-02-10
CASH_OUT,213613,Gabriel Bègue,526244,312631,Agence_moov_Abomey,300000,86387,2022-02-11
TRANSFER,39049,Gabriel Bègue,312631,273582,Aurore Charrier,862320,823271,2022-02-12
CASH_OUT,187789,Gabriel Bègue,273582,85793,Agence_moov_Cotonou,300000,112211,2022-02-13
TRANSFER,60604,Manon Chevalier,275939,215335,Gabriel Bègue,85793,146397,2022-02-15
CASH_OUT,679,Gabriel Bègue,146397,145718,Agence_moov_Abomey,300000,299321,2022-02-16
CASH_IN,271584,Agence_moov_Cotonou,300000,28416,Gabriel Bègue,145718,417302,2022-02-17
CASH_OUT,402412,Gabriel Bègue,417302,14890,Agence_moov_Abomey,300000,-102412,2022-02-20
CASH_OUT,10296,Gabriel Bègue,14890,4594,Agence_moov_Abomey,300000,289704,2022-02-20
CASH_IN,287912,Agence_moov_Cotonou,300000,12088,Gabriel Bègue,4594,292506,2022-02-22
CASH_OUT,107268,Gabriel Bègue,292506,185238,Agence_moov_Ouidah,300000,192732,2022-02-22
TRANSFER,185049,Gabriel Bègue,185238,189,Thibaut de la Lombard,162331,-22718,2022-02-26
CASH_IN,289353,Agence_moov_Abomey,300000,10647,Gabriel Bègue,189,289542,2022-02-27
CASH_IN,131869,Agence_moov_Cotonou,300000,168131,Michelle-Dorothée Lévêque,-77462,54407,2022-02-01
CASH_IN,146413,Agence_moov_Cotonou,300000,153587,Michelle-Dorothée Lévêque,54407,200820,2022-02-08
CASH_OUT,118783,Michelle-Dorothée Lévêque,200820,82037,Agence_moov_Ouidah,300000,181217,2022-02-08
CASH_OUT,59048,Michelle-Dorothée Lévêque,82037,22989,Agence_moov_Cotonou,300000,240952,2022-02-08
CASH_IN,193456,Agence_moov_Cotonou,300000,106544,Michelle-Dorothée Lévêque,22989,216445,2022-02-11
TRANSFER,1006867,Émile-René Baudry,1247796,240929,Michelle-Dorothée Lévêque,216445,1223312,2022-02-11
CASH_IN,139422,Agence_moov_Cotonou,300000,160578,Michelle-Dorothée Lévêque,1223312,1362734,2022-02-12
CASH_OUT,1048411,Michelle-Dorothée Lévêque,1362734,314323,Agence_moov_Abomey,300000,-748411,2022-02-13
CASH_IN,81151,Agence_moov_Abomey,300000,218849,Michelle-Dorothée Lévêque,314323,395474,2022-02-13
CASH_IN,283271,Agence_moov_Cotonou,300000,16729,Michelle-Dorothée Lévêque,395474,678745,2022-02-20
CASH_OUT,641932,Michelle-Dorothée Lévêque,678745,36813,Agence_moov_Abomey,300000,-341932,2022-02-21
CASH_IN,182979,Agence_moov_Abomey,300000,117021,Michelle-Dorothée Lévêque,36813,219792,2022-02-22
CASH_OUT,216473,Michelle-Dorothée Lévêque,219792,3319,Agence_moov_Ouidah,300000,83527,2022-02-26
CASH_OUT,2394,Michelle-Dorothée Lévêque,3319,925,Agence_moov_Abomey,300000,297606,2022-02-26
CASH_IN,35130,Agence_moov_Cotonou,300000,264870,Michelle-Dorothée Lévêque,925,36055,2022-02-27
CASH_IN,186068,Agence_moov_Abomey,300000,113932,Constance Bourdon-Millet,-384609,-198541,2022-02-01
CASH_IN,125813,Agence_moov_Abomey,300000,174187,Constance Bourdon-Millet,-198541,-72728,2022-02-03
CASH_IN,96597,Agence_moov_Ouidah,300000,203403,Constance Bourdon-Millet,-72728,23869,2022-02-07
CASH_IN,147380,Agence_moov_Abomey,300000,152620,Constance Bourdon-Millet,23869,171249,2022-02-09
CASH_IN,21040,Agence_moov_Abomey,300000,278960,Constance Bourdon-Millet,171249,192289,2022-02-10
CASH_IN,13899,Agence_moov_Ouidah,300000,286101,Constance Bourdon-Millet,192289,206188,2022-02-10
CASH_OUT,113011,Constance Bourdon-Millet,206188,93177,Agence_moov_Cotonou,300000,186989,2022-02-12
CASH_OUT,86207,Constance Bourdon-Millet,93177,6970,Agence_moov_Cotonou,300000,213793,2022-02-13
CASH_OUT,4330,Constance Bourdon-Millet,6970,2640,Agence_moov_Ouidah,300000,295670,2022-02-14
TRANSFER,141404,Émile-René Baudry,240929,99525,Constance Bourdon-Millet,2640,144044,2022-02-15
TRANSFER,126802,Constance Bourdon-Millet,144044,17242,Véronique Martins de Fleury,185877,59075,2022-02-16
CASH_OUT,10806,Constance Bourdon-Millet,17242,6436,Agence_moov_Cotonou,300000,289194,2022-02-22
TRANSFER,3490,Constance Bourdon-Millet,6436,2946,Aurore Charrier,823271,819781,2022-02-24
CASH_IN,49234,Agence_moov_Abomey,300000,250766,Constance Bourdon-Millet,2946,52180,2022-02-25
CASH_OUT,33385,Constance Bourdon-Millet,52180,18795,Agence_moov_Cotonou,300000,266615,2022-02-27
CASH_IN,235876,Agence_moov_Cotonou,300000,64124,Vincent Joubert,-38606,197270,2022-02-09
TRANSFER,48680,Vincent Joubert,197270,148590,Jules Fernandes,3820,-44860,2022-02-11
TRANSFER,15426,Vincent Joubert,148590,133164,Emmanuel Grégoire,115432,100006,2022-02-11
CASH_OUT,4861,Vincent Joubert,133164,128303,Agence_moov_Abomey,300000,295139,2022-02-12
TRANSFER,207944,Manon Chevalier,215335,7391,Vincent Joubert,128303,336247,2022-02-13
CASH_IN,171829,Agence_moov_Cotonou,300000,128171,Vincent Joubert,336247,508076,2022-02-18
CASH_OUT,322353,Vincent Joubert,508076,185723,Agence_moov_Ouidah,300000,-22353,2022-02-19
TRANSFER,166006,Vincent Joubert,185723,19717,Emmanuel Grégoire,100006,-66000,2022-02-23
CASH_OUT,18404,Vincent Joubert,19717,1313,Agence_moov_Cotonou,300000,281596,2022-02-23
CASH_OUT,543,Vincent Joubert,1313,770,Agence_moov_Cotonou,300000,299457,2022-02-24
TRANSFER,56760,Michel Bouchet,78242,21482,Vincent Joubert,770,57530,2022-02-25
CASH_IN,240868,Agence_moov_Ouidah,300000,59132,Thomas Dupont,-513259,-272391,2022-02-02
CASH_IN,189574,Agence_moov_Cotonou,300000,110426,Thomas Dupont,-272391,-82817,2022-02-05
CASH_IN,196039,Agence_moov_Abomey,300000,103961,Thomas Dupont,-82817,113222,2022-02-06
CASH_OUT,49996,Thomas Dupont,113222,63226,Agence_moov_Abomey,300000,250004,2022-02-11
CASH_IN,4295,Agence_moov_Cotonou,300000,295705,Thomas Dupont,63226,67521,2022-02-12
TRANSFER,43625,Thomas Dupont,67521,23896,Mathilde Picard du Delmas,132253,88628,2022-02-12
TRANSFER,9105,Thomas Dupont,23896,14791,André Renault,136242,127137,2022-02-16
CASH_IN,139974,Agence_moov_Cotonou,300000,160026,Thomas Dupont,14791,154765,2022-02-17
TRANSFER,144737,Antoinette de Dupuis,152407,7670,Thomas Dupont,154765,299502,2022-02-22
CASH_OUT,60058,Thomas Dupont,299502,239444,Agence_moov_Abomey,300000,239942,2022-02-23
CASH_IN,76066,Agence_moov_Cotonou,300000,223934,Thomas Dupont,239444,315510,2022-02-26
CASH_IN,178141,Agence_moov_Cotonou,300000,121859,Thomas Dupont,315510,493651,2022-02-27
CASH_IN,184792,Agence_moov_Abomey,300000,115208,Frédéric Guillou,-45811,138981,2022-02-01
CASH_OUT,11239,Frédéric Guillou,138981,127742,Agence_moov_Cotonou,300000,288761,2022-02-01
CASH_IN,156701,Agence_moov_Cotonou,300000,143299,Frédéric Guillou,127742,284443,2022-02-02
TRANSFER,273063,Bertrand Regnier,320920,47857,Frédéric Guillou,284443,557506,2022-02-03
CASH_IN,266353,Agence_moov_Cotonou,300000,33647,Frédéric Guillou,557506,823859,2022-02-04
TRANSFER,760057,Frédéric Guillou,823859,63802,Léon Da Costa,389,-759668,2022-02-04
CASH_OUT,37117,Frédéric Guillou,63802,26685,Agence_moov_Ouidah,300000,262883,2022-02-06
CASH_OUT,17694,Frédéric Guillou,26685,8991,Agence_moov_Ouidah,300000,282306,2022-02-06
CASH_IN,164484,Agence_moov_Ouidah,300000,135516,Frédéric Guillou,8991,173475,2022-02-12
CASH_IN,28076,Agence_moov_Ouidah,300000,271924,Frédéric Guillou,173475,201551,2022-02-19
TRANSFER,51368,Frédéric Guillou,201551,150183,Stéphane Munoz,706853,655485,2022-02-20
CASH_IN,26810,Agence_moov_Cotonou,300000,273190,Frédéric Guillou,150183,176993,2022-02-23
CASH_OUT,167997,Frédéric Guillou,176993,8996,Agence_moov_Ouidah,300000,132003,2022-02-23
CASH_IN,121340,Agence_moov_Cotonou,300000,178660,Frédéric Guillou,8996,130336,2022-02-23
TRANSFER,105845,Frédéric Guillou,130336,24491,Antoinette de Dupuis,7670,-98175,2022-02-25
CASH_OUT,21979,Frédéric Guillou,24491,2512,Agence_moov_Ouidah,300000,278021,2022-02-26
CASH_IN,101623,Agence_moov_Cotonou,300000,198377,Frédéric Guillou,2512,104135,2022-02-26
CASH_IN,43868,Agence_moov_Abomey,300000,256132,Françoise Morin,361729,405597,2022-02-02
CASH_OUT,185837,Françoise Morin,405597,219760,Agence_moov_Ouidah,300000,114163,2022-02-03
CASH_OUT,22793,Françoise Morin,219760,196967,Agence_moov_Abomey,300000,277207,2022-02-06
TRANSFER,73368,Françoise Morin,196967,123599,Frédérique Fernandes du Bouchet,156399,83031,2022-02-07
CASH_IN,122465,Agence_moov_Cotonou,300000,177535,Françoise Morin,123599,246064,2022-02-12
CASH_OUT,11489,Françoise Morin,246064,234575,Agence_moov_Cotonou,300000,288511,2022-02-15
CASH_IN,231771,Agence_moov_Cotonou,300000,68229,Françoise Morin,234575,466346,2022-02-16
TRANSFER,578019,Aurore Charrier,819781,241762,Françoise Morin,466346,1044365,2022-02-17
TRANSFER,553928,Françoise Morin,1044365,490437,Stéphane Munoz,655485,101557,2022-02-19
TRANSFER,317314,Françoise Morin,490437,173123,Camille Prévost,76012,-241302,2022-02-21
CASH_IN,95879,Agence_moov_Abomey,300000,204121,Françoise Morin,173123,269002,2022-02-21
CASH_OUT,180094,Françoise Morin,269002,88908,Agence_moov_Abomey,300000,119906,2022-02-22
TRANSFER,51012,Françoise Morin,88908,37896,Colette Merle Le Robert,74265,23253,2022-02-23
CASH_IN,155194,Agence_moov_Cotonou,300000,144806,Françoise Morin,37896,193090,2022-02-25
CASH_OUT,69140,Françoise Morin,193090,123950,Agence_moov_Abomey,300000,230860,2022-02-26
CASH_OUT,10981,Michelle Samson,851808,840827,Agence_moov_Abomey,300000,289019,2022-02-04
CASH_IN,144804,Agence_moov_Cotonou,300000,155196,Michelle Samson,840827,985631,2022-02-06
TRANSFER,852193,Michelle Samson,985631,133438,Aurore Charrier,241762,-610431,2022-02-09
CASH_IN,173419,Agence_moov_Ouidah,300000,126581,Michelle Samson,133438,306857,2022-02-10
CASH_IN,126495,Agence_moov_Ouidah,300000,173505,Michelle Samson,306857,433352,2022-02-12
CASH_OUT,159461,Michelle Samson,433352,273891,Agence_moov_Abomey,300000,140539,2022-02-12
CASH_OUT,187981,Michelle Samson,273891,85910,Agence_moov_Cotonou,300000,112019,2022-02-13
CASH_OUT,30571,Michelle Samson,85910,55339,Agence_moov_Ouidah,300000,269429,2022-02-13
TRANSFER,8932,Michel Bouchet,21482,12550,Michelle Samson,55339,64271,2022-02-20
TRANSFER,151892,Marcelle-Valentine Guibert,158594,6702,Michelle Samson,64271,216163,2022-02-20
TRANSFER,321618,Maggie Martinez,678049,356431,Michelle Samson,216163,537781,2022-02-20
CASH_IN,190908,Agence_moov_Abomey,300000,109092,Michelle Samson,537781,728689,2022-02-20
CASH_IN,87340,Agence_moov_Ouidah,300000,212660,Michelle Samson,728689,816029,2022-02-23
CASH_IN,19128,Agence_moov_Ouidah,300000,280872,Michelle Samson,816029,835157,2022-02-24
CASH_IN,178961,Agence_moov_Cotonou,300000,121039,Michelle Samson,835157,1014118,2022-02-25
CASH_IN,220548,Agence_moov_Ouidah,300000,79452,Michelle Samson,1014118,1234666,2022-02-25
CASH_IN,140507,Agence_moov_Abomey,300000,159493,Michelle Samson,1234666,1375173,2022-02-25
CASH_OUT,584295,Michelle Samson,1375173,790878,Agence_moov_Abomey,300000,-284295,2022-02-26
CASH_IN,79445,Agence_moov_Abomey,300000,220555,Anastasie Richard-Neveu,-22554,56891,2022-02-01
CASH_IN,182107,Agence_moov_Abomey,300000,117893,Anastasie Richard-Neveu,56891,238998,2022-02-01
CASH_OUT,107699,Anastasie Richard-Neveu,238998,131299,Agence_moov_Cotonou,300000,192301,2022-02-04
TRANSFER,119274,Anastasie Richard-Neveu,131299,12025,Colette Merle Le Robert,23253,-96021,2022-02-07
CASH_IN,205000,Agence_moov_Abomey,300000,95000,Anastasie Richard-Neveu,12025,217025,2022-02-09
TRANSFER,166675,Anastasie Richard-Neveu,217025,50350,Marcelle-Valentine Guibert,6702,-159973,2022-02-10
CASH_OUT,45960,Anastasie Richard-Neveu,50350,4390,Agence_moov_Cotonou,300000,254040,2022-02-10
CASH_IN,72086,Agence_moov_Abomey,300000,227914,Anastasie Richard-Neveu,4390,76476,2022-02-11
CASH_OUT,44933,Anastasie Richard-Neveu,76476,31543,Agence_moov_Abomey,300000,255067,2022-02-12
TRANSFER,36731,Bertrand Regnier,47857,11126,Anastasie Richard-Neveu,31543,68274,2022-02-13
CASH_IN,205349,Agence_moov_Ouidah,300000,94651,Anastasie Richard-Neveu,68274,273623,2022-02-14
CASH_IN,40736,Agence_moov_Abomey,300000,259264,Anastasie Richard-Neveu,273623,314359,2022-02-24
TRANSFER,27714,Émile-René Baudry,99525,71811,Anastasie Richard-Neveu,314359,342073,2022-02-26
TRANSFER,152839,Anastasie Richard-Neveu,342073,189234,Maggie Martinez,356431,203592,2022-02-26
CASH_IN,101422,Agence_moov_Abomey,300000,198578,Anastasie Richard-Neveu,189234,290656,2022-02-26
TRANSFER,244039,Anastasie Richard-Neveu,290656,46617,Émile-René Baudry,71811,-172228,2022-02-27
CASH_IN,216937,Agence_moov_Ouidah,300000,83063,Philippe Philippe,-903911,-686974,2022-02-01
CASH_IN,88231,Agence_moov_Cotonou,300000,211769,Philippe Philippe,-686974,-598743,2022-02-01
CASH_IN,38983,Agence_moov_Cotonou,300000,261017,Philippe Philippe,-598743,-559760,2022-02-02
CASH_IN,276509,Agence_moov_Ouidah,300000,23491,Philippe Philippe,-559760,-283251,2022-02-03
CASH_IN,122004,Agence_moov_Cotonou,300000,177996,Philippe Philippe,-283251,-161247,2022-02-03
CASH_IN,65980,Agence_moov_Cotonou,300000,234020,Philippe Philippe,-161247,-95267,2022-02-06
CASH_IN,254498,Agence_moov_Ouidah,300000,45502,Philippe Philippe,-95267,159231,2022-02-06
CASH_OUT,139563,Philippe Philippe,159231,19668,Agence_moov_Ouidah,300000,160437,2022-02-09
CASH_IN,208765,Agence_moov_Abomey,300000,91235,Philippe Philippe,19668,228433,2022-02-09
TRANSFER,176580,Philippe Philippe,228433,51853,Stéphane Munoz,101557,-75023,2022-02-13
CASH_OUT,23195,Philippe Philippe,51853,28658,Agence_moov_Abomey,300000,276805,2022-02-16
CASH_IN,214339,Agence_moov_Cotonou,300000,85661,Philippe Philippe,28658,242997,2022-02-22
CASH_OUT,136859,Philippe Philippe,242997,106138,Agence_moov_Abomey,300000,163141,2022-02-23
CASH_IN,16361,Agence_moov_Ouidah,300000,283639,Philippe Philippe,106138,122499,2022-02-26
CASH_OUT,103103,Philippe Philippe,122499,19396,Agence_moov_Ouidah,300000,196897,2022-02-27
TRANSFER,56788,Frédérique Fernandes du Bouchet,83031,26243,Frédérique Fernandes du Bouchet,83031,139819,2022-02-01
CASH_OUT,23062,Frédérique Fernandes du Bouchet,26243,3181,Agence_moov_Abomey,300000,276938,2022-02-02
TRANSFER,2962,Frédérique Fernandes du Bouchet,3181,219,Michel Bouchet,12550,9588,2022-02-03
CASH_IN,293762,Agence_moov_Ouidah,300000,6238,Frédérique Fernandes du Bouchet,219,293981,2022-02-04
CASH_OUT,82784,Frédérique Fernandes du Bouchet,293981,211197,Agence_moov_Ouidah,300000,217216,2022-02-06
TRANSFER,290218,Richard Michel,576173,285955,Frédérique Fernandes du Bouchet,211197,501415,2022-02-07
CASH_OUT,86656,Frédérique Fernandes du Bouchet,501415,414759,Agence_moov_Abomey,300000,213344,2022-02-07
CASH_OUT,193108,Frédérique Fernandes du Bouchet,414759,221651,Agence_moov_Cotonou,300000,106892,2022-02-09
CASH_IN,229315,Agence_moov_Cotonou,300000,70685,Frédérique Fernandes du Bouchet,221651,450966,2022-02-09
CASH_OUT,370363,Frédérique Fernandes du Bouchet,450966,80603,Agence_moov_Cotonou,300000,-70363,2022-02-10
TRANSFER,43710,Frédérique Fernandes du Bouchet,80603,36893,Frédérique Fernandes du Bouchet,80603,36893,2022-02-11
TRANSFER,14790,Frédérique Fernandes du Bouchet,36893,22103,Frédérique Fernandes du Bouchet,36893,51683,2022-02-14
TRANSFER,5033,Frédérique Fernandes du Bouchet,22103,17070,André Renault,127137,122104,2022-02-18
CASH_OUT,9419,Frédérique Fernandes du Bouchet,17070,7651,Agence_moov_Cotonou,300000,290581,2022-02-19
CASH_OUT,1571,Frédérique Fernandes du Bouchet,7651,6080,Agence_moov_Abomey,300000,298429,2022-02-19
TRANSFER,746,Frédérique Fernandes du Bouchet,6080,5334,Tristan Delahaye,1223903,1223157,2022-02-22
CASH_IN,189482,Agence_moov_Ouidah,300000,110518,Frédérique Fernandes du Bouchet,5334,194816,2022-02-23
CASH_OUT,21470,Frédérique Fernandes du Bouchet,194816,173346,Agence_moov_Abomey,300000,278530,2022-02-25
CASH_IN,4528,Agence_moov_Cotonou,300000,295472,Frédérique Fernandes du Bouchet,173346,177874,2022-02-27
TRANSFER,193254,Robert-Louis Gosselin,278416,85162,Frédérique Fernandes du Bouchet,177874,371128,2022-02-27
CASH_OUT,56652,Véronique Martins de Fleury,59075,2423,Agence_moov_Ouidah,300000,243348,2022-02-09
TRANSFER,437,Véronique Martins de Fleury,2423,1986,Robert-Louis Gosselin,85162,84725,2022-02-12
TRANSFER,5565,Robert-Louis Gosselin,84725,79160,Véronique Martins de Fleury,1986,7551,2022-02-13
CASH_IN,145388,Agence_moov_Abomey,300000,154612,Véronique Martins de Fleury,7551,152939,2022-02-20
TRANSFER,96622,Véronique Martins de Fleury,152939,56317,Maggie Martinez,203592,106970,2022-02-25
CASH_IN,74249,Agence_moov_Abomey,300000,225751,Véronique Martins de Fleury,56317,130566,2022-02-26
TRANSFER,57522,Manon Valette,148651,91129,Véronique Martins de Fleury,130566,188088,2022-02-26
CASH_OUT,75793,Raymond Lévy,339169,263376,Agence_moov_Cotonou,300000,224207,2022-02-01
TRANSFER,105240,Raymond Lévy,263376,158136,Maggie Martinez,106970,1730,2022-02-02
CASH_IN,222135,Agence_moov_Abomey,300000,77865,Raymond Lévy,158136,380271,2022-02-02
TRANSFER,346449,Raymond Lévy,380271,33822,Richard Michel,285955,-60494,2022-02-03
CASH_OUT,19760,Raymond Lévy,33822,14062,Agence_moov_Cotonou,300000,280240,2022-02-04
CASH_OUT,13746,Raymond Lévy,14062,316,Agence_moov_Ouidah,300000,286254,2022-02-06
CASH_IN,32974,Agence_moov_Cotonou,300000,267026,Raymond Lévy,316,33290,2022-02-08
TRANSFER,1186,Raymond Lévy,33290,32104,Bertrand Regnier,11126,9940,2022-02-10
CASH_OUT,10484,Raymond Lévy,32104,21620,Agence_moov_Abomey,300000,289516,2022-02-10
CASH_OUT,9381,Raymond Lévy,21620,12239,Agence_moov_Abomey,300000,290619,2022-02-11
CASH_OUT,12003,Raymond Lévy,12239,236,Agence_moov_Ouidah,300000,287997,2022-02-11
CASH_OUT,104,Raymond Lévy,236,132,Agence_moov_Abomey,300000,299896,2022-02-13
TRANSFER,107,Raymond Lévy,132,25,Manon Valette,91129,91022,2022-02-14
CASH_IN,280775,Agence_moov_Ouidah,300000,19225,Raymond Lévy,25,280800,2022-02-18
CASH_IN,61252,Agence_moov_Ouidah,300000,238748,Raymond Lévy,280800,342052,2022-02-18
CASH_OUT,191989,Raymond Lévy,342052,150063,Agence_moov_Ouidah,300000,108011,2022-02-19
CASH_IN,41000,Agence_moov_Abomey,300000,259000,Raymond Lévy,150063,191063,2022-02-20
CASH_IN,3742,Agence_moov_Ouidah,300000,296258,Raymond Lévy,191063,194805,2022-02-23
CASH_IN,172824,Agence_moov_Abomey,300000,127176,Raymond Lévy,194805,367629,2022-02-24
CASH_IN,173542,Agence_moov_Abomey,300000,126458,André Renault,122104,295646,2022-02-01
CASH_IN,67184,Agence_moov_Ouidah,300000,232816,André Renault,295646,362830,2022-02-01
TRANSFER,48328,Manon Valette,91022,42694,André Renault,362830,411158,2022-02-03
CASH_IN,30660,Agence_moov_Abomey,300000,269340,André Renault,411158,441818,2022-02-04
TRANSFER,47036,André Renault,441818,394782,Manon Chevalier,7391,-39645,2022-02-08
CASH_IN,108401,Agence_moov_Ouidah,300000,191599,André Renault,394782,503183,2022-02-11
TRANSFER,343982,André Renault,503183,159201,Manon Valette,42694,-301288,2022-02-11
TRANSFER,62743,Tristan Delahaye,1223157,1160414,André Renault,159201,221944,2022-02-13
CASH_OUT,59935,André Renault,221944,162009,Agence_moov_Ouidah,300000,240065,2022-02-15
TRANSFER,30018,André Renault,162009,131991,Robert-Louis Gosselin,79160,49142,2022-02-15
TRANSFER,29279,André Renault,131991,102712,Maggie Martinez,1730,-27549,2022-02-15
CASH_IN,296328,Agence_moov_Ouidah,300000,3672,André Renault,102712,399040,2022-02-16
CASH_OUT,150989,André Renault,399040,248051,Agence_moov_Ouidah,300000,149011,2022-02-19
CASH_OUT,50266,André Renault,248051,197785,Agence_moov_Abomey,300000,249734,2022-02-20
CASH_OUT,51641,André Renault,197785,146144,Agence_moov_Ouidah,300000,248359,2022-02-21
CASH_OUT,87497,André Renault,146144,58647,Agence_moov_Cotonou,300000,212503,2022-02-26
CASH_OUT,47035,André Renault,58647,11612,Agence_moov_Ouidah,300000,252965,2022-02-26
CASH_OUT,25474,Mathilde Picard du Delmas,88628,63154,Agence_moov_Cotonou,300000,274526,2022-02-02
CASH_IN,164268,Agence_moov_Ouidah,300000,135732,Mathilde Picard du Delmas,63154,227422,2022-02-03
TRANSFER,92742,Mathilde Picard du Delmas,227422,134680,Robert-Louis Gosselin,49142,-43600,2022-02-03
CASH_OUT,2901,Mathilde Picard du Delmas,134680,131779,Agence_moov_Abomey,300000,297099,2022-02-04
CASH_IN,268755,Agence_moov_Abomey,300000,31245,Mathilde Picard du Delmas,131779,400534,2022-02-07
TRANSFER,135843,Mathilde Picard du Delmas,400534,264691,Mathilde Picard du Delmas,400534,536377,2022-02-07
TRANSFER,1237,Bertrand Regnier,9940,8703,Mathilde Picard du Delmas,264691,265928,2022-02-08
TRANSFER,1893,Bertrand Regnier,8703,6810,Mathilde Picard du Delmas,265928,267821,2022-02-10
CASH_IN,287778,Agence_moov_Cotonou,300000,12222,Mathilde Picard du Delmas,267821,555599,2022-02-11
CASH_IN,183479,Agence_moov_Cotonou,300000,116521,Mathilde Picard du Delmas,555599,739078,2022-02-16
TRANSFER,3609,Bertrand Regnier,6810,3201,Mathilde Picard du Delmas,739078,742687,2022-02-18
CASH_OUT,465112,Mathilde Picard du Delmas,742687,277575,Agence_moov_Ouidah,300000,-165112,2022-02-20
CASH_IN,225276,Agence_moov_Abomey,300000,74724,Mathilde Picard du Delmas,277575,502851,2022-02-24
TRANSFER,102083,Mathilde Picard du Delmas,502851,400768,Bertrand Regnier,3201,-98882,2022-02-26
CASH_IN,29494,Agence_moov_Abomey,300000,270506,Émilie du Allain,-278606,-249112,2022-02-01
CASH_IN,50636,Agence_moov_Abomey,300000,249364,Émilie du Allain,-249112,-198476,2022-02-02
CASH_IN,236491,Agence_moov_Cotonou,300000,63509,Émilie du Allain,-198476,38015,2022-02-02
CASH_OUT,24135,Émilie du Allain,38015,13880,Agence_moov_Abomey,300000,275865,2022-02-03
CASH_OUT,6640,Émilie du Allain,13880,7240,Agence_moov_Ouidah,300000,293360,2022-02-09
TRANSFER,552,Émilie du Allain,7240,6688,Émilie du Allain,7240,6688,2022-02-10
CASH_IN,54816,Agence_moov_Cotonou,300000,245184,Émilie du Allain,6688,61504,2022-02-11
CASH_OUT,46627,Émilie du Allain,61504,14877,Agence_moov_Ouidah,300000,253373,2022-02-15
CASH_IN,132457,Agence_moov_Ouidah,300000,167543,Émilie du Allain,14877,147334,2022-02-15
TRANSFER,79345,Émilie du Allain,147334,67989,Émilie du Allain,147334,226679,2022-02-17
CASH_IN,76843,Agence_moov_Abomey,300000,223157,Émilie du Allain,67989,144832,2022-02-19
CASH_OUT,6901,Émilie du Allain,144832,137931,Agence_moov_Ouidah,300000,293099,2022-02-20
CASH_OUT,137382,Émilie du Allain,137931,549,Agence_moov_Cotonou,300000,162618,2022-02-22
CASH_IN,281898,Agence_moov_Abomey,300000,18102,Émilie du Allain,549,282447,2022-02-24
CASH_OUT,205676,Émilie du Allain,282447,76771,Agence_moov_Ouidah,300000,94324,2022-02-24
TRANSFER,958436,Tristan Delahaye,1160414,201978,Émilie du Allain,76771,1035207,2022-02-24
CASH_IN,132430,Agence_moov_Abomey,300000,167570,Marcelle-Valentine Guibert,-159973,-27543,2022-02-01
CASH_IN,197825,Agence_moov_Cotonou,300000,102175,Marcelle-Valentine Guibert,-27543,170282,2022-02-05
CASH_OUT,10328,Marcelle-Valentine Guibert,170282,159954,Agence_moov_Abomey,300000,289672,2022-02-11
CASH_IN,137528,Agence_moov_Ouidah,300000,162472,Marcelle-Valentine Guibert,159954,297482,2022-02-12
CASH_OUT,80349,Marcelle-Valentine Guibert,297482,217133,Agence_moov_Cotonou,300000,219651,2022-02-13
TRANSFER,23918,Tristan Delahaye,201978,178060,Marcelle-Valentine Guibert,217133,241051,2022-02-13
CASH_IN,123201,Agence_moov_Cotonou,300000,176799,Marcelle-Valentine Guibert,241051,364252,2022-02-16
CASH_OUT,175956,Marcelle-Valentine Guibert,364252,188296,Agence_moov_Ouidah,300000,124044,2022-02-17
CASH_OUT,20341,Marcelle-Valentine Guibert,188296,167955,Agence_moov_Cotonou,300000,279659,2022-02-23
CASH_OUT,40495,Marcelle-Valentine Guibert,167955,127460,Agence_moov_Cotonou,300000,259505,2022-02-24
CASH_IN,212788,Agence_moov_Ouidah,300000,87212,Colette Merle Le Robert,-96021,116767,2022-02-01
CASH_OUT,51489,Colette Merle Le Robert,116767,65278,Agence_moov_Abomey,300000,248511,2022-02-04
CASH_OUT,38627,Colette Merle Le Robert,65278,26651,Agence_moov_Abomey,300000,261373,2022-02-04
CASH_IN,76956,Agence_moov_Ouidah,300000,223044,Colette Merle Le Robert,26651,103607,2022-02-11
CASH_OUT,82488,Colette Merle Le Robert,103607,21119,Agence_moov_Abomey,300000,217512,2022-02-12
CASH_OUT,6843,Colette Merle Le Robert,21119,14276,Agence_moov_Cotonou,300000,293157,2022-02-13
TRANSFER,4070,Colette Merle Le Robert,14276,10206,Tristan Delahaye,178060,173990,2022-02-14
CASH_OUT,733,Colette Merle Le Robert,10206,9473,Agence_moov_Ouidah,300000,299267,2022-02-14
CASH_IN,180269,Agence_moov_Cotonou,300000,119731,Colette Merle Le Robert,9473,189742,2022-02-16
CASH_IN,202883,Agence_moov_Ouidah,300000,97117,Colette Merle Le Robert,189742,392625,2022-02-18
CASH_IN,144901,Agence_moov_Ouidah,300000,155099,Colette Merle Le Robert,392625,537526,2022-02-19
CASH_OUT,129887,Colette Merle Le Robert,537526,407639,Agence_moov_Abomey,300000,170113,2022-02-19
CASH_IN,32022,Agence_moov_Abomey,300000,267978,Colette Merle Le Robert,407639,439661,2022-02-21
CASH_IN,169660,Agence_moov_Ouidah,300000,130340,Colette Merle Le Robert,439661,609321,2022-02-26
CASH_IN,109262,Agence_moov_Ouidah,300000,190738,Antoinette de Dupuis,-98175,11087,2022-02-03
TRANSFER,8911,Antoinette de Dupuis,11087,2176,Antoinette de Dupuis,11087,2176,2022-02-03
CASH_OUT,1378,Antoinette de Dupuis,2176,798,Agence_moov_Ouidah,300000,298622,2022-02-03
CASH_IN,182254,Agence_moov_Ouidah,300000,117746,Antoinette de Dupuis,798,183052,2022-02-04
CASH_OUT,141673,Antoinette de Dupuis,183052,41379,Agence_moov_Cotonou,300000,158327,2022-02-05
CASH_OUT,35572,Antoinette de Dupuis,41379,5807,Agence_moov_Cotonou,300000,264428,2022-02-07
CASH_IN,192086,Agence_moov_Cotonou,300000,107914,Antoinette de Dupuis,5807,197893,2022-02-10
CASH_OUT,116634,Antoinette de Dupuis,197893,81259,Agence_moov_Abomey,300000,183366,2022-02-11
TRANSFER,77742,Antoinette de Dupuis,81259,3517,Antoinette de Dupuis,81259,159001,2022-02-12
TRANSFER,522,Antoinette de Dupuis,3517,2995,Antoinette de Dupuis,3517,2995,2022-02-13
CASH_IN,204932,Agence_moov_Cotonou,300000,95068,Antoinette de Dupuis,2995,207927,2022-02-18
CASH_IN,98177,Agence_moov_Abomey,300000,201823,Antoinette de Dupuis,207927,306104,2022-02-18
CASH_IN,136803,Agence_moov_Cotonou,300000,163197,Paul Perez,-106524,30279,2022-02-07
CASH_OUT,23823,Paul Perez,30279,6456,Agence_moov_Cotonou,300000,276177,2022-02-07
CASH_IN,186436,Agence_moov_Ouidah,300000,113564,Paul Perez,6456,192892,2022-02-08
CASH_IN,235247,Agence_moov_Abomey,300000,64753,Paul Perez,192892,428139,2022-02-10
CASH_IN,147830,Agence_moov_Abomey,300000,152170,Paul Perez,428139,575969,2022-02-10
TRANSFER,343766,Paul Perez,575969,232203,Paul Perez,575969,919735,2022-02-13
TRANSFER,145824,Paul Perez,232203,86379,Paul Perez,232203,86379,2022-02-13
CASH_OUT,71445,Paul Perez,86379,14934,Agence_moov_Abomey,300000,228555,2022-02-14
CASH_OUT,10957,Paul Perez,14934,3977,Agence_moov_Abomey,300000,289043,2022-02-15
TRANSFER,3394,Paul Perez,3977,583,Paul Perez,3977,7371,2022-02-16
CASH_IN,29076,Agence_moov_Cotonou,300000,270924,Paul Perez,583,29659,2022-02-20
TRANSFER,19659,Paul Perez,29659,10000,Paul Perez,29659,49318,2022-02-20
CASH_OUT,8057,Paul Perez,10000,1943,Agence_moov_Abomey,300000,291943,2022-02-21
TRANSFER,1111,Paul Perez,1943,832,Paul Perez,1943,3054,2022-02-22
CASH_OUT,530,Paul Perez,832,302,Agence_moov_Cotonou,300000,299470,2022-02-25
CASH_OUT,204,Paul Perez,302,98,Agence_moov_Cotonou,300000,299796,2022-02-26
CASH_IN,188019,Agence_moov_Cotonou,300000,111981,Paul Perez,98,188117,2022-02-26
CASH_IN,270152,Agence_moov_Cotonou,300000,29848,Alphonse Joly,-77587,192565,2022-02-01
CASH_OUT,122677,Alphonse Joly,192565,69888,Agence_moov_Cotonou,300000,177323,2022-02-04
TRANSFER,50678,Alphonse Joly,69888,19210,Alphonse Joly,69888,19210,2022-02-05
TRANSFER,7303,Alphonse Joly,19210,11907,Alphonse Joly,19210,26513,2022-02-09
CASH_OUT,966,Alphonse Joly,11907,10941,Agence_moov_Cotonou,300000,299034,2022-02-14
CASH_IN,206707,Agence_moov_Abomey,300000,93293,Alphonse Joly,10941,217648,2022-02-14
CASH_OUT,116158,Alphonse Joly,217648,101490,Agence_moov_Abomey,300000,183842,2022-02-15
TRANSFER,96037,Alphonse Joly,101490,5453,Alphonse Joly,101490,197527,2022-02-16
CASH_OUT,2652,Alphonse Joly,5453,2801,Agence_moov_Cotonou,300000,297348,2022-02-16
CASH_IN,174325,Agence_moov_Cotonou,300000,125675,Alphonse Joly,2801,177126,2022-02-25
CASH_IN,46644,Agence_moov_Ouidah,300000,253356,Alphonse Joly,177126,223770,2022-02-26
CASH_IN,83012,Agence_moov_Cotonou,300000,216988,Léon Da Costa,-759668,-676656,2022-02-01
CASH_IN,5972,Agence_moov_Abomey,300000,294028,Léon Da Costa,-676656,-670684,2022-02-01
CASH_IN,108009,Agence_moov_Abomey,300000,191991,Léon Da Costa,-670684,-562675,2022-02-03
CASH_IN,3792,Agence_moov_Cotonou,300000,296208,Léon Da Costa,-562675,-558883,2022-02-03
CASH_IN,150962,Agence_moov_Ouidah,300000,149038,Léon Da Costa,-558883,-407921,2022-02-03
CASH_IN,115903,Agence_moov_Ouidah,300000,184097,Léon Da Costa,-407921,-292018,2022-02-04
CASH_IN,8114,Agence_moov_Abomey,300000,291886,Léon Da Costa,-292018,-283904,2022-02-08
CASH_IN,94255,Agence_moov_Ouidah,300000,205745,Léon Da Costa,-283904,-189649,2022-02-10
CASH_IN,109231,Agence_moov_Abomey,300000,190769,Léon Da Costa,-189649,-80418,2022-02-14
CASH_IN,228156,Agence_moov_Cotonou,300000,71844,Léon Da Costa,-80418,147738,2022-02-16
TRANSFER,67689,Léon Da Costa,147738,80049,Léon Da Costa,147738,215427,2022-02-18
CASH_IN,226060,Agence_moov_Ouidah,300000,73940,Léon Da Costa,80049,306109,2022-02-22
CASH_OUT,197680,Léon Da Costa,306109,108429,Agence_moov_Abomey,300000,102320,2022-02-24
CASH_IN,61860,Agence_moov_Cotonou,300000,238140,Léon Da Costa,108429,170289,2022-02-26
CASH_IN,48508,Agence_moov_Ouidah,300000,251492,Marthe Gilles,-1005261,-956753,2022-02-04
CASH_IN,109547,Agence_moov_Ouidah,300000,190453,Marthe Gilles,-956753,-847206,2022-02-09
CASH_IN,256517,Agence_moov_Ouidah,300000,43483,Marthe Gilles,-847206,-590689,2022-02-12
CASH_IN,81275,Agence_moov_Ouidah,300000,218725,Marthe Gilles,-590689,-509414,2022-02-12
CASH_IN,220317,Agence_moov_Ouidah,300000,79683,Marthe Gilles,-509414,-289097,2022-02-12
CASH_IN,182311,Agence_moov_Ouidah,300000,117689,Marthe Gilles,-289097,-106786,2022-02-13
CASH_IN,151231,Agence_moov_Cotonou,300000,148769,Marthe Gilles,-106786,44445,2022-02-13
TRANSFER,38549,Marthe Gilles,44445,5896,Marthe Gilles,44445,5896,2022-02-14
TRANSFER,2251,Marthe Gilles,5896,3645,Marthe Gilles,5896,8147,2022-02-14
CASH_OUT,3278,Marthe Gilles,3645,367,Agence_moov_Ouidah,300000,296722,2022-02-16
CASH_OUT,264,Marthe Gilles,367,103,Agence_moov_Ouidah,300000,299736,2022-02-17
TRANSFER,101,Marthe Gilles,103,2,Marthe Gilles,103,204,2022-02-17
CASH_IN,43019,Agence_moov_Cotonou,300000,256981,Marthe Gilles,2,43021,2022-02-20
CASH_OUT,7035,Marthe Gilles,43021,35986,Agence_moov_Cotonou,300000,292965,2022-02-21
CASH_IN,196494,Agence_moov_Abomey,300000,103506,Marthe Gilles,35986,232480,2022-02-21
CASH_OUT,189336,Marthe Gilles,232480,43144,Agence_moov_Ouidah,300000,110664,2022-02-23
CASH_OUT,15879,Marthe Gilles,43144,27265,Agence_moov_Cotonou,300000,284121,2022-02-25
CASH_OUT,6060,Marthe Gilles,27265,21205,Agence_moov_Cotonou,300000,293940,2022-02-25
CASH_IN,115468,Agence_moov_Cotonou,300000,184532,Marthe Gilles,21205,136673,2022-02-26
CASH_IN,225302,Agence_moov_Cotonou,300000,74698,Bertrand Regnier,-98882,126420,2022-02-02
CASH_OUT,85839,Bertrand Regnier,126420,40581,Agence_moov_Cotonou,300000,214161,2022-02-02
TRANSFER,4566,Bertrand Regnier,40581,36015,Bertrand Regnier,40581,36015,2022-02-06
TRANSFER,5872,Bertrand Regnier,36015,30143,Bertrand Regnier,36015,30143,2022-02-10
TRANSFER,26641,Bertrand Regnier,30143,3502,Bertrand Regnier,30143,3502,2022-02-11
CASH_IN,69722,Agence_moov_Cotonou,300000,230278,Bertrand Regnier,3502,73224,2022-02-12
CASH_IN,60011,Agence_moov_Ouidah,300000,239989,Bertrand Regnier,73224,133235,2022-02-15
CASH_IN,171916,Agence_moov_Ouidah,300000,128084,Bertrand Regnier,133235,305151,2022-02-15
CASH_IN,11675,Agence_moov_Abomey,300000,288325,Bertrand Regnier,305151,316826,2022-02-16
CASH_IN,100294,Agence_moov_Abomey,300000,199706,Bertrand Regnier,316826,417120,2022-02-20
CASH_OUT,236960,Bertrand Regnier,417120,180160,Agence_moov_Ouidah,300000,63040,2022-02-25
CASH_IN,148122,Agence_moov_Ouidah,300000,151878,Bertrand Regnier,180160,328282,2022-02-25
CASH_IN,169909,Agence_moov_Ouidah,300000,130091,Thomas Guichard du Renault,-808350,-638441,2022-02-02
CASH_IN,235616,Agence_moov_Abomey,300000,64384,Thomas Guichard du Renault,-638441,-402825,2022-02-06
CASH_IN,35976,Agence_moov_Ouidah,300000,264024,Thomas Guichard du Renault,-402825,-366849,2022-02-08
CASH_IN,158068,Agence_moov_Cotonou,300000,141932,Thomas Guichard du Renault,-366849,-208781,2022-02-10
CASH_IN,56293,Agence_moov_Abomey,300000,243707,Thomas Guichard du Renault,-208781,-152488,2022-02-14
CASH_IN,68550,Agence_moov_Cotonou,300000,231450,Thomas Guichard du Renault,-152488,-83938,2022-02-14
CASH_IN,87299,Agence_moov_Ouidah,300000,212701,Thomas Guichard du Renault,-83938,3361,2022-02-16
TRANSFER,1475,Thomas Guichard du Renault,3361,1886,Thomas Guichard du Renault,3361,4836,2022-02-16
CASH_IN,155308,Agence_moov_Cotonou,300000,144692,Thomas Guichard du Renault,1886,157194,2022-02-17
CASH_OUT,10662,Thomas Guichard du Renault,157194,146532,Agence_moov_Abomey,300000,289338,2022-02-17
CASH_OUT,120855,Thomas Guichard du Renault,146532,25677,Agence_moov_Cotonou,300000,179145,2022-02-17
CASH_OUT,7447,Thomas Guichard du Renault,25677,18230,Agence_moov_Abomey,300000,292553,2022-02-24
CASH_OUT,10188,Thomas Guichard du Renault,18230,8042,Agence_moov_Abomey,300000,289812,2022-02-25
CASH_IN,18567,Agence_moov_Ouidah,300000,281433,Robert-Louis Gosselin,-43600,-25033,2022-02-06
CASH_IN,83179,Agence_moov_Cotonou,300000,216821,Robert-Louis Gosselin,-25033,58146,2022-02-10
CASH_OUT,8135,Robert-Louis Gosselin,58146,50011,Agence_moov_Cotonou,300000,291865,2022-02-12
TRANSFER,30914,Robert-Louis Gosselin,50011,19097,Robert-Louis Gosselin,50011,80925,2022-02-15
TRANSFER,3140,Robert-Louis Gosselin,19097,15957,Robert-Louis Gosselin,19097,22237,2022-02-15
CASH_OUT,9512,Robert-Louis Gosselin,15957,6445,Agence_moov_Ouidah,300000,290488,2022-02-15
CASH_OUT,3109,Robert-Louis Gosselin,6445,3336,Agence_moov_Abomey,300000,296891,2022-02-20
CASH_OUT,860,Robert-Louis Gosselin,3336,2476,Agence_moov_Ouidah,300000,299140,2022-02-20
CASH_IN,10046,Agence_moov_Ouidah,300000,289954,Robert-Louis Gosselin,2476,12522,2022-02-23
CASH_IN,237433,Agence_moov_Ouidah,300000,62567,Robert-Louis Gosselin,12522,249955,2022-02-23
CASH_IN,87590,Agence_moov_Ouidah,300000,212410,Robert-Louis Gosselin,249955,337545,2022-02-24
CASH_IN,254738,Agence_moov_Ouidah,300000,45262,Robert-Louis Gosselin,337545,592283,2022-02-27
CASH_IN,121125,Agence_moov_Abomey,300000,178875,Emmanuel Grégoire,-66000,55125,2022-02-01
CASH_IN,185322,Agence_moov_Ouidah,300000,114678,Emmanuel Grégoire,55125,240447,2022-02-04
CASH_OUT,71991,Emmanuel Grégoire,240447,168456,Agence_moov_Abomey,300000,228009,2022-02-04
TRANSFER,139605,Emmanuel Grégoire,168456,28851,Emmanuel Grégoire,168456,28851,2022-02-05
CASH_OUT,4701,Emmanuel Grégoire,28851,24150,Agence_moov_Abomey,300000,295299,2022-02-06
TRANSFER,11923,Emmanuel Grégoire,24150,12227,Emmanuel Grégoire,24150,12227,2022-02-06
CASH_IN,222507,Agence_moov_Ouidah,300000,77493,Emmanuel Grégoire,12227,234734,2022-02-08
CASH_OUT,4027,Emmanuel Grégoire,234734,230707,Agence_moov_Cotonou,300000,295973,2022-02-09
TRANSFER,102719,Emmanuel Grégoire,230707,127988,Emmanuel Grégoire,230707,127988,2022-02-11
CASH_IN,126685,Agence_moov_Cotonou,300000,173315,Emmanuel Grégoire,127988,254673,2022-02-12
CASH_OUT,141196,Emmanuel Grégoire,254673,113477,Agence_moov_Cotonou,300000,158804,2022-02-12
CASH_IN,215674,Agence_moov_Ouidah,300000,84326,Emmanuel Grégoire,113477,329151,2022-02-14
CASH_IN,281477,Agence_moov_Abomey,300000,18523,Emmanuel Grégoire,329151,610628,2022-02-18
CASH_IN,60042,Agence_moov_Abomey,300000,239958,Emmanuel Grégoire,610628,670670,2022-02-23
CASH_IN,242736,Agence_moov_Ouidah,300000,57264,Emmanuel Grégoire,670670,913406,2022-02-25
CASH_IN,231436,Agence_moov_Abomey,300000,68564,Emmanuel Grégoire,913406,1144842,2022-02-27
CASH_IN,198590,Agence_moov_Ouidah,300000,101410,Hélène Le Chauvin,-457108,-258518,2022-02-02
CASH_IN,228212,Agence_moov_Ouidah,300000,71788,Hélène Le Chauvin,-258518,-30306,2022-02-03
CASH_IN,107274,Agence_moov_Ouidah,300000,192726,Hélène Le Chauvin,-30306,76968,2022-02-06
CASH_OUT,24059,Hélène Le Chauvin,76968,52909,Agence_moov_Cotonou,300000,275941,2022-02-10
TRANSFER,42125,Hélène Le Chauvin,52909,10784,Hélène Le Chauvin,52909,10784,2022-02-16
CASH_IN,16202,Agence_moov_Ouidah,300000,283798,Hélène Le Chauvin,10784,26986,2022-02-25
CASH_OUT,18569,Hélène Le Chauvin,26986,8417,Agence_moov_Cotonou,300000,281431,2022-02-25
CASH_IN,111597,Agence_moov_Abomey,300000,188403,Lucy Lamy,-200020,-88423,2022-02-05
CASH_IN,32914,Agence_moov_Cotonou,300000,267086,Lucy Lamy,-88423,-55509,2022-02-17
CASH_IN,81280,Agence_moov_Abomey,300000,218720,Lucy Lamy,-55509,25771,2022-02-20
CASH_OUT,22630,Lucy Lamy,25771,3141,Agence_moov_Cotonou,300000,277370,2022-02-22
CASH_OUT,2474,Lucy Lamy,3141,667,Agence_moov_Cotonou,300000,297526,2022-02-23
CASH_OUT,431,Lucy Lamy,667,236,Agence_moov_Ouidah,300000,299569,2022-02-26
CASH_IN,207897,Agence_moov_Ouidah,300000,92103,Camille Prévost,-241302,-33405,2022-02-05
CASH_IN,241401,Agence_moov_Abomey,300000,58599,Camille Prévost,-33405,207996,2022-02-10
CASH_IN,10918,Agence_moov_Ouidah,300000,289082,Camille Prévost,207996,218914,2022-02-15
CASH_OUT,179528,Camille Prévost,218914,39386,Agence_moov_Abomey,300000,120472,2022-02-18
CASH_OUT,33827,Camille Prévost,39386,5559,Agence_moov_Cotonou,300000,266173,2022-02-18
CASH_IN,44967,Agence_moov_Abomey,300000,255033,Audrey Julien de Leleu,-581916,-536949,2022-02-10
CASH_IN,15566,Agence_moov_Cotonou,300000,284434,Audrey Julien de Leleu,-536949,-521383,2022-02-11
CASH_IN,114328,Agence_moov_Cotonou,300000,185672,Audrey Julien de Leleu,-521383,-407055,2022-02-11
CASH_IN,227497,Agence_moov_Ouidah,300000,72503,Audrey Julien de Leleu,-407055,-179558,2022-02-12
CASH_IN,128100,Agence_moov_Cotonou,300000,171900,Audrey Julien de Leleu,-179558,-51458,2022-02-13
CASH_IN,178381,Agence_moov_Abomey,300000,121619,Audrey Julien de Leleu,-51458,126923,2022-02-15
CASH_IN,98875,Agence_moov_Abomey,300000,201125,Audrey Julien de Leleu,126923,225798,2022-02-16
CASH_IN,33143,Agence_moov_Ouidah,300000,266857,Noël Bourgeois,-4367,28776,2022-02-02
CASH_IN,182041,Agence_moov_Ouidah,300000,117959,Noël Bourgeois,28776,210817,2022-02-03
TRANSFER,127849,Noël Bourgeois,210817,82968,Noël Bourgeois,210817,82968,2022-02-05
CASH_OUT,63979,Noël Bourgeois,82968,18989,Agence_moov_Ouidah,300000,236021,2022-02-06
CASH_OUT,157,Noël Bourgeois,18989,18832,Agence_moov_Ouidah,300000,299843,2022-02-07
TRANSFER,14956,Noël Bourgeois,18832,3876,Noël Bourgeois,18832,33788,2022-02-08
CASH_IN,129265,Agence_moov_Cotonou,300000,170735,Noël Bourgeois,3876,133141,2022-02-14
CASH_IN,101543,Agence_moov_Cotonou,300000,198457,Noël Bourgeois,133141,234684,2022-02-14
TRANSFER,226393,Noël Bourgeois,234684,8291,Noël Bourgeois,234684,461077,2022-02-16
CASH_OUT,7529,Noël Bourgeois,8291,762,Agence_moov_Ouidah,300000,292471,2022-02-18
CASH_OUT,491,Noël Bourgeois,762,271,Agence_moov_Abomey,300000,299509,2022-02-19
CASH_OUT,228,Noël Bourgeois,271,43,Agence_moov_Abomey,300000,299772,2022-02-19
CASH_IN,272917,Agence_moov_Cotonou,300000,27083,Noël Bourgeois,43,272960,2022-02-20
CASH_OUT,23443,Noël Bourgeois,272960,249517,Agence_moov_Ouidah,300000,276557,2022-02-24
CASH_OUT,221375,Noël Bourgeois,249517,28142,Agence_moov_Abomey,300000,78625,2022-02-26
CASH_IN,169686,Agence_moov_Cotonou,300000,130314,Anastasie Cousin,66,169752,2022-02-03
CASH_OUT,41767,Anastasie Cousin,169752,127985,Agence_moov_Abomey,300000,258233,2022-02-07
TRANSFER,91359,Anastasie Cousin,127985,36626,Anastasie Cousin,127985,219344,2022-02-07
CASH_OUT,34712,Anastasie Cousin,36626,1914,Agence_moov_Abomey,300000,265288,2022-02-08
CASH_OUT,1087,Anastasie Cousin,1914,827,Agence_moov_Ouidah,300000,298913,2022-02-20
CASH_IN,295012,Agence_moov_Abomey,300000,4988,Anastasie Cousin,827,295839,2022-02-20
CASH_OUT,214878,Anastasie Cousin,295839,80961,Agence_moov_Cotonou,300000,85122,2022-02-21
CASH_OUT,17666,Anastasie Cousin,80961,63295,Agence_moov_Ouidah,300000,282334,2022-02-27
CASH_OUT,58959,Anastasie Cousin,63295,4336,Agence_moov_Abomey,300000,241041,2022-02-27
CASH_OUT,2076,Anastasie Cousin,4336,2260,Agence_moov_Cotonou,300000,297924,2022-02-27
CASH_IN,188647,Agence_moov_Cotonou,300000,111353,Jules Fernandes,-44860,143787,2022-02-02
CASH_IN,36270,Agence_moov_Ouidah,300000,263730,Jules Fernandes,143787,180057,2022-02-04
CASH_IN,160888,Agence_moov_Cotonou,300000,139112,Jules Fernandes,180057,340945,2022-02-05
TRANSFER,221533,Jules Fernandes,340945,119412,Jules Fernandes,340945,562478,2022-02-10
TRANSFER,80168,Jules Fernandes,119412,39244,Jules Fernandes,119412,39244,2022-02-11
CASH_OUT,523,Jules Fernandes,39244,38721,Agence_moov_Ouidah,300000,299477,2022-02-11
TRANSFER,19288,Jules Fernandes,38721,19433,Jules Fernandes,38721,58009,2022-02-12
CASH_OUT,17869,Jules Fernandes,19433,1564,Agence_moov_Abomey,300000,282131,2022-02-15
CASH_IN,294248,Agence_moov_Abomey,300000,5752,Jules Fernandes,1564,295812,2022-02-17
CASH_IN,225267,Agence_moov_Ouidah,300000,74733,Jules Fernandes,295812,521079,2022-02-18
CASH_IN,228453,Agence_moov_Ouidah,300000,71547,Jules Fernandes,521079,749532,2022-02-21
CASH_IN,30955,Agence_moov_Ouidah,300000,269045,Jules Fernandes,749532,780487,2022-02-25
CASH_IN,261412,Agence_moov_Abomey,300000,38588,Manon Valette,-301288,-39876,2022-02-01
CASH_IN,92152,Agence_moov_Abomey,300000,207848,Manon Valette,-39876,52276,2022-02-01
CASH_IN,264654,Agence_moov_Ouidah,300000,35346,Manon Valette,52276,316930,2022-02-02
CASH_IN,258316,Agence_moov_Ouidah,300000,41684,Manon Valette,316930,575246,2022-02-03
CASH_OUT,368437,Manon Valette,575246,206809,Agence_moov_Ouidah,300000,-68437,2022-02-08
CASH_IN,281521,Agence_moov_Abomey,300000,18479,Manon Valette,206809,488330,2022-02-20
CASH_IN,88203,Agence_moov_Ouidah,300000,211797,Manon Valette,488330,576533,2022-02-21
CASH_OUT,502593,Manon Valette,576533,73940,Agence_moov_Ouidah,300000,-202593,2022-02-22
CASH_IN,106613,Agence_moov_Ouidah,300000,193387,Manon Valette,73940,180553,2022-02-27
CASH_IN,244404,Agence_moov_Ouidah,300000,55596,Manon Valette,180553,424957,2022-02-27
CASH_IN,190154,Agence_moov_Ouidah,300000,109846,Maggie Martinez,-27549,162605,2022-02-02
CASH_IN,243156,Agence_moov_Abomey,300000,56844,Maggie Martinez,162605,405761,2022-02-03
TRANSFER,296970,Maggie Martinez,405761,108791,Maggie Martinez,405761,108791,2022-02-09
CASH_OUT,72767,Maggie Martinez,108791,36024,Agence_moov_Abomey,300000,227233,2022-02-11
CASH_IN,218216,Agence_moov_Cotonou,300000,81784,Maggie Martinez,36024,254240,2022-02-19
CASH_IN,265660,Agence_moov_Ouidah,300000,34340,Maggie Martinez,254240,519900,2022-02-21
CASH_OUT,37938,Maggie Martinez,519900,481962,Agence_moov_Ouidah,300000,262062,2022-02-23
CASH_IN,295425,Agence_moov_Abomey,300000,4575,Maggie Martinez,481962,777387,2022-02-24
CASH_IN,200178,Agence_moov_Ouidah,300000,99822,Manon Chevalier,-39645,160533,2022-02-01
CASH_IN,214136,Agence_moov_Cotonou,300000,85864,Manon Chevalier,160533,374669,2022-02-04
CASH_IN,218207,Agence_moov_Ouidah,300000,81793,Manon Chevalier,374669,592876,2022-02-05
CASH_OUT,318210,Manon Chevalier,592876,274666,Agence_moov_Abomey,300000,-18210,2022-02-05
CASH_IN,295563,Agence_moov_Abomey,300000,4437,Manon Chevalier,274666,570229,2022-02-06
CASH_IN,173493,Agence_moov_Cotonou,300000,126507,Manon Chevalier,570229,743722,2022-02-07
TRANSFER,119898,Manon Chevalier,743722,623824,Manon Chevalier,743722,623824,2022-02-10
CASH_IN,602,Agence_moov_Abomey,300000,299398,Manon Chevalier,623824,624426,2022-02-10
TRANSFER,601775,Manon Chevalier,624426,22651,Manon Chevalier,624426,1226201,2022-02-16
CASH_OUT,13352,Manon Chevalier,22651,9299,Agence_moov_Abomey,300000,286648,2022-02-20
CASH_OUT,8031,Manon Chevalier,9299,1268,Agence_moov_Abomey,300000,291969,2022-02-21
CASH_OUT,570,Manon Chevalier,1268,698,Agence_moov_Abomey,300000,299430,2022-02-26
CASH_OUT,137,Manon Chevalier,698,561,Agence_moov_Abomey,300000,299863,2022-02-26
CASH_IN,257329,Agence_moov_Abomey,300000,42671,Manon Chevalier,561,257890,2022-02-26
CASH_IN,89623,Agence_moov_Ouidah,300000,210377,Manon Chevalier,257890,347513,2022-02-27
CASH_IN,255075,Agence_moov_Abomey,300000,44925,Stéphane Munoz,-75023,180052,2022-02-02
TRANSFER,32481,Stéphane Munoz,180052,147571,Stéphane Munoz,180052,212533,2022-02-04
CASH_IN,263202,Agence_moov_Abomey,300000,36798,Stéphane Munoz,147571,410773,2022-02-08
TRANSFER,324259,Stéphane Munoz,410773,86514,Stéphane Munoz,410773,735032,2022-02-10
CASH_OUT,6000,Stéphane Munoz,86514,80514,Agence_moov_Abomey,300000,294000,2022-02-11
CASH_OUT,40094,Stéphane Munoz,80514,40420,Agence_moov_Cotonou,300000,259906,2022-02-11
CASH_OUT,6623,Stéphane Munoz,40420,33797,Agence_moov_Ouidah,300000,293377,2022-02-14
CASH_OUT,12902,Stéphane Munoz,33797,20895,Agence_moov_Ouidah,300000,287098,2022-02-17
CASH_OUT,4049,Stéphane Munoz,20895,16846,Agence_moov_Cotonou,300000,295951,2022-02-17
CASH_IN,122950,Agence_moov_Abomey,300000,177050,Stéphane Munoz,16846,139796,2022-02-24
CASH_OUT,22573,Stéphane Munoz,139796,117223,Agence_moov_Abomey,300000,277427,2022-02-25
CASH_IN,168492,Agence_moov_Abomey,300000,131508,Stéphane Munoz,117223,285715,2022-02-27
CASH_IN,31038,Agence_moov_Cotonou,300000,268962,Paul Rocher-Maillet,-395597,-364559,2022-02-02
CASH_IN,254177,Agence_moov_Cotonou,300000,45823,Paul Rocher-Maillet,-364559,-110382,2022-02-06
CASH_IN,65406,Agence_moov_Ouidah,300000,234594,Paul Rocher-Maillet,-110382,-44976,2022-02-06
CASH_IN,75533,Agence_moov_Abomey,300000,224467,Paul Rocher-Maillet,-44976,30557,2022-02-15
TRANSFER,27745,Paul Rocher-Maillet,30557,2812,Paul Rocher-Maillet,30557,2812,2022-02-17
CASH_OUT,526,Paul Rocher-Maillet,2812,2286,Agence_moov_Abomey,300000,299474,2022-02-18
TRANSFER,1014,Paul Rocher-Maillet,2286,1272,Paul Rocher-Maillet,2286,1272,2022-02-18
CASH_OUT,932,Paul Rocher-Maillet,1272,340,Agence_moov_Abomey,300000,299068,2022-02-20
CASH_IN,170086,Agence_moov_Cotonou,300000,129914,Paul Rocher-Maillet,340,170426,2022-02-20
CASH_IN,23137,Agence_moov_Ouidah,300000,276863,Paul Rocher-Maillet,170426,193563,2022-02-26
CASH_IN,130565,Agence_moov_Ouidah,300000,169435,Richard Michel,-60494,70071,2022-02-08
TRANSFER,24062,Richard Michel,70071,46009,Richard Michel,70071,94133,2022-02-11
CASH_OUT,22375,Richard Michel,46009,23634,Agence_moov_Cotonou,300000,277625,2022-02-12
CASH_IN,159539,Agence_moov_Ouidah,300000,140461,Richard Michel,23634,183173,2022-02-12
CASH_OUT,94769,Richard Michel,183173,88404,Agence_moov_Ouidah,300000,205231,2022-02-17
CASH_IN,222994,Agence_moov_Ouidah,300000,77006,Richard Michel,88404,311398,2022-02-22
CASH_IN,50658,Agence_moov_Ouidah,300000,249342,Thibaut de la Lombard,-22718,27940,2022-02-01
TRANSFER,27343,Thibaut de la Lombard,27940,597,Thibaut de la Lombard,27940,597,2022-02-03
TRANSFER,136,Thibaut de la Lombard,597,461,Thibaut de la Lombard,597,733,2022-02-05
TRANSFER,401,Thibaut de la Lombard,461,60,Thibaut de la Lombard,461,862,2022-02-06
CASH_IN,280877,Agence_moov_Cotonou,300000,19123,Thibaut de la Lombard,60,280937,2022-02-10
CASH_OUT,243014,Thibaut de la Lombard,280937,37923,Agence_moov_Ouidah,300000,56986,2022-02-13
CASH_IN,167843,Agence_moov_Abomey,300000,132157,Thibaut de la Lombard,37923,205766,2022-02-20
CASH_OUT,203654,Thibaut de la Lombard,205766,2112,Agence_moov_Cotonou,300000,96346,2022-02-21
CASH_IN,298251,Agence_moov_Ouidah,300000,1749,Thibaut de la Lombard,2112,300363,2022-02-23
CASH_IN,113940,Agence_moov_Cotonou,300000,186060,Thibaut de la Lombard,300363,414303,2022-02-26
CASH_IN,282858,Agence_moov_Abomey,300000,17142,Émile-René Baudry,-172228,110630,2022-02-03
CASH_OUT,20929,Émile-René Baudry,110630,89701,Agence_moov_Abomey,300000,279071,2022-02-05
TRANSFER,44609,Émile-René Baudry,89701,45092,Émile-René Baudry,89701,134310,2022-02-08
CASH_OUT,13135,Émile-René Baudry,45092,31957,Agence_moov_Cotonou,300000,286865,2022-02-09
CASH_IN,3499,Agence_moov_Cotonou,300000,296501,Émile-René Baudry,31957,35456,2022-02-09
CASH_IN,76893,Agence_moov_Ouidah,300000,223107,Émile-René Baudry,35456,112349,2022-02-09
CASH_IN,219652,Agence_moov_Abomey,300000,80348,Émile-René Baudry,112349,332001,2022-02-10
TRANSFER,318868,Émile-René Baudry,332001,13133,Émile-René Baudry,332001,650869,2022-02-13
CASH_OUT,6921,Émile-René Baudry,13133,6212,Agence_moov_Abomey,300000,293079,2022-02-22
CASH_IN,208676,Agence_moov_Abomey,300000,91324,Émile-René Baudry,6212,214888,2022-02-22
CASH_IN,41780,Agence_moov_Ouidah,300000,258220,Émile-René Baudry,214888,256668,2022-02-23
CASH_IN,299179,Agence_moov_Abomey,300000,821,Émile-René Baudry,256668,555847,2022-02-25
CASH_IN,54610,Agence_moov_Abomey,300000,245390,Émile-René Baudry,555847,610457,2022-02-26
CASH_IN,174863,Agence_moov_Abomey,300000,125137,Aurore Charrier,-610431,-435568,2022-02-12
CASH_IN,211001,Agence_moov_Abomey,300000,88999,Aurore Charrier,-435568,-224567,2022-02-16
CASH_IN,206992,Agence_moov_Cotonou,300000,93008,Aurore Charrier,-224567,-17575,2022-02-16
CASH_IN,64659,Agence_moov_Abomey,300000,235341,Aurore Charrier,-17575,47084,2022-02-17
CASH_OUT,15419,Aurore Charrier,47084,31665,Agence_moov_Abomey,300000,284581,2022-02-21
CASH_IN,163221,Agence_moov_Abomey,300000,136779,Aurore Charrier,31665,194886,2022-02-23
CASH_OUT,20076,Aurore Charrier,194886,174810,Agence_moov_Cotonou,300000,279924,2022-02-26
CASH_OUT,2609,Aurore Charrier,174810,172201,Agence_moov_Abomey,300000,297391,2022-02-27
CASH_OUT,16198,Matthieu-Matthieu Bigot,184100,167902,Agence_moov_Abomey,300000,283802,2022-03-02
CASH_OUT,98641,Matthieu-Matthieu Bigot,167902,69261,Agence_moov_Abomey,300000,201359,2022-03-09
CASH_IN,31253,Agence_moov_Cotonou,300000,268747,Matthieu-Matthieu Bigot,69261,100514,2022-03-11
TRANSFER,478565,Thomas-Robert Morvan,1610500,1131935,Matthieu-Matthieu Bigot,100514,579079,2022-03-26
CASH_IN,19097,Agence_moov_Abomey,300000,280903,Thomas Dupont,1251800,1270897,2022-03-02
TRANSFER,418070,Émile-René Baudry,1504100,1086030,Thomas Dupont,1270897,1688967,2022-03-08
CASH_OUT,906964,Thomas Dupont,1688967,782003,Agence_moov_Ouidah,300000,-606964,2022-03-16
CASH_IN,261830,Agence_moov_Ouidah,300000,38170,Thomas Dupont,782003,1043833,2022-03-19
CASH_IN,91668,Agence_moov_Abomey,300000,208332,Thomas Dupont,1043833,1135501,2022-03-25
TRANSFER,7673,Mathilde de la Samson,29200,21527,Camille Morvan,224700,232373,2022-03-06
TRANSFER,142839,Camille Morvan,232373,89534,Michelle de Étienne,1126800,983961,2022-03-21
CASH_OUT,79115,Camille Morvan,89534,10419,Agence_moov_Ouidah,300000,220885,2022-03-27
TRANSFER,855134,Bertrand Regnier,1347000,491866,Camille Morvan,10419,865553,2022-03-27
CASH_OUT,795761,Bernadette de Jourdan,828900,33139,Agence_moov_Cotonou,300000,-495761,2022-03-06
CASH_IN,165260,Agence_moov_Cotonou,300000,134740,Bernadette de Jourdan,33139,198399,2022-03-11
CASH_OUT,17852,Bernadette de Jourdan,198399,180547,Agence_moov_Ouidah,300000,282148,2022-03-13
TRANSFER,27245,Bernadette de Jourdan,180547,153302,Frédérique Fernandes du Bouchet,1521800,1494555,2022-03-17
CASH_IN,6046,Agence_moov_Ouidah,300000,293954,Bertrand Regnier,491866,497912,2022-03-09
CASH_OUT,332005,Bertrand Regnier,497912,165907,Agence_moov_Abomey,300000,-32005,2022-03-19
CASH_IN,132756,Agence_moov_Abomey,300000,167244,Bertrand Regnier,165907,298663,2022-03-19
CASH_IN,37384,Agence_moov_Cotonou,300000,262616,Bertrand Regnier,298663,336047,2022-03-27
TRANSFER,591988,Céline Collin-Hervé,1512800,920812,Timothée-René Blanchard,654400,1246388,2022-03-04
CASH_IN,215254,Agence_moov_Cotonou,300000,84746,Timothée-René Blanchard,1246388,1461642,2022-03-12
TRANSFER,1019687,Timothée-René Blanchard,1461642,441955,Andrée-Thérèse Mendès,801200,-218487,2022-03-19
CASH_OUT,119435,Timothée-René Blanchard,441955,322520,Agence_moov_Ouidah,300000,180565,2022-03-22
TRANSFER,463973,Stéphane Munoz,1937200,1473227,Timothée-René Blanchard,322520,786493,2022-03-22
CASH_IN,239852,Agence_moov_Abomey,300000,60148,Thérèse Hubert,1940500,2180352,2022-03-12
CASH_IN,224697,Agence_moov_Abomey,300000,75303,Thérèse Hubert,2180352,2405049,2022-03-18
TRANSFER,39319,Thomas Guichard du Renault,110600,71281,Lucy Gillet,1792800,1753481,2022-03-05
TRANSFER,819256,Anne Peltier-Raynaud,1917900,1098644,Thomas Guichard du Renault,71281,890537,2022-03-12
CASH_IN,135187,Agence_moov_Ouidah,300000,164813,Thomas Guichard du Renault,890537,1025724,2022-03-21
CASH_IN,220855,Agence_moov_Cotonou,300000,79145,Thomas Guichard du Renault,1025724,1246579,2022-03-24
CASH_OUT,268676,Thomas Guichard du Renault,1246579,977903,Agence_moov_Abomey,300000,31324,2022-03-25
CASH_IN,59627,Agence_moov_Cotonou,300000,240373,Tristan Delahaye,1552700,1612327,2022-03-05
CASH_IN,6198,Agence_moov_Cotonou,300000,293802,Tristan Delahaye,1612327,1618525,2022-03-05
CASH_OUT,50863,Tristan Delahaye,1618525,1567662,Agence_moov_Cotonou,300000,249137,2022-03-06
TRANSFER,1560391,André Renault,1757200,196809,Tristan Delahaye,1567662,3128053,2022-03-09
CASH_IN,232912,Agence_moov_Cotonou,300000,67088,Tristan Delahaye,3128053,3360965,2022-03-19
CASH_OUT,36864,Bernard Maurice,1401300,1364436,Agence_moov_Cotonou,300000,263136,2022-03-03
CASH_IN,233195,Agence_moov_Ouidah,300000,66805,Bernard Maurice,1364436,1597631,2022-03-07
CASH_IN,282748,Agence_moov_Ouidah,300000,17252,Bernard Maurice,1597631,1880379,2022-03-15
CASH_IN,291754,Agence_moov_Cotonou,300000,8246,Bernard Maurice,1880379,2172133,2022-03-20
CASH_IN,183722,Agence_moov_Cotonou,300000,116278,Michel Bouchet,184600,368322,2022-03-12
CASH_OUT,24750,Michel Bouchet,368322,343572,Agence_moov_Abomey,300000,275250,2022-03-26
CASH_OUT,537885,Richard Le Lévêque,1617300,1079415,Agence_moov_Abomey,300000,-237885,2022-03-15
CASH_IN,8217,Agence_moov_Abomey,300000,291783,Richard Le Lévêque,1079415,1087632,2022-03-15
CASH_OUT,189376,Richard Le Lévêque,1087632,898256,Agence_moov_Ouidah,300000,110624,2022-03-25
TRANSFER,1359924,Paul Rocher-Maillet,1465700,105776,Jules-Roland Bousquet,1721300,3081224,2022-03-12
TRANSFER,1601148,Alphonse Joly,1773200,172052,Jules-Roland Bousquet,3081224,4682372,2022-03-13
CASH_IN,61420,Agence_moov_Abomey,300000,238580,Jules-Roland Bousquet,4682372,4743792,2022-03-20
TRANSFER,4697153,Jules-Roland Bousquet,4743792,46639,Théodore Joseph-Lefebvre,1895000,-2802153,2022-03-27
CASH_OUT,166940,Camille Prévost,1982700,1815760,Agence_moov_Cotonou,300000,133060,2022-03-07
CASH_IN,1627,Agence_moov_Ouidah,300000,298373,Camille Prévost,1815760,1817387,2022-03-09
CASH_OUT,405695,Camille Prévost,1817387,1411692,Agence_moov_Ouidah,300000,-105695,2022-03-14
CASH_IN,297177,Agence_moov_Cotonou,300000,2823,Camille Prévost,1411692,1708869,2022-03-14
CASH_OUT,1057609,Camille Prévost,1708869,651260,Agence_moov_Cotonou,300000,-757609,2022-03-27
TRANSFER,228789,Rémy Grondin,922700,693911,Frédérique Fernandes du Bouchet,1494555,1723344,2022-03-05
CASH_OUT,315213,Frédérique Fernandes du Bouchet,1723344,1408131,Agence_moov_Cotonou,300000,-15213,2022-03-05
CASH_OUT,167614,Frédérique Fernandes du Bouchet,1408131,1240517,Agence_moov_Abomey,300000,132386,2022-03-15
TRANSFER,44804,Lucie Aubert,614000,569196,Thomas-Robert Morvan,1131935,1087131,2022-03-08
TRANSFER,32469,Lucie Aubert,569196,536727,Hélène Le Chauvin,415300,382831,2022-03-10
CASH_IN,36934,Agence_moov_Abomey,300000,263066,Colette-Sophie Prévost,1608800,1645734,2022-03-08
CASH_IN,193339,Agence_moov_Cotonou,300000,106661,Colette-Sophie Prévost,1645734,1839073,2022-03-19
CASH_IN,151727,Agence_moov_Ouidah,300000,148273,Hélène Le Chauvin,382831,534558,2022-03-06
CASH_OUT,89613,Hélène Le Chauvin,534558,444945,Agence_moov_Cotonou,300000,210387,2022-03-16
TRANSFER,132003,Hélène Le Chauvin,444945,312942,Renée Rousseau-Henry,19000,-113003,2022-03-23
CASH_IN,44960,Agence_moov_Ouidah,300000,255040,Thibaut de la Roy,1892500,1937460,2022-03-07
CASH_OUT,793269,Thibaut de la Roy,1937460,1144191,Agence_moov_Abomey,300000,-493269,2022-03-12
CASH_OUT,991813,Thibaut de la Roy,1144191,152378,Agence_moov_Ouidah,300000,-691813,2022-03-25
CASH_OUT,11812,Gabriel Bègue,189200,177388,Agence_moov_Abomey,300000,288188,2022-03-05
CASH_IN,291034,Agence_moov_Cotonou,300000,8966,Gabriel Bègue,177388,468422,2022-03-09
CASH_OUT,344440,Gabriel Bègue,468422,123982,Agence_moov_Ouidah,300000,-44440,2022-03-24
TRANSFER,426750,Alix Barbe,1951900,1525150,Gabriel Bègue,123982,550732,2022-03-26
TRANSFER,609728,Céline Collin-Hervé,920812,311084,Michelle de Étienne,983961,1593689,2022-03-03
CASH_OUT,698071,Michelle de Étienne,1593689,895618,Agence_moov_Cotonou,300000,-398071,2022-03-06
TRANSFER,659137,Michelle de Étienne,895618,236481,Alix Barbe,1525150,866013,2022-03-10
CASH_OUT,170338,Michelle de Étienne,236481,66143,Agence_moov_Ouidah,300000,129662,2022-03-17
TRANSFER,430956,Manon Valette,1044800,613844,Clémence-Véronique Munoz,156400,587356,2022-03-07
CASH_IN,270066,Agence_moov_Ouidah,300000,29934,Stéphane Munoz,1473227,1743293,2022-03-18
CASH_OUT,337795,Stéphane Munoz,1743293,1405498,Agence_moov_Ouidah,300000,-37795,2022-03-20
TRANSFER,779889,Richard Michel,1008800,228911,Renée Le Diaz,366400,1146289,2022-03-01
CASH_IN,233828,Agence_moov_Ouidah,300000,66172,Renée Le Diaz,1146289,1380117,2022-03-01
TRANSFER,566441,Renée Le Diaz,1380117,813676,Martine Aubert,1693000,1126559,2022-03-04
TRANSFER,215827,Renée Le Diaz,813676,597849,Antoinette de Dupuis,1844600,1628773,2022-03-04
TRANSFER,404383,Renée Le Diaz,597849,193466,Thomas de Blin,293500,-110883,2022-03-07
CASH_OUT,131237,Renée Le Diaz,193466,62229,Agence_moov_Ouidah,300000,168763,2022-03-08
TRANSFER,768175,Simone Muller de la Brun,1281800,513625,Renée Le Diaz,62229,830404,2022-03-09
CASH_IN,243966,Agence_moov_Cotonou,300000,56034,Renée Le Diaz,830404,1074370,2022-03-09
CASH_IN,203628,Agence_moov_Abomey,300000,96372,Renée Le Diaz,1074370,1277998,2022-03-10
CASH_IN,262778,Agence_moov_Abomey,300000,37222,Renée Le Diaz,1277998,1540776,2022-03-12
CASH_OUT,115621,Renée Le Diaz,1540776,1425155,Agence_moov_Ouidah,300000,184379,2022-03-13
CASH_IN,222646,Agence_moov_Abomey,300000,77354,Renée Le Diaz,1425155,1647801,2022-03-13
TRANSFER,735292,Michelle Samson,1160400,425108,Renée Le Diaz,1647801,2383093,2022-03-16
CASH_IN,36217,Agence_moov_Cotonou,300000,263783,Renée Le Diaz,2383093,2419310,2022-03-18
TRANSFER,13288,Luc Lévêque-Carre,1552300,1539012,Renée Le Diaz,2419310,2432598,2022-03-18
TRANSFER,2162460,Renée Le Diaz,2432598,270138,Tristan Bousquet-Gros,42500,-2119960,2022-03-18
CASH_IN,214923,Agence_moov_Abomey,300000,85077,Renée Le Diaz,270138,485061,2022-03-18
CASH_IN,169077,Agence_moov_Cotonou,300000,130923,Renée Le Diaz,485061,654138,2022-03-20
CASH_OUT,20937,Renée Le Diaz,654138,633201,Agence_moov_Cotonou,300000,279063,2022-03-22
CASH_OUT,484303,Renée Le Diaz,633201,148898,Agence_moov_Cotonou,300000,-184303,2022-03-22
CASH_IN,150195,Agence_moov_Abomey,300000,149805,Renée Le Diaz,148898,299093,2022-03-22
TRANSFER,1026527,Lucy Lamy,1060700,34173,Renée Le Diaz,299093,1325620,2022-03-23
CASH_IN,112918,Agence_moov_Abomey,300000,187082,Renée Le Diaz,1325620,1438538,2022-03-24
CASH_IN,151926,Agence_moov_Ouidah,300000,148074,Alphonse Gomes,1831000,1982926,2022-03-01
CASH_IN,153515,Agence_moov_Abomey,300000,146485,Alphonse Gomes,1982926,2136441,2022-03-02
TRANSFER,1586419,Alphonse Gomes,2136441,550022,Simone Muller de la Brun,513625,-1072794,2022-03-02
CASH_OUT,407014,Alphonse Gomes,550022,143008,Agence_moov_Ouidah,300000,-107014,2022-03-03
TRANSFER,13374,Lucy Lamy,34173,20799,Alphonse Gomes,143008,156382,2022-03-03
TRANSFER,51507,Alphonse Gomes,156382,104875,Benoît Guyot,976300,924793,2022-03-05
CASH_OUT,42529,Alphonse Gomes,104875,62346,Agence_moov_Ouidah,300000,257471,2022-03-07
CASH_IN,226737,Agence_moov_Abomey,300000,73263,Alphonse Gomes,62346,289083,2022-03-08
CASH_OUT,239710,Alphonse Gomes,289083,49373,Agence_moov_Ouidah,300000,60290,2022-03-09
CASH_OUT,3322,Alphonse Gomes,49373,46051,Agence_moov_Abomey,300000,296678,2022-03-10
TRANSFER,561928,Emmanuel Grégoire,1491200,929272,Alphonse Gomes,46051,607979,2022-03-11
TRANSFER,134092,Marthe Gilles,427900,293808,Alphonse Gomes,607979,742071,2022-03-11
CASH_OUT,404695,Alphonse Gomes,742071,337376,Agence_moov_Ouidah,300000,-104695,2022-03-12
TRANSFER,122583,Alphonse Joly,172052,49469,Alphonse Gomes,337376,459959,2022-03-12
TRANSFER,88813,Manon Chevalier,1246200,1157387,Alphonse Gomes,459959,548772,2022-03-12
CASH_OUT,267929,Alphonse Gomes,548772,280843,Agence_moov_Abomey,300000,32071,2022-03-13
CASH_OUT,217219,Alphonse Gomes,280843,63624,Agence_moov_Ouidah,300000,82781,2022-03-13
CASH_IN,85630,Agence_moov_Abomey,300000,214370,Alphonse Gomes,63624,149254,2022-03-13
CASH_IN,62573,Agence_moov_Cotonou,300000,237427,Alphonse Gomes,149254,211827,2022-03-15
TRANSFER,105072,Mathilde Picard du Delmas,113600,8528,Alphonse Gomes,211827,316899,2022-03-15
CASH_OUT,279312,Alphonse Gomes,316899,37587,Agence_moov_Cotonou,300000,20688,2022-03-16
CASH_OUT,24678,Alphonse Gomes,37587,12909,Agence_moov_Ouidah,300000,275322,2022-03-17
CASH_IN,101261,Agence_moov_Ouidah,300000,198739,Alphonse Gomes,12909,114170,2022-03-17
TRANSFER,55693,Nathalie Bonnin-Joubert,556200,500507,Alphonse Gomes,114170,169863,2022-03-18
CASH_IN,61085,Agence_moov_Ouidah,300000,238915,Alphonse Gomes,169863,230948,2022-03-19
CASH_IN,29888,Agence_moov_Abomey,300000,270112,Alphonse Gomes,230948,260836,2022-03-19
TRANSFER,207491,Alphonse Gomes,260836,53345,Frédéric Guillou,497000,289509,2022-03-20
CASH_IN,153779,Agence_moov_Abomey,300000,146221,Alphonse Gomes,53345,207124,2022-03-21
TRANSFER,282443,Nathalie Bonnin-Joubert,500507,218064,Nathalie Bonnin-Joubert,500507,782950,2022-03-01
TRANSFER,39545,Paul Rocher-Maillet,105776,66231,Nathalie Bonnin-Joubert,218064,257609,2022-03-02
TRANSFER,914037,Manon Lebon,1329500,415463,Nathalie Bonnin-Joubert,257609,1171646,2022-03-03
TRANSFER,597428,Nathalie Bonnin-Joubert,1171646,574218,Frédéric Guillou,289509,-307919,2022-03-05
CASH_IN,59217,Agence_moov_Ouidah,300000,240783,Nathalie Bonnin-Joubert,574218,633435,2022-03-06
CASH_OUT,439986,Nathalie Bonnin-Joubert,633435,193449,Agence_moov_Ouidah,300000,-139986,2022-03-07
CASH_OUT,144254,Nathalie Bonnin-Joubert,193449,49195,Agence_moov_Cotonou,300000,155746,2022-03-08
TRANSFER,65562,Colette Merle Le Robert,175600,110038,Nathalie Bonnin-Joubert,49195,114757,2022-03-09
CASH_OUT,87652,Nathalie Bonnin-Joubert,114757,27105,Agence_moov_Cotonou,300000,212348,2022-03-09
CASH_OUT,16677,Nathalie Bonnin-Joubert,27105,10428,Agence_moov_Abomey,300000,283323,2022-03-10
TRANSFER,63895,Colette Merle Le Robert,110038,46143,Nathalie Bonnin-Joubert,10428,74323,2022-03-10
CASH_IN,213824,Agence_moov_Cotonou,300000,86176,Nathalie Bonnin-Joubert,74323,288147,2022-03-10
CASH_OUT,142114,Nathalie Bonnin-Joubert,288147,146033,Agence_moov_Abomey,300000,157886,2022-03-11
CASH_IN,36729,Agence_moov_Ouidah,300000,263271,Nathalie Bonnin-Joubert,146033,182762,2022-03-14
CASH_OUT,159649,Nathalie Bonnin-Joubert,182762,23113,Agence_moov_Ouidah,300000,140351,2022-03-14
CASH_OUT,2856,Nathalie Bonnin-Joubert,23113,20257,Agence_moov_Abomey,300000,297144,2022-03-16
CASH_IN,197073,Agence_moov_Abomey,300000,102927,Nathalie Bonnin-Joubert,20257,217330,2022-03-18
CASH_IN,242664,Agence_moov_Ouidah,300000,57336,Nathalie Bonnin-Joubert,217330,459994,2022-03-20
CASH_OUT,377110,Nathalie Bonnin-Joubert,459994,82884,Agence_moov_Ouidah,300000,-77110,2022-03-20
TRANSFER,102956,Vincent de la Dumont,131500,28544,Nathalie Bonnin-Joubert,82884,185840,2022-03-23
CASH_OUT,38163,Nathalie Bonnin-Joubert,185840,147677,Agence_moov_Ouidah,300000,261837,2022-03-24
CASH_OUT,81836,Nathalie Bonnin-Joubert,147677,65841,Agence_moov_Cotonou,300000,218164,2022-03-25
CASH_IN,10786,Agence_moov_Ouidah,300000,289214,Nathalie Bonnin-Joubert,65841,76627,2022-03-26
TRANSFER,101600,Maggie Martinez,137500,35900,Céline Collin-Hervé,311084,209484,2022-03-01
CASH_IN,150995,Agence_moov_Cotonou,300000,149005,Maggie Martinez,35900,186895,2022-03-02
TRANSFER,129256,Maggie Martinez,186895,57639,Aurore Charrier,1992700,1863444,2022-03-03
TRANSFER,12067,Maggie Martinez,57639,45572,Anastasie Cousin,660300,648233,2022-03-03
CASH_IN,205553,Agence_moov_Ouidah,300000,94447,Maggie Martinez,45572,251125,2022-03-04
CASH_OUT,201900,Maggie Martinez,251125,49225,Agence_moov_Cotonou,300000,98100,2022-03-05
TRANSFER,47906,Maggie Martinez,49225,1319,Anastasie Richard-Neveu,46300,-1606,2022-03-05
CASH_IN,124229,Agence_moov_Ouidah,300000,175771,Maggie Martinez,1319,125548,2022-03-06
CASH_IN,97411,Agence_moov_Abomey,300000,202589,Maggie Martinez,125548,222959,2022-03-06
CASH_OUT,95780,Maggie Martinez,222959,127179,Agence_moov_Abomey,300000,204220,2022-03-07
CASH_OUT,72058,Maggie Martinez,127179,55121,Agence_moov_Ouidah,300000,227942,2022-03-08
TRANSFER,9244,Maggie Martinez,55121,45877,Agnès Le Giraud,1088900,1079656,2022-03-09
TRANSFER,1080378,Philippe Philippe,1322800,242422,Maggie Martinez,45877,1126255,2022-03-09
TRANSFER,100030,Constance Guillon,1320900,1220870,Maggie Martinez,1126255,1226285,2022-03-10
CASH_OUT,871759,Maggie Martinez,1226285,354526,Agence_moov_Ouidah,300000,-571759,2022-03-15
CASH_OUT,289639,Maggie Martinez,354526,64887,Agence_moov_Cotonou,300000,10361,2022-03-18
CASH_IN,195936,Agence_moov_Ouidah,300000,104064,Maggie Martinez,64887,260823,2022-03-18
CASH_IN,79132,Agence_moov_Cotonou,300000,220868,Maggie Martinez,260823,339955,2022-03-19
TRANSFER,102404,Maggie Martinez,339955,237551,Mathilde de la Samson,21527,-80877,2022-03-22
CASH_OUT,41166,Maggie Martinez,237551,196385,Agence_moov_Abomey,300000,258834,2022-03-22
TRANSFER,293642,Paul Perez,1041600,747958,Maggie Martinez,196385,490027,2022-03-24
TRANSFER,181266,Maggie Martinez,490027,308761,Luc Lévêque-Carre,1539012,1357746,2022-03-24
CASH_IN,215346,Agence_moov_Abomey,300000,84654,Maggie Martinez,308761,524107,2022-03-26
CASH_IN,159002,Agence_moov_Cotonou,300000,140998,Maggie Martinez,524107,683109,2022-03-26
TRANSFER,643993,Maggie Martinez,683109,39116,Mathilde Picard du Delmas,8528,-635465,2022-03-27
CASH_IN,9477,Agence_moov_Abomey,300000,290523,Philippe Philippe,242422,251899,2022-03-01
TRANSFER,430469,Suzanne Bodin,1235500,805031,Philippe Philippe,251899,682368,2022-03-02
TRANSFER,246651,Philippe Philippe,682368,435717,Audrey Julien de Leleu,679400,432749,2022-03-03
CASH_IN,206341,Agence_moov_Ouidah,300000,93659,Philippe Philippe,435717,642058,2022-03-03
TRANSFER,537882,Antoinette de Dupuis,1628773,1090891,Philippe Philippe,642058,1179940,2022-03-03
TRANSFER,300336,Manon Lebon,415463,115127,Philippe Philippe,1179940,1480276,2022-03-05
CASH_IN,29621,Agence_moov_Abomey,300000,270379,Philippe Philippe,1480276,1509897,2022-03-06
CASH_IN,95182,Agence_moov_Ouidah,300000,204818,Philippe Philippe,1509897,1605079,2022-03-08
CASH_IN,80580,Agence_moov_Cotonou,300000,219420,Philippe Philippe,1605079,1685659,2022-03-09
CASH_OUT,171666,Philippe Philippe,1685659,1513993,Agence_moov_Abomey,300000,128334,2022-03-10
CASH_IN,294550,Agence_moov_Cotonou,300000,5450,Philippe Philippe,1513993,1808543,2022-03-13
CASH_OUT,431060,Philippe Philippe,1808543,1377483,Agence_moov_Cotonou,300000,-131060,2022-03-14
CASH_OUT,1052490,Philippe Philippe,1377483,324993,Agence_moov_Ouidah,300000,-752490,2022-03-14
CASH_IN,195812,Agence_moov_Ouidah,300000,104188,Philippe Philippe,324993,520805,2022-03-18
TRANSFER,328992,Philippe Philippe,520805,191813,Colette Merle Le Robert,46143,-282849,2022-03-19
CASH_OUT,26060,Philippe Philippe,191813,165753,Agence_moov_Abomey,300000,273940,2022-03-19
TRANSFER,9306,Philippe Philippe,165753,156447,Robert Laroche,961600,952294,2022-03-20
CASH_OUT,22595,Philippe Philippe,156447,133852,Agence_moov_Ouidah,300000,277405,2022-03-21
CASH_OUT,46478,Philippe Philippe,133852,87374,Agence_moov_Abomey,300000,253522,2022-03-23
TRANSFER,2162,Lucy Lamy,20799,18637,Philippe Philippe,87374,89536,2022-03-24
TRANSFER,595690,Nicolas Salmon Le Hamon,639300,43610,Philippe Philippe,89536,685226,2022-03-25
TRANSFER,203454,Sabine Pineau,1094600,891146,Philippe Philippe,685226,888680,2022-03-25
CASH_IN,165792,Agence_moov_Abomey,300000,134208,Philippe Philippe,888680,1054472,2022-03-26
TRANSFER,1009558,Martine Aubert,1126559,117001,Philippe Philippe,1054472,2064030,2022-03-27
CASH_IN,28349,Agence_moov_Cotonou,300000,271651,Frédéric Guillou,-307919,-279570,2022-03-01
CASH_IN,43894,Agence_moov_Ouidah,300000,256106,Frédéric Guillou,-279570,-235676,2022-03-02
CASH_IN,235515,Agence_moov_Abomey,300000,64485,Frédéric Guillou,-235676,-161,2022-03-03
CASH_IN,235025,Agence_moov_Abomey,300000,64975,Frédéric Guillou,-161,234864,2022-03-03
CASH_OUT,192198,Frédéric Guillou,234864,42666,Agence_moov_Cotonou,300000,107802,2022-03-14
CASH_OUT,14260,Frédéric Guillou,42666,28406,Agence_moov_Cotonou,300000,285740,2022-03-15
TRANSFER,15885,Frédéric Guillou,28406,12521,Robert Laroche,952294,936409,2022-03-15
CASH_IN,61103,Agence_moov_Cotonou,300000,238897,Frédéric Guillou,12521,73624,2022-03-16
TRANSFER,24375,Frédéric Guillou,73624,49249,Jules Fernandes,175400,151025,2022-03-16
CASH_IN,258214,Agence_moov_Abomey,300000,41786,Frédéric Guillou,49249,307463,2022-03-16
CASH_OUT,126750,Frédéric Guillou,307463,180713,Agence_moov_Ouidah,300000,173250,2022-03-16
CASH_OUT,38454,Frédéric Guillou,180713,142259,Agence_moov_Cotonou,300000,261546,2022-03-17
CASH_IN,156047,Agence_moov_Ouidah,300000,143953,Frédéric Guillou,142259,298306,2022-03-18
TRANSFER,2578,Frédéric Guillou,298306,295728,Luc Lévêque-Carre,1357746,1355168,2022-03-19
TRANSFER,201518,Frédéric Guillou,295728,94210,Nicolas Salmon Le Hamon,43610,-157908,2022-03-19
TRANSFER,14091,Alphonse Joly,49469,35378,Frédéric Guillou,94210,108301,2022-03-19
CASH_IN,140578,Agence_moov_Ouidah,300000,159422,Frédéric Guillou,108301,248879,2022-03-20
TRANSFER,185664,Frédéric Guillou,248879,63215,Céline Collin-Hervé,209484,23820,2022-03-20
CASH_IN,131064,Agence_moov_Abomey,300000,168936,Frédéric Guillou,63215,194279,2022-03-22
CASH_OUT,15195,Frédéric Guillou,194279,179084,Agence_moov_Abomey,300000,284805,2022-03-23
CASH_OUT,84396,Frédéric Guillou,179084,94688,Agence_moov_Abomey,300000,215604,2022-03-23
TRANSFER,7312,Frédéric Guillou,94688,87376,Émile-René Baudry,1086030,1078718,2022-03-24
CASH_OUT,33528,Frédéric Guillou,87376,53848,Agence_moov_Cotonou,300000,266472,2022-03-26
CASH_OUT,31286,Frédéric Guillou,53848,22562,Agence_moov_Abomey,300000,268714,2022-03-27
TRANSFER,94557,Jules Fernandes,151025,56468,Lucy Gillet,1753481,1658924,2022-03-01
TRANSFER,4235,Jules Fernandes,56468,52233,Paul Perez,747958,743723,2022-03-01
CASH_OUT,41604,Jules Fernandes,52233,10629,Agence_moov_Abomey,300000,258396,2022-03-02
TRANSFER,55399,Paulette Loiseau,298400,243001,Jules Fernandes,10629,66028,2022-03-03
TRANSFER,1389913,Lucy Gillet,1658924,269011,Jules Fernandes,66028,1455941,2022-03-03
CASH_IN,283447,Agence_moov_Abomey,300000,16553,Jules Fernandes,1455941,1739388,2022-03-04
CASH_IN,144700,Agence_moov_Cotonou,300000,155300,Jules Fernandes,1739388,1884088,2022-03-04
TRANSFER,1733632,Jules Fernandes,1884088,150456,Agnès Le Giraud,1079656,-653976,2022-03-05
TRANSFER,126761,Jules Fernandes,150456,23695,Noémi Bouvier,1493500,1366739,2022-03-06
TRANSFER,13073,Jules Fernandes,23695,10622,Michelle Samson,425108,412035,2022-03-07
CASH_OUT,5381,Jules Fernandes,10622,5241,Agence_moov_Abomey,300000,294619,2022-03-07
CASH_OUT,4563,Jules Fernandes,5241,678,Agence_moov_Cotonou,300000,295437,2022-03-10
TRANSFER,22576,Astrid Lecoq,240500,217924,Jules Fernandes,678,23254,2022-03-10
TRANSFER,14161,Jules Fernandes,23254,9093,Alix Barbe,866013,851852,2022-03-15
TRANSFER,444,Jules Fernandes,9093,8649,Emmanuel Grégoire,929272,928828,2022-03-17
CASH_OUT,7871,Jules Fernandes,8649,778,Agence_moov_Cotonou,300000,292129,2022-03-18
CASH_IN,65554,Agence_moov_Cotonou,300000,234446,Jules Fernandes,778,66332,2022-03-20
CASH_OUT,6762,Jules Fernandes,66332,59570,Agence_moov_Cotonou,300000,293238,2022-03-20
CASH_IN,75397,Agence_moov_Cotonou,300000,224603,Jules Fernandes,59570,134967,2022-03-20
TRANSFER,200709,Aurore Charrier,1863444,1662735,Jules Fernandes,134967,335676,2022-03-20
CASH_OUT,317180,Jules Fernandes,335676,18496,Agence_moov_Cotonou,300000,-17180,2022-03-21
CASH_OUT,15254,Jules Fernandes,18496,3242,Agence_moov_Cotonou,300000,284746,2022-03-22
TRANSFER,158305,Anne Peltier-Raynaud,1098644,940339,Jules Fernandes,3242,161547,2022-03-24
CASH_OUT,148779,Jules Fernandes,161547,12768,Agence_moov_Abomey,300000,151221,2022-03-24
CASH_OUT,5624,Jules Fernandes,12768,7144,Agence_moov_Ouidah,300000,294376,2022-03-26
TRANSFER,157351,Tristan Gomez,433500,276149,Jules Fernandes,7144,164495,2022-03-27
CASH_IN,253933,Agence_moov_Cotonou,300000,46067,Jules Fernandes,164495,418428,2022-03-27
TRANSFER,656962,Raymond Lévy,1381200,724238,Astrid Lecoq,217924,-439038,2022-03-01
CASH_OUT,16823,Raymond Lévy,724238,707415,Agence_moov_Cotonou,300000,283177,2022-03-01
CASH_OUT,286472,Raymond Lévy,707415,420943,Agence_moov_Cotonou,300000,13528,2022-03-01
TRANSFER,538026,Émile-René Baudry,1078718,540692,Raymond Lévy,420943,958969,2022-03-03
CASH_IN,177051,Agence_moov_Ouidah,300000,122949,Raymond Lévy,958969,1136020,2022-03-04
CASH_IN,292564,Agence_moov_Cotonou,300000,7436,Raymond Lévy,1136020,1428584,2022-03-05
TRANSFER,165052,Robert-Louis Gosselin,1305800,1140748,Raymond Lévy,1428584,1593636,2022-03-05
CASH_OUT,482668,Raymond Lévy,1593636,1110968,Agence_moov_Cotonou,300000,-182668,2022-03-06
CASH_OUT,634005,Raymond Lévy,1110968,476963,Agence_moov_Abomey,300000,-334005,2022-03-06
CASH_OUT,280252,Raymond Lévy,476963,196711,Agence_moov_Cotonou,300000,19748,2022-03-08
CASH_OUT,176248,Raymond Lévy,196711,20463,Agence_moov_Cotonou,300000,123752,2022-03-09
CASH_IN,53966,Agence_moov_Cotonou,300000,246034,Raymond Lévy,20463,74429,2022-03-10
CASH_OUT,14774,Raymond Lévy,74429,59655,Agence_moov_Abomey,300000,285226,2022-03-10
CASH_IN,50782,Agence_moov_Cotonou,300000,249218,Raymond Lévy,59655,110437,2022-03-10
CASH_OUT,4490,Raymond Lévy,110437,105947,Agence_moov_Ouidah,300000,295510,2022-03-11
TRANSFER,417016,Virginie Bouvet,472800,55784,Raymond Lévy,105947,522963,2022-03-13
CASH_OUT,382724,Raymond Lévy,522963,140239,Agence_moov_Abomey,300000,-82724,2022-03-14
CASH_IN,91549,Agence_moov_Ouidah,300000,208451,Raymond Lévy,140239,231788,2022-03-14
TRANSFER,97841,Raymond Lévy,231788,133947,Noël Bourgeois,1439900,1342059,2022-03-15
TRANSFER,14715,Lucy Lamy,18637,3922,Raymond Lévy,133947,148662,2022-03-16
TRANSFER,509855,Manon Valette,613844,103989,Raymond Lévy,148662,658517,2022-03-19
TRANSFER,1224821,Noémi Bouvier,1366739,141918,Raymond Lévy,658517,1883338,2022-03-20
CASH_OUT,1847894,Raymond Lévy,1883338,35444,Agence_moov_Cotonou,300000,-1547894,2022-03-20
CASH_OUT,25199,Raymond Lévy,35444,10245,Agence_moov_Abomey,300000,274801,2022-03-21
TRANSFER,29036,Virginie Bouvet,55784,26748,Raymond Lévy,10245,39281,2022-03-21
TRANSFER,35554,Raymond Lévy,39281,3727,Antoinette de Dupuis,1090891,1055337,2022-03-23
CASH_OUT,587,Raymond Lévy,3727,3140,Agence_moov_Abomey,300000,299413,2022-03-24
CASH_IN,263925,Agence_moov_Cotonou,300000,36075,Benoît Guyot,924793,1188718,2022-03-01
CASH_OUT,1087093,Benoît Guyot,1188718,101625,Agence_moov_Cotonou,300000,-787093,2022-03-01
CASH_IN,293364,Agence_moov_Abomey,300000,6636,Benoît Guyot,101625,394989,2022-03-02
CASH_OUT,184286,Benoît Guyot,394989,210703,Agence_moov_Cotonou,300000,115714,2022-03-03
CASH_OUT,39199,Benoît Guyot,210703,171504,Agence_moov_Cotonou,300000,260801,2022-03-05
CASH_IN,68007,Agence_moov_Abomey,300000,231993,Benoît Guyot,171504,239511,2022-03-05
CASH_OUT,212323,Benoît Guyot,239511,27188,Agence_moov_Cotonou,300000,87677,2022-03-06
TRANSFER,282770,Audrey Julien de Leleu,432749,149979,Benoît Guyot,27188,309958,2022-03-07
TRANSFER,524957,Anastasie Cousin,648233,123276,Benoît Guyot,309958,834915,2022-03-08
CASH_IN,177265,Agence_moov_Abomey,300000,122735,Benoît Guyot,834915,1012180,2022-03-10
CASH_OUT,439921,Benoît Guyot,1012180,572259,Agence_moov_Ouidah,300000,-139921,2022-03-10
CASH_OUT,226719,Benoît Guyot,572259,345540,Agence_moov_Ouidah,300000,73281,2022-03-10
CASH_IN,270603,Agence_moov_Ouidah,300000,29397,Benoît Guyot,345540,616143,2022-03-11
TRANSFER,22703,Céline Collin-Hervé,23820,1117,Benoît Guyot,616143,638846,2022-03-11
CASH_OUT,63999,Benoît Guyot,638846,574847,Agence_moov_Cotonou,300000,236001,2022-03-12
CASH_IN,58227,Agence_moov_Abomey,300000,241773,Benoît Guyot,574847,633074,2022-03-13
TRANSFER,575158,Benoît Guyot,633074,57916,Richard Michel,228911,-346247,2022-03-14
CASH_IN,32152,Agence_moov_Ouidah,300000,267848,Benoît Guyot,57916,90068,2022-03-14
CASH_OUT,67559,Benoît Guyot,90068,22509,Agence_moov_Cotonou,300000,232441,2022-03-15
CASH_OUT,7239,Benoît Guyot,22509,15270,Agence_moov_Cotonou,300000,292761,2022-03-18
TRANSFER,1693,Benoît Guyot,15270,13577,Constance Bourdon-Millet,1876000,1874307,2022-03-19
TRANSFER,10237,Benoît Guyot,13577,3340,Michelle Samson,412035,401798,2022-03-20
CASH_OUT,127,Benoît Guyot,3340,3213,Agence_moov_Abomey,300000,299873,2022-03-21
CASH_OUT,1055,Benoît Guyot,3213,2158,Agence_moov_Abomey,300000,298945,2022-03-21
TRANSFER,1566,Benoît Guyot,2158,592,Manon Chevalier,1157387,1155821,2022-03-24
TRANSFER,726132,Suzanne Bodin,805031,78899,Benoît Guyot,592,726724,2022-03-24
CASH_OUT,651010,Benoît Guyot,726724,75714,Agence_moov_Abomey,300000,-351010,2022-03-24
CASH_IN,229230,Agence_moov_Abomey,300000,70770,Benoît Guyot,75714,304944,2022-03-25
TRANSFER,100699,Manon Valette,103989,3290,Benoît Guyot,304944,405643,2022-03-26
CASH_OUT,304285,Benoît Guyot,405643,101358,Agence_moov_Ouidah,300000,-4285,2022-03-27
CASH_IN,112856,Agence_moov_Abomey,300000,187144,Rémy Grondin,693911,806767,2022-03-01
TRANSFER,419350,Rémy Grondin,806767,387417,Aurore Charrier,1662735,1243385,2022-03-01
CASH_OUT,219409,Rémy Grondin,387417,168008,Agence_moov_Abomey,300000,80591,2022-03-02
CASH_OUT,21910,Rémy Grondin,168008,146098,Agence_moov_Ouidah,300000,278090,2022-03-02
CASH_IN,53269,Agence_moov_Cotonou,300000,246731,Rémy Grondin,146098,199367,2022-03-05
CASH_IN,135621,Agence_moov_Cotonou,300000,164379,Rémy Grondin,199367,334988,2022-03-08
TRANSFER,38146,Rémy Grondin,334988,296842,Rémy Grondin,334988,373134,2022-03-09
CASH_OUT,260354,Rémy Grondin,296842,36488,Agence_moov_Ouidah,300000,39646,2022-03-09
TRANSFER,16751,Rémy Grondin,36488,19737,Alix Barbe,851852,835101,2022-03-10
CASH_OUT,16387,Rémy Grondin,19737,3350,Agence_moov_Abomey,300000,283613,2022-03-10
CASH_IN,279406,Agence_moov_Cotonou,300000,20594,Rémy Grondin,3350,282756,2022-03-11
CASH_OUT,105315,Rémy Grondin,282756,177441,Agence_moov_Ouidah,300000,194685,2022-03-14
TRANSFER,115877,Lucy Gillet,269011,153134,Rémy Grondin,177441,293318,2022-03-15
CASH_OUT,125323,Rémy Grondin,293318,167995,Agence_moov_Abomey,300000,174677,2022-03-17
CASH_IN,294649,Agence_moov_Abomey,300000,5351,Rémy Grondin,167995,462644,2022-03-19
TRANSFER,70619,Rémy Grondin,462644,392025,Céline Collin-Hervé,1117,-69502,2022-03-19
CASH_OUT,260227,Rémy Grondin,392025,131798,Agence_moov_Abomey,300000,39773,2022-03-20
CASH_OUT,100364,Rémy Grondin,131798,31434,Agence_moov_Cotonou,300000,199636,2022-03-20
CASH_OUT,23003,Rémy Grondin,31434,8431,Agence_moov_Cotonou,300000,276997,2022-03-21
CASH_IN,87773,Agence_moov_Ouidah,300000,212227,Rémy Grondin,8431,96204,2022-03-22
TRANSFER,384109,Michelle Samson,401798,17689,Rémy Grondin,96204,480313,2022-03-23
TRANSFER,194696,Rémy Grondin,480313,285617,Anne Peltier-Raynaud,940339,745643,2022-03-24
CASH_IN,14158,Agence_moov_Abomey,300000,285842,Rémy Grondin,285617,299775,2022-03-25
TRANSFER,139003,Rémy Grondin,299775,160772,Sabine Pineau,891146,752143,2022-03-27
CASH_IN,50714,Agence_moov_Cotonou,300000,249286,Rémy Grondin,160772,211486,2022-03-27
CASH_IN,164457,Agence_moov_Cotonou,300000,135543,Anastasie Richard-Neveu,-1606,162851,2022-03-01
CASH_IN,243027,Agence_moov_Cotonou,300000,56973,Anastasie Richard-Neveu,162851,405878,2022-03-01
CASH_OUT,218176,Anastasie Richard-Neveu,405878,187702,Agence_moov_Ouidah,300000,81824,2022-03-01
CASH_OUT,28450,Anastasie Richard-Neveu,187702,159252,Agence_moov_Abomey,300000,271550,2022-03-03
CASH_IN,101691,Agence_moov_Ouidah,300000,198309,Anastasie Richard-Neveu,159252,260943,2022-03-03
CASH_IN,102440,Agence_moov_Cotonou,300000,197560,Anastasie Richard-Neveu,260943,363383,2022-03-05
CASH_IN,138952,Agence_moov_Cotonou,300000,161048,Anastasie Richard-Neveu,363383,502335,2022-03-07
CASH_IN,130796,Agence_moov_Cotonou,300000,169204,Anastasie Richard-Neveu,502335,633131,2022-03-07
TRANSFER,26567,Vincent de la Dumont,28544,1977,Anastasie Richard-Neveu,633131,659698,2022-03-09
TRANSFER,457208,Anastasie Richard-Neveu,659698,202490,Thérèse François,287200,-170008,2022-03-10
CASH_OUT,198230,Anastasie Richard-Neveu,202490,4260,Agence_moov_Ouidah,300000,101770,2022-03-10
CASH_OUT,3932,Anastasie Richard-Neveu,4260,328,Agence_moov_Ouidah,300000,296068,2022-03-11
CASH_OUT,120,Anastasie Richard-Neveu,328,208,Agence_moov_Ouidah,300000,299880,2022-03-11
CASH_IN,101407,Agence_moov_Ouidah,300000,198593,Anastasie Richard-Neveu,208,101615,2022-03-13
CASH_IN,167911,Agence_moov_Abomey,300000,132089,Anastasie Richard-Neveu,101615,269526,2022-03-16
CASH_IN,81439,Agence_moov_Abomey,300000,218561,Anastasie Richard-Neveu,269526,350965,2022-03-17
CASH_IN,197095,Agence_moov_Ouidah,300000,102905,Anastasie Richard-Neveu,350965,548060,2022-03-18
CASH_OUT,280831,Anastasie Richard-Neveu,548060,267229,Agence_moov_Cotonou,300000,19169,2022-03-18
CASH_OUT,175349,Anastasie Richard-Neveu,267229,91880,Agence_moov_Cotonou,300000,124651,2022-03-18
TRANSFER,63547,Anastasie Richard-Neveu,91880,28333,Nath Loiseau,1258600,1195053,2022-03-19
CASH_OUT,8421,Anastasie Richard-Neveu,28333,19912,Agence_moov_Cotonou,300000,291579,2022-03-21
CASH_IN,136971,Agence_moov_Cotonou,300000,163029,Anastasie Richard-Neveu,19912,156883,2022-03-21
CASH_IN,122028,Agence_moov_Cotonou,300000,177972,Anastasie Richard-Neveu,156883,278911,2022-03-21
TRANSFER,761567,Luc Lévêque-Carre,1355168,593601,Anastasie Richard-Neveu,278911,1040478,2022-03-22
TRANSFER,558854,Anastasie Richard-Neveu,1040478,481624,Sabine Pineau,752143,193289,2022-03-22
CASH_IN,102345,Agence_moov_Ouidah,300000,197655,Anastasie Richard-Neveu,481624,583969,2022-03-27
CASH_IN,98478,Agence_moov_Cotonou,300000,201522,Marthe Gilles,293808,392286,2022-03-01
TRANSFER,227309,Manon Chevalier,1155821,928512,Marthe Gilles,392286,619595,2022-03-04
CASH_IN,187619,Agence_moov_Abomey,300000,112381,Marthe Gilles,619595,807214,2022-03-04
CASH_OUT,99073,Marthe Gilles,807214,708141,Agence_moov_Abomey,300000,200927,2022-03-05
CASH_IN,101221,Agence_moov_Cotonou,300000,198779,Marthe Gilles,708141,809362,2022-03-05
CASH_IN,254180,Agence_moov_Cotonou,300000,45820,Marthe Gilles,809362,1063542,2022-03-07
CASH_OUT,928599,Marthe Gilles,1063542,134943,Agence_moov_Cotonou,300000,-628599,2022-03-07
CASH_OUT,59797,Marthe Gilles,134943,75146,Agence_moov_Cotonou,300000,240203,2022-03-09
CASH_IN,190149,Agence_moov_Ouidah,300000,109851,Marthe Gilles,75146,265295,2022-03-09
CASH_OUT,203197,Marthe Gilles,265295,62098,Agence_moov_Cotonou,300000,96803,2022-03-13
CASH_OUT,39949,Marthe Gilles,62098,22149,Agence_moov_Ouidah,300000,260051,2022-03-14
TRANSFER,1167001,Constance Guillon,1220870,53869,Marthe Gilles,22149,1189150,2022-03-14
TRANSFER,163428,Thibaut de la Lombard,1637600,1474172,Marthe Gilles,1189150,1352578,2022-03-16
CASH_IN,111898,Agence_moov_Cotonou,300000,188102,Marthe Gilles,1352578,1464476,2022-03-17
CASH_IN,231118,Agence_moov_Ouidah,300000,68882,Marthe Gilles,1464476,1695594,2022-03-17
CASH_IN,46142,Agence_moov_Cotonou,300000,253858,Marthe Gilles,1695594,1741736,2022-03-18
CASH_IN,170906,Agence_moov_Abomey,300000,129094,Marthe Gilles,1741736,1912642,2022-03-19
TRANSFER,1325896,Marthe Gilles,1912642,586746,Aurore Charrier,1243385,-82511,2022-03-19
CASH_OUT,23143,Marthe Gilles,586746,563603,Agence_moov_Ouidah,300000,276857,2022-03-19
CASH_OUT,13800,Marthe Gilles,563603,549803,Agence_moov_Ouidah,300000,286200,2022-03-21
CASH_OUT,104507,Marthe Gilles,549803,445296,Agence_moov_Ouidah,300000,195493,2022-03-21
TRANSFER,57830,Marthe Gilles,445296,387466,Paul Rocher-Maillet,66231,8401,2022-03-22
CASH_OUT,242108,Marthe Gilles,387466,145358,Agence_moov_Ouidah,300000,57892,2022-03-22
TRANSFER,24929,Marthe Gilles,145358,120429,Nath Loiseau,1195053,1170124,2022-03-23
CASH_IN,48176,Agence_moov_Ouidah,300000,251824,Marthe Gilles,120429,168605,2022-03-24
CASH_IN,125421,Agence_moov_Abomey,300000,174579,Marthe Gilles,168605,294026,2022-03-25
CASH_OUT,177950,Sabine Pineau,193289,15339,Agence_moov_Cotonou,300000,122050,2022-03-02
TRANSFER,15124,Emmanuel Grégoire,928828,913704,Sabine Pineau,15339,30463,2022-03-03
CASH_OUT,26494,Sabine Pineau,30463,3969,Agence_moov_Ouidah,300000,273506,2022-03-03
CASH_IN,241046,Agence_moov_Ouidah,300000,58954,Sabine Pineau,3969,245015,2022-03-07
TRANSFER,140335,Aimé Pages,150000,9665,Sabine Pineau,245015,385350,2022-03-08
CASH_OUT,87408,Sabine Pineau,385350,297942,Agence_moov_Abomey,300000,212592,2022-03-08
CASH_OUT,102026,Sabine Pineau,297942,195916,Agence_moov_Ouidah,300000,197974,2022-03-12
CASH_OUT,116338,Sabine Pineau,195916,79578,Agence_moov_Cotonou,300000,183662,2022-03-12
CASH_IN,129993,Agence_moov_Abomey,300000,170007,Sabine Pineau,79578,209571,2022-03-13
CASH_IN,77441,Agence_moov_Abomey,300000,222559,Sabine Pineau,209571,287012,2022-03-14
CASH_OUT,154516,Sabine Pineau,287012,132496,Agence_moov_Cotonou,300000,145484,2022-03-15
CASH_IN,221001,Agence_moov_Ouidah,300000,78999,Sabine Pineau,132496,353497,2022-03-15
CASH_IN,62953,Agence_moov_Cotonou,300000,237047,Sabine Pineau,353497,416450,2022-03-15
CASH_IN,123254,Agence_moov_Ouidah,300000,176746,Sabine Pineau,416450,539704,2022-03-15
CASH_IN,174074,Agence_moov_Ouidah,300000,125926,Sabine Pineau,539704,713778,2022-03-16
CASH_OUT,668758,Sabine Pineau,713778,45020,Agence_moov_Cotonou,300000,-368758,2022-03-17
CASH_OUT,21807,Sabine Pineau,45020,23213,Agence_moov_Abomey,300000,278193,2022-03-19
TRANSFER,66678,Martine Aubert,117001,50323,Sabine Pineau,23213,89891,2022-03-21
CASH_OUT,32335,Sabine Pineau,89891,57556,Agence_moov_Ouidah,300000,267665,2022-03-22
CASH_OUT,52910,Sabine Pineau,57556,4646,Agence_moov_Cotonou,300000,247090,2022-03-22
CASH_IN,124052,Agence_moov_Cotonou,300000,175948,Sabine Pineau,4646,128698,2022-03-23
CASH_IN,137504,Agence_moov_Cotonou,300000,162496,Sabine Pineau,128698,266202,2022-03-25
TRANSFER,70986,Sabine Pineau,266202,195216,Martine Aubert,50323,-20663,2022-03-26
TRANSFER,55587,Sabine Pineau,195216,139629,Victor Michel,1544000,1488413,2022-03-26
CASH_OUT,38077,Sabine Pineau,139629,101552,Agence_moov_Ouidah,300000,261923,2022-03-26
CASH_IN,173479,Agence_moov_Cotonou,300000,126521,Paul Perez,743723,917202,2022-03-01
TRANSFER,124059,Paul Perez,917202,793143,Antoinette de Dupuis,1055337,931278,2022-03-02
TRANSFER,525877,Paul Perez,793143,267266,Luc Lévêque-Carre,593601,67724,2022-03-03
CASH_IN,46551,Agence_moov_Cotonou,300000,253449,Paul Perez,267266,313817,2022-03-03
TRANSFER,155295,Paulette Loiseau,243001,87706,Paul Perez,313817,469112,2022-03-04
CASH_IN,204780,Agence_moov_Abomey,300000,95220,Paul Perez,469112,673892,2022-03-05
CASH_IN,130515,Agence_moov_Abomey,300000,169485,Paul Perez,673892,804407,2022-03-05
CASH_OUT,376985,Paul Perez,804407,427422,Agence_moov_Cotonou,300000,-76985,2022-03-07
CASH_OUT,180438,Paul Perez,427422,246984,Agence_moov_Cotonou,300000,119562,2022-03-09
CASH_IN,266305,Agence_moov_Ouidah,300000,33695,Paul Perez,246984,513289,2022-03-10
TRANSFER,143018,Michelle-Dorothée Lévêque,198600,55582,Paul Perez,513289,656307,2022-03-10
CASH_OUT,556690,Paul Perez,656307,99617,Agence_moov_Ouidah,300000,-256690,2022-03-11
TRANSFER,406938,Emmanuel Grégoire,913704,506766,Paul Perez,99617,506555,2022-03-11
CASH_OUT,299084,Paul Perez,506555,207471,Agence_moov_Ouidah,300000,916,2022-03-13
CASH_IN,186320,Agence_moov_Cotonou,300000,113680,Paul Perez,207471,393791,2022-03-13
CASH_IN,218987,Agence_moov_Abomey,300000,81013,Paul Perez,393791,612778,2022-03-15
CASH_IN,29152,Agence_moov_Ouidah,300000,270848,Paul Perez,612778,641930,2022-03-15
CASH_IN,234214,Agence_moov_Cotonou,300000,65786,Paul Perez,641930,876144,2022-03-15
TRANSFER,186891,Manon Chevalier,928512,741621,Paul Perez,876144,1063035,2022-03-16
CASH_OUT,989593,Paul Perez,1063035,73442,Agence_moov_Cotonou,300000,-689593,2022-03-18
TRANSFER,8072,Paul Rocher-Maillet,8401,329,Paul Perez,73442,81514,2022-03-18
CASH_IN,74290,Agence_moov_Abomey,300000,225710,Paul Perez,81514,155804,2022-03-18
CASH_OUT,46932,Paul Perez,155804,108872,Agence_moov_Abomey,300000,253068,2022-03-18
CASH_OUT,39457,Paul Perez,108872,69415,Agence_moov_Abomey,300000,260543,2022-03-19
TRANSFER,38602,Paul Perez,69415,30813,Suzanne Bodin,78899,40297,2022-03-22
CASH_IN,286958,Agence_moov_Abomey,300000,13042,Paul Perez,30813,317771,2022-03-23
CASH_OUT,297219,Paul Perez,317771,20552,Agence_moov_Abomey,300000,2781,2022-03-25
CASH_OUT,17652,Paul Perez,20552,2900,Agence_moov_Ouidah,300000,282348,2022-03-26
CASH_OUT,21236,Virginie Bouvet,26748,5512,Agence_moov_Cotonou,300000,278764,2022-03-03
TRANSFER,2516,Aimé Pages,9665,7149,Virginie Bouvet,5512,8028,2022-03-05
CASH_OUT,7286,Virginie Bouvet,8028,742,Agence_moov_Cotonou,300000,292714,2022-03-05
CASH_IN,77086,Agence_moov_Ouidah,300000,222914,Virginie Bouvet,742,77828,2022-03-08
CASH_OUT,34000,Virginie Bouvet,77828,43828,Agence_moov_Ouidah,300000,266000,2022-03-08
CASH_IN,50254,Agence_moov_Cotonou,300000,249746,Virginie Bouvet,43828,94082,2022-03-08
CASH_IN,256794,Agence_moov_Ouidah,300000,43206,Virginie Bouvet,94082,350876,2022-03-10
CASH_OUT,65105,Virginie Bouvet,350876,285771,Agence_moov_Cotonou,300000,234895,2022-03-11
TRANSFER,46878,Virginie Bouvet,285771,238893,Constance Bourdon-Millet,1874307,1827429,2022-03-11
CASH_IN,257572,Agence_moov_Ouidah,300000,42428,Virginie Bouvet,238893,496465,2022-03-12
CASH_IN,65782,Agence_moov_Cotonou,300000,234218,Virginie Bouvet,496465,562247,2022-03-12
CASH_IN,110598,Agence_moov_Cotonou,300000,189402,Virginie Bouvet,562247,672845,2022-03-12
CASH_IN,148040,Agence_moov_Abomey,300000,151960,Virginie Bouvet,672845,820885,2022-03-14
CASH_OUT,159916,Virginie Bouvet,820885,660969,Agence_moov_Cotonou,300000,140084,2022-03-15
CASH_OUT,17564,Virginie Bouvet,660969,643405,Agence_moov_Abomey,300000,282436,2022-03-15
CASH_IN,144307,Agence_moov_Cotonou,300000,155693,Virginie Bouvet,643405,787712,2022-03-15
CASH_IN,54062,Agence_moov_Abomey,300000,245938,Virginie Bouvet,787712,841774,2022-03-17
TRANSFER,581153,Virginie Bouvet,841774,260621,Robert-Louis Gosselin,1140748,559595,2022-03-18
TRANSFER,556462,Vincent Joubert,874300,317838,Virginie Bouvet,260621,817083,2022-03-19
TRANSFER,443093,Anne Peltier-Raynaud,745643,302550,Virginie Bouvet,817083,1260176,2022-03-21
CASH_IN,243113,Agence_moov_Ouidah,300000,56887,Virginie Bouvet,1260176,1503289,2022-03-22
TRANSFER,923177,Virginie Bouvet,1503289,580112,Audrey Julien de Leleu,149979,-773198,2022-03-23
CASH_IN,282299,Agence_moov_Ouidah,300000,17701,Virginie Bouvet,580112,862411,2022-03-24
TRANSFER,70630,Lucy Gillet,153134,82504,Virginie Bouvet,862411,933041,2022-03-26
CASH_OUT,616482,Virginie Bouvet,933041,316559,Agence_moov_Ouidah,300000,-316482,2022-03-27
CASH_OUT,272571,Virginie Bouvet,316559,43988,Agence_moov_Ouidah,300000,27429,2022-03-27
CASH_OUT,135386,Véronique Martins de Fleury,385700,250314,Agence_moov_Cotonou,300000,164614,2022-03-01
TRANSFER,106076,Véronique Martins de Fleury,250314,144238,Aimé Pages,7149,-98927,2022-03-02
CASH_OUT,87220,Véronique Martins de Fleury,144238,57018,Agence_moov_Ouidah,300000,212780,2022-03-02
TRANSFER,28523,Véronique Martins de Fleury,57018,28495,Vincent Joubert,317838,289315,2022-03-05
CASH_IN,271503,Agence_moov_Cotonou,300000,28497,Véronique Martins de Fleury,28495,299998,2022-03-09
CASH_OUT,282779,Véronique Martins de Fleury,299998,17219,Agence_moov_Abomey,300000,17221,2022-03-10
TRANSFER,2795,Lucy Lamy,3922,1127,Véronique Martins de Fleury,17219,20014,2022-03-10
CASH_IN,20823,Agence_moov_Abomey,300000,279177,Véronique Martins de Fleury,20014,40837,2022-03-10
CASH_IN,291894,Agence_moov_Abomey,300000,8106,Véronique Martins de Fleury,40837,332731,2022-03-11
CASH_IN,41769,Agence_moov_Ouidah,300000,258231,Véronique Martins de Fleury,332731,374500,2022-03-14
TRANSFER,70402,Véronique Martins de Fleury,374500,304098,Thomas-Robert Morvan,1087131,1016729,2022-03-14
TRANSFER,34164,Suzanne Bodin,40297,6133,Véronique Martins de Fleury,304098,338262,2022-03-15
TRANSFER,293904,Véronique Martins de Fleury,338262,44358,Vincent de la Dumont,1977,-291927,2022-03-15
CASH_OUT,13430,Véronique Martins de Fleury,44358,30928,Agence_moov_Cotonou,300000,286570,2022-03-15
TRANSFER,29510,Véronique Martins de Fleury,30928,1418,Vincent Joubert,289315,259805,2022-03-17
CASH_OUT,583,Véronique Martins de Fleury,1418,835,Agence_moov_Abomey,300000,299417,2022-03-19
CASH_IN,235791,Agence_moov_Abomey,300000,64209,Véronique Martins de Fleury,835,236626,2022-03-20
CASH_IN,244490,Agence_moov_Ouidah,300000,55510,Véronique Martins de Fleury,236626,481116,2022-03-22
TRANSFER,235,Lucy Lamy,1127,892,Véronique Martins de Fleury,481116,481351,2022-03-22
CASH_OUT,77245,Véronique Martins de Fleury,481351,404106,Agence_moov_Abomey,300000,222755,2022-03-23
CASH_IN,169960,Agence_moov_Ouidah,300000,130040,Véronique Martins de Fleury,404106,574066,2022-03-23
TRANSFER,107259,Véronique Martins de Fleury,574066,466807,Antoinette de Dupuis,931278,824019,2022-03-24
CASH_IN,137202,Agence_moov_Abomey,300000,162798,Véronique Martins de Fleury,466807,604009,2022-03-25
CASH_OUT,436332,Véronique Martins de Fleury,604009,167677,Agence_moov_Abomey,300000,-136332,2022-03-26
CASH_OUT,151447,Véronique Martins de Fleury,167677,16230,Agence_moov_Ouidah,300000,148553,2022-03-27
TRANSFER,737371,Léon Da Costa,1022600,285229,Véronique Martins de Fleury,16230,753601,2022-03-27
CASH_IN,236209,Agence_moov_Cotonou,300000,63791,Nath Loiseau,1170124,1406333,2022-03-01
CASH_IN,24038,Agence_moov_Abomey,300000,275962,Nath Loiseau,1406333,1430371,2022-03-01
TRANSFER,200264,Vincent Joubert,259805,59541,Nath Loiseau,1430371,1630635,2022-03-04
TRANSFER,437536,Nath Loiseau,1630635,1193099,Constance Bourdon-Millet,1827429,1389893,2022-03-05
CASH_IN,253961,Agence_moov_Cotonou,300000,46039,Nath Loiseau,1193099,1447060,2022-03-07
TRANSFER,36631,Manon Lebon,115127,78496,Nath Loiseau,1447060,1483691,2022-03-07
CASH_IN,261059,Agence_moov_Cotonou,300000,38941,Nath Loiseau,1483691,1744750,2022-03-08
CASH_IN,152024,Agence_moov_Cotonou,300000,147976,Nath Loiseau,1744750,1896774,2022-03-09
TRANSFER,479710,Nath Loiseau,1896774,1417064,Constance Guillon,53869,-425841,2022-03-10
CASH_IN,35846,Agence_moov_Cotonou,300000,264154,Nath Loiseau,1417064,1452910,2022-03-10
CASH_OUT,1128555,Nath Loiseau,1452910,324355,Agence_moov_Abomey,300000,-828555,2022-03-10
TRANSFER,173351,Nath Loiseau,324355,151004,Robert-Louis Gosselin,559595,386244,2022-03-11
CASH_OUT,130953,Nath Loiseau,151004,20051,Agence_moov_Ouidah,300000,169047,2022-03-13
CASH_OUT,14561,Nath Loiseau,20051,5490,Agence_moov_Abomey,300000,285439,2022-03-17
TRANSFER,828388,Constance Bourdon-Millet,1389893,561505,Nath Loiseau,5490,833878,2022-03-18
CASH_IN,252512,Agence_moov_Cotonou,300000,47488,Nath Loiseau,833878,1086390,2022-03-19
CASH_IN,234307,Agence_moov_Cotonou,300000,65693,Nath Loiseau,1086390,1320697,2022-03-19
CASH_IN,63700,Agence_moov_Abomey,300000,236300,Nath Loiseau,1320697,1384397,2022-03-20
CASH_OUT,277727,Nath Loiseau,1384397,1106670,Agence_moov_Abomey,300000,22273,2022-03-20
TRANSFER,490946,Nath Loiseau,1106670,615724,Robert-Louis Gosselin,386244,-104702,2022-03-21
TRANSFER,169747,Nath Loiseau,615724,445977,Lucy Lamy,892,-168855,2022-03-23
CASH_OUT,271971,Nath Loiseau,445977,174006,Agence_moov_Abomey,300000,28029,2022-03-24
TRANSFER,2173,Manon Valette,3290,1117,Nath Loiseau,174006,176179,2022-03-24
TRANSFER,457302,Émilie du Allain,503700,46398,Nath Loiseau,176179,633481,2022-03-26
CASH_OUT,80499,Nath Loiseau,633481,552982,Agence_moov_Ouidah,300000,219501,2022-03-26
CASH_OUT,34880,Nath Loiseau,552982,518102,Agence_moov_Abomey,300000,265120,2022-03-27
TRANSFER,207455,Alix Barbe,835101,627646,Nath Loiseau,518102,725557,2022-03-27
CASH_IN,275370,Agence_moov_Abomey,300000,24630,Noémi Bouvier,141918,417288,2022-03-02
CASH_IN,275206,Agence_moov_Ouidah,300000,24794,Noémi Bouvier,417288,692494,2022-03-02
CASH_IN,37865,Agence_moov_Cotonou,300000,262135,Noémi Bouvier,692494,730359,2022-03-03
CASH_IN,241238,Agence_moov_Cotonou,300000,58762,Noémi Bouvier,730359,971597,2022-03-04
CASH_OUT,153454,Noémi Bouvier,971597,818143,Agence_moov_Abomey,300000,146546,2022-03-05
CASH_OUT,462203,Noémi Bouvier,818143,355940,Agence_moov_Ouidah,300000,-162203,2022-03-05
TRANSFER,76304,Noémi Bouvier,355940,279636,Alix Barbe,627646,551342,2022-03-05
TRANSFER,9857,Michelle-Dorothée Lévêque,55582,45725,Noémi Bouvier,279636,289493,2022-03-06
TRANSFER,11268,Noémi Bouvier,289493,278225,Thomas-Robert Morvan,1016729,1005461,2022-03-06
CASH_OUT,41290,Noémi Bouvier,278225,236935,Agence_moov_Cotonou,300000,258710,2022-03-08
TRANSFER,167429,Noémi Bouvier,236935,69506,Victor Michel,1488413,1320984,2022-03-09
CASH_IN,216901,Agence_moov_Cotonou,300000,83099,Noémi Bouvier,69506,286407,2022-03-12
CASH_OUT,20047,Noémi Bouvier,286407,266360,Agence_moov_Ouidah,300000,279953,2022-03-12
TRANSFER,116710,Anastasie Cousin,123276,6566,Noémi Bouvier,266360,383070,2022-03-12
CASH_IN,115208,Agence_moov_Abomey,300000,184792,Noémi Bouvier,383070,498278,2022-03-13
TRANSFER,463887,Noémi Bouvier,498278,34391,Robert Laroche,936409,472522,2022-03-17
CASH_OUT,16259,Noémi Bouvier,34391,18132,Agence_moov_Ouidah,300000,283741,2022-03-18
TRANSFER,3544,Noémi Bouvier,18132,14588,Alphonse Joly,35378,31834,2022-03-20
TRANSFER,9806,Noémi Bouvier,14588,4782,Emmanuel Grégoire,506766,496960,2022-03-23
CASH_IN,234418,Agence_moov_Ouidah,300000,65582,Noémi Bouvier,4782,239200,2022-03-24
CASH_IN,111837,Agence_moov_Cotonou,300000,188163,Noémi Bouvier,239200,351037,2022-03-24
CASH_OUT,4486,Noémi Bouvier,351037,346551,Agence_moov_Abomey,300000,295514,2022-03-25
CASH_OUT,140167,Noémi Bouvier,346551,206384,Agence_moov_Ouidah,300000,159833,2022-03-27
CASH_IN,83408,Agence_moov_Cotonou,300000,216592,Lucy Lamy,-168855,-85447,2022-03-01
CASH_IN,103408,Agence_moov_Cotonou,300000,196592,Lucy Lamy,-85447,17961,2022-03-01
CASH_OUT,4343,Lucy Lamy,17961,13618,Agence_moov_Cotonou,300000,295657,2022-03-02
CASH_OUT,1743,Lucy Lamy,13618,11875,Agence_moov_Cotonou,300000,298257,2022-03-03
CASH_OUT,7130,Lucy Lamy,11875,4745,Agence_moov_Ouidah,300000,292870,2022-03-04
CASH_IN,266351,Agence_moov_Ouidah,300000,33649,Lucy Lamy,4745,271096,2022-03-06
CASH_OUT,147012,Lucy Lamy,271096,124084,Agence_moov_Cotonou,300000,152988,2022-03-09
CASH_OUT,98916,Lucy Lamy,124084,25168,Agence_moov_Ouidah,300000,201084,2022-03-10
CASH_OUT,2509,Lucy Lamy,25168,22659,Agence_moov_Ouidah,300000,297491,2022-03-11
CASH_IN,62955,Agence_moov_Abomey,300000,237045,Lucy Lamy,22659,85614,2022-03-13
CASH_OUT,28380,Lucy Lamy,85614,57234,Agence_moov_Abomey,300000,271620,2022-03-17
CASH_IN,35926,Agence_moov_Cotonou,300000,264074,Lucy Lamy,57234,93160,2022-03-20
CASH_OUT,67237,Lucy Lamy,93160,25923,Agence_moov_Abomey,300000,232763,2022-03-21
CASH_OUT,12377,Lucy Lamy,25923,13546,Agence_moov_Abomey,300000,287623,2022-03-22
TRANSFER,9276,Lucy Lamy,13546,4270,Robert Laroche,472522,463246,2022-03-22
CASH_IN,176985,Agence_moov_Abomey,300000,123015,Lucy Lamy,4270,181255,2022-03-24
CASH_IN,111355,Agence_moov_Abomey,300000,188645,Lucy Lamy,181255,292610,2022-03-24
CASH_IN,122372,Agence_moov_Cotonou,300000,177628,Lucy Lamy,292610,414982,2022-03-24
CASH_IN,189400,Agence_moov_Cotonou,300000,110600,Lucy Lamy,414982,604382,2022-03-26
CASH_IN,113087,Agence_moov_Cotonou,300000,186913,Lucy Lamy,604382,717469,2022-03-26
CASH_IN,138296,Agence_moov_Cotonou,300000,161704,Lucy Lamy,717469,855765,2022-03-27
TRANSFER,600942,Lucy Lamy,855765,254823,Émile-René Baudry,540692,-60250,2022-03-27
CASH_IN,134520,Agence_moov_Abomey,300000,165480,Lucy Lamy,254823,389343,2022-03-27
TRANSFER,52055,Manon Lebon,78496,26441,Emmanuel Grégoire,496960,549015,2022-03-01
TRANSFER,223896,Emmanuel Grégoire,549015,325119,Vincent Joubert,59541,-164355,2022-03-01
CASH_IN,217368,Agence_moov_Ouidah,300000,82632,Emmanuel Grégoire,325119,542487,2022-03-01
CASH_IN,17496,Agence_moov_Ouidah,300000,282504,Emmanuel Grégoire,542487,559983,2022-03-05
CASH_OUT,495419,Emmanuel Grégoire,559983,64564,Agence_moov_Ouidah,300000,-195419,2022-03-08
CASH_IN,94117,Agence_moov_Cotonou,300000,205883,Emmanuel Grégoire,64564,158681,2022-03-09
CASH_IN,91882,Agence_moov_Cotonou,300000,208118,Emmanuel Grégoire,158681,250563,2022-03-09
TRANSFER,27803,Alphonse Joly,31834,4031,Emmanuel Grégoire,250563,278366,2022-03-10
CASH_IN,37342,Agence_moov_Cotonou,300000,262658,Emmanuel Grégoire,278366,315708,2022-03-10
TRANSFER,219745,Emmanuel Grégoire,315708,95963,Victor Michel,1320984,1101239,2022-03-12
TRANSFER,7775,Emmanuel Grégoire,95963,88188,Paulette Loiseau,87706,79931,2022-03-13
CASH_IN,209985,Agence_moov_Abomey,300000,90015,Emmanuel Grégoire,88188,298173,2022-03-14
TRANSFER,776407,Thomas-Robert Morvan,1005461,229054,Emmanuel Grégoire,298173,1074580,2022-03-14
CASH_IN,231158,Agence_moov_Ouidah,300000,68842,Emmanuel Grégoire,1074580,1305738,2022-03-15
CASH_OUT,1120638,Emmanuel Grégoire,1305738,185100,Agence_moov_Cotonou,300000,-820638,2022-03-15
CASH_OUT,152568,Emmanuel Grégoire,185100,32532,Agence_moov_Ouidah,300000,147432,2022-03-17
TRANSFER,101132,Alix Barbe,551342,450210,Emmanuel Grégoire,32532,133664,2022-03-18
CASH_IN,198972,Agence_moov_Ouidah,300000,101028,Emmanuel Grégoire,133664,332636,2022-03-18
TRANSFER,73872,Françoise Morin,117800,43928,Emmanuel Grégoire,332636,406508,2022-03-19
CASH_IN,73405,Agence_moov_Abomey,300000,226595,Emmanuel Grégoire,406508,479913,2022-03-19
TRANSFER,418198,Emmanuel Grégoire,479913,61715,Robert Laroche,463246,45048,2022-03-20
CASH_IN,266791,Agence_moov_Ouidah,300000,33209,Emmanuel Grégoire,61715,328506,2022-03-22
CASH_OUT,83747,Emmanuel Grégoire,328506,244759,Agence_moov_Cotonou,300000,216253,2022-03-26
CASH_IN,268162,Agence_moov_Ouidah,300000,31838,Emmanuel Grégoire,244759,512921,2022-03-26
TRANSFER,308366,Emmanuel Grégoire,512921,204555,Paulette Loiseau,79931,-228435,2022-03-26
CASH_OUT,85810,Emmanuel Grégoire,204555,118745,Agence_moov_Ouidah,300000,214190,2022-03-27
CASH_OUT,64078,Emmanuel Grégoire,118745,54667,Agence_moov_Cotonou,300000,235922,2022-03-27
CASH_IN,63285,Agence_moov_Ouidah,300000,236715,Michelle Samson,17689,80974,2022-03-01
CASH_OUT,27821,Michelle Samson,80974,53153,Agence_moov_Cotonou,300000,272179,2022-03-02
CASH_IN,284054,Agence_moov_Cotonou,300000,15946,Michelle Samson,53153,337207,2022-03-03
CASH_IN,224064,Agence_moov_Cotonou,300000,75936,Michelle Samson,337207,561271,2022-03-04
TRANSFER,128566,Michelle Samson,561271,432705,Anne Peltier-Raynaud,302550,173984,2022-03-06
TRANSFER,12890,Michelle-Dorothée Lévêque,45725,32835,Michelle Samson,432705,445595,2022-03-13
TRANSFER,3153,Suzanne Bodin,6133,2980,Michelle Samson,445595,448748,2022-03-14
TRANSFER,347595,Michelle Samson,448748,101153,Thibaut de la Lombard,1474172,1126577,2022-03-15
TRANSFER,493347,Antoinette de Dupuis,824019,330672,Michelle Samson,101153,594500,2022-03-16
TRANSFER,76516,Michelle Samson,594500,517984,Manon Chevalier,741621,665105,2022-03-17
CASH_IN,175713,Agence_moov_Ouidah,300000,124287,Michelle Samson,517984,693697,2022-03-20
CASH_IN,183343,Agence_moov_Ouidah,300000,116657,Michelle Samson,693697,877040,2022-03-22
CASH_IN,291196,Agence_moov_Cotonou,300000,8804,Michelle Samson,877040,1168236,2022-03-23
CASH_IN,224197,Agence_moov_Ouidah,300000,75803,Michelle Samson,1168236,1392433,2022-03-24
CASH_OUT,1205611,Michelle Samson,1392433,186822,Agence_moov_Ouidah,300000,-905611,2022-03-25
TRANSFER,28164,Françoise Morin,43928,15764,Michelle Samson,186822,214986,2022-03-25
TRANSFER,132457,Michelle Samson,214986,82529,Luc Lévêque-Carre,67724,-64733,2022-03-25
CASH_IN,78559,Agence_moov_Cotonou,300000,221441,Michelle Samson,82529,161088,2022-03-26
CASH_IN,64226,Agence_moov_Ouidah,300000,235774,Vincent de la Dumont,-291927,-227701,2022-03-01
CASH_IN,87371,Agence_moov_Ouidah,300000,212629,Vincent de la Dumont,-227701,-140330,2022-03-08
CASH_IN,45333,Agence_moov_Abomey,300000,254667,Vincent de la Dumont,-140330,-94997,2022-03-17
CASH_IN,270985,Agence_moov_Ouidah,300000,29015,Vincent de la Dumont,-94997,175988,2022-03-21
CASH_IN,182871,Agence_moov_Ouidah,300000,117129,Vincent de la Dumont,175988,358859,2022-03-24
CASH_IN,28890,Agence_moov_Cotonou,300000,271110,Vincent de la Dumont,358859,387749,2022-03-27
CASH_IN,74447,Agence_moov_Ouidah,300000,225553,Robert-Louis Gosselin,-104702,-30255,2022-03-02
CASH_IN,82680,Agence_moov_Cotonou,300000,217320,Robert-Louis Gosselin,-30255,52425,2022-03-04
CASH_OUT,31157,Robert-Louis Gosselin,52425,21268,Agence_moov_Abomey,300000,268843,2022-03-06
TRANSFER,2181,Robert-Louis Gosselin,21268,19087,Robert-Louis Gosselin,21268,23449,2022-03-06
CASH_IN,29078,Agence_moov_Cotonou,300000,270922,Robert-Louis Gosselin,19087,48165,2022-03-07
CASH_IN,97910,Agence_moov_Cotonou,300000,202090,Robert-Louis Gosselin,48165,146075,2022-03-07
CASH_OUT,55420,Robert-Louis Gosselin,146075,90655,Agence_moov_Cotonou,300000,244580,2022-03-12
CASH_IN,63512,Agence_moov_Abomey,300000,236488,Robert-Louis Gosselin,90655,154167,2022-03-14
CASH_OUT,129579,Robert-Louis Gosselin,154167,24588,Agence_moov_Ouidah,300000,170421,2022-03-15
TRANSFER,3337,Robert-Louis Gosselin,24588,21251,Lucy Gillet,82504,79167,2022-03-15
CASH_OUT,21130,Robert-Louis Gosselin,21251,121,Agence_moov_Ouidah,300000,278870,2022-03-19
CASH_OUT,111,Robert-Louis Gosselin,121,10,Agence_moov_Abomey,300000,299889,2022-03-20
CASH_IN,157571,Agence_moov_Ouidah,300000,142429,Robert-Louis Gosselin,10,157581,2022-03-21
CASH_OUT,90457,Robert-Louis Gosselin,157581,67124,Agence_moov_Ouidah,300000,209543,2022-03-23
CASH_OUT,58790,Robert-Louis Gosselin,67124,8334,Agence_moov_Ouidah,300000,241210,2022-03-27
CASH_IN,282080,Agence_moov_Ouidah,300000,17920,Émile-René Baudry,-60250,221830,2022-03-01
TRANSFER,107,Paul Rocher-Maillet,329,222,Émile-René Baudry,221830,221937,2022-03-09
TRANSFER,15341,Françoise Morin,15764,423,Émile-René Baudry,221937,237278,2022-03-09
TRANSFER,65622,Émile-René Baudry,237278,171656,Antoinette de Dupuis,330672,265050,2022-03-13
CASH_IN,234068,Agence_moov_Abomey,300000,65932,Émile-René Baudry,171656,405724,2022-03-15
CASH_IN,268815,Agence_moov_Ouidah,300000,31185,Émile-René Baudry,405724,674539,2022-03-22
TRANSFER,615679,Émile-René Baudry,674539,58860,Marc Leleu,563000,-52679,2022-03-24
CASH_IN,196335,Agence_moov_Ouidah,300000,103665,Manon Valette,1117,197452,2022-03-02
TRANSFER,13925,Manon Valette,197452,183527,Manon Lebon,26441,12516,2022-03-04
CASH_IN,212542,Agence_moov_Cotonou,300000,87458,Manon Valette,183527,396069,2022-03-04
TRANSFER,208530,Antoinette de Dupuis,265050,56520,Manon Valette,396069,604599,2022-03-08
TRANSFER,380435,Manon Valette,604599,224164,Paul Rocher-Maillet,222,-380213,2022-03-09
CASH_IN,28455,Agence_moov_Cotonou,300000,271545,Manon Valette,224164,252619,2022-03-13
CASH_IN,202602,Agence_moov_Cotonou,300000,97398,Manon Valette,252619,455221,2022-03-14
TRANSFER,197,Françoise Morin,423,226,Manon Valette,455221,455418,2022-03-14
CASH_IN,274548,Agence_moov_Abomey,300000,25452,Manon Valette,455418,729966,2022-03-14
CASH_IN,195676,Agence_moov_Cotonou,300000,104324,Manon Valette,729966,925642,2022-03-15
TRANSFER,790044,Manon Valette,925642,135598,Michelle-Dorothée Lévêque,32835,-757209,2022-03-15
CASH_IN,109551,Agence_moov_Abomey,300000,190449,Manon Valette,135598,245149,2022-03-16
TRANSFER,110472,Manon Valette,245149,134677,Alphonse Joly,4031,-106441,2022-03-20
TRANSFER,90922,Manon Valette,134677,43755,Antoinette de Dupuis,56520,-34402,2022-03-22
TRANSFER,42871,Manon Valette,43755,884,Manon Lebon,12516,-30355,2022-03-22
TRANSFER,451,Manon Valette,884,433,Thomas-Robert Morvan,229054,228603,2022-03-26
TRANSFER,201,Manon Valette,433,232,Alix Barbe,450210,450009,2022-03-26
CASH_OUT,42723,Tristan Gomez,276149,233426,Agence_moov_Abomey,300000,257277,2022-03-01
CASH_IN,266847,Agence_moov_Abomey,300000,33153,Tristan Gomez,233426,500273,2022-03-02
CASH_OUT,110121,Tristan Gomez,500273,390152,Agence_moov_Cotonou,300000,189879,2022-03-06
CASH_IN,226906,Agence_moov_Abomey,300000,73094,Tristan Gomez,390152,617058,2022-03-06
CASH_OUT,201985,Tristan Gomez,617058,415073,Agence_moov_Ouidah,300000,98015,2022-03-08
CASH_IN,148233,Agence_moov_Ouidah,300000,151767,Tristan Gomez,415073,563306,2022-03-08
TRANSFER,194131,Léon Da Costa,285229,91098,Tristan Gomez,563306,757437,2022-03-09
CASH_IN,178451,Agence_moov_Abomey,300000,121549,Tristan Gomez,757437,935888,2022-03-10
CASH_IN,170317,Agence_moov_Abomey,300000,129683,Tristan Gomez,935888,1106205,2022-03-12
CASH_OUT,604645,Tristan Gomez,1106205,501560,Agence_moov_Cotonou,300000,-304645,2022-03-12
TRANSFER,2109,Anastasie Cousin,6566,4457,Tristan Gomez,501560,503669,2022-03-13
TRANSFER,115759,Anne Peltier-Raynaud,173984,58225,Tristan Gomez,503669,619428,2022-03-13
CASH_IN,248105,Agence_moov_Ouidah,300000,51895,Tristan Gomez,619428,867533,2022-03-14
TRANSFER,39308,Lucy Gillet,79167,39859,Tristan Gomez,867533,906841,2022-03-14
CASH_IN,154247,Agence_moov_Ouidah,300000,145753,Tristan Gomez,906841,1061088,2022-03-16
CASH_IN,121756,Agence_moov_Ouidah,300000,178244,Tristan Gomez,1061088,1182844,2022-03-18
CASH_IN,11646,Agence_moov_Cotonou,300000,288354,Tristan Gomez,1182844,1194490,2022-03-22
TRANSFER,1119,Anastasie Cousin,4457,3338,Tristan Gomez,1194490,1195609,2022-03-24
CASH_IN,77278,Agence_moov_Ouidah,300000,222722,Tristan Gomez,1195609,1272887,2022-03-24
CASH_IN,62090,Agence_moov_Abomey,300000,237910,Tristan Gomez,1272887,1334977,2022-03-24
CASH_IN,164233,Agence_moov_Ouidah,300000,135767,Antoinette de Dupuis,-34402,129831,2022-03-01
CASH_IN,297040,Agence_moov_Ouidah,300000,2960,Antoinette de Dupuis,129831,426871,2022-03-06
CASH_IN,207739,Agence_moov_Ouidah,300000,92261,Antoinette de Dupuis,426871,634610,2022-03-08
CASH_OUT,576621,Antoinette de Dupuis,634610,57989,Agence_moov_Ouidah,300000,-276621,2022-03-09
CASH_IN,204166,Agence_moov_Ouidah,300000,95834,Antoinette de Dupuis,57989,262155,2022-03-09
CASH_OUT,149175,Antoinette de Dupuis,262155,112980,Agence_moov_Abomey,300000,150825,2022-03-11
TRANSFER,73999,Antoinette de Dupuis,112980,38981,Suzanne Bodin,2980,-71019,2022-03-11
TRANSFER,695367,Thibaut de la Lombard,1126577,431210,Antoinette de Dupuis,38981,734348,2022-03-12
CASH_IN,288452,Agence_moov_Ouidah,300000,11548,Antoinette de Dupuis,734348,1022800,2022-03-13
CASH_IN,97531,Agence_moov_Cotonou,300000,202469,Antoinette de Dupuis,1022800,1120331,2022-03-14
CASH_IN,133449,Agence_moov_Abomey,300000,166551,Antoinette de Dupuis,1120331,1253780,2022-03-14
TRANSFER,145,Françoise Morin,226,81,Antoinette de Dupuis,1253780,1253925,2022-03-15
CASH_IN,279943,Agence_moov_Cotonou,300000,20057,Antoinette de Dupuis,1253925,1533868,2022-03-21
CASH_OUT,398134,Antoinette de Dupuis,1533868,1135734,Agence_moov_Cotonou,300000,-98134,2022-03-22
CASH_IN,114501,Agence_moov_Cotonou,300000,185499,Antoinette de Dupuis,1135734,1250235,2022-03-22
CASH_IN,181195,Agence_moov_Ouidah,300000,118805,Antoinette de Dupuis,1250235,1431430,2022-03-23
CASH_IN,134223,Agence_moov_Ouidah,300000,165777,Antoinette de Dupuis,1431430,1565653,2022-03-25
CASH_IN,256172,Agence_moov_Abomey,300000,43828,Antoinette de Dupuis,1565653,1821825,2022-03-26
CASH_IN,296453,Agence_moov_Abomey,300000,3547,Françoise Morin,81,296534,2022-03-04
CASH_OUT,204461,Françoise Morin,296534,92073,Agence_moov_Abomey,300000,95539,2022-03-05
CASH_IN,224555,Agence_moov_Ouidah,300000,75445,Françoise Morin,92073,316628,2022-03-08
CASH_OUT,89249,Françoise Morin,316628,227379,Agence_moov_Abomey,300000,210751,2022-03-11
CASH_IN,167197,Agence_moov_Abomey,300000,132803,Françoise Morin,227379,394576,2022-03-14
TRANSFER,37916,Françoise Morin,394576,356660,Émilie du Allain,46398,8482,2022-03-15
CASH_IN,140998,Agence_moov_Abomey,300000,159002,Françoise Morin,356660,497658,2022-03-20
CASH_OUT,103890,Françoise Morin,497658,393768,Agence_moov_Abomey,300000,196110,2022-03-24
CASH_IN,262037,Agence_moov_Cotonou,300000,37963,Françoise Morin,393768,655805,2022-03-25
TRANSFER,734507,Victor Michel,1101239,366732,Françoise Morin,655805,1390312,2022-03-25
TRANSFER,222863,Thibaut de la Lombard,431210,208347,Françoise Morin,1390312,1613175,2022-03-25
CASH_IN,186833,Agence_moov_Cotonou,300000,113167,Mathilde de la Samson,-80877,105956,2022-03-01
CASH_IN,264320,Agence_moov_Cotonou,300000,35680,Mathilde de la Samson,105956,370276,2022-03-03
CASH_OUT,278867,Mathilde de la Samson,370276,91409,Agence_moov_Ouidah,300000,21133,2022-03-03
CASH_IN,126909,Agence_moov_Cotonou,300000,173091,Mathilde de la Samson,91409,218318,2022-03-06
TRANSFER,156578,Mathilde de la Samson,218318,61740,Manon Chevalier,665105,508527,2022-03-07
CASH_IN,176357,Agence_moov_Ouidah,300000,123643,Mathilde de la Samson,61740,238097,2022-03-12
CASH_IN,292881,Agence_moov_Ouidah,300000,7119,Mathilde de la Samson,238097,530978,2022-03-16
CASH_OUT,42101,Mathilde de la Samson,530978,488877,Agence_moov_Ouidah,300000,257899,2022-03-24
TRANSFER,195721,Thomas-Robert Morvan,228603,32882,Anne Peltier-Raynaud,58225,-137496,2022-03-05
CASH_OUT,1427,Thomas-Robert Morvan,32882,31455,Agence_moov_Cotonou,300000,298573,2022-03-06
CASH_IN,267449,Agence_moov_Cotonou,300000,32551,Thomas-Robert Morvan,31455,298904,2022-03-06
CASH_OUT,59576,Thomas-Robert Morvan,298904,239328,Agence_moov_Ouidah,300000,240424,2022-03-06
TRANSFER,53087,Noël Bourgeois,1342059,1288972,Thomas-Robert Morvan,239328,292415,2022-03-08
TRANSFER,81627,Thomas-Robert Morvan,292415,210788,Constance Bourdon-Millet,561505,479878,2022-03-09
CASH_IN,50959,Agence_moov_Cotonou,300000,249041,Thomas-Robert Morvan,210788,261747,2022-03-10
CASH_IN,9428,Agence_moov_Cotonou,300000,290572,Thomas-Robert Morvan,261747,271175,2022-03-20
TRANSFER,2881,Anastasie Cousin,3338,457,Thomas-Robert Morvan,271175,274056,2022-03-23
CASH_IN,136991,Agence_moov_Cotonou,300000,163009,Thomas-Robert Morvan,274056,411047,2022-03-25
CASH_IN,278857,Agence_moov_Abomey,300000,21143,Robert Laroche,45048,323905,2022-03-01
CASH_OUT,105959,Robert Laroche,323905,217946,Agence_moov_Abomey,300000,194041,2022-03-03
TRANSFER,64758,Robert Laroche,217946,153188,Léon Da Costa,91098,26340,2022-03-07
TRANSFER,102459,Robert Laroche,153188,50729,Léon Da Costa,26340,-76119,2022-03-12
TRANSFER,164,Anastasie Cousin,457,293,Robert Laroche,50729,50893,2022-03-15
CASH_OUT,7504,Robert Laroche,50893,43389,Agence_moov_Abomey,300000,292496,2022-03-15
TRANSFER,40206,Robert Laroche,43389,3183,Manon Chevalier,508527,468321,2022-03-15
TRANSFER,221,Robert Laroche,3183,2962,Manon Chevalier,468321,468100,2022-03-16
CASH_IN,160745,Agence_moov_Cotonou,300000,139255,Robert Laroche,2962,163707,2022-03-16
CASH_IN,109567,Agence_moov_Abomey,300000,190433,Robert Laroche,163707,273274,2022-03-17
CASH_IN,226260,Agence_moov_Cotonou,300000,73740,Robert Laroche,273274,499534,2022-03-18
TRANSFER,110345,Robert Laroche,499534,389189,Robert Laroche,499534,389189,2022-03-19
TRANSFER,100981,Robert Laroche,389189,288208,Lucy Gillet,39859,-61122,2022-03-20
TRANSFER,2106,Robert Laroche,288208,286102,Noël Bourgeois,1288972,1286866,2022-03-21
CASH_OUT,246247,Robert Laroche,286102,39855,Agence_moov_Abomey,300000,53753,2022-03-22
CASH_OUT,11456,Robert Laroche,39855,28399,Agence_moov_Abomey,300000,288544,2022-03-22
CASH_OUT,12115,Robert Laroche,28399,16284,Agence_moov_Abomey,300000,287885,2022-03-22
CASH_OUT,7538,Robert Laroche,16284,8746,Agence_moov_Abomey,300000,292462,2022-03-24
CASH_OUT,4342,Robert Laroche,8746,4404,Agence_moov_Cotonou,300000,295658,2022-03-25
CASH_IN,68493,Agence_moov_Cotonou,300000,231507,Robert Laroche,4404,72897,2022-03-25
CASH_OUT,84331,Alix Barbe,450009,365678,Agence_moov_Abomey,300000,215669,2022-03-04
TRANSFER,67853,Alix Barbe,365678,297825,Thibaut de la Lombard,208347,140494,2022-03-04
CASH_IN,27529,Agence_moov_Abomey,300000,272471,Alix Barbe,297825,325354,2022-03-05
CASH_IN,118515,Agence_moov_Ouidah,300000,181485,Alix Barbe,325354,443869,2022-03-05
CASH_IN,214957,Agence_moov_Ouidah,300000,85043,Alix Barbe,443869,658826,2022-03-06
CASH_OUT,252268,Alix Barbe,658826,406558,Agence_moov_Cotonou,300000,47732,2022-03-06
CASH_OUT,388479,Alix Barbe,406558,18079,Agence_moov_Ouidah,300000,-88479,2022-03-07
CASH_IN,170676,Agence_moov_Ouidah,300000,129324,Alix Barbe,18079,188755,2022-03-07
CASH_IN,188296,Agence_moov_Abomey,300000,111704,Alix Barbe,188755,377051,2022-03-11
CASH_OUT,354673,Alix Barbe,377051,22378,Agence_moov_Ouidah,300000,-54673,2022-03-12
CASH_OUT,20504,Alix Barbe,22378,1874,Agence_moov_Abomey,300000,279496,2022-03-13
TRANSFER,1375,Alix Barbe,1874,499,Victor Michel,366732,365357,2022-03-15
CASH_IN,247167,Agence_moov_Cotonou,300000,52833,Alix Barbe,499,247666,2022-03-18
TRANSFER,194,Alix Barbe,247666,247472,Victor Michel,365357,365163,2022-03-21
CASH_OUT,37577,Alix Barbe,247472,209895,Agence_moov_Cotonou,300000,262423,2022-03-21
TRANSFER,77679,Alix Barbe,209895,132216,Constance Bourdon-Millet,479878,402199,2022-03-23
CASH_OUT,10173,Alix Barbe,132216,122043,Agence_moov_Abomey,300000,289827,2022-03-24
CASH_OUT,32346,Alix Barbe,122043,89697,Agence_moov_Abomey,300000,267654,2022-03-24
CASH_IN,81186,Agence_moov_Cotonou,300000,218814,Paul Rocher-Maillet,-380213,-299027,2022-03-01
CASH_IN,41760,Agence_moov_Abomey,300000,258240,Paul Rocher-Maillet,-299027,-257267,2022-03-01
CASH_IN,180654,Agence_moov_Ouidah,300000,119346,Paul Rocher-Maillet,-257267,-76613,2022-03-03
CASH_IN,160204,Agence_moov_Cotonou,300000,139796,Paul Rocher-Maillet,-76613,83591,2022-03-09
TRANSFER,38868,Paul Rocher-Maillet,83591,44723,Manon Chevalier,468100,429232,2022-03-09
CASH_OUT,3699,Paul Rocher-Maillet,44723,41024,Agence_moov_Ouidah,300000,296301,2022-03-10
TRANSFER,298449,Victor Michel,365163,66714,Paul Rocher-Maillet,41024,339473,2022-03-11
CASH_IN,6563,Agence_moov_Abomey,300000,293437,Paul Rocher-Maillet,339473,346036,2022-03-17
CASH_IN,50949,Agence_moov_Abomey,300000,249051,Paul Rocher-Maillet,346036,396985,2022-03-17
CASH_IN,69147,Agence_moov_Ouidah,300000,230853,Paul Rocher-Maillet,396985,466132,2022-03-20
CASH_IN,134542,Agence_moov_Abomey,300000,165458,Paul Rocher-Maillet,466132,600674,2022-03-26
CASH_IN,239666,Agence_moov_Ouidah,300000,60334,Agnès Le Giraud,-653976,-414310,2022-03-01
CASH_IN,142272,Agence_moov_Cotonou,300000,157728,Agnès Le Giraud,-414310,-272038,2022-03-05
CASH_IN,265651,Agence_moov_Cotonou,300000,34349,Agnès Le Giraud,-272038,-6387,2022-03-05
CASH_IN,270286,Agence_moov_Cotonou,300000,29714,Agnès Le Giraud,-6387,263899,2022-03-07
CASH_OUT,50444,Agnès Le Giraud,263899,213455,Agence_moov_Cotonou,300000,249556,2022-03-11
CASH_IN,24965,Agence_moov_Cotonou,300000,275035,Agnès Le Giraud,213455,238420,2022-03-14
CASH_IN,213057,Agence_moov_Ouidah,300000,86943,Agnès Le Giraud,238420,451477,2022-03-15
TRANSFER,32124,Thibaut de la Lombard,140494,108370,Agnès Le Giraud,451477,483601,2022-03-25
CASH_IN,271419,Agence_moov_Ouidah,300000,28581,Thérèse François,-170008,101411,2022-03-05
CASH_IN,6003,Agence_moov_Ouidah,300000,293997,Thérèse François,101411,107414,2022-03-08
CASH_OUT,30096,Thérèse François,107414,77318,Agence_moov_Cotonou,300000,269904,2022-03-09
TRANSFER,260824,Manon Chevalier,429232,168408,Thérèse François,77318,338142,2022-03-09
CASH_OUT,107692,Thérèse François,338142,230450,Agence_moov_Cotonou,300000,192308,2022-03-10
TRANSFER,91106,Thérèse François,230450,139344,Noël Bourgeois,1286866,1195760,2022-03-12
TRANSFER,41519,Thérèse François,139344,97825,Constance Bourdon-Millet,402199,360680,2022-03-13
TRANSFER,546,Émilie du Allain,8482,7936,Thérèse François,97825,98371,2022-03-14
CASH_OUT,65484,Thérèse François,98371,32887,Agence_moov_Abomey,300000,234516,2022-03-15
CASH_IN,111758,Agence_moov_Ouidah,300000,188242,Thérèse François,32887,144645,2022-03-15
TRANSFER,17673,Victor Michel,66714,49041,Thérèse François,144645,162318,2022-03-17
CASH_IN,45297,Agence_moov_Cotonou,300000,254703,Thérèse François,162318,207615,2022-03-19
TRANSFER,16025,Manon Chevalier,168408,152383,Thérèse François,207615,223640,2022-03-21
CASH_IN,69053,Agence_moov_Abomey,300000,230947,Thérèse François,223640,292693,2022-03-22
CASH_OUT,69904,Thérèse François,292693,222789,Agence_moov_Ouidah,300000,230096,2022-03-22
TRANSFER,159638,Thérèse François,222789,63151,Constance Bourdon-Millet,360680,201042,2022-03-23
CASH_IN,8910,Agence_moov_Cotonou,300000,291090,Thérèse François,63151,72061,2022-03-24
CASH_IN,162506,Agence_moov_Cotonou,300000,137494,Thérèse François,72061,234567,2022-03-26
TRANSFER,185244,Thérèse François,234567,49323,Noël Bourgeois,1195760,1010516,2022-03-27
TRANSFER,5899,Émilie du Allain,7936,2037,Émilie du Allain,7936,13835,2022-03-03
CASH_IN,97389,Agence_moov_Cotonou,300000,202611,Émilie du Allain,2037,99426,2022-03-07
CASH_IN,258424,Agence_moov_Ouidah,300000,41576,Émilie du Allain,99426,357850,2022-03-11
CASH_OUT,57898,Émilie du Allain,357850,299952,Agence_moov_Cotonou,300000,242102,2022-03-12
TRANSFER,68314,Émilie du Allain,299952,231638,Manon Chevalier,152383,84069,2022-03-13
TRANSFER,197928,Constance Bourdon-Millet,201042,3114,Émilie du Allain,231638,429566,2022-03-13
CASH_OUT,165644,Émilie du Allain,429566,263922,Agence_moov_Abomey,300000,134356,2022-03-14
CASH_OUT,121793,Émilie du Allain,263922,142129,Agence_moov_Abomey,300000,178207,2022-03-18
CASH_IN,183428,Agence_moov_Cotonou,300000,116572,Émilie du Allain,142129,325557,2022-03-18
CASH_OUT,202324,Émilie du Allain,325557,123233,Agence_moov_Abomey,300000,97676,2022-03-19
TRANSFER,123201,Émilie du Allain,123233,32,Émilie du Allain,123233,246434,2022-03-20
CASH_IN,35239,Agence_moov_Abomey,300000,264761,Émilie du Allain,32,35271,2022-03-20
TRANSFER,41036,Victor Michel,49041,8005,Émilie du Allain,35271,76307,2022-03-21
CASH_IN,25109,Agence_moov_Ouidah,300000,274891,Émilie du Allain,76307,101416,2022-03-24
CASH_IN,199053,Agence_moov_Cotonou,300000,100947,Émilie du Allain,101416,300469,2022-03-26
CASH_IN,7369,Agence_moov_Cotonou,300000,292631,Suzanne Bodin,-71019,-63650,2022-03-01
CASH_IN,117759,Agence_moov_Abomey,300000,182241,Suzanne Bodin,-63650,54109,2022-03-02
CASH_IN,105734,Agence_moov_Cotonou,300000,194266,Suzanne Bodin,54109,159843,2022-03-02
CASH_IN,88361,Agence_moov_Cotonou,300000,211639,Suzanne Bodin,159843,248204,2022-03-07
CASH_IN,87830,Agence_moov_Cotonou,300000,212170,Suzanne Bodin,248204,336034,2022-03-07
CASH_IN,63194,Agence_moov_Abomey,300000,236806,Suzanne Bodin,336034,399228,2022-03-07
TRANSFER,268942,Suzanne Bodin,399228,130286,Constance Bourdon-Millet,3114,-265828,2022-03-10
CASH_IN,8138,Agence_moov_Abomey,300000,291862,Suzanne Bodin,130286,138424,2022-03-10
TRANSFER,72938,Manon Chevalier,84069,11131,Suzanne Bodin,138424,211362,2022-03-13
TRANSFER,37432,Suzanne Bodin,211362,173930,Suzanne Bodin,211362,248794,2022-03-14
TRANSFER,1468,Manon Chevalier,11131,9663,Suzanne Bodin,173930,175398,2022-03-14
CASH_OUT,18108,Suzanne Bodin,175398,157290,Agence_moov_Abomey,300000,281892,2022-03-16
CASH_IN,81090,Agence_moov_Abomey,300000,218910,Suzanne Bodin,157290,238380,2022-03-19
TRANSFER,170470,Suzanne Bodin,238380,67910,Noël Bourgeois,1010516,840046,2022-03-22
CASH_OUT,44744,Suzanne Bodin,67910,23166,Agence_moov_Ouidah,300000,255256,2022-03-23
TRANSFER,2894,Manon Chevalier,9663,6769,Suzanne Bodin,23166,26060,2022-03-23
TRANSFER,9506,Suzanne Bodin,26060,16554,Noël Bourgeois,840046,830540,2022-03-24
TRANSFER,1766,Suzanne Bodin,16554,14788,Noël Bourgeois,830540,828774,2022-03-25
CASH_OUT,12110,Suzanne Bodin,14788,2678,Agence_moov_Cotonou,300000,287890,2022-03-26
CASH_IN,284992,Agence_moov_Abomey,300000,15008,Marc Leleu,-52679,232313,2022-03-01
CASH_OUT,170104,Marc Leleu,232313,62209,Agence_moov_Ouidah,300000,129896,2022-03-08
CASH_IN,73095,Agence_moov_Abomey,300000,226905,Marc Leleu,62209,135304,2022-03-10
CASH_OUT,1293,Marc Leleu,135304,134011,Agence_moov_Abomey,300000,298707,2022-03-10
CASH_OUT,38863,Marc Leleu,134011,95148,Agence_moov_Cotonou,300000,261137,2022-03-11
TRANSFER,57723,Marc Leleu,95148,37425,Marc Leleu,95148,152871,2022-03-12
CASH_IN,161921,Agence_moov_Abomey,300000,138079,Marc Leleu,37425,199346,2022-03-17
CASH_OUT,22142,Marc Leleu,199346,177204,Agence_moov_Ouidah,300000,277858,2022-03-23
CASH_OUT,34434,Marc Leleu,177204,142770,Agence_moov_Cotonou,300000,265566,2022-03-27
CASH_IN,125268,Agence_moov_Ouidah,300000,174732,Tristan Bousquet-Gros,-2119960,-1994692,2022-03-07
CASH_IN,266343,Agence_moov_Ouidah,300000,33657,Tristan Bousquet-Gros,-1994692,-1728349,2022-03-07
CASH_IN,24493,Agence_moov_Cotonou,300000,275507,Tristan Bousquet-Gros,-1728349,-1703856,2022-03-09
CASH_IN,238297,Agence_moov_Ouidah,300000,61703,Tristan Bousquet-Gros,-1703856,-1465559,2022-03-16
CASH_IN,92764,Agence_moov_Abomey,300000,207236,Tristan Bousquet-Gros,-1465559,-1372795,2022-03-22
CASH_IN,170895,Agence_moov_Ouidah,300000,129105,Tristan Bousquet-Gros,-1372795,-1201900,2022-03-26
CASH_IN,103237,Agence_moov_Abomey,300000,196763,Manon Lebon,-30355,72882,2022-03-04
CASH_OUT,69701,Manon Lebon,72882,3181,Agence_moov_Cotonou,300000,230299,2022-03-05
CASH_OUT,2142,Manon Lebon,3181,1039,Agence_moov_Ouidah,300000,297858,2022-03-05
CASH_OUT,410,Manon Lebon,1039,629,Agence_moov_Cotonou,300000,299590,2022-03-08
TRANSFER,6333,Manon Chevalier,6769,436,Manon Lebon,629,6962,2022-03-14
CASH_OUT,4614,Manon Lebon,6962,2348,Agence_moov_Abomey,300000,295386,2022-03-18
TRANSFER,236,Manon Chevalier,436,200,Manon Lebon,2348,2584,2022-03-18
TRANSFER,156,Manon Chevalier,200,44,Manon Lebon,2584,2740,2022-03-18
TRANSFER,890,Manon Lebon,2740,1850,Noël Bourgeois,828774,827884,2022-03-26
CASH_IN,181040,Agence_moov_Ouidah,300000,118960,Lucy Gillet,-61122,119918,2022-03-01
CASH_OUT,106207,Lucy Gillet,119918,13711,Agence_moov_Cotonou,300000,193793,2022-03-01
CASH_OUT,12475,Lucy Gillet,13711,1236,Agence_moov_Ouidah,300000,287525,2022-03-02
CASH_OUT,1003,Lucy Gillet,1236,233,Agence_moov_Abomey,300000,298997,2022-03-02
CASH_OUT,185,Lucy Gillet,233,48,Agence_moov_Cotonou,300000,299815,2022-03-02
CASH_IN,195991,Agence_moov_Ouidah,300000,104009,Lucy Gillet,48,196039,2022-03-09
TRANSFER,19503,Lucy Gillet,196039,176536,Lucy Gillet,196039,215542,2022-03-11
TRANSFER,134206,Lucy Gillet,176536,42330,Noël Bourgeois,827884,693678,2022-03-11
CASH_OUT,8259,Lucy Gillet,42330,34071,Agence_moov_Abomey,300000,291741,2022-03-11
TRANSFER,558508,Noël Bourgeois,693678,135170,Lucy Gillet,34071,592579,2022-03-12
TRANSFER,100208,Noël Bourgeois,135170,34962,Lucy Gillet,592579,692787,2022-03-13
TRANSFER,601799,Lucy Gillet,692787,90988,Noël Bourgeois,34962,-566837,2022-03-13
CASH_IN,188563,Agence_moov_Cotonou,300000,111437,Lucy Gillet,90988,279551,2022-03-18
CASH_IN,209454,Agence_moov_Cotonou,300000,90546,Lucy Gillet,279551,489005,2022-03-19
CASH_IN,108441,Agence_moov_Abomey,300000,191559,Lucy Gillet,489005,597446,2022-03-27
CASH_IN,79326,Agence_moov_Cotonou,300000,220674,Léon Da Costa,-76119,3207,2022-03-01
TRANSFER,710,Léon Da Costa,3207,2497,Léon Da Costa,3207,3917,2022-03-01
TRANSFER,653,Léon Da Costa,2497,1844,Léon Da Costa,2497,3150,2022-03-03
TRANSFER,345,Léon Da Costa,1844,1499,Léon Da Costa,1844,2189,2022-03-03
CASH_IN,161181,Agence_moov_Ouidah,300000,138819,Léon Da Costa,1499,162680,2022-03-04
CASH_IN,4931,Agence_moov_Cotonou,300000,295069,Léon Da Costa,162680,167611,2022-03-04
TRANSFER,68219,Léon Da Costa,167611,99392,Léon Da Costa,167611,235830,2022-03-07
CASH_OUT,98491,Léon Da Costa,99392,901,Agence_moov_Abomey,300000,201509,2022-03-07
CASH_OUT,553,Léon Da Costa,901,348,Agence_moov_Abomey,300000,299447,2022-03-08
CASH_OUT,302,Léon Da Costa,348,46,Agence_moov_Abomey,300000,299698,2022-03-09
CASH_IN,27458,Agence_moov_Ouidah,300000,272542,Léon Da Costa,46,27504,2022-03-09
CASH_OUT,21575,Léon Da Costa,27504,5929,Agence_moov_Abomey,300000,278425,2022-03-10
CASH_IN,207305,Agence_moov_Cotonou,300000,92695,Léon Da Costa,5929,213234,2022-03-12
CASH_IN,161919,Agence_moov_Abomey,300000,138081,Léon Da Costa,213234,375153,2022-03-13
CASH_IN,23090,Agence_moov_Ouidah,300000,276910,Léon Da Costa,375153,398243,2022-03-15
CASH_IN,229950,Agence_moov_Ouidah,300000,70050,Léon Da Costa,398243,628193,2022-03-15
CASH_IN,65146,Agence_moov_Ouidah,300000,234854,Léon Da Costa,628193,693339,2022-03-17
CASH_IN,6595,Agence_moov_Cotonou,300000,293405,Léon Da Costa,693339,699934,2022-03-19
CASH_IN,66770,Agence_moov_Ouidah,300000,233230,Renée Rousseau-Henry,-113003,-46233,2022-03-02
CASH_IN,92240,Agence_moov_Ouidah,300000,207760,Renée Rousseau-Henry,-46233,46007,2022-03-13
CASH_IN,19922,Agence_moov_Cotonou,300000,280078,Renée Rousseau-Henry,46007,65929,2022-03-13
TRANSFER,59549,Renée Rousseau-Henry,65929,6380,Renée Rousseau-Henry,65929,125478,2022-03-14
TRANSFER,2522,Renée Rousseau-Henry,6380,3858,Renée Rousseau-Henry,6380,3858,2022-03-16
CASH_OUT,641,Renée Rousseau-Henry,3858,3217,Agence_moov_Ouidah,300000,299359,2022-03-17
CASH_OUT,354,Renée Rousseau-Henry,3217,2863,Agence_moov_Cotonou,300000,299646,2022-03-18
CASH_IN,227856,Agence_moov_Ouidah,300000,72144,Thomas de Blin,-110883,116973,2022-03-03
CASH_IN,250269,Agence_moov_Abomey,300000,49731,Thomas de Blin,116973,367242,2022-03-04
CASH_IN,94118,Agence_moov_Abomey,300000,205882,Thomas de Blin,367242,461360,2022-03-06
CASH_IN,33832,Agence_moov_Ouidah,300000,266168,Thomas de Blin,461360,495192,2022-03-09
TRANSFER,211162,Thomas de Blin,495192,284030,Thomas de Blin,495192,706354,2022-03-10
TRANSFER,281305,Thomas de Blin,284030,2725,Thomas de Blin,284030,2725,2022-03-11
CASH_OUT,1655,Thomas de Blin,2725,1070,Agence_moov_Cotonou,300000,298345,2022-03-15
TRANSFER,563,Thomas de Blin,1070,507,Thomas de Blin,1070,507,2022-03-16
CASH_IN,106321,Agence_moov_Ouidah,300000,193679,Thomas de Blin,507,106828,2022-03-24
CASH_IN,174663,Agence_moov_Ouidah,300000,125337,Martine Aubert,-20663,154000,2022-03-05
TRANSFER,38990,Martine Aubert,154000,115010,Martine Aubert,154000,115010,2022-03-05
CASH_IN,159601,Agence_moov_Ouidah,300000,140399,Martine Aubert,115010,274611,2022-03-06
TRANSFER,241741,Martine Aubert,274611,32870,Martine Aubert,274611,32870,2022-03-06
TRANSFER,23760,Martine Aubert,32870,9110,Martine Aubert,32870,9110,2022-03-09
TRANSFER,6339,Martine Aubert,9110,2771,Martine Aubert,9110,15449,2022-03-10
TRANSFER,2063,Martine Aubert,2771,708,Martine Aubert,2771,4834,2022-03-11
CASH_OUT,363,Martine Aubert,708,345,Agence_moov_Abomey,300000,299637,2022-03-15
TRANSFER,332,Martine Aubert,345,13,Martine Aubert,345,677,2022-03-18
CASH_IN,108588,Agence_moov_Abomey,300000,191412,Martine Aubert,13,108601,2022-03-19
CASH_OUT,1428,Martine Aubert,108601,107173,Agence_moov_Ouidah,300000,298572,2022-03-19
CASH_IN,239237,Agence_moov_Abomey,300000,60763,Martine Aubert,107173,346410,2022-03-21
CASH_IN,116440,Agence_moov_Cotonou,300000,183560,Martine Aubert,346410,462850,2022-03-22
CASH_OUT,437059,Martine Aubert,462850,25791,Agence_moov_Ouidah,300000,-137059,2022-03-26
CASH_IN,108402,Agence_moov_Abomey,300000,191598,Martine Aubert,25791,134193,2022-03-26
CASH_OUT,129617,Martine Aubert,134193,4576,Agence_moov_Cotonou,300000,170383,2022-03-27
CASH_IN,267936,Agence_moov_Cotonou,300000,32064,Martine Aubert,4576,272512,2022-03-27
CASH_IN,32497,Agence_moov_Ouidah,300000,267503,Vincent Joubert,-164355,-131858,2022-03-01
CASH_IN,1201,Agence_moov_Cotonou,300000,298799,Vincent Joubert,-131858,-130657,2022-03-02
CASH_IN,162475,Agence_moov_Cotonou,300000,137525,Vincent Joubert,-130657,31818,2022-03-02
TRANSFER,21377,Vincent Joubert,31818,10441,Vincent Joubert,31818,10441,2022-03-03
TRANSFER,5382,Vincent Joubert,10441,5059,Vincent Joubert,10441,5059,2022-03-04
CASH_OUT,2582,Vincent Joubert,5059,2477,Agence_moov_Abomey,300000,297418,2022-03-06
CASH_IN,90813,Agence_moov_Abomey,300000,209187,Vincent Joubert,2477,93290,2022-03-06
CASH_OUT,26318,Vincent Joubert,93290,66972,Agence_moov_Cotonou,300000,273682,2022-03-08
TRANSFER,28330,Vincent Joubert,66972,38642,Vincent Joubert,66972,95302,2022-03-09
CASH_IN,188063,Agence_moov_Cotonou,300000,111937,Vincent Joubert,38642,226705,2022-03-11
CASH_OUT,124055,Vincent Joubert,226705,102650,Agence_moov_Abomey,300000,175945,2022-03-11
CASH_OUT,60877,Vincent Joubert,102650,41773,Agence_moov_Ouidah,300000,239123,2022-03-13
CASH_OUT,19775,Vincent Joubert,41773,21998,Agence_moov_Ouidah,300000,280225,2022-03-17
CASH_IN,190423,Agence_moov_Abomey,300000,109577,Vincent Joubert,21998,212421,2022-03-17
CASH_IN,139197,Agence_moov_Ouidah,300000,160803,Vincent Joubert,212421,351618,2022-03-17
CASH_IN,101110,Agence_moov_Abomey,300000,198890,Nicolas Salmon Le Hamon,-157908,-56798,2022-03-05
CASH_IN,58378,Agence_moov_Abomey,300000,241622,Nicolas Salmon Le Hamon,-56798,1580,2022-03-09
CASH_IN,279621,Agence_moov_Ouidah,300000,20379,Nicolas Salmon Le Hamon,1580,281201,2022-03-11
CASH_IN,290649,Agence_moov_Abomey,300000,9351,Nicolas Salmon Le Hamon,281201,571850,2022-03-11
TRANSFER,160841,Nicolas Salmon Le Hamon,571850,411009,Nicolas Salmon Le Hamon,571850,411009,2022-03-13
CASH_OUT,117507,Nicolas Salmon Le Hamon,411009,293502,Agence_moov_Ouidah,300000,182493,2022-03-14
TRANSFER,221967,Nicolas Salmon Le Hamon,293502,71535,Nicolas Salmon Le Hamon,293502,515469,2022-03-16
CASH_IN,93675,Agence_moov_Cotonou,300000,206325,Nicolas Salmon Le Hamon,71535,165210,2022-03-16
TRANSFER,26451,Nicolas Salmon Le Hamon,165210,138759,Nicolas Salmon Le Hamon,165210,191661,2022-03-18
CASH_OUT,80151,Nicolas Salmon Le Hamon,138759,58608,Agence_moov_Abomey,300000,219849,2022-03-19
CASH_OUT,17189,Nicolas Salmon Le Hamon,58608,41419,Agence_moov_Abomey,300000,282811,2022-03-23
CASH_IN,221228,Agence_moov_Abomey,300000,78772,Nicolas Salmon Le Hamon,41419,262647,2022-03-25
CASH_OUT,110370,Nicolas Salmon Le Hamon,262647,152277,Agence_moov_Ouidah,300000,189630,2022-03-27
CASH_IN,158767,Agence_moov_Ouidah,300000,141233,Anne Peltier-Raynaud,-137496,21271,2022-03-01
CASH_OUT,6619,Anne Peltier-Raynaud,21271,14652,Agence_moov_Abomey,300000,293381,2022-03-02
CASH_IN,207386,Agence_moov_Ouidah,300000,92614,Anne Peltier-Raynaud,14652,222038,2022-03-03
CASH_OUT,97811,Anne Peltier-Raynaud,222038,124227,Agence_moov_Abomey,300000,202189,2022-03-06
CASH_OUT,9814,Anne Peltier-Raynaud,124227,114413,Agence_moov_Abomey,300000,290186,2022-03-08
TRANSFER,30963,Anne Peltier-Raynaud,114413,83450,Anne Peltier-Raynaud,114413,145376,2022-03-08
CASH_OUT,27404,Anne Peltier-Raynaud,83450,56046,Agence_moov_Ouidah,300000,272596,2022-03-12
CASH_OUT,31977,Anne Peltier-Raynaud,56046,24069,Agence_moov_Ouidah,300000,268023,2022-03-22
CASH_OUT,14339,Anne Peltier-Raynaud,24069,9730,Agence_moov_Ouidah,300000,285661,2022-03-22
CASH_IN,76503,Agence_moov_Cotonou,300000,223497,Anne Peltier-Raynaud,9730,86233,2022-03-24
CASH_OUT,64479,Anne Peltier-Raynaud,86233,21754,Agence_moov_Abomey,300000,235521,2022-03-26
CASH_IN,232554,Agence_moov_Abomey,300000,67446,Manon Chevalier,44,232598,2022-03-01
CASH_IN,254754,Agence_moov_Abomey,300000,45246,Manon Chevalier,232598,487352,2022-03-02
CASH_IN,2378,Agence_moov_Cotonou,300000,297622,Manon Chevalier,487352,489730,2022-03-03
CASH_IN,52260,Agence_moov_Ouidah,300000,247740,Manon Chevalier,489730,541990,2022-03-04
CASH_IN,135262,Agence_moov_Cotonou,300000,164738,Manon Chevalier,541990,677252,2022-03-05
CASH_OUT,500813,Manon Chevalier,677252,176439,Agence_moov_Abomey,300000,-200813,2022-03-06
CASH_OUT,149761,Manon Chevalier,176439,26678,Agence_moov_Abomey,300000,150239,2022-03-11
CASH_IN,257974,Agence_moov_Cotonou,300000,42026,Manon Chevalier,26678,284652,2022-03-12
CASH_IN,71575,Agence_moov_Cotonou,300000,228425,Manon Chevalier,284652,356227,2022-03-12
CASH_IN,19442,Agence_moov_Abomey,300000,280558,Manon Chevalier,356227,375669,2022-03-13
CASH_IN,39394,Agence_moov_Ouidah,300000,260606,Manon Chevalier,375669,415063,2022-03-16
CASH_OUT,91613,Manon Chevalier,415063,323450,Agence_moov_Cotonou,300000,208387,2022-03-16
CASH_IN,74463,Agence_moov_Abomey,300000,225537,Manon Chevalier,323450,397913,2022-03-17
CASH_IN,243990,Agence_moov_Abomey,300000,56010,Manon Chevalier,397913,641903,2022-03-24
CASH_OUT,155201,Manon Chevalier,641903,486702,Agence_moov_Ouidah,300000,144799,2022-03-26
CASH_OUT,51660,Manon Chevalier,486702,435042,Agence_moov_Cotonou,300000,248340,2022-03-26
CASH_IN,115310,Agence_moov_Abomey,300000,184690,Céline Collin-Hervé,-69502,45808,2022-03-01
CASH_IN,13267,Agence_moov_Cotonou,300000,286733,Céline Collin-Hervé,45808,59075,2022-03-01
TRANSFER,48998,Céline Collin-Hervé,59075,10077,Céline Collin-Hervé,59075,108073,2022-03-10
CASH_IN,85219,Agence_moov_Ouidah,300000,214781,Céline Collin-Hervé,10077,95296,2022-03-11
CASH_OUT,43581,Céline Collin-Hervé,95296,51715,Agence_moov_Ouidah,300000,256419,2022-03-12
CASH_IN,205154,Agence_moov_Ouidah,300000,94846,Céline Collin-Hervé,51715,256869,2022-03-13
CASH_IN,146716,Agence_moov_Cotonou,300000,153284,Céline Collin-Hervé,256869,403585,2022-03-13
CASH_IN,38253,Agence_moov_Abomey,300000,261747,Céline Collin-Hervé,403585,441838,2022-03-14
CASH_OUT,295493,Céline Collin-Hervé,441838,146345,Agence_moov_Cotonou,300000,4507,2022-03-16
CASH_OUT,140995,Céline Collin-Hervé,146345,5350,Agence_moov_Ouidah,300000,159005,2022-03-21
CASH_IN,236988,Agence_moov_Ouidah,300000,63012,Mathilde Picard du Delmas,-635465,-398477,2022-03-01
CASH_IN,143261,Agence_moov_Abomey,300000,156739,Mathilde Picard du Delmas,-398477,-255216,2022-03-01
CASH_IN,118624,Agence_moov_Ouidah,300000,181376,Mathilde Picard du Delmas,-255216,-136592,2022-03-01
CASH_IN,177249,Agence_moov_Cotonou,300000,122751,Mathilde Picard du Delmas,-136592,40657,2022-03-02
CASH_IN,226854,Agence_moov_Abomey,300000,73146,Mathilde Picard du Delmas,40657,267511,2022-03-03
CASH_IN,161346,Agence_moov_Abomey,300000,138654,Mathilde Picard du Delmas,267511,428857,2022-03-05
TRANSFER,393157,Mathilde Picard du Delmas,428857,35700,Mathilde Picard du Delmas,428857,35700,2022-03-07
CASH_IN,251222,Agence_moov_Ouidah,300000,48778,Mathilde Picard du Delmas,35700,286922,2022-03-10
TRANSFER,41674,Mathilde Picard du Delmas,286922,245248,Mathilde Picard du Delmas,286922,245248,2022-03-10
CASH_IN,159170,Agence_moov_Ouidah,300000,140830,Mathilde Picard du Delmas,245248,404418,2022-03-11
CASH_IN,213908,Agence_moov_Cotonou,300000,86092,Mathilde Picard du Delmas,404418,618326,2022-03-12
CASH_OUT,169437,Mathilde Picard du Delmas,618326,448889,Agence_moov_Abomey,300000,130563,2022-03-13
CASH_IN,221820,Agence_moov_Cotonou,300000,78180,Mathilde Picard du Delmas,448889,670709,2022-03-16
CASH_IN,60097,Agence_moov_Cotonou,300000,239903,Mathilde Picard du Delmas,670709,730806,2022-03-17
CASH_IN,102068,Agence_moov_Ouidah,300000,197932,Mathilde Picard du Delmas,730806,832874,2022-03-19
CASH_OUT,126830,Mathilde Picard du Delmas,832874,706044,Agence_moov_Abomey,300000,173170,2022-03-20
CASH_IN,25966,Agence_moov_Cotonou,300000,274034,Mathilde Picard du Delmas,706044,732010,2022-03-24
CASH_OUT,46045,Mathilde Picard du Delmas,732010,685965,Agence_moov_Abomey,300000,253955,2022-03-24
CASH_OUT,128051,Mathilde Picard du Delmas,685965,557914,Agence_moov_Abomey,300000,171949,2022-03-25
CASH_IN,35372,Agence_moov_Ouidah,300000,264628,Alphonse Joly,-106441,-71069,2022-03-02
CASH_IN,267759,Agence_moov_Cotonou,300000,32241,Alphonse Joly,-71069,196690,2022-03-04
CASH_OUT,10343,Alphonse Joly,196690,186347,Agence_moov_Cotonou,300000,289657,2022-03-06
CASH_IN,222945,Agence_moov_Cotonou,300000,77055,Alphonse Joly,186347,409292,2022-03-09
TRANSFER,25323,Alphonse Joly,409292,383969,Alphonse Joly,409292,434615,2022-03-12
CASH_IN,257609,Agence_moov_Abomey,300000,42391,Alphonse Joly,383969,641578,2022-03-13
CASH_OUT,141299,Alphonse Joly,641578,500279,Agence_moov_Cotonou,300000,158701,2022-03-17
CASH_OUT,259084,Alphonse Joly,500279,241195,Agence_moov_Ouidah,300000,40916,2022-03-18
CASH_IN,197899,Agence_moov_Cotonou,300000,102101,Alphonse Joly,241195,439094,2022-03-19
CASH_OUT,299037,Alphonse Joly,439094,140057,Agence_moov_Cotonou,300000,963,2022-03-19
CASH_OUT,72574,Alphonse Joly,140057,67483,Agence_moov_Abomey,300000,227426,2022-03-22
CASH_OUT,42285,Alphonse Joly,67483,25198,Agence_moov_Ouidah,300000,257715,2022-03-22
CASH_OUT,1862,Alphonse Joly,25198,23336,Agence_moov_Ouidah,300000,298138,2022-03-23
CASH_IN,19157,Agence_moov_Abomey,300000,280843,Alphonse Joly,23336,42493,2022-03-25
CASH_IN,231131,Agence_moov_Abomey,300000,68869,Alphonse Joly,42493,273624,2022-03-27
CASH_IN,126624,Agence_moov_Ouidah,300000,173376,Luc Lévêque-Carre,-64733,61891,2022-03-02
TRANSFER,19033,Luc Lévêque-Carre,61891,42858,Luc Lévêque-Carre,61891,80924,2022-03-02
TRANSFER,14751,Luc Lévêque-Carre,42858,28107,Luc Lévêque-Carre,42858,57609,2022-03-09
CASH_OUT,16839,Luc Lévêque-Carre,28107,11268,Agence_moov_Ouidah,300000,283161,2022-03-11
CASH_OUT,3920,Luc Lévêque-Carre,11268,7348,Agence_moov_Abomey,300000,296080,2022-03-23
CASH_OUT,6101,Luc Lévêque-Carre,7348,1247,Agence_moov_Abomey,300000,293899,2022-03-25
CASH_IN,2936,Agence_moov_Ouidah,300000,297064,Colette Merle Le Robert,-282849,-279913,2022-03-01
CASH_IN,232103,Agence_moov_Ouidah,300000,67897,Colette Merle Le Robert,-279913,-47810,2022-03-07
CASH_IN,226197,Agence_moov_Cotonou,300000,73803,Colette Merle Le Robert,-47810,178387,2022-03-13
CASH_OUT,34230,Colette Merle Le Robert,178387,144157,Agence_moov_Abomey,300000,265770,2022-03-14
CASH_IN,231573,Agence_moov_Ouidah,300000,68427,Colette Merle Le Robert,144157,375730,2022-03-18
CASH_IN,47577,Agence_moov_Abomey,300000,252423,Colette Merle Le Robert,375730,423307,2022-03-18
CASH_OUT,249322,Colette Merle Le Robert,423307,173985,Agence_moov_Abomey,300000,50678,2022-03-24
CASH_IN,283137,Agence_moov_Ouidah,300000,16863,Andrée-Thérèse Mendès,-218487,64650,2022-03-05
CASH_IN,226824,Agence_moov_Abomey,300000,73176,Andrée-Thérèse Mendès,64650,291474,2022-03-05
CASH_IN,170643,Agence_moov_Ouidah,300000,129357,Andrée-Thérèse Mendès,291474,462117,2022-03-07
CASH_IN,100417,Agence_moov_Abomey,300000,199583,Andrée-Thérèse Mendès,462117,562534,2022-03-08
TRANSFER,67111,Andrée-Thérèse Mendès,562534,495423,Andrée-Thérèse Mendès,562534,629645,2022-03-10
CASH_OUT,322854,Andrée-Thérèse Mendès,495423,172569,Agence_moov_Ouidah,300000,-22854,2022-03-10
TRANSFER,40666,Andrée-Thérèse Mendès,172569,131903,Andrée-Thérèse Mendès,172569,213235,2022-03-10
CASH_OUT,62862,Andrée-Thérèse Mendès,131903,69041,Agence_moov_Abomey,300000,237138,2022-03-10
TRANSFER,29702,Andrée-Thérèse Mendès,69041,39339,Andrée-Thérèse Mendès,69041,98743,2022-03-12
TRANSFER,3130,Andrée-Thérèse Mendès,39339,36209,Andrée-Thérèse Mendès,39339,36209,2022-03-12
CASH_IN,249637,Agence_moov_Ouidah,300000,50363,Andrée-Thérèse Mendès,36209,285846,2022-03-14
CASH_IN,298021,Agence_moov_Cotonou,300000,1979,Andrée-Thérèse Mendès,285846,583867,2022-03-14
TRANSFER,544076,Andrée-Thérèse Mendès,583867,39791,Andrée-Thérèse Mendès,583867,39791,2022-03-14
CASH_IN,262591,Agence_moov_Abomey,300000,37409,Andrée-Thérèse Mendès,39791,302382,2022-03-21
CASH_IN,62573,Agence_moov_Ouidah,300000,237427,Andrée-Thérèse Mendès,302382,364955,2022-03-24
CASH_OUT,145384,Andrée-Thérèse Mendès,364955,219571,Agence_moov_Abomey,300000,154616,2022-03-27
CASH_IN,192978,Agence_moov_Ouidah,300000,107022,Noël Bourgeois,-566837,-373859,2022-03-02
CASH_IN,81664,Agence_moov_Abomey,300000,218336,Noël Bourgeois,-373859,-292195,2022-03-05
CASH_IN,176820,Agence_moov_Abomey,300000,123180,Noël Bourgeois,-292195,-115375,2022-03-05
CASH_IN,247696,Agence_moov_Cotonou,300000,52304,Noël Bourgeois,-115375,132321,2022-03-05
CASH_IN,86207,Agence_moov_Abomey,300000,213793,Noël Bourgeois,132321,218528,2022-03-06
CASH_OUT,159119,Noël Bourgeois,218528,59409,Agence_moov_Abomey,300000,140881,2022-03-07
CASH_OUT,21323,Noël Bourgeois,59409,38086,Agence_moov_Ouidah,300000,278677,2022-03-07
CASH_OUT,445,Noël Bourgeois,38086,37641,Agence_moov_Ouidah,300000,299555,2022-03-09
CASH_IN,33406,Agence_moov_Cotonou,300000,266594,Noël Bourgeois,37641,71047,2022-03-10
CASH_IN,254618,Agence_moov_Abomey,300000,45382,Noël Bourgeois,71047,325665,2022-03-20
CASH_OUT,46287,Noël Bourgeois,325665,279378,Agence_moov_Cotonou,300000,253713,2022-03-20
CASH_OUT,178794,Noël Bourgeois,279378,100584,Agence_moov_Cotonou,300000,121206,2022-03-23
CASH_IN,208316,Agence_moov_Ouidah,300000,91684,Noël Bourgeois,100584,308900,2022-03-24
CASH_IN,210218,Agence_moov_Cotonou,300000,89782,Michelle-Dorothée Lévêque,-757209,-546991,2022-03-04
CASH_IN,3759,Agence_moov_Cotonou,300000,296241,Michelle-Dorothée Lévêque,-546991,-543232,2022-03-06
CASH_IN,234131,Agence_moov_Ouidah,300000,65869,Michelle-Dorothée Lévêque,-543232,-309101,2022-03-10
CASH_IN,266148,Agence_moov_Cotonou,300000,33852,Michelle-Dorothée Lévêque,-309101,-42953,2022-03-10
CASH_IN,160026,Agence_moov_Ouidah,300000,139974,Michelle-Dorothée Lévêque,-42953,117073,2022-03-11
CASH_OUT,29438,Michelle-Dorothée Lévêque,117073,87635,Agence_moov_Abomey,300000,270562,2022-03-12
CASH_OUT,37650,Michelle-Dorothée Lévêque,87635,49985,Agence_moov_Abomey,300000,262350,2022-03-25
CASH_IN,136722,Agence_moov_Cotonou,300000,163278,Aurore Charrier,-82511,54211,2022-03-01
CASH_OUT,33850,Aurore Charrier,54211,20361,Agence_moov_Abomey,300000,266150,2022-03-01
TRANSFER,20163,Aurore Charrier,20361,198,Aurore Charrier,20361,198,2022-03-08
CASH_IN,133910,Agence_moov_Cotonou,300000,166090,Aurore Charrier,198,134108,2022-03-09
TRANSFER,133182,Aurore Charrier,134108,926,Aurore Charrier,134108,926,2022-03-09
CASH_IN,185037,Agence_moov_Cotonou,300000,114963,Aurore Charrier,926,185963,2022-03-10
CASH_OUT,67367,Aurore Charrier,185963,118596,Agence_moov_Ouidah,300000,232633,2022-03-10
CASH_OUT,49100,Aurore Charrier,118596,69496,Agence_moov_Cotonou,300000,250900,2022-03-16
TRANSFER,24524,Aurore Charrier,69496,44972,Aurore Charrier,69496,44972,2022-03-16
CASH_OUT,37821,Aurore Charrier,44972,7151,Agence_moov_Cotonou,300000,262179,2022-03-16
CASH_OUT,764,Aurore Charrier,7151,6387,Agence_moov_Abomey,300000,299236,2022-03-19
CASH_IN,120000,Agence_moov_Cotonou,300000,180000,Aurore Charrier,6387,126387,2022-03-21
CASH_OUT,93677,Aurore Charrier,126387,32710,Agence_moov_Cotonou,300000,206323,2022-03-22
CASH_IN,117145,Agence_moov_Ouidah,300000,182855,Aurore Charrier,32710,149855,2022-03-24
CASH_IN,134617,Agence_moov_Abomey,300000,165383,Audrey Julien de Leleu,-773198,-638581,2022-03-05
CASH_IN,233575,Agence_moov_Ouidah,300000,66425,Audrey Julien de Leleu,-638581,-405006,2022-03-05
CASH_IN,85219,Agence_moov_Abomey,300000,214781,Audrey Julien de Leleu,-405006,-319787,2022-03-10
CASH_IN,168507,Agence_moov_Ouidah,300000,131493,Audrey Julien de Leleu,-319787,-151280,2022-03-10
CASH_IN,36600,Agence_moov_Abomey,300000,263400,Audrey Julien de Leleu,-151280,-114680,2022-03-10
CASH_IN,98890,Agence_moov_Ouidah,300000,201110,Audrey Julien de Leleu,-114680,-15790,2022-03-12
CASH_IN,58022,Agence_moov_Ouidah,300000,241978,Audrey Julien de Leleu,-15790,42232,2022-03-12
CASH_IN,233022,Agence_moov_Abomey,300000,66978,Audrey Julien de Leleu,42232,275254,2022-03-13
CASH_IN,284270,Agence_moov_Ouidah,300000,15730,Audrey Julien de Leleu,275254,559524,2022-03-14
CASH_IN,219745,Agence_moov_Cotonou,300000,80255,Audrey Julien de Leleu,559524,779269,2022-03-14
CASH_IN,244093,Agence_moov_Cotonou,300000,55907,Audrey Julien de Leleu,779269,1023362,2022-03-16
CASH_IN,266181,Agence_moov_Cotonou,300000,33819,Audrey Julien de Leleu,1023362,1289543,2022-03-17
CASH_OUT,934395,Audrey Julien de Leleu,1289543,355148,Agence_moov_Ouidah,300000,-634395,2022-03-17
CASH_IN,38543,Agence_moov_Abomey,300000,261457,Audrey Julien de Leleu,355148,393691,2022-03-20
CASH_OUT,49165,Audrey Julien de Leleu,393691,344526,Agence_moov_Abomey,300000,250835,2022-03-21
CASH_IN,20596,Agence_moov_Cotonou,300000,279404,Audrey Julien de Leleu,344526,365122,2022-03-22
CASH_OUT,295488,Audrey Julien de Leleu,365122,69634,Agence_moov_Cotonou,300000,4512,2022-03-24
CASH_IN,164232,Agence_moov_Cotonou,300000,135768,Audrey Julien de Leleu,69634,233866,2022-03-24
CASH_IN,38442,Agence_moov_Ouidah,300000,261558,Astrid Lecoq,-439038,-400596,2022-03-04
CASH_IN,83129,Agence_moov_Cotonou,300000,216871,Astrid Lecoq,-400596,-317467,2022-03-12
CASH_IN,288009,Agence_moov_Abomey,300000,11991,Astrid Lecoq,-317467,-29458,2022-03-20
CASH_IN,281300,Agence_moov_Abomey,300000,18700,Astrid Lecoq,-29458,251842,2022-03-21
CASH_OUT,192670,Astrid Lecoq,251842,59172,Agence_moov_Abomey,300000,107330,2022-03-22
TRANSFER,49142,Astrid Lecoq,59172,10030,Astrid Lecoq,59172,108314,2022-03-23
CASH_OUT,8156,Astrid Lecoq,10030,1874,Agence_moov_Abomey,300000,291844,2022-03-25
CASH_IN,82304,Agence_moov_Ouidah,300000,217696,Astrid Lecoq,1874,84178,2022-03-26
CASH_IN,65144,Agence_moov_Ouidah,300000,234856,Paulette Loiseau,-228435,-163291,2022-03-05
CASH_IN,179947,Agence_moov_Cotonou,300000,120053,Paulette Loiseau,-163291,16656,2022-03-07
TRANSFER,13288,Paulette Loiseau,16656,3368,Paulette Loiseau,16656,29944,2022-03-12
TRANSFER,513,Paulette Loiseau,3368,2855,Paulette Loiseau,3368,2855,2022-03-13
CASH_IN,35998,Agence_moov_Cotonou,300000,264002,Paulette Loiseau,2855,38853,2022-03-13
CASH_OUT,1651,Paulette Loiseau,38853,37202,Agence_moov_Cotonou,300000,298349,2022-03-22
CASH_OUT,17114,Paulette Loiseau,37202,20088,Agence_moov_Ouidah,300000,282886,2022-03-26
CASH_IN,278650,Agence_moov_Cotonou,300000,21350,Constance Bourdon-Millet,-265828,12822,2022-03-03
TRANSFER,7941,Constance Bourdon-Millet,12822,4881,Constance Bourdon-Millet,12822,20763,2022-03-06
CASH_OUT,2801,Constance Bourdon-Millet,4881,2080,Agence_moov_Ouidah,300000,297199,2022-03-07
CASH_IN,74979,Agence_moov_Cotonou,300000,225021,Constance Bourdon-Millet,2080,77059,2022-03-07
TRANSFER,7792,Constance Bourdon-Millet,77059,69267,Constance Bourdon-Millet,77059,84851,2022-03-07
CASH_IN,220196,Agence_moov_Cotonou,300000,79804,Constance Bourdon-Millet,69267,289463,2022-03-08
CASH_OUT,22135,Constance Bourdon-Millet,289463,267328,Agence_moov_Cotonou,300000,277865,2022-03-12
CASH_OUT,123773,Constance Bourdon-Millet,267328,143555,Agence_moov_Ouidah,300000,176227,2022-03-14
CASH_OUT,125504,Constance Bourdon-Millet,143555,18051,Agence_moov_Cotonou,300000,174496,2022-03-15
CASH_IN,248704,Agence_moov_Cotonou,300000,51296,Constance Bourdon-Millet,18051,266755,2022-03-17
CASH_OUT,250240,Constance Bourdon-Millet,266755,16515,Agence_moov_Abomey,300000,49760,2022-03-21
CASH_IN,71001,Agence_moov_Ouidah,300000,228999,Constance Bourdon-Millet,16515,87516,2022-03-26
CASH_OUT,22171,Constance Bourdon-Millet,87516,65345,Agence_moov_Cotonou,300000,277829,2022-03-27
CASH_IN,162517,Agence_moov_Ouidah,300000,137483,Théodore Joseph-Lefebvre,-2802153,-2639636,2022-03-01
CASH_IN,275182,Agence_moov_Ouidah,300000,24818,Théodore Joseph-Lefebvre,-2639636,-2364454,2022-03-03
CASH_IN,157074,Agence_moov_Cotonou,300000,142926,Théodore Joseph-Lefebvre,-2364454,-2207380,2022-03-08
CASH_IN,64332,Agence_moov_Ouidah,300000,235668,Théodore Joseph-Lefebvre,-2207380,-2143048,2022-03-13
CASH_IN,184006,Agence_moov_Cotonou,300000,115994,Théodore Joseph-Lefebvre,-2143048,-1959042,2022-03-19
CASH_IN,114330,Agence_moov_Abomey,300000,185670,Théodore Joseph-Lefebvre,-1959042,-1844712,2022-03-20
CASH_IN,268136,Agence_moov_Ouidah,300000,31864,Théodore Joseph-Lefebvre,-1844712,-1576576,2022-03-20
CASH_IN,67016,Agence_moov_Ouidah,300000,232984,Théodore Joseph-Lefebvre,-1576576,-1509560,2022-03-20
CASH_IN,238668,Agence_moov_Cotonou,300000,61332,Théodore Joseph-Lefebvre,-1509560,-1270892,2022-03-25
CASH_IN,236868,Agence_moov_Abomey,300000,63132,Théodore Joseph-Lefebvre,-1270892,-1034024,2022-03-26
CASH_IN,192116,Agence_moov_Cotonou,300000,107884,Simone Muller de la Brun,-1072794,-880678,2022-03-01
CASH_IN,123599,Agence_moov_Cotonou,300000,176401,Simone Muller de la Brun,-880678,-757079,2022-03-02
CASH_IN,294746,Agence_moov_Abomey,300000,5254,Simone Muller de la Brun,-757079,-462333,2022-03-06
CASH_IN,9685,Agence_moov_Ouidah,300000,290315,Simone Muller de la Brun,-462333,-452648,2022-03-09
CASH_IN,53308,Agence_moov_Cotonou,300000,246692,Simone Muller de la Brun,-452648,-399340,2022-03-10
CASH_IN,187205,Agence_moov_Ouidah,300000,112795,Simone Muller de la Brun,-399340,-212135,2022-03-12
CASH_IN,209360,Agence_moov_Abomey,300000,90640,Simone Muller de la Brun,-212135,-2775,2022-03-14
CASH_IN,90882,Agence_moov_Ouidah,300000,209118,Simone Muller de la Brun,-2775,88107,2022-03-16
CASH_OUT,10422,Simone Muller de la Brun,88107,77685,Agence_moov_Abomey,300000,289578,2022-03-18
CASH_OUT,18321,Simone Muller de la Brun,77685,59364,Agence_moov_Abomey,300000,281679,2022-03-21
CASH_OUT,23123,Simone Muller de la Brun,59364,36241,Agence_moov_Abomey,300000,276877,2022-03-26
CASH_IN,286158,Agence_moov_Ouidah,300000,13842,Simone Muller de la Brun,36241,322399,2022-03-26
CASH_IN,69918,Agence_moov_Ouidah,300000,230082,Richard Michel,-346247,-276329,2022-03-01
CASH_IN,95074,Agence_moov_Abomey,300000,204926,Richard Michel,-276329,-181255,2022-03-02
CASH_IN,139346,Agence_moov_Ouidah,300000,160654,Richard Michel,-181255,-41909,2022-03-07
CASH_IN,35603,Agence_moov_Abomey,300000,264397,Richard Michel,-41909,-6306,2022-03-08
CASH_IN,254376,Agence_moov_Abomey,300000,45624,Richard Michel,-6306,248070,2022-03-09
TRANSFER,48612,Richard Michel,248070,199458,Richard Michel,248070,199458,2022-03-11
CASH_IN,107730,Agence_moov_Abomey,300000,192270,Richard Michel,199458,307188,2022-03-12
TRANSFER,302336,Richard Michel,307188,4852,Richard Michel,307188,609524,2022-03-12
CASH_OUT,4512,Richard Michel,4852,340,Agence_moov_Abomey,300000,295488,2022-03-13
CASH_IN,185003,Agence_moov_Cotonou,300000,114997,Richard Michel,340,185343,2022-03-14
CASH_OUT,183886,Richard Michel,185343,1457,Agence_moov_Cotonou,300000,116114,2022-03-16
CASH_IN,118421,Agence_moov_Cotonou,300000,181579,Richard Michel,1457,119878,2022-03-19
CASH_IN,290125,Agence_moov_Cotonou,300000,9875,Aimé Pages,-98927,191198,2022-03-01
TRANSFER,105115,Aimé Pages,191198,86083,Aimé Pages,191198,86083,2022-03-02
CASH_IN,191872,Agence_moov_Abomey,300000,108128,Aimé Pages,86083,277955,2022-03-04
TRANSFER,197561,Aimé Pages,277955,80394,Aimé Pages,277955,80394,2022-03-04
CASH_IN,43112,Agence_moov_Cotonou,300000,256888,Aimé Pages,80394,123506,2022-03-04
CASH_IN,262544,Agence_moov_Abomey,300000,37456,Aimé Pages,123506,386050,2022-03-06
CASH_OUT,58976,Aimé Pages,386050,327074,Agence_moov_Cotonou,300000,241024,2022-03-06
CASH_OUT,217193,Aimé Pages,327074,109881,Agence_moov_Abomey,300000,82807,2022-03-07
CASH_OUT,5942,Aimé Pages,109881,103939,Agence_moov_Ouidah,300000,294058,2022-03-09
TRANSFER,24928,Aimé Pages,103939,79011,Aimé Pages,103939,128867,2022-03-10
CASH_OUT,11930,Aimé Pages,79011,67081,Agence_moov_Cotonou,300000,288070,2022-03-11
TRANSFER,36626,Aimé Pages,67081,30455,Aimé Pages,67081,103707,2022-03-11
CASH_OUT,5032,Aimé Pages,30455,25423,Agence_moov_Abomey,300000,294968,2022-03-16
CASH_IN,40580,Agence_moov_Cotonou,300000,259420,Aimé Pages,25423,66003,2022-03-25
CASH_OUT,58444,Aimé Pages,66003,7559,Agence_moov_Ouidah,300000,241556,2022-03-27
CASH_IN,39951,Agence_moov_Cotonou,300000,260049,Constance Guillon,-425841,-385890,2022-03-01
CASH_IN,291024,Agence_moov_Cotonou,300000,8976,Constance Guillon,-385890,-94866,2022-03-02
CASH_IN,63779,Agence_moov_Ouidah,300000,236221,Constance Guillon,-94866,-31087,2022-03-04
CASH_IN,125517,Agence_moov_Abomey,300000,174483,Constance Guillon,-31087,94430,2022-03-04
TRANSFER,50218,Constance Guillon,94430,44212,Constance Guillon,94430,44212,2022-03-05
CASH_IN,210937,Agence_moov_Cotonou,300000,89063,Constance Guillon,44212,255149,2022-03-07
CASH_IN,109247,Agence_moov_Ouidah,300000,190753,Constance Guillon,255149,364396,2022-03-09
CASH_IN,243227,Agence_moov_Cotonou,300000,56773,Constance Guillon,364396,607623,2022-03-11
CASH_IN,284947,Agence_moov_Cotonou,300000,15053,Constance Guillon,607623,892570,2022-03-11
CASH_OUT,45598,Constance Guillon,892570,846972,Agence_moov_Ouidah,300000,254402,2022-03-19
CASH_IN,28781,Agence_moov_Ouidah,300000,271219,Constance Guillon,846972,875753,2022-03-27
CASH_IN,267084,Agence_moov_Cotonou,300000,32916,Constance Guillon,875753,1142837,2022-03-27
CASH_IN,53623,Agence_moov_Cotonou,300000,246377,Thibaut de la Lombard,293600,347223,2022-04-07
CASH_IN,225523,Agence_moov_Abomey,300000,74477,Thibaut de la Lombard,347223,572746,2022-04-12
TRANSFER,200722,Thibaut de la Lombard,572746,372024,Hélène de la Gérard,1227000,1026278,2022-04-14
CASH_OUT,143879,Thibaut de la Lombard,372024,228145,Agence_moov_Abomey,300000,156121,2022-04-18
CASH_IN,277171,Agence_moov_Ouidah,300000,22829,Alphonse Gomes,437600,714771,2022-04-10
TRANSFER,573953,Alphonse Gomes,714771,140818,Bertrand Regnier,1799200,1225247,2022-04-17
CASH_OUT,85663,Alphonse Gomes,140818,55155,Agence_moov_Ouidah,300000,214337,2022-04-18
CASH_IN,240370,Agence_moov_Ouidah,300000,59630,Alphonse Gomes,55155,295525,2022-04-25
CASH_IN,55909,Agence_moov_Ouidah,300000,244091,Hélène Le Chauvin,1943600,1999509,2022-04-06
CASH_IN,29129,Agence_moov_Ouidah,300000,270871,Hélène Le Chauvin,1999509,2028638,2022-04-07
CASH_OUT,947813,Hélène Le Chauvin,2028638,1080825,Agence_moov_Cotonou,300000,-647813,2022-04-13
CASH_OUT,1016079,Hélène Le Chauvin,1080825,64746,Agence_moov_Ouidah,300000,-716079,2022-04-27
TRANSFER,169124,Bernadette de Jourdan,1537400,1368276,Véronique Martins de Fleury,567500,398376,2022-04-15
CASH_IN,33230,Agence_moov_Ouidah,300000,266770,Manon Chevalier,95700,128930,2022-04-08
CASH_OUT,49971,Manon Chevalier,128930,78959,Agence_moov_Abomey,300000,250029,2022-04-09
CASH_OUT,37934,Manon Chevalier,78959,41025,Agence_moov_Abomey,300000,262066,2022-04-24
CASH_IN,110513,Agence_moov_Cotonou,300000,189487,Hélène de la Gérard,1026278,1136791,2022-04-04
CASH_OUT,458011,Hélène de la Gérard,1136791,678780,Agence_moov_Abomey,300000,-158011,2022-04-16
CASH_OUT,228680,Manon Valette,515400,286720,Agence_moov_Cotonou,300000,71320,2022-04-19
CASH_OUT,232266,Manon Valette,286720,54454,Agence_moov_Ouidah,300000,67734,2022-04-22
CASH_IN,245137,Agence_moov_Abomey,300000,54863,Renée Rousseau-Henry,780000,1025137,2022-04-02
CASH_IN,50896,Agence_moov_Abomey,300000,249104,Paul Perez,141800,192696,2022-04-11
CASH_IN,87613,Agence_moov_Abomey,300000,212387,Paul Perez,192696,280309,2022-04-11
CASH_OUT,352518,Robert Laroche,553200,200682,Agence_moov_Cotonou,300000,-52518,2022-04-15
CASH_OUT,34152,Robert Laroche,200682,166530,Agence_moov_Abomey,300000,265848,2022-04-16
CASH_OUT,161960,Robert Laroche,166530,4570,Agence_moov_Ouidah,300000,138040,2022-04-18
CASH_OUT,377300,Antoinette de Dupuis,1463100,1085800,Agence_moov_Abomey,300000,-77300,2022-04-08
TRANSFER,1105679,Tristan Gomez,1505100,399421,Antoinette de Dupuis,1085800,2191479,2022-04-18
CASH_IN,167776,Agence_moov_Cotonou,300000,132224,Andrée-Thérèse Mendès,1778700,1946476,2022-04-05
CASH_IN,202056,Agence_moov_Cotonou,300000,97944,Andrée-Thérèse Mendès,1946476,2148532,2022-04-05
CASH_IN,270622,Agence_moov_Cotonou,300000,29378,Andrée-Thérèse Mendès,2148532,2419154,2022-04-21
CASH_OUT,713172,Andrée-Thérèse Mendès,2419154,1705982,Agence_moov_Ouidah,300000,-413172,2022-04-24
CASH_IN,67411,Agence_moov_Ouidah,300000,232589,Anne Peltier-Raynaud,80100,147511,2022-04-07
CASH_IN,44683,Agence_moov_Cotonou,300000,255317,Anne Peltier-Raynaud,147511,192194,2022-04-09
TRANSFER,175717,Anne Peltier-Raynaud,192194,16477,Nathalie Bonnin-Joubert,242200,66483,2022-04-19
CASH_IN,214005,Agence_moov_Ouidah,300000,85995,Lucie Aubert,191500,405505,2022-04-09
CASH_OUT,401746,Lucie Aubert,405505,3759,Agence_moov_Ouidah,300000,-101746,2022-04-11
CASH_IN,180678,Agence_moov_Cotonou,300000,119322,Lucie Aubert,3759,184437,2022-04-14
CASH_IN,156042,Agence_moov_Abomey,300000,143958,Richard Michel,28700,184742,2022-04-09
CASH_OUT,25667,Richard Michel,184742,159075,Agence_moov_Ouidah,300000,274333,2022-04-15
TRANSFER,489519,Matthieu-Matthieu Bigot,892500,402981,Richard Michel,159075,648594,2022-04-16
CASH_OUT,611294,Richard Michel,648594,37300,Agence_moov_Cotonou,300000,-311294,2022-04-27
CASH_OUT,301617,Constance Bourdon-Millet,308100,6483,Agence_moov_Cotonou,300000,-1617,2022-04-06
CASH_OUT,5162,Constance Bourdon-Millet,6483,1321,Agence_moov_Ouidah,300000,294838,2022-04-09
CASH_OUT,752,Constance Bourdon-Millet,1321,569,Agence_moov_Cotonou,300000,299248,2022-04-20
CASH_OUT,253007,Benoît Guyot,375600,122593,Agence_moov_Cotonou,300000,46993,2022-04-21
CASH_OUT,1199002,Astrid Lecoq,1943900,744898,Agence_moov_Abomey,300000,-899002,2022-04-08
CASH_OUT,584350,Astrid Lecoq,744898,160548,Agence_moov_Ouidah,300000,-284350,2022-04-09
CASH_IN,147679,Agence_moov_Ouidah,300000,152321,Astrid Lecoq,160548,308227,2022-04-26
TRANSFER,317678,Luc Lévêque-Carre,468200,150522,Thérèse François,1407300,1724978,2022-04-03
CASH_OUT,1143268,Thérèse François,1724978,581710,Agence_moov_Ouidah,300000,-843268,2022-04-13
CASH_OUT,250516,Thérèse François,581710,331194,Agence_moov_Ouidah,300000,49484,2022-04-14
CASH_OUT,92076,Thérèse François,331194,239118,Agence_moov_Cotonou,300000,207924,2022-04-19
CASH_OUT,1079067,Bertrand Regnier,1225247,146180,Agence_moov_Cotonou,300000,-779067,2022-04-14
CASH_OUT,110935,Bertrand Regnier,146180,35245,Agence_moov_Cotonou,300000,189065,2022-04-24
CASH_OUT,130017,Christine Texier,241600,111583,Agence_moov_Cotonou,300000,169983,2022-04-07
CASH_IN,15919,Agence_moov_Ouidah,300000,284081,Christine Texier,111583,127502,2022-04-15
TRANSFER,41829,Christine Texier,127502,85673,Lucy Gillet,692500,650671,2022-04-20
CASH_IN,226267,Agence_moov_Cotonou,300000,73733,Christine Texier,85673,311940,2022-04-25
CASH_IN,111270,Agence_moov_Ouidah,300000,188730,Paulette Loiseau,1008500,1119770,2022-04-03
CASH_OUT,1025804,Paulette Loiseau,1119770,93966,Agence_moov_Abomey,300000,-725804,2022-04-16
TRANSFER,69462,Véronique Martins de Fleury,398376,328914,Paulette Loiseau,93966,163428,2022-04-18
CASH_OUT,14660,Paulette Loiseau,163428,148768,Agence_moov_Ouidah,300000,285340,2022-04-18
CASH_IN,297396,Agence_moov_Ouidah,300000,2604,Paulette Loiseau,148768,446164,2022-04-22
CASH_IN,35009,Agence_moov_Abomey,300000,264991,Frédéric Guillou,1740200,1775209,2022-04-02
TRANSFER,1572270,Frédéric Guillou,1775209,202939,Constance Guillon,1443900,-128370,2022-04-19
TRANSFER,80762,Frédéric Guillou,202939,122177,Stéphane Munoz,1239800,1159038,2022-04-25
CASH_IN,283644,Agence_moov_Ouidah,300000,16356,Timothée-René Blanchard,1349300,1632944,2022-04-04
TRANSFER,124816,Thibaut de la Roy,475800,350984,Timothée-René Blanchard,1632944,1757760,2022-04-18
TRANSFER,1409255,Timothée-René Blanchard,1757760,348505,Agnès Le Giraud,342000,-1067255,2022-04-22
TRANSFER,116459,Timothée-René Blanchard,348505,232046,Gabriel Bègue,554300,437841,2022-04-24
TRANSFER,554432,Simone Muller de la Brun,1118400,563968,Gabriel Bègue,437841,992273,2022-04-08
CASH_OUT,884316,Gabriel Bègue,992273,107957,Agence_moov_Cotonou,300000,-584316,2022-04-09
TRANSFER,104050,Gabriel Bègue,107957,3907,Marcelle-Valentine Guibert,485900,381850,2022-04-16
TRANSFER,8222,Richard Le Lévêque,59600,51378,Suzanne Bodin,1227600,1219378,2022-04-01
TRANSFER,5371,Richard Le Lévêque,51378,46007,Matthieu-Matthieu Bigot,402981,397610,2022-04-02
CASH_OUT,21040,Richard Le Lévêque,46007,24967,Agence_moov_Abomey,300000,278960,2022-04-03
CASH_OUT,215,Richard Le Lévêque,24967,24752,Agence_moov_Ouidah,300000,299785,2022-04-04
TRANSFER,100938,Maggie Martinez,969400,868462,Richard Le Lévêque,24752,125690,2022-04-04
TRANSFER,39875,Richard Le Lévêque,125690,85815,Nicolas Salmon Le Hamon,315900,276025,2022-04-05
TRANSFER,5987,Richard Le Lévêque,85815,79828,Maggie Martinez,868462,862475,2022-04-05
CASH_IN,84362,Agence_moov_Ouidah,300000,215638,Richard Le Lévêque,79828,164190,2022-04-05
TRANSFER,79322,Richard Le Lévêque,164190,84868,Marthe Gilles,97700,18378,2022-04-06
TRANSFER,26870,Richard Le Lévêque,84868,57998,André Renault,1913700,1886830,2022-04-07
CASH_OUT,22311,Richard Le Lévêque,57998,35687,Agence_moov_Ouidah,300000,277689,2022-04-08
TRANSFER,1422663,Émilie du Allain,1829500,406837,Richard Le Lévêque,35687,1458350,2022-04-11
CASH_OUT,7024,Richard Le Lévêque,1458350,1451326,Agence_moov_Abomey,300000,292976,2022-04-13
TRANSFER,310662,Martine Aubert,326000,15338,Richard Le Lévêque,1451326,1761988,2022-04-15
TRANSFER,989360,Adèle Da Silva-Klein,1349500,360140,Richard Le Lévêque,1761988,2751348,2022-04-17
TRANSFER,12194,Martine Aubert,15338,3144,Richard Le Lévêque,2751348,2763542,2022-04-20
CASH_IN,267973,Agence_moov_Cotonou,300000,32027,Richard Le Lévêque,2763542,3031515,2022-04-20
CASH_IN,182557,Agence_moov_Cotonou,300000,117443,Richard Le Lévêque,3031515,3214072,2022-04-20
TRANSFER,60579,Victor Michel,176500,115921,Richard Le Lévêque,3214072,3274651,2022-04-21
CASH_OUT,2215048,Richard Le Lévêque,3274651,1059603,Agence_moov_Cotonou,300000,-1915048,2022-04-22
TRANSFER,1048255,Richard Le Lévêque,1059603,11348,Vincent Joubert,1491400,443145,2022-04-22
CASH_IN,249699,Agence_moov_Ouidah,300000,50301,Richard Le Lévêque,11348,261047,2022-04-23
CASH_IN,176246,Agence_moov_Abomey,300000,123754,Richard Le Lévêque,261047,437293,2022-04-24
TRANSFER,423255,Nath Loiseau,637900,214645,Richard Le Lévêque,437293,860548,2022-04-24
CASH_OUT,436704,Richard Le Lévêque,860548,423844,Agence_moov_Ouidah,300000,-136704,2022-04-27
TRANSFER,241343,Philippe Philippe,799600,558257,Victor Michel,115921,357264,2022-04-01
TRANSFER,187776,Victor Michel,357264,169488,Colette Merle Le Robert,47800,-139976,2022-04-02
TRANSFER,64925,Stéphane Munoz,1159038,1094113,Victor Michel,169488,234413,2022-04-02
CASH_IN,41219,Agence_moov_Abomey,300000,258781,Victor Michel,234413,275632,2022-04-03
CASH_IN,259731,Agence_moov_Cotonou,300000,40269,Victor Michel,275632,535363,2022-04-05
TRANSFER,304903,Vincent Joubert,443145,138242,Victor Michel,535363,840266,2022-04-07
CASH_IN,61564,Agence_moov_Cotonou,300000,238436,Victor Michel,840266,901830,2022-04-07
CASH_OUT,248071,Victor Michel,901830,653759,Agence_moov_Ouidah,300000,51929,2022-04-09
CASH_IN,15158,Agence_moov_Ouidah,300000,284842,Victor Michel,653759,668917,2022-04-11
CASH_IN,207694,Agence_moov_Abomey,300000,92306,Victor Michel,668917,876611,2022-04-12
CASH_IN,235008,Agence_moov_Cotonou,300000,64992,Victor Michel,876611,1111619,2022-04-12
CASH_IN,147322,Agence_moov_Cotonou,300000,152678,Victor Michel,1111619,1258941,2022-04-13
TRANSFER,299149,Matthieu-Matthieu Bigot,397610,98461,Victor Michel,1258941,1558090,2022-04-14
CASH_IN,285677,Agence_moov_Abomey,300000,14323,Victor Michel,1558090,1843767,2022-04-14
CASH_IN,2308,Agence_moov_Abomey,300000,297692,Victor Michel,1843767,1846075,2022-04-16
TRANSFER,117688,Jules Fernandes,440800,323112,Victor Michel,1846075,1963763,2022-04-18
TRANSFER,406293,Noël Bourgeois,1755100,1348807,Victor Michel,1963763,2370056,2022-04-19
TRANSFER,835085,Stéphane Munoz,1094113,259028,Victor Michel,2370056,3205141,2022-04-19
CASH_IN,231964,Agence_moov_Abomey,300000,68036,Victor Michel,3205141,3437105,2022-04-21
CASH_OUT,3003818,Victor Michel,3437105,433287,Agence_moov_Abomey,300000,-2703818,2022-04-21
TRANSFER,274582,Victor Michel,433287,158705,Vincent Joubert,138242,-136340,2022-04-23
TRANSFER,551443,Noël Bourgeois,1348807,797364,Victor Michel,158705,710148,2022-04-25
TRANSFER,517995,Victor Michel,710148,192153,Gérard de la Martinez,1961100,1443105,2022-04-25
CASH_IN,201661,Agence_moov_Ouidah,300000,98339,Victor Michel,192153,393814,2022-04-26
CASH_OUT,146922,Victor Michel,393814,246892,Agence_moov_Abomey,300000,153078,2022-04-27
CASH_OUT,127821,Victor Michel,246892,119071,Agence_moov_Ouidah,300000,172179,2022-04-27
CASH_IN,150678,Agence_moov_Ouidah,300000,149322,Victor Michel,119071,269749,2022-04-27
CASH_OUT,43981,Nathalie Bonnin-Joubert,66483,22502,Agence_moov_Ouidah,300000,256019,2022-04-03
CASH_OUT,6307,Nathalie Bonnin-Joubert,22502,16195,Agence_moov_Cotonou,300000,293693,2022-04-03
TRANSFER,2897,Nathalie Bonnin-Joubert,16195,13298,Aimé Pages,1788800,1785903,2022-04-04
CASH_IN,73959,Agence_moov_Abomey,300000,226041,Nathalie Bonnin-Joubert,13298,87257,2022-04-04
CASH_OUT,80065,Nathalie Bonnin-Joubert,87257,7192,Agence_moov_Abomey,300000,219935,2022-04-05
CASH_IN,290697,Agence_moov_Abomey,300000,9303,Nathalie Bonnin-Joubert,7192,297889,2022-04-06
CASH_IN,198924,Agence_moov_Abomey,300000,101076,Nathalie Bonnin-Joubert,297889,496813,2022-04-08
CASH_IN,128005,Agence_moov_Cotonou,300000,171995,Nathalie Bonnin-Joubert,496813,624818,2022-04-08
TRANSFER,478730,Nathalie Bonnin-Joubert,624818,146088,Anastasie Richard-Neveu,587900,109170,2022-04-08
TRANSFER,664127,Noël Bourgeois,797364,133237,Nathalie Bonnin-Joubert,146088,810215,2022-04-09
CASH_IN,77793,Agence_moov_Abomey,300000,222207,Nathalie Bonnin-Joubert,810215,888008,2022-04-09
TRANSFER,199453,Robert-Louis Gosselin,924800,725347,Nathalie Bonnin-Joubert,888008,1087461,2022-04-10
TRANSFER,468130,Nathalie Bonnin-Joubert,1087461,619331,André Renault,1886830,1418700,2022-04-11
CASH_IN,289756,Agence_moov_Abomey,300000,10244,Nathalie Bonnin-Joubert,619331,909087,2022-04-13
CASH_IN,168904,Agence_moov_Ouidah,300000,131096,Nathalie Bonnin-Joubert,909087,1077991,2022-04-14
CASH_IN,298678,Agence_moov_Abomey,300000,1322,Nathalie Bonnin-Joubert,1077991,1376669,2022-04-14
CASH_IN,249858,Agence_moov_Ouidah,300000,50142,Nathalie Bonnin-Joubert,1376669,1626527,2022-04-17
CASH_IN,196254,Agence_moov_Abomey,300000,103746,Nathalie Bonnin-Joubert,1626527,1822781,2022-04-17
TRANSFER,1203393,Nathalie Bonnin-Joubert,1822781,619388,Rémy Grondin,96000,-1107393,2022-04-17
TRANSFER,475292,Michelle Samson,684900,209608,Nathalie Bonnin-Joubert,619388,1094680,2022-04-18
CASH_OUT,828589,Nathalie Bonnin-Joubert,1094680,266091,Agence_moov_Abomey,300000,-528589,2022-04-19
TRANSFER,1120,Martine Aubert,3144,2024,Nathalie Bonnin-Joubert,266091,267211,2022-04-19
CASH_OUT,138171,Nathalie Bonnin-Joubert,267211,129040,Agence_moov_Cotonou,300000,161829,2022-04-19
TRANSFER,10862,Nathalie Bonnin-Joubert,129040,118178,Manon Lebon,1617600,1606738,2022-04-21
CASH_OUT,85755,Nathalie Bonnin-Joubert,118178,32423,Agence_moov_Abomey,300000,214245,2022-04-22
CASH_IN,262496,Agence_moov_Cotonou,300000,37504,Nathalie Bonnin-Joubert,32423,294919,2022-04-22
TRANSFER,132156,Thibaut de la Roy,350984,218828,Nathalie Bonnin-Joubert,294919,427075,2022-04-25
TRANSFER,13169,Nathalie Bonnin-Joubert,427075,413906,Michel Bouchet,1018500,1005331,2022-04-27
TRANSFER,346846,Tristan Gomez,399421,52575,Renée Le Diaz,370100,23254,2022-04-03
CASH_OUT,39918,Tristan Gomez,52575,12657,Agence_moov_Cotonou,300000,260082,2022-04-05
TRANSFER,174485,Maggie Martinez,862475,687990,Tristan Gomez,12657,187142,2022-04-07
CASH_OUT,51667,Tristan Gomez,187142,135475,Agence_moov_Abomey,300000,248333,2022-04-09
TRANSFER,1320086,Camille Prévost,1704200,384114,Tristan Gomez,135475,1455561,2022-04-09
CASH_IN,35180,Agence_moov_Cotonou,300000,264820,Tristan Gomez,1455561,1490741,2022-04-10
TRANSFER,122043,Tristan Gomez,1490741,1368698,Alphonse Joly,218500,96457,2022-04-10
CASH_OUT,370023,Tristan Gomez,1368698,998675,Agence_moov_Ouidah,300000,-70023,2022-04-11
CASH_OUT,273942,Tristan Gomez,998675,724733,Agence_moov_Abomey,300000,26058,2022-04-12
CASH_IN,143509,Agence_moov_Abomey,300000,156491,Tristan Gomez,724733,868242,2022-04-12
CASH_OUT,623328,Tristan Gomez,868242,244914,Agence_moov_Ouidah,300000,-323328,2022-04-13
CASH_OUT,200898,Tristan Gomez,244914,44016,Agence_moov_Ouidah,300000,99102,2022-04-14
CASH_IN,135740,Agence_moov_Cotonou,300000,164260,Tristan Gomez,44016,179756,2022-04-16
CASH_OUT,176286,Tristan Gomez,179756,3470,Agence_moov_Ouidah,300000,123714,2022-04-16
CASH_IN,221872,Agence_moov_Cotonou,300000,78128,Tristan Gomez,3470,225342,2022-04-17
TRANSFER,77720,Tristan Gomez,225342,147622,Colette-Sophie Prévost,402500,324780,2022-04-17
TRANSFER,101477,Michelle Samson,209608,108131,Tristan Gomez,147622,249099,2022-04-19
CASH_OUT,167409,Tristan Gomez,249099,81690,Agence_moov_Cotonou,300000,132591,2022-04-20
CASH_OUT,3771,Tristan Gomez,81690,77919,Agence_moov_Ouidah,300000,296229,2022-04-20
TRANSFER,1317419,Aimé Pages,1785903,468484,Tristan Gomez,77919,1395338,2022-04-22
TRANSFER,1335392,Tristan Gomez,1395338,59946,Renée Le Diaz,23254,-1312138,2022-04-22
CASH_OUT,12888,Tristan Gomez,59946,47058,Agence_moov_Abomey,300000,287112,2022-04-26
CASH_OUT,6758,Tristan Gomez,47058,40300,Agence_moov_Cotonou,300000,293242,2022-04-27
CASH_IN,233531,Agence_moov_Ouidah,300000,66469,Thomas-Robert Morvan,373300,606831,2022-04-01
CASH_OUT,477551,Thomas-Robert Morvan,606831,129280,Agence_moov_Cotonou,300000,-177551,2022-04-01
CASH_OUT,20011,Thomas-Robert Morvan,129280,109269,Agence_moov_Cotonou,300000,279989,2022-04-05
TRANSFER,93799,Thomas-Robert Morvan,109269,15470,Marcelle-Valentine Guibert,381850,288051,2022-04-08
CASH_OUT,9635,Thomas-Robert Morvan,15470,5835,Agence_moov_Ouidah,300000,290365,2022-04-08
CASH_IN,216101,Agence_moov_Cotonou,300000,83899,Thomas-Robert Morvan,5835,221936,2022-04-08
CASH_IN,144795,Agence_moov_Ouidah,300000,155205,Thomas-Robert Morvan,221936,366731,2022-04-08
CASH_IN,121233,Agence_moov_Cotonou,300000,178767,Thomas-Robert Morvan,366731,487964,2022-04-09
CASH_IN,26308,Agence_moov_Cotonou,300000,273692,Thomas-Robert Morvan,487964,514272,2022-04-09
TRANSFER,411154,Thomas-Robert Morvan,514272,103118,Emmanuel Grégoire,1525900,1114746,2022-04-10
CASH_IN,251752,Agence_moov_Abomey,300000,48248,Thomas-Robert Morvan,103118,354870,2022-04-11
TRANSFER,45146,Thomas-Robert Morvan,354870,309724,Tristan Delahaye,486700,441554,2022-04-11
TRANSFER,187546,Thomas-Robert Morvan,309724,122178,Aurore Charrier,386200,198654,2022-04-12
CASH_OUT,6534,Thomas-Robert Morvan,122178,115644,Agence_moov_Ouidah,300000,293466,2022-04-13
CASH_OUT,64703,Thomas-Robert Morvan,115644,50941,Agence_moov_Ouidah,300000,235297,2022-04-15
CASH_OUT,39401,Thomas-Robert Morvan,50941,11540,Agence_moov_Ouidah,300000,260599,2022-04-16
CASH_IN,68466,Agence_moov_Cotonou,300000,231534,Thomas-Robert Morvan,11540,80006,2022-04-16
CASH_OUT,18202,Thomas-Robert Morvan,80006,61804,Agence_moov_Cotonou,300000,281798,2022-04-17
CASH_IN,260267,Agence_moov_Cotonou,300000,39733,Thomas-Robert Morvan,61804,322071,2022-04-18
TRANSFER,103852,Thomas-Robert Morvan,322071,218219,Anastasie Richard-Neveu,109170,5318,2022-04-18
CASH_OUT,69866,Thomas-Robert Morvan,218219,148353,Agence_moov_Abomey,300000,230134,2022-04-19
TRANSFER,218104,Aimé Pages,468484,250380,Thomas-Robert Morvan,148353,366457,2022-04-22
CASH_IN,267761,Agence_moov_Ouidah,300000,32239,Thomas-Robert Morvan,366457,634218,2022-04-22
CASH_OUT,98850,Thomas-Robert Morvan,634218,535368,Agence_moov_Cotonou,300000,201150,2022-04-22
CASH_OUT,22504,Thomas-Robert Morvan,535368,512864,Agence_moov_Cotonou,300000,277496,2022-04-23
TRANSFER,163076,Nath Loiseau,214645,51569,Thomas-Robert Morvan,512864,675940,2022-04-25
CASH_IN,180329,Agence_moov_Cotonou,300000,119671,Thomas-Robert Morvan,675940,856269,2022-04-25
CASH_IN,290070,Agence_moov_Abomey,300000,9930,Thomas-Robert Morvan,856269,1146339,2022-04-26
TRANSFER,1005058,Thomas-Robert Morvan,1146339,141281,Matthieu-Matthieu Bigot,98461,-906597,2022-04-26
CASH_IN,275147,Agence_moov_Ouidah,300000,24853,Thomas-Robert Morvan,141281,416428,2022-04-26
TRANSFER,1158862,Clémence-Véronique Munoz,1510700,351838,Vincent de la Dumont,165500,-993362,2022-04-01
CASH_IN,275636,Agence_moov_Ouidah,300000,24364,Clémence-Véronique Munoz,351838,627474,2022-04-02
CASH_OUT,37751,Clémence-Véronique Munoz,627474,589723,Agence_moov_Cotonou,300000,262249,2022-04-03
TRANSFER,516728,Clémence-Véronique Munoz,589723,72995,Camille Morvan,807000,290272,2022-04-05
CASH_IN,261666,Agence_moov_Ouidah,300000,38334,Clémence-Véronique Munoz,72995,334661,2022-04-06
CASH_IN,275847,Agence_moov_Cotonou,300000,24153,Clémence-Véronique Munoz,334661,610508,2022-04-08
CASH_OUT,332766,Clémence-Véronique Munoz,610508,277742,Agence_moov_Ouidah,300000,-32766,2022-04-09
CASH_IN,232600,Agence_moov_Cotonou,300000,67400,Clémence-Véronique Munoz,277742,510342,2022-04-10
CASH_OUT,155014,Clémence-Véronique Munoz,510342,355328,Agence_moov_Ouidah,300000,144986,2022-04-12
TRANSFER,306285,Clémence-Véronique Munoz,355328,49043,Véronique Martins de Fleury,328914,22629,2022-04-13
CASH_OUT,38405,Clémence-Véronique Munoz,49043,10638,Agence_moov_Abomey,300000,261595,2022-04-14
CASH_OUT,8280,Clémence-Véronique Munoz,10638,2358,Agence_moov_Cotonou,300000,291720,2022-04-15
CASH_IN,87966,Agence_moov_Cotonou,300000,212034,Clémence-Véronique Munoz,2358,90324,2022-04-16
CASH_OUT,41158,Clémence-Véronique Munoz,90324,49166,Agence_moov_Abomey,300000,258842,2022-04-16
TRANSFER,232714,Émile-René Baudry,698400,465686,Clémence-Véronique Munoz,49166,281880,2022-04-16
CASH_IN,277417,Agence_moov_Cotonou,300000,22583,Clémence-Véronique Munoz,281880,559297,2022-04-18
CASH_OUT,162255,Clémence-Véronique Munoz,559297,397042,Agence_moov_Ouidah,300000,137745,2022-04-19
TRANSFER,80853,Clémence-Véronique Munoz,397042,316189,Paul Rocher-Maillet,1299100,1218247,2022-04-19
CASH_IN,14834,Agence_moov_Abomey,300000,285166,Clémence-Véronique Munoz,316189,331023,2022-04-19
CASH_IN,206724,Agence_moov_Abomey,300000,93276,Clémence-Véronique Munoz,331023,537747,2022-04-20
TRANSFER,217760,Clémence-Véronique Munoz,537747,319987,Stéphane Munoz,259028,41268,2022-04-21
CASH_OUT,234406,Clémence-Véronique Munoz,319987,85581,Agence_moov_Abomey,300000,65594,2022-04-24
CASH_OUT,60919,Clémence-Véronique Munoz,85581,24662,Agence_moov_Cotonou,300000,239081,2022-04-25
TRANSFER,59596,Luc Lévêque-Carre,150522,90926,Clémence-Véronique Munoz,24662,84258,2022-04-25
TRANSFER,48703,Clémence-Véronique Munoz,84258,35555,Mathilde de la Samson,230700,181997,2022-04-25
TRANSFER,35137,Clémence-Véronique Munoz,35555,418,Tristan Bousquet-Gros,1228000,1192863,2022-04-26
TRANSFER,215,Clémence-Véronique Munoz,418,203,Marcelle-Valentine Guibert,288051,287836,2022-04-26
TRANSFER,116,Clémence-Véronique Munoz,203,87,Tristan Delahaye,441554,441438,2022-04-27
TRANSFER,5859,Nicolas Salmon Le Hamon,276025,270166,Colette-Sophie Prévost,324780,318921,2022-04-02
TRANSFER,31155,Aurore Charrier,198654,167499,Nicolas Salmon Le Hamon,270166,301321,2022-04-04
CASH_IN,49752,Agence_moov_Cotonou,300000,250248,Nicolas Salmon Le Hamon,301321,351073,2022-04-04
CASH_OUT,69860,Nicolas Salmon Le Hamon,351073,281213,Agence_moov_Abomey,300000,230140,2022-04-04
TRANSFER,97425,Nicolas Salmon Le Hamon,281213,183788,Thomas Guichard du Renault,1598700,1501275,2022-04-05
TRANSFER,650,Martine Aubert,2024,1374,Nicolas Salmon Le Hamon,183788,184438,2022-04-06
CASH_IN,190382,Agence_moov_Ouidah,300000,109618,Nicolas Salmon Le Hamon,184438,374820,2022-04-07
TRANSFER,304225,Nicolas Salmon Le Hamon,374820,70595,Michelle Samson,108131,-196094,2022-04-07
CASH_OUT,12767,Nicolas Salmon Le Hamon,70595,57828,Agence_moov_Ouidah,300000,287233,2022-04-07
TRANSFER,12731,Camille Morvan,290272,277541,Nicolas Salmon Le Hamon,57828,70559,2022-04-10
CASH_OUT,26515,Nicolas Salmon Le Hamon,70559,44044,Agence_moov_Ouidah,300000,273485,2022-04-11
TRANSFER,427364,Michelle de Étienne,1037700,610336,Nicolas Salmon Le Hamon,44044,471408,2022-04-12
CASH_OUT,202640,Nicolas Salmon Le Hamon,471408,268768,Agence_moov_Ouidah,300000,97360,2022-04-14
TRANSFER,161296,Nicolas Salmon Le Hamon,268768,107472,Emmanuel Grégoire,1114746,953450,2022-04-15
CASH_IN,18272,Agence_moov_Cotonou,300000,281728,Nicolas Salmon Le Hamon,107472,125744,2022-04-16
CASH_OUT,1250,Nicolas Salmon Le Hamon,125744,124494,Agence_moov_Ouidah,300000,298750,2022-04-17
TRANSFER,2329,Anastasie Richard-Neveu,5318,2989,Nicolas Salmon Le Hamon,124494,126823,2022-04-18
TRANSFER,115698,Colette-Sophie Prévost,318921,203223,Nicolas Salmon Le Hamon,126823,242521,2022-04-19
TRANSFER,154017,Tristan Bousquet-Gros,1192863,1038846,Nicolas Salmon Le Hamon,242521,396538,2022-04-20
CASH_IN,12046,Agence_moov_Cotonou,300000,287954,Nicolas Salmon Le Hamon,396538,408584,2022-04-21
CASH_OUT,51452,Nicolas Salmon Le Hamon,408584,357132,Agence_moov_Abomey,300000,248548,2022-04-22
CASH_OUT,33858,Nicolas Salmon Le Hamon,357132,323274,Agence_moov_Abomey,300000,266142,2022-04-24
CASH_OUT,145859,Nicolas Salmon Le Hamon,323274,177415,Agence_moov_Ouidah,300000,154141,2022-04-24
CASH_OUT,170382,Nicolas Salmon Le Hamon,177415,7033,Agence_moov_Cotonou,300000,129618,2022-04-26
CASH_OUT,4722,Nicolas Salmon Le Hamon,7033,2311,Agence_moov_Abomey,300000,295278,2022-04-26
TRANSFER,1910,Nicolas Salmon Le Hamon,2311,401,Camille Prévost,384114,382204,2022-04-27
CASH_IN,744,Agence_moov_Ouidah,300000,299256,Rémy Grondin,-1107393,-1106649,2022-04-01
CASH_IN,26857,Agence_moov_Cotonou,300000,273143,Rémy Grondin,-1106649,-1079792,2022-04-01
CASH_IN,261111,Agence_moov_Ouidah,300000,38889,Rémy Grondin,-1079792,-818681,2022-04-01
CASH_IN,235345,Agence_moov_Abomey,300000,64655,Rémy Grondin,-818681,-583336,2022-04-02
CASH_IN,112514,Agence_moov_Abomey,300000,187486,Rémy Grondin,-583336,-470822,2022-04-02
CASH_IN,40504,Agence_moov_Ouidah,300000,259496,Rémy Grondin,-470822,-430318,2022-04-03
CASH_IN,208245,Agence_moov_Cotonou,300000,91755,Rémy Grondin,-430318,-222073,2022-04-05
CASH_IN,1138,Agence_moov_Abomey,300000,298862,Rémy Grondin,-222073,-220935,2022-04-09
CASH_IN,266177,Agence_moov_Cotonou,300000,33823,Rémy Grondin,-220935,45242,2022-04-10
TRANSFER,711988,Thomas de Blin,1283100,571112,Rémy Grondin,45242,757230,2022-04-12
TRANSFER,748441,Rémy Grondin,757230,8789,Émile-René Baudry,465686,-282755,2022-04-15
CASH_IN,295192,Agence_moov_Abomey,300000,4808,Rémy Grondin,8789,303981,2022-04-16
TRANSFER,50087,Rémy Grondin,303981,253894,Marthe Gilles,18378,-31709,2022-04-18
CASH_OUT,227276,Rémy Grondin,253894,26618,Agence_moov_Cotonou,300000,72724,2022-04-18
TRANSFER,9798,Rémy Grondin,26618,16820,Camille Prévost,382204,372406,2022-04-20
CASH_IN,112001,Agence_moov_Ouidah,300000,187999,Rémy Grondin,16820,128821,2022-04-21
CASH_OUT,7034,Rémy Grondin,128821,121787,Agence_moov_Abomey,300000,292966,2022-04-23
CASH_IN,30198,Agence_moov_Ouidah,300000,269802,Rémy Grondin,121787,151985,2022-04-24
CASH_IN,258935,Agence_moov_Ouidah,300000,41065,Rémy Grondin,151985,410920,2022-04-24
CASH_OUT,99324,Rémy Grondin,410920,311596,Agence_moov_Cotonou,300000,200676,2022-04-26
CASH_IN,295626,Agence_moov_Cotonou,300000,4374,Rémy Grondin,311596,607222,2022-04-26
TRANSFER,474945,Frédérique Fernandes du Bouchet,979000,504055,Thomas Dupont,1963800,1488855,2022-04-01
TRANSFER,85890,Sabine Pineau,465400,379510,Frédérique Fernandes du Bouchet,504055,589945,2022-04-03
CASH_OUT,480520,Frédérique Fernandes du Bouchet,589945,109425,Agence_moov_Ouidah,300000,-180520,2022-04-04
TRANSFER,69956,Frédérique Fernandes du Bouchet,109425,39469,Michelle de Étienne,610336,540380,2022-04-04
TRANSFER,23320,Noémi Bouvier,1875300,1851980,Frédérique Fernandes du Bouchet,39469,62789,2022-04-04
CASH_IN,254562,Agence_moov_Cotonou,300000,45438,Frédérique Fernandes du Bouchet,62789,317351,2022-04-06
CASH_OUT,169539,Frédérique Fernandes du Bouchet,317351,147812,Agence_moov_Ouidah,300000,130461,2022-04-06
CASH_IN,19540,Agence_moov_Ouidah,300000,280460,Frédérique Fernandes du Bouchet,147812,167352,2022-04-09
TRANSFER,153364,Frédérique Fernandes du Bouchet,167352,13988,Mathilde de la Samson,181997,28633,2022-04-09
CASH_OUT,851,Frédérique Fernandes du Bouchet,13988,13137,Agence_moov_Abomey,300000,299149,2022-04-10
TRANSFER,11578,Frédérique Fernandes du Bouchet,13137,1559,Gérard de la Martinez,1443105,1431527,2022-04-10
TRANSFER,351157,Tristan Delahaye,441438,90281,Frédérique Fernandes du Bouchet,1559,352716,2022-04-11
CASH_IN,133543,Agence_moov_Abomey,300000,166457,Frédérique Fernandes du Bouchet,352716,486259,2022-04-12
CASH_OUT,286314,Frédérique Fernandes du Bouchet,486259,199945,Agence_moov_Abomey,300000,13686,2022-04-13
TRANSFER,17433,Frédérique Fernandes du Bouchet,199945,182512,Stéphane Munoz,41268,23835,2022-04-13
TRANSFER,102444,Frédérique Fernandes du Bouchet,182512,80068,Aurore Charrier,167499,65055,2022-04-15
TRANSFER,64663,Frédérique Fernandes du Bouchet,80068,15405,Colette-Sophie Prévost,203223,138560,2022-04-15
CASH_OUT,5533,Frédérique Fernandes du Bouchet,15405,9872,Agence_moov_Cotonou,300000,294467,2022-04-16
TRANSFER,4098,Frédérique Fernandes du Bouchet,9872,5774,Martine Aubert,1374,-2724,2022-04-20
TRANSFER,4907,Frédérique Fernandes du Bouchet,5774,867,Thibaut de la Roy,218828,213921,2022-04-20
CASH_OUT,276,Frédérique Fernandes du Bouchet,867,591,Agence_moov_Cotonou,300000,299724,2022-04-21
CASH_OUT,204,Frédérique Fernandes du Bouchet,591,387,Agence_moov_Abomey,300000,299796,2022-04-23
CASH_IN,3802,Agence_moov_Abomey,300000,296198,Frédérique Fernandes du Bouchet,387,4189,2022-04-23
CASH_IN,151368,Agence_moov_Ouidah,300000,148632,Frédérique Fernandes du Bouchet,4189,155557,2022-04-24
TRANSFER,4879,Frédérique Fernandes du Bouchet,155557,150678,Anastasie Cousin,1785100,1780221,2022-04-24
TRANSFER,24560,Frédérique Fernandes du Bouchet,150678,126118,Michelle-Dorothée Lévêque,1339900,1315340,2022-04-24
CASH_IN,29798,Agence_moov_Ouidah,300000,270202,Frédérique Fernandes du Bouchet,126118,155916,2022-04-25
CASH_IN,51909,Agence_moov_Ouidah,300000,248091,Frédérique Fernandes du Bouchet,155916,207825,2022-04-25
CASH_OUT,54967,Frédérique Fernandes du Bouchet,207825,152858,Agence_moov_Abomey,300000,245033,2022-04-25
CASH_IN,291547,Agence_moov_Cotonou,300000,8453,Frédérique Fernandes du Bouchet,152858,444405,2022-04-27
CASH_OUT,1177371,Théodore Joseph-Lefebvre,1687500,510129,Agence_moov_Ouidah,300000,-877371,2022-04-03
CASH_OUT,231681,Théodore Joseph-Lefebvre,510129,278448,Agence_moov_Ouidah,300000,68319,2022-04-03
CASH_IN,277757,Agence_moov_Cotonou,300000,22243,Théodore Joseph-Lefebvre,278448,556205,2022-04-04
CASH_IN,88171,Agence_moov_Abomey,300000,211829,Théodore Joseph-Lefebvre,556205,644376,2022-04-05
CASH_IN,1356,Agence_moov_Cotonou,300000,298644,Théodore Joseph-Lefebvre,644376,645732,2022-04-05
TRANSFER,553045,Théodore Joseph-Lefebvre,645732,92687,Camille Prévost,372406,-180639,2022-04-06
CASH_IN,25039,Agence_moov_Ouidah,300000,274961,Théodore Joseph-Lefebvre,92687,117726,2022-04-08
CASH_IN,137349,Agence_moov_Ouidah,300000,162651,Théodore Joseph-Lefebvre,117726,255075,2022-04-08
TRANSFER,221873,Théodore Joseph-Lefebvre,255075,33202,Adèle Da Silva-Klein,360140,138267,2022-04-09
TRANSFER,375914,Simone Muller de la Brun,563968,188054,Théodore Joseph-Lefebvre,33202,409116,2022-04-09
CASH_IN,37938,Agence_moov_Ouidah,300000,262062,Théodore Joseph-Lefebvre,409116,447054,2022-04-11
CASH_IN,277332,Agence_moov_Abomey,300000,22668,Théodore Joseph-Lefebvre,447054,724386,2022-04-12
TRANSFER,334650,Mathilde Picard du Delmas,339800,5150,Théodore Joseph-Lefebvre,724386,1059036,2022-04-13
TRANSFER,1100688,Jules-Roland Bousquet,1900400,799712,Théodore Joseph-Lefebvre,1059036,2159724,2022-04-13
TRANSFER,78034,Tristan Delahaye,90281,12247,Théodore Joseph-Lefebvre,2159724,2237758,2022-04-17
CASH_OUT,1654085,Théodore Joseph-Lefebvre,2237758,583673,Agence_moov_Abomey,300000,-1354085,2022-04-20
CASH_OUT,405639,Théodore Joseph-Lefebvre,583673,178034,Agence_moov_Cotonou,300000,-105639,2022-04-21
CASH_OUT,142824,Théodore Joseph-Lefebvre,178034,35210,Agence_moov_Cotonou,300000,157176,2022-04-21
CASH_IN,103244,Agence_moov_Abomey,300000,196756,Théodore Joseph-Lefebvre,35210,138454,2022-04-22
CASH_OUT,127582,Théodore Joseph-Lefebvre,138454,10872,Agence_moov_Cotonou,300000,172418,2022-04-23
TRANSFER,3927,Théodore Joseph-Lefebvre,10872,6945,Adèle Da Silva-Klein,138267,134340,2022-04-26
TRANSFER,49225,Marcelle-Valentine Guibert,287836,238611,Théodore Joseph-Lefebvre,6945,56170,2022-04-26
TRANSFER,10845,Théodore Joseph-Lefebvre,56170,45325,Paul Rocher-Maillet,1218247,1207402,2022-04-27
TRANSFER,43523,Théodore Joseph-Lefebvre,45325,1802,Luc Lévêque-Carre,90926,47403,2022-04-27
TRANSFER,9205,Nath Loiseau,51569,42364,Lucy Lamy,579600,588805,2022-04-03
CASH_OUT,545700,Lucy Lamy,588805,43105,Agence_moov_Cotonou,300000,-245700,2022-04-04
TRANSFER,36073,Lucy Lamy,43105,7032,Tristan Delahaye,12247,-23826,2022-04-04
CASH_IN,266175,Agence_moov_Cotonou,300000,33825,Lucy Lamy,7032,273207,2022-04-05
TRANSFER,390683,Philippe Philippe,558257,167574,Lucy Lamy,273207,663890,2022-04-07
CASH_OUT,300163,Lucy Lamy,663890,363727,Agence_moov_Cotonou,300000,-163,2022-04-09
TRANSFER,130905,Lucy Lamy,363727,232822,Sabine Pineau,379510,248605,2022-04-12
CASH_IN,296016,Agence_moov_Cotonou,300000,3984,Lucy Lamy,232822,528838,2022-04-13
TRANSFER,344055,Lucy Lamy,528838,184783,Thérèse Hubert,608600,264545,2022-04-14
CASH_IN,15041,Agence_moov_Cotonou,300000,284959,Lucy Lamy,184783,199824,2022-04-15
CASH_OUT,23369,Lucy Lamy,199824,176455,Agence_moov_Abomey,300000,276631,2022-04-17
TRANSFER,1233413,Alix Barbe,1833200,599787,Lucy Lamy,176455,1409868,2022-04-17
CASH_IN,4348,Agence_moov_Cotonou,300000,295652,Lucy Lamy,1409868,1414216,2022-04-20
CASH_OUT,500301,Lucy Lamy,1414216,913915,Agence_moov_Abomey,300000,-200301,2022-04-21
CASH_OUT,193203,Lucy Lamy,913915,720712,Agence_moov_Cotonou,300000,106797,2022-04-22
CASH_OUT,611997,Lucy Lamy,720712,108715,Agence_moov_Abomey,300000,-311997,2022-04-22
CASH_IN,252907,Agence_moov_Cotonou,300000,47093,Lucy Lamy,108715,361622,2022-04-22
CASH_IN,228176,Agence_moov_Cotonou,300000,71824,Lucy Lamy,361622,589798,2022-04-25
CASH_OUT,16396,Lucy Lamy,589798,573402,Agence_moov_Cotonou,300000,283604,2022-04-26
CASH_IN,244278,Agence_moov_Ouidah,300000,55722,Lucy Lamy,573402,817680,2022-04-27
TRANSFER,352382,Michelle-Dorothée Lévêque,1315340,962958,Lucy Lamy,817680,1170062,2022-04-27
CASH_IN,17071,Agence_moov_Ouidah,300000,282929,Mathilde de la Samson,28633,45704,2022-04-02
TRANSFER,1260730,Thomas Dupont,1488855,228125,Mathilde de la Samson,45704,1306434,2022-04-03
CASH_IN,26725,Agence_moov_Ouidah,300000,273275,Mathilde de la Samson,1306434,1333159,2022-04-04
CASH_OUT,737324,Mathilde de la Samson,1333159,595835,Agence_moov_Abomey,300000,-437324,2022-04-04
CASH_OUT,261997,Mathilde de la Samson,595835,333838,Agence_moov_Ouidah,300000,38003,2022-04-05
CASH_OUT,18420,Mathilde de la Samson,333838,315418,Agence_moov_Cotonou,300000,281580,2022-04-05
CASH_IN,168408,Agence_moov_Ouidah,300000,131592,Mathilde de la Samson,315418,483826,2022-04-07
TRANSFER,1089654,Paul Rocher-Maillet,1207402,117748,Mathilde de la Samson,483826,1573480,2022-04-09
CASH_IN,119097,Agence_moov_Abomey,300000,180903,Mathilde de la Samson,1573480,1692577,2022-04-10
CASH_OUT,1630068,Mathilde de la Samson,1692577,62509,Agence_moov_Cotonou,300000,-1330068,2022-04-11
CASH_IN,165585,Agence_moov_Ouidah,300000,134415,Mathilde de la Samson,62509,228094,2022-04-13
CASH_IN,80127,Agence_moov_Abomey,300000,219873,Mathilde de la Samson,228094,308221,2022-04-13
CASH_IN,154840,Agence_moov_Cotonou,300000,145160,Mathilde de la Samson,308221,463061,2022-04-14
CASH_IN,270576,Agence_moov_Ouidah,300000,29424,Mathilde de la Samson,463061,733637,2022-04-14
CASH_IN,175430,Agence_moov_Cotonou,300000,124570,Mathilde de la Samson,733637,909067,2022-04-15
CASH_OUT,46044,Mathilde de la Samson,909067,863023,Agence_moov_Ouidah,300000,253956,2022-04-16
CASH_OUT,633888,Mathilde de la Samson,863023,229135,Agence_moov_Abomey,300000,-333888,2022-04-17
CASH_IN,66699,Agence_moov_Cotonou,300000,233301,Mathilde de la Samson,229135,295834,2022-04-18
TRANSFER,59978,Paul Rocher-Maillet,117748,57770,Mathilde de la Samson,295834,355812,2022-04-20
CASH_OUT,322004,Mathilde de la Samson,355812,33808,Agence_moov_Cotonou,300000,-22004,2022-04-21
CASH_IN,42911,Agence_moov_Abomey,300000,257089,Mathilde de la Samson,33808,76719,2022-04-22
TRANSFER,55884,Aurore Charrier,65055,9171,Mathilde de la Samson,76719,132603,2022-04-22
CASH_OUT,73195,Mathilde de la Samson,132603,59408,Agence_moov_Ouidah,300000,226805,2022-04-24
TRANSFER,484764,Michelle-Dorothée Lévêque,962958,478194,Mathilde de la Samson,59408,544172,2022-04-26
CASH_IN,207552,Agence_moov_Abomey,300000,92448,Mathilde de la Samson,544172,751724,2022-04-26
CASH_IN,123056,Agence_moov_Cotonou,300000,176944,Mathilde de la Samson,751724,874780,2022-04-27
TRANSFER,99998,Philippe Philippe,167574,67576,Léon Da Costa,629000,529002,2022-04-01
TRANSFER,14157,Philippe Philippe,67576,53419,Stéphane Munoz,23835,9678,2022-04-01
TRANSFER,20185,Philippe Philippe,53419,33234,Sabine Pineau,248605,228420,2022-04-01
CASH_OUT,10917,Philippe Philippe,33234,22317,Agence_moov_Abomey,300000,289083,2022-04-06
CASH_OUT,13770,Philippe Philippe,22317,8547,Agence_moov_Cotonou,300000,286230,2022-04-08
CASH_OUT,7762,Philippe Philippe,8547,785,Agence_moov_Cotonou,300000,292238,2022-04-09
TRANSFER,230,Philippe Philippe,785,555,Gérard de la Martinez,1431527,1431297,2022-04-10
TRANSFER,82345,Sabine Pineau,228420,146075,Philippe Philippe,555,82900,2022-04-11
TRANSFER,63228,Philippe Philippe,82900,19672,Anastasie Richard-Neveu,2989,-60239,2022-04-11
CASH_IN,171846,Agence_moov_Abomey,300000,128154,Philippe Philippe,19672,191518,2022-04-12
CASH_OUT,164285,Philippe Philippe,191518,27233,Agence_moov_Ouidah,300000,135715,2022-04-12
CASH_IN,81633,Agence_moov_Cotonou,300000,218367,Philippe Philippe,27233,108866,2022-04-12
CASH_OUT,105130,Philippe Philippe,108866,3736,Agence_moov_Cotonou,300000,194870,2022-04-12
CASH_OUT,1546,Philippe Philippe,3736,2190,Agence_moov_Cotonou,300000,298454,2022-04-13
TRANSFER,516,Philippe Philippe,2190,1674,Camille Morvan,277541,277025,2022-04-15
CASH_OUT,1632,Philippe Philippe,1674,42,Agence_moov_Abomey,300000,298368,2022-04-15
CASH_IN,55715,Agence_moov_Abomey,300000,244285,Philippe Philippe,42,55757,2022-04-16
CASH_IN,175626,Agence_moov_Abomey,300000,124374,Philippe Philippe,55757,231383,2022-04-17
TRANSFER,216692,Michelle-Dorothée Lévêque,478194,261502,Philippe Philippe,231383,448075,2022-04-17
TRANSFER,164734,Philippe Philippe,448075,283341,Alix Barbe,599787,435053,2022-04-18
TRANSFER,1122,Aurore Charrier,9171,8049,Philippe Philippe,283341,284463,2022-04-19
CASH_OUT,127407,Philippe Philippe,284463,157056,Agence_moov_Abomey,300000,172593,2022-04-19
TRANSFER,156880,Jules Fernandes,323112,166232,Philippe Philippe,157056,313936,2022-04-19
TRANSFER,209892,Philippe Philippe,313936,104044,Philippe Philippe,313936,523828,2022-04-23
CASH_OUT,5972,Philippe Philippe,104044,98072,Agence_moov_Abomey,300000,294028,2022-04-25
CASH_OUT,81455,Philippe Philippe,98072,16617,Agence_moov_Ouidah,300000,218545,2022-04-26
TRANSFER,343561,Thomas de Blin,571112,227551,Philippe Philippe,16617,360178,2022-04-27
CASH_OUT,128990,Thibaut de la Roy,213921,84931,Agence_moov_Ouidah,300000,171010,2022-04-01
TRANSFER,73961,Thibaut de la Roy,84931,10970,Anastasie Cousin,1780221,1706260,2022-04-05
TRANSFER,10407,Thibaut de la Roy,10970,563,Tristan Bousquet-Gros,1038846,1028439,2022-04-05
TRANSFER,425,Thibaut de la Roy,563,138,Thomas Guichard du Renault,1501275,1500850,2022-04-08
TRANSFER,843327,Robert Clerc,1784500,941173,Thibaut de la Roy,138,843465,2022-04-08
CASH_IN,223667,Agence_moov_Abomey,300000,76333,Thibaut de la Roy,843465,1067132,2022-04-10
CASH_OUT,674261,Thibaut de la Roy,1067132,392871,Agence_moov_Abomey,300000,-374261,2022-04-10
TRANSFER,153495,Thibaut de la Roy,392871,239376,Suzanne Bodin,1219378,1065883,2022-04-11
CASH_IN,161139,Agence_moov_Cotonou,300000,138861,Thibaut de la Roy,239376,400515,2022-04-12
CASH_OUT,225069,Thibaut de la Roy,400515,175446,Agence_moov_Abomey,300000,74931,2022-04-13
CASH_OUT,132357,Thibaut de la Roy,175446,43089,Agence_moov_Ouidah,300000,167643,2022-04-13
TRANSFER,2441,Thibaut de la Roy,43089,40648,Raymond Lévy,665700,663259,2022-04-14
TRANSFER,18532,Gérard de la Martinez,1431297,1412765,Thibaut de la Roy,40648,59180,2022-04-15
TRANSFER,44009,Thibaut de la Roy,59180,15171,Thibaut de la Roy,59180,103189,2022-04-15
TRANSFER,1127598,Manon Lebon,1606738,479140,Thibaut de la Roy,15171,1142769,2022-04-16
TRANSFER,86375,Colette-Sophie Prévost,138560,52185,Thibaut de la Roy,1142769,1229144,2022-04-18
CASH_OUT,779835,Thibaut de la Roy,1229144,449309,Agence_moov_Cotonou,300000,-479835,2022-04-20
CASH_OUT,325563,Thibaut de la Roy,449309,123746,Agence_moov_Ouidah,300000,-25563,2022-04-21
TRANSFER,35213,Thibaut de la Roy,123746,88533,Robert-Louis Gosselin,725347,690134,2022-04-21
CASH_IN,267730,Agence_moov_Ouidah,300000,32270,Thibaut de la Roy,88533,356263,2022-04-22
CASH_IN,289552,Agence_moov_Cotonou,300000,10448,Thibaut de la Roy,356263,645815,2022-04-22
CASH_OUT,516086,Thibaut de la Roy,645815,129729,Agence_moov_Cotonou,300000,-216086,2022-04-23
CASH_IN,138685,Agence_moov_Ouidah,300000,161315,Thibaut de la Roy,129729,268414,2022-04-26
CASH_IN,100508,Agence_moov_Ouidah,300000,199492,Thibaut de la Roy,268414,368922,2022-04-27
CASH_IN,95537,Agence_moov_Ouidah,300000,204463,Thibaut de la Roy,368922,464459,2022-04-27
CASH_OUT,37122,Aimé Pages,250380,213258,Agence_moov_Abomey,300000,262878,2022-04-04
CASH_IN,6053,Agence_moov_Abomey,300000,293947,Aimé Pages,213258,219311,2022-04-04
CASH_IN,240830,Agence_moov_Ouidah,300000,59170,Aimé Pages,219311,460141,2022-04-04
CASH_OUT,56017,Aimé Pages,460141,404124,Agence_moov_Abomey,300000,243983,2022-04-04
CASH_OUT,172919,Aimé Pages,404124,231205,Agence_moov_Abomey,300000,127081,2022-04-05
CASH_IN,78529,Agence_moov_Abomey,300000,221471,Aimé Pages,231205,309734,2022-04-07
TRANSFER,179045,Raymond Lévy,663259,484214,Aimé Pages,309734,488779,2022-04-09
CASH_OUT,107789,Aimé Pages,488779,380990,Agence_moov_Ouidah,300000,192211,2022-04-10
TRANSFER,29628,Aimé Pages,380990,351362,Simone Muller de la Brun,188054,158426,2022-04-13
CASH_IN,15855,Agence_moov_Ouidah,300000,284145,Aimé Pages,351362,367217,2022-04-14
CASH_OUT,305267,Aimé Pages,367217,61950,Agence_moov_Ouidah,300000,-5267,2022-04-14
CASH_OUT,12339,Aimé Pages,61950,49611,Agence_moov_Abomey,300000,287661,2022-04-15
TRANSFER,28657,Aimé Pages,49611,20954,Paul Rocher-Maillet,57770,29113,2022-04-15
TRANSFER,272508,André Renault,1418700,1146192,Aimé Pages,20954,293462,2022-04-17
CASH_IN,137772,Agence_moov_Abomey,300000,162228,Aimé Pages,293462,431234,2022-04-20
TRANSFER,876321,Anastasie Cousin,1706260,829939,Aimé Pages,431234,1307555,2022-04-21
CASH_IN,183941,Agence_moov_Abomey,300000,116059,Aimé Pages,1307555,1491496,2022-04-22
CASH_IN,162665,Agence_moov_Abomey,300000,137335,Aimé Pages,1491496,1654161,2022-04-22
CASH_OUT,1179681,Aimé Pages,1654161,474480,Agence_moov_Cotonou,300000,-879681,2022-04-23
CASH_IN,110078,Agence_moov_Abomey,300000,189922,Aimé Pages,474480,584558,2022-04-23
CASH_IN,199834,Agence_moov_Ouidah,300000,100166,Aimé Pages,584558,784392,2022-04-23
CASH_OUT,481458,Aimé Pages,784392,302934,Agence_moov_Abomey,300000,-181458,2022-04-24
CASH_IN,295269,Agence_moov_Ouidah,300000,4731,Aimé Pages,302934,598203,2022-04-26
CASH_IN,237392,Agence_moov_Cotonou,300000,62608,Raymond Lévy,484214,721606,2022-04-02
TRANSFER,131286,Thérèse Hubert,264545,133259,Raymond Lévy,721606,852892,2022-04-03
CASH_IN,57438,Agence_moov_Ouidah,300000,242562,Raymond Lévy,852892,910330,2022-04-05
CASH_IN,158032,Agence_moov_Abomey,300000,141968,Raymond Lévy,910330,1068362,2022-04-05
CASH_IN,289775,Agence_moov_Cotonou,300000,10225,Raymond Lévy,1068362,1358137,2022-04-06
TRANSFER,80043,Jules Fernandes,166232,86189,Raymond Lévy,1358137,1438180,2022-04-06
CASH_OUT,276837,Raymond Lévy,1438180,1161343,Agence_moov_Cotonou,300000,23163,2022-04-07
CASH_OUT,590647,Raymond Lévy,1161343,570696,Agence_moov_Abomey,300000,-290647,2022-04-07
CASH_OUT,412996,Raymond Lévy,570696,157700,Agence_moov_Abomey,300000,-112996,2022-04-08
TRANSFER,17746,Paul Rocher-Maillet,29113,11367,Raymond Lévy,157700,175446,2022-04-10
TRANSFER,6376,Stéphane Munoz,9678,3302,Raymond Lévy,175446,181822,2022-04-12
CASH_IN,44993,Agence_moov_Ouidah,300000,255007,Raymond Lévy,181822,226815,2022-04-12
TRANSFER,51480,Raymond Lévy,226815,175335,Thomas Guichard du Renault,1500850,1449370,2022-04-12
CASH_IN,198786,Agence_moov_Ouidah,300000,101214,Raymond Lévy,175335,374121,2022-04-12
CASH_IN,242122,Agence_moov_Cotonou,300000,57878,Raymond Lévy,374121,616243,2022-04-13
TRANSFER,344251,Suzanne Bodin,1065883,721632,Raymond Lévy,616243,960494,2022-04-14
CASH_OUT,86997,Raymond Lévy,960494,873497,Agence_moov_Abomey,300000,213003,2022-04-14
CASH_OUT,96974,Raymond Lévy,873497,776523,Agence_moov_Ouidah,300000,203026,2022-04-15
CASH_IN,196898,Agence_moov_Ouidah,300000,103102,Raymond Lévy,776523,973421,2022-04-17
TRANSFER,13110,Véronique Martins de Fleury,22629,9519,Raymond Lévy,973421,986531,2022-04-19
CASH_IN,101468,Agence_moov_Cotonou,300000,198532,Raymond Lévy,986531,1087999,2022-04-20
CASH_IN,184476,Agence_moov_Abomey,300000,115524,Raymond Lévy,1087999,1272475,2022-04-20
TRANSFER,886089,Raymond Lévy,1272475,386386,Audrey Julien de Leleu,769800,-116289,2022-04-20
CASH_IN,96356,Agence_moov_Abomey,300000,203644,Raymond Lévy,386386,482742,2022-04-21
CASH_IN,50742,Agence_moov_Abomey,300000,249258,Raymond Lévy,482742,533484,2022-04-21
CASH_IN,10419,Agence_moov_Ouidah,300000,289581,Raymond Lévy,533484,543903,2022-04-24
CASH_IN,115727,Agence_moov_Cotonou,300000,184273,Raymond Lévy,543903,659630,2022-04-24
TRANSFER,117928,Michelle de Étienne,540380,422452,Noël Bourgeois,133237,15309,2022-04-03
CASH_OUT,263464,Michelle de Étienne,422452,158988,Agence_moov_Cotonou,300000,36536,2022-04-03
CASH_IN,238735,Agence_moov_Ouidah,300000,61265,Michelle de Étienne,158988,397723,2022-04-06
CASH_IN,112511,Agence_moov_Ouidah,300000,187489,Michelle de Étienne,397723,510234,2022-04-07
CASH_IN,197713,Agence_moov_Ouidah,300000,102287,Michelle de Étienne,510234,707947,2022-04-08
CASH_IN,297663,Agence_moov_Abomey,300000,2337,Michelle de Étienne,707947,1005610,2022-04-08
TRANSFER,455313,Michelle de Étienne,1005610,550297,Thomas Guichard du Renault,1449370,994057,2022-04-10
CASH_IN,285906,Agence_moov_Cotonou,300000,14094,Michelle de Étienne,550297,836203,2022-04-12
CASH_IN,203965,Agence_moov_Abomey,300000,96035,Michelle de Étienne,836203,1040168,2022-04-14
CASH_OUT,273123,Michelle de Étienne,1040168,767045,Agence_moov_Abomey,300000,26877,2022-04-15
TRANSFER,747625,Michelle de Étienne,767045,19420,Jules-Roland Bousquet,799712,52087,2022-04-16
CASH_OUT,13005,Michelle de Étienne,19420,6415,Agence_moov_Abomey,300000,286995,2022-04-16
CASH_OUT,4986,Michelle de Étienne,6415,1429,Agence_moov_Cotonou,300000,295014,2022-04-17
CASH_IN,164719,Agence_moov_Abomey,300000,135281,Michelle de Étienne,1429,166148,2022-04-18
TRANSFER,36957,Michelle de Étienne,166148,129191,Tristan Bousquet-Gros,1028439,991482,2022-04-18
CASH_OUT,44833,Michelle de Étienne,129191,84358,Agence_moov_Cotonou,300000,255167,2022-04-19
CASH_IN,4153,Agence_moov_Abomey,300000,295847,Michelle de Étienne,84358,88511,2022-04-22
CASH_OUT,2100,Michelle de Étienne,88511,86411,Agence_moov_Abomey,300000,297900,2022-04-24
TRANSFER,18531,Jules-Roland Bousquet,52087,33556,Michelle de Étienne,86411,104942,2022-04-25
TRANSFER,27050,Michelle de Étienne,104942,77892,Michel Bouchet,1005331,978281,2022-04-26
CASH_IN,185580,Agence_moov_Abomey,300000,114420,Michelle de Étienne,77892,263472,2022-04-26
CASH_OUT,129986,Michelle de Étienne,263472,133486,Agence_moov_Cotonou,300000,170014,2022-04-27
CASH_OUT,3859,Alix Barbe,435053,431194,Agence_moov_Cotonou,300000,296141,2022-04-04
TRANSFER,102749,Alix Barbe,431194,328445,Sabine Pineau,146075,43326,2022-04-04
CASH_OUT,153001,Alix Barbe,328445,175444,Agence_moov_Ouidah,300000,146999,2022-04-05
TRANSFER,1309370,Noémi Bouvier,1851980,542610,Alix Barbe,175444,1484814,2022-04-07
CASH_IN,273711,Agence_moov_Ouidah,300000,26289,Alix Barbe,1484814,1758525,2022-04-08
TRANSFER,1233732,Alix Barbe,1758525,524793,Maggie Martinez,687990,-545742,2022-04-08
CASH_OUT,270837,Alix Barbe,524793,253956,Agence_moov_Ouidah,300000,29163,2022-04-10
TRANSFER,2209,Stéphane Munoz,3302,1093,Alix Barbe,253956,256165,2022-04-11
CASH_OUT,86042,Alix Barbe,256165,170123,Agence_moov_Abomey,300000,213958,2022-04-14
CASH_IN,145010,Agence_moov_Cotonou,300000,154990,Alix Barbe,170123,315133,2022-04-14
CASH_IN,172857,Agence_moov_Ouidah,300000,127143,Alix Barbe,315133,487990,2022-04-15
TRANSFER,88399,Anastasie Cousin,829939,741540,Alix Barbe,487990,576389,2022-04-16
TRANSFER,27858,Michelle-Dorothée Lévêque,261502,233644,Alix Barbe,576389,604247,2022-04-17
CASH_OUT,518100,Alix Barbe,604247,86147,Agence_moov_Cotonou,300000,-218100,2022-04-18
TRANSFER,37969,Luc Lévêque-Carre,47403,9434,Alix Barbe,86147,124116,2022-04-19
CASH_IN,192323,Agence_moov_Ouidah,300000,107677,Alix Barbe,124116,316439,2022-04-20
CASH_OUT,106721,Alix Barbe,316439,209718,Agence_moov_Ouidah,300000,193279,2022-04-22
CASH_OUT,169539,Alix Barbe,209718,40179,Agence_moov_Ouidah,300000,130461,2022-04-25
TRANSFER,505,Alix Barbe,40179,39674,Robert Clerc,941173,940668,2022-04-25
CASH_IN,95407,Agence_moov_Abomey,300000,204593,Alix Barbe,39674,135081,2022-04-26
CASH_IN,268442,Agence_moov_Ouidah,300000,31558,Alix Barbe,135081,403523,2022-04-26
CASH_OUT,688,Mathilde Picard du Delmas,5150,4462,Agence_moov_Ouidah,300000,299312,2022-04-01
TRANSFER,1876,Mathilde Picard du Delmas,4462,2586,Michelle-Dorothée Lévêque,233644,231768,2022-04-02
TRANSFER,1528,Mathilde Picard du Delmas,2586,1058,Noémi Bouvier,542610,541082,2022-04-03
CASH_OUT,267,Mathilde Picard du Delmas,1058,791,Agence_moov_Cotonou,300000,299733,2022-04-06
TRANSFER,4698,Paul Rocher-Maillet,11367,6669,Mathilde Picard du Delmas,791,5489,2022-04-06
CASH_OUT,566,Mathilde Picard du Delmas,5489,4923,Agence_moov_Cotonou,300000,299434,2022-04-08
TRANSFER,34387,Sabine Pineau,43326,8939,Mathilde Picard du Delmas,4923,39310,2022-04-09
TRANSFER,311694,Manon Lebon,479140,167446,Mathilde Picard du Delmas,39310,351004,2022-04-09
CASH_OUT,171210,Mathilde Picard du Delmas,351004,179794,Agence_moov_Abomey,300000,128790,2022-04-10
CASH_OUT,111608,Mathilde Picard du Delmas,179794,68186,Agence_moov_Abomey,300000,188392,2022-04-10
CASH_OUT,7082,Mathilde Picard du Delmas,68186,61104,Agence_moov_Cotonou,300000,292918,2022-04-10
CASH_IN,91306,Agence_moov_Abomey,300000,208694,Mathilde Picard du Delmas,61104,152410,2022-04-11
CASH_IN,129569,Agence_moov_Ouidah,300000,170431,Mathilde Picard du Delmas,152410,281979,2022-04-11
CASH_OUT,109916,Mathilde Picard du Delmas,281979,172063,Agence_moov_Cotonou,300000,190084,2022-04-13
CASH_IN,127696,Agence_moov_Cotonou,300000,172304,Mathilde Picard du Delmas,172063,299759,2022-04-14
TRANSFER,9353,Colette-Sophie Prévost,52185,42832,Mathilde Picard du Delmas,299759,309112,2022-04-14
CASH_IN,130942,Agence_moov_Ouidah,300000,169058,Mathilde Picard du Delmas,309112,440054,2022-04-15
CASH_IN,214208,Agence_moov_Ouidah,300000,85792,Mathilde Picard du Delmas,440054,654262,2022-04-16
CASH_IN,131778,Agence_moov_Ouidah,300000,168222,Mathilde Picard du Delmas,654262,786040,2022-04-17
CASH_OUT,437878,Mathilde Picard du Delmas,786040,348162,Agence_moov_Ouidah,300000,-137878,2022-04-17
TRANSFER,206189,Mathilde Picard du Delmas,348162,141973,Mathilde Picard du Delmas,348162,554351,2022-04-18
TRANSFER,45478,Marcelle-Valentine Guibert,238611,193133,Mathilde Picard du Delmas,141973,187451,2022-04-20
CASH_OUT,164668,Mathilde Picard du Delmas,187451,22783,Agence_moov_Cotonou,300000,135332,2022-04-24
CASH_OUT,13321,Mathilde Picard du Delmas,22783,9462,Agence_moov_Ouidah,300000,286679,2022-04-24
CASH_IN,204586,Agence_moov_Cotonou,300000,95414,Mathilde Picard du Delmas,9462,214048,2022-04-25
TRANSFER,309431,Léon Da Costa,529002,219571,Mathilde Picard du Delmas,214048,523479,2022-04-26
CASH_OUT,92962,Mathilde Picard du Delmas,523479,430517,Agence_moov_Cotonou,300000,207038,2022-04-27
CASH_IN,254077,Agence_moov_Ouidah,300000,45923,Tristan Delahaye,-23826,230251,2022-04-03
CASH_IN,165731,Agence_moov_Cotonou,300000,134269,Tristan Delahaye,230251,395982,2022-04-04
TRANSFER,615488,Céline Collin-Hervé,1694100,1078612,Tristan Delahaye,395982,1011470,2022-04-05
TRANSFER,10935,Tristan Delahaye,1011470,1000535,Adèle Da Silva-Klein,134340,123405,2022-04-06
TRANSFER,778702,Tristan Delahaye,1000535,221833,Paul Rocher-Maillet,6669,-772033,2022-04-07
CASH_OUT,110515,Tristan Delahaye,221833,111318,Agence_moov_Abomey,300000,189485,2022-04-08
CASH_IN,259768,Agence_moov_Abomey,300000,40232,Tristan Delahaye,111318,371086,2022-04-10
CASH_OUT,216620,Tristan Delahaye,371086,154466,Agence_moov_Abomey,300000,83380,2022-04-10
CASH_OUT,23956,Tristan Delahaye,154466,130510,Agence_moov_Abomey,300000,276044,2022-04-12
CASH_OUT,52785,Tristan Delahaye,130510,77725,Agence_moov_Abomey,300000,247215,2022-04-13
CASH_IN,115032,Agence_moov_Cotonou,300000,184968,Tristan Delahaye,77725,192757,2022-04-13
CASH_OUT,9462,Tristan Delahaye,192757,183295,Agence_moov_Abomey,300000,290538,2022-04-15
CASH_IN,31913,Agence_moov_Cotonou,300000,268087,Tristan Delahaye,183295,215208,2022-04-19
CASH_IN,250995,Agence_moov_Cotonou,300000,49005,Tristan Delahaye,215208,466203,2022-04-20
TRANSFER,175317,Robert-Louis Gosselin,690134,514817,Tristan Delahaye,466203,641520,2022-04-20
TRANSFER,639359,Tristan Delahaye,641520,2161,Aurore Charrier,8049,-631310,2022-04-20
CASH_OUT,1540,Tristan Delahaye,2161,621,Agence_moov_Cotonou,300000,298460,2022-04-21
TRANSFER,10073,Colette-Sophie Prévost,42832,32759,Tristan Delahaye,621,10694,2022-04-21
TRANSFER,9352,Tristan Delahaye,10694,1342,Nath Loiseau,42364,33012,2022-04-21
CASH_OUT,1157,Tristan Delahaye,1342,185,Agence_moov_Abomey,300000,298843,2022-04-22
TRANSFER,6649,Noël Bourgeois,15309,8660,Tristan Delahaye,185,6834,2022-04-25
TRANSFER,258659,Céline Collin-Hervé,1078612,819953,Tristan Delahaye,6834,265493,2022-04-26
CASH_IN,246946,Agence_moov_Cotonou,300000,53054,Tristan Delahaye,265493,512439,2022-04-26
TRANSFER,45062,Noémi Bouvier,541082,496020,Tristan Delahaye,512439,557501,2022-04-27
TRANSFER,594276,Tristan Bousquet-Gros,991482,397206,Marcelle-Valentine Guibert,193133,-401143,2022-04-02
TRANSFER,214335,Tristan Bousquet-Gros,397206,182871,Jules-Roland Bousquet,33556,-180779,2022-04-03
CASH_IN,152478,Agence_moov_Abomey,300000,147522,Tristan Bousquet-Gros,182871,335349,2022-04-03
CASH_OUT,39037,Tristan Bousquet-Gros,335349,296312,Agence_moov_Abomey,300000,260963,2022-04-04
TRANSFER,6105,Nath Loiseau,33012,26907,Tristan Bousquet-Gros,296312,302417,2022-04-06
TRANSFER,43026,Tristan Bousquet-Gros,302417,259391,Emmanuel Grégoire,953450,910424,2022-04-06
TRANSFER,2524,Luc Lévêque-Carre,9434,6910,Tristan Bousquet-Gros,259391,261915,2022-04-06
CASH_OUT,157639,Tristan Bousquet-Gros,261915,104276,Agence_moov_Ouidah,300000,142361,2022-04-08
CASH_IN,115113,Agence_moov_Cotonou,300000,184887,Tristan Bousquet-Gros,104276,219389,2022-04-10
TRANSFER,37370,Tristan Bousquet-Gros,219389,182019,Jules Fernandes,86189,48819,2022-04-10
CASH_IN,225705,Agence_moov_Cotonou,300000,74295,Tristan Bousquet-Gros,182019,407724,2022-04-11
CASH_OUT,222466,Tristan Bousquet-Gros,407724,185258,Agence_moov_Cotonou,300000,77534,2022-04-17
CASH_IN,234351,Agence_moov_Abomey,300000,65649,Tristan Bousquet-Gros,185258,419609,2022-04-18
CASH_OUT,337562,Tristan Bousquet-Gros,419609,82047,Agence_moov_Cotonou,300000,-37562,2022-04-19
TRANSFER,6936,Tristan Bousquet-Gros,82047,75111,André Renault,1146192,1139256,2022-04-19
TRANSFER,18025,Jules Fernandes,48819,30794,Tristan Bousquet-Gros,75111,93136,2022-04-20
TRANSFER,5566,Tristan Bousquet-Gros,93136,87570,Véronique Martins de Fleury,9519,3953,2022-04-20
CASH_IN,69645,Agence_moov_Abomey,300000,230355,Tristan Bousquet-Gros,87570,157215,2022-04-21
CASH_IN,78433,Agence_moov_Cotonou,300000,221567,Tristan Bousquet-Gros,157215,235648,2022-04-22
CASH_IN,73186,Agence_moov_Abomey,300000,226814,Tristan Bousquet-Gros,235648,308834,2022-04-24
CASH_IN,227080,Agence_moov_Abomey,300000,72920,Martine Aubert,-2724,224356,2022-04-01
TRANSFER,4130,Luc Lévêque-Carre,6910,2780,Martine Aubert,224356,228486,2022-04-06
CASH_IN,132621,Agence_moov_Abomey,300000,167379,Martine Aubert,228486,361107,2022-04-07
CASH_IN,10788,Agence_moov_Ouidah,300000,289212,Martine Aubert,361107,371895,2022-04-11
TRANSFER,67224,Martine Aubert,371895,304671,Noël Bourgeois,8660,-58564,2022-04-12
CASH_OUT,106514,Martine Aubert,304671,198157,Agence_moov_Abomey,300000,193486,2022-04-13
CASH_IN,253339,Agence_moov_Ouidah,300000,46661,Martine Aubert,198157,451496,2022-04-14
TRANSFER,354614,Michel Bouchet,978281,623667,Martine Aubert,451496,806110,2022-04-15
CASH_OUT,414463,Martine Aubert,806110,391647,Agence_moov_Ouidah,300000,-114463,2022-04-16
CASH_OUT,64852,Martine Aubert,391647,326795,Agence_moov_Abomey,300000,235148,2022-04-17
CASH_IN,247204,Agence_moov_Abomey,300000,52796,Martine Aubert,326795,573999,2022-04-19
CASH_IN,92257,Agence_moov_Abomey,300000,207743,Agnès Le Giraud,-1067255,-974998,2022-04-02
CASH_IN,178485,Agence_moov_Ouidah,300000,121515,Agnès Le Giraud,-974998,-796513,2022-04-05
CASH_IN,234751,Agence_moov_Abomey,300000,65249,Agnès Le Giraud,-796513,-561762,2022-04-06
CASH_IN,101078,Agence_moov_Cotonou,300000,198922,Agnès Le Giraud,-561762,-460684,2022-04-09
CASH_IN,62481,Agence_moov_Abomey,300000,237519,Agnès Le Giraud,-460684,-398203,2022-04-11
CASH_IN,238717,Agence_moov_Cotonou,300000,61283,Agnès Le Giraud,-398203,-159486,2022-04-13
CASH_IN,106400,Agence_moov_Cotonou,300000,193600,Agnès Le Giraud,-159486,-53086,2022-04-18
CASH_IN,46343,Agence_moov_Ouidah,300000,253657,Agnès Le Giraud,-53086,-6743,2022-04-18
CASH_IN,182171,Agence_moov_Ouidah,300000,117829,Agnès Le Giraud,-6743,175428,2022-04-19
CASH_OUT,92667,Agnès Le Giraud,175428,82761,Agence_moov_Ouidah,300000,207333,2022-04-22
TRANSFER,550057,Anastasie Cousin,741540,191483,Anastasie Cousin,741540,191483,2022-04-07
TRANSFER,42746,Anastasie Cousin,191483,148737,Alphonse Joly,96457,53711,2022-04-07
TRANSFER,1619,Sabine Pineau,8939,7320,Anastasie Cousin,148737,150356,2022-04-10
CASH_IN,10173,Agence_moov_Ouidah,300000,289827,Anastasie Cousin,150356,160529,2022-04-11
TRANSFER,26608,Adèle Da Silva-Klein,123405,96797,Anastasie Cousin,160529,187137,2022-04-12
CASH_OUT,78960,Anastasie Cousin,187137,108177,Agence_moov_Cotonou,300000,221040,2022-04-13
CASH_OUT,59371,Anastasie Cousin,108177,48806,Agence_moov_Cotonou,300000,240629,2022-04-13
CASH_IN,136573,Agence_moov_Cotonou,300000,163427,Anastasie Cousin,48806,185379,2022-04-14
CASH_OUT,54798,Anastasie Cousin,185379,130581,Agence_moov_Ouidah,300000,245202,2022-04-14
CASH_OUT,16582,Anastasie Cousin,130581,113999,Agence_moov_Cotonou,300000,283418,2022-04-15
CASH_IN,7482,Agence_moov_Ouidah,300000,292518,Anastasie Cousin,113999,121481,2022-04-18
CASH_OUT,37327,Anastasie Cousin,121481,84154,Agence_moov_Ouidah,300000,262673,2022-04-18
CASH_OUT,9322,Anastasie Cousin,84154,74832,Agence_moov_Abomey,300000,290678,2022-04-21
CASH_IN,24343,Agence_moov_Ouidah,300000,275657,Anastasie Cousin,74832,99175,2022-04-25
CASH_OUT,94073,Anastasie Cousin,99175,5102,Agence_moov_Abomey,300000,205927,2022-04-25
TRANSFER,3368,Anastasie Cousin,5102,1734,Céline Collin-Hervé,819953,816585,2022-04-26
CASH_IN,31410,Agence_moov_Abomey,300000,268590,Camille Prévost,-180639,-149229,2022-04-01
CASH_IN,81805,Agence_moov_Ouidah,300000,218195,Camille Prévost,-149229,-67424,2022-04-03
CASH_IN,92895,Agence_moov_Ouidah,300000,207105,Camille Prévost,-67424,25471,2022-04-04
CASH_IN,250663,Agence_moov_Cotonou,300000,49337,Camille Prévost,25471,276134,2022-04-05
CASH_OUT,16445,Camille Prévost,276134,259689,Agence_moov_Ouidah,300000,283555,2022-04-06
CASH_OUT,6716,Camille Prévost,259689,252973,Agence_moov_Ouidah,300000,293284,2022-04-07
CASH_IN,82700,Agence_moov_Cotonou,300000,217300,Camille Prévost,252973,335673,2022-04-09
TRANSFER,207208,Camille Prévost,335673,128465,Alphonse Joly,53711,-153497,2022-04-12
CASH_IN,221492,Agence_moov_Ouidah,300000,78508,Camille Prévost,128465,349957,2022-04-14
TRANSFER,100144,Camille Prévost,349957,249813,Thomas de Blin,227551,127407,2022-04-16
TRANSFER,31112,Camille Prévost,249813,218701,Sabine Pineau,7320,-23792,2022-04-17
CASH_OUT,69930,Camille Prévost,218701,148771,Agence_moov_Cotonou,300000,230070,2022-04-18
TRANSFER,45009,Camille Prévost,148771,103762,Suzanne Bodin,721632,676623,2022-04-21
CASH_IN,120845,Agence_moov_Abomey,300000,179155,Camille Prévost,103762,224607,2022-04-22
CASH_IN,13704,Agence_moov_Abomey,300000,286296,Camille Prévost,224607,238311,2022-04-22
CASH_IN,165285,Agence_moov_Cotonou,300000,134715,Camille Prévost,238311,403596,2022-04-23
CASH_OUT,206326,Camille Prévost,403596,197270,Agence_moov_Ouidah,300000,93674,2022-04-25
CASH_IN,82800,Agence_moov_Abomey,300000,217200,Camille Prévost,197270,280070,2022-04-27
TRANSFER,115859,Noémi Bouvier,496020,380161,Manon Lebon,167446,283305,2022-04-02
TRANSFER,50389,Manon Lebon,283305,232916,Emmanuel Grégoire,910424,860035,2022-04-04
CASH_OUT,171186,Manon Lebon,232916,61730,Agence_moov_Abomey,300000,128814,2022-04-05
TRANSFER,160684,Michelle-Dorothée Lévêque,231768,71084,Manon Lebon,61730,222414,2022-04-07
CASH_IN,235787,Agence_moov_Abomey,300000,64213,Manon Lebon,222414,458201,2022-04-07
TRANSFER,16952,Manon Lebon,458201,441249,Thomas Guichard du Renault,994057,977105,2022-04-09
TRANSFER,3816,Véronique Martins de Fleury,3953,137,Manon Lebon,441249,445065,2022-04-11
CASH_IN,265742,Agence_moov_Cotonou,300000,34258,Manon Lebon,445065,710807,2022-04-12
CASH_IN,276149,Agence_moov_Ouidah,300000,23851,Manon Lebon,710807,986956,2022-04-13
TRANSFER,223555,Thomas Dupont,228125,4570,Manon Lebon,986956,1210511,2022-04-18
CASH_IN,41460,Agence_moov_Abomey,300000,258540,Manon Lebon,1210511,1251971,2022-04-24
CASH_OUT,528926,Manon Lebon,1251971,723045,Agence_moov_Abomey,300000,-228926,2022-04-24
CASH_OUT,613231,Manon Lebon,723045,109814,Agence_moov_Abomey,300000,-313231,2022-04-26
CASH_OUT,108452,Manon Lebon,109814,1362,Agence_moov_Ouidah,300000,191548,2022-04-27
TRANSFER,10929,Colette-Sophie Prévost,32759,21830,Léon Da Costa,219571,208642,2022-04-02
TRANSFER,1066,Stéphane Munoz,1093,27,Colette-Sophie Prévost,21830,22896,2022-04-03
CASH_IN,181198,Agence_moov_Ouidah,300000,118802,Colette-Sophie Prévost,22896,204094,2022-04-04
CASH_OUT,33470,Colette-Sophie Prévost,204094,170624,Agence_moov_Cotonou,300000,266530,2022-04-05
CASH_IN,155952,Agence_moov_Cotonou,300000,144048,Colette-Sophie Prévost,170624,326576,2022-04-07
CASH_OUT,157434,Colette-Sophie Prévost,326576,169142,Agence_moov_Ouidah,300000,142566,2022-04-07
CASH_IN,121749,Agence_moov_Abomey,300000,178251,Colette-Sophie Prévost,169142,290891,2022-04-08
CASH_IN,294178,Agence_moov_Cotonou,300000,5822,Colette-Sophie Prévost,290891,585069,2022-04-17
TRANSFER,525417,Colette-Sophie Prévost,585069,59652,Emmanuel Grégoire,860035,334618,2022-04-20
TRANSFER,7552,Colette-Sophie Prévost,59652,52100,Thérèse Hubert,133259,125707,2022-04-24
TRANSFER,325,Colette-Sophie Prévost,52100,51775,Véronique Martins de Fleury,137,-188,2022-04-25
CASH_OUT,24723,Colette-Sophie Prévost,51775,27052,Agence_moov_Abomey,300000,275277,2022-04-25
CASH_IN,233578,Agence_moov_Cotonou,300000,66422,Michelle-Dorothée Lévêque,71084,304662,2022-04-02
TRANSFER,411203,Céline Collin-Hervé,816585,405382,Michelle-Dorothée Lévêque,304662,715865,2022-04-03
TRANSFER,243874,Céline Collin-Hervé,405382,161508,Michelle-Dorothée Lévêque,715865,959739,2022-04-06
CASH_IN,101893,Agence_moov_Ouidah,300000,198107,Michelle-Dorothée Lévêque,959739,1061632,2022-04-06
CASH_IN,267221,Agence_moov_Ouidah,300000,32779,Michelle-Dorothée Lévêque,1061632,1328853,2022-04-09
CASH_OUT,682369,Michelle-Dorothée Lévêque,1328853,646484,Agence_moov_Ouidah,300000,-382369,2022-04-09
CASH_IN,83823,Agence_moov_Abomey,300000,216177,Michelle-Dorothée Lévêque,646484,730307,2022-04-10
CASH_IN,89972,Agence_moov_Ouidah,300000,210028,Michelle-Dorothée Lévêque,730307,820279,2022-04-15
CASH_IN,171758,Agence_moov_Cotonou,300000,128242,Michelle-Dorothée Lévêque,820279,992037,2022-04-18
TRANSFER,287074,Émilie du Allain,406837,119763,Michelle-Dorothée Lévêque,992037,1279111,2022-04-18
CASH_IN,274713,Agence_moov_Ouidah,300000,25287,Michelle-Dorothée Lévêque,1279111,1553824,2022-04-20
CASH_OUT,890156,Michelle-Dorothée Lévêque,1553824,663668,Agence_moov_Ouidah,300000,-590156,2022-04-22
TRANSFER,62683,Adèle Da Silva-Klein,96797,34114,Michelle-Dorothée Lévêque,663668,726351,2022-04-27
CASH_IN,83739,Agence_moov_Cotonou,300000,216261,Maggie Martinez,-545742,-462003,2022-04-05
CASH_IN,187705,Agence_moov_Cotonou,300000,112295,Maggie Martinez,-462003,-274298,2022-04-06
CASH_IN,226467,Agence_moov_Cotonou,300000,73533,Maggie Martinez,-274298,-47831,2022-04-07
CASH_IN,290883,Agence_moov_Cotonou,300000,9117,Maggie Martinez,-47831,243052,2022-04-08
CASH_IN,253601,Agence_moov_Ouidah,300000,46399,Maggie Martinez,243052,496653,2022-04-10
TRANSFER,174745,Maggie Martinez,496653,321908,Suzanne Bodin,676623,501878,2022-04-10
CASH_OUT,66787,Maggie Martinez,321908,255121,Agence_moov_Cotonou,300000,233213,2022-04-11
TRANSFER,60530,Maggie Martinez,255121,194591,Camille Morvan,277025,216495,2022-04-13
CASH_IN,220217,Agence_moov_Ouidah,300000,79783,Maggie Martinez,194591,414808,2022-04-13
CASH_OUT,329240,Maggie Martinez,414808,85568,Agence_moov_Abomey,300000,-29240,2022-04-13
CASH_IN,245567,Agence_moov_Cotonou,300000,54433,Maggie Martinez,85568,331135,2022-04-16
CASH_OUT,196530,Maggie Martinez,331135,134605,Agence_moov_Cotonou,300000,103470,2022-04-18
CASH_OUT,12896,Maggie Martinez,134605,121709,Agence_moov_Abomey,300000,287104,2022-04-19
TRANSFER,377498,Thomas Guichard du Renault,977105,599607,Maggie Martinez,121709,499207,2022-04-19
TRANSFER,44783,Camille Morvan,216495,171712,Maggie Martinez,499207,543990,2022-04-19
TRANSFER,271747,Maggie Martinez,543990,272243,Adèle Da Silva-Klein,34114,-237633,2022-04-23
CASH_OUT,19864,Maggie Martinez,272243,252379,Agence_moov_Abomey,300000,280136,2022-04-26
CASH_IN,147891,Agence_moov_Cotonou,300000,152109,Maggie Martinez,252379,400270,2022-04-27
CASH_OUT,26184,Nath Loiseau,26907,723,Agence_moov_Cotonou,300000,273816,2022-04-01
CASH_IN,120446,Agence_moov_Cotonou,300000,179554,Nath Loiseau,723,121169,2022-04-04
CASH_OUT,84129,Nath Loiseau,121169,37040,Agence_moov_Ouidah,300000,215871,2022-04-07
CASH_OUT,19497,Nath Loiseau,37040,17543,Agence_moov_Abomey,300000,280503,2022-04-07
TRANSFER,75426,Emmanuel Grégoire,334618,259192,Nath Loiseau,17543,92969,2022-04-11
TRANSFER,160466,Céline Collin-Hervé,161508,1042,Nath Loiseau,92969,253435,2022-04-12
CASH_OUT,205876,Nath Loiseau,253435,47559,Agence_moov_Abomey,300000,94124,2022-04-14
TRANSFER,24706,Nath Loiseau,47559,22853,Suzanne Bodin,501878,477172,2022-04-16
TRANSFER,19439,Emmanuel Grégoire,259192,239753,Nath Loiseau,22853,42292,2022-04-21
TRANSFER,3562,Thomas Dupont,4570,1008,Nath Loiseau,42292,45854,2022-04-21
TRANSFER,5858,Nath Loiseau,45854,39996,Gérard de la Martinez,1412765,1406907,2022-04-24
CASH_IN,163199,Agence_moov_Ouidah,300000,136801,Nath Loiseau,39996,203195,2022-04-26
CASH_OUT,189020,Emmanuel Grégoire,239753,50733,Agence_moov_Ouidah,300000,110980,2022-04-02
TRANSFER,27072,Emmanuel Grégoire,50733,23661,Luc Lévêque-Carre,2780,-24292,2022-04-04
TRANSFER,11491,Emmanuel Grégoire,23661,12170,Jules Fernandes,30794,19303,2022-04-04
TRANSFER,103999,Léon Da Costa,208642,104643,Emmanuel Grégoire,12170,116169,2022-04-04
TRANSFER,68885,Simone Muller de la Brun,158426,89541,Emmanuel Grégoire,116169,185054,2022-04-05
CASH_IN,201728,Agence_moov_Ouidah,300000,98272,Emmanuel Grégoire,185054,386782,2022-04-06
CASH_OUT,81944,Emmanuel Grégoire,386782,304838,Agence_moov_Ouidah,300000,218056,2022-04-06
CASH_IN,160094,Agence_moov_Cotonou,300000,139906,Emmanuel Grégoire,304838,464932,2022-04-07
CASH_OUT,77279,Emmanuel Grégoire,464932,387653,Agence_moov_Abomey,300000,222721,2022-04-11
CASH_IN,182798,Agence_moov_Abomey,300000,117202,Emmanuel Grégoire,387653,570451,2022-04-11
TRANSFER,279688,Thomas Guichard du Renault,599607,319919,Emmanuel Grégoire,570451,850139,2022-04-16
CASH_OUT,583954,Emmanuel Grégoire,850139,266185,Agence_moov_Cotonou,300000,-283954,2022-04-17
CASH_IN,968,Agence_moov_Cotonou,300000,299032,Emmanuel Grégoire,266185,267153,2022-04-20
TRANSFER,1986,Thomas Guichard du Renault,319919,317933,Emmanuel Grégoire,267153,269139,2022-04-21
CASH_IN,193412,Agence_moov_Cotonou,300000,106588,Emmanuel Grégoire,269139,462551,2022-04-22
CASH_IN,115162,Agence_moov_Cotonou,300000,184838,Emmanuel Grégoire,462551,577713,2022-04-23
TRANSFER,499644,Emmanuel Grégoire,577713,78069,Thérèse Hubert,125707,-373937,2022-04-23
CASH_IN,159743,Agence_moov_Cotonou,300000,140257,Thomas de Blin,127407,287150,2022-04-04
CASH_IN,204399,Agence_moov_Abomey,300000,95601,Thomas de Blin,287150,491549,2022-04-10
CASH_IN,77609,Agence_moov_Ouidah,300000,222391,Thomas de Blin,491549,569158,2022-04-12
CASH_OUT,91080,Thomas de Blin,569158,478078,Agence_moov_Abomey,300000,208920,2022-04-13
TRANSFER,522269,André Renault,1139256,616987,Thomas de Blin,478078,1000347,2022-04-15
TRANSFER,137434,Camille Morvan,171712,34278,Thomas de Blin,1000347,1137781,2022-04-16
TRANSFER,358,Céline Collin-Hervé,1042,684,Thomas de Blin,1137781,1138139,2022-04-18
TRANSFER,66416,Thomas de Blin,1138139,1071723,Noémi Bouvier,380161,313745,2022-04-19
TRANSFER,16465,Camille Morvan,34278,17813,Thomas de Blin,1071723,1088188,2022-04-21
TRANSFER,389075,Robert-Louis Gosselin,514817,125742,Thomas de Blin,1088188,1477263,2022-04-22
CASH_OUT,70988,Thomas de Blin,1477263,1406275,Agence_moov_Ouidah,300000,229012,2022-04-25
CASH_OUT,1355858,Thomas de Blin,1406275,50417,Agence_moov_Cotonou,300000,-1055858,2022-04-26
CASH_IN,190047,Agence_moov_Ouidah,300000,109953,Aurore Charrier,-631310,-441263,2022-04-01
CASH_IN,74267,Agence_moov_Ouidah,300000,225733,Aurore Charrier,-441263,-366996,2022-04-02
CASH_IN,242945,Agence_moov_Abomey,300000,57055,Aurore Charrier,-366996,-124051,2022-04-02
CASH_IN,96679,Agence_moov_Abomey,300000,203321,Aurore Charrier,-124051,-27372,2022-04-05
CASH_IN,83733,Agence_moov_Ouidah,300000,216267,Aurore Charrier,-27372,56361,2022-04-07
CASH_IN,193524,Agence_moov_Abomey,300000,106476,Aurore Charrier,56361,249885,2022-04-12
CASH_IN,156916,Agence_moov_Abomey,300000,143084,Aurore Charrier,249885,406801,2022-04-13
TRANSFER,94751,Aurore Charrier,406801,312050,Suzanne Bodin,477172,382421,2022-04-15
CASH_IN,161407,Agence_moov_Cotonou,300000,138593,Aurore Charrier,312050,473457,2022-04-16
TRANSFER,79508,Robert-Louis Gosselin,125742,46234,Aurore Charrier,473457,552965,2022-04-16
CASH_IN,69313,Agence_moov_Abomey,300000,230687,Aurore Charrier,552965,622278,2022-04-19
CASH_OUT,269051,Aurore Charrier,622278,353227,Agence_moov_Ouidah,300000,30949,2022-04-20
CASH_OUT,155818,Aurore Charrier,353227,197409,Agence_moov_Ouidah,300000,144182,2022-04-22
TRANSFER,6636,Émilie du Allain,119763,113127,Aurore Charrier,197409,204045,2022-04-22
CASH_IN,19555,Agence_moov_Abomey,300000,280445,Aurore Charrier,204045,223600,2022-04-24
CASH_OUT,111803,Aurore Charrier,223600,111797,Agence_moov_Abomey,300000,188197,2022-04-27
TRANSFER,80028,Émilie du Allain,113127,33099,Thomas Guichard du Renault,317933,397961,2022-04-01
CASH_IN,1696,Agence_moov_Cotonou,300000,298304,Thomas Guichard du Renault,397961,399657,2022-04-01
CASH_OUT,1507,Thomas Guichard du Renault,399657,398150,Agence_moov_Abomey,300000,298493,2022-04-04
CASH_OUT,197515,Thomas Guichard du Renault,398150,200635,Agence_moov_Abomey,300000,102485,2022-04-11
CASH_OUT,130790,Thomas Guichard du Renault,200635,69845,Agence_moov_Ouidah,300000,169210,2022-04-11
CASH_IN,93984,Agence_moov_Cotonou,300000,206016,Thomas Guichard du Renault,69845,163829,2022-04-11
CASH_IN,6874,Agence_moov_Cotonou,300000,293126,Thomas Guichard du Renault,163829,170703,2022-04-12
CASH_OUT,66018,Thomas Guichard du Renault,170703,104685,Agence_moov_Cotonou,300000,233982,2022-04-13
CASH_OUT,34800,Thomas Guichard du Renault,104685,69885,Agence_moov_Cotonou,300000,265200,2022-04-14
CASH_OUT,2561,Thomas Guichard du Renault,69885,67324,Agence_moov_Abomey,300000,297439,2022-04-15
TRANSFER,962,Thomas Dupont,1008,46,Thomas Guichard du Renault,67324,68286,2022-04-16
TRANSFER,117033,Suzanne Bodin,382421,265388,Thomas Guichard du Renault,68286,185319,2022-04-17
CASH_IN,276933,Agence_moov_Abomey,300000,23067,Thomas Guichard du Renault,185319,462252,2022-04-18
TRANSFER,4519,Simone Muller de la Brun,89541,85022,Thomas Guichard du Renault,462252,466771,2022-04-18
CASH_OUT,115311,Thomas Guichard du Renault,466771,351460,Agence_moov_Abomey,300000,184689,2022-04-20
CASH_IN,243077,Agence_moov_Cotonou,300000,56923,Thomas Guichard du Renault,351460,594537,2022-04-22
CASH_OUT,445763,Thomas Guichard du Renault,594537,148774,Agence_moov_Cotonou,300000,-145763,2022-04-22
CASH_IN,248854,Agence_moov_Cotonou,300000,51146,Thomas Guichard du Renault,148774,397628,2022-04-23
CASH_OUT,307936,Thomas Guichard du Renault,397628,89692,Agence_moov_Abomey,300000,-7936,2022-04-24
CASH_IN,209404,Agence_moov_Ouidah,300000,90596,Thérèse Hubert,-373937,-164533,2022-04-07
CASH_IN,206608,Agence_moov_Cotonou,300000,93392,Thérèse Hubert,-164533,42075,2022-04-09
CASH_OUT,4418,Thérèse Hubert,42075,37657,Agence_moov_Ouidah,300000,295582,2022-04-10
TRANSFER,18798,Thérèse Hubert,37657,18859,Camille Morvan,17813,-985,2022-04-11
TRANSFER,15802,Thérèse Hubert,18859,3057,Jules Fernandes,19303,3501,2022-04-12
CASH_IN,240819,Agence_moov_Abomey,300000,59181,Thérèse Hubert,3057,243876,2022-04-13
CASH_OUT,204073,Thérèse Hubert,243876,39803,Agence_moov_Abomey,300000,95927,2022-04-16
CASH_OUT,33614,Thérèse Hubert,39803,6189,Agence_moov_Ouidah,300000,266386,2022-04-19
CASH_OUT,2433,Thérèse Hubert,6189,3756,Agence_moov_Abomey,300000,297567,2022-04-20
CASH_IN,63077,Agence_moov_Abomey,300000,236923,Thérèse Hubert,3756,66833,2022-04-22
CASH_OUT,28720,Thérèse Hubert,66833,38113,Agence_moov_Ouidah,300000,271280,2022-04-24
CASH_IN,160383,Agence_moov_Cotonou,300000,139617,Thérèse Hubert,38113,198496,2022-04-25
TRANSFER,191124,Thérèse Hubert,198496,7372,Robert-Louis Gosselin,46234,-144890,2022-04-26
CASH_OUT,1064,Thérèse Hubert,7372,6308,Agence_moov_Ouidah,300000,298936,2022-04-27
CASH_IN,75085,Agence_moov_Cotonou,300000,224915,Luc Lévêque-Carre,-24292,50793,2022-04-01
TRANSFER,35542,Luc Lévêque-Carre,50793,15251,Luc Lévêque-Carre,50793,15251,2022-04-08
CASH_OUT,500,Luc Lévêque-Carre,15251,14751,Agence_moov_Abomey,300000,299500,2022-04-08
TRANSFER,3647,Luc Lévêque-Carre,14751,11104,Luc Lévêque-Carre,14751,11104,2022-04-17
CASH_OUT,4505,Luc Lévêque-Carre,11104,6599,Agence_moov_Ouidah,300000,295495,2022-04-19
CASH_OUT,4931,Luc Lévêque-Carre,6599,1668,Agence_moov_Abomey,300000,295069,2022-04-21
TRANSFER,100,Luc Lévêque-Carre,1668,1568,Léon Da Costa,104643,104543,2022-04-22
CASH_OUT,313,Luc Lévêque-Carre,1568,1255,Agence_moov_Ouidah,300000,299687,2022-04-22
CASH_IN,175222,Agence_moov_Abomey,300000,124778,Luc Lévêque-Carre,1255,176477,2022-04-24
CASH_IN,18423,Agence_moov_Ouidah,300000,281577,Luc Lévêque-Carre,176477,194900,2022-04-25
CASH_IN,85992,Agence_moov_Ouidah,300000,214008,Luc Lévêque-Carre,194900,280892,2022-04-25
CASH_OUT,231970,Luc Lévêque-Carre,280892,48922,Agence_moov_Ouidah,300000,68030,2022-04-25
CASH_OUT,19390,Luc Lévêque-Carre,48922,29532,Agence_moov_Cotonou,300000,280610,2022-04-27
TRANSFER,182,Céline Collin-Hervé,684,502,Luc Lévêque-Carre,29532,29714,2022-04-27
CASH_IN,65733,Agence_moov_Ouidah,300000,234267,Véronique Martins de Fleury,-188,65545,2022-04-05
CASH_OUT,56368,Véronique Martins de Fleury,65545,9177,Agence_moov_Ouidah,300000,243632,2022-04-07
CASH_OUT,4210,Véronique Martins de Fleury,9177,4967,Agence_moov_Cotonou,300000,295790,2022-04-08
TRANSFER,282953,André Renault,616987,334034,Véronique Martins de Fleury,4967,287920,2022-04-13
CASH_OUT,24539,Véronique Martins de Fleury,287920,263381,Agence_moov_Abomey,300000,275461,2022-04-14
CASH_OUT,19647,Véronique Martins de Fleury,263381,243734,Agence_moov_Cotonou,300000,280353,2022-04-16
CASH_IN,235309,Agence_moov_Cotonou,300000,64691,Véronique Martins de Fleury,243734,479043,2022-04-17
TRANSFER,81757,Suzanne Bodin,265388,183631,Véronique Martins de Fleury,479043,560800,2022-04-17
CASH_IN,126282,Agence_moov_Abomey,300000,173718,Véronique Martins de Fleury,560800,687082,2022-04-23
CASH_IN,207484,Agence_moov_Cotonou,300000,92516,Vincent de la Dumont,-993362,-785878,2022-04-06
CASH_IN,162407,Agence_moov_Ouidah,300000,137593,Vincent de la Dumont,-785878,-623471,2022-04-06
CASH_IN,276949,Agence_moov_Abomey,300000,23051,Vincent de la Dumont,-623471,-346522,2022-04-07
CASH_IN,209837,Agence_moov_Abomey,300000,90163,Vincent de la Dumont,-346522,-136685,2022-04-07
CASH_IN,176035,Agence_moov_Cotonou,300000,123965,Vincent de la Dumont,-136685,39350,2022-04-08
TRANSFER,30855,Vincent de la Dumont,39350,8495,Robert Clerc,940668,909813,2022-04-14
TRANSFER,14400,Émilie du Allain,33099,18699,Vincent de la Dumont,8495,22895,2022-04-14
CASH_OUT,3816,Vincent de la Dumont,22895,19079,Agence_moov_Ouidah,300000,296184,2022-04-22
CASH_OUT,17801,Vincent de la Dumont,19079,1278,Agence_moov_Cotonou,300000,282199,2022-04-26
CASH_IN,84853,Agence_moov_Abomey,300000,215147,Audrey Julien de Leleu,-116289,-31436,2022-04-01
CASH_IN,229444,Agence_moov_Abomey,300000,70556,Audrey Julien de Leleu,-31436,198008,2022-04-03
CASH_IN,73312,Agence_moov_Cotonou,300000,226688,Audrey Julien de Leleu,198008,271320,2022-04-04
TRANSFER,269055,Audrey Julien de Leleu,271320,2265,Suzanne Bodin,183631,-85424,2022-04-06
TRANSFER,312300,Noémi Bouvier,313745,1445,Audrey Julien de Leleu,2265,314565,2022-04-09
CASH_OUT,190987,Audrey Julien de Leleu,314565,123578,Agence_moov_Abomey,300000,109013,2022-04-10
TRANSFER,2137,Jules Fernandes,3501,1364,Audrey Julien de Leleu,123578,125715,2022-04-11
CASH_OUT,86379,Audrey Julien de Leleu,125715,39336,Agence_moov_Abomey,300000,213621,2022-04-14
CASH_IN,114611,Agence_moov_Ouidah,300000,185389,Audrey Julien de Leleu,39336,153947,2022-04-16
CASH_OUT,86602,Audrey Julien de Leleu,153947,67345,Agence_moov_Abomey,300000,213398,2022-04-16
CASH_IN,161037,Agence_moov_Ouidah,300000,138963,Audrey Julien de Leleu,67345,228382,2022-04-19
CASH_OUT,21294,Audrey Julien de Leleu,228382,207088,Agence_moov_Abomey,300000,278706,2022-04-19
TRANSFER,296704,André Renault,334034,37330,Audrey Julien de Leleu,207088,503792,2022-04-21
CASH_OUT,426752,Audrey Julien de Leleu,503792,77040,Agence_moov_Cotonou,300000,-126752,2022-04-23
TRANSFER,61286,Audrey Julien de Leleu,77040,15754,Céline Collin-Hervé,502,-60784,2022-04-24
TRANSFER,679252,Robert Clerc,909813,230561,Audrey Julien de Leleu,15754,695006,2022-04-25
CASH_OUT,475,Noémi Bouvier,1445,970,Agence_moov_Ouidah,300000,299525,2022-04-04
CASH_IN,48745,Agence_moov_Ouidah,300000,251255,Noémi Bouvier,970,49715,2022-04-04
CASH_IN,147422,Agence_moov_Cotonou,300000,152578,Noémi Bouvier,49715,197137,2022-04-05
TRANSFER,207463,Robert Clerc,230561,23098,Noémi Bouvier,197137,404600,2022-04-06
CASH_OUT,311977,Noémi Bouvier,404600,92623,Agence_moov_Abomey,300000,-11977,2022-04-08
CASH_OUT,82930,Noémi Bouvier,92623,9693,Agence_moov_Ouidah,300000,217070,2022-04-12
CASH_IN,261272,Agence_moov_Cotonou,300000,38728,Noémi Bouvier,9693,270965,2022-04-13
TRANSFER,211891,Noémi Bouvier,270965,59074,Robert Clerc,23098,-188793,2022-04-14
CASH_IN,71076,Agence_moov_Ouidah,300000,228924,Noémi Bouvier,59074,130150,2022-04-14
CASH_IN,247674,Agence_moov_Abomey,300000,52326,Noémi Bouvier,130150,377824,2022-04-15
TRANSFER,57100,Noémi Bouvier,377824,320724,André Renault,37330,-19770,2022-04-16
TRANSFER,185765,Noémi Bouvier,320724,134959,Simone Muller de la Brun,85022,-100743,2022-04-16
TRANSFER,3727,Émilie du Allain,18699,14972,Noémi Bouvier,134959,138686,2022-04-20
CASH_OUT,5842,Noémi Bouvier,138686,132844,Agence_moov_Ouidah,300000,294158,2022-04-20
CASH_IN,15536,Agence_moov_Ouidah,300000,284464,Noémi Bouvier,132844,148380,2022-04-22
CASH_OUT,90871,Noémi Bouvier,148380,57509,Agence_moov_Abomey,300000,209129,2022-04-22
TRANSFER,24239,Noémi Bouvier,57509,33270,Léon Da Costa,104543,80304,2022-04-23
TRANSFER,25692,Noémi Bouvier,33270,7578,Michel Bouchet,623667,597975,2022-04-23
CASH_OUT,7344,Noémi Bouvier,7578,234,Agence_moov_Ouidah,300000,292656,2022-04-25
TRANSFER,193,Noémi Bouvier,234,41,Léon Da Costa,80304,80111,2022-04-25
CASH_IN,170056,Agence_moov_Ouidah,300000,129944,André Renault,-19770,150286,2022-04-01
TRANSFER,43108,André Renault,150286,107178,Jules Fernandes,1364,-41744,2022-04-01
CASH_IN,90551,Agence_moov_Ouidah,300000,209449,André Renault,107178,197729,2022-04-03
CASH_OUT,53879,André Renault,197729,143850,Agence_moov_Abomey,300000,246121,2022-04-04
CASH_OUT,65886,André Renault,143850,77964,Agence_moov_Cotonou,300000,234114,2022-04-05
TRANSFER,51891,André Renault,77964,26073,Émilie du Allain,14972,-36919,2022-04-07
CASH_IN,248057,Agence_moov_Cotonou,300000,51943,André Renault,26073,274130,2022-04-08
TRANSFER,63069,André Renault,274130,211061,Léon Da Costa,80111,17042,2022-04-08
TRANSFER,105473,André Renault,211061,105588,André Renault,211061,105588,2022-04-09
CASH_OUT,79155,André Renault,105588,26433,Agence_moov_Ouidah,300000,220845,2022-04-09
CASH_IN,241902,Agence_moov_Cotonou,300000,58098,André Renault,26433,268335,2022-04-10
CASH_IN,163642,Agence_moov_Abomey,300000,136358,André Renault,268335,431977,2022-04-11
CASH_OUT,113288,André Renault,431977,318689,Agence_moov_Abomey,300000,186712,2022-04-12
TRANSFER,172104,André Renault,318689,146585,Gérard de la Martinez,1406907,1234803,2022-04-15
CASH_IN,80245,Agence_moov_Cotonou,300000,219755,André Renault,146585,226830,2022-04-19
TRANSFER,45998,André Renault,226830,180832,Gérard de la Martinez,1234803,1188805,2022-04-20
TRANSFER,136323,André Renault,180832,44509,Gérard de la Martinez,1188805,1052482,2022-04-25
CASH_IN,268591,Agence_moov_Cotonou,300000,31409,André Renault,44509,313100,2022-04-26
CASH_OUT,43318,André Renault,313100,269782,Agence_moov_Ouidah,300000,256682,2022-04-27
CASH_IN,184724,Agence_moov_Abomey,300000,115276,Émilie du Allain,-36919,147805,2022-04-01
TRANSFER,123034,Émilie du Allain,147805,24771,Michel Bouchet,597975,474941,2022-04-01
CASH_IN,193971,Agence_moov_Cotonou,300000,106029,Émilie du Allain,24771,218742,2022-04-01
CASH_IN,82487,Agence_moov_Ouidah,300000,217513,Émilie du Allain,218742,301229,2022-04-03
CASH_OUT,214988,Émilie du Allain,301229,86241,Agence_moov_Cotonou,300000,85012,2022-04-03
CASH_OUT,28213,Émilie du Allain,86241,58028,Agence_moov_Ouidah,300000,271787,2022-04-04
CASH_OUT,40259,Émilie du Allain,58028,17769,Agence_moov_Cotonou,300000,259741,2022-04-06
TRANSFER,8284,Émilie du Allain,17769,9485,Émilie du Allain,17769,9485,2022-04-08
TRANSFER,8993,Émilie du Allain,9485,492,Michel Bouchet,474941,465948,2022-04-09
CASH_IN,145548,Agence_moov_Ouidah,300000,154452,Émilie du Allain,492,146040,2022-04-10
CASH_OUT,108986,Émilie du Allain,146040,37054,Agence_moov_Cotonou,300000,191014,2022-04-19
CASH_OUT,28244,Émilie du Allain,37054,8810,Agence_moov_Cotonou,300000,271756,2022-04-19
CASH_OUT,6918,Émilie du Allain,8810,1892,Agence_moov_Cotonou,300000,293082,2022-04-20
TRANSFER,636,Émilie du Allain,1892,1256,Léon Da Costa,17042,16406,2022-04-24
TRANSFER,1150,Léon Da Costa,16406,15256,Émilie du Allain,1256,2406,2022-04-25
CASH_OUT,1085,Émilie du Allain,2406,1321,Agence_moov_Abomey,300000,298915,2022-04-25
CASH_IN,105291,Agence_moov_Ouidah,300000,194709,Suzanne Bodin,-85424,19867,2022-04-02
TRANSFER,11619,Suzanne Bodin,19867,8248,Suzanne Bodin,19867,8248,2022-04-02
TRANSFER,395,Suzanne Bodin,8248,7853,Suzanne Bodin,8248,8643,2022-04-03
TRANSFER,14463,Léon Da Costa,15256,793,Suzanne Bodin,7853,22316,2022-04-03
TRANSFER,15117,Suzanne Bodin,22316,7199,Suzanne Bodin,22316,37433,2022-04-04
TRANSFER,3892,Suzanne Bodin,7199,3307,Léon Da Costa,793,-3099,2022-04-06
CASH_OUT,1885,Suzanne Bodin,3307,1422,Agence_moov_Ouidah,300000,298115,2022-04-09
CASH_IN,198378,Agence_moov_Cotonou,300000,101622,Suzanne Bodin,1422,199800,2022-04-11
CASH_OUT,45190,Suzanne Bodin,199800,154610,Agence_moov_Abomey,300000,254810,2022-04-15
CASH_IN,111302,Agence_moov_Abomey,300000,188698,Suzanne Bodin,154610,265912,2022-04-16
CASH_IN,186556,Agence_moov_Abomey,300000,113444,Suzanne Bodin,265912,452468,2022-04-21
CASH_IN,39262,Agence_moov_Ouidah,300000,260738,Suzanne Bodin,452468,491730,2022-04-24
CASH_IN,7194,Agence_moov_Ouidah,300000,292806,Céline Collin-Hervé,-60784,-53590,2022-04-03
CASH_IN,87229,Agence_moov_Cotonou,300000,212771,Céline Collin-Hervé,-53590,33639,2022-04-05
TRANSFER,16353,Céline Collin-Hervé,33639,17286,Céline Collin-Hervé,33639,49992,2022-04-07
CASH_IN,299274,Agence_moov_Ouidah,300000,726,Céline Collin-Hervé,17286,316560,2022-04-09
CASH_IN,226132,Agence_moov_Abomey,300000,73868,Céline Collin-Hervé,316560,542692,2022-04-12
CASH_OUT,284186,Céline Collin-Hervé,542692,258506,Agence_moov_Cotonou,300000,15814,2022-04-12
CASH_OUT,38590,Céline Collin-Hervé,258506,219916,Agence_moov_Cotonou,300000,261410,2022-04-13
CASH_OUT,195821,Céline Collin-Hervé,219916,24095,Agence_moov_Abomey,300000,104179,2022-04-17
CASH_OUT,14123,Céline Collin-Hervé,24095,9972,Agence_moov_Ouidah,300000,285877,2022-04-22
CASH_OUT,4156,Céline Collin-Hervé,9972,5816,Agence_moov_Ouidah,300000,295844,2022-04-23
CASH_OUT,1806,Céline Collin-Hervé,5816,4010,Agence_moov_Abomey,300000,298194,2022-04-27
CASH_IN,228821,Agence_moov_Abomey,300000,71179,Céline Collin-Hervé,4010,232831,2022-04-27
CASH_IN,280120,Agence_moov_Cotonou,300000,19880,Noël Bourgeois,-58564,221556,2022-04-03
CASH_IN,227914,Agence_moov_Ouidah,300000,72086,Noël Bourgeois,221556,449470,2022-04-04
TRANSFER,1639,Noël Bourgeois,449470,447831,Noël Bourgeois,449470,451109,2022-04-07
CASH_IN,80465,Agence_moov_Abomey,300000,219535,Noël Bourgeois,447831,528296,2022-04-07
CASH_OUT,456562,Noël Bourgeois,528296,71734,Agence_moov_Cotonou,300000,-156562,2022-04-09
CASH_IN,235208,Agence_moov_Cotonou,300000,64792,Noël Bourgeois,71734,306942,2022-04-09
CASH_IN,201496,Agence_moov_Ouidah,300000,98504,Noël Bourgeois,306942,508438,2022-04-11
CASH_IN,52751,Agence_moov_Abomey,300000,247249,Noël Bourgeois,508438,561189,2022-04-12
CASH_OUT,456375,Noël Bourgeois,561189,104814,Agence_moov_Cotonou,300000,-156375,2022-04-13
CASH_IN,290874,Agence_moov_Abomey,300000,9126,Noël Bourgeois,104814,395688,2022-04-14
CASH_OUT,388303,Noël Bourgeois,395688,7385,Agence_moov_Ouidah,300000,-88303,2022-04-14
CASH_OUT,504,Noël Bourgeois,7385,6881,Agence_moov_Ouidah,300000,299496,2022-04-19
CASH_IN,132593,Agence_moov_Ouidah,300000,167407,Noël Bourgeois,6881,139474,2022-04-20
CASH_OUT,80939,Noël Bourgeois,139474,58535,Agence_moov_Ouidah,300000,219061,2022-04-25
CASH_IN,225339,Agence_moov_Ouidah,300000,74661,Anastasie Richard-Neveu,-60239,165100,2022-04-10
TRANSFER,130884,Anastasie Richard-Neveu,165100,34216,Anastasie Richard-Neveu,165100,295984,2022-04-11
CASH_OUT,21436,Anastasie Richard-Neveu,34216,12780,Agence_moov_Abomey,300000,278564,2022-04-15
CASH_IN,274318,Agence_moov_Abomey,300000,25682,Anastasie Richard-Neveu,12780,287098,2022-04-22
CASH_OUT,126248,Anastasie Richard-Neveu,287098,160850,Agence_moov_Cotonou,300000,173752,2022-04-23
CASH_IN,31666,Agence_moov_Ouidah,300000,268334,Anastasie Richard-Neveu,160850,192516,2022-04-24
CASH_IN,286363,Agence_moov_Abomey,300000,13637,Vincent Joubert,-136340,150023,2022-04-01
TRANSFER,2636,Vincent Joubert,150023,147387,Vincent Joubert,150023,147387,2022-04-01
TRANSFER,8979,Vincent Joubert,147387,138408,Vincent Joubert,147387,156366,2022-04-02
CASH_OUT,136710,Vincent Joubert,138408,1698,Agence_moov_Ouidah,300000,163290,2022-04-06
CASH_OUT,1420,Vincent Joubert,1698,278,Agence_moov_Ouidah,300000,298580,2022-04-09
CASH_OUT,213,Vincent Joubert,278,65,Agence_moov_Abomey,300000,299787,2022-04-16
CASH_IN,165717,Agence_moov_Cotonou,300000,134283,Vincent Joubert,65,165782,2022-04-20
CASH_OUT,151344,Vincent Joubert,165782,14438,Agence_moov_Ouidah,300000,148656,2022-04-20
CASH_IN,49457,Agence_moov_Cotonou,300000,250543,Alphonse Joly,-153497,-104040,2022-04-03
CASH_IN,42376,Agence_moov_Cotonou,300000,257624,Alphonse Joly,-104040,-61664,2022-04-04
CASH_IN,120182,Agence_moov_Ouidah,300000,179818,Alphonse Joly,-61664,58518,2022-04-05
CASH_OUT,54081,Alphonse Joly,58518,4437,Agence_moov_Cotonou,300000,245919,2022-04-06
CASH_IN,21663,Agence_moov_Cotonou,300000,278337,Alphonse Joly,4437,26100,2022-04-07
TRANSFER,7374,Alphonse Joly,26100,18726,Alphonse Joly,26100,18726,2022-04-09
CASH_OUT,2683,Alphonse Joly,18726,16043,Agence_moov_Abomey,300000,297317,2022-04-12
TRANSFER,7409,Alphonse Joly,16043,8634,Alphonse Joly,16043,8634,2022-04-15
CASH_IN,66368,Agence_moov_Cotonou,300000,233632,Alphonse Joly,8634,75002,2022-04-16
CASH_IN,275403,Agence_moov_Cotonou,300000,24597,Alphonse Joly,75002,350405,2022-04-16
TRANSFER,26862,Alphonse Joly,350405,323543,Alphonse Joly,350405,323543,2022-04-16
CASH_IN,52068,Agence_moov_Cotonou,300000,247932,Alphonse Joly,323543,375611,2022-04-19
CASH_IN,168807,Agence_moov_Cotonou,300000,131193,Alphonse Joly,375611,544418,2022-04-21
CASH_OUT,170787,Alphonse Joly,544418,373631,Agence_moov_Cotonou,300000,129213,2022-04-23
CASH_OUT,279604,Alphonse Joly,373631,94027,Agence_moov_Abomey,300000,20396,2022-04-26
CASH_IN,299987,Agence_moov_Ouidah,300000,13,Sabine Pineau,-23792,276195,2022-04-02
CASH_IN,66996,Agence_moov_Cotonou,300000,233004,Sabine Pineau,276195,343191,2022-04-02
TRANSFER,2535,Sabine Pineau,343191,340656,Sabine Pineau,343191,345726,2022-04-02
CASH_OUT,202860,Sabine Pineau,340656,137796,Agence_moov_Cotonou,300000,97140,2022-04-03
CASH_OUT,81449,Sabine Pineau,137796,56347,Agence_moov_Ouidah,300000,218551,2022-04-03
CASH_IN,25585,Agence_moov_Abomey,300000,274415,Sabine Pineau,56347,81932,2022-04-03
CASH_IN,214631,Agence_moov_Cotonou,300000,85369,Sabine Pineau,81932,296563,2022-04-09
CASH_OUT,205698,Sabine Pineau,296563,90865,Agence_moov_Cotonou,300000,94302,2022-04-10
CASH_IN,189806,Agence_moov_Cotonou,300000,110194,Sabine Pineau,90865,280671,2022-04-13
CASH_OUT,5173,Sabine Pineau,280671,275498,Agence_moov_Ouidah,300000,294827,2022-04-14
TRANSFER,196651,Sabine Pineau,275498,78847,Sabine Pineau,275498,472149,2022-04-15
CASH_IN,217907,Agence_moov_Cotonou,300000,82093,Sabine Pineau,78847,296754,2022-04-15
CASH_IN,96637,Agence_moov_Abomey,300000,203363,Sabine Pineau,296754,393391,2022-04-16
CASH_OUT,263664,Sabine Pineau,393391,129727,Agence_moov_Ouidah,300000,36336,2022-04-17
CASH_OUT,54855,Sabine Pineau,129727,74872,Agence_moov_Abomey,300000,245145,2022-04-18
CASH_IN,83710,Agence_moov_Ouidah,300000,216290,Sabine Pineau,74872,158582,2022-04-19
CASH_OUT,59072,Sabine Pineau,158582,99510,Agence_moov_Cotonou,300000,240928,2022-04-24
CASH_IN,177904,Agence_moov_Abomey,300000,122096,Matthieu-Matthieu Bigot,-906597,-728693,2022-04-02
CASH_IN,264388,Agence_moov_Cotonou,300000,35612,Matthieu-Matthieu Bigot,-728693,-464305,2022-04-06
CASH_IN,286876,Agence_moov_Cotonou,300000,13124,Matthieu-Matthieu Bigot,-464305,-177429,2022-04-10
CASH_IN,154516,Agence_moov_Cotonou,300000,145484,Matthieu-Matthieu Bigot,-177429,-22913,2022-04-13
CASH_IN,267324,Agence_moov_Abomey,300000,32676,Matthieu-Matthieu Bigot,-22913,244411,2022-04-13
CASH_IN,57930,Agence_moov_Cotonou,300000,242070,Camille Morvan,-985,56945,2022-04-05
CASH_IN,167617,Agence_moov_Cotonou,300000,132383,Camille Morvan,56945,224562,2022-04-05
TRANSFER,60527,Camille Morvan,224562,164035,Camille Morvan,224562,164035,2022-04-05
CASH_OUT,67198,Camille Morvan,164035,96837,Agence_moov_Ouidah,300000,232802,2022-04-05
TRANSFER,4607,Camille Morvan,96837,92230,Camille Morvan,96837,101444,2022-04-07
CASH_OUT,46642,Camille Morvan,92230,45588,Agence_moov_Cotonou,300000,253358,2022-04-08
TRANSFER,20112,Camille Morvan,45588,25476,Camille Morvan,45588,25476,2022-04-08
CASH_OUT,19207,Camille Morvan,25476,6269,Agence_moov_Ouidah,300000,280793,2022-04-10
CASH_IN,272914,Agence_moov_Cotonou,300000,27086,Camille Morvan,6269,279183,2022-04-11
CASH_IN,208130,Agence_moov_Ouidah,300000,91870,Camille Morvan,279183,487313,2022-04-14
CASH_IN,87547,Agence_moov_Ouidah,300000,212453,Camille Morvan,487313,574860,2022-04-14
CASH_IN,262864,Agence_moov_Abomey,300000,37136,Camille Morvan,574860,837724,2022-04-16
CASH_IN,268162,Agence_moov_Abomey,300000,31838,Camille Morvan,837724,1105886,2022-04-17
CASH_OUT,44732,Camille Morvan,1105886,1061154,Agence_moov_Ouidah,300000,255268,2022-04-25
CASH_IN,61177,Agence_moov_Abomey,300000,238823,Colette Merle Le Robert,-139976,-78799,2022-04-01
CASH_IN,132669,Agence_moov_Abomey,300000,167331,Colette Merle Le Robert,-78799,53870,2022-04-02
CASH_OUT,4814,Colette Merle Le Robert,53870,49056,Agence_moov_Cotonou,300000,295186,2022-04-03
CASH_IN,95763,Agence_moov_Ouidah,300000,204237,Colette Merle Le Robert,49056,144819,2022-04-08
CASH_IN,11156,Agence_moov_Ouidah,300000,288844,Colette Merle Le Robert,144819,155975,2022-04-09
CASH_OUT,153392,Colette Merle Le Robert,155975,2583,Agence_moov_Ouidah,300000,146608,2022-04-15
CASH_OUT,2359,Colette Merle Le Robert,2583,224,Agence_moov_Ouidah,300000,297641,2022-04-21
CASH_IN,66250,Agence_moov_Abomey,300000,233750,Colette Merle Le Robert,224,66474,2022-04-23
CASH_OUT,3370,Colette Merle Le Robert,66474,63104,Agence_moov_Abomey,300000,296630,2022-04-24
CASH_OUT,40183,Colette Merle Le Robert,63104,22921,Agence_moov_Ouidah,300000,259817,2022-04-25
CASH_IN,71976,Agence_moov_Ouidah,300000,228024,Simone Muller de la Brun,-100743,-28767,2022-04-01
CASH_IN,215934,Agence_moov_Ouidah,300000,84066,Simone Muller de la Brun,-28767,187167,2022-04-05
CASH_IN,226609,Agence_moov_Abomey,300000,73391,Simone Muller de la Brun,187167,413776,2022-04-09
CASH_IN,183154,Agence_moov_Ouidah,300000,116846,Simone Muller de la Brun,413776,596930,2022-04-11
CASH_IN,93934,Agence_moov_Cotonou,300000,206066,Simone Muller de la Brun,596930,690864,2022-04-18
CASH_IN,172601,Agence_moov_Cotonou,300000,127399,Simone Muller de la Brun,690864,863465,2022-04-23
CASH_IN,234927,Agence_moov_Ouidah,300000,65073,Émile-René Baudry,-282755,-47828,2022-04-01
CASH_IN,95122,Agence_moov_Ouidah,300000,204878,Émile-René Baudry,-47828,47294,2022-04-05
CASH_IN,167345,Agence_moov_Abomey,300000,132655,Émile-René Baudry,47294,214639,2022-04-07
CASH_OUT,56226,Émile-René Baudry,214639,158413,Agence_moov_Cotonou,300000,243774,2022-04-07
TRANSFER,59356,Émile-René Baudry,158413,99057,Émile-René Baudry,158413,99057,2022-04-19
CASH_IN,261491,Agence_moov_Ouidah,300000,38509,Émile-René Baudry,99057,360548,2022-04-20
CASH_OUT,255712,Émile-René Baudry,360548,104836,Agence_moov_Ouidah,300000,44288,2022-04-22
TRANSFER,30507,Émile-René Baudry,104836,74329,Émile-René Baudry,104836,74329,2022-04-25
CASH_OUT,70737,Émile-René Baudry,74329,3592,Agence_moov_Cotonou,300000,229263,2022-04-25
CASH_IN,277509,Agence_moov_Cotonou,300000,22491,Émile-René Baudry,3592,281101,2022-04-26
CASH_OUT,62104,Émile-René Baudry,281101,218997,Agence_moov_Cotonou,300000,237896,2022-04-26
CASH_IN,204199,Agence_moov_Ouidah,300000,95801,Robert Clerc,-188793,15406,2022-04-01
CASH_IN,148880,Agence_moov_Abomey,300000,151120,Robert Clerc,15406,164286,2022-04-01
CASH_OUT,90836,Robert Clerc,164286,73450,Agence_moov_Abomey,300000,209164,2022-04-02
CASH_OUT,40249,Robert Clerc,73450,33201,Agence_moov_Abomey,300000,259751,2022-04-03
CASH_IN,236507,Agence_moov_Cotonou,300000,63493,Robert Clerc,33201,269708,2022-04-04
CASH_IN,37517,Agence_moov_Ouidah,300000,262483,Robert Clerc,269708,307225,2022-04-05
CASH_OUT,283659,Robert Clerc,307225,23566,Agence_moov_Abomey,300000,16341,2022-04-07
CASH_OUT,2808,Robert Clerc,23566,20758,Agence_moov_Ouidah,300000,297192,2022-04-07
TRANSFER,14386,Robert Clerc,20758,6372,Robert Clerc,20758,6372,2022-04-10
CASH_OUT,2234,Robert Clerc,6372,4138,Agence_moov_Abomey,300000,297766,2022-04-11
CASH_OUT,3372,Robert Clerc,4138,766,Agence_moov_Ouidah,300000,296628,2022-04-17
CASH_IN,127484,Agence_moov_Abomey,300000,172516,Robert Clerc,766,128250,2022-04-18
TRANSFER,71097,Robert Clerc,128250,57153,Robert Clerc,128250,57153,2022-04-18
CASH_OUT,4423,Robert Clerc,57153,52730,Agence_moov_Ouidah,300000,295577,2022-04-21
CASH_OUT,796,Robert Clerc,52730,51934,Agence_moov_Cotonou,300000,299204,2022-04-23
CASH_IN,81950,Agence_moov_Ouidah,300000,218050,Robert Clerc,51934,133884,2022-04-23
CASH_OUT,140,Robert Clerc,133884,133744,Agence_moov_Cotonou,300000,299860,2022-04-24
CASH_OUT,45115,Robert Clerc,133744,88629,Agence_moov_Cotonou,300000,254885,2022-04-25
CASH_OUT,838,Robert Clerc,88629,87791,Agence_moov_Cotonou,300000,299162,2022-04-27
CASH_IN,92185,Agence_moov_Ouidah,300000,207815,Adèle Da Silva-Klein,-237633,-145448,2022-04-04
CASH_IN,33851,Agence_moov_Ouidah,300000,266149,Adèle Da Silva-Klein,-145448,-111597,2022-04-08
CASH_IN,357,Agence_moov_Ouidah,300000,299643,Adèle Da Silva-Klein,-111597,-111240,2022-04-10
CASH_IN,288452,Agence_moov_Cotonou,300000,11548,Adèle Da Silva-Klein,-111240,177212,2022-04-10
CASH_IN,292094,Agence_moov_Ouidah,300000,7906,Adèle Da Silva-Klein,177212,469306,2022-04-12
CASH_OUT,334998,Adèle Da Silva-Klein,469306,134308,Agence_moov_Ouidah,300000,-34998,2022-04-14
CASH_IN,257230,Agence_moov_Ouidah,300000,42770,Adèle Da Silva-Klein,134308,391538,2022-04-20
CASH_IN,32706,Agence_moov_Ouidah,300000,267294,Adèle Da Silva-Klein,391538,424244,2022-04-20
CASH_OUT,244179,Adèle Da Silva-Klein,424244,180065,Agence_moov_Ouidah,300000,55821,2022-04-27
CASH_IN,29739,Agence_moov_Cotonou,300000,270261,Jules Fernandes,-41744,-12005,2022-04-03
CASH_IN,248547,Agence_moov_Ouidah,300000,51453,Jules Fernandes,-12005,236542,2022-04-03
CASH_IN,20771,Agence_moov_Cotonou,300000,279229,Jules Fernandes,236542,257313,2022-04-04
CASH_IN,81000,Agence_moov_Ouidah,300000,219000,Jules Fernandes,257313,338313,2022-04-05
CASH_OUT,263147,Jules Fernandes,338313,75166,Agence_moov_Cotonou,300000,36853,2022-04-07
CASH_OUT,66458,Jules Fernandes,75166,8708,Agence_moov_Cotonou,300000,233542,2022-04-13
CASH_IN,280629,Agence_moov_Cotonou,300000,19371,Jules Fernandes,8708,289337,2022-04-17
CASH_IN,251711,Agence_moov_Abomey,300000,48289,Jules Fernandes,289337,541048,2022-04-21
CASH_OUT,80918,Jules Fernandes,541048,460130,Agence_moov_Abomey,300000,219082,2022-04-21
CASH_IN,281117,Agence_moov_Abomey,300000,18883,Thomas Dupont,46,281163,2022-04-02
TRANSFER,189010,Thomas Dupont,281163,92153,Thomas Dupont,281163,470173,2022-04-02
CASH_IN,281153,Agence_moov_Ouidah,300000,18847,Thomas Dupont,92153,373306,2022-04-03
CASH_IN,47986,Agence_moov_Ouidah,300000,252014,Thomas Dupont,373306,421292,2022-04-08
CASH_IN,155017,Agence_moov_Abomey,300000,144983,Thomas Dupont,421292,576309,2022-04-13
CASH_IN,134913,Agence_moov_Ouidah,300000,165087,Thomas Dupont,576309,711222,2022-04-18
CASH_IN,172163,Agence_moov_Ouidah,300000,127837,Léon Da Costa,-3099,169064,2022-04-01
CASH_OUT,160770,Léon Da Costa,169064,8294,Agence_moov_Cotonou,300000,139230,2022-04-03
CASH_IN,123026,Agence_moov_Cotonou,300000,176974,Léon Da Costa,8294,131320,2022-04-06
CASH_OUT,65223,Léon Da Costa,131320,66097,Agence_moov_Cotonou,300000,234777,2022-04-08
CASH_IN,25240,Agence_moov_Abomey,300000,274760,Léon Da Costa,66097,91337,2022-04-11
CASH_OUT,45932,Léon Da Costa,91337,45405,Agence_moov_Cotonou,300000,254068,2022-04-15
CASH_IN,226454,Agence_moov_Ouidah,300000,73546,Léon Da Costa,45405,271859,2022-04-20
CASH_IN,164591,Agence_moov_Cotonou,300000,135409,Léon Da Costa,271859,436450,2022-04-21
CASH_IN,232109,Agence_moov_Ouidah,300000,67891,Léon Da Costa,436450,668559,2022-04-21
CASH_IN,17625,Agence_moov_Cotonou,300000,282375,Léon Da Costa,668559,686184,2022-04-25
CASH_IN,103010,Agence_moov_Ouidah,300000,196990,Renée Le Diaz,-1312138,-1209128,2022-04-02
CASH_IN,92882,Agence_moov_Ouidah,300000,207118,Renée Le Diaz,-1209128,-1116246,2022-04-06
CASH_IN,214949,Agence_moov_Abomey,300000,85051,Renée Le Diaz,-1116246,-901297,2022-04-08
CASH_IN,240870,Agence_moov_Abomey,300000,59130,Renée Le Diaz,-901297,-660427,2022-04-09
CASH_IN,177175,Agence_moov_Abomey,300000,122825,Renée Le Diaz,-660427,-483252,2022-04-09
CASH_IN,164999,Agence_moov_Cotonou,300000,135001,Renée Le Diaz,-483252,-318253,2022-04-09
CASH_IN,50818,Agence_moov_Ouidah,300000,249182,Renée Le Diaz,-318253,-267435,2022-04-12
CASH_IN,119433,Agence_moov_Cotonou,300000,180567,Renée Le Diaz,-267435,-148002,2022-04-13
CASH_IN,221072,Agence_moov_Cotonou,300000,78928,Renée Le Diaz,-148002,73070,2022-04-19
CASH_IN,81004,Agence_moov_Abomey,300000,218996,Renée Le Diaz,73070,154074,2022-04-23
CASH_OUT,68353,Renée Le Diaz,154074,85721,Agence_moov_Ouidah,300000,231647,2022-04-25
CASH_IN,170202,Agence_moov_Cotonou,300000,129798,Renée Le Diaz,85721,255923,2022-04-27
CASH_IN,102167,Agence_moov_Cotonou,300000,197833,Stéphane Munoz,27,102194,2022-04-06
CASH_OUT,46316,Stéphane Munoz,102194,55878,Agence_moov_Ouidah,300000,253684,2022-04-07
CASH_IN,245298,Agence_moov_Abomey,300000,54702,Stéphane Munoz,55878,301176,2022-04-08
CASH_OUT,187241,Stéphane Munoz,301176,113935,Agence_moov_Ouidah,300000,112759,2022-04-09
CASH_OUT,63174,Stéphane Munoz,113935,50761,Agence_moov_Cotonou,300000,236826,2022-04-09
CASH_IN,223704,Agence_moov_Abomey,300000,76296,Stéphane Munoz,50761,274465,2022-04-09
TRANSFER,259470,Stéphane Munoz,274465,14995,Stéphane Munoz,274465,533935,2022-04-11
CASH_IN,143310,Agence_moov_Ouidah,300000,156690,Stéphane Munoz,14995,158305,2022-04-16
CASH_OUT,83057,Stéphane Munoz,158305,75248,Agence_moov_Ouidah,300000,216943,2022-04-22
CASH_OUT,8439,Stéphane Munoz,75248,66809,Agence_moov_Cotonou,300000,291561,2022-04-23
CASH_OUT,16838,Stéphane Munoz,66809,49971,Agence_moov_Ouidah,300000,283162,2022-04-24
CASH_IN,277106,Agence_moov_Cotonou,300000,22894,Stéphane Munoz,49971,327077,2022-04-26
CASH_IN,61451,Agence_moov_Cotonou,300000,238549,Marthe Gilles,-31709,29742,2022-04-02
CASH_OUT,18126,Marthe Gilles,29742,11616,Agence_moov_Cotonou,300000,281874,2022-04-03
CASH_OUT,8706,Marthe Gilles,11616,2910,Agence_moov_Abomey,300000,291294,2022-04-04
TRANSFER,2439,Marthe Gilles,2910,471,Marthe Gilles,2910,471,2022-04-04
CASH_IN,193949,Agence_moov_Cotonou,300000,106051,Marthe Gilles,471,194420,2022-04-05
TRANSFER,80151,Marthe Gilles,194420,114269,Marthe Gilles,194420,114269,2022-04-06
CASH_IN,48639,Agence_moov_Ouidah,300000,251361,Marthe Gilles,114269,162908,2022-04-07
CASH_OUT,78145,Marthe Gilles,162908,84763,Agence_moov_Ouidah,300000,221855,2022-04-08
TRANSFER,22645,Marthe Gilles,84763,62118,Marthe Gilles,84763,107408,2022-04-09
CASH_OUT,48698,Marthe Gilles,62118,13420,Agence_moov_Abomey,300000,251302,2022-04-10
CASH_IN,248099,Agence_moov_Ouidah,300000,51901,Marthe Gilles,13420,261519,2022-04-11
TRANSFER,114630,Marthe Gilles,261519,146889,Marthe Gilles,261519,146889,2022-04-12
CASH_OUT,73711,Marthe Gilles,146889,73178,Agence_moov_Cotonou,300000,226289,2022-04-14
CASH_IN,135599,Agence_moov_Cotonou,300000,164401,Marthe Gilles,73178,208777,2022-04-16
CASH_OUT,25619,Marthe Gilles,208777,183158,Agence_moov_Ouidah,300000,274381,2022-04-17
CASH_IN,66911,Agence_moov_Ouidah,300000,233089,Marthe Gilles,183158,250069,2022-04-26
CASH_OUT,22548,Marthe Gilles,250069,227521,Agence_moov_Abomey,300000,277452,2022-04-27
CASH_IN,46667,Agence_moov_Ouidah,300000,253333,Jules-Roland Bousquet,-180779,-134112,2022-04-04
CASH_IN,287072,Agence_moov_Abomey,300000,12928,Jules-Roland Bousquet,-134112,152960,2022-04-08
CASH_IN,272749,Agence_moov_Abomey,300000,27251,Jules-Roland Bousquet,152960,425709,2022-04-08
CASH_OUT,373676,Jules-Roland Bousquet,425709,52033,Agence_moov_Abomey,300000,-73676,2022-04-09
CASH_IN,4691,Agence_moov_Cotonou,300000,295309,Jules-Roland Bousquet,52033,56724,2022-04-10
CASH_IN,198274,Agence_moov_Abomey,300000,101726,Jules-Roland Bousquet,56724,254998,2022-04-17
CASH_OUT,213949,Jules-Roland Bousquet,254998,41049,Agence_moov_Abomey,300000,86051,2022-04-26
CASH_OUT,40403,Jules-Roland Bousquet,41049,646,Agence_moov_Cotonou,300000,259597,2022-04-27
CASH_IN,249886,Agence_moov_Ouidah,300000,50114,Constance Guillon,-128370,121516,2022-04-01
TRANSFER,69204,Constance Guillon,121516,52312,Constance Guillon,121516,190720,2022-04-02
CASH_IN,77735,Agence_moov_Abomey,300000,222265,Constance Guillon,52312,130047,2022-04-03
TRANSFER,85424,Constance Guillon,130047,44623,Constance Guillon,130047,215471,2022-04-06
CASH_OUT,31219,Constance Guillon,44623,13404,Agence_moov_Ouidah,300000,268781,2022-04-09
CASH_IN,98393,Agence_moov_Ouidah,300000,201607,Constance Guillon,13404,111797,2022-04-12
CASH_IN,146462,Agence_moov_Ouidah,300000,153538,Constance Guillon,111797,258259,2022-04-13
CASH_IN,157982,Agence_moov_Ouidah,300000,142018,Constance Guillon,258259,416241,2022-04-17
CASH_IN,82130,Agence_moov_Ouidah,300000,217870,Constance Guillon,416241,498371,2022-04-18
CASH_OUT,72314,Constance Guillon,498371,426057,Agence_moov_Abomey,300000,227686,2022-04-18
CASH_IN,163924,Agence_moov_Abomey,300000,136076,Constance Guillon,426057,589981,2022-04-24
CASH_IN,262453,Agence_moov_Abomey,300000,37547,Robert-Louis Gosselin,-144890,117563,2022-04-03
CASH_IN,130013,Agence_moov_Abomey,300000,169987,Robert-Louis Gosselin,117563,247576,2022-04-06
TRANSFER,35458,Robert-Louis Gosselin,247576,212118,Robert-Louis Gosselin,247576,283034,2022-04-10
CASH_OUT,41130,Robert-Louis Gosselin,212118,170988,Agence_moov_Abomey,300000,258870,2022-04-11
CASH_OUT,72573,Robert-Louis Gosselin,170988,98415,Agence_moov_Cotonou,300000,227427,2022-04-14
CASH_OUT,23517,Robert-Louis Gosselin,98415,74898,Agence_moov_Ouidah,300000,276483,2022-04-14
CASH_IN,79070,Agence_moov_Cotonou,300000,220930,Robert-Louis Gosselin,74898,153968,2022-04-18
CASH_OUT,139968,Robert-Louis Gosselin,153968,14000,Agence_moov_Abomey,300000,160032,2022-04-26
CASH_IN,128009,Agence_moov_Abomey,300000,171991,Marcelle-Valentine Guibert,-401143,-273134,2022-04-01
CASH_IN,79087,Agence_moov_Abomey,300000,220913,Marcelle-Valentine Guibert,-273134,-194047,2022-04-02
CASH_IN,204815,Agence_moov_Cotonou,300000,95185,Marcelle-Valentine Guibert,-194047,10768,2022-04-04
TRANSFER,7072,Marcelle-Valentine Guibert,10768,3696,Marcelle-Valentine Guibert,10768,17840,2022-04-08
CASH_OUT,292,Marcelle-Valentine Guibert,3696,3404,Agence_moov_Cotonou,300000,299708,2022-04-11
CASH_IN,101522,Agence_moov_Abomey,300000,198478,Marcelle-Valentine Guibert,3404,104926,2022-04-16
CASH_OUT,100024,Marcelle-Valentine Guibert,104926,4902,Agence_moov_Ouidah,300000,199976,2022-04-21
CASH_IN,29632,Agence_moov_Cotonou,300000,270368,Paul Rocher-Maillet,-772033,-742401,2022-04-04
CASH_IN,5088,Agence_moov_Cotonou,300000,294912,Paul Rocher-Maillet,-742401,-737313,2022-04-05
CASH_IN,215409,Agence_moov_Ouidah,300000,84591,Paul Rocher-Maillet,-737313,-521904,2022-04-13
CASH_IN,293262,Agence_moov_Abomey,300000,6738,Paul Rocher-Maillet,-521904,-228642,2022-04-14
CASH_IN,130405,Agence_moov_Ouidah,300000,169595,Paul Rocher-Maillet,-228642,-98237,2022-04-14
CASH_IN,90501,Agence_moov_Ouidah,300000,209499,Paul Rocher-Maillet,-98237,-7736,2022-04-17
CASH_IN,104785,Agence_moov_Abomey,300000,195215,Paul Rocher-Maillet,-7736,97049,2022-04-19
CASH_OUT,2112,Paul Rocher-Maillet,97049,94937,Agence_moov_Abomey,300000,297888,2022-04-24
CASH_OUT,51232,Paul Rocher-Maillet,94937,43705,Agence_moov_Ouidah,300000,248768,2022-04-25
CASH_IN,294521,Agence_moov_Ouidah,300000,5479,Michelle Samson,-196094,98427,2022-04-01
TRANSFER,73857,Michelle Samson,98427,24570,Michelle Samson,98427,24570,2022-04-02
CASH_OUT,6891,Michelle Samson,24570,17679,Agence_moov_Abomey,300000,293109,2022-04-02
TRANSFER,3696,Michelle Samson,17679,13983,Michelle Samson,17679,21375,2022-04-07
CASH_IN,154788,Agence_moov_Abomey,300000,145212,Michelle Samson,13983,168771,2022-04-08
CASH_IN,56396,Agence_moov_Abomey,300000,243604,Michelle Samson,168771,225167,2022-04-16
CASH_IN,104925,Agence_moov_Cotonou,300000,195075,Tristan Gomez,741700,846625,2022-05-04
CASH_IN,200317,Agence_moov_Cotonou,300000,99683,Manon Chevalier,1170900,1371217,2022-05-20
TRANSFER,780585,Nath Loiseau,1190900,410315,Manon Chevalier,1371217,2151802,2022-05-21
CASH_OUT,1291332,Paulette Loiseau,1938500,647168,Agence_moov_Cotonou,300000,-991332,2022-05-04
CASH_OUT,288318,Paulette Loiseau,647168,358850,Agence_moov_Ouidah,300000,11682,2022-05-07
TRANSFER,353450,Clémence-Véronique Munoz,585600,232150,Paulette Loiseau,358850,712300,2022-05-08
CASH_OUT,660136,Paulette Loiseau,712300,52164,Agence_moov_Cotonou,300000,-360136,2022-05-08
CASH_OUT,21523,Paulette Loiseau,52164,30641,Agence_moov_Ouidah,300000,278477,2022-05-16
TRANSFER,13002,Alphonse Joly,561800,548798,Aurore Charrier,663000,676002,2022-05-03
TRANSFER,389810,Thibaut de la Roy,1758600,1368790,Philippe Philippe,688900,1078710,2022-05-02
CASH_IN,233755,Agence_moov_Ouidah,300000,66245,Philippe Philippe,1078710,1312465,2022-05-20
CASH_OUT,380804,Mathilde Picard du Delmas,1838500,1457696,Agence_moov_Abomey,300000,-80804,2022-05-12
TRANSFER,80496,Vincent de la Dumont,496900,416404,Bertrand Regnier,404400,323904,2022-05-04
CASH_OUT,388557,Vincent de la Dumont,416404,27847,Agence_moov_Ouidah,300000,-88557,2022-05-04
CASH_OUT,7236,Vincent de la Dumont,27847,20611,Agence_moov_Ouidah,300000,292764,2022-05-19
CASH_OUT,3283,Vincent de la Dumont,20611,17328,Agence_moov_Abomey,300000,296717,2022-05-26
CASH_OUT,375300,Nicolas Salmon Le Hamon,696700,321400,Agence_moov_Cotonou,300000,-75300,2022-05-08
TRANSFER,224910,Nicolas Salmon Le Hamon,321400,96490,Gérard de la Martinez,877400,652490,2022-05-09
TRANSFER,61258,Michel Bouchet,217100,155842,Nicolas Salmon Le Hamon,96490,157748,2022-05-20
CASH_OUT,306072,Thibaut de la Lombard,1393000,1086928,Agence_moov_Cotonou,300000,-6072,2022-05-03
CASH_IN,291331,Agence_moov_Abomey,300000,8669,Thibaut de la Lombard,1086928,1378259,2022-05-23
CASH_OUT,128099,Théodore Joseph-Lefebvre,368900,240801,Agence_moov_Abomey,300000,171901,2022-05-05
TRANSFER,978147,Marc Leleu,1422600,444453,Théodore Joseph-Lefebvre,240801,1218948,2022-05-07
CASH_OUT,428823,Théodore Joseph-Lefebvre,1218948,790125,Agence_moov_Ouidah,300000,-128823,2022-05-15
CASH_IN,241832,Agence_moov_Abomey,300000,58168,Théodore Joseph-Lefebvre,790125,1031957,2022-05-17
CASH_IN,88409,Agence_moov_Ouidah,300000,211591,Martine Aubert,706600,795009,2022-05-01
CASH_OUT,40416,Martine Aubert,795009,754593,Agence_moov_Ouidah,300000,259584,2022-05-08
TRANSFER,274252,Martine Aubert,754593,480341,Thérèse François,880100,605848,2022-05-09
TRANSFER,115814,Martine Aubert,480341,364527,Camille Prévost,1489600,1373786,2022-05-26
TRANSFER,127909,Paul Rocher-Maillet,149400,21491,Lucie Aubert,1251200,1379109,2022-05-03
TRANSFER,597980,Simone Muller de la Brun,670500,72520,Lucie Aubert,1379109,1977089,2022-05-17
TRANSFER,594687,Lucie Aubert,1977089,1382402,Lucy Lamy,835600,240913,2022-05-20
TRANSFER,1411599,Noémi Bouvier,1576000,164401,Robert-Louis Gosselin,1342500,-69099,2022-05-05
CASH_OUT,69073,Noémi Bouvier,164401,95328,Agence_moov_Ouidah,300000,230927,2022-05-10
TRANSFER,24433,Noémi Bouvier,95328,70895,Alphonse Gomes,387700,363267,2022-05-15
CASH_IN,147762,Agence_moov_Abomey,300000,152238,Noémi Bouvier,70895,218657,2022-05-26
TRANSFER,224583,Michelle Samson,303000,78417,Richard Michel,416000,640583,2022-05-06
CASH_OUT,199236,Alphonse Joly,548798,349562,Agence_moov_Cotonou,300000,100764,2022-05-02
CASH_IN,100795,Agence_moov_Abomey,300000,199205,Alphonse Joly,349562,450357,2022-05-12
CASH_IN,44514,Agence_moov_Cotonou,300000,255486,Alphonse Joly,450357,494871,2022-05-19
TRANSFER,61251,Alphonse Joly,494871,433620,Jules Fernandes,1749100,1687849,2022-05-27
CASH_IN,213102,Agence_moov_Ouidah,300000,86898,Alphonse Joly,433620,646722,2022-05-27
CASH_OUT,380753,Émile-René Baudry,827700,446947,Agence_moov_Cotonou,300000,-80753,2022-05-09
CASH_OUT,423610,Émile-René Baudry,446947,23337,Agence_moov_Cotonou,300000,-123610,2022-05-15
CASH_IN,234101,Agence_moov_Cotonou,300000,65899,Émile-René Baudry,23337,257438,2022-05-19
CASH_OUT,182044,Colette-Sophie Prévost,384700,202656,Agence_moov_Cotonou,300000,117956,2022-05-09
CASH_OUT,105476,Colette-Sophie Prévost,202656,97180,Agence_moov_Ouidah,300000,194524,2022-05-13
TRANSFER,587399,Antoinette de Dupuis,1977000,1389601,Colette-Sophie Prévost,97180,684579,2022-05-19
CASH_IN,154375,Agence_moov_Abomey,300000,145625,Colette-Sophie Prévost,684579,838954,2022-05-27
CASH_OUT,161842,Constance Bourdon-Millet,251000,89158,Agence_moov_Ouidah,300000,138158,2022-05-10
CASH_OUT,44002,Constance Bourdon-Millet,89158,45156,Agence_moov_Abomey,300000,255998,2022-05-12
TRANSFER,49212,Audrey Julien de Leleu,63400,14188,Constance Bourdon-Millet,45156,94368,2022-05-20
TRANSFER,23608,Michelle-Dorothée Lévêque,405900,382292,Constance Bourdon-Millet,94368,117976,2022-05-23
TRANSFER,134594,Luc Lévêque-Carre,662200,527606,Constance Bourdon-Millet,117976,252570,2022-05-25
TRANSFER,245380,Andrée-Thérèse Mendès,876400,631020,Thomas de Blin,1413700,1168320,2022-05-06
CASH_OUT,613657,Andrée-Thérèse Mendès,631020,17363,Agence_moov_Ouidah,300000,-313657,2022-05-27
TRANSFER,191361,Tristan Bousquet-Gros,1555100,1363739,Hélène de la Gérard,80600,271961,2022-05-05
CASH_IN,35557,Agence_moov_Abomey,300000,264443,Hélène de la Gérard,271961,307518,2022-05-05
TRANSFER,119178,Renée Le Diaz,621400,502222,Hélène de la Gérard,307518,426696,2022-05-06
CASH_IN,40356,Agence_moov_Cotonou,300000,259644,Hélène de la Gérard,426696,467052,2022-05-12
CASH_IN,289256,Agence_moov_Cotonou,300000,10744,Maggie Martinez,1283700,1572956,2022-05-13
TRANSFER,823744,Maggie Martinez,1572956,749212,Adèle Da Silva-Klein,1788000,964256,2022-05-17
TRANSFER,293314,Maggie Martinez,749212,455898,Aimé Pages,284200,-9114,2022-05-18
CASH_OUT,225282,Maggie Martinez,455898,230616,Agence_moov_Ouidah,300000,74718,2022-05-26
TRANSFER,197641,Clémence-Véronique Munoz,232150,34509,Michel Bouchet,155842,353483,2022-05-04
CASH_OUT,220065,Michel Bouchet,353483,133418,Agence_moov_Abomey,300000,79935,2022-05-08
CASH_OUT,127654,Michel Bouchet,133418,5764,Agence_moov_Cotonou,300000,172346,2022-05-11
TRANSFER,3451,Michel Bouchet,5764,2313,Jules Fernandes,1687849,1684398,2022-05-26
TRANSFER,4678,Christine Texier,1992900,1988222,Bernard Maurice,882500,887178,2022-05-09
CASH_IN,14831,Agence_moov_Ouidah,300000,285169,Bernard Maurice,887178,902009,2022-05-10
CASH_OUT,766464,Bernard Maurice,902009,135545,Agence_moov_Cotonou,300000,-466464,2022-05-21
TRANSFER,164316,Robert Clerc,676100,511784,Thomas Guichard du Renault,1901900,1737584,2022-05-01
CASH_OUT,414564,Robert Clerc,511784,97220,Agence_moov_Ouidah,300000,-114564,2022-05-12
CASH_OUT,40547,Robert Clerc,97220,56673,Agence_moov_Cotonou,300000,259453,2022-05-16
TRANSFER,411796,Stéphane Munoz,774800,363004,Lucy Gillet,1054100,1465896,2022-05-01
CASH_IN,130869,Agence_moov_Abomey,300000,169131,Lucy Gillet,1465896,1596765,2022-05-03
CASH_IN,226085,Agence_moov_Cotonou,300000,73915,Lucy Gillet,1596765,1822850,2022-05-03
CASH_IN,230229,Agence_moov_Cotonou,300000,69771,Lucy Gillet,1822850,2053079,2022-05-06
CASH_OUT,1303729,Lucy Gillet,2053079,749350,Agence_moov_Abomey,300000,-1003729,2022-05-10
CASH_OUT,49948,Lucy Gillet,749350,699402,Agence_moov_Abomey,300000,250052,2022-05-11
TRANSFER,304735,Agnès Le Giraud,422300,117565,Lucy Gillet,699402,1004137,2022-05-11
CASH_OUT,266063,Lucy Gillet,1004137,738074,Agence_moov_Abomey,300000,33937,2022-05-13
CASH_OUT,422537,Lucy Gillet,738074,315537,Agence_moov_Abomey,300000,-122537,2022-05-13
TRANSFER,311942,Manon Lebon,1303300,991358,Lucy Gillet,315537,627479,2022-05-14
TRANSFER,457037,Gabriel Bègue,778000,320963,Lucy Gillet,627479,1084516,2022-05-14
CASH_IN,175534,Agence_moov_Ouidah,300000,124466,Lucy Gillet,1084516,1260050,2022-05-16
TRANSFER,1149472,Lucy Gillet,1260050,110578,Astrid Lecoq,1265400,115928,2022-05-19
TRANSFER,78050,Lucy Gillet,110578,32528,Anne Peltier-Raynaud,590400,512350,2022-05-19
TRANSFER,29288,Lucy Gillet,32528,3240,Bertrand Regnier,323904,294616,2022-05-23
CASH_OUT,1641,Lucy Gillet,3240,1599,Agence_moov_Cotonou,300000,298359,2022-05-23
TRANSFER,1411,Lucy Gillet,1599,188,Robert Laroche,619500,618089,2022-05-23
TRANSFER,103,Lucy Gillet,188,85,Alix Barbe,740700,740597,2022-05-24
CASH_IN,137346,Agence_moov_Ouidah,300000,162654,Lucy Gillet,85,137431,2022-05-24
TRANSFER,736679,Camille Morvan,1015900,279221,Lucy Gillet,137431,874110,2022-05-25
CASH_IN,179548,Agence_moov_Ouidah,300000,120452,Lucy Gillet,874110,1053658,2022-05-25
CASH_IN,137035,Agence_moov_Ouidah,300000,162965,Lucy Gillet,1053658,1190693,2022-05-26
TRANSFER,23211,Hélène Le Chauvin,78100,54889,Renée Rousseau-Henry,1645600,1668811,2022-05-07
TRANSFER,1201221,Antoinette de Dupuis,1389601,188380,Renée Rousseau-Henry,1668811,2870032,2022-05-07
CASH_IN,195307,Agence_moov_Abomey,300000,104693,Renée Rousseau-Henry,2870032,3065339,2022-05-07
CASH_IN,169943,Agence_moov_Ouidah,300000,130057,Renée Rousseau-Henry,3065339,3235282,2022-05-08
CASH_OUT,992741,Renée Rousseau-Henry,3235282,2242541,Agence_moov_Abomey,300000,-692741,2022-05-10
CASH_IN,138152,Agence_moov_Cotonou,300000,161848,Renée Rousseau-Henry,2242541,2380693,2022-05-11
CASH_IN,284968,Agence_moov_Cotonou,300000,15032,Renée Rousseau-Henry,2380693,2665661,2022-05-13
TRANSFER,317584,Marc Leleu,444453,126869,Renée Rousseau-Henry,2665661,2983245,2022-05-16
CASH_IN,169499,Agence_moov_Cotonou,300000,130501,Renée Rousseau-Henry,2983245,3152744,2022-05-17
CASH_OUT,1296487,Renée Rousseau-Henry,3152744,1856257,Agence_moov_Abomey,300000,-996487,2022-05-17
CASH_OUT,1238688,Renée Rousseau-Henry,1856257,617569,Agence_moov_Abomey,300000,-938688,2022-05-18
TRANSFER,243536,Gabriel Bègue,320963,77427,Renée Rousseau-Henry,617569,861105,2022-05-18
TRANSFER,449801,Renée Rousseau-Henry,861105,411304,Camille Morvan,279221,-170580,2022-05-19
CASH_IN,26877,Agence_moov_Cotonou,300000,273123,Renée Rousseau-Henry,411304,438181,2022-05-19
TRANSFER,227576,Paul Perez,985200,757624,Renée Rousseau-Henry,438181,665757,2022-05-20
CASH_IN,125755,Agence_moov_Cotonou,300000,174245,Renée Rousseau-Henry,665757,791512,2022-05-20
TRANSFER,841383,Manon Valette,1502000,660617,Renée Rousseau-Henry,791512,1632895,2022-05-21
TRANSFER,159337,Bernadette de Jourdan,1333800,1174463,Renée Rousseau-Henry,1632895,1792232,2022-05-21
TRANSFER,1745190,Renée Rousseau-Henry,1792232,47042,Nathalie Bonnin-Joubert,1075500,-669690,2022-05-22
CASH_IN,282101,Agence_moov_Cotonou,300000,17899,Renée Rousseau-Henry,47042,329143,2022-05-22
TRANSFER,252665,Renée Rousseau-Henry,329143,76478,Camille Prévost,1373786,1121121,2022-05-22
TRANSFER,71411,Renée Rousseau-Henry,76478,5067,Manon Valette,660617,589206,2022-05-23
CASH_OUT,3198,Renée Rousseau-Henry,5067,1869,Agence_moov_Ouidah,300000,296802,2022-05-23
TRANSFER,237,Renée Rousseau-Henry,1869,1632,Alix Barbe,740597,740360,2022-05-23
CASH_IN,144078,Agence_moov_Cotonou,300000,155922,Renée Rousseau-Henry,1632,145710,2022-05-27
CASH_IN,102176,Agence_moov_Ouidah,300000,197824,Vincent Joubert,1665400,1767576,2022-05-01
CASH_IN,155882,Agence_moov_Cotonou,300000,144118,Vincent Joubert,1767576,1923458,2022-05-05
CASH_OUT,1120983,Vincent Joubert,1923458,802475,Agence_moov_Ouidah,300000,-820983,2022-05-05
CASH_IN,215784,Agence_moov_Ouidah,300000,84216,Vincent Joubert,802475,1018259,2022-05-06
CASH_IN,246198,Agence_moov_Cotonou,300000,53802,Vincent Joubert,1018259,1264457,2022-05-06
TRANSFER,24762,Vincent Joubert,1264457,1239695,Véronique Martins de Fleury,809500,784738,2022-05-06
TRANSFER,689379,Vincent Joubert,1239695,550316,Adèle Da Silva-Klein,964256,274877,2022-05-09
TRANSFER,6474,Tristan Delahaye,526400,519926,Vincent Joubert,550316,556790,2022-05-12
CASH_IN,220994,Agence_moov_Ouidah,300000,79006,Vincent Joubert,556790,777784,2022-05-13
TRANSFER,28512,Vincent Joubert,777784,749272,Céline Collin-Hervé,941100,912588,2022-05-14
TRANSFER,44072,Vincent Joubert,749272,705200,Thibaut de la Roy,1368790,1324718,2022-05-14
TRANSFER,533425,Vincent Joubert,705200,171775,Thomas de Blin,1168320,634895,2022-05-16
TRANSFER,161738,Vincent Joubert,171775,10037,Véronique Martins de Fleury,784738,623000,2022-05-17
CASH_OUT,509,Vincent Joubert,10037,9528,Agence_moov_Abomey,300000,299491,2022-05-17
CASH_IN,220791,Agence_moov_Abomey,300000,79209,Vincent Joubert,9528,230319,2022-05-17
CASH_IN,29871,Agence_moov_Ouidah,300000,270129,Vincent Joubert,230319,260190,2022-05-18
TRANSFER,117679,Vincent Joubert,260190,142511,Paul Rocher-Maillet,21491,-96188,2022-05-19
TRANSFER,45687,Vincent Joubert,142511,96824,Lucy Lamy,240913,195226,2022-05-20
TRANSFER,60635,Vincent Joubert,96824,36189,Virginie Bouvet,1594500,1533865,2022-05-21
CASH_IN,105962,Agence_moov_Ouidah,300000,194038,Vincent Joubert,36189,142151,2022-05-24
CASH_IN,229316,Agence_moov_Abomey,300000,70684,Vincent Joubert,142151,371467,2022-05-25
CASH_OUT,156011,Vincent Joubert,371467,215456,Agence_moov_Abomey,300000,143989,2022-05-25
TRANSFER,78996,Vincent Joubert,215456,136460,Emmanuel Grégoire,696100,617104,2022-05-27
CASH_OUT,109340,Vincent Joubert,136460,27120,Agence_moov_Cotonou,300000,190660,2022-05-27
CASH_IN,252448,Agence_moov_Abomey,300000,47552,Constance Guillon,1969200,2221648,2022-05-05
CASH_OUT,104899,Constance Guillon,2221648,2116749,Agence_moov_Ouidah,300000,195101,2022-05-06
CASH_IN,99482,Agence_moov_Cotonou,300000,200518,Constance Guillon,2116749,2216231,2022-05-07
CASH_OUT,1351750,Constance Guillon,2216231,864481,Agence_moov_Cotonou,300000,-1051750,2022-05-07
TRANSFER,638500,Constance Guillon,864481,225981,Camille Prévost,1121121,482621,2022-05-11
CASH_OUT,104141,Constance Guillon,225981,121840,Agence_moov_Cotonou,300000,195859,2022-05-12
CASH_OUT,101449,Constance Guillon,121840,20391,Agence_moov_Abomey,300000,198551,2022-05-12
CASH_OUT,17747,Constance Guillon,20391,2644,Agence_moov_Cotonou,300000,282253,2022-05-13
TRANSFER,39626,Hélène Le Chauvin,54889,15263,Constance Guillon,2644,42270,2022-05-14
TRANSFER,7172,Léon Da Costa,1205500,1198328,Constance Guillon,42270,49442,2022-05-16
CASH_OUT,5553,Constance Guillon,49442,43889,Agence_moov_Cotonou,300000,294447,2022-05-16
CASH_OUT,17421,Constance Guillon,43889,26468,Agence_moov_Abomey,300000,282579,2022-05-17
TRANSFER,7810,Constance Guillon,26468,18658,Manon Valette,589206,581396,2022-05-18
TRANSFER,11922,Constance Guillon,18658,6736,Thérèse Hubert,991600,979678,2022-05-19
CASH_IN,85454,Agence_moov_Cotonou,300000,214546,Constance Guillon,6736,92190,2022-05-20
CASH_IN,163325,Agence_moov_Ouidah,300000,136675,Constance Guillon,92190,255515,2022-05-20
CASH_OUT,24398,Constance Guillon,255515,231117,Agence_moov_Ouidah,300000,275602,2022-05-20
CASH_IN,182843,Agence_moov_Cotonou,300000,117157,Constance Guillon,231117,413960,2022-05-22
TRANSFER,36830,Constance Guillon,413960,377130,Michelle-Dorothée Lévêque,382292,345462,2022-05-23
TRANSFER,51304,Michelle-Dorothée Lévêque,345462,294158,Constance Guillon,377130,428434,2022-05-26
TRANSFER,9825,Tristan Bousquet-Gros,1363739,1353914,Constance Guillon,428434,438259,2022-05-27
TRANSFER,66986,Agnès Le Giraud,117565,50579,Emmanuel Grégoire,617104,684090,2022-05-01
TRANSFER,82204,Emmanuel Grégoire,684090,601886,Robert Laroche,618089,535885,2022-05-03
CASH_IN,74312,Agence_moov_Abomey,300000,225688,Emmanuel Grégoire,601886,676198,2022-05-03
CASH_IN,234535,Agence_moov_Cotonou,300000,65465,Emmanuel Grégoire,676198,910733,2022-05-07
CASH_OUT,119993,Emmanuel Grégoire,910733,790740,Agence_moov_Abomey,300000,180007,2022-05-07
CASH_IN,93576,Agence_moov_Abomey,300000,206424,Emmanuel Grégoire,790740,884316,2022-05-09
CASH_IN,233448,Agence_moov_Abomey,300000,66552,Emmanuel Grégoire,884316,1117764,2022-05-09
CASH_IN,58436,Agence_moov_Cotonou,300000,241564,Emmanuel Grégoire,1117764,1176200,2022-05-09
CASH_IN,42720,Agence_moov_Cotonou,300000,257280,Emmanuel Grégoire,1176200,1218920,2022-05-10
CASH_IN,189398,Agence_moov_Ouidah,300000,110602,Emmanuel Grégoire,1218920,1408318,2022-05-12
CASH_OUT,147279,Emmanuel Grégoire,1408318,1261039,Agence_moov_Ouidah,300000,152721,2022-05-13
TRANSFER,672199,Emmanuel Grégoire,1261039,588840,Thomas-Robert Morvan,558600,-113599,2022-05-14
TRANSFER,310254,Véronique Martins de Fleury,623000,312746,Emmanuel Grégoire,588840,899094,2022-05-15
CASH_IN,34820,Agence_moov_Cotonou,300000,265180,Emmanuel Grégoire,899094,933914,2022-05-15
CASH_OUT,846346,Emmanuel Grégoire,933914,87568,Agence_moov_Abomey,300000,-546346,2022-05-17
TRANSFER,994548,André Renault,1318100,323552,Emmanuel Grégoire,87568,1082116,2022-05-17
TRANSFER,745958,Marthe Gilles,1131300,385342,Emmanuel Grégoire,1082116,1828074,2022-05-18
CASH_IN,143115,Agence_moov_Cotonou,300000,156885,Emmanuel Grégoire,1828074,1971189,2022-05-18
CASH_IN,152664,Agence_moov_Abomey,300000,147336,Emmanuel Grégoire,1971189,2123853,2022-05-20
TRANSFER,1651444,Emmanuel Grégoire,2123853,472409,Stéphane Munoz,363004,-1288440,2022-05-22
CASH_OUT,139187,Emmanuel Grégoire,472409,333222,Agence_moov_Abomey,300000,160813,2022-05-22
CASH_IN,252381,Agence_moov_Abomey,300000,47619,Emmanuel Grégoire,333222,585603,2022-05-23
TRANSFER,123502,Emmanuel Grégoire,585603,462101,Manon Valette,581396,457894,2022-05-23
CASH_IN,66344,Agence_moov_Ouidah,300000,233656,Emmanuel Grégoire,462101,528445,2022-05-23
CASH_IN,9490,Agence_moov_Ouidah,300000,290510,Emmanuel Grégoire,528445,537935,2022-05-24
CASH_IN,77788,Agence_moov_Ouidah,300000,222212,Emmanuel Grégoire,537935,615723,2022-05-26
CASH_IN,223262,Agence_moov_Abomey,300000,76738,Emmanuel Grégoire,615723,838985,2022-05-26
CASH_IN,278582,Agence_moov_Cotonou,300000,21418,Emmanuel Grégoire,838985,1117567,2022-05-26
TRANSFER,40426,Astrid Lecoq,115928,75502,Bernadette de Jourdan,1174463,1134037,2022-05-03
CASH_OUT,64431,Astrid Lecoq,75502,11071,Agence_moov_Abomey,300000,235569,2022-05-05
CASH_OUT,363,Astrid Lecoq,11071,10708,Agence_moov_Ouidah,300000,299637,2022-05-07
CASH_IN,285070,Agence_moov_Cotonou,300000,14930,Astrid Lecoq,10708,295778,2022-05-07
TRANSFER,489630,Sabine Pineau,1476100,986470,Astrid Lecoq,295778,785408,2022-05-07
CASH_OUT,39526,Astrid Lecoq,785408,745882,Agence_moov_Cotonou,300000,260474,2022-05-10
CASH_OUT,602519,Astrid Lecoq,745882,143363,Agence_moov_Abomey,300000,-302519,2022-05-13
TRANSFER,118121,Astrid Lecoq,143363,25242,Richard Le Lévêque,585600,467479,2022-05-13
CASH_OUT,10733,Astrid Lecoq,25242,14509,Agence_moov_Ouidah,300000,289267,2022-05-14
CASH_IN,541,Agence_moov_Cotonou,300000,299459,Astrid Lecoq,14509,15050,2022-05-15
TRANSFER,472047,Alix Barbe,740360,268313,Astrid Lecoq,15050,487097,2022-05-15
CASH_IN,294101,Agence_moov_Abomey,300000,5899,Astrid Lecoq,487097,781198,2022-05-15
CASH_IN,14689,Agence_moov_Abomey,300000,285311,Astrid Lecoq,781198,795887,2022-05-15
CASH_IN,16341,Agence_moov_Ouidah,300000,283659,Astrid Lecoq,795887,812228,2022-05-16
CASH_OUT,244539,Astrid Lecoq,812228,567689,Agence_moov_Cotonou,300000,55461,2022-05-18
CASH_OUT,437636,Astrid Lecoq,567689,130053,Agence_moov_Abomey,300000,-137636,2022-05-19
CASH_IN,115089,Agence_moov_Cotonou,300000,184911,Astrid Lecoq,130053,245142,2022-05-19
CASH_IN,15459,Agence_moov_Cotonou,300000,284541,Astrid Lecoq,245142,260601,2022-05-20
TRANSFER,99654,Alphonse Gomes,363267,263613,Astrid Lecoq,260601,360255,2022-05-23
CASH_IN,22223,Agence_moov_Abomey,300000,277777,Astrid Lecoq,360255,382478,2022-05-23
TRANSFER,704458,Noël Bourgeois,1193000,488542,Astrid Lecoq,382478,1086936,2022-05-23
TRANSFER,889991,Astrid Lecoq,1086936,196945,Jules-Roland Bousquet,454500,-435491,2022-05-24
CASH_IN,109102,Agence_moov_Cotonou,300000,190898,Astrid Lecoq,196945,306047,2022-05-25
CASH_IN,18891,Agence_moov_Ouidah,300000,281109,Astrid Lecoq,306047,324938,2022-05-26
CASH_IN,120885,Agence_moov_Abomey,300000,179115,Camille Morvan,-170580,-49695,2022-05-01
CASH_IN,175466,Agence_moov_Ouidah,300000,124534,Camille Morvan,-49695,125771,2022-05-03
TRANSFER,111443,Camille Morvan,125771,14328,Françoise Morin,1547200,1435757,2022-05-03
CASH_IN,88090,Agence_moov_Ouidah,300000,211910,Camille Morvan,14328,102418,2022-05-06
CASH_IN,141852,Agence_moov_Ouidah,300000,158148,Camille Morvan,102418,244270,2022-05-06
TRANSFER,310725,Noël Bourgeois,488542,177817,Camille Morvan,244270,554995,2022-05-08
CASH_IN,74109,Agence_moov_Cotonou,300000,225891,Camille Morvan,554995,629104,2022-05-11
CASH_IN,180865,Agence_moov_Abomey,300000,119135,Camille Morvan,629104,809969,2022-05-11
TRANSFER,131689,Camille Morvan,809969,678280,Bernadette de Jourdan,1134037,1002348,2022-05-12
TRANSFER,128688,Camille Morvan,678280,549592,Camille Morvan,678280,806968,2022-05-13
CASH_OUT,24047,Camille Morvan,549592,525545,Agence_moov_Cotonou,300000,275953,2022-05-13
CASH_IN,168453,Agence_moov_Ouidah,300000,131547,Camille Morvan,525545,693998,2022-05-15
CASH_IN,93629,Agence_moov_Abomey,300000,206371,Camille Morvan,693998,787627,2022-05-16
CASH_OUT,380362,Camille Morvan,787627,407265,Agence_moov_Abomey,300000,-80362,2022-05-16
CASH_OUT,211491,Camille Morvan,407265,195774,Agence_moov_Abomey,300000,88509,2022-05-17
CASH_OUT,135777,Camille Morvan,195774,59997,Agence_moov_Cotonou,300000,164223,2022-05-17
CASH_OUT,47848,Camille Morvan,59997,12149,Agence_moov_Abomey,300000,252152,2022-05-18
CASH_IN,75770,Agence_moov_Abomey,300000,224230,Camille Morvan,12149,87919,2022-05-18
CASH_IN,64090,Agence_moov_Cotonou,300000,235910,Camille Morvan,87919,152009,2022-05-20
CASH_OUT,38479,Camille Morvan,152009,113530,Agence_moov_Abomey,300000,261521,2022-05-20
TRANSFER,104370,Camille Morvan,113530,9160,Tristan Bousquet-Gros,1353914,1249544,2022-05-20
CASH_OUT,4062,Camille Morvan,9160,5098,Agence_moov_Abomey,300000,295938,2022-05-20
CASH_OUT,4324,Camille Morvan,5098,774,Agence_moov_Abomey,300000,295676,2022-05-22
CASH_IN,184272,Agence_moov_Cotonou,300000,115728,Camille Morvan,774,185046,2022-05-22
CASH_IN,25814,Agence_moov_Cotonou,300000,274186,Camille Morvan,185046,210860,2022-05-22
TRANSFER,34463,Clémence-Véronique Munoz,34509,46,Camille Morvan,210860,245323,2022-05-26
CASH_IN,11596,Agence_moov_Abomey,300000,288404,Nath Loiseau,410315,421911,2022-05-01
CASH_OUT,358896,Nath Loiseau,421911,63015,Agence_moov_Abomey,300000,-58896,2022-05-01
CASH_OUT,21388,Nath Loiseau,63015,41627,Agence_moov_Cotonou,300000,278612,2022-05-02
CASH_OUT,6800,Nath Loiseau,41627,34827,Agence_moov_Abomey,300000,293200,2022-05-04
CASH_OUT,23170,Nath Loiseau,34827,11657,Agence_moov_Abomey,300000,276830,2022-05-05
CASH_IN,159996,Agence_moov_Abomey,300000,140004,Nath Loiseau,11657,171653,2022-05-06
CASH_IN,160821,Agence_moov_Ouidah,300000,139179,Nath Loiseau,171653,332474,2022-05-07
CASH_IN,66628,Agence_moov_Cotonou,300000,233372,Nath Loiseau,332474,399102,2022-05-08
CASH_IN,268230,Agence_moov_Cotonou,300000,31770,Nath Loiseau,399102,667332,2022-05-10
CASH_IN,25597,Agence_moov_Ouidah,300000,274403,Nath Loiseau,667332,692929,2022-05-13
CASH_OUT,677394,Nath Loiseau,692929,15535,Agence_moov_Abomey,300000,-377394,2022-05-13
TRANSFER,4000,Nath Loiseau,15535,11535,Marc Leleu,126869,122869,2022-05-13
CASH_IN,283563,Agence_moov_Abomey,300000,16437,Nath Loiseau,11535,295098,2022-05-15
CASH_IN,147525,Agence_moov_Ouidah,300000,152475,Nath Loiseau,295098,442623,2022-05-16
CASH_OUT,241221,Nath Loiseau,442623,201402,Agence_moov_Abomey,300000,58779,2022-05-18
TRANSFER,162166,Nath Loiseau,201402,39236,Richard Le Lévêque,467479,305313,2022-05-19
CASH_OUT,11305,Nath Loiseau,39236,27931,Agence_moov_Cotonou,300000,288695,2022-05-22
CASH_IN,247035,Agence_moov_Ouidah,300000,52965,Nath Loiseau,27931,274966,2022-05-22
CASH_OUT,272992,Nath Loiseau,274966,1974,Agence_moov_Ouidah,300000,27008,2022-05-22
CASH_OUT,806,Nath Loiseau,1974,1168,Agence_moov_Cotonou,300000,299194,2022-05-23
CASH_OUT,1140,Nath Loiseau,1168,28,Agence_moov_Cotonou,300000,298860,2022-05-23
CASH_IN,14314,Agence_moov_Cotonou,300000,285686,Nath Loiseau,28,14342,2022-05-25
TRANSFER,2540,Nath Loiseau,14342,11802,Antoinette de Dupuis,188380,185840,2022-05-25
CASH_OUT,1074,Nath Loiseau,11802,10728,Agence_moov_Ouidah,300000,298926,2022-05-25
TRANSFER,3034,Nath Loiseau,10728,7694,Antoinette de Dupuis,185840,182806,2022-05-26
CASH_IN,164655,Agence_moov_Ouidah,300000,135345,Aimé Pages,-9114,155541,2022-05-02
CASH_OUT,84847,Aimé Pages,155541,70694,Agence_moov_Cotonou,300000,215153,2022-05-02
CASH_OUT,22528,Aimé Pages,70694,48166,Agence_moov_Cotonou,300000,277472,2022-05-04
TRANSFER,858769,Céline Collin-Hervé,912588,53819,Aimé Pages,48166,906935,2022-05-07
CASH_IN,267577,Agence_moov_Cotonou,300000,32423,Aimé Pages,906935,1174512,2022-05-10
CASH_IN,62305,Agence_moov_Ouidah,300000,237695,Aimé Pages,1174512,1236817,2022-05-11
CASH_IN,114728,Agence_moov_Abomey,300000,185272,Aimé Pages,1236817,1351545,2022-05-12
CASH_IN,158936,Agence_moov_Ouidah,300000,141064,Aimé Pages,1351545,1510481,2022-05-12
TRANSFER,477020,Tristan Delahaye,519926,42906,Aimé Pages,1510481,1987501,2022-05-15
CASH_OUT,1620058,Aimé Pages,1987501,367443,Agence_moov_Cotonou,300000,-1320058,2022-05-15
CASH_IN,87875,Agence_moov_Cotonou,300000,212125,Aimé Pages,367443,455318,2022-05-15
CASH_OUT,188340,Aimé Pages,455318,266978,Agence_moov_Cotonou,300000,111660,2022-05-15
CASH_OUT,54776,Aimé Pages,266978,212202,Agence_moov_Ouidah,300000,245224,2022-05-16
CASH_IN,253060,Agence_moov_Cotonou,300000,46940,Aimé Pages,212202,465262,2022-05-17
CASH_IN,122011,Agence_moov_Cotonou,300000,177989,Aimé Pages,465262,587273,2022-05-17
CASH_OUT,41917,Aimé Pages,587273,545356,Agence_moov_Abomey,300000,258083,2022-05-18
CASH_IN,140204,Agence_moov_Abomey,300000,159796,Aimé Pages,545356,685560,2022-05-19
TRANSFER,538946,Aimé Pages,685560,146614,Tristan Bousquet-Gros,1249544,710598,2022-05-19
CASH_OUT,106014,Aimé Pages,146614,40600,Agence_moov_Ouidah,300000,193986,2022-05-19
TRANSFER,305573,Manon Lebon,991358,685785,Aimé Pages,40600,346173,2022-05-20
CASH_OUT,169315,Aimé Pages,346173,176858,Agence_moov_Cotonou,300000,130685,2022-05-21
CASH_OUT,40976,Aimé Pages,176858,135882,Agence_moov_Abomey,300000,259024,2022-05-21
CASH_OUT,46932,Aimé Pages,135882,88950,Agence_moov_Abomey,300000,253068,2022-05-22
TRANSFER,61798,Aimé Pages,88950,27152,Hélène Le Chauvin,15263,-46535,2022-05-23
TRANSFER,440596,Camille Prévost,482621,42025,Aimé Pages,27152,467748,2022-05-23
CASH_OUT,240112,Aimé Pages,467748,227636,Agence_moov_Cotonou,300000,59888,2022-05-24
CASH_OUT,104884,Aimé Pages,227636,122752,Agence_moov_Ouidah,300000,195116,2022-05-25
CASH_IN,29706,Agence_moov_Cotonou,300000,270294,Aimé Pages,122752,152458,2022-05-26
TRANSFER,993312,Léon Da Costa,1198328,205016,Aimé Pages,152458,1145770,2022-05-27
TRANSFER,77425,Aimé Pages,1145770,1068345,Marcelle-Valentine Guibert,1188400,1110975,2022-05-27
CASH_IN,99507,Agence_moov_Abomey,300000,200493,Jules-Roland Bousquet,-435491,-335984,2022-05-01
CASH_IN,123681,Agence_moov_Abomey,300000,176319,Jules-Roland Bousquet,-335984,-212303,2022-05-01
CASH_IN,120580,Agence_moov_Ouidah,300000,179420,Jules-Roland Bousquet,-212303,-91723,2022-05-02
CASH_IN,97110,Agence_moov_Cotonou,300000,202890,Jules-Roland Bousquet,-91723,5387,2022-05-02
CASH_IN,175663,Agence_moov_Abomey,300000,124337,Jules-Roland Bousquet,5387,181050,2022-05-04
TRANSFER,1170367,Thomas Guichard du Renault,1737584,567217,Jules-Roland Bousquet,181050,1351417,2022-05-04
CASH_IN,242616,Agence_moov_Abomey,300000,57384,Jules-Roland Bousquet,1351417,1594033,2022-05-04
TRANSFER,639298,Jules-Roland Bousquet,1594033,954735,Colette Merle Le Robert,1015100,375802,2022-05-04
CASH_OUT,192203,Jules-Roland Bousquet,954735,762532,Agence_moov_Cotonou,300000,107797,2022-05-08
CASH_IN,30443,Agence_moov_Abomey,300000,269557,Jules-Roland Bousquet,762532,792975,2022-05-08
CASH_OUT,397961,Jules-Roland Bousquet,792975,395014,Agence_moov_Cotonou,300000,-97961,2022-05-13
CASH_OUT,98627,Jules-Roland Bousquet,395014,296387,Agence_moov_Cotonou,300000,201373,2022-05-14
TRANSFER,202811,Jules-Roland Bousquet,296387,93576,Agnès Le Giraud,50579,-152232,2022-05-14
TRANSFER,257966,Adèle Da Silva-Klein,274877,16911,Jules-Roland Bousquet,93576,351542,2022-05-17
CASH_OUT,221189,Jules-Roland Bousquet,351542,130353,Agence_moov_Cotonou,300000,78811,2022-05-19
TRANSFER,27534,Manon Lebon,685785,658251,Jules-Roland Bousquet,130353,157887,2022-05-20
CASH_OUT,111785,Jules-Roland Bousquet,157887,46102,Agence_moov_Cotonou,300000,188215,2022-05-21
TRANSFER,897,Jules-Roland Bousquet,46102,45205,Gabriel Bègue,77427,76530,2022-05-22
CASH_OUT,17706,Jules-Roland Bousquet,45205,27499,Agence_moov_Ouidah,300000,282294,2022-05-23
CASH_OUT,20129,Jules-Roland Bousquet,27499,7370,Agence_moov_Abomey,300000,279871,2022-05-23
CASH_IN,130930,Agence_moov_Abomey,300000,169070,Jules-Roland Bousquet,7370,138300,2022-05-23
TRANSFER,23797,Jules-Roland Bousquet,138300,114503,Simone Muller de la Brun,72520,48723,2022-05-23
CASH_IN,115445,Agence_moov_Ouidah,300000,184555,Jules-Roland Bousquet,114503,229948,2022-05-25
TRANSFER,237719,Victor Michel,357500,119781,Jules-Roland Bousquet,229948,467667,2022-05-26
CASH_OUT,293209,Michelle-Dorothée Lévêque,294158,949,Agence_moov_Abomey,300000,6791,2022-05-01
CASH_OUT,606,Michelle-Dorothée Lévêque,949,343,Agence_moov_Cotonou,300000,299394,2022-05-01
CASH_IN,118115,Agence_moov_Abomey,300000,181885,Michelle-Dorothée Lévêque,343,118458,2022-05-02
CASH_OUT,93199,Michelle-Dorothée Lévêque,118458,25259,Agence_moov_Abomey,300000,206801,2022-05-02
CASH_IN,62893,Agence_moov_Ouidah,300000,237107,Michelle-Dorothée Lévêque,25259,88152,2022-05-05
CASH_IN,11848,Agence_moov_Cotonou,300000,288152,Michelle-Dorothée Lévêque,88152,100000,2022-05-06
TRANSFER,556926,Thomas de Blin,634895,77969,Michelle-Dorothée Lévêque,100000,656926,2022-05-07
CASH_OUT,135481,Michelle-Dorothée Lévêque,656926,521445,Agence_moov_Abomey,300000,164519,2022-05-08
TRANSFER,1091405,Rémy Grondin,1268500,177095,Michelle-Dorothée Lévêque,521445,1612850,2022-05-08
CASH_OUT,1285476,Michelle-Dorothée Lévêque,1612850,327374,Agence_moov_Abomey,300000,-985476,2022-05-11
TRANSFER,136506,Michelle-Dorothée Lévêque,327374,190868,Thibaut de la Roy,1324718,1188212,2022-05-15
TRANSFER,275765,André Renault,323552,47787,Michelle-Dorothée Lévêque,190868,466633,2022-05-15
TRANSFER,4317,Tristan Delahaye,42906,38589,Michelle-Dorothée Lévêque,466633,470950,2022-05-16
CASH_OUT,77442,Michelle-Dorothée Lévêque,470950,393508,Agence_moov_Cotonou,300000,222558,2022-05-17
CASH_OUT,51572,Michelle-Dorothée Lévêque,393508,341936,Agence_moov_Cotonou,300000,248428,2022-05-19
CASH_IN,184652,Agence_moov_Cotonou,300000,115348,Michelle-Dorothée Lévêque,341936,526588,2022-05-20
TRANSFER,457205,Michelle-Dorothée Lévêque,526588,69383,Thérèse Hubert,979678,522473,2022-05-21
CASH_IN,123631,Agence_moov_Cotonou,300000,176369,Michelle-Dorothée Lévêque,69383,193014,2022-05-22
CASH_IN,244271,Agence_moov_Ouidah,300000,55729,Michelle-Dorothée Lévêque,193014,437285,2022-05-23
CASH_IN,271851,Agence_moov_Ouidah,300000,28149,Michelle-Dorothée Lévêque,437285,709136,2022-05-24
TRANSFER,7137,Alix Barbe,268313,261176,Michelle-Dorothée Lévêque,709136,716273,2022-05-26
CASH_OUT,6896,Michelle-Dorothée Lévêque,716273,709377,Agence_moov_Abomey,300000,293104,2022-05-27
CASH_IN,240098,Agence_moov_Ouidah,300000,59902,Anastasie Richard-Neveu,981700,1221798,2022-05-01
CASH_OUT,1008422,Anastasie Richard-Neveu,1221798,213376,Agence_moov_Abomey,300000,-708422,2022-05-02
CASH_OUT,143259,Anastasie Richard-Neveu,213376,70117,Agence_moov_Abomey,300000,156741,2022-05-02
CASH_OUT,48431,Anastasie Richard-Neveu,70117,21686,Agence_moov_Cotonou,300000,251569,2022-05-05
CASH_OUT,2625,Anastasie Richard-Neveu,21686,19061,Agence_moov_Ouidah,300000,297375,2022-05-05
CASH_OUT,15212,Anastasie Richard-Neveu,19061,3849,Agence_moov_Abomey,300000,284788,2022-05-05
CASH_IN,145956,Agence_moov_Abomey,300000,154044,Anastasie Richard-Neveu,3849,149805,2022-05-06
CASH_IN,56795,Agence_moov_Cotonou,300000,243205,Anastasie Richard-Neveu,149805,206600,2022-05-07
CASH_OUT,154305,Anastasie Richard-Neveu,206600,52295,Agence_moov_Abomey,300000,145695,2022-05-07
TRANSFER,21636,Anastasie Richard-Neveu,52295,30659,Frédérique Fernandes du Bouchet,1638300,1616664,2022-05-08
TRANSFER,15142,Simone Muller de la Brun,48723,33581,Anastasie Richard-Neveu,30659,45801,2022-05-11
CASH_OUT,34990,Anastasie Richard-Neveu,45801,10811,Agence_moov_Ouidah,300000,265010,2022-05-11
CASH_OUT,4222,Anastasie Richard-Neveu,10811,6589,Agence_moov_Cotonou,300000,295778,2022-05-12
TRANSFER,116897,Tristan Bousquet-Gros,710598,593701,Anastasie Richard-Neveu,6589,123486,2022-05-13
CASH_IN,233017,Agence_moov_Ouidah,300000,66983,Anastasie Richard-Neveu,123486,356503,2022-05-14
CASH_IN,2141,Agence_moov_Ouidah,300000,297859,Anastasie Richard-Neveu,356503,358644,2022-05-15
CASH_OUT,96354,Anastasie Richard-Neveu,358644,262290,Agence_moov_Ouidah,300000,203646,2022-05-15
CASH_OUT,125247,Anastasie Richard-Neveu,262290,137043,Agence_moov_Abomey,300000,174753,2022-05-18
CASH_IN,230230,Agence_moov_Cotonou,300000,69770,Anastasie Richard-Neveu,137043,367273,2022-05-18
CASH_OUT,327306,Anastasie Richard-Neveu,367273,39967,Agence_moov_Abomey,300000,-27306,2022-05-19
CASH_IN,98818,Agence_moov_Ouidah,300000,201182,Anastasie Richard-Neveu,39967,138785,2022-05-21
TRANSFER,84432,Anastasie Richard-Neveu,138785,54353,Victor Michel,119781,35349,2022-05-24
CASH_OUT,1872,Anastasie Richard-Neveu,54353,52481,Agence_moov_Abomey,300000,298128,2022-05-26
CASH_IN,247603,Agence_moov_Cotonou,300000,52397,Anastasie Richard-Neveu,52481,300084,2022-05-27
TRANSFER,93718,Lucy Lamy,195226,101508,Anastasie Richard-Neveu,300084,393802,2022-05-27
CASH_IN,206440,Agence_moov_Cotonou,300000,93560,Benoît Guyot,1429000,1635440,2022-05-03
CASH_IN,9841,Agence_moov_Cotonou,300000,290159,Benoît Guyot,1635440,1645281,2022-05-04
CASH_IN,281273,Agence_moov_Cotonou,300000,18727,Benoît Guyot,1645281,1926554,2022-05-04
TRANSFER,1784706,Benoît Guyot,1926554,141848,Véronique Martins de Fleury,312746,-1471960,2022-05-04
CASH_IN,228724,Agence_moov_Cotonou,300000,71276,Benoît Guyot,141848,370572,2022-05-06
CASH_OUT,65575,Benoît Guyot,370572,304997,Agence_moov_Abomey,300000,234425,2022-05-08
CASH_IN,150394,Agence_moov_Abomey,300000,149606,Benoît Guyot,304997,455391,2022-05-08
CASH_IN,275807,Agence_moov_Ouidah,300000,24193,Benoît Guyot,455391,731198,2022-05-08
CASH_IN,54951,Agence_moov_Cotonou,300000,245049,Benoît Guyot,731198,786149,2022-05-09
TRANSFER,297341,Benoît Guyot,786149,488808,Renée Le Diaz,502222,204881,2022-05-09
CASH_OUT,448028,Benoît Guyot,488808,40780,Agence_moov_Abomey,300000,-148028,2022-05-09
CASH_OUT,1500,Benoît Guyot,40780,39280,Agence_moov_Cotonou,300000,298500,2022-05-10
CASH_OUT,28302,Benoît Guyot,39280,10978,Agence_moov_Ouidah,300000,271698,2022-05-10
CASH_IN,272174,Agence_moov_Ouidah,300000,27826,Benoît Guyot,10978,283152,2022-05-11
CASH_OUT,36771,Benoît Guyot,283152,246381,Agence_moov_Ouidah,300000,263229,2022-05-11
TRANSFER,244228,Benoît Guyot,246381,2153,Timothée-René Blanchard,215400,-28828,2022-05-12
CASH_OUT,1194,Benoît Guyot,2153,959,Agence_moov_Ouidah,300000,298806,2022-05-13
CASH_OUT,171,Benoît Guyot,959,788,Agence_moov_Cotonou,300000,299829,2022-05-15
TRANSFER,348,Benoît Guyot,788,440,Rémy Grondin,177095,176747,2022-05-16
TRANSFER,593913,Sabine Pineau,986470,392557,Benoît Guyot,440,594353,2022-05-17
TRANSFER,535590,Benoît Guyot,594353,58763,Gérard de la Martinez,652490,116900,2022-05-18
CASH_IN,10202,Agence_moov_Cotonou,300000,289798,Benoît Guyot,58763,68965,2022-05-22
CASH_IN,203527,Agence_moov_Ouidah,300000,96473,Benoît Guyot,68965,272492,2022-05-22
CASH_OUT,90166,Benoît Guyot,272492,182326,Agence_moov_Abomey,300000,209834,2022-05-22
CASH_IN,111685,Agence_moov_Cotonou,300000,188315,Benoît Guyot,182326,294011,2022-05-25
TRANSFER,143076,Benoît Guyot,294011,150935,Marthe Gilles,385342,242266,2022-05-27
TRANSFER,290703,Thérèse Hubert,522473,231770,Benoît Guyot,150935,441638,2022-05-27
TRANSFER,2910,Tristan Delahaye,38589,35679,Michelle de Étienne,622500,619590,2022-05-01
TRANSFER,507315,Frédéric Guillou,541300,33985,Tristan Delahaye,35679,542994,2022-05-03
TRANSFER,134758,Noël Bourgeois,177817,43059,Tristan Delahaye,542994,677752,2022-05-03
TRANSFER,357445,Christine Texier,1988222,1630777,Tristan Delahaye,677752,1035197,2022-05-03
TRANSFER,3231,Audrey Julien de Leleu,14188,10957,Tristan Delahaye,1035197,1038428,2022-05-03
CASH_IN,80927,Agence_moov_Cotonou,300000,219073,Tristan Delahaye,1038428,1119355,2022-05-04
CASH_OUT,1060317,Tristan Delahaye,1119355,59038,Agence_moov_Abomey,300000,-760317,2022-05-06
CASH_OUT,54353,Tristan Delahaye,59038,4685,Agence_moov_Cotonou,300000,245647,2022-05-06
TRANSFER,2242,Tristan Delahaye,4685,2443,Paul Perez,757624,755382,2022-05-07
TRANSFER,431,Tristan Delahaye,2443,2012,Audrey Julien de Leleu,10957,10526,2022-05-08
CASH_IN,131268,Agence_moov_Abomey,300000,168732,Tristan Delahaye,2012,133280,2022-05-09
CASH_OUT,86038,Tristan Delahaye,133280,47242,Agence_moov_Cotonou,300000,213962,2022-05-12
CASH_IN,173997,Agence_moov_Abomey,300000,126003,Tristan Delahaye,47242,221239,2022-05-14
TRANSFER,182810,Tristan Delahaye,221239,38429,Bertrand Regnier,294616,111806,2022-05-14
CASH_IN,76372,Agence_moov_Cotonou,300000,223628,Tristan Delahaye,38429,114801,2022-05-16
CASH_IN,216028,Agence_moov_Ouidah,300000,83972,Tristan Delahaye,114801,330829,2022-05-17
CASH_OUT,52551,Tristan Delahaye,330829,278278,Agence_moov_Cotonou,300000,247449,2022-05-18
CASH_IN,19155,Agence_moov_Cotonou,300000,280845,Tristan Delahaye,278278,297433,2022-05-18
CASH_IN,266832,Agence_moov_Abomey,300000,33168,Tristan Delahaye,297433,564265,2022-05-21
TRANSFER,396340,Tristan Delahaye,564265,167925,Renée Le Diaz,204881,-191459,2022-05-21
CASH_IN,74287,Agence_moov_Cotonou,300000,225713,Tristan Delahaye,167925,242212,2022-05-21
CASH_IN,291096,Agence_moov_Cotonou,300000,8904,Tristan Delahaye,242212,533308,2022-05-22
CASH_IN,48827,Agence_moov_Abomey,300000,251173,Tristan Delahaye,533308,582135,2022-05-22
TRANSFER,139120,Tristan Delahaye,582135,443015,Marcelle-Valentine Guibert,1110975,971855,2022-05-23
CASH_OUT,351591,Tristan Delahaye,443015,91424,Agence_moov_Cotonou,300000,-51591,2022-05-23
CASH_OUT,42222,Tristan Delahaye,91424,49202,Agence_moov_Cotonou,300000,257778,2022-05-24
TRANSFER,10064,Tristan Delahaye,49202,39138,Thomas de Blin,77969,67905,2022-05-25
TRANSFER,7619,Tristan Delahaye,39138,31519,Michelle Samson,78417,70798,2022-05-27
CASH_IN,218272,Agence_moov_Cotonou,300000,81728,Alphonse Gomes,263613,481885,2022-05-01
TRANSFER,967817,Jules Fernandes,1684398,716581,Alphonse Gomes,481885,1449702,2022-05-02
TRANSFER,480418,Alphonse Gomes,1449702,969284,Émilie du Allain,1474500,994082,2022-05-03
TRANSFER,14570,Adèle Da Silva-Klein,16911,2341,Alphonse Gomes,969284,983854,2022-05-04
CASH_OUT,281756,Alphonse Gomes,983854,702098,Agence_moov_Abomey,300000,18244,2022-05-05
TRANSFER,256674,Alphonse Gomes,702098,445424,Christine Texier,1630777,1374103,2022-05-05
CASH_OUT,320319,Alphonse Gomes,445424,125105,Agence_moov_Abomey,300000,-20319,2022-05-06
CASH_IN,240506,Agence_moov_Ouidah,300000,59494,Alphonse Gomes,125105,365611,2022-05-10
TRANSFER,31824,Thomas de Blin,67905,36081,Alphonse Gomes,365611,397435,2022-05-11
CASH_IN,16176,Agence_moov_Ouidah,300000,283824,Alphonse Gomes,397435,413611,2022-05-11
CASH_OUT,320637,Alphonse Gomes,413611,92974,Agence_moov_Cotonou,300000,-20637,2022-05-12
TRANSFER,21488,Anne Peltier-Raynaud,512350,490862,Alphonse Gomes,92974,114462,2022-05-13
CASH_IN,3934,Agence_moov_Ouidah,300000,296066,Alphonse Gomes,114462,118396,2022-05-13
TRANSFER,78500,Alphonse Gomes,118396,39896,Sabine Pineau,392557,314057,2022-05-16
TRANSFER,31667,Simone Muller de la Brun,33581,1914,Alphonse Gomes,39896,71563,2022-05-18
TRANSFER,22113,Alphonse Gomes,71563,49450,Lucy Lamy,101508,79395,2022-05-18
CASH_OUT,1437,Alphonse Gomes,49450,48013,Agence_moov_Cotonou,300000,298563,2022-05-20
CASH_OUT,16789,Alphonse Gomes,48013,31224,Agence_moov_Abomey,300000,283211,2022-05-20
CASH_IN,273678,Agence_moov_Cotonou,300000,26322,Alphonse Gomes,31224,304902,2022-05-22
CASH_OUT,147686,Alphonse Gomes,304902,157216,Agence_moov_Ouidah,300000,152314,2022-05-23
CASH_OUT,144690,Alphonse Gomes,157216,12526,Agence_moov_Abomey,300000,155310,2022-05-25
CASH_OUT,11223,Alphonse Gomes,12526,1303,Agence_moov_Cotonou,300000,288777,2022-05-25
CASH_IN,160134,Agence_moov_Ouidah,300000,139866,Alphonse Gomes,1303,161437,2022-05-27
TRANSFER,27406,Alphonse Gomes,161437,134031,Virginie Bouvet,1533865,1506459,2022-05-27
CASH_IN,210413,Agence_moov_Cotonou,300000,89587,Anne Peltier-Raynaud,490862,701275,2022-05-01
TRANSFER,44722,Marthe Gilles,242266,197544,Anne Peltier-Raynaud,701275,745997,2022-05-01
CASH_IN,113381,Agence_moov_Ouidah,300000,186619,Anne Peltier-Raynaud,745997,859378,2022-05-01
CASH_IN,39646,Agence_moov_Cotonou,300000,260354,Anne Peltier-Raynaud,859378,899024,2022-05-02
TRANSFER,418486,Anne Peltier-Raynaud,899024,480538,Frédérique Fernandes du Bouchet,1616664,1198178,2022-05-03
CASH_OUT,82381,Anne Peltier-Raynaud,480538,398157,Agence_moov_Abomey,300000,217619,2022-05-04
TRANSFER,1829,Simone Muller de la Brun,1914,85,Anne Peltier-Raynaud,398157,399986,2022-05-04
CASH_OUT,173096,Anne Peltier-Raynaud,399986,226890,Agence_moov_Cotonou,300000,126904,2022-05-04
CASH_OUT,221587,Anne Peltier-Raynaud,226890,5303,Agence_moov_Cotonou,300000,78413,2022-05-04
CASH_IN,69608,Agence_moov_Abomey,300000,230392,Anne Peltier-Raynaud,5303,74911,2022-05-06
TRANSFER,53631,Anne Peltier-Raynaud,74911,21280,Noël Bourgeois,43059,-10572,2022-05-08
CASH_OUT,16471,Anne Peltier-Raynaud,21280,4809,Agence_moov_Cotonou,300000,283529,2022-05-08
CASH_IN,80810,Agence_moov_Cotonou,300000,219190,Anne Peltier-Raynaud,4809,85619,2022-05-09
CASH_IN,53868,Agence_moov_Cotonou,300000,246132,Anne Peltier-Raynaud,85619,139487,2022-05-10
TRANSFER,115250,Anne Peltier-Raynaud,139487,24237,Alix Barbe,261176,145926,2022-05-10
CASH_OUT,7169,Anne Peltier-Raynaud,24237,17068,Agence_moov_Abomey,300000,292831,2022-05-12
CASH_OUT,2239,Anne Peltier-Raynaud,17068,14829,Agence_moov_Ouidah,300000,297761,2022-05-13
TRANSFER,7332,Anne Peltier-Raynaud,14829,7497,Richard Le Lévêque,305313,297981,2022-05-14
TRANSFER,3361,Anne Peltier-Raynaud,7497,4136,Bertrand Regnier,111806,108445,2022-05-14
CASH_IN,241007,Agence_moov_Ouidah,300000,58993,Anne Peltier-Raynaud,4136,245143,2022-05-14
TRANSFER,109689,Anne Peltier-Raynaud,245143,135454,Robert Laroche,535885,426196,2022-05-16
CASH_OUT,34054,Anne Peltier-Raynaud,135454,101400,Agence_moov_Abomey,300000,265946,2022-05-17
CASH_IN,102071,Agence_moov_Cotonou,300000,197929,Anne Peltier-Raynaud,101400,203471,2022-05-20
TRANSFER,202174,Anne Peltier-Raynaud,203471,1297,Tristan Bousquet-Gros,593701,391527,2022-05-22
TRANSFER,970,Anne Peltier-Raynaud,1297,327,Tristan Bousquet-Gros,391527,390557,2022-05-24
CASH_OUT,253,Anne Peltier-Raynaud,327,74,Agence_moov_Abomey,300000,299747,2022-05-24
TRANSFER,24329,Marthe Gilles,197544,173215,Michelle de Étienne,619590,643919,2022-05-01
CASH_OUT,60244,Michelle de Étienne,643919,583675,Agence_moov_Abomey,300000,239756,2022-05-02
TRANSFER,25254,Michelle de Étienne,583675,558421,Marthe Gilles,173215,147961,2022-05-02
TRANSFER,1143617,Frédérique Fernandes du Bouchet,1198178,54561,Michelle de Étienne,558421,1702038,2022-05-03
CASH_IN,170759,Agence_moov_Cotonou,300000,129241,Michelle de Étienne,1702038,1872797,2022-05-03
CASH_IN,149836,Agence_moov_Cotonou,300000,150164,Michelle de Étienne,1872797,2022633,2022-05-04
CASH_OUT,677173,Michelle de Étienne,2022633,1345460,Agence_moov_Cotonou,300000,-377173,2022-05-07
CASH_OUT,1056854,Michelle de Étienne,1345460,288606,Agence_moov_Abomey,300000,-756854,2022-05-07
TRANSFER,218312,Michelle de Étienne,288606,70294,Gabriel Bègue,76530,-141782,2022-05-07
CASH_IN,57877,Agence_moov_Cotonou,300000,242123,Michelle de Étienne,70294,128171,2022-05-08
TRANSFER,87369,Michelle de Étienne,128171,40802,Christine Texier,1374103,1286734,2022-05-08
TRANSFER,13988,Antoinette de Dupuis,182806,168818,Michelle de Étienne,40802,54790,2022-05-11
TRANSFER,40222,Rémy Grondin,176747,136525,Michelle de Étienne,54790,95012,2022-05-12
CASH_OUT,92740,Michelle de Étienne,95012,2272,Agence_moov_Abomey,300000,207260,2022-05-13
CASH_OUT,1438,Michelle de Étienne,2272,834,Agence_moov_Cotonou,300000,298562,2022-05-14
CASH_IN,92384,Agence_moov_Abomey,300000,207616,Michelle de Étienne,834,93218,2022-05-14
TRANSFER,777458,Christine Texier,1286734,509276,Michelle de Étienne,93218,870676,2022-05-14
TRANSFER,266427,Michelle de Étienne,870676,604249,Michelle de Étienne,870676,1137103,2022-05-15
TRANSFER,10772,André Renault,47787,37015,Michelle de Étienne,604249,615021,2022-05-16
CASH_OUT,33157,Michelle de Étienne,615021,581864,Agence_moov_Abomey,300000,266843,2022-05-19
TRANSFER,272136,Richard Le Lévêque,297981,25845,Michelle de Étienne,581864,854000,2022-05-20
CASH_OUT,579474,Michelle de Étienne,854000,274526,Agence_moov_Cotonou,300000,-279474,2022-05-21
CASH_OUT,265664,Michelle de Étienne,274526,8862,Agence_moov_Ouidah,300000,34336,2022-05-21
TRANSFER,328162,Manon Lebon,658251,330089,Michelle de Étienne,8862,337024,2022-05-22
CASH_IN,145760,Agence_moov_Cotonou,300000,154240,Michelle de Étienne,337024,482784,2022-05-23
CASH_IN,256668,Agence_moov_Ouidah,300000,43332,Michelle de Étienne,482784,739452,2022-05-24
CASH_IN,80891,Agence_moov_Ouidah,300000,219109,Michelle de Étienne,739452,820343,2022-05-25
TRANSFER,83331,Jules Fernandes,716581,633250,Marthe Gilles,147961,231292,2022-05-02
CASH_IN,103748,Agence_moov_Cotonou,300000,196252,Marthe Gilles,231292,335040,2022-05-03
CASH_IN,171308,Agence_moov_Cotonou,300000,128692,Marthe Gilles,335040,506348,2022-05-03
TRANSFER,229565,Sabine Pineau,314057,84492,Marthe Gilles,506348,735913,2022-05-06
CASH_IN,199003,Agence_moov_Ouidah,300000,100997,Marthe Gilles,735913,934916,2022-05-06
CASH_OUT,772294,Marthe Gilles,934916,162622,Agence_moov_Cotonou,300000,-472294,2022-05-07
TRANSFER,2285,Marthe Gilles,162622,160337,Thomas de Blin,36081,33796,2022-05-07
CASH_IN,226303,Agence_moov_Ouidah,300000,73697,Marthe Gilles,160337,386640,2022-05-07
CASH_OUT,247561,Marthe Gilles,386640,139079,Agence_moov_Cotonou,300000,52439,2022-05-08
TRANSFER,82032,Marthe Gilles,139079,57047,Tristan Bousquet-Gros,390557,308525,2022-05-08
CASH_IN,35291,Agence_moov_Cotonou,300000,264709,Marthe Gilles,57047,92338,2022-05-08
TRANSFER,85315,Marthe Gilles,92338,7023,Camille Prévost,42025,-43290,2022-05-09
CASH_IN,28367,Agence_moov_Ouidah,300000,271633,Marthe Gilles,7023,35390,2022-05-10
CASH_IN,290130,Agence_moov_Abomey,300000,9870,Marthe Gilles,35390,325520,2022-05-11
CASH_IN,279938,Agence_moov_Ouidah,300000,20062,Marthe Gilles,325520,605458,2022-05-12
TRANSFER,605442,Marthe Gilles,605458,16,Manon Lebon,330089,-275353,2022-05-12
CASH_IN,10894,Agence_moov_Ouidah,300000,289106,Marthe Gilles,16,10910,2022-05-13
CASH_OUT,7764,Marthe Gilles,10910,3146,Agence_moov_Abomey,300000,292236,2022-05-15
CASH_IN,9241,Agence_moov_Ouidah,300000,290759,Marthe Gilles,3146,12387,2022-05-16
TRANSFER,6451,Marthe Gilles,12387,5936,Antoinette de Dupuis,168818,162367,2022-05-20
TRANSFER,1898,Marthe Gilles,5936,4038,Frédéric Guillou,33985,32087,2022-05-22
TRANSFER,2012,Marthe Gilles,4038,2026,Alix Barbe,145926,143914,2022-05-22
TRANSFER,1774,Marthe Gilles,2026,252,Bertrand Regnier,108445,106671,2022-05-23
CASH_OUT,173,Marthe Gilles,252,79,Agence_moov_Ouidah,300000,299827,2022-05-23
CASH_IN,150569,Agence_moov_Abomey,300000,149431,Marthe Gilles,79,150648,2022-05-23
TRANSFER,47531,Tristan Bousquet-Gros,308525,260994,Colette Merle Le Robert,375802,328271,2022-05-01
CASH_OUT,241136,Tristan Bousquet-Gros,260994,19858,Agence_moov_Abomey,300000,58864,2022-05-02
TRANSFER,5042,Tristan Bousquet-Gros,19858,14816,Robert Laroche,426196,421154,2022-05-05
CASH_IN,59919,Agence_moov_Abomey,300000,240081,Tristan Bousquet-Gros,14816,74735,2022-05-05
CASH_IN,157838,Agence_moov_Abomey,300000,142162,Tristan Bousquet-Gros,74735,232573,2022-05-08
CASH_OUT,133291,Tristan Bousquet-Gros,232573,99282,Agence_moov_Abomey,300000,166709,2022-05-09
TRANSFER,74602,Alix Barbe,143914,69312,Tristan Bousquet-Gros,99282,173884,2022-05-11
CASH_OUT,139480,Tristan Bousquet-Gros,173884,34404,Agence_moov_Abomey,300000,160520,2022-05-12
TRANSFER,13414,Tristan Bousquet-Gros,34404,20990,Anastasie Cousin,1802500,1789086,2022-05-13
CASH_OUT,3789,Tristan Bousquet-Gros,20990,17201,Agence_moov_Cotonou,300000,296211,2022-05-14
TRANSFER,10577,Tristan Bousquet-Gros,17201,6624,Rémy Grondin,136525,125948,2022-05-14
TRANSFER,24207,Antoinette de Dupuis,162367,138160,Tristan Bousquet-Gros,6624,30831,2022-05-15
TRANSFER,2213,Tristan Bousquet-Gros,30831,28618,Frédérique Fernandes du Bouchet,54561,52348,2022-05-18
TRANSFER,20550,Tristan Bousquet-Gros,28618,8068,Rémy Grondin,125948,105398,2022-05-19
TRANSFER,1334,Thomas de Blin,33796,32462,Tristan Bousquet-Gros,8068,9402,2022-05-21
TRANSFER,1091,Tristan Bousquet-Gros,9402,8311,Lucy Lamy,79395,78304,2022-05-24
CASH_OUT,2956,Tristan Bousquet-Gros,8311,5355,Agence_moov_Ouidah,300000,297044,2022-05-25
TRANSFER,427837,Bernadette de Jourdan,1002348,574511,Tristan Bousquet-Gros,5355,433192,2022-05-25
TRANSFER,198336,Tristan Bousquet-Gros,433192,234856,Émilie du Allain,994082,795746,2022-05-25
CASH_OUT,185395,Tristan Bousquet-Gros,234856,49461,Agence_moov_Abomey,300000,114605,2022-05-26
TRANSFER,226812,Luc Lévêque-Carre,527606,300794,Tristan Bousquet-Gros,49461,276273,2022-05-26
CASH_IN,103703,Agence_moov_Cotonou,300000,196297,Christine Texier,509276,612979,2022-05-01
TRANSFER,410087,Christine Texier,612979,202892,Marc Leleu,122869,-287218,2022-05-01
CASH_OUT,141752,Christine Texier,202892,61140,Agence_moov_Abomey,300000,158248,2022-05-01
CASH_IN,276157,Agence_moov_Ouidah,300000,23843,Christine Texier,61140,337297,2022-05-02
CASH_OUT,299878,Christine Texier,337297,37419,Agence_moov_Abomey,300000,122,2022-05-02
CASH_IN,217217,Agence_moov_Cotonou,300000,82783,Christine Texier,37419,254636,2022-05-03
TRANSFER,57453,Michelle Samson,70798,13345,Christine Texier,254636,312089,2022-05-03
TRANSFER,156096,Christine Texier,312089,155993,Michelle Samson,13345,-142751,2022-05-04
CASH_IN,166010,Agence_moov_Cotonou,300000,133990,Christine Texier,155993,322003,2022-05-04
CASH_OUT,61235,Christine Texier,322003,260768,Agence_moov_Ouidah,300000,238765,2022-05-07
TRANSFER,234030,Christine Texier,260768,26738,Sabine Pineau,84492,-149538,2022-05-07
CASH_OUT,22382,Christine Texier,26738,4356,Agence_moov_Cotonou,300000,277618,2022-05-07
TRANSFER,484631,Jules Fernandes,633250,148619,Christine Texier,4356,488987,2022-05-09
TRANSFER,284601,Luc Lévêque-Carre,300794,16193,Christine Texier,488987,773588,2022-05-13
TRANSFER,640269,Françoise Morin,1435757,795488,Christine Texier,773588,1413857,2022-05-14
CASH_OUT,322510,Christine Texier,1413857,1091347,Agence_moov_Abomey,300000,-22510,2022-05-15
CASH_IN,68191,Agence_moov_Abomey,300000,231809,Christine Texier,1091347,1159538,2022-05-17
TRANSFER,1048857,Christine Texier,1159538,110681,Frédéric Guillou,32087,-1016770,2022-05-18
CASH_OUT,34340,Christine Texier,110681,76341,Agence_moov_Cotonou,300000,265660,2022-05-19
CASH_OUT,3361,Christine Texier,76341,72980,Agence_moov_Abomey,300000,296639,2022-05-21
CASH_OUT,29103,Christine Texier,72980,43877,Agence_moov_Ouidah,300000,270897,2022-05-22
TRANSFER,3662,André Renault,37015,33353,Christine Texier,43877,47539,2022-05-23
TRANSFER,26363,Christine Texier,47539,21176,Françoise Morin,795488,769125,2022-05-24
TRANSFER,510176,Anastasie Cousin,1789086,1278910,Christine Texier,21176,531352,2022-05-26
CASH_OUT,451151,Christine Texier,531352,80201,Agence_moov_Cotonou,300000,-151151,2022-05-27
CASH_IN,16289,Agence_moov_Ouidah,300000,283711,Alix Barbe,69312,85601,2022-05-03
CASH_IN,138704,Agence_moov_Cotonou,300000,161296,Alix Barbe,85601,224305,2022-05-04
TRANSFER,6569,Alix Barbe,224305,217736,Céline Collin-Hervé,53819,47250,2022-05-06
TRANSFER,186583,Thérèse Hubert,231770,45187,Alix Barbe,217736,404319,2022-05-07
CASH_IN,149700,Agence_moov_Ouidah,300000,150300,Alix Barbe,404319,554019,2022-05-09
CASH_IN,88072,Agence_moov_Ouidah,300000,211928,Alix Barbe,554019,642091,2022-05-15
CASH_OUT,50674,Alix Barbe,642091,591417,Agence_moov_Cotonou,300000,249326,2022-05-16
CASH_IN,110905,Agence_moov_Cotonou,300000,189095,Alix Barbe,591417,702322,2022-05-17
CASH_OUT,177486,Alix Barbe,702322,524836,Agence_moov_Abomey,300000,122514,2022-05-22
TRANSFER,137392,Alix Barbe,524836,387444,Lucy Lamy,78304,-59088,2022-05-24
CASH_IN,253440,Agence_moov_Abomey,300000,46560,Alix Barbe,387444,640884,2022-05-27
CASH_IN,286484,Agence_moov_Ouidah,300000,13516,Clémence-Véronique Munoz,46,286530,2022-05-01
TRANSFER,49829,Clémence-Véronique Munoz,286530,236701,Gérard de la Martinez,116900,67071,2022-05-01
CASH_OUT,213483,Clémence-Véronique Munoz,236701,23218,Agence_moov_Cotonou,300000,86517,2022-05-03
CASH_OUT,18292,Clémence-Véronique Munoz,23218,4926,Agence_moov_Abomey,300000,281708,2022-05-06
CASH_IN,275041,Agence_moov_Abomey,300000,24959,Clémence-Véronique Munoz,4926,279967,2022-05-09
CASH_OUT,84522,Clémence-Véronique Munoz,279967,195445,Agence_moov_Abomey,300000,215478,2022-05-12
TRANSFER,488304,Paul Perez,755382,267078,Clémence-Véronique Munoz,195445,683749,2022-05-13
CASH_OUT,398085,Clémence-Véronique Munoz,683749,285664,Agence_moov_Cotonou,300000,-98085,2022-05-14
CASH_OUT,217211,Clémence-Véronique Munoz,285664,68453,Agence_moov_Abomey,300000,82789,2022-05-15
CASH_OUT,27903,Clémence-Véronique Munoz,68453,40550,Agence_moov_Abomey,300000,272097,2022-05-17
CASH_OUT,24433,Clémence-Véronique Munoz,40550,16117,Agence_moov_Abomey,300000,275567,2022-05-18
CASH_IN,214716,Agence_moov_Cotonou,300000,85284,Clémence-Véronique Munoz,16117,230833,2022-05-19
CASH_OUT,171526,Clémence-Véronique Munoz,230833,59307,Agence_moov_Ouidah,300000,128474,2022-05-21
CASH_OUT,31819,Clémence-Véronique Munoz,59307,27488,Agence_moov_Abomey,300000,268181,2022-05-26
CASH_OUT,90302,Jules Fernandes,148619,58317,Agence_moov_Cotonou,300000,209698,2022-05-01
CASH_IN,124360,Agence_moov_Ouidah,300000,175640,Jules Fernandes,58317,182677,2022-05-01
TRANSFER,25065,Richard Le Lévêque,25845,780,Jules Fernandes,182677,207742,2022-05-03
TRANSFER,187613,Bernadette de Jourdan,574511,386898,Jules Fernandes,207742,395355,2022-05-04
CASH_OUT,255031,Jules Fernandes,395355,140324,Agence_moov_Abomey,300000,44969,2022-05-04
CASH_OUT,46630,Jules Fernandes,140324,93694,Agence_moov_Abomey,300000,253370,2022-05-04
TRANSFER,10667,Frédérique Fernandes du Bouchet,52348,41681,Jules Fernandes,93694,104361,2022-05-06
CASH_OUT,76568,Jules Fernandes,104361,27793,Agence_moov_Cotonou,300000,223432,2022-05-12
CASH_OUT,18204,Jules Fernandes,27793,9589,Agence_moov_Cotonou,300000,281796,2022-05-15
CASH_IN,177385,Agence_moov_Ouidah,300000,122615,Jules Fernandes,9589,186974,2022-05-16
CASH_IN,73073,Agence_moov_Abomey,300000,226927,Jules Fernandes,186974,260047,2022-05-18
CASH_IN,277480,Agence_moov_Abomey,300000,22520,Jules Fernandes,260047,537527,2022-05-19
CASH_OUT,52462,Jules Fernandes,537527,485065,Agence_moov_Abomey,300000,247538,2022-05-19
CASH_OUT,228832,Jules Fernandes,485065,256233,Agence_moov_Cotonou,300000,71168,2022-05-23
TRANSFER,473,Thomas Guichard du Renault,567217,566744,Jules Fernandes,256233,256706,2022-05-23
CASH_OUT,163511,Jules Fernandes,256706,93195,Agence_moov_Cotonou,300000,136489,2022-05-24
CASH_OUT,7060,Jules Fernandes,93195,86135,Agence_moov_Abomey,300000,292940,2022-05-27
CASH_IN,197470,Agence_moov_Ouidah,300000,102530,Marc Leleu,-287218,-89748,2022-05-02
CASH_IN,205572,Agence_moov_Ouidah,300000,94428,Marc Leleu,-89748,115824,2022-05-03
CASH_IN,212552,Agence_moov_Cotonou,300000,87448,Marc Leleu,115824,328376,2022-05-04
CASH_IN,45649,Agence_moov_Abomey,300000,254351,Marc Leleu,328376,374025,2022-05-05
CASH_IN,225463,Agence_moov_Cotonou,300000,74537,Marc Leleu,374025,599488,2022-05-05
CASH_IN,252463,Agence_moov_Cotonou,300000,47537,Marc Leleu,599488,851951,2022-05-05
CASH_IN,42802,Agence_moov_Ouidah,300000,257198,Marc Leleu,851951,894753,2022-05-08
CASH_IN,67315,Agence_moov_Abomey,300000,232685,Marc Leleu,894753,962068,2022-05-09
CASH_OUT,727183,Marc Leleu,962068,234885,Agence_moov_Cotonou,300000,-427183,2022-05-11
CASH_OUT,196928,Marc Leleu,234885,37957,Agence_moov_Cotonou,300000,103072,2022-05-13
TRANSFER,27410,Marc Leleu,37957,10547,Françoise Morin,769125,741715,2022-05-16
CASH_OUT,4645,Marc Leleu,10547,5902,Agence_moov_Cotonou,300000,295355,2022-05-17
CASH_OUT,3553,Marc Leleu,5902,2349,Agence_moov_Cotonou,300000,296447,2022-05-17
TRANSFER,24919,Victor Michel,35349,10430,Marc Leleu,2349,27268,2022-05-18
CASH_OUT,14498,Marc Leleu,27268,12770,Agence_moov_Cotonou,300000,285502,2022-05-19
TRANSFER,8833,Marc Leleu,12770,3937,Colette Merle Le Robert,328271,319438,2022-05-19
CASH_IN,80835,Agence_moov_Abomey,300000,219165,Marc Leleu,3937,84772,2022-05-21
CASH_IN,197608,Agence_moov_Abomey,300000,102392,Marc Leleu,84772,282380,2022-05-22
CASH_IN,282519,Agence_moov_Ouidah,300000,17481,Marc Leleu,282380,564899,2022-05-27
TRANSFER,82091,Rémy Grondin,105398,23307,Paul Perez,267078,184987,2022-05-05
CASH_IN,170142,Agence_moov_Cotonou,300000,129858,Rémy Grondin,23307,193449,2022-05-05
CASH_IN,127166,Agence_moov_Ouidah,300000,172834,Rémy Grondin,193449,320615,2022-05-08
CASH_IN,58848,Agence_moov_Abomey,300000,241152,Rémy Grondin,320615,379463,2022-05-09
CASH_IN,36859,Agence_moov_Ouidah,300000,263141,Rémy Grondin,379463,416322,2022-05-12
CASH_IN,193280,Agence_moov_Cotonou,300000,106720,Rémy Grondin,416322,609602,2022-05-13
TRANSFER,22578,Paul Perez,184987,162409,Rémy Grondin,609602,632180,2022-05-14
TRANSFER,165375,Rémy Grondin,632180,466805,Thérèse Hubert,45187,-120188,2022-05-23
CASH_IN,65500,Agence_moov_Ouidah,300000,234500,Timothée-René Blanchard,-28828,36672,2022-05-02
CASH_OUT,18154,Timothée-René Blanchard,36672,18518,Agence_moov_Cotonou,300000,281846,2022-05-03
CASH_IN,47213,Agence_moov_Cotonou,300000,252787,Timothée-René Blanchard,18518,65731,2022-05-05
CASH_OUT,38768,Timothée-René Blanchard,65731,26963,Agence_moov_Ouidah,300000,261232,2022-05-07
TRANSFER,10004,Timothée-René Blanchard,26963,16959,Colette Merle Le Robert,319438,309434,2022-05-08
TRANSFER,407335,Marcelle-Valentine Guibert,971855,564520,Timothée-René Blanchard,16959,424294,2022-05-08
CASH_OUT,211524,Timothée-René Blanchard,424294,212770,Agence_moov_Abomey,300000,88476,2022-05-08
TRANSFER,68373,Timothée-René Blanchard,212770,144397,Gérard de la Martinez,67071,-1302,2022-05-11
TRANSFER,132365,Timothée-René Blanchard,144397,12032,Timothée-René Blanchard,144397,276762,2022-05-13
TRANSFER,63696,Bernadette de Jourdan,386898,323202,Timothée-René Blanchard,12032,75728,2022-05-14
CASH_IN,69442,Agence_moov_Ouidah,300000,230558,Timothée-René Blanchard,75728,145170,2022-05-15
TRANSFER,109111,Bernadette de Jourdan,323202,214091,Timothée-René Blanchard,145170,254281,2022-05-19
CASH_IN,7507,Agence_moov_Cotonou,300000,292493,Timothée-René Blanchard,254281,261788,2022-05-21
CASH_OUT,190172,Timothée-René Blanchard,261788,71616,Agence_moov_Abomey,300000,109828,2022-05-23
CASH_IN,117445,Agence_moov_Abomey,300000,182555,Timothée-René Blanchard,71616,189061,2022-05-25
CASH_IN,235600,Agence_moov_Abomey,300000,64400,Colette Merle Le Robert,309434,545034,2022-05-02
TRANSFER,26980,Bertrand Regnier,106671,79691,Colette Merle Le Robert,545034,572014,2022-05-03
TRANSFER,358497,Françoise Morin,741715,383218,Colette Merle Le Robert,572014,930511,2022-05-04
CASH_IN,72292,Agence_moov_Cotonou,300000,227708,Colette Merle Le Robert,930511,1002803,2022-05-06
TRANSFER,524594,Colette Merle Le Robert,1002803,478209,Richard Le Lévêque,780,-523814,2022-05-09
TRANSFER,44840,Colette Merle Le Robert,478209,433369,André Renault,33353,-11487,2022-05-11
CASH_OUT,128888,Colette Merle Le Robert,433369,304481,Agence_moov_Ouidah,300000,171112,2022-05-12
CASH_IN,92161,Agence_moov_Cotonou,300000,207839,Colette Merle Le Robert,304481,396642,2022-05-13
TRANSFER,10421,Colette Merle Le Robert,396642,386221,Colette Merle Le Robert,396642,407063,2022-05-14
CASH_OUT,40407,Colette Merle Le Robert,386221,345814,Agence_moov_Abomey,300000,259593,2022-05-15
CASH_OUT,52481,Colette Merle Le Robert,345814,293333,Agence_moov_Cotonou,300000,247519,2022-05-16
TRANSFER,111755,Colette Merle Le Robert,293333,181578,Thibaut de la Roy,1188212,1076457,2022-05-17
CASH_IN,105037,Agence_moov_Cotonou,300000,194963,Colette Merle Le Robert,181578,286615,2022-05-17
TRANSFER,143223,Bernadette de Jourdan,214091,70868,Colette Merle Le Robert,286615,429838,2022-05-21
CASH_IN,257722,Agence_moov_Ouidah,300000,42278,Colette Merle Le Robert,429838,687560,2022-05-21
TRANSFER,435795,Colette Merle Le Robert,687560,251765,Virginie Bouvet,1506459,1070664,2022-05-24
CASH_IN,83854,Agence_moov_Abomey,300000,216146,Colette Merle Le Robert,251765,335619,2022-05-24
CASH_IN,71130,Agence_moov_Abomey,300000,228870,Colette Merle Le Robert,335619,406749,2022-05-25
CASH_IN,36068,Agence_moov_Cotonou,300000,263932,Colette Merle Le Robert,406749,442817,2022-05-27
CASH_IN,226287,Agence_moov_Abomey,300000,73713,André Renault,-11487,214800,2022-05-01
TRANSFER,4130,Audrey Julien de Leleu,10526,6396,André Renault,214800,218930,2022-05-02
CASH_IN,87076,Agence_moov_Cotonou,300000,212924,André Renault,218930,306006,2022-05-07
CASH_OUT,179188,André Renault,306006,126818,Agence_moov_Ouidah,300000,120812,2022-05-12
TRANSFER,388346,Marcelle-Valentine Guibert,564520,176174,André Renault,126818,515164,2022-05-12
TRANSFER,179,Bernadette de Jourdan,70868,70689,André Renault,515164,515343,2022-05-15
CASH_OUT,158353,André Renault,515343,356990,Agence_moov_Abomey,300000,141647,2022-05-18
CASH_OUT,292992,André Renault,356990,63998,Agence_moov_Cotonou,300000,7008,2022-05-19
CASH_OUT,19633,André Renault,63998,44365,Agence_moov_Ouidah,300000,280367,2022-05-24
TRANSFER,23097,André Renault,44365,21268,Thomas Guichard du Renault,566744,543647,2022-05-24
CASH_OUT,17758,André Renault,21268,3510,Agence_moov_Abomey,300000,282242,2022-05-25
TRANSFER,134800,Thomas Guichard du Renault,543647,408847,André Renault,3510,138310,2022-05-26
CASH_OUT,24972,André Renault,138310,113338,Agence_moov_Ouidah,300000,275028,2022-05-26
TRANSFER,8151,Victor Michel,10430,2279,Marcelle-Valentine Guibert,176174,168023,2022-05-07
CASH_OUT,853,Victor Michel,2279,1426,Agence_moov_Abomey,300000,299147,2022-05-12
TRANSFER,254285,Robert Laroche,421154,166869,Victor Michel,1426,255711,2022-05-13
CASH_OUT,234134,Victor Michel,255711,21577,Agence_moov_Abomey,300000,65866,2022-05-13
TRANSFER,17648,Victor Michel,21577,3929,Antoinette de Dupuis,138160,120512,2022-05-15
TRANSFER,33253,Bernadette de Jourdan,70689,37436,Victor Michel,3929,37182,2022-05-15
CASH_OUT,23798,Victor Michel,37182,13384,Agence_moov_Cotonou,300000,276202,2022-05-16
CASH_IN,198644,Agence_moov_Cotonou,300000,101356,Victor Michel,13384,212028,2022-05-17
TRANSFER,878776,Anastasie Cousin,1278910,400134,Victor Michel,212028,1090804,2022-05-20
TRANSFER,889040,Victor Michel,1090804,201764,Adèle Da Silva-Klein,2341,-886699,2022-05-23
CASH_OUT,143394,Victor Michel,201764,58370,Agence_moov_Ouidah,300000,156606,2022-05-27
TRANSFER,16885,Thomas de Blin,32462,15577,Victor Michel,58370,75255,2022-05-27
CASH_IN,175226,Agence_moov_Cotonou,300000,124774,Thomas-Robert Morvan,-113599,61627,2022-05-01
CASH_IN,76706,Agence_moov_Cotonou,300000,223294,Thomas-Robert Morvan,61627,138333,2022-05-07
CASH_IN,135855,Agence_moov_Abomey,300000,164145,Thomas-Robert Morvan,138333,274188,2022-05-07
CASH_OUT,216588,Thomas-Robert Morvan,274188,57600,Agence_moov_Cotonou,300000,83412,2022-05-09
CASH_IN,42435,Agence_moov_Cotonou,300000,257565,Thomas-Robert Morvan,57600,100035,2022-05-09
CASH_OUT,30330,Thomas-Robert Morvan,100035,69705,Agence_moov_Cotonou,300000,269670,2022-05-10
TRANSFER,36771,Bernadette de Jourdan,37436,665,Thomas-Robert Morvan,69705,106476,2022-05-13
TRANSFER,58050,Thomas-Robert Morvan,106476,48426,Thomas de Blin,15577,-42473,2022-05-13
CASH_OUT,13681,Thomas-Robert Morvan,48426,34745,Agence_moov_Abomey,300000,286319,2022-05-17
TRANSFER,8389,Thomas-Robert Morvan,34745,26356,Robert Laroche,166869,158480,2022-05-19
TRANSFER,442894,Thibaut de la Roy,1076457,633563,Thomas-Robert Morvan,26356,469250,2022-05-20
CASH_IN,167560,Agence_moov_Cotonou,300000,132440,Thomas-Robert Morvan,469250,636810,2022-05-21
TRANSFER,160813,Françoise Morin,383218,222405,Thomas-Robert Morvan,636810,797623,2022-05-22
CASH_OUT,39497,Thomas-Robert Morvan,797623,758126,Agence_moov_Ouidah,300000,260503,2022-05-26
CASH_OUT,711521,Thomas-Robert Morvan,758126,46605,Agence_moov_Cotonou,300000,-411521,2022-05-27
TRANSFER,218579,Françoise Morin,222405,3826,Thomas Guichard du Renault,408847,627426,2022-05-05
CASH_OUT,521437,Thomas Guichard du Renault,627426,105989,Agence_moov_Ouidah,300000,-221437,2022-05-07
CASH_OUT,53118,Thomas Guichard du Renault,105989,52871,Agence_moov_Ouidah,300000,246882,2022-05-15
TRANSFER,40385,Marcelle-Valentine Guibert,168023,127638,Thomas Guichard du Renault,52871,93256,2022-05-17
CASH_OUT,31628,Thomas Guichard du Renault,93256,61628,Agence_moov_Cotonou,300000,268372,2022-05-25
CASH_OUT,25853,Thomas Guichard du Renault,61628,35775,Agence_moov_Cotonou,300000,274147,2022-05-27
CASH_OUT,34984,Céline Collin-Hervé,47250,12266,Agence_moov_Cotonou,300000,265016,2022-05-02
CASH_IN,168131,Agence_moov_Ouidah,300000,131869,Céline Collin-Hervé,12266,180397,2022-05-04
CASH_IN,293296,Agence_moov_Ouidah,300000,6704,Céline Collin-Hervé,180397,473693,2022-05-06
TRANSFER,461329,Céline Collin-Hervé,473693,12364,Manon Valette,457894,-3435,2022-05-07
CASH_OUT,4309,Céline Collin-Hervé,12364,8055,Agence_moov_Abomey,300000,295691,2022-05-09
CASH_OUT,852,Céline Collin-Hervé,8055,7203,Agence_moov_Cotonou,300000,299148,2022-05-09
CASH_IN,139816,Agence_moov_Cotonou,300000,160184,Céline Collin-Hervé,7203,147019,2022-05-11
CASH_OUT,101068,Céline Collin-Hervé,147019,45951,Agence_moov_Cotonou,300000,198932,2022-05-13
CASH_OUT,16743,Céline Collin-Hervé,45951,29208,Agence_moov_Abomey,300000,283257,2022-05-13
CASH_IN,51707,Agence_moov_Ouidah,300000,248293,Céline Collin-Hervé,29208,80915,2022-05-19
TRANSFER,199585,Anastasie Cousin,400134,200549,Céline Collin-Hervé,80915,280500,2022-05-23
CASH_OUT,173129,Céline Collin-Hervé,280500,107371,Agence_moov_Abomey,300000,126871,2022-05-25
CASH_IN,203655,Agence_moov_Cotonou,300000,96345,Céline Collin-Hervé,107371,311026,2022-05-25
CASH_IN,107188,Agence_moov_Abomey,300000,192812,Céline Collin-Hervé,311026,418214,2022-05-25
CASH_IN,190176,Agence_moov_Ouidah,300000,109824,Robert-Louis Gosselin,-69099,121077,2022-05-06
TRANSFER,87589,Robert-Louis Gosselin,121077,33488,Robert-Louis Gosselin,121077,208666,2022-05-09
TRANSFER,12052,Robert-Louis Gosselin,33488,21436,Paul Perez,162409,150357,2022-05-16
TRANSFER,18708,Robert-Louis Gosselin,21436,2728,Robert-Louis Gosselin,21436,2728,2022-05-19
CASH_IN,190238,Agence_moov_Ouidah,300000,109762,Robert-Louis Gosselin,2728,192966,2022-05-20
CASH_OUT,188623,Robert-Louis Gosselin,192966,4343,Agence_moov_Ouidah,300000,111377,2022-05-21
CASH_IN,135119,Agence_moov_Ouidah,300000,164881,Robert-Louis Gosselin,4343,139462,2022-05-23
TRANSFER,107280,Antoinette de Dupuis,120512,13232,Bernadette de Jourdan,665,-106615,2022-05-03
CASH_OUT,3407,Antoinette de Dupuis,13232,9825,Agence_moov_Ouidah,300000,296593,2022-05-04
CASH_OUT,3393,Antoinette de Dupuis,9825,6432,Agence_moov_Ouidah,300000,296607,2022-05-05
CASH_IN,248353,Agence_moov_Abomey,300000,51647,Antoinette de Dupuis,6432,254785,2022-05-05
CASH_OUT,83302,Antoinette de Dupuis,254785,171483,Agence_moov_Cotonou,300000,216698,2022-05-07
TRANSFER,145136,Antoinette de Dupuis,171483,26347,Anastasie Cousin,200549,55413,2022-05-08
CASH_OUT,6936,Antoinette de Dupuis,26347,19411,Agence_moov_Ouidah,300000,293064,2022-05-11
CASH_IN,275125,Agence_moov_Ouidah,300000,24875,Antoinette de Dupuis,19411,294536,2022-05-14
TRANSFER,5391,Antoinette de Dupuis,294536,289145,Luc Lévêque-Carre,16193,10802,2022-05-15
CASH_IN,284407,Agence_moov_Abomey,300000,15593,Antoinette de Dupuis,289145,573552,2022-05-15
CASH_IN,101498,Agence_moov_Cotonou,300000,198502,Antoinette de Dupuis,573552,675050,2022-05-16
CASH_OUT,546921,Antoinette de Dupuis,675050,128129,Agence_moov_Cotonou,300000,-246921,2022-05-18
CASH_OUT,21186,Antoinette de Dupuis,128129,106943,Agence_moov_Cotonou,300000,278814,2022-05-20
TRANSFER,26051,Antoinette de Dupuis,106943,80892,Frédérique Fernandes du Bouchet,41681,15630,2022-05-21
CASH_IN,141519,Agence_moov_Abomey,300000,158481,Antoinette de Dupuis,80892,222411,2022-05-23
CASH_IN,295969,Agence_moov_Ouidah,300000,4031,Antoinette de Dupuis,222411,518380,2022-05-24
CASH_OUT,228522,Antoinette de Dupuis,518380,289858,Agence_moov_Ouidah,300000,71478,2022-05-27
CASH_OUT,3464,Antoinette de Dupuis,289858,286394,Agence_moov_Abomey,300000,296536,2022-05-27
CASH_OUT,236380,Antoinette de Dupuis,286394,50014,Agence_moov_Ouidah,300000,63620,2022-05-27
TRANSFER,406699,Virginie Bouvet,1070664,663965,Frédérique Fernandes du Bouchet,15630,422329,2022-05-03
CASH_IN,123144,Agence_moov_Ouidah,300000,176856,Frédérique Fernandes du Bouchet,422329,545473,2022-05-04
CASH_IN,120488,Agence_moov_Cotonou,300000,179512,Frédérique Fernandes du Bouchet,545473,665961,2022-05-04
CASH_OUT,449788,Frédérique Fernandes du Bouchet,665961,216173,Agence_moov_Abomey,300000,-149788,2022-05-05
TRANSFER,11245,Paul Perez,150357,139112,Frédérique Fernandes du Bouchet,216173,227418,2022-05-09
TRANSFER,406,Françoise Morin,3826,3420,Frédérique Fernandes du Bouchet,227418,227824,2022-05-10
CASH_IN,2077,Agence_moov_Ouidah,300000,297923,Frédérique Fernandes du Bouchet,227824,229901,2022-05-11
CASH_IN,104075,Agence_moov_Abomey,300000,195925,Frédérique Fernandes du Bouchet,229901,333976,2022-05-12
CASH_IN,169313,Agence_moov_Ouidah,300000,130687,Frédérique Fernandes du Bouchet,333976,503289,2022-05-26
CASH_IN,110221,Agence_moov_Ouidah,300000,189779,Hélène Le Chauvin,-46535,63686,2022-05-01
TRANSFER,14905,Hélène Le Chauvin,63686,48781,Anastasie Cousin,55413,40508,2022-05-01
TRANSFER,419298,Virginie Bouvet,663965,244667,Hélène Le Chauvin,48781,468079,2022-05-04
CASH_OUT,456023,Hélène Le Chauvin,468079,12056,Agence_moov_Cotonou,300000,-156023,2022-05-07
TRANSFER,3928,Hélène Le Chauvin,12056,8128,Marcelle-Valentine Guibert,127638,123710,2022-05-08
CASH_OUT,220,Hélène Le Chauvin,8128,7908,Agence_moov_Cotonou,300000,299780,2022-05-08
TRANSFER,3395,Hélène Le Chauvin,7908,4513,Thibaut de la Roy,633563,630168,2022-05-10
CASH_OUT,1398,Hélène Le Chauvin,4513,3115,Agence_moov_Abomey,300000,298602,2022-05-11
TRANSFER,1686,Hélène Le Chauvin,3115,1429,Luc Lévêque-Carre,10802,9116,2022-05-11
CASH_OUT,973,Hélène Le Chauvin,1429,456,Agence_moov_Ouidah,300000,299027,2022-05-12
CASH_IN,37280,Agence_moov_Ouidah,300000,262720,Hélène Le Chauvin,456,37736,2022-05-13
CASH_IN,188463,Agence_moov_Cotonou,300000,111537,Hélène Le Chauvin,37736,226199,2022-05-15
TRANSFER,240916,Virginie Bouvet,244667,3751,Hélène Le Chauvin,226199,467115,2022-05-19
CASH_OUT,441901,Hélène Le Chauvin,467115,25214,Agence_moov_Ouidah,300000,-141901,2022-05-22
CASH_IN,255940,Agence_moov_Cotonou,300000,44060,Hélène Le Chauvin,25214,281154,2022-05-23
TRANSFER,1212,Françoise Morin,3420,2208,Hélène Le Chauvin,281154,282366,2022-05-23
CASH_OUT,34018,Hélène Le Chauvin,282366,248348,Agence_moov_Cotonou,300000,265982,2022-05-23
CASH_IN,290863,Agence_moov_Cotonou,300000,9137,Hélène Le Chauvin,248348,539211,2022-05-25
TRANSFER,89143,Hélène Le Chauvin,539211,450068,Luc Lévêque-Carre,9116,-80027,2022-05-25
CASH_IN,232670,Agence_moov_Abomey,300000,67330,Stéphane Munoz,-1288440,-1055770,2022-05-02
CASH_IN,158998,Agence_moov_Abomey,300000,141002,Stéphane Munoz,-1055770,-896772,2022-05-02
CASH_IN,242614,Agence_moov_Cotonou,300000,57386,Stéphane Munoz,-896772,-654158,2022-05-04
CASH_IN,209124,Agence_moov_Abomey,300000,90876,Stéphane Munoz,-654158,-445034,2022-05-07
CASH_IN,297887,Agence_moov_Ouidah,300000,2113,Stéphane Munoz,-445034,-147147,2022-05-07
CASH_IN,223586,Agence_moov_Cotonou,300000,76414,Stéphane Munoz,-147147,76439,2022-05-12
CASH_IN,142927,Agence_moov_Ouidah,300000,157073,Stéphane Munoz,76439,219366,2022-05-12
CASH_IN,264376,Agence_moov_Abomey,300000,35624,Stéphane Munoz,219366,483742,2022-05-15
TRANSFER,110951,Stéphane Munoz,483742,372791,Françoise Morin,2208,-108743,2022-05-16
CASH_OUT,164982,Stéphane Munoz,372791,207809,Agence_moov_Abomey,300000,135018,2022-05-16
CASH_IN,250243,Agence_moov_Cotonou,300000,49757,Stéphane Munoz,207809,458052,2022-05-16
TRANSFER,27473,Marcelle-Valentine Guibert,123710,96237,Stéphane Munoz,458052,485525,2022-05-19
CASH_IN,140416,Agence_moov_Cotonou,300000,159584,Stéphane Munoz,485525,625941,2022-05-21
CASH_IN,37121,Agence_moov_Ouidah,300000,262879,Stéphane Munoz,625941,663062,2022-05-22
TRANSFER,192829,Stéphane Munoz,663062,470233,Léon Da Costa,205016,12187,2022-05-23
TRANSFER,74300,Marcelle-Valentine Guibert,96237,21937,Stéphane Munoz,470233,544533,2022-05-24
CASH_OUT,382770,Stéphane Munoz,544533,161763,Agence_moov_Abomey,300000,-82770,2022-05-25
TRANSFER,40510,Stéphane Munoz,161763,121253,Paul Perez,139112,98602,2022-05-26
TRANSFER,11449,Anastasie Cousin,40508,29059,Émilie du Allain,795746,807195,2022-05-01
CASH_IN,124044,Agence_moov_Abomey,300000,175956,Émilie du Allain,807195,931239,2022-05-04
CASH_IN,154371,Agence_moov_Cotonou,300000,145629,Émilie du Allain,931239,1085610,2022-05-06
TRANSFER,953831,Émilie du Allain,1085610,131779,Léon Da Costa,12187,-941644,2022-05-10
CASH_OUT,70975,Émilie du Allain,131779,60804,Agence_moov_Ouidah,300000,229025,2022-05-12
CASH_OUT,45291,Émilie du Allain,60804,15513,Agence_moov_Abomey,300000,254709,2022-05-13
TRANSFER,14013,Émilie du Allain,15513,1500,Virginie Bouvet,3751,-10262,2022-05-13
CASH_OUT,866,Émilie du Allain,1500,634,Agence_moov_Cotonou,300000,299134,2022-05-14
TRANSFER,320,Émilie du Allain,634,314,Thibaut de la Roy,630168,629848,2022-05-16
TRANSFER,314,Émilie du Allain,314,0,Audrey Julien de Leleu,6396,6082,2022-05-18
CASH_IN,139605,Agence_moov_Ouidah,300000,160395,Émilie du Allain,0,139605,2022-05-26
CASH_IN,260216,Agence_moov_Abomey,300000,39784,Simone Muller de la Brun,85,260301,2022-05-02
TRANSFER,176449,Simone Muller de la Brun,260301,83852,Thibaut de la Roy,629848,453399,2022-05-03
CASH_OUT,25994,Simone Muller de la Brun,83852,57858,Agence_moov_Abomey,300000,274006,2022-05-04
CASH_OUT,24971,Simone Muller de la Brun,57858,32887,Agence_moov_Cotonou,300000,275029,2022-05-08
CASH_OUT,10718,Simone Muller de la Brun,32887,22169,Agence_moov_Ouidah,300000,289282,2022-05-10
TRANSFER,7952,Simone Muller de la Brun,22169,14217,Simone Muller de la Brun,22169,30121,2022-05-11
TRANSFER,3091,Audrey Julien de Leleu,6082,2991,Simone Muller de la Brun,14217,17308,2022-05-15
CASH_OUT,7700,Simone Muller de la Brun,17308,9608,Agence_moov_Abomey,300000,292300,2022-05-20
CASH_OUT,8850,Simone Muller de la Brun,9608,758,Agence_moov_Ouidah,300000,291150,2022-05-21
TRANSFER,296,Simone Muller de la Brun,758,462,Paul Perez,98602,98306,2022-05-21
TRANSFER,28950,Anastasie Cousin,29059,109,Simone Muller de la Brun,462,29412,2022-05-23
CASH_IN,101061,Agence_moov_Ouidah,300000,198939,Simone Muller de la Brun,29412,130473,2022-05-24
CASH_IN,144393,Agence_moov_Abomey,300000,155607,Virginie Bouvet,-10262,134131,2022-05-01
TRANSFER,32740,Paul Perez,98306,65566,Virginie Bouvet,134131,166871,2022-05-01
TRANSFER,11738,Virginie Bouvet,166871,155133,Thibaut de la Roy,453399,441661,2022-05-05
CASH_IN,202655,Agence_moov_Abomey,300000,97345,Virginie Bouvet,155133,357788,2022-05-06
CASH_OUT,165166,Virginie Bouvet,357788,192622,Agence_moov_Ouidah,300000,134834,2022-05-11
CASH_IN,124864,Agence_moov_Abomey,300000,175136,Virginie Bouvet,192622,317486,2022-05-11
CASH_OUT,5374,Virginie Bouvet,317486,312112,Agence_moov_Abomey,300000,294626,2022-05-13
TRANSFER,77013,Virginie Bouvet,312112,235099,Thibaut de la Roy,441661,364648,2022-05-14
CASH_IN,36343,Agence_moov_Ouidah,300000,263657,Virginie Bouvet,235099,271442,2022-05-16
TRANSFER,190009,Virginie Bouvet,271442,81433,Audrey Julien de Leleu,2991,-187018,2022-05-16
CASH_OUT,61708,Virginie Bouvet,81433,19725,Agence_moov_Cotonou,300000,238292,2022-05-20
TRANSFER,2975,Virginie Bouvet,19725,16750,Virginie Bouvet,19725,22700,2022-05-22
TRANSFER,103,Anastasie Cousin,109,6,Virginie Bouvet,16750,16853,2022-05-22
TRANSFER,45833,Paul Perez,65566,19733,Virginie Bouvet,16853,62686,2022-05-23
TRANSFER,1272,Virginie Bouvet,62686,61414,Paul Perez,19733,18461,2022-05-23
TRANSFER,6851,Paul Perez,18461,11610,Virginie Bouvet,61414,68265,2022-05-24
CASH_IN,182307,Agence_moov_Ouidah,300000,117693,Virginie Bouvet,68265,250572,2022-05-24
TRANSFER,71239,Virginie Bouvet,250572,179333,Paul Perez,11610,-59629,2022-05-25
CASH_IN,229734,Agence_moov_Ouidah,300000,70266,Thomas de Blin,-42473,187261,2022-05-01
CASH_IN,31416,Agence_moov_Abomey,300000,268584,Thomas de Blin,187261,218677,2022-05-03
CASH_IN,93939,Agence_moov_Abomey,300000,206061,Thomas de Blin,218677,312616,2022-05-11
CASH_OUT,264168,Thomas de Blin,312616,48448,Agence_moov_Cotonou,300000,35832,2022-05-22
CASH_IN,119202,Agence_moov_Cotonou,300000,180798,Thomas de Blin,48448,167650,2022-05-23
CASH_IN,77331,Agence_moov_Abomey,300000,222669,Thomas de Blin,167650,244981,2022-05-27
CASH_IN,238607,Agence_moov_Cotonou,300000,61393,Renée Le Diaz,-191459,47148,2022-05-01
CASH_IN,8047,Agence_moov_Ouidah,300000,291953,Renée Le Diaz,47148,55195,2022-05-01
CASH_IN,293399,Agence_moov_Ouidah,300000,6601,Renée Le Diaz,55195,348594,2022-05-10
CASH_OUT,331723,Renée Le Diaz,348594,16871,Agence_moov_Cotonou,300000,-31723,2022-05-14
CASH_IN,79115,Agence_moov_Cotonou,300000,220885,Renée Le Diaz,16871,95986,2022-05-18
CASH_IN,153920,Agence_moov_Ouidah,300000,146080,Renée Le Diaz,95986,249906,2022-05-19
TRANSFER,71306,Renée Le Diaz,249906,178600,Renée Le Diaz,249906,321212,2022-05-24
CASH_IN,197269,Agence_moov_Abomey,300000,102731,Adèle Da Silva-Klein,-886699,-689430,2022-05-01
CASH_IN,259386,Agence_moov_Abomey,300000,40614,Adèle Da Silva-Klein,-689430,-430044,2022-05-01
CASH_IN,208717,Agence_moov_Abomey,300000,91283,Adèle Da Silva-Klein,-430044,-221327,2022-05-11
CASH_IN,156353,Agence_moov_Abomey,300000,143647,Adèle Da Silva-Klein,-221327,-64974,2022-05-16
CASH_IN,46445,Agence_moov_Abomey,300000,253555,Adèle Da Silva-Klein,-64974,-18529,2022-05-18
CASH_IN,183250,Agence_moov_Cotonou,300000,116750,Adèle Da Silva-Klein,-18529,164721,2022-05-22
CASH_OUT,67115,Adèle Da Silva-Klein,164721,97606,Agence_moov_Cotonou,300000,232885,2022-05-23
CASH_OUT,64339,Adèle Da Silva-Klein,97606,33267,Agence_moov_Ouidah,300000,235661,2022-05-26
CASH_IN,275118,Agence_moov_Ouidah,300000,24882,Camille Prévost,-43290,231828,2022-05-03
TRANSFER,227022,Camille Prévost,231828,4806,Camille Prévost,231828,458850,2022-05-04
TRANSFER,3317,Camille Prévost,4806,1489,Camille Prévost,4806,1489,2022-05-06
CASH_OUT,782,Camille Prévost,1489,707,Agence_moov_Ouidah,300000,299218,2022-05-07
CASH_OUT,564,Camille Prévost,707,143,Agence_moov_Ouidah,300000,299436,2022-05-07
TRANSFER,131,Camille Prévost,143,12,Camille Prévost,143,12,2022-05-07
CASH_IN,72438,Agence_moov_Ouidah,300000,227562,Camille Prévost,12,72450,2022-05-08
CASH_OUT,34640,Camille Prévost,72450,37810,Agence_moov_Cotonou,300000,265360,2022-05-11
CASH_OUT,21766,Camille Prévost,37810,16044,Agence_moov_Cotonou,300000,278234,2022-05-12
CASH_OUT,3127,Camille Prévost,16044,12917,Agence_moov_Ouidah,300000,296873,2022-05-13
CASH_IN,282962,Agence_moov_Abomey,300000,17038,Camille Prévost,12917,295879,2022-05-13
TRANSFER,72546,Camille Prévost,295879,223333,Camille Prévost,295879,368425,2022-05-15
CASH_OUT,141012,Camille Prévost,223333,82321,Agence_moov_Ouidah,300000,158988,2022-05-15
CASH_IN,109285,Agence_moov_Abomey,300000,190715,Camille Prévost,82321,191606,2022-05-16
CASH_OUT,16706,Camille Prévost,191606,174900,Agence_moov_Cotonou,300000,283294,2022-05-20
CASH_OUT,93827,Camille Prévost,174900,81073,Agence_moov_Abomey,300000,206173,2022-05-25
CASH_OUT,78642,Camille Prévost,81073,2431,Agence_moov_Ouidah,300000,221358,2022-05-26
CASH_OUT,217,Camille Prévost,2431,2214,Agence_moov_Abomey,300000,299783,2022-05-27
CASH_IN,181291,Agence_moov_Ouidah,300000,118709,Camille Prévost,2214,183505,2022-05-27
CASH_IN,256552,Agence_moov_Abomey,300000,43448,Audrey Julien de Leleu,-187018,69534,2022-05-01
CASH_IN,2815,Agence_moov_Abomey,300000,297185,Audrey Julien de Leleu,69534,72349,2022-05-07
CASH_IN,299435,Agence_moov_Ouidah,300000,565,Audrey Julien de Leleu,72349,371784,2022-05-12
CASH_OUT,50011,Audrey Julien de Leleu,371784,321773,Agence_moov_Ouidah,300000,249989,2022-05-18
CASH_OUT,212834,Audrey Julien de Leleu,321773,108939,Agence_moov_Cotonou,300000,87166,2022-05-19
CASH_IN,219279,Agence_moov_Ouidah,300000,80721,Sabine Pineau,-149538,69741,2022-05-02
CASH_OUT,10375,Sabine Pineau,69741,59366,Agence_moov_Ouidah,300000,289625,2022-05-02
CASH_IN,204594,Agence_moov_Cotonou,300000,95406,Sabine Pineau,59366,263960,2022-05-04
CASH_IN,83541,Agence_moov_Abomey,300000,216459,Sabine Pineau,263960,347501,2022-05-05
CASH_IN,213537,Agence_moov_Ouidah,300000,86463,Sabine Pineau,347501,561038,2022-05-05
CASH_IN,254966,Agence_moov_Abomey,300000,45034,Sabine Pineau,561038,816004,2022-05-08
CASH_IN,261251,Agence_moov_Abomey,300000,38749,Sabine Pineau,816004,1077255,2022-05-08
CASH_OUT,531488,Sabine Pineau,1077255,545767,Agence_moov_Cotonou,300000,-231488,2022-05-11
CASH_OUT,239437,Sabine Pineau,545767,306330,Agence_moov_Cotonou,300000,60563,2022-05-12
CASH_IN,99707,Agence_moov_Abomey,300000,200293,Sabine Pineau,306330,406037,2022-05-13
CASH_OUT,174585,Sabine Pineau,406037,231452,Agence_moov_Abomey,300000,125415,2022-05-14
CASH_OUT,157205,Sabine Pineau,231452,74247,Agence_moov_Ouidah,300000,142795,2022-05-16
CASH_OUT,20674,Sabine Pineau,74247,53573,Agence_moov_Cotonou,300000,279326,2022-05-17
CASH_OUT,17054,Sabine Pineau,53573,36519,Agence_moov_Ouidah,300000,282946,2022-05-19
TRANSFER,14852,Sabine Pineau,36519,21667,Sabine Pineau,36519,51371,2022-05-21
CASH_OUT,2854,Sabine Pineau,21667,18813,Agence_moov_Abomey,300000,297146,2022-05-22
CASH_OUT,3780,Sabine Pineau,18813,15033,Agence_moov_Cotonou,300000,296220,2022-05-22
CASH_OUT,5042,Sabine Pineau,15033,9991,Agence_moov_Abomey,300000,294958,2022-05-25
CASH_IN,237312,Agence_moov_Cotonou,300000,62688,Agnès Le Giraud,-152232,85080,2022-05-01
CASH_OUT,55335,Agnès Le Giraud,85080,29745,Agence_moov_Ouidah,300000,244665,2022-05-01
CASH_OUT,27078,Agnès Le Giraud,29745,2667,Agence_moov_Abomey,300000,272922,2022-05-06
TRANSFER,2163,Agnès Le Giraud,2667,504,Agnès Le Giraud,2667,504,2022-05-09
CASH_OUT,140,Agnès Le Giraud,504,364,Agence_moov_Abomey,300000,299860,2022-05-11
CASH_IN,208780,Agence_moov_Cotonou,300000,91220,Agnès Le Giraud,364,209144,2022-05-13
CASH_IN,233181,Agence_moov_Abomey,300000,66819,Agnès Le Giraud,209144,442325,2022-05-14
CASH_OUT,115920,Agnès Le Giraud,442325,326405,Agence_moov_Cotonou,300000,184080,2022-05-15
TRANSFER,306370,Agnès Le Giraud,326405,20035,Agnès Le Giraud,326405,20035,2022-05-15
TRANSFER,17105,Agnès Le Giraud,20035,2930,Agnès Le Giraud,20035,2930,2022-05-15
CASH_OUT,1149,Agnès Le Giraud,2930,1781,Agence_moov_Ouidah,300000,298851,2022-05-20
TRANSFER,899,Agnès Le Giraud,1781,882,Agnès Le Giraud,1781,2680,2022-05-21
CASH_IN,87962,Agence_moov_Ouidah,300000,212038,Agnès Le Giraud,882,88844,2022-05-21
CASH_IN,116471,Agence_moov_Cotonou,300000,183529,Agnès Le Giraud,88844,205315,2022-05-23
CASH_IN,42588,Agence_moov_Cotonou,300000,257412,Agnès Le Giraud,205315,247903,2022-05-27
CASH_IN,193838,Agence_moov_Abomey,300000,106162,Véronique Martins de Fleury,-1471960,-1278122,2022-05-01
CASH_IN,190475,Agence_moov_Cotonou,300000,109525,Véronique Martins de Fleury,-1278122,-1087647,2022-05-02
CASH_IN,68469,Agence_moov_Ouidah,300000,231531,Véronique Martins de Fleury,-1087647,-1019178,2022-05-03
CASH_IN,296514,Agence_moov_Cotonou,300000,3486,Véronique Martins de Fleury,-1019178,-722664,2022-05-03
CASH_IN,222226,Agence_moov_Abomey,300000,77774,Véronique Martins de Fleury,-722664,-500438,2022-05-03
CASH_IN,49799,Agence_moov_Cotonou,300000,250201,Véronique Martins de Fleury,-500438,-450639,2022-05-04
CASH_IN,191467,Agence_moov_Cotonou,300000,108533,Véronique Martins de Fleury,-450639,-259172,2022-05-05
CASH_IN,298911,Agence_moov_Abomey,300000,1089,Véronique Martins de Fleury,-259172,39739,2022-05-07
TRANSFER,31579,Véronique Martins de Fleury,39739,8160,Véronique Martins de Fleury,39739,71318,2022-05-10
CASH_IN,159938,Agence_moov_Cotonou,300000,140062,Véronique Martins de Fleury,8160,168098,2022-05-10
CASH_OUT,102490,Véronique Martins de Fleury,168098,65608,Agence_moov_Abomey,300000,197510,2022-05-11
CASH_IN,195379,Agence_moov_Cotonou,300000,104621,Véronique Martins de Fleury,65608,260987,2022-05-12
TRANSFER,16349,Véronique Martins de Fleury,260987,244638,Véronique Martins de Fleury,260987,244638,2022-05-14
CASH_IN,57206,Agence_moov_Abomey,300000,242794,Véronique Martins de Fleury,244638,301844,2022-05-16
CASH_IN,18571,Agence_moov_Ouidah,300000,281429,Véronique Martins de Fleury,301844,320415,2022-05-18
CASH_OUT,41625,Véronique Martins de Fleury,320415,278790,Agence_moov_Cotonou,300000,258375,2022-05-21
CASH_IN,122290,Agence_moov_Abomey,300000,177710,Véronique Martins de Fleury,278790,401080,2022-05-22
CASH_IN,51876,Agence_moov_Abomey,300000,248124,Gabriel Bègue,-141782,-89906,2022-05-05
CASH_IN,3308,Agence_moov_Abomey,300000,296692,Gabriel Bègue,-89906,-86598,2022-05-08
CASH_IN,182966,Agence_moov_Ouidah,300000,117034,Gabriel Bègue,-86598,96368,2022-05-14
CASH_IN,249141,Agence_moov_Ouidah,300000,50859,Gabriel Bègue,96368,345509,2022-05-21
CASH_IN,294303,Agence_moov_Abomey,300000,5697,Thérèse Hubert,-120188,174115,2022-05-04
CASH_OUT,171430,Thérèse Hubert,174115,2685,Agence_moov_Cotonou,300000,128570,2022-05-05
TRANSFER,953,Thérèse Hubert,2685,1732,Thérèse Hubert,2685,3638,2022-05-08
TRANSFER,1678,Thérèse Hubert,1732,54,Thérèse Hubert,1732,3410,2022-05-09
CASH_IN,39865,Agence_moov_Cotonou,300000,260135,Thérèse Hubert,54,39919,2022-05-12
TRANSFER,26906,Thérèse Hubert,39919,13013,Thérèse Hubert,39919,13013,2022-05-12
CASH_OUT,4409,Thérèse Hubert,13013,8604,Agence_moov_Abomey,300000,295591,2022-05-19
CASH_OUT,1014,Thérèse Hubert,8604,7590,Agence_moov_Ouidah,300000,298986,2022-05-19
CASH_OUT,3691,Thérèse Hubert,7590,3899,Agence_moov_Abomey,300000,296309,2022-05-22
CASH_OUT,245,Thérèse Hubert,3899,3654,Agence_moov_Ouidah,300000,299755,2022-05-23
CASH_IN,127024,Agence_moov_Cotonou,300000,172976,Thérèse Hubert,3654,130678,2022-05-25
CASH_IN,290748,Agence_moov_Cotonou,300000,9252,Gérard de la Martinez,-1302,289446,2022-05-01
CASH_IN,109586,Agence_moov_Cotonou,300000,190414,Gérard de la Martinez,289446,399032,2022-05-04
CASH_IN,285708,Agence_moov_Abomey,300000,14292,Gérard de la Martinez,399032,684740,2022-05-06
CASH_OUT,66359,Gérard de la Martinez,684740,618381,Agence_moov_Cotonou,300000,233641,2022-05-07
CASH_IN,120148,Agence_moov_Ouidah,300000,179852,Gérard de la Martinez,618381,738529,2022-05-07
TRANSFER,314720,Gérard de la Martinez,738529,423809,Gérard de la Martinez,738529,1053249,2022-05-08
TRANSFER,337065,Gérard de la Martinez,423809,86744,Gérard de la Martinez,423809,86744,2022-05-10
CASH_OUT,53285,Gérard de la Martinez,86744,33459,Agence_moov_Cotonou,300000,246715,2022-05-11
CASH_OUT,23145,Gérard de la Martinez,33459,10314,Agence_moov_Ouidah,300000,276855,2022-05-11
TRANSFER,7513,Gérard de la Martinez,10314,2801,Gérard de la Martinez,10314,2801,2022-05-14
TRANSFER,392,Gérard de la Martinez,2801,2409,Gérard de la Martinez,2801,2409,2022-05-16
CASH_IN,66655,Agence_moov_Ouidah,300000,233345,Gérard de la Martinez,2409,69064,2022-05-17
CASH_OUT,58698,Gérard de la Martinez,69064,10366,Agence_moov_Abomey,300000,241302,2022-05-18
CASH_OUT,7971,Gérard de la Martinez,10366,2395,Agence_moov_Ouidah,300000,292029,2022-05-24
CASH_IN,245721,Agence_moov_Ouidah,300000,54279,Gérard de la Martinez,2395,248116,2022-05-25
CASH_IN,837,Agence_moov_Abomey,300000,299163,Gérard de la Martinez,248116,248953,2022-05-27
CASH_IN,106408,Agence_moov_Cotonou,300000,193592,Gérard de la Martinez,248953,355361,2022-05-27
CASH_IN,15761,Agence_moov_Cotonou,300000,284239,Paul Rocher-Maillet,-96188,-80427,2022-05-02
CASH_IN,270002,Agence_moov_Abomey,300000,29998,Paul Rocher-Maillet,-80427,189575,2022-05-07
CASH_OUT,116392,Paul Rocher-Maillet,189575,73183,Agence_moov_Abomey,300000,183608,2022-05-08
TRANSFER,32046,Paul Rocher-Maillet,73183,41137,Paul Rocher-Maillet,73183,41137,2022-05-12
TRANSFER,7990,Paul Rocher-Maillet,41137,33147,Paul Rocher-Maillet,41137,33147,2022-05-13
CASH_IN,210850,Agence_moov_Cotonou,300000,89150,Paul Rocher-Maillet,33147,243997,2022-05-14
CASH_OUT,148356,Paul Rocher-Maillet,243997,95641,Agence_moov_Ouidah,300000,151644,2022-05-25
CASH_IN,297638,Agence_moov_Abomey,300000,2362,Paul Rocher-Maillet,95641,393279,2022-05-25
CASH_IN,66704,Agence_moov_Ouidah,300000,233296,Noël Bourgeois,-10572,56132,2022-05-03
CASH_OUT,28612,Noël Bourgeois,56132,27520,Agence_moov_Cotonou,300000,271388,2022-05-07
TRANSFER,3325,Noël Bourgeois,27520,24195,Noël Bourgeois,27520,30845,2022-05-08
TRANSFER,14881,Noël Bourgeois,24195,9314,Noël Bourgeois,24195,9314,2022-05-09
CASH_OUT,416,Noël Bourgeois,9314,8898,Agence_moov_Ouidah,300000,299584,2022-05-11
CASH_OUT,1578,Noël Bourgeois,8898,7320,Agence_moov_Ouidah,300000,298422,2022-05-11
CASH_IN,6843,Agence_moov_Ouidah,300000,293157,Noël Bourgeois,7320,14163,2022-05-14
CASH_IN,160266,Agence_moov_Ouidah,300000,139734,Noël Bourgeois,14163,174429,2022-05-15
CASH_OUT,165899,Noël Bourgeois,174429,8530,Agence_moov_Cotonou,300000,134101,2022-05-16
TRANSFER,1135,Noël Bourgeois,8530,7395,Noël Bourgeois,8530,7395,2022-05-16
CASH_OUT,6059,Noël Bourgeois,7395,1336,Agence_moov_Abomey,300000,293941,2022-05-17
CASH_IN,92855,Agence_moov_Cotonou,300000,207145,Noël Bourgeois,1336,94191,2022-05-17
CASH_OUT,37328,Noël Bourgeois,94191,56863,Agence_moov_Cotonou,300000,262672,2022-05-18
CASH_IN,234837,Agence_moov_Ouidah,300000,65163,Noël Bourgeois,56863,291700,2022-05-25
CASH_OUT,250838,Noël Bourgeois,291700,40862,Agence_moov_Ouidah,300000,49162,2022-05-25
CASH_IN,85949,Agence_moov_Cotonou,300000,214051,Noël Bourgeois,40862,126811,2022-05-26
CASH_OUT,68549,Noël Bourgeois,126811,58262,Agence_moov_Abomey,300000,231451,2022-05-27
CASH_IN,129280,Agence_moov_Ouidah,300000,170720,Manon Valette,-3435,125845,2022-05-01
TRANSFER,10479,Manon Valette,125845,115366,Manon Valette,125845,136324,2022-05-02
CASH_IN,12495,Agence_moov_Abomey,300000,287505,Manon Valette,115366,127861,2022-05-04
TRANSFER,126752,Manon Valette,127861,1109,Manon Valette,127861,1109,2022-05-06
TRANSFER,126,Manon Valette,1109,983,Manon Valette,1109,1235,2022-05-07
CASH_OUT,814,Manon Valette,983,169,Agence_moov_Abomey,300000,299186,2022-05-09
CASH_OUT,108,Manon Valette,169,61,Agence_moov_Cotonou,300000,299892,2022-05-09
CASH_IN,77569,Agence_moov_Cotonou,300000,222431,Manon Valette,61,77630,2022-05-09
TRANSFER,69385,Manon Valette,77630,8245,Manon Valette,77630,147015,2022-05-13
CASH_IN,49050,Agence_moov_Ouidah,300000,250950,Manon Valette,8245,57295,2022-05-14
CASH_OUT,1608,Manon Valette,57295,55687,Agence_moov_Ouidah,300000,298392,2022-05-14
CASH_OUT,31222,Manon Valette,55687,24465,Agence_moov_Abomey,300000,268778,2022-05-15
CASH_IN,213120,Agence_moov_Abomey,300000,86880,Manon Valette,24465,237585,2022-05-15
CASH_IN,114821,Agence_moov_Ouidah,300000,185179,Manon Valette,237585,352406,2022-05-17
CASH_IN,284717,Agence_moov_Abomey,300000,15283,Manon Valette,352406,637123,2022-05-20
CASH_IN,115051,Agence_moov_Ouidah,300000,184949,Manon Valette,637123,752174,2022-05-22
CASH_IN,235775,Agence_moov_Cotonou,300000,64225,Frédéric Guillou,-1016770,-780995,2022-05-04
CASH_IN,34778,Agence_moov_Cotonou,300000,265222,Frédéric Guillou,-780995,-746217,2022-05-05
CASH_IN,116286,Agence_moov_Cotonou,300000,183714,Frédéric Guillou,-746217,-629931,2022-05-05
CASH_IN,167125,Agence_moov_Ouidah,300000,132875,Frédéric Guillou,-629931,-462806,2022-05-06
CASH_IN,33163,Agence_moov_Ouidah,300000,266837,Frédéric Guillou,-462806,-429643,2022-05-07
CASH_IN,174539,Agence_moov_Cotonou,300000,125461,Frédéric Guillou,-429643,-255104,2022-05-11
CASH_IN,156001,Agence_moov_Cotonou,300000,143999,Frédéric Guillou,-255104,-99103,2022-05-11
CASH_IN,87024,Agence_moov_Abomey,300000,212976,Frédéric Guillou,-99103,-12079,2022-05-12
CASH_IN,196586,Agence_moov_Abomey,300000,103414,Frédéric Guillou,-12079,184507,2022-05-12
CASH_IN,160440,Agence_moov_Abomey,300000,139560,Frédéric Guillou,184507,344947,2022-05-12
CASH_OUT,42044,Frédéric Guillou,344947,302903,Agence_moov_Abomey,300000,257956,2022-05-13
CASH_IN,197256,Agence_moov_Ouidah,300000,102744,Frédéric Guillou,302903,500159,2022-05-15
CASH_IN,235410,Agence_moov_Abomey,300000,64590,Frédéric Guillou,500159,735569,2022-05-19
CASH_IN,56811,Agence_moov_Abomey,300000,243189,Frédéric Guillou,735569,792380,2022-05-24
CASH_OUT,456986,Frédéric Guillou,792380,335394,Agence_moov_Ouidah,300000,-156986,2022-05-25
CASH_OUT,222139,Frédéric Guillou,335394,113255,Agence_moov_Abomey,300000,77861,2022-05-25
CASH_IN,22399,Agence_moov_Abomey,300000,277601,Frédéric Guillou,113255,135654,2022-05-25
CASH_OUT,92390,Frédéric Guillou,135654,43264,Agence_moov_Cotonou,300000,207610,2022-05-26
CASH_IN,59617,Agence_moov_Abomey,300000,240383,Bernadette de Jourdan,-106615,-46998,2022-05-02
CASH_IN,150941,Agence_moov_Ouidah,300000,149059,Bernadette de Jourdan,-46998,103943,2022-05-02
CASH_OUT,18513,Bernadette de Jourdan,103943,85430,Agence_moov_Ouidah,300000,281487,2022-05-02
TRANSFER,74472,Bernadette de Jourdan,85430,10958,Bernadette de Jourdan,85430,159902,2022-05-03
CASH_OUT,2354,Bernadette de Jourdan,10958,8604,Agence_moov_Cotonou,300000,297646,2022-05-03
CASH_IN,236176,Agence_moov_Ouidah,300000,63824,Bernadette de Jourdan,8604,244780,2022-05-03
CASH_OUT,122540,Bernadette de Jourdan,244780,122240,Agence_moov_Cotonou,300000,177460,2022-05-04
CASH_IN,149328,Agence_moov_Ouidah,300000,150672,Bernadette de Jourdan,122240,271568,2022-05-05
CASH_OUT,127211,Bernadette de Jourdan,271568,144357,Agence_moov_Ouidah,300000,172789,2022-05-08
CASH_IN,283441,Agence_moov_Ouidah,300000,16559,Bernadette de Jourdan,144357,427798,2022-05-10
CASH_IN,210816,Agence_moov_Abomey,300000,89184,Bernadette de Jourdan,427798,638614,2022-05-17
CASH_IN,146359,Agence_moov_Cotonou,300000,153641,Bernadette de Jourdan,638614,784973,2022-05-22
CASH_OUT,172803,Bernadette de Jourdan,784973,612170,Agence_moov_Ouidah,300000,127197,2022-05-24
CASH_IN,52920,Agence_moov_Cotonou,300000,247080,Bernadette de Jourdan,612170,665090,2022-05-26
CASH_IN,256386,Agence_moov_Cotonou,300000,43614,Bernadette de Jourdan,665090,921476,2022-05-26
CASH_IN,281182,Agence_moov_Cotonou,300000,18818,Bernadette de Jourdan,921476,1202658,2022-05-27
CASH_IN,4735,Agence_moov_Abomey,300000,295265,Paul Perez,-59629,-54894,2022-05-02
CASH_IN,16228,Agence_moov_Ouidah,300000,283772,Paul Perez,-54894,-38666,2022-05-03
CASH_IN,61938,Agence_moov_Ouidah,300000,238062,Paul Perez,-38666,23272,2022-05-03
CASH_IN,200670,Agence_moov_Ouidah,300000,99330,Paul Perez,23272,223942,2022-05-03
CASH_IN,121469,Agence_moov_Cotonou,300000,178531,Paul Perez,223942,345411,2022-05-05
CASH_IN,235652,Agence_moov_Ouidah,300000,64348,Paul Perez,345411,581063,2022-05-05
CASH_OUT,41933,Paul Perez,581063,539130,Agence_moov_Cotonou,300000,258067,2022-05-09
CASH_OUT,125618,Paul Perez,539130,413512,Agence_moov_Ouidah,300000,174382,2022-05-11
CASH_IN,246451,Agence_moov_Ouidah,300000,53549,Paul Perez,413512,659963,2022-05-19
CASH_IN,26285,Agence_moov_Ouidah,300000,273715,Paul Perez,659963,686248,2022-05-20
CASH_IN,218711,Agence_moov_Abomey,300000,81289,Paul Perez,686248,904959,2022-05-21
CASH_IN,268886,Agence_moov_Abomey,300000,31114,Paul Perez,904959,1173845,2022-05-21
CASH_OUT,1131746,Paul Perez,1173845,42099,Agence_moov_Abomey,300000,-831746,2022-05-26
CASH_IN,276067,Agence_moov_Abomey,300000,23933,Paul Perez,42099,318166,2022-05-27
CASH_IN,292109,Agence_moov_Ouidah,300000,7891,Manon Lebon,-275353,16756,2022-05-06
CASH_OUT,9350,Manon Lebon,16756,7406,Agence_moov_Ouidah,300000,290650,2022-05-08
CASH_IN,107669,Agence_moov_Ouidah,300000,192331,Manon Lebon,7406,115075,2022-05-10
CASH_IN,101407,Agence_moov_Abomey,300000,198593,Manon Lebon,115075,216482,2022-05-11
CASH_OUT,35469,Manon Lebon,216482,181013,Agence_moov_Abomey,300000,264531,2022-05-11
CASH_OUT,45608,Manon Lebon,181013,135405,Agence_moov_Cotonou,300000,254392,2022-05-11
TRANSFER,99078,Manon Lebon,135405,36327,Manon Lebon,135405,234483,2022-05-13
TRANSFER,26750,Manon Lebon,36327,9577,Manon Lebon,36327,9577,2022-05-13
CASH_OUT,1382,Manon Lebon,9577,8195,Agence_moov_Ouidah,300000,298618,2022-05-13
CASH_IN,231909,Agence_moov_Abomey,300000,68091,Manon Lebon,8195,240104,2022-05-14
CASH_OUT,33593,Manon Lebon,240104,206511,Agence_moov_Cotonou,300000,266407,2022-05-16
CASH_IN,100175,Agence_moov_Ouidah,300000,199825,Manon Lebon,206511,306686,2022-05-16
CASH_OUT,277825,Manon Lebon,306686,28861,Agence_moov_Abomey,300000,22175,2022-05-17
CASH_OUT,10916,Manon Lebon,28861,17945,Agence_moov_Cotonou,300000,289084,2022-05-19
CASH_OUT,1253,Manon Lebon,17945,16692,Agence_moov_Abomey,300000,298747,2022-05-19
CASH_OUT,2068,Manon Lebon,16692,14624,Agence_moov_Ouidah,300000,297932,2022-05-20
CASH_IN,167035,Agence_moov_Cotonou,300000,132965,Lucy Lamy,-59088,107947,2022-05-01
CASH_IN,183699,Agence_moov_Cotonou,300000,116301,Lucy Lamy,107947,291646,2022-05-04
CASH_OUT,239290,Lucy Lamy,291646,52356,Agence_moov_Abomey,300000,60710,2022-05-06
CASH_OUT,10885,Lucy Lamy,52356,41471,Agence_moov_Abomey,300000,289115,2022-05-08
CASH_IN,240574,Agence_moov_Ouidah,300000,59426,Lucy Lamy,41471,282045,2022-05-13
CASH_OUT,228636,Lucy Lamy,282045,53409,Agence_moov_Ouidah,300000,71364,2022-05-14
CASH_OUT,15483,Lucy Lamy,53409,37926,Agence_moov_Ouidah,300000,284517,2022-05-14
TRANSFER,29871,Lucy Lamy,37926,8055,Lucy Lamy,37926,8055,2022-05-16
CASH_OUT,3942,Lucy Lamy,8055,4113,Agence_moov_Ouidah,300000,296058,2022-05-16
CASH_IN,198759,Agence_moov_Ouidah,300000,101241,Lucy Lamy,4113,202872,2022-05-19
CASH_IN,201312,Agence_moov_Ouidah,300000,98688,Lucy Lamy,202872,404184,2022-05-19
CASH_IN,79481,Agence_moov_Cotonou,300000,220519,Lucy Lamy,404184,483665,2022-05-20
CASH_IN,25411,Agence_moov_Abomey,300000,274589,Lucy Lamy,483665,509076,2022-05-24
CASH_IN,297777,Agence_moov_Cotonou,300000,2223,Lucy Lamy,509076,806853,2022-05-25
CASH_OUT,767260,Lucy Lamy,806853,39593,Agence_moov_Cotonou,300000,-467260,2022-05-25
CASH_OUT,21726,Lucy Lamy,39593,17867,Agence_moov_Cotonou,300000,278274,2022-05-25
CASH_IN,70062,Agence_moov_Cotonou,300000,229938,Nathalie Bonnin-Joubert,-669690,-599628,2022-05-01
CASH_IN,52347,Agence_moov_Cotonou,300000,247653,Nathalie Bonnin-Joubert,-599628,-547281,2022-05-09
CASH_IN,201958,Agence_moov_Cotonou,300000,98042,Nathalie Bonnin-Joubert,-547281,-345323,2022-05-09
CASH_IN,171682,Agence_moov_Ouidah,300000,128318,Nathalie Bonnin-Joubert,-345323,-173641,2022-05-10
CASH_IN,285685,Agence_moov_Abomey,300000,14315,Nathalie Bonnin-Joubert,-173641,112044,2022-05-14
TRANSFER,61780,Nathalie Bonnin-Joubert,112044,50264,Nathalie Bonnin-Joubert,112044,173824,2022-05-15
CASH_OUT,24546,Nathalie Bonnin-Joubert,50264,25718,Agence_moov_Cotonou,300000,275454,2022-05-17
CASH_OUT,8082,Nathalie Bonnin-Joubert,25718,17636,Agence_moov_Cotonou,300000,291918,2022-05-19
TRANSFER,15521,Nathalie Bonnin-Joubert,17636,2115,Nathalie Bonnin-Joubert,17636,2115,2022-05-22
CASH_IN,133789,Agence_moov_Cotonou,300000,166211,Nathalie Bonnin-Joubert,2115,135904,2022-05-24
CASH_IN,241313,Agence_moov_Abomey,300000,58687,Nathalie Bonnin-Joubert,135904,377217,2022-05-27
CASH_IN,176889,Agence_moov_Cotonou,300000,123111,Léon Da Costa,-941644,-764755,2022-05-01
CASH_IN,258601,Agence_moov_Abomey,300000,41399,Léon Da Costa,-764755,-506154,2022-05-02
CASH_IN,170339,Agence_moov_Cotonou,300000,129661,Léon Da Costa,-506154,-335815,2022-05-03
CASH_IN,65998,Agence_moov_Cotonou,300000,234002,Léon Da Costa,-335815,-269817,2022-05-04
CASH_IN,107677,Agence_moov_Cotonou,300000,192323,Léon Da Costa,-269817,-162140,2022-05-04
CASH_IN,290686,Agence_moov_Cotonou,300000,9314,Léon Da Costa,-162140,128546,2022-05-06
CASH_OUT,80200,Léon Da Costa,128546,48346,Agence_moov_Ouidah,300000,219800,2022-05-07
CASH_IN,8724,Agence_moov_Ouidah,300000,291276,Léon Da Costa,48346,57070,2022-05-07
CASH_IN,135734,Agence_moov_Cotonou,300000,164266,Léon Da Costa,57070,192804,2022-05-07
CASH_IN,171855,Agence_moov_Cotonou,300000,128145,Léon Da Costa,192804,364659,2022-05-09
CASH_IN,295065,Agence_moov_Abomey,300000,4935,Léon Da Costa,364659,659724,2022-05-10
CASH_OUT,645499,Léon Da Costa,659724,14225,Agence_moov_Cotonou,300000,-345499,2022-05-15
TRANSFER,10849,Léon Da Costa,14225,3376,Léon Da Costa,14225,3376,2022-05-16
CASH_IN,68786,Agence_moov_Cotonou,300000,231214,Léon Da Costa,3376,72162,2022-05-18
CASH_IN,108243,Agence_moov_Ouidah,300000,191757,Léon Da Costa,72162,180405,2022-05-25
CASH_IN,24410,Agence_moov_Ouidah,300000,275590,Anastasie Cousin,6,24416,2022-05-04
TRANSFER,1519,Anastasie Cousin,24416,22897,Anastasie Cousin,24416,22897,2022-05-06
TRANSFER,17246,Anastasie Cousin,22897,5651,Anastasie Cousin,22897,5651,2022-05-07
TRANSFER,4395,Anastasie Cousin,5651,1256,Anastasie Cousin,5651,10046,2022-05-08
TRANSFER,598,Anastasie Cousin,1256,658,Anastasie Cousin,1256,658,2022-05-08
CASH_IN,231894,Agence_moov_Ouidah,300000,68106,Anastasie Cousin,658,232552,2022-05-08
CASH_OUT,117534,Anastasie Cousin,232552,115018,Agence_moov_Cotonou,300000,182466,2022-05-11
CASH_OUT,101802,Anastasie Cousin,115018,13216,Agence_moov_Ouidah,300000,198198,2022-05-13
CASH_IN,134281,Agence_moov_Ouidah,300000,165719,Anastasie Cousin,13216,147497,2022-05-14
CASH_IN,187256,Agence_moov_Ouidah,300000,112744,Anastasie Cousin,147497,334753,2022-05-20
CASH_IN,47040,Agence_moov_Cotonou,300000,252960,Anastasie Cousin,334753,381793,2022-05-21
CASH_IN,237654,Agence_moov_Cotonou,300000,62346,Anastasie Cousin,381793,619447,2022-05-22
CASH_OUT,336356,Anastasie Cousin,619447,283091,Agence_moov_Cotonou,300000,-36356,2022-05-25
CASH_IN,178004,Agence_moov_Ouidah,300000,121996,Anastasie Cousin,283091,461095,2022-05-26
CASH_OUT,254236,Anastasie Cousin,461095,206859,Agence_moov_Cotonou,300000,45764,2022-05-26
CASH_IN,284531,Agence_moov_Abomey,300000,15469,Anastasie Cousin,206859,491390,2022-05-26
CASH_IN,252721,Agence_moov_Ouidah,300000,47279,Richard Le Lévêque,-523814,-271093,2022-05-01
CASH_IN,280391,Agence_moov_Cotonou,300000,19609,Richard Le Lévêque,-271093,9298,2022-05-02
CASH_IN,162263,Agence_moov_Cotonou,300000,137737,Richard Le Lévêque,9298,171561,2022-05-03
CASH_IN,133373,Agence_moov_Cotonou,300000,166627,Richard Le Lévêque,171561,304934,2022-05-05
CASH_IN,162370,Agence_moov_Ouidah,300000,137630,Richard Le Lévêque,304934,467304,2022-05-05
CASH_IN,171853,Agence_moov_Cotonou,300000,128147,Richard Le Lévêque,467304,639157,2022-05-05
CASH_OUT,263799,Richard Le Lévêque,639157,375358,Agence_moov_Ouidah,300000,36201,2022-05-06
TRANSFER,279363,Richard Le Lévêque,375358,95995,Richard Le Lévêque,375358,654721,2022-05-07
CASH_IN,260535,Agence_moov_Ouidah,300000,39465,Richard Le Lévêque,95995,356530,2022-05-10
CASH_IN,83847,Agence_moov_Abomey,300000,216153,Richard Le Lévêque,356530,440377,2022-05-12
TRANSFER,320791,Richard Le Lévêque,440377,119586,Richard Le Lévêque,440377,761168,2022-05-13
CASH_OUT,25893,Richard Le Lévêque,119586,93693,Agence_moov_Cotonou,300000,274107,2022-05-13
CASH_OUT,93059,Richard Le Lévêque,93693,634,Agence_moov_Ouidah,300000,206941,2022-05-13
CASH_OUT,250,Richard Le Lévêque,634,384,Agence_moov_Cotonou,300000,299750,2022-05-14
CASH_OUT,282,Richard Le Lévêque,384,102,Agence_moov_Ouidah,300000,299718,2022-05-23
CASH_OUT,100,Richard Le Lévêque,102,2,Agence_moov_Ouidah,300000,299900,2022-05-23
CASH_IN,275912,Agence_moov_Abomey,300000,24088,Richard Le Lévêque,2,275914,2022-05-23
CASH_OUT,257560,Richard Le Lévêque,275914,18354,Agence_moov_Ouidah,300000,42440,2022-05-25
CASH_IN,148500,Agence_moov_Ouidah,300000,151500,Françoise Morin,-108743,39757,2022-05-01
CASH_IN,91313,Agence_moov_Cotonou,300000,208687,Françoise Morin,39757,131070,2022-05-05
CASH_OUT,128878,Françoise Morin,131070,2192,Agence_moov_Cotonou,300000,171122,2022-05-14
CASH_OUT,1548,Françoise Morin,2192,644,Agence_moov_Ouidah,300000,298452,2022-05-20
CASH_OUT,581,Françoise Morin,644,63,Agence_moov_Cotonou,300000,299419,2022-05-22
CASH_IN,53558,Agence_moov_Cotonou,300000,246442,Françoise Morin,63,53621,2022-05-23
CASH_IN,276742,Agence_moov_Ouidah,300000,23258,Françoise Morin,53621,330363,2022-05-26
CASH_IN,196965,Agence_moov_Ouidah,300000,103035,Françoise Morin,330363,527328,2022-05-27
CASH_IN,56404,Agence_moov_Abomey,300000,243596,Michelle Samson,-142751,-86347,2022-05-01
CASH_IN,173282,Agence_moov_Ouidah,300000,126718,Michelle Samson,-86347,86935,2022-05-03
TRANSFER,24631,Michelle Samson,86935,62304,Michelle Samson,86935,111566,2022-05-04
TRANSFER,43573,Michelle Samson,62304,18731,Michelle Samson,62304,18731,2022-05-05
TRANSFER,4917,Michelle Samson,18731,13814,Michelle Samson,18731,23648,2022-05-10
CASH_IN,108415,Agence_moov_Abomey,300000,191585,Michelle Samson,13814,122229,2022-05-10
CASH_IN,76477,Agence_moov_Abomey,300000,223523,Michelle Samson,122229,198706,2022-05-14
CASH_OUT,36357,Michelle Samson,198706,162349,Agence_moov_Abomey,300000,263643,2022-05-15
CASH_IN,280989,Agence_moov_Cotonou,300000,19011,Michelle Samson,162349,443338,2022-05-19
CASH_OUT,107814,Michelle Samson,443338,335524,Agence_moov_Ouidah,300000,192186,2022-05-22
CASH_OUT,320,Michelle Samson,335524,335204,Agence_moov_Cotonou,300000,299680,2022-05-23
CASH_OUT,52564,Camille Morvan,94200,41636,Agence_moov_Abomey,300000,247436,2022-06-17
CASH_IN,92480,Agence_moov_Ouidah,300000,207520,Camille Morvan,41636,134116,2022-06-27
CASH_IN,28062,Agence_moov_Cotonou,300000,271938,Robert Laroche,928500,956562,2022-06-08
CASH_IN,210947,Agence_moov_Ouidah,300000,89053,Robert Laroche,956562,1167509,2022-06-21
CASH_OUT,226270,Marcelle-Valentine Guibert,1823500,1597230,Agence_moov_Cotonou,300000,73730,2022-06-02
TRANSFER,626218,Marcelle-Valentine Guibert,1597230,971012,Jules Fernandes,1891900,1265682,2022-06-09
CASH_IN,37084,Agence_moov_Ouidah,300000,262916,Marcelle-Valentine Guibert,971012,1008096,2022-06-15
TRANSFER,408823,Marthe Gilles,671300,262477,Marcelle-Valentine Guibert,1008096,1416919,2022-06-20
CASH_OUT,139687,Adèle Da Silva-Klein,246400,106713,Agence_moov_Abomey,300000,160313,2022-06-23
TRANSFER,763140,Audrey Julien de Leleu,1346000,582860,Noël Bourgeois,1436300,673160,2022-06-08
TRANSFER,1166525,Aimé Pages,1452000,285475,Audrey Julien de Leleu,582860,1749385,2022-06-16
CASH_IN,202541,Agence_moov_Ouidah,300000,97459,Audrey Julien de Leleu,1749385,1951926,2022-06-18
CASH_OUT,210386,Audrey Julien de Leleu,1951926,1741540,Agence_moov_Abomey,300000,89614,2022-06-20
TRANSFER,1039631,Audrey Julien de Leleu,1741540,701909,Paulette Loiseau,650600,-389031,2022-06-26
CASH_OUT,23849,Émilie du Allain,367800,343951,Agence_moov_Ouidah,300000,276151,2022-06-02
TRANSFER,172274,Richard Michel,1301200,1128926,Émilie du Allain,343951,516225,2022-06-06
TRANSFER,117303,Frédérique Fernandes du Bouchet,1412600,1295297,Émilie du Allain,516225,633528,2022-06-11
TRANSFER,649481,Constance Guillon,754700,105219,Émilie du Allain,633528,1283009,2022-06-27
CASH_OUT,741517,Thibaut de la Lombard,1641800,900283,Agence_moov_Ouidah,300000,-441517,2022-06-01
TRANSFER,114214,Christine Texier,694200,579986,Thibaut de la Lombard,900283,1014497,2022-06-07
CASH_IN,43047,Agence_moov_Ouidah,300000,256953,Thibaut de la Lombard,1014497,1057544,2022-06-16
CASH_IN,38880,Agence_moov_Cotonou,300000,261120,Thibaut de la Lombard,1057544,1096424,2022-06-18
CASH_IN,58090,Agence_moov_Cotonou,300000,241910,Thibaut de la Lombard,1096424,1154514,2022-06-21
TRANSFER,356785,Richard Le Lévêque,444000,87215,Anastasie Richard-Neveu,586400,943185,2022-06-17
TRANSFER,89280,Anastasie Richard-Neveu,943185,853905,Stéphane Munoz,1950100,1860820,2022-06-23
TRANSFER,481502,Vincent de la Dumont,1928700,1447198,Anastasie Richard-Neveu,853905,1335407,2022-06-25
TRANSFER,618848,Anastasie Richard-Neveu,1335407,716559,Michel Bouchet,545000,-73848,2022-06-25
CASH_IN,68634,Agence_moov_Abomey,300000,231366,Vincent Joubert,231100,299734,2022-06-01
CASH_OUT,84893,Vincent Joubert,299734,214841,Agence_moov_Abomey,300000,215107,2022-06-04
TRANSFER,491483,Suzanne Bodin,1959000,1467517,Hélène Le Chauvin,272200,-219283,2022-06-14
CASH_OUT,793205,Philippe Philippe,862900,69695,Agence_moov_Abomey,300000,-493205,2022-06-02
CASH_IN,220976,Agence_moov_Cotonou,300000,79024,Philippe Philippe,69695,290671,2022-06-27
TRANSFER,367020,Astrid Lecoq,393400,26380,Théodore Joseph-Lefebvre,1347600,980580,2022-06-02
CASH_IN,182370,Agence_moov_Cotonou,300000,117630,Astrid Lecoq,26380,208750,2022-06-19
CASH_OUT,27902,Astrid Lecoq,208750,180848,Agence_moov_Ouidah,300000,272098,2022-06-22
TRANSFER,126116,Astrid Lecoq,180848,54732,Lucie Aubert,1813300,1687184,2022-06-22
TRANSFER,840007,Maggie Martinez,1216000,375993,Astrid Lecoq,54732,894739,2022-06-24
CASH_IN,217386,Agence_moov_Ouidah,300000,82614,Anne Peltier-Raynaud,333600,550986,2022-06-04
CASH_IN,125320,Agence_moov_Cotonou,300000,174680,Anne Peltier-Raynaud,550986,676306,2022-06-05
CASH_IN,208448,Agence_moov_Abomey,300000,91552,Anne Peltier-Raynaud,676306,884754,2022-06-08
CASH_IN,80865,Agence_moov_Abomey,300000,219135,Anne Peltier-Raynaud,884754,965619,2022-06-11
CASH_OUT,431451,Christine Texier,579986,148535,Agence_moov_Cotonou,300000,-131451,2022-06-07
TRANSFER,48698,Christine Texier,148535,99837,Simone Muller de la Brun,515200,466502,2022-06-19
CASH_OUT,55036,Christine Texier,99837,44801,Agence_moov_Ouidah,300000,244964,2022-06-19
CASH_IN,199834,Agence_moov_Ouidah,300000,100166,Christine Texier,44801,244635,2022-06-20
CASH_IN,167856,Agence_moov_Abomey,300000,132144,Christine Texier,244635,412491,2022-06-27
CASH_IN,57251,Agence_moov_Abomey,300000,242749,Nathalie Bonnin-Joubert,814000,871251,2022-06-22
TRANSFER,123127,Tristan Delahaye,690200,567073,Nathalie Bonnin-Joubert,871251,994378,2022-06-27
TRANSFER,1561719,Clémence-Véronique Munoz,1867400,305681,Virginie Bouvet,1977800,3539519,2022-06-04
CASH_OUT,557403,Benoît Guyot,710500,153097,Agence_moov_Ouidah,300000,-257403,2022-06-26
CASH_OUT,958986,Lucie Aubert,1687184,728198,Agence_moov_Ouidah,300000,-658986,2022-06-03
CASH_OUT,396252,Lucie Aubert,728198,331946,Agence_moov_Ouidah,300000,-96252,2022-06-10
CASH_IN,157448,Agence_moov_Cotonou,300000,142552,Lucie Aubert,331946,489394,2022-06-23
TRANSFER,144954,Lucie Aubert,489394,344440,Thomas Guichard du Renault,442000,297046,2022-06-26
CASH_IN,55330,Agence_moov_Cotonou,300000,244670,Tristan Gomez,1216100,1271430,2022-06-05
TRANSFER,289488,Simone Muller de la Brun,466502,177014,Tristan Gomez,1271430,1560918,2022-06-07
CASH_IN,196742,Agence_moov_Cotonou,300000,103258,Matthieu-Matthieu Bigot,1662400,1859142,2022-06-09
CASH_OUT,1742790,Matthieu-Matthieu Bigot,1859142,116352,Agence_moov_Cotonou,300000,-1442790,2022-06-18
CASH_IN,192881,Agence_moov_Cotonou,300000,107119,Nicolas Salmon Le Hamon,444500,637381,2022-06-02
CASH_OUT,576698,Nicolas Salmon Le Hamon,637381,60683,Agence_moov_Cotonou,300000,-276698,2022-06-07
CASH_IN,10953,Agence_moov_Cotonou,300000,289047,Nicolas Salmon Le Hamon,60683,71636,2022-06-08
CASH_OUT,12348,Nicolas Salmon Le Hamon,71636,59288,Agence_moov_Ouidah,300000,287652,2022-06-10
TRANSFER,26528,Nicolas Salmon Le Hamon,59288,32760,Nicolas Salmon Le Hamon,59288,85816,2022-06-22
TRANSFER,767989,Renée Le Diaz,1725800,957811,Hélène de la Gérard,1318500,2086489,2022-06-03
CASH_OUT,784644,Hélène de la Gérard,2086489,1301845,Agence_moov_Abomey,300000,-484644,2022-06-12
CASH_IN,36474,Agence_moov_Abomey,300000,263526,Hélène de la Gérard,1301845,1338319,2022-06-16
CASH_OUT,1260899,Hélène de la Gérard,1338319,77420,Agence_moov_Abomey,300000,-960899,2022-06-19
TRANSFER,380189,Manon Chevalier,769800,389611,Thomas de Blin,1580700,1960889,2022-06-07
CASH_IN,148269,Agence_moov_Ouidah,300000,151731,Thomas de Blin,1960889,2109158,2022-06-12
CASH_OUT,188400,Michelle de Étienne,1198200,1009800,Agence_moov_Abomey,300000,111600,2022-06-05
TRANSFER,606980,Michelle de Étienne,1009800,402820,Marthe Gilles,262477,-344503,2022-06-05
CASH_IN,269820,Agence_moov_Abomey,300000,30180,Hélène Le Chauvin,-219283,50537,2022-06-16
CASH_OUT,41372,Hélène Le Chauvin,50537,9165,Agence_moov_Abomey,300000,258628,2022-06-22
CASH_IN,140989,Agence_moov_Ouidah,300000,159011,Hélène Le Chauvin,9165,150154,2022-06-25
CASH_IN,247810,Agence_moov_Ouidah,300000,52190,Lucy Gillet,1044400,1292210,2022-06-01
CASH_OUT,1190854,Lucy Gillet,1292210,101356,Agence_moov_Cotonou,300000,-890854,2022-06-03
CASH_OUT,99660,Lucy Gillet,101356,1696,Agence_moov_Ouidah,300000,200340,2022-06-04
TRANSFER,367,Lucy Gillet,1696,1329,Alix Barbe,106500,106133,2022-06-04
TRANSFER,144094,Antoinette de Dupuis,226300,82206,Lucy Gillet,1329,145423,2022-06-07
CASH_OUT,74429,Lucy Gillet,145423,70994,Agence_moov_Ouidah,300000,225571,2022-06-07
CASH_OUT,36285,Lucy Gillet,70994,34709,Agence_moov_Cotonou,300000,263715,2022-06-07
TRANSFER,1673673,Agnès Le Giraud,1711200,37527,Lucy Gillet,34709,1708382,2022-06-12
CASH_OUT,641284,Lucy Gillet,1708382,1067098,Agence_moov_Ouidah,300000,-341284,2022-06-13
CASH_IN,239463,Agence_moov_Ouidah,300000,60537,Lucy Gillet,1067098,1306561,2022-06-15
TRANSFER,7412,Thibaut de la Roy,383600,376188,Lucy Gillet,1306561,1313973,2022-06-17
TRANSFER,9331,Renée Le Diaz,957811,948480,Lucy Gillet,1313973,1323304,2022-06-19
TRANSFER,1719231,Constance Bourdon-Millet,1793500,74269,Lucy Gillet,1323304,3042535,2022-06-20
TRANSFER,42552,Sabine Pineau,244500,201948,Lucy Gillet,3042535,3085087,2022-06-21
CASH_OUT,791349,Lucy Gillet,3085087,2293738,Agence_moov_Cotonou,300000,-491349,2022-06-22
CASH_IN,242789,Agence_moov_Ouidah,300000,57211,Lucy Gillet,2293738,2536527,2022-06-22
CASH_OUT,2424405,Lucy Gillet,2536527,112122,Agence_moov_Abomey,300000,-2124405,2022-06-23
TRANSFER,416633,Robert-Louis Gosselin,753200,336567,Lucy Gillet,112122,528755,2022-06-23
TRANSFER,220194,Lucy Gillet,528755,308561,Thibaut de la Roy,376188,155994,2022-06-24
CASH_IN,180929,Agence_moov_Cotonou,300000,119071,Lucy Gillet,308561,489490,2022-06-26
CASH_IN,251911,Agence_moov_Abomey,300000,48089,Lucy Gillet,489490,741401,2022-06-26
CASH_OUT,214202,Noémi Bouvier,258900,44698,Agence_moov_Cotonou,300000,85798,2022-06-02
CASH_IN,236162,Agence_moov_Ouidah,300000,63838,Noémi Bouvier,44698,280860,2022-06-02
CASH_OUT,7174,Noémi Bouvier,280860,273686,Agence_moov_Abomey,300000,292826,2022-06-02
TRANSFER,20967,Agnès Le Giraud,37527,16560,Noémi Bouvier,273686,294653,2022-06-03
TRANSFER,799311,Émile-René Baudry,1650200,850889,Noémi Bouvier,294653,1093964,2022-06-04
CASH_IN,267392,Agence_moov_Ouidah,300000,32608,Noémi Bouvier,1093964,1361356,2022-06-04
CASH_IN,229960,Agence_moov_Cotonou,300000,70040,Noémi Bouvier,1361356,1591316,2022-06-04
CASH_IN,164492,Agence_moov_Cotonou,300000,135508,Noémi Bouvier,1591316,1755808,2022-06-04
TRANSFER,1391401,Aurore Charrier,1621700,230299,Noémi Bouvier,1755808,3147209,2022-06-05
CASH_IN,50980,Agence_moov_Ouidah,300000,249020,Noémi Bouvier,3147209,3198189,2022-06-06
TRANSFER,1689078,Noémi Bouvier,3198189,1509111,Thérèse François,1674400,-14678,2022-06-08
TRANSFER,40482,Emmanuel Grégoire,163800,123318,Noémi Bouvier,1509111,1549593,2022-06-08
CASH_IN,248523,Agence_moov_Cotonou,300000,51477,Noémi Bouvier,1549593,1798116,2022-06-09
TRANSFER,349849,Noémi Bouvier,1798116,1448267,Céline Collin-Hervé,280400,-69449,2022-06-10
CASH_OUT,984765,Noémi Bouvier,1448267,463502,Agence_moov_Abomey,300000,-684765,2022-06-11
CASH_IN,125356,Agence_moov_Ouidah,300000,174644,Noémi Bouvier,463502,588858,2022-06-11
TRANSFER,546681,Noémi Bouvier,588858,42177,Léon Da Costa,292000,-254681,2022-06-11
CASH_OUT,34696,Noémi Bouvier,42177,7481,Agence_moov_Cotonou,300000,265304,2022-06-12
CASH_OUT,2961,Noémi Bouvier,7481,4520,Agence_moov_Abomey,300000,297039,2022-06-12
CASH_IN,146568,Agence_moov_Ouidah,300000,153432,Noémi Bouvier,4520,151088,2022-06-13
TRANSFER,3136,Aurore Charrier,230299,227163,Noémi Bouvier,151088,154224,2022-06-14
TRANSFER,26028,Simone Muller de la Brun,177014,150986,Noémi Bouvier,154224,180252,2022-06-16
TRANSFER,580590,Nath Loiseau,808700,228110,Noémi Bouvier,180252,760842,2022-06-26
TRANSFER,762941,Renée Le Diaz,948480,185539,Maggie Martinez,375993,-386948,2022-06-03
CASH_IN,195270,Agence_moov_Cotonou,300000,104730,Renée Le Diaz,185539,380809,2022-06-03
TRANSFER,340160,Colette-Sophie Prévost,623300,283140,Renée Le Diaz,380809,720969,2022-06-04
CASH_OUT,675089,Renée Le Diaz,720969,45880,Agence_moov_Abomey,300000,-375089,2022-06-05
TRANSFER,112001,Bertrand Regnier,949500,837499,Renée Le Diaz,45880,157881,2022-06-06
CASH_IN,122539,Agence_moov_Ouidah,300000,177461,Renée Le Diaz,157881,280420,2022-06-06
CASH_OUT,61460,Renée Le Diaz,280420,218960,Agence_moov_Abomey,300000,238540,2022-06-07
TRANSFER,57645,Renée Le Diaz,218960,161315,Aimé Pages,285475,227830,2022-06-07
CASH_IN,236137,Agence_moov_Cotonou,300000,63863,Renée Le Diaz,161315,397452,2022-06-08
CASH_IN,141467,Agence_moov_Abomey,300000,158533,Renée Le Diaz,397452,538919,2022-06-09
TRANSFER,767296,Camille Prévost,846800,79504,Renée Le Diaz,538919,1306215,2022-06-11
CASH_IN,237926,Agence_moov_Ouidah,300000,62074,Renée Le Diaz,1306215,1544141,2022-06-15
CASH_IN,16066,Agence_moov_Ouidah,300000,283934,Renée Le Diaz,1544141,1560207,2022-06-16
TRANSFER,1460885,Renée Le Diaz,1560207,99322,Frédérique Fernandes du Bouchet,1295297,-165588,2022-06-17
TRANSFER,57292,Renée Le Diaz,99322,42030,Thibaut de la Roy,155994,98702,2022-06-18
CASH_OUT,39351,Renée Le Diaz,42030,2679,Agence_moov_Ouidah,300000,260649,2022-06-21
CASH_OUT,1892,Renée Le Diaz,2679,787,Agence_moov_Cotonou,300000,298108,2022-06-22
CASH_IN,175515,Agence_moov_Abomey,300000,124485,Renée Le Diaz,787,176302,2022-06-23
CASH_OUT,118208,Renée Le Diaz,176302,58094,Agence_moov_Abomey,300000,181792,2022-06-24
CASH_IN,256492,Agence_moov_Cotonou,300000,43508,Renée Le Diaz,58094,314586,2022-06-26
CASH_OUT,250653,Renée Le Diaz,314586,63933,Agence_moov_Cotonou,300000,49347,2022-06-27
CASH_OUT,55941,Renée Le Diaz,63933,7992,Agence_moov_Abomey,300000,244059,2022-06-27
CASH_IN,242785,Agence_moov_Abomey,300000,57215,Stéphane Munoz,1860820,2103605,2022-06-01
TRANSFER,227963,Robert Clerc,1486100,1258137,Stéphane Munoz,2103605,2331568,2022-06-02
CASH_IN,75751,Agence_moov_Ouidah,300000,224249,Stéphane Munoz,2331568,2407319,2022-06-02
CASH_IN,271936,Agence_moov_Abomey,300000,28064,Stéphane Munoz,2407319,2679255,2022-06-02
CASH_IN,118508,Agence_moov_Abomey,300000,181492,Stéphane Munoz,2679255,2797763,2022-06-02
CASH_OUT,2205598,Stéphane Munoz,2797763,592165,Agence_moov_Cotonou,300000,-1905598,2022-06-03
TRANSFER,745717,Mathilde de la Samson,1237800,492083,Stéphane Munoz,592165,1337882,2022-06-05
CASH_OUT,473589,Stéphane Munoz,1337882,864293,Agence_moov_Cotonou,300000,-173589,2022-06-05
CASH_IN,27385,Agence_moov_Abomey,300000,272615,Stéphane Munoz,864293,891678,2022-06-07
CASH_OUT,131771,Stéphane Munoz,891678,759907,Agence_moov_Ouidah,300000,168229,2022-06-11
CASH_OUT,40759,Stéphane Munoz,759907,719148,Agence_moov_Cotonou,300000,259241,2022-06-12
CASH_OUT,571348,Stéphane Munoz,719148,147800,Agence_moov_Abomey,300000,-271348,2022-06-12
CASH_IN,37564,Agence_moov_Abomey,300000,262436,Stéphane Munoz,147800,185364,2022-06-14
CASH_OUT,117800,Stéphane Munoz,185364,67564,Agence_moov_Abomey,300000,182200,2022-06-14
CASH_IN,254576,Agence_moov_Ouidah,300000,45424,Stéphane Munoz,67564,322140,2022-06-18
TRANSFER,311395,Stéphane Munoz,322140,10745,Véronique Martins de Fleury,1697200,1385805,2022-06-19
CASH_OUT,2181,Stéphane Munoz,10745,8564,Agence_moov_Abomey,300000,297819,2022-06-21
CASH_OUT,4795,Stéphane Munoz,8564,3769,Agence_moov_Ouidah,300000,295205,2022-06-22
CASH_IN,113335,Agence_moov_Ouidah,300000,186665,Stéphane Munoz,3769,117104,2022-06-22
CASH_OUT,36617,Stéphane Munoz,117104,80487,Agence_moov_Abomey,300000,263383,2022-06-22
CASH_IN,270207,Agence_moov_Abomey,300000,29793,Stéphane Munoz,80487,350694,2022-06-23
CASH_OUT,212312,Stéphane Munoz,350694,138382,Agence_moov_Abomey,300000,87688,2022-06-23
CASH_IN,294054,Agence_moov_Cotonou,300000,5946,Stéphane Munoz,138382,432436,2022-06-25
CASH_OUT,311283,Stéphane Munoz,432436,121153,Agence_moov_Abomey,300000,-11283,2022-06-26
CASH_IN,280850,Agence_moov_Ouidah,300000,19150,Stéphane Munoz,121153,402003,2022-06-26
CASH_IN,286106,Agence_moov_Ouidah,300000,13894,Stéphane Munoz,402003,688109,2022-06-26
CASH_IN,173889,Agence_moov_Abomey,300000,126111,Stéphane Munoz,688109,861998,2022-06-26
TRANSFER,386996,Stéphane Munoz,861998,475002,Robert Clerc,1258137,871141,2022-06-27
CASH_IN,202464,Agence_moov_Ouidah,300000,97536,Mathilde de la Samson,492083,694547,2022-06-01
CASH_IN,226789,Agence_moov_Ouidah,300000,73211,Mathilde de la Samson,694547,921336,2022-06-01
CASH_IN,175317,Agence_moov_Cotonou,300000,124683,Mathilde de la Samson,921336,1096653,2022-06-02
TRANSFER,731519,Mathilde de la Samson,1096653,365134,Lucy Lamy,349900,-381619,2022-06-02
CASH_OUT,224566,Mathilde de la Samson,365134,140568,Agence_moov_Cotonou,300000,75434,2022-06-02
CASH_IN,81677,Agence_moov_Abomey,300000,218323,Mathilde de la Samson,140568,222245,2022-06-03
TRANSFER,75673,Mathilde de la Samson,222245,146572,Timothée-René Blanchard,362100,286427,2022-06-03
CASH_OUT,27669,Mathilde de la Samson,146572,118903,Agence_moov_Ouidah,300000,272331,2022-06-04
TRANSFER,80644,Mathilde de la Samson,118903,38259,Bernard Maurice,76300,-4344,2022-06-05
TRANSFER,53859,Alix Barbe,106133,52274,Mathilde de la Samson,38259,92118,2022-06-05
CASH_IN,85628,Agence_moov_Ouidah,300000,214372,Mathilde de la Samson,92118,177746,2022-06-05
TRANSFER,2019,Agnès Le Giraud,16560,14541,Mathilde de la Samson,177746,179765,2022-06-05
CASH_OUT,80578,Mathilde de la Samson,179765,99187,Agence_moov_Ouidah,300000,219422,2022-06-06
CASH_OUT,12097,Mathilde de la Samson,99187,87090,Agence_moov_Cotonou,300000,287903,2022-06-07
CASH_OUT,12568,Mathilde de la Samson,87090,74522,Agence_moov_Abomey,300000,287432,2022-06-08
TRANSFER,340120,Alphonse Joly,435600,95480,Mathilde de la Samson,74522,414642,2022-06-10
CASH_OUT,337793,Mathilde de la Samson,414642,76849,Agence_moov_Ouidah,300000,-37793,2022-06-11
TRANSFER,57048,Mathilde de la Samson,76849,19801,Manon Chevalier,389611,332563,2022-06-12
TRANSFER,11706,Mathilde de la Samson,19801,8095,Françoise Morin,1672500,1660794,2022-06-13
TRANSFER,57633,Robert Clerc,871141,813508,Mathilde de la Samson,8095,65728,2022-06-15
CASH_IN,264011,Agence_moov_Abomey,300000,35989,Mathilde de la Samson,65728,329739,2022-06-17
CASH_IN,184321,Agence_moov_Ouidah,300000,115679,Mathilde de la Samson,329739,514060,2022-06-17
TRANSFER,87095,Martine Aubert,307200,220105,Mathilde de la Samson,514060,601155,2022-06-17
TRANSFER,573526,Mathilde de la Samson,601155,27629,Michelle Samson,1036600,463074,2022-06-17
CASH_IN,233934,Agence_moov_Cotonou,300000,66066,Mathilde de la Samson,27629,261563,2022-06-20
CASH_OUT,36006,Mathilde de la Samson,261563,225557,Agence_moov_Abomey,300000,263994,2022-06-21
CASH_IN,14995,Agence_moov_Abomey,300000,285005,Mathilde de la Samson,225557,240552,2022-06-23
CASH_OUT,59720,Mathilde de la Samson,240552,180832,Agence_moov_Abomey,300000,240280,2022-06-23
CASH_IN,62967,Agence_moov_Cotonou,300000,237033,Mathilde de la Samson,180832,243799,2022-06-24
TRANSFER,10313,Andrée-Thérèse Mendès,75100,64787,Mathilde de la Samson,243799,254112,2022-06-27
CASH_OUT,344180,Paul Rocher-Maillet,477500,133320,Agence_moov_Ouidah,300000,-44180,2022-06-03
CASH_OUT,45853,Paul Rocher-Maillet,133320,87467,Agence_moov_Abomey,300000,254147,2022-06-04
CASH_OUT,77707,Paul Rocher-Maillet,87467,9760,Agence_moov_Abomey,300000,222293,2022-06-05
CASH_OUT,1787,Paul Rocher-Maillet,9760,7973,Agence_moov_Cotonou,300000,298213,2022-06-07
CASH_OUT,1555,Paul Rocher-Maillet,7973,6418,Agence_moov_Ouidah,300000,298445,2022-06-08
CASH_IN,140218,Agence_moov_Ouidah,300000,159782,Paul Rocher-Maillet,6418,146636,2022-06-08
CASH_IN,118555,Agence_moov_Cotonou,300000,181445,Paul Rocher-Maillet,146636,265191,2022-06-09
CASH_OUT,214097,Paul Rocher-Maillet,265191,51094,Agence_moov_Cotonou,300000,85903,2022-06-11
CASH_OUT,14533,Paul Rocher-Maillet,51094,36561,Agence_moov_Cotonou,300000,285467,2022-06-11
CASH_IN,35611,Agence_moov_Cotonou,300000,264389,Paul Rocher-Maillet,36561,72172,2022-06-12
CASH_IN,202188,Agence_moov_Abomey,300000,97812,Paul Rocher-Maillet,72172,274360,2022-06-12
TRANSFER,173320,Paul Rocher-Maillet,274360,101040,Michelle-Dorothée Lévêque,607300,433980,2022-06-15
TRANSFER,48317,Paul Rocher-Maillet,101040,52723,Victor Michel,719600,671283,2022-06-17
CASH_OUT,3943,Paul Rocher-Maillet,52723,48780,Agence_moov_Abomey,300000,296057,2022-06-18
CASH_OUT,43432,Paul Rocher-Maillet,48780,5348,Agence_moov_Abomey,300000,256568,2022-06-19
CASH_IN,266387,Agence_moov_Ouidah,300000,33613,Paul Rocher-Maillet,5348,271735,2022-06-20
CASH_OUT,114174,Paul Rocher-Maillet,271735,157561,Agence_moov_Ouidah,300000,185826,2022-06-21
CASH_OUT,9933,Paul Rocher-Maillet,157561,147628,Agence_moov_Abomey,300000,290067,2022-06-24
CASH_IN,85042,Agence_moov_Cotonou,300000,214958,Paul Rocher-Maillet,147628,232670,2022-06-24
CASH_OUT,50330,Paul Rocher-Maillet,232670,182340,Agence_moov_Abomey,300000,249670,2022-06-26
TRANSFER,482307,Thérèse Hubert,936800,454493,Paul Rocher-Maillet,182340,664647,2022-06-27
CASH_IN,216924,Agence_moov_Abomey,300000,83076,Paul Perez,184400,401324,2022-06-01
CASH_IN,275822,Agence_moov_Ouidah,300000,24178,Paul Perez,401324,677146,2022-06-02
CASH_OUT,336496,Paul Perez,677146,340650,Agence_moov_Ouidah,300000,-36496,2022-06-02
TRANSFER,73994,Aimé Pages,227830,153836,Paul Perez,340650,414644,2022-06-02
CASH_IN,207941,Agence_moov_Ouidah,300000,92059,Paul Perez,414644,622585,2022-06-03
CASH_OUT,378718,Paul Perez,622585,243867,Agence_moov_Ouidah,300000,-78718,2022-06-05
TRANSFER,157167,Paul Perez,243867,86700,Antoinette de Dupuis,82206,-74961,2022-06-05
TRANSFER,777723,Gérard de la Martinez,1065300,287577,Paul Perez,86700,864423,2022-06-05
CASH_OUT,553554,Paul Perez,864423,310869,Agence_moov_Abomey,300000,-253554,2022-06-05
TRANSFER,19817,Paul Perez,310869,291052,Thibaut de la Roy,98702,78885,2022-06-07
CASH_IN,130094,Agence_moov_Ouidah,300000,169906,Paul Perez,291052,421146,2022-06-10
CASH_IN,94902,Agence_moov_Cotonou,300000,205098,Paul Perez,421146,516048,2022-06-10
CASH_IN,161831,Agence_moov_Cotonou,300000,138169,Paul Perez,516048,677879,2022-06-11
CASH_IN,213054,Agence_moov_Abomey,300000,86946,Paul Perez,677879,890933,2022-06-12
TRANSFER,23008,Alphonse Joly,95480,72472,Paul Perez,890933,913941,2022-06-14
CASH_IN,211222,Agence_moov_Abomey,300000,88778,Paul Perez,913941,1125163,2022-06-17
CASH_IN,66090,Agence_moov_Abomey,300000,233910,Paul Perez,1125163,1191253,2022-06-19
TRANSFER,416594,Paul Perez,1191253,774659,Alphonse Joly,72472,-344122,2022-06-19
CASH_IN,193962,Agence_moov_Cotonou,300000,106038,Paul Perez,774659,968621,2022-06-20
TRANSFER,203676,Paul Perez,968621,764945,Gérard de la Martinez,287577,83901,2022-06-21
CASH_IN,45768,Agence_moov_Cotonou,300000,254232,Paul Perez,764945,810713,2022-06-22
TRANSFER,28003,Tristan Bousquet-Gros,317200,289197,Paul Perez,810713,838716,2022-06-23
CASH_IN,118105,Agence_moov_Cotonou,300000,181895,Paul Perez,838716,956821,2022-06-23
CASH_IN,217894,Agence_moov_Abomey,300000,82106,Paul Perez,956821,1174715,2022-06-23
TRANSFER,747151,Paul Perez,1174715,427564,Alphonse Gomes,1142200,395049,2022-06-24
CASH_IN,80071,Agence_moov_Abomey,300000,219929,Paul Perez,427564,507635,2022-06-24
TRANSFER,284367,Noël Bourgeois,673160,388793,Paul Perez,507635,792002,2022-06-25
CASH_IN,26590,Agence_moov_Abomey,300000,273410,Paul Perez,792002,818592,2022-06-27
CASH_OUT,23666,Rémy Grondin,1524000,1500334,Agence_moov_Abomey,300000,276334,2022-06-02
CASH_OUT,281531,Rémy Grondin,1500334,1218803,Agence_moov_Ouidah,300000,18469,2022-06-02
TRANSFER,167524,Aurore Charrier,227163,59639,Rémy Grondin,1218803,1386327,2022-06-02
CASH_OUT,903579,Rémy Grondin,1386327,482748,Agence_moov_Cotonou,300000,-603579,2022-06-03
CASH_OUT,295441,Rémy Grondin,482748,187307,Agence_moov_Cotonou,300000,4559,2022-06-04
CASH_OUT,11700,Rémy Grondin,187307,175607,Agence_moov_Cotonou,300000,288300,2022-06-06
CASH_IN,161248,Agence_moov_Abomey,300000,138752,Rémy Grondin,175607,336855,2022-06-09
TRANSFER,1141018,André Renault,1252900,111882,Rémy Grondin,336855,1477873,2022-06-09
TRANSFER,845437,Bernadette de Jourdan,1933600,1088163,Rémy Grondin,1477873,2323310,2022-06-09
CASH_OUT,391908,Rémy Grondin,2323310,1931402,Agence_moov_Ouidah,300000,-91908,2022-06-09
CASH_OUT,1386181,Rémy Grondin,1931402,545221,Agence_moov_Abomey,300000,-1086181,2022-06-11
CASH_IN,56332,Agence_moov_Abomey,300000,243668,Rémy Grondin,545221,601553,2022-06-11
CASH_IN,247097,Agence_moov_Ouidah,300000,52903,Rémy Grondin,601553,848650,2022-06-12
CASH_OUT,672860,Rémy Grondin,848650,175790,Agence_moov_Cotonou,300000,-372860,2022-06-13
CASH_IN,215571,Agence_moov_Abomey,300000,84429,Rémy Grondin,175790,391361,2022-06-13
CASH_OUT,265760,Rémy Grondin,391361,125601,Agence_moov_Ouidah,300000,34240,2022-06-14
TRANSFER,124028,Rémy Grondin,125601,1573,André Renault,111882,-12146,2022-06-14
TRANSFER,261019,Thérèse Hubert,454493,193474,Rémy Grondin,1573,262592,2022-06-14
CASH_IN,142773,Agence_moov_Ouidah,300000,157227,Rémy Grondin,262592,405365,2022-06-15
CASH_OUT,148483,Rémy Grondin,405365,256882,Agence_moov_Ouidah,300000,151517,2022-06-17
TRANSFER,140633,Rémy Grondin,256882,116249,Tristan Bousquet-Gros,289197,148564,2022-06-19
CASH_IN,283744,Agence_moov_Cotonou,300000,16256,Rémy Grondin,116249,399993,2022-06-21
CASH_OUT,357098,Rémy Grondin,399993,42895,Agence_moov_Cotonou,300000,-57098,2022-06-26
TRANSFER,5570,Rémy Grondin,42895,37325,Michelle-Dorothée Lévêque,433980,428410,2022-06-27
TRANSFER,28426,Alix Barbe,52274,23848,Raymond Lévy,1298700,1327126,2022-06-01
CASH_OUT,63495,Raymond Lévy,1327126,1263631,Agence_moov_Ouidah,300000,236505,2022-06-03
TRANSFER,66293,Raymond Lévy,1263631,1197338,Andrée-Thérèse Mendès,64787,-1506,2022-06-03
CASH_IN,246328,Agence_moov_Abomey,300000,53672,Raymond Lévy,1197338,1443666,2022-06-03
CASH_IN,76341,Agence_moov_Cotonou,300000,223659,Raymond Lévy,1443666,1520007,2022-06-05
CASH_IN,183219,Agence_moov_Cotonou,300000,116781,Raymond Lévy,1520007,1703226,2022-06-09
CASH_IN,221649,Agence_moov_Cotonou,300000,78351,Raymond Lévy,1703226,1924875,2022-06-10
CASH_OUT,628449,Raymond Lévy,1924875,1296426,Agence_moov_Abomey,300000,-328449,2022-06-10
CASH_OUT,677327,Raymond Lévy,1296426,619099,Agence_moov_Ouidah,300000,-377327,2022-06-11
CASH_IN,25100,Agence_moov_Cotonou,300000,274900,Raymond Lévy,619099,644199,2022-06-11
CASH_IN,270610,Agence_moov_Abomey,300000,29390,Raymond Lévy,644199,914809,2022-06-12
TRANSFER,371756,Luc Lévêque-Carre,613400,241644,Raymond Lévy,914809,1286565,2022-06-14
TRANSFER,705976,Raymond Lévy,1286565,580589,Tristan Delahaye,567073,-138903,2022-06-14
CASH_OUT,75048,Raymond Lévy,580589,505541,Agence_moov_Ouidah,300000,224952,2022-06-15
TRANSFER,278912,Thomas Guichard du Renault,297046,18134,Raymond Lévy,505541,784453,2022-06-17
TRANSFER,60419,Emmanuel Grégoire,123318,62899,Raymond Lévy,784453,844872,2022-06-19
CASH_IN,213988,Agence_moov_Ouidah,300000,86012,Raymond Lévy,844872,1058860,2022-06-21
CASH_OUT,744260,Raymond Lévy,1058860,314600,Agence_moov_Abomey,300000,-444260,2022-06-21
TRANSFER,747114,Thomas-Robert Morvan,777300,30186,Raymond Lévy,314600,1061714,2022-06-22
CASH_IN,78634,Agence_moov_Ouidah,300000,221366,Raymond Lévy,1061714,1140348,2022-06-23
CASH_OUT,822371,Raymond Lévy,1140348,317977,Agence_moov_Cotonou,300000,-522371,2022-06-24
CASH_OUT,311498,Raymond Lévy,317977,6479,Agence_moov_Cotonou,300000,-11498,2022-06-25
TRANSFER,5065,Raymond Lévy,6479,1414,Martine Aubert,220105,215040,2022-06-25
TRANSFER,74234,Tristan Bousquet-Gros,148564,74330,Raymond Lévy,1414,75648,2022-06-26
CASH_IN,48009,Agence_moov_Cotonou,300000,251991,Raymond Lévy,75648,123657,2022-06-27
CASH_IN,48291,Agence_moov_Cotonou,300000,251709,Tristan Delahaye,-138903,-90612,2022-06-01
CASH_IN,35508,Agence_moov_Ouidah,300000,264492,Tristan Delahaye,-90612,-55104,2022-06-01
CASH_IN,274072,Agence_moov_Ouidah,300000,25928,Tristan Delahaye,-55104,218968,2022-06-01
CASH_OUT,118477,Tristan Delahaye,218968,100491,Agence_moov_Abomey,300000,181523,2022-06-03
CASH_IN,155214,Agence_moov_Ouidah,300000,144786,Tristan Delahaye,100491,255705,2022-06-03
CASH_IN,182520,Agence_moov_Cotonou,300000,117480,Tristan Delahaye,255705,438225,2022-06-05
TRANSFER,126685,Tristan Delahaye,438225,311540,Noël Bourgeois,388793,262108,2022-06-05
CASH_IN,4397,Agence_moov_Abomey,300000,295603,Tristan Delahaye,311540,315937,2022-06-06
TRANSFER,43943,Aimé Pages,153836,109893,Tristan Delahaye,315937,359880,2022-06-07
CASH_OUT,136117,Tristan Delahaye,359880,223763,Agence_moov_Cotonou,300000,163883,2022-06-08
CASH_OUT,220159,Tristan Delahaye,223763,3604,Agence_moov_Abomey,300000,79841,2022-06-08
CASH_OUT,1805,Tristan Delahaye,3604,1799,Agence_moov_Cotonou,300000,298195,2022-06-10
CASH_OUT,1538,Tristan Delahaye,1799,261,Agence_moov_Abomey,300000,298462,2022-06-10
CASH_IN,286409,Agence_moov_Ouidah,300000,13591,Tristan Delahaye,261,286670,2022-06-14
TRANSFER,90835,Tristan Delahaye,286670,195835,Aimé Pages,109893,19058,2022-06-14
TRANSFER,34579,Constance Guillon,105219,70640,Tristan Delahaye,195835,230414,2022-06-17
CASH_IN,171996,Agence_moov_Abomey,300000,128004,Tristan Delahaye,230414,402410,2022-06-17
CASH_IN,79754,Agence_moov_Ouidah,300000,220246,Tristan Delahaye,402410,482164,2022-06-18
CASH_OUT,222255,Tristan Delahaye,482164,259909,Agence_moov_Abomey,300000,77745,2022-06-19
CASH_IN,97960,Agence_moov_Ouidah,300000,202040,Tristan Delahaye,259909,357869,2022-06-19
TRANSFER,124725,Tristan Delahaye,357869,233144,Manon Chevalier,332563,207838,2022-06-19
TRANSFER,269047,Timothée-René Blanchard,286427,17380,Tristan Delahaye,233144,502191,2022-06-20
CASH_OUT,340569,Tristan Delahaye,502191,161622,Agence_moov_Ouidah,300000,-40569,2022-06-21
TRANSFER,40224,Sabine Pineau,201948,161724,Tristan Delahaye,161622,201846,2022-06-21
CASH_IN,109604,Agence_moov_Abomey,300000,190396,Tristan Delahaye,201846,311450,2022-06-22
CASH_OUT,2704,Tristan Delahaye,311450,308746,Agence_moov_Ouidah,300000,297296,2022-06-23
TRANSFER,138394,Manon Chevalier,207838,69444,Tristan Delahaye,308746,447140,2022-06-25
CASH_OUT,417633,Tristan Delahaye,447140,29507,Agence_moov_Cotonou,300000,-117633,2022-06-26
CASH_IN,221586,Agence_moov_Cotonou,300000,78414,Émile-René Baudry,850889,1072475,2022-06-04
CASH_IN,20326,Agence_moov_Cotonou,300000,279674,Émile-René Baudry,1072475,1092801,2022-06-07
TRANSFER,305686,Émile-René Baudry,1092801,787115,Thibaut de la Roy,78885,-226801,2022-06-08
CASH_IN,112072,Agence_moov_Abomey,300000,187928,Émile-René Baudry,787115,899187,2022-06-08
CASH_OUT,302083,Émile-René Baudry,899187,597104,Agence_moov_Abomey,300000,-2083,2022-06-11
CASH_OUT,114851,Émile-René Baudry,597104,482253,Agence_moov_Cotonou,300000,185149,2022-06-11
TRANSFER,198133,Émile-René Baudry,482253,284120,Bernadette de Jourdan,1088163,890030,2022-06-12
CASH_OUT,11247,Émile-René Baudry,284120,272873,Agence_moov_Cotonou,300000,288753,2022-06-14
TRANSFER,26424,Émile-René Baudry,272873,246449,Thomas Dupont,1746900,1720476,2022-06-15
CASH_OUT,207015,Émile-René Baudry,246449,39434,Agence_moov_Ouidah,300000,92985,2022-06-15
CASH_IN,31840,Agence_moov_Cotonou,300000,268160,Émile-René Baudry,39434,71274,2022-06-15
TRANSFER,4766,Agnès Le Giraud,14541,9775,Émile-René Baudry,71274,76040,2022-06-15
CASH_IN,110056,Agence_moov_Cotonou,300000,189944,Émile-René Baudry,76040,186096,2022-06-16
CASH_OUT,114714,Émile-René Baudry,186096,71382,Agence_moov_Ouidah,300000,185286,2022-06-17
TRANSFER,1082280,Jules-Roland Bousquet,1418200,335920,Émile-René Baudry,71382,1153662,2022-06-18
CASH_IN,258014,Agence_moov_Ouidah,300000,41986,Émile-René Baudry,1153662,1411676,2022-06-19
CASH_IN,10725,Agence_moov_Ouidah,300000,289275,Émile-René Baudry,1411676,1422401,2022-06-20
TRANSFER,276022,Émile-René Baudry,1422401,1146379,Emmanuel Grégoire,62899,-213123,2022-06-22
CASH_IN,107953,Agence_moov_Ouidah,300000,192047,Émile-René Baudry,1146379,1254332,2022-06-24
TRANSFER,1176,Alix Barbe,23848,22672,Émile-René Baudry,1254332,1255508,2022-06-25
TRANSFER,283774,Émile-René Baudry,1255508,971734,Jules-Roland Bousquet,335920,52146,2022-06-25
CASH_IN,63971,Agence_moov_Cotonou,300000,236029,Victor Michel,671283,735254,2022-06-02
CASH_OUT,164460,Victor Michel,735254,570794,Agence_moov_Ouidah,300000,135540,2022-06-02
CASH_OUT,168190,Victor Michel,570794,402604,Agence_moov_Ouidah,300000,131810,2022-06-02
TRANSFER,333188,Michelle Samson,463074,129886,Victor Michel,402604,735792,2022-06-03
TRANSFER,88876,Victor Michel,735792,646916,Anastasie Cousin,206400,117524,2022-06-07
CASH_IN,146641,Agence_moov_Abomey,300000,153359,Victor Michel,646916,793557,2022-06-08
TRANSFER,555667,Victor Michel,793557,237890,Timothée-René Blanchard,17380,-538287,2022-06-09
CASH_OUT,71310,Victor Michel,237890,166580,Agence_moov_Ouidah,300000,228690,2022-06-10
CASH_IN,66478,Agence_moov_Abomey,300000,233522,Victor Michel,166580,233058,2022-06-10
CASH_IN,193057,Agence_moov_Ouidah,300000,106943,Victor Michel,233058,426115,2022-06-11
CASH_IN,192934,Agence_moov_Abomey,300000,107066,Victor Michel,426115,619049,2022-06-12
TRANSFER,439689,Robert Clerc,813508,373819,Victor Michel,619049,1058738,2022-06-12
CASH_IN,260000,Agence_moov_Cotonou,300000,40000,Victor Michel,1058738,1318738,2022-06-13
CASH_IN,90121,Agence_moov_Ouidah,300000,209879,Victor Michel,1318738,1408859,2022-06-15
CASH_IN,79401,Agence_moov_Ouidah,300000,220599,Victor Michel,1408859,1488260,2022-06-16
TRANSFER,767231,Victor Michel,1488260,721029,Martine Aubert,215040,-552191,2022-06-18
CASH_OUT,318882,Victor Michel,721029,402147,Agence_moov_Ouidah,300000,-18882,2022-06-19
CASH_OUT,401658,Victor Michel,402147,489,Agence_moov_Ouidah,300000,-101658,2022-06-21
TRANSFER,93667,Alphonse Gomes,395049,301382,Victor Michel,489,94156,2022-06-23
TRANSFER,1426,Victor Michel,94156,92730,Clémence-Véronique Munoz,305681,304255,2022-06-25
CASH_OUT,51471,Victor Michel,92730,41259,Agence_moov_Abomey,300000,248529,2022-06-25
TRANSFER,168243,Mathilde Picard du Delmas,1967000,1798757,Victor Michel,41259,209502,2022-06-26
TRANSFER,63419,Manon Chevalier,69444,6025,Victor Michel,209502,272921,2022-06-27
CASH_OUT,30235,Victor Michel,272921,242686,Agence_moov_Cotonou,300000,269765,2022-06-27
CASH_IN,96985,Agence_moov_Cotonou,300000,203015,Martine Aubert,-552191,-455206,2022-06-01
CASH_IN,105316,Agence_moov_Cotonou,300000,194684,Martine Aubert,-455206,-349890,2022-06-02
CASH_IN,195897,Agence_moov_Ouidah,300000,104103,Martine Aubert,-349890,-153993,2022-06-03
CASH_IN,9279,Agence_moov_Ouidah,300000,290721,Martine Aubert,-153993,-144714,2022-06-03
CASH_IN,274107,Agence_moov_Cotonou,300000,25893,Martine Aubert,-144714,129393,2022-06-05
CASH_IN,150149,Agence_moov_Abomey,300000,149851,Martine Aubert,129393,279542,2022-06-06
CASH_IN,82166,Agence_moov_Cotonou,300000,217834,Martine Aubert,279542,361708,2022-06-07
TRANSFER,55614,Michelle Samson,129886,74272,Martine Aubert,361708,417322,2022-06-07
CASH_OUT,120142,Martine Aubert,417322,297180,Agence_moov_Abomey,300000,179858,2022-06-09
CASH_IN,141529,Agence_moov_Cotonou,300000,158471,Martine Aubert,297180,438709,2022-06-10
CASH_IN,297590,Agence_moov_Abomey,300000,2410,Martine Aubert,438709,736299,2022-06-14
TRANSFER,579013,Martine Aubert,736299,157286,Aurore Charrier,59639,-519374,2022-06-15
TRANSFER,266875,Renée Rousseau-Henry,612300,345425,Martine Aubert,157286,424161,2022-06-16
CASH_IN,164345,Agence_moov_Cotonou,300000,135655,Martine Aubert,424161,588506,2022-06-17
CASH_IN,47346,Agence_moov_Ouidah,300000,252654,Martine Aubert,588506,635852,2022-06-17
CASH_OUT,292062,Martine Aubert,635852,343790,Agence_moov_Abomey,300000,7938,2022-06-17
TRANSFER,294606,Martine Aubert,343790,49184,Simone Muller de la Brun,150986,-143620,2022-06-17
CASH_OUT,19655,Martine Aubert,49184,29529,Agence_moov_Abomey,300000,280345,2022-06-18
CASH_OUT,19752,Martine Aubert,29529,9777,Agence_moov_Abomey,300000,280248,2022-06-18
CASH_OUT,7457,Martine Aubert,9777,2320,Agence_moov_Abomey,300000,292543,2022-06-18
CASH_IN,86710,Agence_moov_Cotonou,300000,213290,Martine Aubert,2320,89030,2022-06-19
CASH_OUT,40149,Martine Aubert,89030,48881,Agence_moov_Cotonou,300000,259851,2022-06-20
CASH_OUT,32795,Martine Aubert,48881,16086,Agence_moov_Cotonou,300000,267205,2022-06-21
TRANSFER,220,Martine Aubert,16086,15866,Richard Le Lévêque,87215,86995,2022-06-23
CASH_IN,245676,Agence_moov_Cotonou,300000,54324,Martine Aubert,15866,261542,2022-06-25
TRANSFER,11618,Robert Clerc,373819,362201,Martine Aubert,261542,273160,2022-06-25
CASH_OUT,176452,Martine Aubert,273160,96708,Agence_moov_Cotonou,300000,123548,2022-06-25
TRANSFER,15213,Thomas Guichard du Renault,18134,2921,Martine Aubert,96708,111921,2022-06-25
TRANSFER,52513,Tristan Bousquet-Gros,74330,21817,Martine Aubert,111921,164434,2022-06-25
TRANSFER,154718,Martine Aubert,164434,9716,Nath Loiseau,228110,73392,2022-06-26
TRANSFER,774688,Bertrand Regnier,837499,62811,Agnès Le Giraud,9775,784463,2022-06-01
CASH_OUT,733649,Agnès Le Giraud,784463,50814,Agence_moov_Abomey,300000,-433649,2022-06-01
CASH_OUT,29592,Agnès Le Giraud,50814,21222,Agence_moov_Abomey,300000,270408,2022-06-02
TRANSFER,4939,Agnès Le Giraud,21222,16283,Gabriel Bègue,1289300,1284361,2022-06-03
TRANSFER,337,Agnès Le Giraud,16283,15946,Aimé Pages,19058,18721,2022-06-03
CASH_OUT,8299,Agnès Le Giraud,15946,7647,Agence_moov_Ouidah,300000,291701,2022-06-03
CASH_OUT,4808,Agnès Le Giraud,7647,2839,Agence_moov_Ouidah,300000,295192,2022-06-03
CASH_OUT,1824,Agnès Le Giraud,2839,1015,Agence_moov_Ouidah,300000,298176,2022-06-05
CASH_IN,113390,Agence_moov_Abomey,300000,186610,Agnès Le Giraud,1015,114405,2022-06-05
CASH_OUT,101349,Agnès Le Giraud,114405,13056,Agence_moov_Ouidah,300000,198651,2022-06-08
TRANSFER,9309,Agnès Le Giraud,13056,3747,Bertrand Regnier,62811,53502,2022-06-08
CASH_IN,135298,Agence_moov_Abomey,300000,164702,Agnès Le Giraud,3747,139045,2022-06-10
CASH_OUT,54420,Agnès Le Giraud,139045,84625,Agence_moov_Abomey,300000,245580,2022-06-12
CASH_IN,219611,Agence_moov_Abomey,300000,80389,Agnès Le Giraud,84625,304236,2022-06-12
TRANSFER,266262,Agnès Le Giraud,304236,37974,Alix Barbe,22672,-243590,2022-06-16
TRANSFER,35291,Agnès Le Giraud,37974,2683,Colette-Sophie Prévost,283140,247849,2022-06-18
CASH_IN,220955,Agence_moov_Abomey,300000,79045,Agnès Le Giraud,2683,223638,2022-06-18
CASH_IN,258999,Agence_moov_Cotonou,300000,41001,Agnès Le Giraud,223638,482637,2022-06-19
CASH_IN,70684,Agence_moov_Abomey,300000,229316,Agnès Le Giraud,482637,553321,2022-06-19
TRANSFER,452894,Agnès Le Giraud,553321,100427,Luc Lévêque-Carre,241644,-211250,2022-06-21
CASH_OUT,74296,Agnès Le Giraud,100427,26131,Agence_moov_Abomey,300000,225704,2022-06-22
CASH_OUT,21024,Agnès Le Giraud,26131,5107,Agence_moov_Ouidah,300000,278976,2022-06-22
CASH_IN,78039,Agence_moov_Abomey,300000,221961,Agnès Le Giraud,5107,83146,2022-06-22
CASH_OUT,18579,Agnès Le Giraud,83146,64567,Agence_moov_Cotonou,300000,281421,2022-06-22
CASH_IN,287059,Agence_moov_Ouidah,300000,12941,Agnès Le Giraud,64567,351626,2022-06-25
TRANSFER,12894,Nath Loiseau,73392,60498,Agnès Le Giraud,351626,364520,2022-06-26
TRANSFER,59757,Agnès Le Giraud,364520,304763,Noël Bourgeois,262108,202351,2022-06-27
TRANSFER,116506,Renée Rousseau-Henry,345425,228919,Constance Bourdon-Millet,74269,-42237,2022-06-02
CASH_OUT,430,Renée Rousseau-Henry,228919,228489,Agence_moov_Cotonou,300000,299570,2022-06-03
CASH_OUT,100608,Renée Rousseau-Henry,228489,127881,Agence_moov_Ouidah,300000,199392,2022-06-04
CASH_IN,147016,Agence_moov_Ouidah,300000,152984,Renée Rousseau-Henry,127881,274897,2022-06-05
CASH_OUT,166586,Renée Rousseau-Henry,274897,108311,Agence_moov_Abomey,300000,133414,2022-06-05
TRANSFER,98435,Renée Rousseau-Henry,108311,9876,Richard Le Lévêque,86995,-11440,2022-06-06
CASH_OUT,4396,Renée Rousseau-Henry,9876,5480,Agence_moov_Ouidah,300000,295604,2022-06-08
TRANSFER,607477,Françoise Morin,1660794,1053317,Renée Rousseau-Henry,5480,612957,2022-06-10
CASH_IN,254390,Agence_moov_Cotonou,300000,45610,Renée Rousseau-Henry,612957,867347,2022-06-10
TRANSFER,1221014,Jules Fernandes,1265682,44668,Renée Rousseau-Henry,867347,2088361,2022-06-10
TRANSFER,5032,Jules Fernandes,44668,39636,Renée Rousseau-Henry,2088361,2093393,2022-06-12
CASH_IN,570,Agence_moov_Abomey,300000,299430,Renée Rousseau-Henry,2093393,2093963,2022-06-14
TRANSFER,1496725,Renée Rousseau-Henry,2093963,597238,Thérèse Hubert,193474,-1303251,2022-06-16
CASH_IN,199672,Agence_moov_Cotonou,300000,100328,Renée Rousseau-Henry,597238,796910,2022-06-16
CASH_OUT,739203,Renée Rousseau-Henry,796910,57707,Agence_moov_Cotonou,300000,-439203,2022-06-16
TRANSFER,2258,Thomas Guichard du Renault,2921,663,Renée Rousseau-Henry,57707,59965,2022-06-17
CASH_IN,266327,Agence_moov_Cotonou,300000,33673,Renée Rousseau-Henry,59965,326292,2022-06-20
TRANSFER,228683,Renée Rousseau-Henry,326292,97609,Gabriel Bègue,1284361,1055678,2022-06-21
TRANSFER,43991,Renée Rousseau-Henry,97609,53618,Manon Chevalier,6025,-37966,2022-06-22
CASH_OUT,38888,Renée Rousseau-Henry,53618,14730,Agence_moov_Ouidah,300000,261112,2022-06-24
CASH_OUT,13546,Renée Rousseau-Henry,14730,1184,Agence_moov_Ouidah,300000,286454,2022-06-24
CASH_IN,16961,Agence_moov_Ouidah,300000,283039,Renée Rousseau-Henry,1184,18145,2022-06-25
CASH_IN,97465,Agence_moov_Ouidah,300000,202535,Renée Rousseau-Henry,18145,115610,2022-06-25
CASH_OUT,41574,Renée Rousseau-Henry,115610,74036,Agence_moov_Abomey,300000,258426,2022-06-26
CASH_IN,295051,Agence_moov_Cotonou,300000,4949,Renée Rousseau-Henry,74036,369087,2022-06-26
CASH_IN,97336,Agence_moov_Cotonou,300000,202664,Aurore Charrier,-519374,-422038,2022-06-03
CASH_IN,108417,Agence_moov_Ouidah,300000,191583,Aurore Charrier,-422038,-313621,2022-06-03
CASH_IN,205201,Agence_moov_Cotonou,300000,94799,Aurore Charrier,-313621,-108420,2022-06-06
CASH_IN,11000,Agence_moov_Cotonou,300000,289000,Aurore Charrier,-108420,-97420,2022-06-07
CASH_IN,84656,Agence_moov_Ouidah,300000,215344,Aurore Charrier,-97420,-12764,2022-06-07
CASH_IN,21221,Agence_moov_Cotonou,300000,278779,Aurore Charrier,-12764,8457,2022-06-09
CASH_IN,129700,Agence_moov_Cotonou,300000,170300,Aurore Charrier,8457,138157,2022-06-10
CASH_OUT,71168,Aurore Charrier,138157,66989,Agence_moov_Ouidah,300000,228832,2022-06-10
CASH_OUT,60686,Aurore Charrier,66989,6303,Agence_moov_Ouidah,300000,239314,2022-06-11
TRANSFER,838995,Bernadette de Jourdan,890030,51035,Aurore Charrier,6303,845298,2022-06-12
TRANSFER,819907,Aurore Charrier,845298,25391,Manon Lebon,650200,-169707,2022-06-12
CASH_IN,69934,Agence_moov_Abomey,300000,230066,Aurore Charrier,25391,95325,2022-06-12
TRANSFER,13715,Robert Clerc,362201,348486,Aurore Charrier,95325,109040,2022-06-14
CASH_IN,21116,Agence_moov_Ouidah,300000,278884,Aurore Charrier,109040,130156,2022-06-15
CASH_OUT,13996,Aurore Charrier,130156,116160,Agence_moov_Ouidah,300000,286004,2022-06-15
CASH_IN,45056,Agence_moov_Cotonou,300000,254944,Aurore Charrier,116160,161216,2022-06-18
CASH_OUT,47766,Aurore Charrier,161216,113450,Agence_moov_Ouidah,300000,252234,2022-06-19
TRANSFER,110228,Aurore Charrier,113450,3222,Aimé Pages,18721,-91507,2022-06-19
CASH_IN,194449,Agence_moov_Abomey,300000,105551,Aurore Charrier,3222,197671,2022-06-22
CASH_OUT,75751,Aurore Charrier,197671,121920,Agence_moov_Abomey,300000,224249,2022-06-24
CASH_IN,162256,Agence_moov_Ouidah,300000,137744,Aurore Charrier,121920,284176,2022-06-24
CASH_OUT,63942,Aurore Charrier,284176,220234,Agence_moov_Cotonou,300000,236058,2022-06-25
CASH_IN,222936,Agence_moov_Abomey,300000,77064,Aurore Charrier,220234,443170,2022-06-26
CASH_IN,114680,Agence_moov_Abomey,300000,185320,Aurore Charrier,443170,557850,2022-06-26
CASH_OUT,324554,Aurore Charrier,557850,233296,Agence_moov_Ouidah,300000,-24554,2022-06-27
CASH_IN,267246,Agence_moov_Abomey,300000,32754,Aurore Charrier,233296,500542,2022-06-27
CASH_IN,18898,Agence_moov_Ouidah,300000,281102,Théodore Joseph-Lefebvre,980580,999478,2022-06-01
CASH_IN,216487,Agence_moov_Cotonou,300000,83513,Théodore Joseph-Lefebvre,999478,1215965,2022-06-04
TRANSFER,566224,Théodore Joseph-Lefebvre,1215965,649741,Colette-Sophie Prévost,247849,-318375,2022-06-05
CASH_IN,164788,Agence_moov_Abomey,300000,135212,Théodore Joseph-Lefebvre,649741,814529,2022-06-06
TRANSFER,57008,Constance Guillon,70640,13632,Théodore Joseph-Lefebvre,814529,871537,2022-06-07
CASH_IN,82553,Agence_moov_Abomey,300000,217447,Théodore Joseph-Lefebvre,871537,954090,2022-06-07
CASH_OUT,496896,Théodore Joseph-Lefebvre,954090,457194,Agence_moov_Abomey,300000,-196896,2022-06-09
CASH_OUT,330673,Théodore Joseph-Lefebvre,457194,126521,Agence_moov_Cotonou,300000,-30673,2022-06-10
CASH_IN,148320,Agence_moov_Ouidah,300000,151680,Théodore Joseph-Lefebvre,126521,274841,2022-06-11
TRANSFER,206384,Théodore Joseph-Lefebvre,274841,68457,Gabriel Bègue,1055678,849294,2022-06-12
CASH_OUT,33305,Théodore Joseph-Lefebvre,68457,35152,Agence_moov_Cotonou,300000,266695,2022-06-12
CASH_IN,21685,Agence_moov_Cotonou,300000,278315,Théodore Joseph-Lefebvre,35152,56837,2022-06-13
TRANSFER,6666,Constance Guillon,13632,6966,Théodore Joseph-Lefebvre,56837,63503,2022-06-15
TRANSFER,99756,Robert Clerc,348486,248730,Théodore Joseph-Lefebvre,63503,163259,2022-06-16
CASH_OUT,34095,Théodore Joseph-Lefebvre,163259,129164,Agence_moov_Ouidah,300000,265905,2022-06-18
CASH_IN,37182,Agence_moov_Cotonou,300000,262818,Théodore Joseph-Lefebvre,129164,166346,2022-06-19
CASH_IN,89910,Agence_moov_Abomey,300000,210090,Théodore Joseph-Lefebvre,166346,256256,2022-06-19
CASH_OUT,245678,Théodore Joseph-Lefebvre,256256,10578,Agence_moov_Cotonou,300000,54322,2022-06-19
TRANSFER,32274,Jules-Roland Bousquet,52146,19872,Théodore Joseph-Lefebvre,10578,42852,2022-06-20
TRANSFER,20421,Théodore Joseph-Lefebvre,42852,22431,Théodore Joseph-Lefebvre,42852,22431,2022-06-21
CASH_IN,164637,Agence_moov_Cotonou,300000,135363,Théodore Joseph-Lefebvre,22431,187068,2022-06-21
CASH_IN,44790,Agence_moov_Ouidah,300000,255210,Théodore Joseph-Lefebvre,187068,231858,2022-06-21
TRANSFER,331791,Robert-Louis Gosselin,336567,4776,Théodore Joseph-Lefebvre,231858,563649,2022-06-22
TRANSFER,199277,Théodore Joseph-Lefebvre,563649,364372,Robert-Louis Gosselin,4776,-194501,2022-06-23
CASH_IN,256634,Agence_moov_Ouidah,300000,43366,Théodore Joseph-Lefebvre,364372,621006,2022-06-24
CASH_OUT,6098,Théodore Joseph-Lefebvre,621006,614908,Agence_moov_Ouidah,300000,293902,2022-06-24
CASH_IN,1284,Agence_moov_Ouidah,300000,298716,Gérard de la Martinez,83901,85185,2022-06-01
CASH_IN,278441,Agence_moov_Ouidah,300000,21559,Gérard de la Martinez,85185,363626,2022-06-03
CASH_IN,150048,Agence_moov_Abomey,300000,149952,Gérard de la Martinez,363626,513674,2022-06-04
TRANSFER,320155,Gérard de la Martinez,513674,193519,Clémence-Véronique Munoz,304255,-15900,2022-06-07
CASH_IN,146143,Agence_moov_Ouidah,300000,153857,Gérard de la Martinez,193519,339662,2022-06-07
CASH_IN,145309,Agence_moov_Abomey,300000,154691,Gérard de la Martinez,339662,484971,2022-06-07
CASH_OUT,434490,Gérard de la Martinez,484971,50481,Agence_moov_Ouidah,300000,-134490,2022-06-09
CASH_IN,55121,Agence_moov_Ouidah,300000,244879,Gérard de la Martinez,50481,105602,2022-06-09
CASH_OUT,95489,Gérard de la Martinez,105602,10113,Agence_moov_Abomey,300000,204511,2022-06-10
TRANSFER,7727,Gérard de la Martinez,10113,2386,Anastasie Cousin,117524,109797,2022-06-14
TRANSFER,1322,Gérard de la Martinez,2386,1064,Bernadette de Jourdan,51035,49713,2022-06-15
CASH_IN,287464,Agence_moov_Abomey,300000,12536,Gérard de la Martinez,1064,288528,2022-06-17
TRANSFER,170723,Noël Bourgeois,202351,31628,Gérard de la Martinez,288528,459251,2022-06-18
CASH_OUT,164311,Gérard de la Martinez,459251,294940,Agence_moov_Ouidah,300000,135689,2022-06-19
CASH_OUT,147292,Gérard de la Martinez,294940,147648,Agence_moov_Cotonou,300000,152708,2022-06-20
TRANSFER,78687,Gérard de la Martinez,147648,68961,Noël Bourgeois,31628,-47059,2022-06-20
CASH_IN,246451,Agence_moov_Cotonou,300000,53549,Gérard de la Martinez,68961,315412,2022-06-22
CASH_OUT,183653,Gérard de la Martinez,315412,131759,Agence_moov_Cotonou,300000,116347,2022-06-25
TRANSFER,21484,Thomas Dupont,1720476,1698992,Gérard de la Martinez,131759,153243,2022-06-26
CASH_IN,75139,Agence_moov_Cotonou,300000,224861,Gérard de la Martinez,153243,228382,2022-06-26
TRANSFER,118423,Gérard de la Martinez,228382,109959,Robert Clerc,248730,130307,2022-06-26
CASH_OUT,99531,Gérard de la Martinez,109959,10428,Agence_moov_Cotonou,300000,200469,2022-06-27
CASH_IN,151066,Agence_moov_Abomey,300000,148934,André Renault,-12146,138920,2022-06-01
CASH_IN,233463,Agence_moov_Ouidah,300000,66537,André Renault,138920,372383,2022-06-03
CASH_OUT,254240,André Renault,372383,118143,Agence_moov_Cotonou,300000,45760,2022-06-04
TRANSFER,634691,Véronique Martins de Fleury,1385805,751114,André Renault,118143,752834,2022-06-05
TRANSFER,88430,André Renault,752834,664404,Jules Fernandes,39636,-48794,2022-06-05
CASH_OUT,426744,André Renault,664404,237660,Agence_moov_Abomey,300000,-126744,2022-06-05
CASH_OUT,192048,André Renault,237660,45612,Agence_moov_Ouidah,300000,107952,2022-06-06
TRANSFER,25884,André Renault,45612,19728,Véronique Martins de Fleury,751114,725230,2022-06-08
CASH_OUT,15833,André Renault,19728,3895,Agence_moov_Ouidah,300000,284167,2022-06-08
CASH_IN,273367,Agence_moov_Cotonou,300000,26633,André Renault,3895,277262,2022-06-10
CASH_IN,156077,Agence_moov_Cotonou,300000,143923,André Renault,277262,433339,2022-06-10
CASH_IN,78318,Agence_moov_Cotonou,300000,221682,André Renault,433339,511657,2022-06-11
CASH_OUT,115269,André Renault,511657,396388,Agence_moov_Ouidah,300000,184731,2022-06-12
TRANSFER,158288,Gabriel Bègue,849294,691006,André Renault,396388,554676,2022-06-15
TRANSFER,429394,André Renault,554676,125282,Gabriel Bègue,691006,261612,2022-06-16
CASH_IN,4611,Agence_moov_Ouidah,300000,295389,André Renault,125282,129893,2022-06-16
TRANSFER,77423,André Renault,129893,52470,Nath Loiseau,60498,-16925,2022-06-17
TRANSFER,244656,Alphonse Gomes,301382,56726,André Renault,52470,297126,2022-06-17
TRANSFER,228300,Gabriel Bègue,261612,33312,André Renault,297126,525426,2022-06-18
TRANSFER,60819,Robert Clerc,130307,69488,André Renault,525426,586245,2022-06-19
TRANSFER,601095,Véronique Martins de Fleury,725230,124135,André Renault,586245,1187340,2022-06-21
CASH_OUT,1076573,André Renault,1187340,110767,Agence_moov_Ouidah,300000,-776573,2022-06-22
TRANSFER,92830,André Renault,110767,17937,Alphonse Gomes,56726,-36104,2022-06-25
CASH_OUT,14696,André Renault,17937,3241,Agence_moov_Cotonou,300000,285304,2022-06-26
TRANSFER,1654,André Renault,3241,1587,Françoise Morin,1053317,1051663,2022-06-27
CASH_OUT,10563,Bernadette de Jourdan,49713,39150,Agence_moov_Ouidah,300000,289437,2022-06-01
TRANSFER,138767,Frédéric Guillou,691500,552733,Bernadette de Jourdan,39150,177917,2022-06-03
CASH_IN,126879,Agence_moov_Ouidah,300000,173121,Bernadette de Jourdan,177917,304796,2022-06-04
CASH_OUT,209305,Bernadette de Jourdan,304796,95491,Agence_moov_Abomey,300000,90695,2022-06-05
CASH_OUT,87428,Bernadette de Jourdan,95491,8063,Agence_moov_Abomey,300000,212572,2022-06-05
CASH_OUT,2303,Bernadette de Jourdan,8063,5760,Agence_moov_Cotonou,300000,297697,2022-06-06
CASH_IN,144989,Agence_moov_Ouidah,300000,155011,Bernadette de Jourdan,5760,150749,2022-06-07
CASH_OUT,121876,Bernadette de Jourdan,150749,28873,Agence_moov_Cotonou,300000,178124,2022-06-08
TRANSFER,44004,Robert Clerc,69488,25484,Bernadette de Jourdan,28873,72877,2022-06-11
CASH_IN,231482,Agence_moov_Abomey,300000,68518,Bernadette de Jourdan,72877,304359,2022-06-11
CASH_OUT,123359,Bernadette de Jourdan,304359,181000,Agence_moov_Cotonou,300000,176641,2022-06-11
CASH_OUT,1025,Bernadette de Jourdan,181000,179975,Agence_moov_Cotonou,300000,298975,2022-06-13
TRANSFER,15553,Jules-Roland Bousquet,19872,4319,Bernadette de Jourdan,179975,195528,2022-06-13
TRANSFER,3169,Constance Guillon,6966,3797,Bernadette de Jourdan,195528,198697,2022-06-13
TRANSFER,86251,Bernadette de Jourdan,198697,112446,Michelle Samson,74272,-11979,2022-06-15
CASH_OUT,103817,Bernadette de Jourdan,112446,8629,Agence_moov_Ouidah,300000,196183,2022-06-16
TRANSFER,545,Thomas Guichard du Renault,663,118,Bernadette de Jourdan,8629,9174,2022-06-19
TRANSFER,7035,Bernadette de Jourdan,9174,2139,Bernadette de Jourdan,9174,16209,2022-06-19
CASH_OUT,351,Bernadette de Jourdan,2139,1788,Agence_moov_Abomey,300000,299649,2022-06-20
TRANSFER,2113,Jules-Roland Bousquet,4319,2206,Bernadette de Jourdan,1788,3901,2022-06-20
CASH_IN,48485,Agence_moov_Abomey,300000,251515,Bernadette de Jourdan,3901,52386,2022-06-21
TRANSFER,111,Thomas Guichard du Renault,118,7,Bernadette de Jourdan,52386,52497,2022-06-24
TRANSFER,44017,Bernadette de Jourdan,52497,8480,Mathilde Picard du Delmas,1798757,1754740,2022-06-25
CASH_IN,264964,Agence_moov_Cotonou,300000,35036,Bernadette de Jourdan,8480,273444,2022-06-25
CASH_OUT,188143,Bernadette de Jourdan,273444,85301,Agence_moov_Ouidah,300000,111857,2022-06-26
CASH_OUT,6695,Bernadette de Jourdan,85301,78606,Agence_moov_Ouidah,300000,293305,2022-06-27
CASH_OUT,171761,Michelle-Dorothée Lévêque,428410,256649,Agence_moov_Cotonou,300000,128239,2022-06-01
CASH_IN,47357,Agence_moov_Cotonou,300000,252643,Michelle-Dorothée Lévêque,256649,304006,2022-06-03
TRANSFER,2678,Tristan Bousquet-Gros,21817,19139,Michelle-Dorothée Lévêque,304006,306684,2022-06-05
CASH_IN,101069,Agence_moov_Abomey,300000,198931,Michelle-Dorothée Lévêque,306684,407753,2022-06-05
TRANSFER,349237,Michelle-Dorothée Lévêque,407753,58516,Mathilde Picard du Delmas,1754740,1405503,2022-06-08
CASH_IN,13601,Agence_moov_Cotonou,300000,286399,Michelle-Dorothée Lévêque,58516,72117,2022-06-10
TRANSFER,62860,Michelle-Dorothée Lévêque,72117,9257,Michelle-Dorothée Lévêque,72117,134977,2022-06-14
CASH_IN,175816,Agence_moov_Ouidah,300000,124184,Michelle-Dorothée Lévêque,9257,185073,2022-06-14
CASH_OUT,4225,Michelle-Dorothée Lévêque,185073,180848,Agence_moov_Cotonou,300000,295775,2022-06-14
CASH_IN,100858,Agence_moov_Abomey,300000,199142,Michelle-Dorothée Lévêque,180848,281706,2022-06-16
CASH_IN,237185,Agence_moov_Abomey,300000,62815,Michelle-Dorothée Lévêque,281706,518891,2022-06-17
CASH_OUT,464260,Michelle-Dorothée Lévêque,518891,54631,Agence_moov_Abomey,300000,-164260,2022-06-21
TRANSFER,113068,Véronique Martins de Fleury,124135,11067,Michelle-Dorothée Lévêque,54631,167699,2022-06-21
CASH_IN,246964,Agence_moov_Abomey,300000,53036,Michelle-Dorothée Lévêque,167699,414663,2022-06-23
CASH_OUT,404402,Michelle-Dorothée Lévêque,414663,10261,Agence_moov_Ouidah,300000,-104402,2022-06-24
CASH_IN,297978,Agence_moov_Abomey,300000,2022,Emmanuel Grégoire,-213123,84855,2022-06-01
CASH_OUT,371,Emmanuel Grégoire,84855,84484,Agence_moov_Abomey,300000,299629,2022-06-06
CASH_IN,189780,Agence_moov_Abomey,300000,110220,Emmanuel Grégoire,84484,274264,2022-06-07
CASH_OUT,3105,Emmanuel Grégoire,274264,271159,Agence_moov_Cotonou,300000,296895,2022-06-13
CASH_OUT,220890,Emmanuel Grégoire,271159,50269,Agence_moov_Abomey,300000,79110,2022-06-15
CASH_OUT,30698,Emmanuel Grégoire,50269,19571,Agence_moov_Ouidah,300000,269302,2022-06-16
CASH_IN,39041,Agence_moov_Ouidah,300000,260959,Emmanuel Grégoire,19571,58612,2022-06-16
CASH_IN,4742,Agence_moov_Ouidah,300000,295258,Emmanuel Grégoire,58612,63354,2022-06-18
CASH_OUT,12738,Emmanuel Grégoire,63354,50616,Agence_moov_Abomey,300000,287262,2022-06-21
TRANSFER,47431,Emmanuel Grégoire,50616,3185,Tristan Bousquet-Gros,19139,-28292,2022-06-22
CASH_OUT,939,Emmanuel Grégoire,3185,2246,Agence_moov_Abomey,300000,299061,2022-06-23
TRANSFER,2105,Robert Clerc,25484,23379,Emmanuel Grégoire,2246,4351,2022-06-23
CASH_IN,47372,Agence_moov_Abomey,300000,252628,Thibaut de la Roy,-226801,-179429,2022-06-01
CASH_IN,178641,Agence_moov_Abomey,300000,121359,Thibaut de la Roy,-179429,-788,2022-06-05
CASH_IN,83315,Agence_moov_Abomey,300000,216685,Thibaut de la Roy,-788,82527,2022-06-08
CASH_IN,180925,Agence_moov_Ouidah,300000,119075,Thibaut de la Roy,82527,263452,2022-06-09
CASH_IN,52074,Agence_moov_Cotonou,300000,247926,Thibaut de la Roy,263452,315526,2022-06-15
CASH_OUT,63540,Thibaut de la Roy,315526,251986,Agence_moov_Ouidah,300000,236460,2022-06-15
CASH_OUT,231853,Thibaut de la Roy,251986,20133,Agence_moov_Ouidah,300000,68147,2022-06-16
CASH_OUT,15833,Thibaut de la Roy,20133,4300,Agence_moov_Abomey,300000,284167,2022-06-16
CASH_IN,274436,Agence_moov_Cotonou,300000,25564,Thibaut de la Roy,4300,278736,2022-06-24
TRANSFER,6976,Véronique Martins de Fleury,11067,4091,Thibaut de la Roy,278736,285712,2022-06-26
CASH_IN,88625,Agence_moov_Abomey,300000,211375,Thibaut de la Roy,285712,374337,2022-06-26
CASH_IN,131101,Agence_moov_Abomey,300000,168899,Jules Fernandes,-48794,82307,2022-06-02
CASH_OUT,37214,Jules Fernandes,82307,45093,Agence_moov_Ouidah,300000,262786,2022-06-03
CASH_OUT,30290,Jules Fernandes,45093,14803,Agence_moov_Ouidah,300000,269710,2022-06-03
CASH_OUT,8837,Jules Fernandes,14803,5966,Agence_moov_Cotonou,300000,291163,2022-06-10
TRANSFER,407,Jules-Roland Bousquet,2206,1799,Jules Fernandes,5966,6373,2022-06-11
TRANSFER,888759,Françoise Morin,1051663,162904,Jules Fernandes,6373,895132,2022-06-12
TRANSFER,42015,Bertrand Regnier,53502,11487,Jules Fernandes,895132,937147,2022-06-14
CASH_OUT,655038,Jules Fernandes,937147,282109,Agence_moov_Ouidah,300000,-355038,2022-06-15
CASH_IN,171918,Agence_moov_Ouidah,300000,128082,Jules Fernandes,282109,454027,2022-06-15
CASH_OUT,86406,Jules Fernandes,454027,367621,Agence_moov_Abomey,300000,213594,2022-06-15
TRANSFER,373,Jules-Roland Bousquet,1799,1426,Jules Fernandes,367621,367994,2022-06-23
CASH_OUT,14785,Jules Fernandes,367994,353209,Agence_moov_Ouidah,300000,285215,2022-06-24
CASH_OUT,302324,Jules Fernandes,353209,50885,Agence_moov_Cotonou,300000,-2324,2022-06-26
CASH_IN,290629,Agence_moov_Ouidah,300000,9371,Alix Barbe,-243590,47039,2022-06-02
CASH_OUT,19556,Alix Barbe,47039,27483,Agence_moov_Abomey,300000,280444,2022-06-06
TRANSFER,20551,Alix Barbe,27483,6932,Frédéric Guillou,552733,532182,2022-06-07
CASH_OUT,1693,Alix Barbe,6932,5239,Agence_moov_Cotonou,300000,298307,2022-06-07
CASH_IN,283781,Agence_moov_Ouidah,300000,16219,Alix Barbe,5239,289020,2022-06-09
CASH_IN,45181,Agence_moov_Cotonou,300000,254819,Alix Barbe,289020,334201,2022-06-09
CASH_IN,98874,Agence_moov_Cotonou,300000,201126,Alix Barbe,334201,433075,2022-06-09
CASH_OUT,280530,Alix Barbe,433075,152545,Agence_moov_Cotonou,300000,19470,2022-06-11
CASH_IN,79534,Agence_moov_Ouidah,300000,220466,Alix Barbe,152545,232079,2022-06-12
TRANSFER,140410,Alix Barbe,232079,91669,Françoise Morin,162904,22494,2022-06-18
CASH_OUT,6661,Alix Barbe,91669,85008,Agence_moov_Ouidah,300000,293339,2022-06-22
CASH_IN,84623,Agence_moov_Abomey,300000,215377,Alix Barbe,85008,169631,2022-06-24
TRANSFER,72530,Alix Barbe,169631,97101,Bertrand Regnier,11487,-61043,2022-06-25
TRANSFER,40074,Alix Barbe,97101,57027,Thomas-Robert Morvan,30186,-9888,2022-06-25
CASH_IN,31232,Agence_moov_Ouidah,300000,268768,Maggie Martinez,-386948,-355716,2022-06-05
CASH_IN,89057,Agence_moov_Abomey,300000,210943,Maggie Martinez,-355716,-266659,2022-06-07
CASH_IN,142902,Agence_moov_Abomey,300000,157098,Maggie Martinez,-266659,-123757,2022-06-09
CASH_IN,275688,Agence_moov_Cotonou,300000,24312,Maggie Martinez,-123757,151931,2022-06-10
TRANSFER,149691,Maggie Martinez,151931,2240,Thomas Dupont,1698992,1549301,2022-06-21
CASH_OUT,2181,Maggie Martinez,2240,59,Agence_moov_Cotonou,300000,297819,2022-06-24
CASH_IN,23961,Agence_moov_Ouidah,300000,276039,Maggie Martinez,59,24020,2022-06-27
CASH_OUT,18199,Maggie Martinez,24020,5821,Agence_moov_Abomey,300000,281801,2022-06-27
TRANSFER,3854,Maggie Martinez,5821,1967,Robert Clerc,23379,19525,2022-06-27
TRANSFER,11821,Sabine Pineau,161724,149903,Françoise Morin,22494,10673,2022-06-02
CASH_OUT,76826,Sabine Pineau,149903,73077,Agence_moov_Ouidah,300000,223174,2022-06-04
TRANSFER,26220,Sabine Pineau,73077,46857,Gabriel Bègue,33312,7092,2022-06-05
CASH_OUT,11262,Sabine Pineau,46857,35595,Agence_moov_Ouidah,300000,288738,2022-06-11
CASH_OUT,26321,Sabine Pineau,35595,9274,Agence_moov_Ouidah,300000,273679,2022-06-13
CASH_OUT,3347,Sabine Pineau,9274,5927,Agence_moov_Cotonou,300000,296653,2022-06-16
CASH_IN,172951,Agence_moov_Cotonou,300000,127049,Sabine Pineau,5927,178878,2022-06-16
CASH_OUT,16099,Sabine Pineau,178878,162779,Agence_moov_Cotonou,300000,283901,2022-06-18
TRANSFER,146587,Sabine Pineau,162779,16192,Mathilde Picard du Delmas,1405503,1258916,2022-06-23
CASH_IN,220496,Agence_moov_Ouidah,300000,79504,Sabine Pineau,16192,236688,2022-06-24
CASH_OUT,35633,Sabine Pineau,236688,201055,Agence_moov_Ouidah,300000,264367,2022-06-25
TRANSFER,68068,Sabine Pineau,201055,132987,Sabine Pineau,201055,269123,2022-06-26
CASH_OUT,49729,Sabine Pineau,132987,83258,Agence_moov_Cotonou,300000,250271,2022-06-26
CASH_OUT,80629,Sabine Pineau,83258,2629,Agence_moov_Cotonou,300000,219371,2022-06-27
TRANSFER,282,Sabine Pineau,2629,2347,Robert Clerc,19525,19243,2022-06-27
CASH_IN,114562,Agence_moov_Ouidah,300000,185438,Manon Lebon,-169707,-55145,2022-06-04
CASH_IN,252292,Agence_moov_Ouidah,300000,47708,Manon Lebon,-55145,197147,2022-06-11
CASH_IN,205099,Agence_moov_Abomey,300000,94901,Manon Lebon,197147,402246,2022-06-16
CASH_OUT,20583,Manon Lebon,402246,381663,Agence_moov_Ouidah,300000,279417,2022-06-18
CASH_IN,118020,Agence_moov_Cotonou,300000,181980,Manon Lebon,381663,499683,2022-06-19
CASH_IN,129385,Agence_moov_Abomey,300000,170615,Manon Lebon,499683,629068,2022-06-22
CASH_IN,282242,Agence_moov_Ouidah,300000,17758,Manon Lebon,629068,911310,2022-06-23
CASH_IN,61571,Agence_moov_Abomey,300000,238429,Nath Loiseau,-16925,44646,2022-06-01
CASH_IN,259948,Agence_moov_Abomey,300000,40052,Nath Loiseau,44646,304594,2022-06-03
CASH_IN,291480,Agence_moov_Ouidah,300000,8520,Nath Loiseau,304594,596074,2022-06-11
CASH_OUT,100769,Nath Loiseau,596074,495305,Agence_moov_Ouidah,300000,199231,2022-06-12
CASH_OUT,466867,Nath Loiseau,495305,28438,Agence_moov_Ouidah,300000,-166867,2022-06-16
CASH_OUT,22620,Nath Loiseau,28438,5818,Agence_moov_Cotonou,300000,277380,2022-06-18
TRANSFER,384622,Frédéric Guillou,532182,147560,Nath Loiseau,5818,390440,2022-06-25
CASH_IN,275068,Agence_moov_Cotonou,300000,24932,Antoinette de Dupuis,-74961,200107,2022-06-08
CASH_IN,51640,Agence_moov_Ouidah,300000,248360,Antoinette de Dupuis,200107,251747,2022-06-11
CASH_IN,132849,Agence_moov_Abomey,300000,167151,Antoinette de Dupuis,251747,384596,2022-06-11
CASH_IN,140441,Agence_moov_Cotonou,300000,159559,Antoinette de Dupuis,384596,525037,2022-06-12
CASH_IN,222676,Agence_moov_Cotonou,300000,77324,Antoinette de Dupuis,525037,747713,2022-06-13
CASH_IN,139973,Agence_moov_Ouidah,300000,160027,Antoinette de Dupuis,747713,887686,2022-06-24
CASH_IN,135493,Agence_moov_Ouidah,300000,164507,Frédérique Fernandes du Bouchet,-165588,-30095,2022-06-02
CASH_IN,186826,Agence_moov_Abomey,300000,113174,Frédérique Fernandes du Bouchet,-30095,156731,2022-06-03
TRANSFER,1643,Gabriel Bègue,7092,5449,Frédérique Fernandes du Bouchet,156731,158374,2022-06-03
TRANSFER,419796,Mathilde Picard du Delmas,1258916,839120,Frédérique Fernandes du Bouchet,158374,578170,2022-06-06
TRANSFER,766,Jules-Roland Bousquet,1426,660,Frédérique Fernandes du Bouchet,578170,578936,2022-06-08
TRANSFER,504293,Frédérique Fernandes du Bouchet,578936,74643,Thomas Dupont,1549301,1045008,2022-06-11
TRANSFER,8990,Frédérique Fernandes du Bouchet,74643,65653,Robert Clerc,19243,10253,2022-06-11
CASH_OUT,35492,Frédérique Fernandes du Bouchet,65653,30161,Agence_moov_Ouidah,300000,264508,2022-06-13
CASH_IN,117516,Agence_moov_Ouidah,300000,182484,Frédérique Fernandes du Bouchet,30161,147677,2022-06-15
CASH_IN,136201,Agence_moov_Abomey,300000,163799,Frédérique Fernandes du Bouchet,147677,283878,2022-06-20
TRANSFER,67068,Anastasie Cousin,109797,42729,Frédérique Fernandes du Bouchet,283878,350946,2022-06-21
TRANSFER,301828,Frédérique Fernandes du Bouchet,350946,49118,Constance Guillon,3797,-298031,2022-06-25
CASH_IN,82296,Agence_moov_Abomey,300000,217704,Simone Muller de la Brun,-143620,-61324,2022-06-01
CASH_IN,203846,Agence_moov_Abomey,300000,96154,Simone Muller de la Brun,-61324,142522,2022-06-03
TRANSFER,7307,Robert Clerc,10253,2946,Simone Muller de la Brun,142522,149829,2022-06-06
CASH_OUT,54494,Simone Muller de la Brun,149829,95335,Agence_moov_Cotonou,300000,245506,2022-06-07
TRANSFER,955,Robert Clerc,2946,1991,Simone Muller de la Brun,95335,96290,2022-06-10
TRANSFER,82611,Simone Muller de la Brun,96290,13679,Simone Muller de la Brun,96290,178901,2022-06-10
TRANSFER,7171,Simone Muller de la Brun,13679,6508,Robert Clerc,1991,-5180,2022-06-12
CASH_IN,229691,Agence_moov_Ouidah,300000,70309,Simone Muller de la Brun,6508,236199,2022-06-14
CASH_IN,58226,Agence_moov_Ouidah,300000,241774,Simone Muller de la Brun,236199,294425,2022-06-18
CASH_IN,186830,Agence_moov_Cotonou,300000,113170,Simone Muller de la Brun,294425,481255,2022-06-19
CASH_IN,141119,Agence_moov_Ouidah,300000,158881,Simone Muller de la Brun,481255,622374,2022-06-19
CASH_IN,83105,Agence_moov_Cotonou,300000,216895,Simone Muller de la Brun,622374,705479,2022-06-21
TRANSFER,314350,Simone Muller de la Brun,705479,391129,Françoise Morin,10673,-303677,2022-06-22
CASH_IN,183705,Agence_moov_Cotonou,300000,116295,Simone Muller de la Brun,391129,574834,2022-06-22
CASH_OUT,86322,Simone Muller de la Brun,574834,488512,Agence_moov_Abomey,300000,213678,2022-06-23
CASH_OUT,397287,Simone Muller de la Brun,488512,91225,Agence_moov_Ouidah,300000,-97287,2022-06-25
CASH_IN,294256,Agence_moov_Ouidah,300000,5744,Manon Chevalier,-37966,256290,2022-06-01
CASH_OUT,121741,Manon Chevalier,256290,134549,Agence_moov_Cotonou,300000,178259,2022-06-04
CASH_OUT,118769,Manon Chevalier,134549,15780,Agence_moov_Ouidah,300000,181231,2022-06-05
CASH_IN,289048,Agence_moov_Abomey,300000,10952,Manon Chevalier,15780,304828,2022-06-06
CASH_IN,292222,Agence_moov_Cotonou,300000,7778,Manon Chevalier,304828,597050,2022-06-06
CASH_IN,173085,Agence_moov_Abomey,300000,126915,Manon Chevalier,597050,770135,2022-06-06
TRANSFER,642049,Manon Chevalier,770135,128086,Manon Chevalier,770135,128086,2022-06-08
CASH_OUT,4824,Manon Chevalier,128086,123262,Agence_moov_Abomey,300000,295176,2022-06-10
CASH_IN,182386,Agence_moov_Ouidah,300000,117614,Manon Chevalier,123262,305648,2022-06-11
TRANSFER,192586,Manon Chevalier,305648,113062,Frédéric Guillou,147560,-45026,2022-06-11
CASH_OUT,5446,Manon Chevalier,113062,107616,Agence_moov_Cotonou,300000,294554,2022-06-11
CASH_OUT,16681,Manon Chevalier,107616,90935,Agence_moov_Cotonou,300000,283319,2022-06-18
CASH_OUT,16588,Manon Chevalier,90935,74347,Agence_moov_Ouidah,300000,283412,2022-06-19
TRANSFER,2439,Gabriel Bègue,5449,3010,Manon Chevalier,74347,76786,2022-06-20
CASH_IN,141792,Agence_moov_Cotonou,300000,158208,Manon Chevalier,76786,218578,2022-06-25
TRANSFER,44570,Manon Chevalier,218578,174008,Thomas Dupont,1045008,1000438,2022-06-27
CASH_IN,8298,Agence_moov_Cotonou,300000,291702,Céline Collin-Hervé,-69449,-61151,2022-06-08
CASH_IN,18325,Agence_moov_Abomey,300000,281675,Céline Collin-Hervé,-61151,-42826,2022-06-08
CASH_IN,88216,Agence_moov_Abomey,300000,211784,Céline Collin-Hervé,-42826,45390,2022-06-10
CASH_IN,134264,Agence_moov_Abomey,300000,165736,Céline Collin-Hervé,45390,179654,2022-06-12
CASH_OUT,128747,Céline Collin-Hervé,179654,50907,Agence_moov_Cotonou,300000,171253,2022-06-14
TRANSFER,22380,Céline Collin-Hervé,50907,28527,Céline Collin-Hervé,50907,73287,2022-06-15
CASH_IN,22751,Agence_moov_Cotonou,300000,277249,Céline Collin-Hervé,28527,51278,2022-06-21
CASH_OUT,48773,Céline Collin-Hervé,51278,2505,Agence_moov_Cotonou,300000,251227,2022-06-21
TRANSFER,279,Jules-Roland Bousquet,660,381,Céline Collin-Hervé,2505,2784,2022-06-22
CASH_OUT,2761,Céline Collin-Hervé,2784,23,Agence_moov_Ouidah,300000,297239,2022-06-23
CASH_IN,217602,Agence_moov_Abomey,300000,82398,Céline Collin-Hervé,23,217625,2022-06-27
CASH_OUT,623565,Mathilde Picard du Delmas,839120,215555,Agence_moov_Ouidah,300000,-323565,2022-06-01
CASH_IN,258738,Agence_moov_Ouidah,300000,41262,Mathilde Picard du Delmas,215555,474293,2022-06-03
TRANSFER,464207,Thomas Dupont,1000438,536231,Mathilde Picard du Delmas,474293,938500,2022-06-12
CASH_OUT,829765,Mathilde Picard du Delmas,938500,108735,Agence_moov_Ouidah,300000,-529765,2022-06-14
CASH_IN,60779,Agence_moov_Cotonou,300000,239221,Mathilde Picard du Delmas,108735,169514,2022-06-18
CASH_OUT,66647,Mathilde Picard du Delmas,169514,102867,Agence_moov_Cotonou,300000,233353,2022-06-21
CASH_OUT,2903,Mathilde Picard du Delmas,102867,99964,Agence_moov_Ouidah,300000,297097,2022-06-25
CASH_IN,126732,Agence_moov_Abomey,300000,173268,Richard Le Lévêque,-11440,115292,2022-06-01
CASH_IN,17946,Agence_moov_Cotonou,300000,282054,Richard Le Lévêque,115292,133238,2022-06-03
CASH_OUT,100121,Richard Le Lévêque,133238,33117,Agence_moov_Cotonou,300000,199879,2022-06-04
CASH_OUT,5922,Richard Le Lévêque,33117,27195,Agence_moov_Abomey,300000,294078,2022-06-05
CASH_OUT,7283,Richard Le Lévêque,27195,19912,Agence_moov_Cotonou,300000,292717,2022-06-05
CASH_OUT,12618,Richard Le Lévêque,19912,7294,Agence_moov_Ouidah,300000,287382,2022-06-07
CASH_IN,217387,Agence_moov_Cotonou,300000,82613,Richard Le Lévêque,7294,224681,2022-06-10
CASH_OUT,76541,Richard Le Lévêque,224681,148140,Agence_moov_Cotonou,300000,223459,2022-06-13
CASH_OUT,133136,Richard Le Lévêque,148140,15004,Agence_moov_Abomey,300000,166864,2022-06-17
CASH_OUT,4998,Richard Le Lévêque,15004,10006,Agence_moov_Cotonou,300000,295002,2022-06-17
CASH_IN,230166,Agence_moov_Cotonou,300000,69834,Richard Le Lévêque,10006,240172,2022-06-20
CASH_OUT,25360,Richard Le Lévêque,240172,214812,Agence_moov_Ouidah,300000,274640,2022-06-21
CASH_IN,90618,Agence_moov_Abomey,300000,209382,Richard Le Lévêque,214812,305430,2022-06-22
CASH_IN,289365,Agence_moov_Abomey,300000,10635,Richard Le Lévêque,305430,594795,2022-06-23
CASH_OUT,562777,Richard Le Lévêque,594795,32018,Agence_moov_Abomey,300000,-262777,2022-06-25
CASH_IN,224850,Agence_moov_Abomey,300000,75150,Clémence-Véronique Munoz,-15900,208950,2022-06-01
CASH_IN,23798,Agence_moov_Abomey,300000,276202,Clémence-Véronique Munoz,208950,232748,2022-06-04
CASH_IN,38926,Agence_moov_Abomey,300000,261074,Clémence-Véronique Munoz,232748,271674,2022-06-06
CASH_OUT,59937,Clémence-Véronique Munoz,271674,211737,Agence_moov_Abomey,300000,240063,2022-06-18
TRANSFER,1565,Gabriel Bègue,3010,1445,Clémence-Véronique Munoz,211737,213302,2022-06-21
CASH_IN,1757,Agence_moov_Cotonou,300000,298243,Clémence-Véronique Munoz,213302,215059,2022-06-22
CASH_IN,38751,Agence_moov_Ouidah,300000,261249,Frédéric Guillou,-45026,-6275,2022-06-01
CASH_IN,101762,Agence_moov_Abomey,300000,198238,Frédéric Guillou,-6275,95487,2022-06-02
CASH_OUT,71547,Frédéric Guillou,95487,23940,Agence_moov_Cotonou,300000,228453,2022-06-03
CASH_IN,54852,Agence_moov_Ouidah,300000,245148,Frédéric Guillou,23940,78792,2022-06-14
CASH_IN,80152,Agence_moov_Cotonou,300000,219848,Frédéric Guillou,78792,158944,2022-06-18
CASH_IN,120266,Agence_moov_Cotonou,300000,179734,Frédéric Guillou,158944,279210,2022-06-26
CASH_IN,89538,Agence_moov_Cotonou,300000,210462,Tristan Bousquet-Gros,-28292,61246,2022-06-02
TRANSFER,3043,Camille Prévost,79504,76461,Tristan Bousquet-Gros,61246,64289,2022-06-04
CASH_OUT,64179,Tristan Bousquet-Gros,64289,110,Agence_moov_Abomey,300000,235821,2022-06-04
TRANSFER,27258,Camille Prévost,76461,49203,Tristan Bousquet-Gros,110,27368,2022-06-11
CASH_IN,250598,Agence_moov_Ouidah,300000,49402,Tristan Bousquet-Gros,27368,277966,2022-06-13
CASH_IN,114764,Agence_moov_Ouidah,300000,185236,Tristan Bousquet-Gros,277966,392730,2022-06-20
CASH_OUT,259305,Tristan Bousquet-Gros,392730,133425,Agence_moov_Abomey,300000,40695,2022-06-26
TRANSFER,1090,Gabriel Bègue,1445,355,Tristan Bousquet-Gros,133425,134515,2022-06-27
CASH_IN,271339,Agence_moov_Cotonou,300000,28661,Constance Bourdon-Millet,-42237,229102,2022-06-04
CASH_OUT,160319,Constance Bourdon-Millet,229102,68783,Agence_moov_Ouidah,300000,139681,2022-06-10
CASH_IN,97589,Agence_moov_Ouidah,300000,202411,Constance Bourdon-Millet,68783,166372,2022-06-16
CASH_OUT,89624,Constance Bourdon-Millet,166372,76748,Agence_moov_Abomey,300000,210376,2022-06-16
TRANSFER,3485,Véronique Martins de Fleury,4091,606,Constance Bourdon-Millet,76748,80233,2022-06-19
CASH_IN,52897,Agence_moov_Abomey,300000,247103,Constance Bourdon-Millet,80233,133130,2022-06-24
TRANSFER,223,Gabriel Bègue,355,132,Constance Bourdon-Millet,133130,133353,2022-06-25
CASH_IN,288489,Agence_moov_Ouidah,300000,11511,Jules-Roland Bousquet,381,288870,2022-06-01
CASH_OUT,214073,Jules-Roland Bousquet,288870,74797,Agence_moov_Ouidah,300000,85927,2022-06-01
CASH_IN,195851,Agence_moov_Cotonou,300000,104149,Jules-Roland Bousquet,74797,270648,2022-06-04
TRANSFER,203146,Thomas Dupont,536231,333085,Jules-Roland Bousquet,270648,473794,2022-06-05
CASH_OUT,221377,Jules-Roland Bousquet,473794,252417,Agence_moov_Ouidah,300000,78623,2022-06-05
TRANSFER,336,Anastasie Cousin,42729,42393,Jules-Roland Bousquet,252417,252753,2022-06-05
TRANSFER,250631,Jules-Roland Bousquet,252753,2122,Thomas Dupont,333085,82454,2022-06-05
CASH_OUT,208,Jules-Roland Bousquet,2122,1914,Agence_moov_Abomey,300000,299792,2022-06-07
CASH_OUT,1234,Jules-Roland Bousquet,1914,680,Agence_moov_Cotonou,300000,298766,2022-06-08
TRANSFER,332,Jules-Roland Bousquet,680,348,Camille Prévost,49203,48871,2022-06-08
CASH_IN,74448,Agence_moov_Ouidah,300000,225552,Jules-Roland Bousquet,348,74796,2022-06-11
TRANSFER,55988,Jules-Roland Bousquet,74796,18808,Anastasie Cousin,42393,-13595,2022-06-11
CASH_IN,83491,Agence_moov_Ouidah,300000,216509,Jules-Roland Bousquet,18808,102299,2022-06-11
TRANSFER,185,Véronique Martins de Fleury,606,421,Jules-Roland Bousquet,102299,102484,2022-06-12
TRANSFER,14867,Camille Prévost,48871,34004,Jules-Roland Bousquet,102484,117351,2022-06-21
CASH_OUT,1255,Jules-Roland Bousquet,117351,116096,Agence_moov_Abomey,300000,298745,2022-06-23
TRANSFER,14431,Jules-Roland Bousquet,116096,101665,Véronique Martins de Fleury,421,-14010,2022-06-25
CASH_IN,107001,Agence_moov_Abomey,300000,192999,Jules-Roland Bousquet,101665,208666,2022-06-27
CASH_IN,75566,Agence_moov_Cotonou,300000,224434,Jules-Roland Bousquet,208666,284232,2022-06-27
CASH_IN,150203,Agence_moov_Cotonou,300000,149797,Bertrand Regnier,-61043,89160,2022-06-03
TRANSFER,10702,Bertrand Regnier,89160,78458,Thomas Dupont,82454,71752,2022-06-07
CASH_OUT,55750,Bertrand Regnier,78458,22708,Agence_moov_Cotonou,300000,244250,2022-06-10
TRANSFER,12221,Bertrand Regnier,22708,10487,Thomas Dupont,71752,59531,2022-06-19
CASH_IN,199066,Agence_moov_Ouidah,300000,100934,Bertrand Regnier,10487,209553,2022-06-20
TRANSFER,31691,Camille Prévost,34004,2313,Bertrand Regnier,209553,241244,2022-06-27
CASH_IN,64773,Agence_moov_Ouidah,300000,235227,Lucy Lamy,-381619,-316846,2022-06-05
CASH_IN,35659,Agence_moov_Ouidah,300000,264341,Lucy Lamy,-316846,-281187,2022-06-06
CASH_IN,154394,Agence_moov_Ouidah,300000,145606,Lucy Lamy,-281187,-126793,2022-06-06
CASH_IN,35720,Agence_moov_Abomey,300000,264280,Lucy Lamy,-126793,-91073,2022-06-07
CASH_IN,291257,Agence_moov_Abomey,300000,8743,Lucy Lamy,-91073,200184,2022-06-11
CASH_IN,177803,Agence_moov_Cotonou,300000,122197,Lucy Lamy,200184,377987,2022-06-13
CASH_OUT,260810,Lucy Lamy,377987,117177,Agence_moov_Ouidah,300000,39190,2022-06-15
CASH_IN,203138,Agence_moov_Abomey,300000,96862,Lucy Lamy,117177,320315,2022-06-17
TRANSFER,98759,Lucy Lamy,320315,221556,Gabriel Bègue,132,-98627,2022-06-20
TRANSFER,60513,Lucy Lamy,221556,161043,Lucy Lamy,221556,282069,2022-06-22
TRANSFER,454,Camille Prévost,2313,1859,Lucy Lamy,161043,161497,2022-06-24
TRANSFER,146754,Lucy Lamy,161497,14743,Thomas Dupont,59531,-87223,2022-06-25
CASH_IN,241327,Agence_moov_Abomey,300000,58673,Marthe Gilles,-344503,-103176,2022-06-02
CASH_IN,93479,Agence_moov_Abomey,300000,206521,Marthe Gilles,-103176,-9697,2022-06-05
CASH_IN,182881,Agence_moov_Cotonou,300000,117119,Marthe Gilles,-9697,173184,2022-06-07
CASH_OUT,101710,Marthe Gilles,173184,71474,Agence_moov_Abomey,300000,198290,2022-06-08
CASH_OUT,41581,Marthe Gilles,71474,29893,Agence_moov_Cotonou,300000,258419,2022-06-09
TRANSFER,3474,Marthe Gilles,29893,26419,Camille Prévost,1859,-1615,2022-06-09
CASH_OUT,22842,Marthe Gilles,26419,3577,Agence_moov_Cotonou,300000,277158,2022-06-10
CASH_IN,257943,Agence_moov_Ouidah,300000,42057,Marthe Gilles,3577,261520,2022-06-11
CASH_OUT,35992,Marthe Gilles,261520,225528,Agence_moov_Abomey,300000,264008,2022-06-15
TRANSFER,40231,Marthe Gilles,225528,185297,Marthe Gilles,225528,265759,2022-06-15
CASH_OUT,14502,Marthe Gilles,185297,170795,Agence_moov_Ouidah,300000,285498,2022-06-15
CASH_IN,195011,Agence_moov_Cotonou,300000,104989,Marthe Gilles,170795,365806,2022-06-16
CASH_OUT,187753,Marthe Gilles,365806,178053,Agence_moov_Cotonou,300000,112247,2022-06-19
CASH_OUT,44077,Marthe Gilles,178053,133976,Agence_moov_Abomey,300000,255923,2022-06-21
CASH_IN,283393,Agence_moov_Abomey,300000,16607,Marthe Gilles,133976,417369,2022-06-22
CASH_OUT,188263,Marthe Gilles,417369,229106,Agence_moov_Abomey,300000,111737,2022-06-22
CASH_OUT,174308,Marthe Gilles,229106,54798,Agence_moov_Cotonou,300000,125692,2022-06-26
CASH_OUT,8500,Marthe Gilles,54798,46298,Agence_moov_Abomey,300000,291500,2022-06-27
CASH_IN,280610,Agence_moov_Ouidah,300000,19390,Anastasie Cousin,-13595,267015,2022-06-02
TRANSFER,213073,Anastasie Cousin,267015,53942,Anastasie Cousin,267015,53942,2022-06-05
CASH_OUT,1613,Anastasie Cousin,53942,52329,Agence_moov_Cotonou,300000,298387,2022-06-08
TRANSFER,30367,Anastasie Cousin,52329,21962,Anastasie Cousin,52329,82696,2022-06-11
CASH_IN,3767,Agence_moov_Abomey,300000,296233,Anastasie Cousin,21962,25729,2022-06-12
TRANSFER,2912,Anastasie Cousin,25729,22817,Anastasie Cousin,25729,22817,2022-06-13
CASH_OUT,5286,Anastasie Cousin,22817,17531,Agence_moov_Cotonou,300000,294714,2022-06-15
CASH_IN,164259,Agence_moov_Cotonou,300000,135741,Anastasie Cousin,17531,181790,2022-06-19
CASH_IN,112212,Agence_moov_Abomey,300000,187788,Anastasie Cousin,181790,294002,2022-06-19
CASH_IN,147226,Agence_moov_Cotonou,300000,152774,Anastasie Cousin,294002,441228,2022-06-21
CASH_IN,147799,Agence_moov_Ouidah,300000,152201,Anastasie Cousin,441228,589027,2022-06-25
CASH_OUT,395702,Anastasie Cousin,589027,193325,Agence_moov_Ouidah,300000,-95702,2022-06-26
CASH_IN,274166,Agence_moov_Cotonou,300000,25834,Timothée-René Blanchard,-538287,-264121,2022-06-01
CASH_IN,63843,Agence_moov_Abomey,300000,236157,Timothée-René Blanchard,-264121,-200278,2022-06-07
CASH_IN,43260,Agence_moov_Abomey,300000,256740,Timothée-René Blanchard,-200278,-157018,2022-06-08
CASH_IN,195855,Agence_moov_Cotonou,300000,104145,Timothée-René Blanchard,-157018,38837,2022-06-11
CASH_OUT,6820,Timothée-René Blanchard,38837,32017,Agence_moov_Cotonou,300000,293180,2022-06-13
CASH_OUT,17212,Timothée-René Blanchard,32017,14805,Agence_moov_Abomey,300000,282788,2022-06-14
TRANSFER,7176,Timothée-René Blanchard,14805,7629,Timothée-René Blanchard,14805,7629,2022-06-15
TRANSFER,2624,Timothée-René Blanchard,7629,5005,Timothée-René Blanchard,7629,5005,2022-06-15
CASH_OUT,1970,Timothée-René Blanchard,5005,3035,Agence_moov_Cotonou,300000,298030,2022-06-22
CASH_OUT,2679,Timothée-René Blanchard,3035,356,Agence_moov_Ouidah,300000,297321,2022-06-22
CASH_OUT,244,Timothée-René Blanchard,356,112,Agence_moov_Ouidah,300000,299756,2022-06-27
CASH_OUT,110,Timothée-René Blanchard,112,2,Agence_moov_Cotonou,300000,299890,2022-06-27
CASH_IN,100025,Agence_moov_Ouidah,300000,199975,Alphonse Joly,-344122,-244097,2022-06-01
CASH_IN,290591,Agence_moov_Abomey,300000,9409,Alphonse Joly,-244097,46494,2022-06-01
TRANSFER,35531,Alphonse Joly,46494,10963,Alphonse Joly,46494,10963,2022-06-03
CASH_IN,201658,Agence_moov_Abomey,300000,98342,Alphonse Joly,10963,212621,2022-06-04
TRANSFER,196355,Alphonse Joly,212621,16266,Alphonse Joly,212621,408976,2022-06-04
CASH_OUT,5175,Alphonse Joly,16266,11091,Agence_moov_Ouidah,300000,294825,2022-06-05
CASH_OUT,3020,Alphonse Joly,11091,8071,Agence_moov_Abomey,300000,296980,2022-06-05
CASH_OUT,3409,Alphonse Joly,8071,4662,Agence_moov_Cotonou,300000,296591,2022-06-07
CASH_OUT,346,Alphonse Joly,4662,4316,Agence_moov_Cotonou,300000,299654,2022-06-12
CASH_IN,240562,Agence_moov_Abomey,300000,59438,Alphonse Joly,4316,244878,2022-06-13
CASH_IN,104630,Agence_moov_Ouidah,300000,195370,Alphonse Joly,244878,349508,2022-06-14
TRANSFER,177131,Alphonse Joly,349508,172377,Alphonse Joly,349508,172377,2022-06-15
CASH_OUT,166366,Alphonse Joly,172377,6011,Agence_moov_Abomey,300000,133634,2022-06-16
CASH_OUT,3368,Alphonse Joly,6011,2643,Agence_moov_Ouidah,300000,296632,2022-06-16
CASH_OUT,1608,Alphonse Joly,2643,1035,Agence_moov_Cotonou,300000,298392,2022-06-17
CASH_IN,291847,Agence_moov_Ouidah,300000,8153,Alphonse Joly,1035,292882,2022-06-27
CASH_IN,88775,Agence_moov_Cotonou,300000,211225,Aimé Pages,-91507,-2732,2022-06-03
CASH_IN,239343,Agence_moov_Ouidah,300000,60657,Aimé Pages,-2732,236611,2022-06-05
TRANSFER,95825,Aimé Pages,236611,140786,Aimé Pages,236611,332436,2022-06-07
CASH_OUT,116171,Aimé Pages,140786,24615,Agence_moov_Cotonou,300000,183829,2022-06-10
CASH_OUT,7566,Aimé Pages,24615,17049,Agence_moov_Ouidah,300000,292434,2022-06-11
CASH_OUT,7374,Aimé Pages,17049,9675,Agence_moov_Cotonou,300000,292626,2022-06-12
CASH_OUT,1786,Aimé Pages,9675,7889,Agence_moov_Abomey,300000,298214,2022-06-15
CASH_IN,191953,Agence_moov_Abomey,300000,108047,Aimé Pages,7889,199842,2022-06-20
CASH_OUT,191192,Aimé Pages,199842,8650,Agence_moov_Cotonou,300000,108808,2022-06-20
CASH_OUT,2156,Aimé Pages,8650,6494,Agence_moov_Abomey,300000,297844,2022-06-24
CASH_IN,215777,Agence_moov_Ouidah,300000,84223,Aimé Pages,6494,222271,2022-06-26
CASH_IN,18625,Agence_moov_Cotonou,300000,281375,Thomas Guichard du Renault,7,18632,2022-06-01
CASH_IN,133936,Agence_moov_Abomey,300000,166064,Thomas Guichard du Renault,18632,152568,2022-06-02
TRANSFER,151413,Thomas Guichard du Renault,152568,1155,Thomas Guichard du Renault,152568,303981,2022-06-02
TRANSFER,737,Thomas Guichard du Renault,1155,418,Thomas Guichard du Renault,1155,1892,2022-06-08
TRANSFER,134,Thomas Guichard du Renault,418,284,Thomas Guichard du Renault,418,552,2022-06-10
CASH_OUT,226,Thomas Guichard du Renault,284,58,Agence_moov_Ouidah,300000,299774,2022-06-10
CASH_IN,54042,Agence_moov_Ouidah,300000,245958,Thomas Guichard du Renault,58,54100,2022-06-11
TRANSFER,2376,Thomas Guichard du Renault,54100,51724,Thomas Guichard du Renault,54100,56476,2022-06-12
CASH_IN,201093,Agence_moov_Ouidah,300000,98907,Thomas Guichard du Renault,51724,252817,2022-06-15
CASH_OUT,96620,Thomas Guichard du Renault,252817,156197,Agence_moov_Ouidah,300000,203380,2022-06-16
CASH_OUT,89421,Thomas Guichard du Renault,156197,66776,Agence_moov_Abomey,300000,210579,2022-06-18
CASH_IN,33302,Agence_moov_Abomey,300000,266698,Thomas Guichard du Renault,66776,100078,2022-06-21
CASH_OUT,23044,Thomas Guichard du Renault,100078,77034,Agence_moov_Ouidah,300000,276956,2022-06-22
CASH_IN,140434,Agence_moov_Ouidah,300000,159566,Thomas Guichard du Renault,77034,217468,2022-06-26
CASH_OUT,123695,Thomas Guichard du Renault,217468,93773,Agence_moov_Ouidah,300000,176305,2022-06-26
CASH_IN,76109,Agence_moov_Abomey,300000,223891,Paulette Loiseau,-389031,-312922,2022-06-04
CASH_IN,114585,Agence_moov_Cotonou,300000,185415,Paulette Loiseau,-312922,-198337,2022-06-05
CASH_IN,112847,Agence_moov_Abomey,300000,187153,Paulette Loiseau,-198337,-85490,2022-06-06
CASH_IN,129322,Agence_moov_Abomey,300000,170678,Paulette Loiseau,-85490,43832,2022-06-07
TRANSFER,38973,Paulette Loiseau,43832,4859,Paulette Loiseau,43832,82805,2022-06-07
CASH_OUT,4058,Paulette Loiseau,4859,801,Agence_moov_Ouidah,300000,295942,2022-06-12
TRANSFER,511,Paulette Loiseau,801,290,Paulette Loiseau,801,290,2022-06-13
CASH_OUT,271,Paulette Loiseau,290,19,Agence_moov_Ouidah,300000,299729,2022-06-16
CASH_IN,188302,Agence_moov_Ouidah,300000,111698,Paulette Loiseau,19,188321,2022-06-18
CASH_OUT,60271,Paulette Loiseau,188321,128050,Agence_moov_Abomey,300000,239729,2022-06-22
CASH_IN,251274,Agence_moov_Abomey,300000,48726,Thomas Dupont,-87223,164051,2022-06-01
CASH_IN,109414,Agence_moov_Cotonou,300000,190586,Thomas Dupont,164051,273465,2022-06-03
TRANSFER,186741,Thomas Dupont,273465,86724,Thomas Dupont,273465,460206,2022-06-03
TRANSFER,39919,Thomas Dupont,86724,46805,Thomas Dupont,86724,46805,2022-06-04
CASH_OUT,20406,Thomas Dupont,46805,26399,Agence_moov_Cotonou,300000,279594,2022-06-05
CASH_IN,228476,Agence_moov_Abomey,300000,71524,Thomas Dupont,26399,254875,2022-06-09
CASH_IN,19468,Agence_moov_Abomey,300000,280532,Thomas Dupont,254875,274343,2022-06-15
CASH_OUT,269643,Thomas Dupont,274343,4700,Agence_moov_Abomey,300000,30357,2022-06-16
CASH_IN,23548,Agence_moov_Abomey,300000,276452,Thomas Dupont,4700,28248,2022-06-21
CASH_IN,237636,Agence_moov_Abomey,300000,62364,Thomas Dupont,28248,265884,2022-06-22
CASH_IN,221734,Agence_moov_Ouidah,300000,78266,Thomas Dupont,265884,487618,2022-06-22
CASH_IN,138671,Agence_moov_Ouidah,300000,161329,Thomas Dupont,487618,626289,2022-06-27
CASH_IN,43749,Agence_moov_Abomey,300000,256251,Thérèse François,-14678,29071,2022-06-03
CASH_OUT,18674,Thérèse François,29071,10397,Agence_moov_Ouidah,300000,281326,2022-06-05
CASH_OUT,4067,Thérèse François,10397,6330,Agence_moov_Abomey,300000,295933,2022-06-05
CASH_IN,143208,Agence_moov_Cotonou,300000,156792,Thérèse François,6330,149538,2022-06-05
CASH_IN,223495,Agence_moov_Abomey,300000,76505,Thérèse François,149538,373033,2022-06-12
TRANSFER,24994,Thérèse François,373033,348039,Thérèse François,373033,398027,2022-06-14
CASH_OUT,300451,Thérèse François,348039,47588,Agence_moov_Abomey,300000,-451,2022-06-15
CASH_OUT,14239,Thérèse François,47588,33349,Agence_moov_Cotonou,300000,285761,2022-06-17
CASH_OUT,27117,Thérèse François,33349,6232,Agence_moov_Ouidah,300000,272883,2022-06-21
CASH_IN,19206,Agence_moov_Abomey,300000,280794,Thérèse François,6232,25438,2022-06-23
CASH_IN,236835,Agence_moov_Ouidah,300000,63165,Noël Bourgeois,-47059,189776,2022-06-02
CASH_OUT,144304,Noël Bourgeois,189776,45472,Agence_moov_Ouidah,300000,155696,2022-06-04
TRANSFER,35751,Noël Bourgeois,45472,9721,Noël Bourgeois,45472,81223,2022-06-04
CASH_IN,294637,Agence_moov_Abomey,300000,5363,Noël Bourgeois,9721,304358,2022-06-07
CASH_OUT,207691,Noël Bourgeois,304358,96667,Agence_moov_Ouidah,300000,92309,2022-06-10
CASH_OUT,8974,Noël Bourgeois,96667,87693,Agence_moov_Cotonou,300000,291026,2022-06-25
CASH_IN,179096,Agence_moov_Ouidah,300000,120904,Colette-Sophie Prévost,-318375,-139279,2022-06-01
CASH_IN,192890,Agence_moov_Abomey,300000,107110,Colette-Sophie Prévost,-139279,53611,2022-06-01
CASH_IN,65818,Agence_moov_Cotonou,300000,234182,Colette-Sophie Prévost,53611,119429,2022-06-02
CASH_IN,134049,Agence_moov_Abomey,300000,165951,Colette-Sophie Prévost,119429,253478,2022-06-08
CASH_OUT,174825,Colette-Sophie Prévost,253478,78653,Agence_moov_Ouidah,300000,125175,2022-06-08
TRANSFER,62499,Colette-Sophie Prévost,78653,16154,Colette-Sophie Prévost,78653,141152,2022-06-08
CASH_IN,129127,Agence_moov_Cotonou,300000,170873,Colette-Sophie Prévost,16154,145281,2022-06-10
TRANSFER,53254,Colette-Sophie Prévost,145281,92027,Colette-Sophie Prévost,145281,198535,2022-06-11
CASH_IN,139555,Agence_moov_Abomey,300000,160445,Colette-Sophie Prévost,92027,231582,2022-06-14
TRANSFER,22127,Colette-Sophie Prévost,231582,209455,Colette-Sophie Prévost,231582,209455,2022-06-16
CASH_IN,210738,Agence_moov_Abomey,300000,89262,Colette-Sophie Prévost,209455,420193,2022-06-17
CASH_IN,74395,Agence_moov_Ouidah,300000,225605,Colette-Sophie Prévost,420193,494588,2022-06-20
CASH_IN,74001,Agence_moov_Cotonou,300000,225999,Colette-Sophie Prévost,494588,568589,2022-06-21
CASH_IN,30604,Agence_moov_Cotonou,300000,269396,Gabriel Bègue,-98627,-68023,2022-06-01
CASH_IN,298770,Agence_moov_Abomey,300000,1230,Gabriel Bègue,-68023,230747,2022-06-01
CASH_IN,223797,Agence_moov_Abomey,300000,76203,Gabriel Bègue,230747,454544,2022-06-01
TRANSFER,83337,Gabriel Bègue,454544,371207,Gabriel Bègue,454544,371207,2022-06-02
TRANSFER,366344,Gabriel Bègue,371207,4863,Gabriel Bègue,371207,737551,2022-06-02
CASH_IN,31214,Agence_moov_Abomey,300000,268786,Gabriel Bègue,4863,36077,2022-06-02
CASH_OUT,17788,Gabriel Bègue,36077,18289,Agence_moov_Cotonou,300000,282212,2022-06-04
CASH_IN,280523,Agence_moov_Abomey,300000,19477,Gabriel Bègue,18289,298812,2022-06-08
CASH_IN,44112,Agence_moov_Ouidah,300000,255888,Gabriel Bègue,298812,342924,2022-06-08
CASH_IN,143931,Agence_moov_Ouidah,300000,156069,Gabriel Bègue,342924,486855,2022-06-09
CASH_IN,150663,Agence_moov_Cotonou,300000,149337,Gabriel Bègue,486855,637518,2022-06-14
CASH_IN,231705,Agence_moov_Cotonou,300000,68295,Gabriel Bègue,637518,869223,2022-06-15
CASH_OUT,490648,Gabriel Bègue,869223,378575,Agence_moov_Abomey,300000,-190648,2022-06-17
CASH_IN,183675,Agence_moov_Ouidah,300000,116325,Robert-Louis Gosselin,-194501,-10826,2022-06-02
CASH_IN,24885,Agence_moov_Cotonou,300000,275115,Robert-Louis Gosselin,-10826,14059,2022-06-03
CASH_IN,121062,Agence_moov_Ouidah,300000,178938,Robert-Louis Gosselin,14059,135121,2022-06-07
TRANSFER,96588,Robert-Louis Gosselin,135121,38533,Robert-Louis Gosselin,135121,231709,2022-06-08
CASH_IN,231863,Agence_moov_Cotonou,300000,68137,Robert-Louis Gosselin,38533,270396,2022-06-11
CASH_IN,111807,Agence_moov_Cotonou,300000,188193,Robert-Louis Gosselin,270396,382203,2022-06-13
TRANSFER,266249,Robert-Louis Gosselin,382203,115954,Robert-Louis Gosselin,382203,115954,2022-06-15
CASH_OUT,7536,Robert-Louis Gosselin,115954,108418,Agence_moov_Ouidah,300000,292464,2022-06-25
CASH_IN,94849,Agence_moov_Cotonou,300000,205151,Robert Clerc,-5180,89669,2022-06-02
CASH_IN,240751,Agence_moov_Ouidah,300000,59249,Robert Clerc,89669,330420,2022-06-03
TRANSFER,32744,Robert Clerc,330420,297676,Robert Clerc,330420,363164,2022-06-05
CASH_OUT,187621,Robert Clerc,297676,110055,Agence_moov_Cotonou,300000,112379,2022-06-05
CASH_OUT,108911,Robert Clerc,110055,1144,Agence_moov_Ouidah,300000,191089,2022-06-06
CASH_IN,82438,Agence_moov_Ouidah,300000,217562,Robert Clerc,1144,83582,2022-06-06
CASH_OUT,5480,Robert Clerc,83582,78102,Agence_moov_Cotonou,300000,294520,2022-06-07
CASH_OUT,69754,Robert Clerc,78102,8348,Agence_moov_Cotonou,300000,230246,2022-06-08
CASH_IN,186933,Agence_moov_Abomey,300000,113067,Robert Clerc,8348,195281,2022-06-20
CASH_OUT,158086,Robert Clerc,195281,37195,Agence_moov_Ouidah,300000,141914,2022-06-22
CASH_OUT,22457,Robert Clerc,37195,14738,Agence_moov_Cotonou,300000,277543,2022-06-27
CASH_IN,278184,Agence_moov_Cotonou,300000,21816,Robert Clerc,14738,292922,2022-06-27
CASH_IN,236049,Agence_moov_Cotonou,300000,63951,Thomas-Robert Morvan,-9888,226161,2022-06-04
CASH_IN,15297,Agence_moov_Cotonou,300000,284703,Thomas-Robert Morvan,226161,241458,2022-06-04
CASH_IN,274925,Agence_moov_Cotonou,300000,25075,Thomas-Robert Morvan,241458,516383,2022-06-06
CASH_IN,136027,Agence_moov_Abomey,300000,163973,Thomas-Robert Morvan,516383,652410,2022-06-11
CASH_IN,18954,Agence_moov_Abomey,300000,281046,Thomas-Robert Morvan,652410,671364,2022-06-11
CASH_OUT,129948,Thomas-Robert Morvan,671364,541416,Agence_moov_Abomey,300000,170052,2022-06-16
CASH_OUT,291863,Thomas-Robert Morvan,541416,249553,Agence_moov_Ouidah,300000,8137,2022-06-25
CASH_IN,200912,Agence_moov_Abomey,300000,99088,Véronique Martins de Fleury,-14010,186902,2022-06-02
TRANSFER,110095,Véronique Martins de Fleury,186902,76807,Véronique Martins de Fleury,186902,76807,2022-06-04
CASH_OUT,43778,Véronique Martins de Fleury,76807,33029,Agence_moov_Ouidah,300000,256222,2022-06-05
CASH_OUT,31598,Véronique Martins de Fleury,33029,1431,Agence_moov_Abomey,300000,268402,2022-06-06
CASH_IN,275459,Agence_moov_Abomey,300000,24541,Véronique Martins de Fleury,1431,276890,2022-06-06
CASH_IN,157005,Agence_moov_Cotonou,300000,142995,Véronique Martins de Fleury,276890,433895,2022-06-06
CASH_OUT,52546,Véronique Martins de Fleury,433895,381349,Agence_moov_Cotonou,300000,247454,2022-06-07
CASH_IN,58882,Agence_moov_Cotonou,300000,241118,Véronique Martins de Fleury,381349,440231,2022-06-07
TRANSFER,253230,Véronique Martins de Fleury,440231,187001,Véronique Martins de Fleury,440231,187001,2022-06-09
CASH_IN,129610,Agence_moov_Cotonou,300000,170390,Véronique Martins de Fleury,187001,316611,2022-06-10
CASH_OUT,65333,Véronique Martins de Fleury,316611,251278,Agence_moov_Ouidah,300000,234667,2022-06-11
CASH_IN,93149,Agence_moov_Cotonou,300000,206851,Véronique Martins de Fleury,251278,344427,2022-06-16
CASH_OUT,141835,Véronique Martins de Fleury,344427,202592,Agence_moov_Ouidah,300000,158165,2022-06-18
CASH_IN,126991,Agence_moov_Ouidah,300000,173009,Véronique Martins de Fleury,202592,329583,2022-06-22
CASH_IN,193292,Agence_moov_Cotonou,300000,106708,Véronique Martins de Fleury,329583,522875,2022-06-22
CASH_OUT,205183,Véronique Martins de Fleury,522875,317692,Agence_moov_Ouidah,300000,94817,2022-06-25
CASH_IN,127807,Agence_moov_Ouidah,300000,172193,Véronique Martins de Fleury,317692,445499,2022-06-25
CASH_IN,22350,Agence_moov_Cotonou,300000,277650,Françoise Morin,-303677,-281327,2022-06-02
CASH_IN,252428,Agence_moov_Ouidah,300000,47572,Françoise Morin,-281327,-28899,2022-06-03
CASH_IN,134460,Agence_moov_Abomey,300000,165540,Françoise Morin,-28899,105561,2022-06-04
CASH_IN,189840,Agence_moov_Cotonou,300000,110160,Françoise Morin,105561,295401,2022-06-05
TRANSFER,220451,Françoise Morin,295401,74950,Françoise Morin,295401,74950,2022-06-08
CASH_IN,219566,Agence_moov_Abomey,300000,80434,Françoise Morin,74950,294516,2022-06-11
CASH_OUT,92068,Françoise Morin,294516,202448,Agence_moov_Abomey,300000,207932,2022-06-12
CASH_IN,270965,Agence_moov_Ouidah,300000,29035,Françoise Morin,202448,473413,2022-06-14
CASH_IN,284785,Agence_moov_Ouidah,300000,15215,Françoise Morin,473413,758198,2022-06-21
CASH_OUT,565635,Françoise Morin,758198,192563,Agence_moov_Ouidah,300000,-265635,2022-06-22
CASH_IN,81632,Agence_moov_Cotonou,300000,218368,Françoise Morin,192563,274195,2022-06-22
CASH_IN,169956,Agence_moov_Ouidah,300000,130044,Françoise Morin,274195,444151,2022-06-26
CASH_IN,6763,Agence_moov_Abomey,300000,293237,Alphonse Gomes,-36104,-29341,2022-06-01
CASH_IN,35357,Agence_moov_Ouidah,300000,264643,Alphonse Gomes,-29341,6016,2022-06-04
CASH_IN,265758,Agence_moov_Ouidah,300000,34242,Alphonse Gomes,6016,271774,2022-06-06
CASH_IN,26927,Agence_moov_Ouidah,300000,273073,Alphonse Gomes,271774,298701,2022-06-07
CASH_IN,135668,Agence_moov_Ouidah,300000,164332,Alphonse Gomes,298701,434369,2022-06-07
CASH_IN,189271,Agence_moov_Abomey,300000,110729,Alphonse Gomes,434369,623640,2022-06-08
TRANSFER,101676,Alphonse Gomes,623640,521964,Alphonse Gomes,623640,521964,2022-06-10
CASH_IN,138513,Agence_moov_Cotonou,300000,161487,Alphonse Gomes,521964,660477,2022-06-11
TRANSFER,318697,Alphonse Gomes,660477,341780,Alphonse Gomes,660477,979174,2022-06-11
CASH_OUT,233875,Alphonse Gomes,341780,107905,Agence_moov_Cotonou,300000,66125,2022-06-12
TRANSFER,34101,Alphonse Gomes,107905,73804,Alphonse Gomes,107905,73804,2022-06-13
CASH_IN,132176,Agence_moov_Abomey,300000,167824,Alphonse Gomes,73804,205980,2022-06-13
CASH_IN,178464,Agence_moov_Ouidah,300000,121536,Alphonse Gomes,205980,384444,2022-06-14
CASH_IN,92235,Agence_moov_Abomey,300000,207765,Alphonse Gomes,384444,476679,2022-06-16
CASH_OUT,411235,Alphonse Gomes,476679,65444,Agence_moov_Ouidah,300000,-111235,2022-06-18
CASH_IN,248871,Agence_moov_Abomey,300000,51129,Alphonse Gomes,65444,314315,2022-06-22
CASH_OUT,44505,Alphonse Gomes,314315,269810,Agence_moov_Abomey,300000,255495,2022-06-25
CASH_OUT,240105,Alphonse Gomes,269810,29705,Agence_moov_Ouidah,300000,59895,2022-06-27
CASH_IN,261774,Agence_moov_Ouidah,300000,38226,Andrée-Thérèse Mendès,-1506,260268,2022-06-01
TRANSFER,64368,Andrée-Thérèse Mendès,260268,195900,Andrée-Thérèse Mendès,260268,195900,2022-06-02
TRANSFER,148321,Andrée-Thérèse Mendès,195900,47579,Andrée-Thérèse Mendès,195900,47579,2022-06-02
TRANSFER,1500,Andrée-Thérèse Mendès,47579,46079,Andrée-Thérèse Mendès,47579,49079,2022-06-03
CASH_OUT,1906,Andrée-Thérèse Mendès,46079,44173,Agence_moov_Abomey,300000,298094,2022-06-14
CASH_IN,94747,Agence_moov_Abomey,300000,205253,Andrée-Thérèse Mendès,44173,138920,2022-06-18
CASH_OUT,101121,Andrée-Thérèse Mendès,138920,37799,Agence_moov_Cotonou,300000,198879,2022-06-23
CASH_IN,98041,Agence_moov_Ouidah,300000,201959,Thérèse Hubert,-1303251,-1205210,2022-06-03
CASH_IN,248005,Agence_moov_Abomey,300000,51995,Thérèse Hubert,-1205210,-957205,2022-06-05
CASH_IN,282152,Agence_moov_Ouidah,300000,17848,Thérèse Hubert,-957205,-675053,2022-06-08
CASH_IN,118616,Agence_moov_Abomey,300000,181384,Thérèse Hubert,-675053,-556437,2022-06-09
CASH_IN,216260,Agence_moov_Cotonou,300000,83740,Thérèse Hubert,-556437,-340177,2022-06-11
CASH_IN,285146,Agence_moov_Cotonou,300000,14854,Thérèse Hubert,-340177,-55031,2022-06-11
CASH_IN,271359,Agence_moov_Ouidah,300000,28641,Thérèse Hubert,-55031,216328,2022-06-19
CASH_IN,243038,Agence_moov_Cotonou,300000,56962,Constance Guillon,-298031,-54993,2022-06-03
CASH_IN,215593,Agence_moov_Ouidah,300000,84407,Constance Guillon,-54993,160600,2022-06-06
CASH_IN,251613,Agence_moov_Ouidah,300000,48387,Constance Guillon,160600,412213,2022-06-07
CASH_IN,67544,Agence_moov_Abomey,300000,232456,Constance Guillon,412213,479757,2022-06-08
CASH_OUT,361894,Constance Guillon,479757,117863,Agence_moov_Cotonou,300000,-61894,2022-06-13
TRANSFER,38095,Constance Guillon,117863,79768,Constance Guillon,117863,155958,2022-06-13
CASH_OUT,2873,Constance Guillon,79768,76895,Agence_moov_Abomey,300000,297127,2022-06-15
CASH_IN,216662,Agence_moov_Ouidah,300000,83338,Constance Guillon,76895,293557,2022-06-15
CASH_OUT,213989,Constance Guillon,293557,79568,Agence_moov_Ouidah,300000,86011,2022-06-16
CASH_OUT,50003,Constance Guillon,79568,29565,Agence_moov_Cotonou,300000,249997,2022-06-18
CASH_OUT,25203,Constance Guillon,29565,4362,Agence_moov_Cotonou,300000,274797,2022-06-18
CASH_OUT,2597,Constance Guillon,4362,1765,Agence_moov_Abomey,300000,297403,2022-06-21
CASH_IN,230535,Agence_moov_Cotonou,300000,69465,Michelle Samson,-11979,218556,2022-06-02
CASH_IN,8097,Agence_moov_Ouidah,300000,291903,Michelle Samson,218556,226653,2022-06-04
CASH_IN,281252,Agence_moov_Abomey,300000,18748,Michelle Samson,226653,507905,2022-06-04
CASH_IN,229466,Agence_moov_Ouidah,300000,70534,Michelle Samson,507905,737371,2022-06-04
TRANSFER,245146,Michelle Samson,737371,492225,Michelle Samson,737371,492225,2022-06-05
CASH_OUT,196123,Michelle Samson,492225,296102,Agence_moov_Cotonou,300000,103877,2022-06-06
CASH_OUT,75469,Michelle Samson,296102,220633,Agence_moov_Abomey,300000,224531,2022-06-07
CASH_IN,234491,Agence_moov_Ouidah,300000,65509,Michelle Samson,220633,455124,2022-06-11
CASH_OUT,245865,Michelle Samson,455124,209259,Agence_moov_Abomey,300000,54135,2022-06-11
TRANSFER,151544,Michelle Samson,209259,57715,Michelle Samson,209259,57715,2022-06-12
TRANSFER,49414,Michelle Samson,57715,8301,Michelle Samson,57715,8301,2022-06-15
TRANSFER,4409,Michelle Samson,8301,3892,Michelle Samson,8301,3892,2022-06-15
CASH_IN,168478,Agence_moov_Cotonou,300000,131522,Michelle Samson,3892,172370,2022-06-16
CASH_OUT,35466,Michelle Samson,172370,136904,Agence_moov_Ouidah,300000,264534,2022-06-17
CASH_IN,41920,Agence_moov_Abomey,300000,258080,Michelle Samson,136904,178824,2022-06-20
CASH_IN,21174,Agence_moov_Abomey,300000,278826,Michelle Samson,178824,199998,2022-06-21
CASH_OUT,118837,Michelle Samson,199998,81161,Agence_moov_Cotonou,300000,181163,2022-06-27
CASH_IN,36563,Agence_moov_Ouidah,300000,263437,Michel Bouchet,-73848,-37285,2022-06-06
CASH_IN,107183,Agence_moov_Cotonou,300000,192817,Michel Bouchet,-37285,69898,2022-06-09
CASH_OUT,20744,Michel Bouchet,69898,49154,Agence_moov_Ouidah,300000,279256,2022-06-09
CASH_IN,146874,Agence_moov_Cotonou,300000,153126,Michel Bouchet,49154,196028,2022-06-15
CASH_IN,66781,Agence_moov_Cotonou,300000,233219,Michel Bouchet,196028,262809,2022-06-16
CASH_OUT,64840,Michel Bouchet,262809,197969,Agence_moov_Cotonou,300000,235160,2022-06-18
CASH_IN,68289,Agence_moov_Ouidah,300000,231711,Michel Bouchet,197969,266258,2022-06-19
CASH_OUT,38227,Michel Bouchet,266258,228031,Agence_moov_Abomey,300000,261773,2022-06-23
TRANSFER,89625,Michel Bouchet,228031,138406,Michel Bouchet,228031,317656,2022-06-24
CASH_OUT,83885,Michel Bouchet,138406,54521,Agence_moov_Cotonou,300000,216115,2022-06-24
CASH_IN,245575,Agence_moov_Ouidah,300000,54425,Bernard Maurice,-4344,241231,2022-06-08
CASH_OUT,112910,Bernard Maurice,241231,128321,Agence_moov_Abomey,300000,187090,2022-06-10
CASH_IN,132783,Agence_moov_Cotonou,300000,167217,Bernard Maurice,128321,261104,2022-06-15
CASH_OUT,197347,Bernard Maurice,261104,63757,Agence_moov_Cotonou,300000,102653,2022-06-18
TRANSFER,5664,Bernard Maurice,63757,58093,Bernard Maurice,63757,69421,2022-06-19
CASH_IN,131036,Agence_moov_Ouidah,300000,168964,Bernard Maurice,58093,189129,2022-06-21
CASH_IN,141313,Agence_moov_Ouidah,300000,158687,Luc Lévêque-Carre,-211250,-69937,2022-06-02
CASH_IN,178961,Agence_moov_Ouidah,300000,121039,Luc Lévêque-Carre,-69937,109024,2022-06-03
TRANSFER,31516,Luc Lévêque-Carre,109024,77508,Luc Lévêque-Carre,109024,77508,2022-06-06
CASH_OUT,69141,Luc Lévêque-Carre,77508,8367,Agence_moov_Cotonou,300000,230859,2022-06-06
CASH_IN,234566,Agence_moov_Ouidah,300000,65434,Luc Lévêque-Carre,8367,242933,2022-06-09
CASH_OUT,91555,Luc Lévêque-Carre,242933,151378,Agence_moov_Cotonou,300000,208445,2022-06-11
CASH_OUT,128708,Luc Lévêque-Carre,151378,22670,Agence_moov_Abomey,300000,171292,2022-06-12
TRANSFER,8149,Luc Lévêque-Carre,22670,14521,Luc Lévêque-Carre,22670,30819,2022-06-13
CASH_OUT,9855,Luc Lévêque-Carre,14521,4666,Agence_moov_Abomey,300000,290145,2022-06-15
CASH_IN,269498,Agence_moov_Cotonou,300000,30502,Luc Lévêque-Carre,4666,274164,2022-06-21
CASH_IN,263962,Agence_moov_Cotonou,300000,36038,Luc Lévêque-Carre,274164,538126,2022-06-25
CASH_IN,77036,Agence_moov_Cotonou,300000,222964,Léon Da Costa,-254681,-177645,2022-06-03
CASH_IN,83875,Agence_moov_Ouidah,300000,216125,Léon Da Costa,-177645,-93770,2022-06-04
CASH_IN,124282,Agence_moov_Cotonou,300000,175718,Léon Da Costa,-93770,30512,2022-06-09
CASH_IN,96878,Agence_moov_Cotonou,300000,203122,Léon Da Costa,30512,127390,2022-06-13
CASH_IN,99268,Agence_moov_Ouidah,300000,200732,Léon Da Costa,127390,226658,2022-06-19
TRANSFER,94138,Léon Da Costa,226658,132520,Léon Da Costa,226658,132520,2022-06-20
TRANSFER,82721,Léon Da Costa,132520,49799,Léon Da Costa,132520,49799,2022-06-22
CASH_IN,286325,Agence_moov_Ouidah,300000,13675,Camille Prévost,-1615,284710,2022-06-01
TRANSFER,71484,Camille Prévost,284710,213226,Camille Prévost,284710,356194,2022-06-01
CASH_OUT,201856,Camille Prévost,213226,11370,Agence_moov_Abomey,300000,98144,2022-06-03
CASH_IN,292355,Agence_moov_Ouidah,300000,7645,Camille Prévost,11370,303725,2022-06-07
CASH_IN,308,Agence_moov_Cotonou,300000,299692,Camille Prévost,303725,304033,2022-06-09
CASH_OUT,174986,Camille Prévost,304033,129047,Agence_moov_Cotonou,300000,125014,2022-06-16
CASH_IN,278736,Agence_moov_Ouidah,300000,21264,Camille Prévost,129047,407783,2022-06-16
CASH_IN,226456,Agence_moov_Abomey,300000,73544,Camille Prévost,407783,634239,2022-06-20
CASH_OUT,287740,Paul Rocher-Maillet,1651500,1363760,Agence_moov_Abomey,300000,12260,2022-07-13
CASH_OUT,1119891,Paul Rocher-Maillet,1363760,243869,Agence_moov_Cotonou,300000,-819891,2022-07-15
TRANSFER,466991,Robert-Louis Gosselin,646500,179509,Paul Rocher-Maillet,243869,710860,2022-07-23
TRANSFER,643934,Paul Rocher-Maillet,710860,66926,Paulette Loiseau,1944900,1300966,2022-07-27
CASH_IN,26940,Agence_moov_Abomey,300000,273060,Paul Rocher-Maillet,66926,93866,2022-07-27
CASH_OUT,512767,Marcelle-Valentine Guibert,1301000,788233,Agence_moov_Ouidah,300000,-212767,2022-07-23
TRANSFER,412341,Camille Morvan,610000,197659,Émilie du Allain,1809600,2221941,2022-07-11
CASH_OUT,298824,Raymond Lévy,367300,68476,Agence_moov_Cotonou,300000,1176,2022-07-04
TRANSFER,54952,Raymond Lévy,68476,13524,Manon Valette,1727400,1672448,2022-07-14
CASH_OUT,570593,Nath Loiseau,591700,21107,Agence_moov_Abomey,300000,-270593,2022-07-01
TRANSFER,2488,Sabine Pineau,259500,257012,Alix Barbe,28200,25712,2022-07-02
CASH_IN,102744,Agence_moov_Ouidah,300000,197256,Sabine Pineau,257012,359756,2022-07-21
TRANSFER,834330,Nicolas Salmon Le Hamon,1889400,1055070,Sabine Pineau,359756,1194086,2022-07-27
CASH_IN,43590,Agence_moov_Cotonou,300000,256410,Thérèse François,1275300,1318890,2022-07-09
TRANSFER,141330,Thérèse François,1318890,1177560,Camille Morvan,197659,56329,2022-07-23
CASH_OUT,507287,Bernadette de Jourdan,1155200,647913,Agence_moov_Ouidah,300000,-207287,2022-07-04
CASH_IN,251193,Agence_moov_Cotonou,300000,48807,Bernadette de Jourdan,647913,899106,2022-07-18
CASH_OUT,597911,Bernadette de Jourdan,899106,301195,Agence_moov_Abomey,300000,-297911,2022-07-20
TRANSFER,87222,Bernadette de Jourdan,301195,213973,Gérard de la Martinez,876100,788878,2022-07-24
CASH_OUT,102193,Bernadette de Jourdan,213973,111780,Agence_moov_Cotonou,300000,197807,2022-07-26
CASH_IN,196103,Agence_moov_Cotonou,300000,103897,Emmanuel Grégoire,1298600,1494703,2022-07-05
CASH_IN,246564,Agence_moov_Cotonou,300000,53436,Emmanuel Grégoire,1494703,1741267,2022-07-17
CASH_OUT,1398347,Emmanuel Grégoire,1741267,342920,Agence_moov_Abomey,300000,-1098347,2022-07-27
CASH_IN,97571,Agence_moov_Abomey,300000,202429,Vincent Joubert,748400,845971,2022-07-04
CASH_OUT,45255,Gabriel Bègue,1746900,1701645,Agence_moov_Abomey,300000,254745,2022-07-02
TRANSFER,655675,Gabriel Bègue,1701645,1045970,Adèle Da Silva-Klein,515800,-139875,2022-07-10
CASH_IN,102064,Agence_moov_Abomey,300000,197936,Gabriel Bègue,1045970,1148034,2022-07-10
CASH_IN,263005,Agence_moov_Abomey,300000,36995,Tristan Gomez,1157100,1420105,2022-07-01
TRANSFER,485591,Tristan Gomez,1420105,934514,Tristan Gomez,1420105,1905696,2022-07-01
CASH_IN,202536,Agence_moov_Ouidah,300000,97464,Tristan Gomez,934514,1137050,2022-07-13
TRANSFER,622705,Tristan Gomez,1137050,514345,Antoinette de Dupuis,1266500,643795,2022-07-15
CASH_OUT,167898,Tristan Gomez,514345,346447,Agence_moov_Cotonou,300000,132102,2022-07-23
CASH_IN,30224,Agence_moov_Cotonou,300000,269776,Manon Lebon,1894800,1925024,2022-07-03
CASH_OUT,1830012,Manon Lebon,1925024,95012,Agence_moov_Cotonou,300000,-1530012,2022-07-05
TRANSFER,914914,Paul Perez,1132200,217286,Manon Lebon,95012,1009926,2022-07-06
TRANSFER,1230123,Jules Fernandes,1508800,278677,Manon Lebon,1009926,2240049,2022-07-25
TRANSFER,131998,Agnès Le Giraud,457300,325302,Victor Michel,1347800,1215802,2022-07-03
CASH_OUT,81049,Agnès Le Giraud,325302,244253,Agence_moov_Ouidah,300000,218951,2022-07-16
CASH_IN,74830,Agence_moov_Abomey,300000,225170,Agnès Le Giraud,244253,319083,2022-07-18
CASH_IN,70326,Agence_moov_Abomey,300000,229674,Adèle Da Silva-Klein,-139875,-69549,2022-07-21
CASH_IN,225947,Agence_moov_Cotonou,300000,74053,Adèle Da Silva-Klein,-69549,156398,2022-07-23
CASH_OUT,107154,Adèle Da Silva-Klein,156398,49244,Agence_moov_Abomey,300000,192846,2022-07-25
TRANSFER,924855,Françoise Morin,1173300,248445,Noël Bourgeois,1913800,2838655,2022-07-04
TRANSFER,158515,Thérèse Hubert,792300,633785,Noël Bourgeois,2838655,2997170,2022-07-08
CASH_OUT,1254239,Noël Bourgeois,2997170,1742931,Agence_moov_Ouidah,300000,-954239,2022-07-23
TRANSFER,192234,Noël Bourgeois,1742931,1550697,Colette Merle Le Robert,1054000,861766,2022-07-26
CASH_OUT,381359,Michelle Samson,430400,49041,Agence_moov_Cotonou,300000,-81359,2022-07-06
TRANSFER,1628,Thomas Guichard du Renault,73800,72172,Michelle Samson,49041,50669,2022-07-09
TRANSFER,22084,Michelle Samson,50669,28585,Audrey Julien de Leleu,1062600,1040516,2022-07-26
CASH_OUT,388841,Jules-Roland Bousquet,504500,115659,Agence_moov_Ouidah,300000,-88841,2022-07-04
CASH_IN,50177,Agence_moov_Abomey,300000,249823,Jules-Roland Bousquet,115659,165836,2022-07-09
CASH_OUT,96290,Jules-Roland Bousquet,165836,69546,Agence_moov_Cotonou,300000,203710,2022-07-19
CASH_OUT,44974,Jules-Roland Bousquet,69546,24572,Agence_moov_Abomey,300000,255026,2022-07-19
CASH_IN,159060,Agence_moov_Ouidah,300000,140940,Thomas Guichard du Renault,72172,231232,2022-07-04
CASH_OUT,157885,Thomas Guichard du Renault,231232,73347,Agence_moov_Cotonou,300000,142115,2022-07-06
CASH_IN,219260,Agence_moov_Cotonou,300000,80740,Thomas Guichard du Renault,73347,292607,2022-07-16
CASH_OUT,157305,Thomas Guichard du Renault,292607,135302,Agence_moov_Abomey,300000,142695,2022-07-21
CASH_IN,215094,Agence_moov_Cotonou,300000,84906,Thomas Guichard du Renault,135302,350396,2022-07-27
CASH_IN,130468,Agence_moov_Abomey,300000,169532,Émile-René Baudry,726300,856768,2022-07-06
CASH_IN,289708,Agence_moov_Ouidah,300000,10292,Émile-René Baudry,856768,1146476,2022-07-23
TRANSFER,420471,Luc Lévêque-Carre,456500,36029,Nathalie Bonnin-Joubert,20000,-400471,2022-07-08
CASH_OUT,30971,Luc Lévêque-Carre,36029,5058,Agence_moov_Abomey,300000,269029,2022-07-08
CASH_OUT,161,Luc Lévêque-Carre,5058,4897,Agence_moov_Cotonou,300000,299839,2022-07-13
TRANSFER,480212,Frédérique Fernandes du Bouchet,661200,180988,Luc Lévêque-Carre,4897,485109,2022-07-14
CASH_OUT,105490,Luc Lévêque-Carre,485109,379619,Agence_moov_Ouidah,300000,194510,2022-07-21
CASH_IN,278428,Agence_moov_Abomey,300000,21572,Céline Collin-Hervé,1667600,1946028,2022-07-08
CASH_IN,233350,Agence_moov_Cotonou,300000,66650,Céline Collin-Hervé,1946028,2179378,2022-07-13
CASH_IN,291568,Agence_moov_Cotonou,300000,8432,Céline Collin-Hervé,2179378,2470946,2022-07-15
CASH_IN,208254,Agence_moov_Abomey,300000,91746,Véronique Martins de Fleury,582400,790654,2022-07-10
TRANSFER,25205,Véronique Martins de Fleury,790654,765449,Marc Leleu,1493100,1467895,2022-07-20
CASH_IN,219731,Agence_moov_Abomey,300000,80269,Véronique Martins de Fleury,765449,985180,2022-07-24
CASH_IN,119009,Agence_moov_Abomey,300000,180991,Robert Laroche,528800,647809,2022-07-22
CASH_OUT,455851,Thibaut de la Roy,1566100,1110249,Agence_moov_Ouidah,300000,-155851,2022-07-01
CASH_IN,243883,Agence_moov_Abomey,300000,56117,Thibaut de la Roy,1110249,1354132,2022-07-03
CASH_IN,235429,Agence_moov_Abomey,300000,64571,Thibaut de la Roy,1354132,1589561,2022-07-03
CASH_IN,131139,Agence_moov_Cotonou,300000,168861,Thibaut de la Roy,1589561,1720700,2022-07-04
CASH_OUT,1221560,Thibaut de la Roy,1720700,499140,Agence_moov_Cotonou,300000,-921560,2022-07-04
TRANSFER,594307,Théodore Joseph-Lefebvre,1352000,757693,Thibaut de la Roy,499140,1093447,2022-07-05
CASH_OUT,1066970,Thibaut de la Roy,1093447,26477,Agence_moov_Cotonou,300000,-766970,2022-07-05
CASH_OUT,10092,Thibaut de la Roy,26477,16385,Agence_moov_Abomey,300000,289908,2022-07-06
CASH_OUT,5658,Thibaut de la Roy,16385,10727,Agence_moov_Abomey,300000,294342,2022-07-06
CASH_OUT,2952,Thibaut de la Roy,10727,7775,Agence_moov_Abomey,300000,297048,2022-07-11
CASH_OUT,7025,Thibaut de la Roy,7775,750,Agence_moov_Ouidah,300000,292975,2022-07-12
TRANSFER,1187545,Alphonse Joly,1902000,714455,Thibaut de la Roy,750,1188295,2022-07-15
TRANSFER,954087,Thibaut de la Roy,1188295,234208,Thomas-Robert Morvan,157000,-797087,2022-07-16
TRANSFER,233957,Vincent de la Dumont,1130300,896343,Thibaut de la Roy,234208,468165,2022-07-18
CASH_IN,42892,Agence_moov_Ouidah,300000,257108,Thibaut de la Roy,468165,511057,2022-07-19
CASH_OUT,29753,Thibaut de la Roy,511057,481304,Agence_moov_Abomey,300000,270247,2022-07-21
CASH_OUT,277428,Thibaut de la Roy,481304,203876,Agence_moov_Abomey,300000,22572,2022-07-22
CASH_OUT,199308,Thibaut de la Roy,203876,4568,Agence_moov_Cotonou,300000,100692,2022-07-22
CASH_OUT,4540,Thibaut de la Roy,4568,28,Agence_moov_Abomey,300000,295460,2022-07-22
CASH_IN,233549,Agence_moov_Cotonou,300000,66451,Thibaut de la Roy,28,233577,2022-07-22
CASH_OUT,38055,Thibaut de la Roy,233577,195522,Agence_moov_Ouidah,300000,261945,2022-07-23
CASH_IN,132780,Agence_moov_Ouidah,300000,167220,Thibaut de la Roy,195522,328302,2022-07-23
CASH_OUT,318712,Thibaut de la Roy,328302,9590,Agence_moov_Cotonou,300000,-18712,2022-07-23
CASH_OUT,1529,Thibaut de la Roy,9590,8061,Agence_moov_Abomey,300000,298471,2022-07-23
TRANSFER,212,Thibaut de la Roy,8061,7849,Noémi Bouvier,342400,342188,2022-07-24
TRANSFER,116935,Frédéric Guillou,132100,15165,Thibaut de la Roy,7849,124784,2022-07-24
CASH_OUT,33641,Thibaut de la Roy,124784,91143,Agence_moov_Ouidah,300000,266359,2022-07-24
CASH_IN,63916,Agence_moov_Ouidah,300000,236084,Thibaut de la Roy,91143,155059,2022-07-26
CASH_OUT,51992,Thibaut de la Roy,155059,103067,Agence_moov_Abomey,300000,248008,2022-07-26
CASH_IN,127908,Agence_moov_Ouidah,300000,172092,Thibaut de la Roy,103067,230975,2022-07-27
CASH_IN,81831,Agence_moov_Ouidah,300000,218169,Gérard de la Martinez,788878,870709,2022-07-01
CASH_IN,44939,Agence_moov_Ouidah,300000,255061,Gérard de la Martinez,870709,915648,2022-07-01
TRANSFER,845893,Gérard de la Martinez,915648,69755,Lucie Aubert,1397800,551907,2022-07-02
CASH_IN,37336,Agence_moov_Abomey,300000,262664,Gérard de la Martinez,69755,107091,2022-07-03
TRANSFER,453118,Nicolas Salmon Le Hamon,1055070,601952,Gérard de la Martinez,107091,560209,2022-07-03
CASH_IN,126416,Agence_moov_Abomey,300000,173584,Gérard de la Martinez,560209,686625,2022-07-03
CASH_IN,90193,Agence_moov_Ouidah,300000,209807,Gérard de la Martinez,686625,776818,2022-07-04
CASH_OUT,520095,Gérard de la Martinez,776818,256723,Agence_moov_Ouidah,300000,-220095,2022-07-07
CASH_OUT,245488,Gérard de la Martinez,256723,11235,Agence_moov_Abomey,300000,54512,2022-07-08
CASH_IN,22287,Agence_moov_Cotonou,300000,277713,Gérard de la Martinez,11235,33522,2022-07-10
CASH_IN,255773,Agence_moov_Ouidah,300000,44227,Gérard de la Martinez,33522,289295,2022-07-10
CASH_IN,94923,Agence_moov_Ouidah,300000,205077,Gérard de la Martinez,289295,384218,2022-07-11
CASH_IN,187468,Agence_moov_Ouidah,300000,112532,Gérard de la Martinez,384218,571686,2022-07-13
CASH_IN,235012,Agence_moov_Ouidah,300000,64988,Gérard de la Martinez,571686,806698,2022-07-14
CASH_IN,114344,Agence_moov_Cotonou,300000,185656,Gérard de la Martinez,806698,921042,2022-07-15
CASH_IN,293160,Agence_moov_Cotonou,300000,6840,Gérard de la Martinez,921042,1214202,2022-07-17
CASH_IN,216447,Agence_moov_Cotonou,300000,83553,Gérard de la Martinez,1214202,1430649,2022-07-18
CASH_OUT,133349,Gérard de la Martinez,1430649,1297300,Agence_moov_Ouidah,300000,166651,2022-07-18
TRANSFER,609922,Gérard de la Martinez,1297300,687378,Robert-Louis Gosselin,179509,-430413,2022-07-19
TRANSFER,520375,Gérard de la Martinez,687378,167003,Renée Le Diaz,1151900,631525,2022-07-21
TRANSFER,77011,Gérard de la Martinez,167003,89992,Marthe Gilles,582500,505489,2022-07-22
TRANSFER,701425,Paulette Loiseau,1300966,599541,Gérard de la Martinez,89992,791417,2022-07-23
TRANSFER,245762,Simone Muller de la Brun,391200,145438,Gérard de la Martinez,791417,1037179,2022-07-24
TRANSFER,142011,Gérard de la Martinez,1037179,895168,Maggie Martinez,611500,469489,2022-07-25
TRANSFER,1334981,Philippe Philippe,1850400,515419,Gérard de la Martinez,895168,2230149,2022-07-25
TRANSFER,1732303,Gérard de la Martinez,2230149,497846,Matthieu-Matthieu Bigot,911900,-820403,2022-07-26
CASH_IN,219919,Agence_moov_Cotonou,300000,80081,Gérard de la Martinez,497846,717765,2022-07-27
CASH_IN,208875,Agence_moov_Ouidah,300000,91125,Gérard de la Martinez,717765,926640,2022-07-27
CASH_IN,292490,Agence_moov_Abomey,300000,7510,Gérard de la Martinez,926640,1219130,2022-07-27
TRANSFER,416466,Antoinette de Dupuis,643795,227329,Thérèse Hubert,633785,217319,2022-07-01
CASH_IN,249666,Agence_moov_Cotonou,300000,50334,Antoinette de Dupuis,227329,476995,2022-07-01
CASH_OUT,9450,Antoinette de Dupuis,476995,467545,Agence_moov_Cotonou,300000,290550,2022-07-02
TRANSFER,203325,Antoinette de Dupuis,467545,264220,Richard Michel,1548500,1345175,2022-07-03
TRANSFER,333148,Richard Michel,1345175,1012027,Antoinette de Dupuis,264220,597368,2022-07-05
CASH_IN,79009,Agence_moov_Abomey,300000,220991,Antoinette de Dupuis,597368,676377,2022-07-06
CASH_OUT,440898,Antoinette de Dupuis,676377,235479,Agence_moov_Abomey,300000,-140898,2022-07-07
CASH_OUT,162317,Antoinette de Dupuis,235479,73162,Agence_moov_Cotonou,300000,137683,2022-07-08
TRANSFER,358409,Robert Clerc,360500,2091,Antoinette de Dupuis,73162,431571,2022-07-09
CASH_IN,106983,Agence_moov_Ouidah,300000,193017,Antoinette de Dupuis,431571,538554,2022-07-12
CASH_OUT,193480,Antoinette de Dupuis,538554,345074,Agence_moov_Ouidah,300000,106520,2022-07-14
TRANSFER,421456,Aimé Pages,1495900,1074444,Antoinette de Dupuis,345074,766530,2022-07-15
CASH_OUT,694680,Antoinette de Dupuis,766530,71850,Agence_moov_Ouidah,300000,-394680,2022-07-15
TRANSFER,28699,Antoinette de Dupuis,71850,43151,Timothée-René Blanchard,885200,856501,2022-07-15
TRANSFER,23095,Antoinette de Dupuis,43151,20056,Léon Da Costa,1560500,1537405,2022-07-16
CASH_IN,134399,Agence_moov_Abomey,300000,165601,Antoinette de Dupuis,20056,154455,2022-07-16
CASH_IN,249868,Agence_moov_Ouidah,300000,50132,Antoinette de Dupuis,154455,404323,2022-07-17
CASH_OUT,246273,Antoinette de Dupuis,404323,158050,Agence_moov_Cotonou,300000,53727,2022-07-17
TRANSFER,77199,Antoinette de Dupuis,158050,80851,Michelle-Dorothée Lévêque,1162200,1085001,2022-07-23
CASH_IN,174474,Agence_moov_Cotonou,300000,125526,Antoinette de Dupuis,80851,255325,2022-07-23
CASH_OUT,81173,Antoinette de Dupuis,255325,174152,Agence_moov_Abomey,300000,218827,2022-07-23
CASH_IN,270268,Agence_moov_Ouidah,300000,29732,Antoinette de Dupuis,174152,444420,2022-07-24
TRANSFER,194143,Antoinette de Dupuis,444420,250277,Colette Merle Le Robert,861766,667623,2022-07-26
CASH_IN,244154,Agence_moov_Abomey,300000,55846,Antoinette de Dupuis,250277,494431,2022-07-27
CASH_OUT,37562,Anne Peltier-Raynaud,38500,938,Agence_moov_Cotonou,300000,262438,2022-07-01
CASH_IN,188186,Agence_moov_Cotonou,300000,111814,Anne Peltier-Raynaud,938,189124,2022-07-01
CASH_IN,281500,Agence_moov_Ouidah,300000,18500,Anne Peltier-Raynaud,189124,470624,2022-07-01
TRANSFER,110282,Anne Peltier-Raynaud,470624,360342,Michelle-Dorothée Lévêque,1085001,974719,2022-07-01
CASH_OUT,117720,Anne Peltier-Raynaud,360342,242622,Agence_moov_Cotonou,300000,182280,2022-07-03
CASH_IN,151072,Agence_moov_Ouidah,300000,148928,Anne Peltier-Raynaud,242622,393694,2022-07-07
CASH_IN,67884,Agence_moov_Abomey,300000,232116,Anne Peltier-Raynaud,393694,461578,2022-07-07
CASH_IN,242659,Agence_moov_Cotonou,300000,57341,Anne Peltier-Raynaud,461578,704237,2022-07-07
CASH_OUT,371836,Anne Peltier-Raynaud,704237,332401,Agence_moov_Abomey,300000,-71836,2022-07-09
CASH_IN,166891,Agence_moov_Abomey,300000,133109,Anne Peltier-Raynaud,332401,499292,2022-07-10
CASH_IN,209203,Agence_moov_Abomey,300000,90797,Anne Peltier-Raynaud,499292,708495,2022-07-12
CASH_IN,171900,Agence_moov_Abomey,300000,128100,Anne Peltier-Raynaud,708495,880395,2022-07-13
CASH_IN,278952,Agence_moov_Abomey,300000,21048,Anne Peltier-Raynaud,880395,1159347,2022-07-14
TRANSFER,39901,Simone Muller de la Brun,145438,105537,Anne Peltier-Raynaud,1159347,1199248,2022-07-15
CASH_IN,92647,Agence_moov_Ouidah,300000,207353,Anne Peltier-Raynaud,1199248,1291895,2022-07-15
TRANSFER,98655,Anne Peltier-Raynaud,1291895,1193240,Astrid Lecoq,1887300,1788645,2022-07-16
TRANSFER,90481,Nicolas Salmon Le Hamon,601952,511471,Anne Peltier-Raynaud,1193240,1283721,2022-07-16
TRANSFER,608555,Anne Peltier-Raynaud,1283721,675166,Hélène de la Gérard,1583200,974645,2022-07-19
CASH_IN,84769,Agence_moov_Ouidah,300000,215231,Anne Peltier-Raynaud,675166,759935,2022-07-19
TRANSFER,43118,Françoise Morin,248445,205327,Anne Peltier-Raynaud,759935,803053,2022-07-20
CASH_IN,219035,Agence_moov_Abomey,300000,80965,Anne Peltier-Raynaud,803053,1022088,2022-07-21
TRANSFER,290076,Anne Peltier-Raynaud,1022088,732012,Frédéric Guillou,15165,-274911,2022-07-22
CASH_OUT,665950,Anne Peltier-Raynaud,732012,66062,Agence_moov_Abomey,300000,-365950,2022-07-25
CASH_IN,281651,Agence_moov_Cotonou,300000,18349,Astrid Lecoq,1788645,2070296,2022-07-01
CASH_OUT,759587,Astrid Lecoq,2070296,1310709,Agence_moov_Cotonou,300000,-459587,2022-07-02
CASH_IN,233781,Agence_moov_Ouidah,300000,66219,Astrid Lecoq,1310709,1544490,2022-07-02
CASH_IN,114176,Agence_moov_Abomey,300000,185824,Astrid Lecoq,1544490,1658666,2022-07-02
CASH_IN,285671,Agence_moov_Cotonou,300000,14329,Astrid Lecoq,1658666,1944337,2022-07-05
TRANSFER,54165,Bertrand Regnier,1211900,1157735,Astrid Lecoq,1944337,1998502,2022-07-06
CASH_IN,161192,Agence_moov_Ouidah,300000,138808,Astrid Lecoq,1998502,2159694,2022-07-08
TRANSFER,321637,Marc Leleu,1467895,1146258,Astrid Lecoq,2159694,2481331,2022-07-08
TRANSFER,222104,Lucie Aubert,551907,329803,Astrid Lecoq,2481331,2703435,2022-07-12
CASH_OUT,1600581,Astrid Lecoq,2703435,1102854,Agence_moov_Abomey,300000,-1300581,2022-07-12
CASH_OUT,194669,Astrid Lecoq,1102854,908185,Agence_moov_Ouidah,300000,105331,2022-07-12
TRANSFER,478914,Astrid Lecoq,908185,429271,Manon Valette,1672448,1193534,2022-07-13
CASH_OUT,116780,Astrid Lecoq,429271,312491,Agence_moov_Cotonou,300000,183220,2022-07-16
TRANSFER,709407,Théodore Joseph-Lefebvre,757693,48286,Astrid Lecoq,312491,1021898,2022-07-18
TRANSFER,48181,Astrid Lecoq,1021898,973717,Astrid Lecoq,1021898,1070079,2022-07-18
CASH_OUT,935225,Astrid Lecoq,973717,38492,Agence_moov_Cotonou,300000,-635225,2022-07-20
CASH_IN,62217,Agence_moov_Abomey,300000,237783,Astrid Lecoq,38492,100709,2022-07-21
CASH_IN,5299,Agence_moov_Abomey,300000,294701,Astrid Lecoq,100709,106008,2022-07-22
CASH_OUT,7663,Astrid Lecoq,106008,98345,Agence_moov_Cotonou,300000,292337,2022-07-23
TRANSFER,42693,Astrid Lecoq,98345,55652,Paul Perez,217286,174593,2022-07-24
CASH_OUT,3126,Astrid Lecoq,55652,52526,Agence_moov_Abomey,300000,296874,2022-07-24
CASH_IN,141278,Agence_moov_Ouidah,300000,158722,Astrid Lecoq,52526,193804,2022-07-25
CASH_IN,157876,Agence_moov_Ouidah,300000,142124,Astrid Lecoq,193804,351680,2022-07-26
CASH_IN,205468,Agence_moov_Abomey,300000,94532,Astrid Lecoq,351680,557148,2022-07-27
TRANSFER,121267,Astrid Lecoq,557148,435881,Thérèse Hubert,217319,96052,2022-07-27
CASH_IN,149449,Agence_moov_Ouidah,300000,150551,Lucy Lamy,1638700,1788149,2022-07-01
CASH_OUT,123016,Lucy Lamy,1788149,1665133,Agence_moov_Cotonou,300000,176984,2022-07-01
TRANSFER,298102,Stéphane Munoz,840000,541898,Lucy Lamy,1665133,1963235,2022-07-02
CASH_OUT,1284254,Lucy Lamy,1963235,678981,Agence_moov_Cotonou,300000,-984254,2022-07-02
CASH_IN,111079,Agence_moov_Abomey,300000,188921,Lucy Lamy,678981,790060,2022-07-03
CASH_OUT,305816,Lucy Lamy,790060,484244,Agence_moov_Abomey,300000,-5816,2022-07-06
CASH_IN,190784,Agence_moov_Ouidah,300000,109216,Lucy Lamy,484244,675028,2022-07-07
CASH_OUT,278246,Lucy Lamy,675028,396782,Agence_moov_Ouidah,300000,21754,2022-07-09
CASH_IN,296138,Agence_moov_Ouidah,300000,3862,Lucy Lamy,396782,692920,2022-07-09
TRANSFER,384857,André Renault,1474700,1089843,Lucy Lamy,692920,1077777,2022-07-09
TRANSFER,750758,Tristan Bousquet-Gros,1419800,669042,Lucy Lamy,1077777,1828535,2022-07-09
CASH_OUT,791676,Lucy Lamy,1828535,1036859,Agence_moov_Cotonou,300000,-491676,2022-07-10
TRANSFER,1610279,Rémy Grondin,1631600,21321,Lucy Lamy,1036859,2647138,2022-07-12
TRANSFER,1622994,Lucy Lamy,2647138,1024144,Anastasie Cousin,410700,-1212294,2022-07-13
CASH_OUT,370682,Lucy Lamy,1024144,653462,Agence_moov_Abomey,300000,-70682,2022-07-14
CASH_OUT,354320,Lucy Lamy,653462,299142,Agence_moov_Cotonou,300000,-54320,2022-07-14
CASH_OUT,118135,Lucy Lamy,299142,181007,Agence_moov_Abomey,300000,181865,2022-07-14
CASH_OUT,53726,Lucy Lamy,181007,127281,Agence_moov_Cotonou,300000,246274,2022-07-15
CASH_OUT,40428,Lucy Lamy,127281,86853,Agence_moov_Cotonou,300000,259572,2022-07-17
CASH_OUT,64607,Lucy Lamy,86853,22246,Agence_moov_Abomey,300000,235393,2022-07-17
TRANSFER,1032249,Marc Leleu,1146258,114009,Lucy Lamy,22246,1054495,2022-07-17
CASH_OUT,554533,Lucy Lamy,1054495,499962,Agence_moov_Ouidah,300000,-254533,2022-07-17
TRANSFER,23067,Lucy Lamy,499962,476895,Colette Merle Le Robert,667623,644556,2022-07-18
CASH_OUT,299286,Lucy Lamy,476895,177609,Agence_moov_Ouidah,300000,714,2022-07-20
TRANSFER,92594,Lucy Lamy,177609,85015,Constance Bourdon-Millet,479400,386806,2022-07-21
CASH_OUT,6925,Lucy Lamy,85015,78090,Agence_moov_Ouidah,300000,293075,2022-07-23
CASH_IN,234147,Agence_moov_Ouidah,300000,65853,Lucy Lamy,78090,312237,2022-07-25
CASH_OUT,142402,Lucy Lamy,312237,169835,Agence_moov_Cotonou,300000,157598,2022-07-26
CASH_IN,63204,Agence_moov_Cotonou,300000,236796,Jules Fernandes,278677,341881,2022-07-02
CASH_IN,294389,Agence_moov_Ouidah,300000,5611,Jules Fernandes,341881,636270,2022-07-04
CASH_IN,257179,Agence_moov_Ouidah,300000,42821,Jules Fernandes,636270,893449,2022-07-04
CASH_OUT,44243,Jules Fernandes,893449,849206,Agence_moov_Ouidah,300000,255757,2022-07-05
CASH_OUT,83699,Jules Fernandes,849206,765507,Agence_moov_Ouidah,300000,216301,2022-07-05
TRANSFER,164791,Suzanne Bodin,632700,467909,Jules Fernandes,765507,930298,2022-07-06
CASH_IN,4904,Agence_moov_Cotonou,300000,295096,Jules Fernandes,930298,935202,2022-07-08
CASH_OUT,643655,Jules Fernandes,935202,291547,Agence_moov_Ouidah,300000,-343655,2022-07-10
CASH_IN,82014,Agence_moov_Cotonou,300000,217986,Jules Fernandes,291547,373561,2022-07-11
CASH_IN,25073,Agence_moov_Cotonou,300000,274927,Jules Fernandes,373561,398634,2022-07-11
TRANSFER,317521,Jules Fernandes,398634,81113,Rémy Grondin,21321,-296200,2022-07-12
CASH_OUT,51497,Jules Fernandes,81113,29616,Agence_moov_Ouidah,300000,248503,2022-07-13
CASH_OUT,3355,Jules Fernandes,29616,26261,Agence_moov_Ouidah,300000,296645,2022-07-15
TRANSFER,116241,Philippe Philippe,515419,399178,Jules Fernandes,26261,142502,2022-07-15
CASH_OUT,88851,Jules Fernandes,142502,53651,Agence_moov_Cotonou,300000,211149,2022-07-15
CASH_OUT,7189,Jules Fernandes,53651,46462,Agence_moov_Ouidah,300000,292811,2022-07-16
CASH_OUT,1484,Jules Fernandes,46462,44978,Agence_moov_Abomey,300000,298516,2022-07-17
CASH_OUT,39245,Jules Fernandes,44978,5733,Agence_moov_Abomey,300000,260755,2022-07-17
TRANSFER,615,Jules Fernandes,5733,5118,Robert Clerc,2091,1476,2022-07-17
TRANSFER,3380,Théodore Joseph-Lefebvre,48286,44906,Jules Fernandes,5118,8498,2022-07-18
TRANSFER,5567,Jules Fernandes,8498,2931,Aimé Pages,1074444,1068877,2022-07-19
TRANSFER,356,Jules Fernandes,2931,2575,Vincent de la Dumont,896343,895987,2022-07-20
CASH_OUT,2468,Jules Fernandes,2575,107,Agence_moov_Ouidah,300000,297532,2022-07-20
CASH_OUT,107,Jules Fernandes,107,0,Agence_moov_Ouidah,300000,299893,2022-07-20
CASH_IN,115168,Agence_moov_Abomey,300000,184832,Jules Fernandes,0,115168,2022-07-20
CASH_OUT,92207,Jules Fernandes,115168,22961,Agence_moov_Abomey,300000,207793,2022-07-21
CASH_OUT,13309,Jules Fernandes,22961,9652,Agence_moov_Ouidah,300000,286691,2022-07-24
TRANSFER,85805,Paulette Loiseau,599541,513736,Jules Fernandes,9652,95457,2022-07-24
CASH_IN,291853,Agence_moov_Cotonou,300000,8147,Jules Fernandes,95457,387310,2022-07-27
TRANSFER,253187,Jules Fernandes,387310,134123,Tristan Bousquet-Gros,669042,415855,2022-07-27
TRANSFER,18276,Théodore Joseph-Lefebvre,44906,26630,Paul Perez,174593,156317,2022-07-01
TRANSFER,519992,Renée Le Diaz,631525,111533,Théodore Joseph-Lefebvre,26630,546622,2022-07-01
CASH_IN,150946,Agence_moov_Ouidah,300000,149054,Théodore Joseph-Lefebvre,546622,697568,2022-07-01
CASH_OUT,250169,Théodore Joseph-Lefebvre,697568,447399,Agence_moov_Ouidah,300000,49831,2022-07-05
TRANSFER,247289,Bertrand Regnier,1157735,910446,Théodore Joseph-Lefebvre,447399,694688,2022-07-06
CASH_OUT,650629,Théodore Joseph-Lefebvre,694688,44059,Agence_moov_Abomey,300000,-350629,2022-07-06
CASH_IN,180685,Agence_moov_Ouidah,300000,119315,Théodore Joseph-Lefebvre,44059,224744,2022-07-07
CASH_IN,201979,Agence_moov_Abomey,300000,98021,Théodore Joseph-Lefebvre,224744,426723,2022-07-09
CASH_OUT,274105,Théodore Joseph-Lefebvre,426723,152618,Agence_moov_Abomey,300000,25895,2022-07-09
CASH_IN,34204,Agence_moov_Abomey,300000,265796,Théodore Joseph-Lefebvre,152618,186822,2022-07-10
TRANSFER,277769,Suzanne Bodin,467909,190140,Théodore Joseph-Lefebvre,186822,464591,2022-07-12
CASH_OUT,341479,Théodore Joseph-Lefebvre,464591,123112,Agence_moov_Abomey,300000,-41479,2022-07-13
TRANSFER,20557,Théodore Joseph-Lefebvre,123112,102555,Christine Texier,329100,308543,2022-07-13
CASH_OUT,46841,Théodore Joseph-Lefebvre,102555,55714,Agence_moov_Abomey,300000,253159,2022-07-16
CASH_OUT,643,Théodore Joseph-Lefebvre,55714,55071,Agence_moov_Abomey,300000,299357,2022-07-18
TRANSFER,914159,Michelle de Étienne,1636200,722041,Théodore Joseph-Lefebvre,55071,969230,2022-07-19
TRANSFER,728339,Théodore Joseph-Lefebvre,969230,240891,Vincent de la Dumont,895987,167648,2022-07-19
CASH_OUT,121735,Théodore Joseph-Lefebvre,240891,119156,Agence_moov_Ouidah,300000,178265,2022-07-19
CASH_OUT,56284,Théodore Joseph-Lefebvre,119156,62872,Agence_moov_Cotonou,300000,243716,2022-07-19
CASH_OUT,2097,Théodore Joseph-Lefebvre,62872,60775,Agence_moov_Abomey,300000,297903,2022-07-22
CASH_OUT,21536,Théodore Joseph-Lefebvre,60775,39239,Agence_moov_Abomey,300000,278464,2022-07-23
CASH_IN,24139,Agence_moov_Ouidah,300000,275861,Théodore Joseph-Lefebvre,39239,63378,2022-07-24
CASH_IN,83775,Agence_moov_Ouidah,300000,216225,Théodore Joseph-Lefebvre,63378,147153,2022-07-24
CASH_IN,141515,Agence_moov_Abomey,300000,158485,Théodore Joseph-Lefebvre,147153,288668,2022-07-25
TRANSFER,69922,Marc Leleu,114009,44087,Théodore Joseph-Lefebvre,288668,358590,2022-07-26
CASH_IN,15750,Agence_moov_Abomey,300000,284250,Théodore Joseph-Lefebvre,358590,374340,2022-07-26
CASH_OUT,242338,Théodore Joseph-Lefebvre,374340,132002,Agence_moov_Abomey,300000,57662,2022-07-27
TRANSFER,77742,Renée Le Diaz,111533,33791,Virginie Bouvet,1291400,1213658,2022-07-01
CASH_OUT,17912,Renée Le Diaz,33791,15879,Agence_moov_Cotonou,300000,282088,2022-07-04
CASH_OUT,7837,Renée Le Diaz,15879,8042,Agence_moov_Ouidah,300000,292163,2022-07-04
CASH_IN,14023,Agence_moov_Ouidah,300000,285977,Renée Le Diaz,8042,22065,2022-07-06
CASH_OUT,4464,Renée Le Diaz,22065,17601,Agence_moov_Abomey,300000,295536,2022-07-06
CASH_IN,249469,Agence_moov_Abomey,300000,50531,Renée Le Diaz,17601,267070,2022-07-08
CASH_IN,230760,Agence_moov_Ouidah,300000,69240,Renée Le Diaz,267070,497830,2022-07-08
CASH_IN,159454,Agence_moov_Cotonou,300000,140546,Renée Le Diaz,497830,657284,2022-07-08
TRANSFER,822409,Manon Valette,1193534,371125,Renée Le Diaz,657284,1479693,2022-07-08
CASH_IN,121324,Agence_moov_Cotonou,300000,178676,Renée Le Diaz,1479693,1601017,2022-07-10
TRANSFER,252772,Richard Michel,1012027,759255,Renée Le Diaz,1601017,1853789,2022-07-11
CASH_OUT,843742,Renée Le Diaz,1853789,1010047,Agence_moov_Ouidah,300000,-543742,2022-07-13
CASH_IN,42855,Agence_moov_Abomey,300000,257145,Renée Le Diaz,1010047,1052902,2022-07-14
CASH_IN,225897,Agence_moov_Abomey,300000,74103,Renée Le Diaz,1052902,1278799,2022-07-15
TRANSFER,849779,Renée Le Diaz,1278799,429020,Colette-Sophie Prévost,1268800,419021,2022-07-15
CASH_OUT,252708,Renée Le Diaz,429020,176312,Agence_moov_Cotonou,300000,47292,2022-07-16
TRANSFER,240626,Marthe Gilles,505489,264863,Renée Le Diaz,176312,416938,2022-07-17
CASH_IN,40897,Agence_moov_Abomey,300000,259103,Renée Le Diaz,416938,457835,2022-07-17
TRANSFER,18243,Camille Morvan,56329,38086,Renée Le Diaz,457835,476078,2022-07-19
TRANSFER,196612,Renée Le Diaz,476078,279466,Hélène de la Gérard,974645,778033,2022-07-20
CASH_IN,281263,Agence_moov_Abomey,300000,18737,Renée Le Diaz,279466,560729,2022-07-21
CASH_IN,177784,Agence_moov_Ouidah,300000,122216,Renée Le Diaz,560729,738513,2022-07-21
CASH_IN,73550,Agence_moov_Cotonou,300000,226450,Renée Le Diaz,738513,812063,2022-07-21
CASH_OUT,244404,Renée Le Diaz,812063,567659,Agence_moov_Cotonou,300000,55596,2022-07-24
TRANSFER,839945,Bertrand Regnier,910446,70501,Renée Le Diaz,567659,1407604,2022-07-25
CASH_IN,134655,Agence_moov_Cotonou,300000,165345,Renée Le Diaz,1407604,1542259,2022-07-27
TRANSFER,494349,Colette Merle Le Robert,644556,150207,Manon Valette,371125,-123224,2022-07-01
CASH_OUT,127806,Colette Merle Le Robert,150207,22401,Agence_moov_Abomey,300000,172194,2022-07-03
CASH_OUT,15978,Colette Merle Le Robert,22401,6423,Agence_moov_Cotonou,300000,284022,2022-07-04
CASH_OUT,3829,Colette Merle Le Robert,6423,2594,Agence_moov_Ouidah,300000,296171,2022-07-04
CASH_OUT,1163,Colette Merle Le Robert,2594,1431,Agence_moov_Abomey,300000,298837,2022-07-05
TRANSFER,339,Colette Merle Le Robert,1431,1092,Lucy Gillet,41500,41161,2022-07-05
TRANSFER,230284,Tristan Bousquet-Gros,415855,185571,Colette Merle Le Robert,1092,231376,2022-07-06
TRANSFER,113721,Colette Merle Le Robert,231376,117655,Paul Perez,156317,42596,2022-07-06
CASH_IN,282182,Agence_moov_Ouidah,300000,17818,Colette Merle Le Robert,117655,399837,2022-07-07
TRANSFER,417494,Martine Aubert,786900,369406,Colette Merle Le Robert,399837,817331,2022-07-08
CASH_OUT,305312,Colette Merle Le Robert,817331,512019,Agence_moov_Ouidah,300000,-5312,2022-07-08
TRANSFER,97906,Thomas de Blin,342100,244194,Colette Merle Le Robert,512019,609925,2022-07-09
CASH_IN,285243,Agence_moov_Ouidah,300000,14757,Colette Merle Le Robert,609925,895168,2022-07-11
CASH_OUT,61975,Colette Merle Le Robert,895168,833193,Agence_moov_Cotonou,300000,238025,2022-07-11
CASH_IN,201824,Agence_moov_Ouidah,300000,98176,Colette Merle Le Robert,833193,1035017,2022-07-11
CASH_OUT,36740,Colette Merle Le Robert,1035017,998277,Agence_moov_Cotonou,300000,263260,2022-07-14
CASH_IN,256000,Agence_moov_Cotonou,300000,44000,Colette Merle Le Robert,998277,1254277,2022-07-14
CASH_OUT,883106,Colette Merle Le Robert,1254277,371171,Agence_moov_Abomey,300000,-583106,2022-07-14
CASH_IN,3009,Agence_moov_Cotonou,300000,296991,Colette Merle Le Robert,371171,374180,2022-07-14
TRANSFER,223,Robert Clerc,1476,1253,Colette Merle Le Robert,374180,374403,2022-07-16
TRANSFER,96314,Colette Merle Le Robert,374403,278089,Frédérique Fernandes du Bouchet,180988,84674,2022-07-26
TRANSFER,3500,Lucy Gillet,41161,37661,Colette Merle Le Robert,278089,281589,2022-07-27
CASH_IN,157918,Agence_moov_Cotonou,300000,142082,Mathilde Picard du Delmas,872100,1030018,2022-07-01
CASH_IN,64828,Agence_moov_Abomey,300000,235172,Mathilde Picard du Delmas,1030018,1094846,2022-07-01
CASH_IN,278245,Agence_moov_Cotonou,300000,21755,Mathilde Picard du Delmas,1094846,1373091,2022-07-02
TRANSFER,36833,Simone Muller de la Brun,105537,68704,Mathilde Picard du Delmas,1373091,1409924,2022-07-03
CASH_OUT,48559,Mathilde Picard du Delmas,1409924,1361365,Agence_moov_Cotonou,300000,251441,2022-07-04
CASH_IN,54215,Agence_moov_Ouidah,300000,245785,Mathilde Picard du Delmas,1361365,1415580,2022-07-05
TRANSFER,1295579,Mathilde Picard du Delmas,1415580,120001,Noémi Bouvier,342188,-953391,2022-07-06
CASH_IN,236088,Agence_moov_Ouidah,300000,63912,Mathilde Picard du Delmas,120001,356089,2022-07-07
CASH_OUT,226957,Mathilde Picard du Delmas,356089,129132,Agence_moov_Ouidah,300000,73043,2022-07-07
CASH_OUT,16490,Mathilde Picard du Delmas,129132,112642,Agence_moov_Cotonou,300000,283510,2022-07-07
TRANSFER,72852,Maggie Martinez,469489,396637,Mathilde Picard du Delmas,112642,185494,2022-07-07
CASH_IN,81203,Agence_moov_Abomey,300000,218797,Mathilde Picard du Delmas,185494,266697,2022-07-09
TRANSFER,226437,Mathilde Picard du Delmas,266697,40260,Thibaut de la Lombard,571500,345063,2022-07-10
CASH_OUT,9896,Mathilde Picard du Delmas,40260,30364,Agence_moov_Cotonou,300000,290104,2022-07-14
TRANSFER,3480,Mathilde Picard du Delmas,30364,26884,Marc Leleu,44087,40607,2022-07-16
CASH_IN,5213,Agence_moov_Abomey,300000,294787,Mathilde Picard du Delmas,26884,32097,2022-07-20
CASH_IN,259232,Agence_moov_Abomey,300000,40768,Mathilde Picard du Delmas,32097,291329,2022-07-20
TRANSFER,195411,Mathilde Picard du Delmas,291329,95918,Aimé Pages,1068877,873466,2022-07-21
TRANSFER,80568,Mathilde Picard du Delmas,95918,15350,Aimé Pages,873466,792898,2022-07-21
TRANSFER,15173,Mathilde Picard du Delmas,15350,177,Benoît Guyot,1772700,1757527,2022-07-22
CASH_OUT,119,Mathilde Picard du Delmas,177,58,Agence_moov_Cotonou,300000,299881,2022-07-25
CASH_IN,20980,Agence_moov_Abomey,300000,279020,Mathilde Picard du Delmas,58,21038,2022-07-27
CASH_OUT,2057,Mathilde Picard du Delmas,21038,18981,Agence_moov_Abomey,300000,297943,2022-07-27
CASH_IN,212516,Agence_moov_Cotonou,300000,87484,Rémy Grondin,-296200,-83684,2022-07-01
CASH_IN,298970,Agence_moov_Cotonou,300000,1030,Rémy Grondin,-83684,215286,2022-07-02
TRANSFER,9149,Paul Perez,42596,33447,Rémy Grondin,215286,224435,2022-07-03
CASH_IN,71967,Agence_moov_Cotonou,300000,228033,Rémy Grondin,224435,296402,2022-07-04
CASH_IN,272376,Agence_moov_Ouidah,300000,27624,Rémy Grondin,296402,568778,2022-07-05
TRANSFER,277936,Rémy Grondin,568778,290842,Thérèse Hubert,96052,-181884,2022-07-06
TRANSFER,187147,Rémy Grondin,290842,103695,Audrey Julien de Leleu,1040516,853369,2022-07-07
CASH_IN,240629,Agence_moov_Abomey,300000,59371,Rémy Grondin,103695,344324,2022-07-07
CASH_OUT,212079,Rémy Grondin,344324,132245,Agence_moov_Cotonou,300000,87921,2022-07-08
CASH_IN,101657,Agence_moov_Abomey,300000,198343,Rémy Grondin,132245,233902,2022-07-08
CASH_IN,297436,Agence_moov_Ouidah,300000,2564,Rémy Grondin,233902,531338,2022-07-08
TRANSFER,37780,Marc Leleu,40607,2827,Rémy Grondin,531338,569118,2022-07-09
CASH_OUT,283281,Rémy Grondin,569118,285837,Agence_moov_Cotonou,300000,16719,2022-07-12
TRANSFER,130293,Vincent de la Dumont,167648,37355,Rémy Grondin,285837,416130,2022-07-13
CASH_IN,2659,Agence_moov_Cotonou,300000,297341,Rémy Grondin,416130,418789,2022-07-18
CASH_IN,183596,Agence_moov_Cotonou,300000,116404,Rémy Grondin,418789,602385,2022-07-19
CASH_OUT,562924,Rémy Grondin,602385,39461,Agence_moov_Abomey,300000,-262924,2022-07-19
CASH_IN,225102,Agence_moov_Ouidah,300000,74898,Rémy Grondin,39461,264563,2022-07-19
CASH_IN,10394,Agence_moov_Ouidah,300000,289606,Rémy Grondin,264563,274957,2022-07-20
CASH_IN,216886,Agence_moov_Cotonou,300000,83114,Rémy Grondin,274957,491843,2022-07-20
CASH_OUT,211742,Rémy Grondin,491843,280101,Agence_moov_Cotonou,300000,88258,2022-07-22
CASH_OUT,13653,Rémy Grondin,280101,266448,Agence_moov_Abomey,300000,286347,2022-07-23
CASH_IN,272372,Agence_moov_Ouidah,300000,27628,Rémy Grondin,266448,538820,2022-07-25
TRANSFER,159753,Constance Bourdon-Millet,386806,227053,Rémy Grondin,538820,698573,2022-07-26
CASH_OUT,48426,Rémy Grondin,698573,650147,Agence_moov_Ouidah,300000,251574,2022-07-26
CASH_OUT,457733,Rémy Grondin,650147,192414,Agence_moov_Cotonou,300000,-157733,2022-07-26
CASH_OUT,150657,Rémy Grondin,192414,41757,Agence_moov_Cotonou,300000,149343,2022-07-27
CASH_IN,235400,Agence_moov_Cotonou,300000,64600,Renée Rousseau-Henry,1889200,2124600,2022-07-01
CASH_IN,137656,Agence_moov_Ouidah,300000,162344,Renée Rousseau-Henry,2124600,2262256,2022-07-01
CASH_OUT,2108237,Renée Rousseau-Henry,2262256,154019,Agence_moov_Cotonou,300000,-1808237,2022-07-04
TRANSFER,212256,Mathilde de la Samson,1600800,1388544,Renée Rousseau-Henry,154019,366275,2022-07-04
CASH_IN,203307,Agence_moov_Abomey,300000,96693,Renée Rousseau-Henry,366275,569582,2022-07-06
CASH_OUT,447982,Renée Rousseau-Henry,569582,121600,Agence_moov_Ouidah,300000,-147982,2022-07-06
CASH_IN,75817,Agence_moov_Abomey,300000,224183,Renée Rousseau-Henry,121600,197417,2022-07-08
CASH_OUT,137660,Renée Rousseau-Henry,197417,59757,Agence_moov_Ouidah,300000,162340,2022-07-12
CASH_IN,95204,Agence_moov_Abomey,300000,204796,Renée Rousseau-Henry,59757,154961,2022-07-13
CASH_OUT,60291,Renée Rousseau-Henry,154961,94670,Agence_moov_Cotonou,300000,239709,2022-07-13
TRANSFER,16193,Renée Rousseau-Henry,94670,78477,Tristan Delahaye,1526400,1510207,2022-07-14
CASH_OUT,23378,Renée Rousseau-Henry,78477,55099,Agence_moov_Ouidah,300000,276622,2022-07-14
CASH_IN,70938,Agence_moov_Abomey,300000,229062,Renée Rousseau-Henry,55099,126037,2022-07-15
CASH_OUT,72103,Renée Rousseau-Henry,126037,53934,Agence_moov_Ouidah,300000,227897,2022-07-15
CASH_OUT,8950,Renée Rousseau-Henry,53934,44984,Agence_moov_Ouidah,300000,291050,2022-07-16
TRANSFER,44174,Renée Rousseau-Henry,44984,810,Stéphane Munoz,541898,497724,2022-07-17
CASH_OUT,189,Renée Rousseau-Henry,810,621,Agence_moov_Cotonou,300000,299811,2022-07-17
CASH_OUT,178,Renée Rousseau-Henry,621,443,Agence_moov_Abomey,300000,299822,2022-07-21
CASH_IN,216265,Agence_moov_Cotonou,300000,83735,Renée Rousseau-Henry,443,216708,2022-07-22
CASH_IN,202541,Agence_moov_Ouidah,300000,97459,Renée Rousseau-Henry,216708,419249,2022-07-23
TRANSFER,328469,Renée Rousseau-Henry,419249,90780,Paul Perez,33447,-295022,2022-07-26
CASH_OUT,15213,Renée Rousseau-Henry,90780,75567,Agence_moov_Cotonou,300000,284787,2022-07-27
CASH_IN,102724,Agence_moov_Abomey,300000,197276,Frédérique Fernandes du Bouchet,84674,187398,2022-07-02
TRANSFER,50920,Frédérique Fernandes du Bouchet,187398,136478,Bertrand Regnier,70501,19581,2022-07-03
TRANSFER,280769,Nicolas Salmon Le Hamon,511471,230702,Frédérique Fernandes du Bouchet,136478,417247,2022-07-04
CASH_OUT,212399,Frédérique Fernandes du Bouchet,417247,204848,Agence_moov_Cotonou,300000,87601,2022-07-04
CASH_OUT,63708,Frédérique Fernandes du Bouchet,204848,141140,Agence_moov_Cotonou,300000,236292,2022-07-06
TRANSFER,121986,Frédérique Fernandes du Bouchet,141140,19154,Martine Aubert,369406,247420,2022-07-07
CASH_IN,15724,Agence_moov_Cotonou,300000,284276,Frédérique Fernandes du Bouchet,19154,34878,2022-07-07
CASH_OUT,15929,Frédérique Fernandes du Bouchet,34878,18949,Agence_moov_Cotonou,300000,284071,2022-07-07
CASH_IN,254617,Agence_moov_Ouidah,300000,45383,Frédérique Fernandes du Bouchet,18949,273566,2022-07-07
CASH_OUT,117414,Frédérique Fernandes du Bouchet,273566,156152,Agence_moov_Cotonou,300000,182586,2022-07-07
CASH_IN,120259,Agence_moov_Abomey,300000,179741,Frédérique Fernandes du Bouchet,156152,276411,2022-07-11
TRANSFER,268852,Frédérique Fernandes du Bouchet,276411,7559,Alix Barbe,25712,-243140,2022-07-12
CASH_IN,85816,Agence_moov_Cotonou,300000,214184,Frédérique Fernandes du Bouchet,7559,93375,2022-07-12
CASH_OUT,9247,Frédérique Fernandes du Bouchet,93375,84128,Agence_moov_Ouidah,300000,290753,2022-07-16
TRANSFER,14948,Frédérique Fernandes du Bouchet,84128,69180,Robert Clerc,1253,-13695,2022-07-16
TRANSFER,75080,Michelle-Dorothée Lévêque,974719,899639,Frédérique Fernandes du Bouchet,69180,144260,2022-07-17
CASH_OUT,111250,Frédérique Fernandes du Bouchet,144260,33010,Agence_moov_Cotonou,300000,188750,2022-07-17
TRANSFER,24990,Frédérique Fernandes du Bouchet,33010,8020,Michelle-Dorothée Lévêque,899639,874649,2022-07-20
CASH_IN,3190,Agence_moov_Cotonou,300000,296810,Frédérique Fernandes du Bouchet,8020,11210,2022-07-20
TRANSFER,11076,Frédérique Fernandes du Bouchet,11210,134,André Renault,1089843,1078767,2022-07-21
CASH_IN,156296,Agence_moov_Ouidah,300000,143704,Frédérique Fernandes du Bouchet,134,156430,2022-07-21
CASH_IN,73772,Agence_moov_Cotonou,300000,226228,Frédérique Fernandes du Bouchet,156430,230202,2022-07-25
TRANSFER,754025,Michelle-Dorothée Lévêque,874649,120624,Frédérique Fernandes du Bouchet,230202,984227,2022-07-26
TRANSFER,149306,Frédérique Fernandes du Bouchet,984227,834921,Vincent de la Dumont,37355,-111951,2022-07-26
CASH_IN,192478,Agence_moov_Cotonou,300000,107522,Frédérique Fernandes du Bouchet,834921,1027399,2022-07-27
CASH_OUT,271961,Frédérique Fernandes du Bouchet,1027399,755438,Agence_moov_Ouidah,300000,28039,2022-07-27
TRANSFER,1899,Marc Leleu,2827,928,Nicolas Salmon Le Hamon,230702,228803,2022-07-01
CASH_OUT,364,Marc Leleu,928,564,Agence_moov_Abomey,300000,299636,2022-07-03
CASH_OUT,477,Marc Leleu,564,87,Agence_moov_Ouidah,300000,299523,2022-07-04
CASH_IN,255230,Agence_moov_Cotonou,300000,44770,Marc Leleu,87,255317,2022-07-05
TRANSFER,3220,Simone Muller de la Brun,68704,65484,Marc Leleu,255317,258537,2022-07-05
CASH_IN,222863,Agence_moov_Ouidah,300000,77137,Marc Leleu,258537,481400,2022-07-07
CASH_IN,192976,Agence_moov_Cotonou,300000,107024,Marc Leleu,481400,674376,2022-07-08
CASH_IN,174771,Agence_moov_Abomey,300000,125229,Marc Leleu,674376,849147,2022-07-09
CASH_IN,54595,Agence_moov_Cotonou,300000,245405,Marc Leleu,849147,903742,2022-07-09
CASH_OUT,23135,Marc Leleu,903742,880607,Agence_moov_Cotonou,300000,276865,2022-07-11
CASH_IN,93556,Agence_moov_Abomey,300000,206444,Marc Leleu,880607,974163,2022-07-11
TRANSFER,170712,Lucie Aubert,329803,159091,Marc Leleu,974163,1144875,2022-07-12
CASH_IN,193347,Agence_moov_Abomey,300000,106653,Marc Leleu,1144875,1338222,2022-07-12
CASH_IN,164370,Agence_moov_Cotonou,300000,135630,Marc Leleu,1338222,1502592,2022-07-14
TRANSFER,287129,Clémence-Véronique Munoz,1612400,1325271,Marc Leleu,1502592,1789721,2022-07-15
CASH_OUT,1560243,Marc Leleu,1789721,229478,Agence_moov_Ouidah,300000,-1260243,2022-07-15
TRANSFER,96195,Marc Leleu,229478,133283,Bertrand Regnier,19581,-76614,2022-07-17
CASH_OUT,121071,Marc Leleu,133283,12212,Agence_moov_Abomey,300000,178929,2022-07-18
CASH_IN,75081,Agence_moov_Ouidah,300000,224919,Marc Leleu,12212,87293,2022-07-19
CASH_IN,161182,Agence_moov_Ouidah,300000,138818,Marc Leleu,87293,248475,2022-07-20
TRANSFER,634768,Alphonse Joly,714455,79687,Marc Leleu,248475,883243,2022-07-21
TRANSFER,547295,Marc Leleu,883243,335948,Tristan Bousquet-Gros,185571,-361724,2022-07-22
CASH_IN,45249,Agence_moov_Cotonou,300000,254751,Marc Leleu,335948,381197,2022-07-22
CASH_OUT,280094,Marc Leleu,381197,101103,Agence_moov_Abomey,300000,19906,2022-07-27
CASH_IN,185465,Agence_moov_Cotonou,300000,114535,Marc Leleu,101103,286568,2022-07-27
CASH_OUT,452320,Michel Bouchet,518300,65980,Agence_moov_Cotonou,300000,-152320,2022-07-01
CASH_OUT,26617,Michel Bouchet,65980,39363,Agence_moov_Cotonou,300000,273383,2022-07-01
TRANSFER,24960,Michel Bouchet,39363,14403,Marthe Gilles,264863,239903,2022-07-02
TRANSFER,144588,Clémence-Véronique Munoz,1325271,1180683,Michel Bouchet,14403,158991,2022-07-05
TRANSFER,260740,Hélène de la Gérard,778033,517293,Michel Bouchet,158991,419731,2022-07-06
CASH_IN,724,Agence_moov_Ouidah,300000,299276,Michel Bouchet,419731,420455,2022-07-06
CASH_IN,272015,Agence_moov_Cotonou,300000,27985,Michel Bouchet,420455,692470,2022-07-06
TRANSFER,415137,Tristan Delahaye,1510207,1095070,Michel Bouchet,692470,1107607,2022-07-07
TRANSFER,649189,Andrée-Thérèse Mendès,1750000,1100811,Michel Bouchet,1107607,1756796,2022-07-07
CASH_IN,34034,Agence_moov_Abomey,300000,265966,Michel Bouchet,1756796,1790830,2022-07-08
TRANSFER,1286506,Michel Bouchet,1790830,504324,Lucy Gillet,37661,-1248845,2022-07-11
CASH_IN,144930,Agence_moov_Cotonou,300000,155070,Michel Bouchet,504324,649254,2022-07-13
CASH_IN,265575,Agence_moov_Abomey,300000,34425,Michel Bouchet,649254,914829,2022-07-18
CASH_IN,158172,Agence_moov_Ouidah,300000,141828,Michel Bouchet,914829,1073001,2022-07-18
TRANSFER,679949,Andrée-Thérèse Mendès,1100811,420862,Michel Bouchet,1073001,1752950,2022-07-18
CASH_IN,111433,Agence_moov_Ouidah,300000,188567,Michel Bouchet,1752950,1864383,2022-07-22
TRANSFER,140401,Michel Bouchet,1864383,1723982,Constance Bourdon-Millet,227053,86652,2022-07-24
TRANSFER,727598,Michel Bouchet,1723982,996384,Tristan Delahaye,1095070,367472,2022-07-24
CASH_IN,34909,Agence_moov_Abomey,300000,265091,Michel Bouchet,996384,1031293,2022-07-25
TRANSFER,106840,Christine Texier,308543,201703,Michel Bouchet,1031293,1138133,2022-07-25
CASH_IN,151519,Agence_moov_Cotonou,300000,148481,Michel Bouchet,1138133,1289652,2022-07-25
CASH_IN,156166,Agence_moov_Ouidah,300000,143834,Michel Bouchet,1289652,1445818,2022-07-25
CASH_IN,262092,Agence_moov_Abomey,300000,37908,Michel Bouchet,1445818,1707910,2022-07-25
CASH_IN,235875,Agence_moov_Cotonou,300000,64125,Michel Bouchet,1707910,1943785,2022-07-26
CASH_IN,223123,Agence_moov_Cotonou,300000,76877,Michel Bouchet,1943785,2166908,2022-07-26
CASH_OUT,82028,Michel Bouchet,2166908,2084880,Agence_moov_Ouidah,300000,217972,2022-07-27
CASH_IN,225979,Agence_moov_Ouidah,300000,74021,André Renault,1078767,1304746,2022-07-02
CASH_IN,115292,Agence_moov_Cotonou,300000,184708,André Renault,1304746,1420038,2022-07-03
CASH_IN,1006,Agence_moov_Abomey,300000,298994,André Renault,1420038,1421044,2022-07-04
TRANSFER,968255,Camille Prévost,1032900,64645,André Renault,1421044,2389299,2022-07-05
CASH_OUT,697938,André Renault,2389299,1691361,Agence_moov_Abomey,300000,-397938,2022-07-07
CASH_IN,240270,Agence_moov_Abomey,300000,59730,André Renault,1691361,1931631,2022-07-07
CASH_IN,52573,Agence_moov_Cotonou,300000,247427,André Renault,1931631,1984204,2022-07-09
CASH_OUT,455250,André Renault,1984204,1528954,Agence_moov_Ouidah,300000,-155250,2022-07-09
CASH_IN,90727,Agence_moov_Abomey,300000,209273,André Renault,1528954,1619681,2022-07-10
CASH_OUT,805023,André Renault,1619681,814658,Agence_moov_Cotonou,300000,-505023,2022-07-11
CASH_IN,258148,Agence_moov_Abomey,300000,41852,André Renault,814658,1072806,2022-07-13
TRANSFER,337879,André Renault,1072806,734927,Hélène Le Chauvin,34700,-303179,2022-07-14
CASH_IN,178113,Agence_moov_Cotonou,300000,121887,André Renault,734927,913040,2022-07-15
CASH_IN,244285,Agence_moov_Cotonou,300000,55715,André Renault,913040,1157325,2022-07-15
TRANSFER,275097,Thibaut de la Lombard,345063,69966,André Renault,1157325,1432422,2022-07-16
TRANSFER,1400298,André Renault,1432422,32124,Françoise Morin,205327,-1194971,2022-07-17
TRANSFER,682609,Timothée-René Blanchard,856501,173892,André Renault,32124,714733,2022-07-21
CASH_OUT,177475,André Renault,714733,537258,Agence_moov_Ouidah,300000,122525,2022-07-22
TRANSFER,520038,André Renault,537258,17220,Maggie Martinez,396637,-123401,2022-07-22
CASH_IN,29692,Agence_moov_Abomey,300000,270308,André Renault,17220,46912,2022-07-23
CASH_IN,46843,Agence_moov_Ouidah,300000,253157,André Renault,46912,93755,2022-07-23
TRANSFER,12196,Nicolas Salmon Le Hamon,228803,216607,André Renault,93755,105951,2022-07-24
CASH_OUT,31496,André Renault,105951,74455,Agence_moov_Abomey,300000,268504,2022-07-25
TRANSFER,295387,Audrey Julien de Leleu,853369,557982,André Renault,74455,369842,2022-07-27
CASH_IN,282375,Agence_moov_Abomey,300000,17625,Martine Aubert,247420,529795,2022-07-01
CASH_IN,259266,Agence_moov_Abomey,300000,40734,Martine Aubert,529795,789061,2022-07-02
TRANSFER,769966,Martine Aubert,789061,19095,Thomas de Blin,244194,-525772,2022-07-03
CASH_OUT,904,Martine Aubert,19095,18191,Agence_moov_Ouidah,300000,299096,2022-07-04
TRANSFER,15353,Aimé Pages,792898,777545,Martine Aubert,18191,33544,2022-07-05
TRANSFER,165187,Richard Michel,759255,594068,Martine Aubert,33544,198731,2022-07-05
CASH_OUT,27501,Martine Aubert,198731,171230,Agence_moov_Cotonou,300000,272499,2022-07-06
CASH_IN,154807,Agence_moov_Cotonou,300000,145193,Martine Aubert,171230,326037,2022-07-06
CASH_IN,35796,Agence_moov_Ouidah,300000,264204,Martine Aubert,326037,361833,2022-07-06
TRANSFER,82827,Martine Aubert,361833,279006,Camille Morvan,38086,-44741,2022-07-07
TRANSFER,26369,Simone Muller de la Brun,65484,39115,Martine Aubert,279006,305375,2022-07-11
CASH_IN,68904,Agence_moov_Cotonou,300000,231096,Martine Aubert,305375,374279,2022-07-11
TRANSFER,130958,Lucie Aubert,159091,28133,Martine Aubert,374279,505237,2022-07-13
CASH_OUT,410463,Martine Aubert,505237,94774,Agence_moov_Cotonou,300000,-110463,2022-07-14
CASH_OUT,44597,Martine Aubert,94774,50177,Agence_moov_Cotonou,300000,255403,2022-07-19
TRANSFER,402760,Andrée-Thérèse Mendès,420862,18102,Martine Aubert,50177,452937,2022-07-19
CASH_OUT,372336,Martine Aubert,452937,80601,Agence_moov_Ouidah,300000,-72336,2022-07-21
TRANSFER,1580,Martine Aubert,80601,79021,Andrée-Thérèse Mendès,18102,16522,2022-07-21
CASH_IN,89971,Agence_moov_Ouidah,300000,210029,Martine Aubert,79021,168992,2022-07-21
CASH_IN,228146,Agence_moov_Cotonou,300000,71854,Martine Aubert,168992,397138,2022-07-21
TRANSFER,311082,Martine Aubert,397138,86056,Alphonse Gomes,619200,308118,2022-07-21
TRANSFER,70978,Alphonse Gomes,308118,237140,Martine Aubert,86056,157034,2022-07-22
TRANSFER,73779,Martine Aubert,157034,83255,Mathilde de la Samson,1388544,1314765,2022-07-23
TRANSFER,20899,Martine Aubert,83255,62356,Bernard Maurice,869000,848101,2022-07-23
CASH_OUT,22224,Martine Aubert,62356,40132,Agence_moov_Cotonou,300000,277776,2022-07-24
TRANSFER,1117,Martine Aubert,40132,39015,Michelle de Étienne,722041,720924,2022-07-27
CASH_IN,188773,Agence_moov_Cotonou,300000,111227,Bertrand Regnier,-76614,112159,2022-07-01
TRANSFER,37640,Bertrand Regnier,112159,74519,Thibaut de la Lombard,69966,32326,2022-07-03
CASH_IN,89224,Agence_moov_Cotonou,300000,210776,Bertrand Regnier,74519,163743,2022-07-04
TRANSFER,216279,Nicolas Salmon Le Hamon,216607,328,Bertrand Regnier,163743,380022,2022-07-06
TRANSFER,531784,Mathilde de la Samson,1314765,782981,Bertrand Regnier,380022,911806,2022-07-08
TRANSFER,311124,Bertrand Regnier,911806,600682,Timothée-René Blanchard,173892,-137232,2022-07-08
CASH_OUT,533294,Bertrand Regnier,600682,67388,Agence_moov_Cotonou,300000,-233294,2022-07-09
CASH_OUT,3728,Bertrand Regnier,67388,63660,Agence_moov_Cotonou,300000,296272,2022-07-09
CASH_IN,79805,Agence_moov_Cotonou,300000,220195,Bertrand Regnier,63660,143465,2022-07-10
TRANSFER,54771,Bertrand Regnier,143465,88694,Simone Muller de la Brun,39115,-15656,2022-07-11
CASH_OUT,18655,Bertrand Regnier,88694,70039,Agence_moov_Abomey,300000,281345,2022-07-13
CASH_IN,263798,Agence_moov_Ouidah,300000,36202,Bertrand Regnier,70039,333837,2022-07-13
CASH_OUT,208308,Bertrand Regnier,333837,125529,Agence_moov_Cotonou,300000,91692,2022-07-14
TRANSFER,380249,Richard Michel,594068,213819,Bertrand Regnier,125529,505778,2022-07-14
CASH_IN,144833,Agence_moov_Ouidah,300000,155167,Bertrand Regnier,505778,650611,2022-07-16
TRANSFER,67991,Alphonse Joly,79687,11696,Bertrand Regnier,650611,718602,2022-07-19
CASH_IN,103012,Agence_moov_Ouidah,300000,196988,Bertrand Regnier,718602,821614,2022-07-19
CASH_OUT,70339,Bertrand Regnier,821614,751275,Agence_moov_Abomey,300000,229661,2022-07-20
CASH_IN,179703,Agence_moov_Cotonou,300000,120297,Bertrand Regnier,751275,930978,2022-07-20
TRANSFER,585302,Bertrand Regnier,930978,345676,Mathilde de la Samson,782981,197679,2022-07-21
CASH_IN,179712,Agence_moov_Cotonou,300000,120288,Bertrand Regnier,345676,525388,2022-07-21
CASH_IN,65720,Agence_moov_Ouidah,300000,234280,Bertrand Regnier,525388,591108,2022-07-23
TRANSFER,74891,Tristan Delahaye,367472,292581,Bertrand Regnier,591108,665999,2022-07-26
CASH_OUT,565998,Bertrand Regnier,665999,100001,Agence_moov_Abomey,300000,-265998,2022-07-27
CASH_IN,16307,Agence_moov_Abomey,300000,283693,Michelle-Dorothée Lévêque,120624,136931,2022-07-02
CASH_OUT,118277,Michelle-Dorothée Lévêque,136931,18654,Agence_moov_Abomey,300000,181723,2022-07-03
CASH_OUT,5936,Michelle-Dorothée Lévêque,18654,12718,Agence_moov_Abomey,300000,294064,2022-07-03
CASH_IN,38625,Agence_moov_Ouidah,300000,261375,Michelle-Dorothée Lévêque,12718,51343,2022-07-03
CASH_IN,270305,Agence_moov_Abomey,300000,29695,Michelle-Dorothée Lévêque,51343,321648,2022-07-04
TRANSFER,138035,Hélène de la Gérard,517293,379258,Michelle-Dorothée Lévêque,321648,459683,2022-07-04
CASH_IN,208560,Agence_moov_Abomey,300000,91440,Michelle-Dorothée Lévêque,459683,668243,2022-07-07
TRANSFER,300220,Stéphane Munoz,497724,197504,Michelle-Dorothée Lévêque,668243,968463,2022-07-07
CASH_OUT,571540,Michelle-Dorothée Lévêque,968463,396923,Agence_moov_Ouidah,300000,-271540,2022-07-08
CASH_OUT,92941,Michelle-Dorothée Lévêque,396923,303982,Agence_moov_Abomey,300000,207059,2022-07-14
CASH_IN,139456,Agence_moov_Cotonou,300000,160544,Michelle-Dorothée Lévêque,303982,443438,2022-07-15
TRANSFER,935433,Clémence-Véronique Munoz,1180683,245250,Michelle-Dorothée Lévêque,443438,1378871,2022-07-16
CASH_OUT,621100,Michelle-Dorothée Lévêque,1378871,757771,Agence_moov_Abomey,300000,-321100,2022-07-16
CASH_IN,122958,Agence_moov_Cotonou,300000,177042,Michelle-Dorothée Lévêque,757771,880729,2022-07-17
CASH_OUT,668882,Michelle-Dorothée Lévêque,880729,211847,Agence_moov_Ouidah,300000,-368882,2022-07-17
TRANSFER,5230,Andrée-Thérèse Mendès,16522,11292,Michelle-Dorothée Lévêque,211847,217077,2022-07-18
CASH_OUT,128742,Michelle-Dorothée Lévêque,217077,88335,Agence_moov_Abomey,300000,171258,2022-07-19
CASH_IN,212466,Agence_moov_Cotonou,300000,87534,Michelle-Dorothée Lévêque,88335,300801,2022-07-20
CASH_IN,181782,Agence_moov_Abomey,300000,118218,Michelle-Dorothée Lévêque,300801,482583,2022-07-20
CASH_OUT,51952,Michelle-Dorothée Lévêque,482583,430631,Agence_moov_Abomey,300000,248048,2022-07-22
CASH_IN,282417,Agence_moov_Ouidah,300000,17583,Michelle-Dorothée Lévêque,430631,713048,2022-07-25
CASH_OUT,164514,Michelle-Dorothée Lévêque,713048,548534,Agence_moov_Abomey,300000,135486,2022-07-27
TRANSFER,82373,Michelle de Étienne,720924,638551,Léon Da Costa,1537405,1619778,2022-07-04
CASH_OUT,489826,Léon Da Costa,1619778,1129952,Agence_moov_Abomey,300000,-189826,2022-07-07
CASH_IN,49620,Agence_moov_Ouidah,300000,250380,Léon Da Costa,1129952,1179572,2022-07-08
CASH_OUT,928009,Léon Da Costa,1179572,251563,Agence_moov_Abomey,300000,-628009,2022-07-14
CASH_IN,88307,Agence_moov_Cotonou,300000,211693,Léon Da Costa,251563,339870,2022-07-17
TRANSFER,342630,Colette-Sophie Prévost,419021,76391,Léon Da Costa,339870,682500,2022-07-17
CASH_OUT,115033,Léon Da Costa,682500,567467,Agence_moov_Cotonou,300000,184967,2022-07-17
CASH_OUT,360917,Léon Da Costa,567467,206550,Agence_moov_Ouidah,300000,-60917,2022-07-18
CASH_OUT,124205,Léon Da Costa,206550,82345,Agence_moov_Ouidah,300000,175795,2022-07-19
CASH_IN,196005,Agence_moov_Abomey,300000,103995,Léon Da Costa,82345,278350,2022-07-20
CASH_OUT,165169,Léon Da Costa,278350,113181,Agence_moov_Abomey,300000,134831,2022-07-20
CASH_OUT,49394,Léon Da Costa,113181,63787,Agence_moov_Cotonou,300000,250606,2022-07-22
TRANSFER,82319,Michelle de Étienne,638551,556232,Léon Da Costa,63787,146106,2022-07-25
CASH_IN,1218,Agence_moov_Cotonou,300000,298782,Timothée-René Blanchard,-137232,-136014,2022-07-02
CASH_IN,225410,Agence_moov_Ouidah,300000,74590,Timothée-René Blanchard,-136014,89396,2022-07-03
TRANSFER,224949,Clémence-Véronique Munoz,245250,20301,Timothée-René Blanchard,89396,314345,2022-07-05
CASH_OUT,51876,Timothée-René Blanchard,314345,262469,Agence_moov_Abomey,300000,248124,2022-07-05
CASH_IN,170855,Agence_moov_Abomey,300000,129145,Timothée-René Blanchard,262469,433324,2022-07-06
CASH_OUT,40607,Timothée-René Blanchard,433324,392717,Agence_moov_Cotonou,300000,259393,2022-07-09
CASH_OUT,126651,Timothée-René Blanchard,392717,266066,Agence_moov_Ouidah,300000,173349,2022-07-09
TRANSFER,171765,Timothée-René Blanchard,266066,94301,Bernard Maurice,848101,676336,2022-07-12
CASH_IN,116454,Agence_moov_Abomey,300000,183546,Timothée-René Blanchard,94301,210755,2022-07-13
CASH_OUT,92520,Timothée-René Blanchard,210755,118235,Agence_moov_Cotonou,300000,207480,2022-07-13
CASH_IN,140667,Agence_moov_Cotonou,300000,159333,Timothée-René Blanchard,118235,258902,2022-07-13
CASH_IN,193151,Agence_moov_Abomey,300000,106849,Timothée-René Blanchard,258902,452053,2022-07-14
CASH_OUT,254432,Timothée-René Blanchard,452053,197621,Agence_moov_Ouidah,300000,45568,2022-07-14
CASH_OUT,39959,Timothée-René Blanchard,197621,157662,Agence_moov_Abomey,300000,260041,2022-07-19
CASH_OUT,142315,Timothée-René Blanchard,157662,15347,Agence_moov_Ouidah,300000,157685,2022-07-19
CASH_IN,246600,Agence_moov_Cotonou,300000,53400,Timothée-René Blanchard,15347,261947,2022-07-21
CASH_IN,129995,Agence_moov_Cotonou,300000,170005,Timothée-René Blanchard,261947,391942,2022-07-24
CASH_OUT,95240,Timothée-René Blanchard,391942,296702,Agence_moov_Abomey,300000,204760,2022-07-27
CASH_OUT,100810,Timothée-René Blanchard,296702,195892,Agence_moov_Cotonou,300000,199190,2022-07-27
CASH_IN,175918,Agence_moov_Ouidah,300000,124082,Thérèse Hubert,-181884,-5966,2022-07-01
CASH_IN,550,Agence_moov_Cotonou,300000,299450,Thérèse Hubert,-5966,-5416,2022-07-04
CASH_IN,207393,Agence_moov_Abomey,300000,92607,Thérèse Hubert,-5416,201977,2022-07-05
TRANSFER,31475,Christine Texier,201703,170228,Thérèse Hubert,201977,233452,2022-07-05
CASH_IN,897,Agence_moov_Abomey,300000,299103,Thérèse Hubert,233452,234349,2022-07-06
CASH_OUT,173713,Thérèse Hubert,234349,60636,Agence_moov_Cotonou,300000,126287,2022-07-07
TRANSFER,38052,Thérèse Hubert,60636,22584,Clémence-Véronique Munoz,20301,-17751,2022-07-07
TRANSFER,163974,Mathilde de la Samson,197679,33705,Thérèse Hubert,22584,186558,2022-07-09
TRANSFER,157768,Bernard Maurice,676336,518568,Thérèse Hubert,186558,344326,2022-07-09
TRANSFER,76318,Christine Texier,170228,93910,Thérèse Hubert,344326,420644,2022-07-14
CASH_OUT,165708,Thérèse Hubert,420644,254936,Agence_moov_Cotonou,300000,134292,2022-07-16
CASH_OUT,101564,Thérèse Hubert,254936,153372,Agence_moov_Abomey,300000,198436,2022-07-16
CASH_OUT,100490,Thérèse Hubert,153372,52882,Agence_moov_Cotonou,300000,199510,2022-07-19
TRANSFER,27002,Thérèse Hubert,52882,25880,Lucie Aubert,28133,1131,2022-07-20
TRANSFER,23947,Thérèse Hubert,25880,1933,Paulette Loiseau,513736,489789,2022-07-20
CASH_IN,286284,Agence_moov_Cotonou,300000,13716,Thérèse Hubert,1933,288217,2022-07-23
TRANSFER,218330,Alphonse Gomes,237140,18810,Thérèse Hubert,288217,506547,2022-07-27
CASH_OUT,344189,Thérèse Hubert,506547,162358,Agence_moov_Ouidah,300000,-44189,2022-07-27
TRANSFER,227201,Virginie Bouvet,1213658,986457,Thérèse Hubert,162358,389559,2022-07-27
CASH_IN,281008,Agence_moov_Cotonou,300000,18992,Thérèse Hubert,389559,670567,2022-07-27
CASH_IN,180281,Agence_moov_Ouidah,300000,119719,Noémi Bouvier,-953391,-773110,2022-07-01
CASH_IN,124534,Agence_moov_Ouidah,300000,175466,Noémi Bouvier,-773110,-648576,2022-07-04
CASH_IN,102654,Agence_moov_Abomey,300000,197346,Noémi Bouvier,-648576,-545922,2022-07-07
CASH_IN,119238,Agence_moov_Abomey,300000,180762,Noémi Bouvier,-545922,-426684,2022-07-09
CASH_IN,62016,Agence_moov_Cotonou,300000,237984,Noémi Bouvier,-426684,-364668,2022-07-15
CASH_IN,180927,Agence_moov_Ouidah,300000,119073,Noémi Bouvier,-364668,-183741,2022-07-16
CASH_IN,293947,Agence_moov_Ouidah,300000,6053,Noémi Bouvier,-183741,110206,2022-07-16
TRANSFER,83605,Noémi Bouvier,110206,26601,Tristan Delahaye,292581,208976,2022-07-16
CASH_OUT,4530,Noémi Bouvier,26601,22071,Agence_moov_Cotonou,300000,295470,2022-07-17
CASH_IN,80202,Agence_moov_Ouidah,300000,219798,Noémi Bouvier,22071,102273,2022-07-18
TRANSFER,36480,Colette-Sophie Prévost,76391,39911,Noémi Bouvier,102273,138753,2022-07-19
CASH_OUT,43155,Noémi Bouvier,138753,95598,Agence_moov_Cotonou,300000,256845,2022-07-20
TRANSFER,151376,Stéphane Munoz,197504,46128,Noémi Bouvier,95598,246974,2022-07-22
CASH_IN,43307,Agence_moov_Abomey,300000,256693,Noémi Bouvier,246974,290281,2022-07-23
TRANSFER,180359,Noémi Bouvier,290281,109922,Camille Prévost,64645,-115714,2022-07-27
CASH_OUT,181857,Hélène de la Gérard,379258,197401,Agence_moov_Ouidah,300000,118143,2022-07-01
TRANSFER,4461,Alphonse Gomes,18810,14349,Hélène de la Gérard,197401,201862,2022-07-01
CASH_IN,91011,Agence_moov_Ouidah,300000,208989,Hélène de la Gérard,201862,292873,2022-07-01
TRANSFER,26160,Hélène de la Gérard,292873,266713,Bernard Maurice,518568,492408,2022-07-03
TRANSFER,197336,Hélène de la Gérard,266713,69377,Richard Michel,213819,16483,2022-07-06
CASH_IN,80534,Agence_moov_Cotonou,300000,219466,Hélène de la Gérard,69377,149911,2022-07-06
CASH_OUT,58959,Hélène de la Gérard,149911,90952,Agence_moov_Abomey,300000,241041,2022-07-06
CASH_OUT,11910,Hélène de la Gérard,90952,79042,Agence_moov_Cotonou,300000,288090,2022-07-06
CASH_IN,10237,Agence_moov_Abomey,300000,289763,Hélène de la Gérard,79042,89279,2022-07-07
CASH_OUT,27366,Hélène de la Gérard,89279,61913,Agence_moov_Cotonou,300000,272634,2022-07-08
CASH_IN,95692,Agence_moov_Cotonou,300000,204308,Hélène de la Gérard,61913,157605,2022-07-17
CASH_OUT,48777,Hélène de la Gérard,157605,108828,Agence_moov_Cotonou,300000,251223,2022-07-19
TRANSFER,96561,Marthe Gilles,239903,143342,Hélène de la Gérard,108828,205389,2022-07-22
TRANSFER,30810,Thibaut de la Lombard,32326,1516,Hélène de la Gérard,205389,236199,2022-07-24
CASH_OUT,167732,Hélène de la Gérard,236199,68467,Agence_moov_Ouidah,300000,132268,2022-07-25
TRANSFER,11356,Colette-Sophie Prévost,39911,28555,Hélène de la Gérard,68467,79823,2022-07-25
CASH_IN,49484,Agence_moov_Abomey,300000,250516,Hélène de la Gérard,79823,129307,2022-07-27
CASH_IN,229412,Agence_moov_Abomey,300000,70588,Frédéric Guillou,-274911,-45499,2022-07-08
CASH_IN,135493,Agence_moov_Abomey,300000,164507,Frédéric Guillou,-45499,89994,2022-07-09
CASH_OUT,55490,Frédéric Guillou,89994,34504,Agence_moov_Ouidah,300000,244510,2022-07-20
CASH_IN,23897,Agence_moov_Cotonou,300000,276103,Frédéric Guillou,34504,58401,2022-07-21
CASH_OUT,56151,Frédéric Guillou,58401,2250,Agence_moov_Ouidah,300000,243849,2022-07-25
TRANSFER,797,Frédéric Guillou,2250,1453,Mathilde de la Samson,33705,32908,2022-07-26
CASH_IN,141804,Agence_moov_Cotonou,300000,158196,Tristan Bousquet-Gros,-361724,-219920,2022-07-07
CASH_IN,9694,Agence_moov_Cotonou,300000,290306,Tristan Bousquet-Gros,-219920,-210226,2022-07-14
CASH_IN,181681,Agence_moov_Abomey,300000,118319,Tristan Bousquet-Gros,-210226,-28545,2022-07-17
CASH_IN,134692,Agence_moov_Cotonou,300000,165308,Tristan Bousquet-Gros,-28545,106147,2022-07-24
CASH_IN,155479,Agence_moov_Abomey,300000,144521,Tristan Bousquet-Gros,106147,261626,2022-07-24
TRANSFER,86136,Tristan Bousquet-Gros,261626,175490,Marthe Gilles,143342,57206,2022-07-26
CASH_IN,125980,Agence_moov_Cotonou,300000,174020,Robert Clerc,-13695,112285,2022-07-01
TRANSFER,99948,Robert Clerc,112285,12337,Alphonse Joly,11696,-88252,2022-07-13
CASH_IN,91727,Agence_moov_Abomey,300000,208273,Robert Clerc,12337,104064,2022-07-14
CASH_IN,177306,Agence_moov_Abomey,300000,122694,Robert Clerc,104064,281370,2022-07-20
CASH_OUT,121311,Robert Clerc,281370,160059,Agence_moov_Abomey,300000,178689,2022-07-20
CASH_OUT,147212,Robert Clerc,160059,12847,Agence_moov_Ouidah,300000,152788,2022-07-20
CASH_IN,10021,Agence_moov_Ouidah,300000,289979,Matthieu-Matthieu Bigot,-820403,-810382,2022-07-01
CASH_IN,78095,Agence_moov_Cotonou,300000,221905,Matthieu-Matthieu Bigot,-810382,-732287,2022-07-03
CASH_IN,250135,Agence_moov_Cotonou,300000,49865,Matthieu-Matthieu Bigot,-732287,-482152,2022-07-03
CASH_IN,173161,Agence_moov_Abomey,300000,126839,Matthieu-Matthieu Bigot,-482152,-308991,2022-07-04
CASH_IN,62506,Agence_moov_Abomey,300000,237494,Matthieu-Matthieu Bigot,-308991,-246485,2022-07-05
CASH_IN,145776,Agence_moov_Ouidah,300000,154224,Matthieu-Matthieu Bigot,-246485,-100709,2022-07-07
CASH_IN,280131,Agence_moov_Abomey,300000,19869,Matthieu-Matthieu Bigot,-100709,179422,2022-07-08
CASH_OUT,110864,Matthieu-Matthieu Bigot,179422,68558,Agence_moov_Ouidah,300000,189136,2022-07-09
CASH_IN,88533,Agence_moov_Abomey,300000,211467,Matthieu-Matthieu Bigot,68558,157091,2022-07-10
CASH_IN,4856,Agence_moov_Ouidah,300000,295144,Matthieu-Matthieu Bigot,157091,161947,2022-07-11
TRANSFER,49443,Christine Texier,93910,44467,Matthieu-Matthieu Bigot,161947,211390,2022-07-15
CASH_OUT,151915,Matthieu-Matthieu Bigot,211390,59475,Agence_moov_Abomey,300000,148085,2022-07-17
CASH_OUT,57468,Matthieu-Matthieu Bigot,59475,2007,Agence_moov_Cotonou,300000,242532,2022-07-19
CASH_OUT,537,Matthieu-Matthieu Bigot,2007,1470,Agence_moov_Abomey,300000,299463,2022-07-21
CASH_OUT,1335,Matthieu-Matthieu Bigot,1470,135,Agence_moov_Abomey,300000,298665,2022-07-21
CASH_IN,66223,Agence_moov_Abomey,300000,233777,Matthieu-Matthieu Bigot,135,66358,2022-07-21
TRANSFER,14960,Mathilde de la Samson,32908,17948,Matthieu-Matthieu Bigot,66358,81318,2022-07-22
CASH_IN,268464,Agence_moov_Abomey,300000,31536,Matthieu-Matthieu Bigot,81318,349782,2022-07-25
TRANSFER,1083,Thibaut de la Lombard,1516,433,Matthieu-Matthieu Bigot,349782,350865,2022-07-26
CASH_OUT,317,Nicolas Salmon Le Hamon,328,11,Agence_moov_Abomey,300000,299683,2022-07-02
CASH_IN,34374,Agence_moov_Ouidah,300000,265626,Nicolas Salmon Le Hamon,11,34385,2022-07-03
TRANSFER,8319,Mathilde de la Samson,17948,9629,Nicolas Salmon Le Hamon,34385,42704,2022-07-08
CASH_IN,153169,Agence_moov_Cotonou,300000,146831,Nicolas Salmon Le Hamon,42704,195873,2022-07-10
CASH_IN,55678,Agence_moov_Abomey,300000,244322,Nicolas Salmon Le Hamon,195873,251551,2022-07-10
TRANSFER,976082,Benoît Guyot,1757527,781445,Nicolas Salmon Le Hamon,251551,1227633,2022-07-15
CASH_IN,30039,Agence_moov_Cotonou,300000,269961,Nicolas Salmon Le Hamon,1227633,1257672,2022-07-20
CASH_OUT,285990,Nicolas Salmon Le Hamon,1257672,971682,Agence_moov_Cotonou,300000,14010,2022-07-23
CASH_IN,277894,Agence_moov_Ouidah,300000,22106,Vincent de la Dumont,-111951,165943,2022-07-02
TRANSFER,57333,Vincent de la Dumont,165943,108610,Vincent de la Dumont,165943,223276,2022-07-04
TRANSFER,97010,Vincent de la Dumont,108610,11600,Vincent de la Dumont,108610,11600,2022-07-05
CASH_OUT,4336,Vincent de la Dumont,11600,7264,Agence_moov_Cotonou,300000,295664,2022-07-08
CASH_IN,243060,Agence_moov_Cotonou,300000,56940,Vincent de la Dumont,7264,250324,2022-07-09
CASH_IN,17090,Agence_moov_Cotonou,300000,282910,Vincent de la Dumont,250324,267414,2022-07-09
TRANSFER,256504,Vincent de la Dumont,267414,10910,Colette-Sophie Prévost,28555,-227949,2022-07-11
TRANSFER,300410,Audrey Julien de Leleu,557982,257572,Vincent de la Dumont,10910,311320,2022-07-19
TRANSFER,36973,Vincent de la Dumont,311320,274347,Paulette Loiseau,489789,452816,2022-07-20
TRANSFER,351795,Michelle de Étienne,556232,204437,Vincent de la Dumont,274347,626142,2022-07-20
TRANSFER,109257,Virginie Bouvet,986457,877200,Lucie Aubert,1131,-108126,2022-07-01
CASH_OUT,20945,Virginie Bouvet,877200,856255,Agence_moov_Ouidah,300000,279055,2022-07-03
CASH_IN,210489,Agence_moov_Abomey,300000,89511,Virginie Bouvet,856255,1066744,2022-07-05
CASH_OUT,105412,Virginie Bouvet,1066744,961332,Agence_moov_Cotonou,300000,194588,2022-07-06
CASH_IN,268179,Agence_moov_Cotonou,300000,31821,Virginie Bouvet,961332,1229511,2022-07-09
TRANSFER,802914,Virginie Bouvet,1229511,426597,Audrey Julien de Leleu,257572,-545342,2022-07-10
TRANSFER,374312,Virginie Bouvet,426597,52285,Aimé Pages,777545,403233,2022-07-11
CASH_IN,19429,Agence_moov_Ouidah,300000,280571,Virginie Bouvet,52285,71714,2022-07-12
CASH_IN,59835,Agence_moov_Abomey,300000,240165,Virginie Bouvet,71714,131549,2022-07-15
CASH_OUT,83206,Virginie Bouvet,131549,48343,Agence_moov_Abomey,300000,216794,2022-07-17
CASH_OUT,5890,Virginie Bouvet,48343,42453,Agence_moov_Abomey,300000,294110,2022-07-20
CASH_IN,202417,Agence_moov_Abomey,300000,97583,Virginie Bouvet,42453,244870,2022-07-20
CASH_OUT,178705,Virginie Bouvet,244870,66165,Agence_moov_Abomey,300000,121295,2022-07-20
CASH_IN,199295,Agence_moov_Cotonou,300000,100705,Virginie Bouvet,66165,265460,2022-07-23
CASH_IN,154327,Agence_moov_Cotonou,300000,145673,Virginie Bouvet,265460,419787,2022-07-25
CASH_OUT,109744,Virginie Bouvet,419787,310043,Agence_moov_Abomey,300000,190256,2022-07-27
CASH_IN,181173,Agence_moov_Abomey,300000,118827,Manon Valette,-123224,57949,2022-07-03
TRANSFER,87417,Benoît Guyot,781445,694028,Manon Valette,57949,145366,2022-07-05
CASH_OUT,42168,Manon Valette,145366,103198,Agence_moov_Abomey,300000,257832,2022-07-05
TRANSFER,54781,Manon Valette,103198,48417,Christine Texier,44467,-10314,2022-07-08
CASH_IN,231271,Agence_moov_Abomey,300000,68729,Manon Valette,48417,279688,2022-07-09
TRANSFER,165344,Philippe Philippe,399178,233834,Manon Valette,279688,445032,2022-07-11
TRANSFER,80889,Philippe Philippe,233834,152945,Manon Valette,445032,525921,2022-07-11
TRANSFER,9557,Constance Bourdon-Millet,86652,77095,Manon Valette,525921,535478,2022-07-15
CASH_OUT,137395,Manon Valette,535478,398083,Agence_moov_Ouidah,300000,162605,2022-07-16
CASH_OUT,123532,Manon Valette,398083,274551,Agence_moov_Ouidah,300000,176468,2022-07-17
CASH_OUT,63950,Manon Valette,274551,210601,Agence_moov_Abomey,300000,236050,2022-07-18
CASH_OUT,29005,Manon Valette,210601,181596,Agence_moov_Ouidah,300000,270995,2022-07-19
CASH_OUT,135213,Manon Valette,181596,46383,Agence_moov_Abomey,300000,164787,2022-07-20
TRANSFER,68287,Philippe Philippe,152945,84658,Manon Valette,46383,114670,2022-07-22
TRANSFER,190039,Tristan Delahaye,208976,18937,Manon Valette,114670,304709,2022-07-23
CASH_IN,260718,Agence_moov_Cotonou,300000,39282,Manon Valette,304709,565427,2022-07-26
CASH_OUT,10064,Tristan Delahaye,18937,8873,Agence_moov_Ouidah,300000,289936,2022-07-01
TRANSFER,4818,Tristan Delahaye,8873,4055,Mathilde de la Samson,9629,4811,2022-07-02
TRANSFER,54637,Suzanne Bodin,190140,135503,Tristan Delahaye,4055,58692,2022-07-10
CASH_IN,155400,Agence_moov_Cotonou,300000,144600,Tristan Delahaye,58692,214092,2022-07-10
TRANSFER,20960,Tristan Delahaye,214092,193132,Tristan Delahaye,214092,235052,2022-07-10
CASH_OUT,106273,Tristan Delahaye,193132,86859,Agence_moov_Ouidah,300000,193727,2022-07-11
CASH_IN,96434,Agence_moov_Cotonou,300000,203566,Tristan Delahaye,86859,183293,2022-07-12
CASH_IN,12828,Agence_moov_Cotonou,300000,287172,Tristan Delahaye,183293,196121,2022-07-14
TRANSFER,35230,Tristan Delahaye,196121,160891,Thibaut de la Lombard,433,-34797,2022-07-14
TRANSFER,370123,Bernard Maurice,492408,122285,Tristan Delahaye,160891,531014,2022-07-15
CASH_OUT,122115,Tristan Delahaye,531014,408899,Agence_moov_Cotonou,300000,177885,2022-07-15
CASH_OUT,315532,Tristan Delahaye,408899,93367,Agence_moov_Cotonou,300000,-15532,2022-07-18
CASH_OUT,46206,Tristan Delahaye,93367,47161,Agence_moov_Cotonou,300000,253794,2022-07-25
CASH_OUT,44507,Tristan Delahaye,47161,2654,Agence_moov_Abomey,300000,255493,2022-07-25
CASH_IN,122552,Agence_moov_Ouidah,300000,177448,Christine Texier,-10314,112238,2022-07-03
CASH_IN,212886,Agence_moov_Cotonou,300000,87114,Christine Texier,112238,325124,2022-07-04
CASH_IN,265975,Agence_moov_Ouidah,300000,34025,Christine Texier,325124,591099,2022-07-04
TRANSFER,453584,Anastasie Richard-Neveu,557100,103516,Christine Texier,591099,1044683,2022-07-05
CASH_IN,170437,Agence_moov_Abomey,300000,129563,Christine Texier,1044683,1215120,2022-07-10
CASH_OUT,828052,Christine Texier,1215120,387068,Agence_moov_Ouidah,300000,-528052,2022-07-13
CASH_IN,187379,Agence_moov_Abomey,300000,112621,Christine Texier,387068,574447,2022-07-13
TRANSFER,5470,Andrée-Thérèse Mendès,11292,5822,Christine Texier,574447,579917,2022-07-14
CASH_IN,16516,Agence_moov_Cotonou,300000,283484,Christine Texier,579917,596433,2022-07-20
CASH_IN,139383,Agence_moov_Cotonou,300000,160617,Christine Texier,596433,735816,2022-07-21
CASH_IN,123558,Agence_moov_Abomey,300000,176442,Christine Texier,735816,859374,2022-07-22
TRANSFER,15217,Stéphane Munoz,46128,30911,Christine Texier,859374,874591,2022-07-22
CASH_OUT,454210,Christine Texier,874591,420381,Agence_moov_Cotonou,300000,-154210,2022-07-27
CASH_IN,19009,Agence_moov_Abomey,300000,280991,Suzanne Bodin,135503,154512,2022-07-02
CASH_IN,129747,Agence_moov_Cotonou,300000,170253,Suzanne Bodin,154512,284259,2022-07-12
CASH_OUT,106472,Suzanne Bodin,284259,177787,Agence_moov_Abomey,300000,193528,2022-07-14
CASH_OUT,57894,Suzanne Bodin,177787,119893,Agence_moov_Ouidah,300000,242106,2022-07-15
CASH_OUT,29934,Suzanne Bodin,119893,89959,Agence_moov_Ouidah,300000,270066,2022-07-18
CASH_OUT,81497,Suzanne Bodin,89959,8462,Agence_moov_Cotonou,300000,218503,2022-07-22
TRANSFER,2147,Andrée-Thérèse Mendès,5822,3675,Suzanne Bodin,8462,10609,2022-07-24
CASH_IN,180760,Agence_moov_Abomey,300000,119240,Alix Barbe,-243140,-62380,2022-07-01
CASH_IN,210564,Agence_moov_Ouidah,300000,89436,Alix Barbe,-62380,148184,2022-07-05
TRANSFER,4927,Stéphane Munoz,30911,25984,Alix Barbe,148184,153111,2022-07-05
CASH_OUT,69982,Alix Barbe,153111,83129,Agence_moov_Cotonou,300000,230018,2022-07-08
CASH_OUT,56796,Alix Barbe,83129,26333,Agence_moov_Abomey,300000,243204,2022-07-09
CASH_OUT,11840,Alix Barbe,26333,14493,Agence_moov_Abomey,300000,288160,2022-07-16
CASH_IN,94545,Agence_moov_Ouidah,300000,205455,Alix Barbe,14493,109038,2022-07-17
TRANSFER,76043,Alix Barbe,109038,32995,Stéphane Munoz,25984,-50059,2022-07-18
CASH_OUT,22888,Alix Barbe,32995,10107,Agence_moov_Abomey,300000,277112,2022-07-18
CASH_IN,251275,Agence_moov_Abomey,300000,48725,Alix Barbe,10107,261382,2022-07-19
CASH_OUT,136592,Alix Barbe,261382,124790,Agence_moov_Cotonou,300000,163408,2022-07-19
TRANSFER,84587,Alix Barbe,124790,40203,Mathilde de la Samson,4811,-79776,2022-07-20
CASH_OUT,17154,Alix Barbe,40203,23049,Agence_moov_Abomey,300000,282846,2022-07-21
CASH_IN,234761,Agence_moov_Ouidah,300000,65239,Alix Barbe,23049,257810,2022-07-23
CASH_IN,210456,Agence_moov_Ouidah,300000,89544,Alix Barbe,257810,468266,2022-07-25
CASH_OUT,211369,Alix Barbe,468266,256897,Agence_moov_Cotonou,300000,88631,2022-07-25
CASH_IN,30810,Agence_moov_Abomey,300000,269190,Alix Barbe,256897,287707,2022-07-27
TRANSFER,13508,Alphonse Gomes,14349,841,Marthe Gilles,57206,70714,2022-07-05
TRANSFER,18679,Marthe Gilles,70714,52035,Philippe Philippe,84658,65979,2022-07-06
TRANSFER,49619,Marthe Gilles,52035,2416,Philippe Philippe,65979,16360,2022-07-12
CASH_OUT,2306,Marthe Gilles,2416,110,Agence_moov_Cotonou,300000,297694,2022-07-15
CASH_OUT,109,Marthe Gilles,110,1,Agence_moov_Ouidah,300000,299891,2022-07-15
CASH_IN,211287,Agence_moov_Ouidah,300000,88713,Marthe Gilles,1,211288,2022-07-15
TRANSFER,199061,Marthe Gilles,211288,12227,Richard Michel,16483,-182578,2022-07-19
CASH_IN,73701,Agence_moov_Ouidah,300000,226299,Marthe Gilles,12227,85928,2022-07-19
CASH_OUT,116075,Bernard Maurice,122285,6210,Agence_moov_Cotonou,300000,183925,2022-07-02
CASH_IN,37849,Agence_moov_Ouidah,300000,262151,Bernard Maurice,6210,44059,2022-07-03
TRANSFER,86724,Benoît Guyot,694028,607304,Bernard Maurice,44059,130783,2022-07-03
CASH_IN,99116,Agence_moov_Cotonou,300000,200884,Bernard Maurice,130783,229899,2022-07-05
CASH_OUT,129820,Bernard Maurice,229899,100079,Agence_moov_Abomey,300000,170180,2022-07-14
TRANSFER,57029,Bernard Maurice,100079,43050,Anastasie Richard-Neveu,103516,46487,2022-07-16
TRANSFER,136511,Aimé Pages,403233,266722,Bernard Maurice,43050,179561,2022-07-21
CASH_IN,80891,Agence_moov_Abomey,300000,219109,Camille Prévost,-115714,-34823,2022-07-03
CASH_IN,108338,Agence_moov_Cotonou,300000,191662,Camille Prévost,-34823,73515,2022-07-03
TRANSFER,20095,Camille Prévost,73515,53420,Andrée-Thérèse Mendès,3675,-16420,2022-07-06
CASH_IN,43618,Agence_moov_Cotonou,300000,256382,Camille Prévost,53420,97038,2022-07-10
CASH_IN,115256,Agence_moov_Abomey,300000,184744,Camille Prévost,97038,212294,2022-07-10
CASH_IN,103352,Agence_moov_Ouidah,300000,196648,Camille Prévost,212294,315646,2022-07-16
TRANSFER,70454,Camille Prévost,315646,245192,Benoît Guyot,607304,536850,2022-07-18
CASH_OUT,58470,Camille Prévost,245192,186722,Agence_moov_Ouidah,300000,241530,2022-07-19
CASH_IN,276229,Agence_moov_Abomey,300000,23771,Camille Prévost,186722,462951,2022-07-21
TRANSFER,140072,Aimé Pages,266722,126650,Camille Prévost,462951,603023,2022-07-22
TRANSFER,196102,Benoît Guyot,536850,340748,Camille Prévost,603023,799125,2022-07-26
TRANSFER,38260,Camille Prévost,799125,760865,Alphonse Gomes,841,-37419,2022-07-26
CASH_IN,185988,Agence_moov_Abomey,300000,114012,Camille Prévost,760865,946853,2022-07-27
CASH_IN,54544,Agence_moov_Cotonou,300000,245456,Françoise Morin,-1194971,-1140427,2022-07-01
CASH_IN,52813,Agence_moov_Ouidah,300000,247187,Françoise Morin,-1140427,-1087614,2022-07-02
CASH_IN,181450,Agence_moov_Ouidah,300000,118550,Françoise Morin,-1087614,-906164,2022-07-05
CASH_IN,92023,Agence_moov_Abomey,300000,207977,Françoise Morin,-906164,-814141,2022-07-08
CASH_IN,212062,Agence_moov_Ouidah,300000,87938,Françoise Morin,-814141,-602079,2022-07-14
CASH_IN,860,Agence_moov_Abomey,300000,299140,Françoise Morin,-602079,-601219,2022-07-18
CASH_IN,209914,Agence_moov_Abomey,300000,90086,Françoise Morin,-601219,-391305,2022-07-22
CASH_IN,245708,Agence_moov_Ouidah,300000,54292,Françoise Morin,-391305,-145597,2022-07-24
CASH_IN,73615,Agence_moov_Abomey,300000,226385,Françoise Morin,-145597,-71982,2022-07-25
CASH_IN,198793,Agence_moov_Cotonou,300000,101207,Alphonse Joly,-88252,110541,2022-07-03
CASH_OUT,38792,Alphonse Joly,110541,71749,Agence_moov_Ouidah,300000,261208,2022-07-03
CASH_IN,136862,Agence_moov_Cotonou,300000,163138,Alphonse Joly,71749,208611,2022-07-03
CASH_OUT,84127,Alphonse Joly,208611,124484,Agence_moov_Ouidah,300000,215873,2022-07-10
TRANSFER,61539,Alphonse Joly,124484,62945,Paulette Loiseau,452816,391277,2022-07-11
CASH_IN,98516,Agence_moov_Ouidah,300000,201484,Alphonse Joly,62945,161461,2022-07-14
CASH_OUT,152079,Alphonse Joly,161461,9382,Agence_moov_Ouidah,300000,147921,2022-07-16
CASH_OUT,4006,Alphonse Joly,9382,5376,Agence_moov_Abomey,300000,295994,2022-07-19
CASH_IN,132462,Agence_moov_Ouidah,300000,167538,Alphonse Joly,5376,137838,2022-07-21
TRANSFER,36770,Alphonse Joly,137838,101068,Michelle de Étienne,204437,167667,2022-07-24
CASH_IN,288471,Agence_moov_Ouidah,300000,11529,Richard Michel,-182578,105893,2022-07-01
TRANSFER,63018,Michelle de Étienne,167667,104649,Richard Michel,105893,168911,2022-07-01
CASH_IN,249763,Agence_moov_Ouidah,300000,50237,Richard Michel,168911,418674,2022-07-02
CASH_OUT,144426,Richard Michel,418674,274248,Agence_moov_Ouidah,300000,155574,2022-07-02
TRANSFER,73792,Richard Michel,274248,200456,Michelle de Étienne,104649,30857,2022-07-04
CASH_OUT,55688,Richard Michel,200456,144768,Agence_moov_Abomey,300000,244312,2022-07-05
CASH_OUT,104491,Richard Michel,144768,40277,Agence_moov_Cotonou,300000,195509,2022-07-06
CASH_IN,131801,Agence_moov_Cotonou,300000,168199,Richard Michel,40277,172078,2022-07-06
TRANSFER,35618,Richard Michel,172078,136460,Anastasie Richard-Neveu,46487,10869,2022-07-07
CASH_IN,147380,Agence_moov_Ouidah,300000,152620,Richard Michel,136460,283840,2022-07-08
TRANSFER,270580,Benoît Guyot,340748,70168,Richard Michel,283840,554420,2022-07-08
TRANSFER,309350,Richard Michel,554420,245070,Michelle de Étienne,30857,-278493,2022-07-12
CASH_IN,36454,Agence_moov_Ouidah,300000,263546,Richard Michel,245070,281524,2022-07-19
CASH_IN,201311,Agence_moov_Ouidah,300000,98689,Richard Michel,281524,482835,2022-07-20
CASH_IN,231246,Agence_moov_Abomey,300000,68754,Richard Michel,482835,714081,2022-07-21
TRANSFER,14062,Richard Michel,714081,700019,Anastasie Richard-Neveu,10869,-3193,2022-07-23
CASH_IN,51212,Agence_moov_Cotonou,300000,248788,Richard Michel,700019,751231,2022-07-26
CASH_IN,177853,Agence_moov_Abomey,300000,122147,Maggie Martinez,-123401,54452,2022-07-01
CASH_OUT,29793,Maggie Martinez,54452,24659,Agence_moov_Abomey,300000,270207,2022-07-03
CASH_OUT,15406,Maggie Martinez,24659,9253,Agence_moov_Cotonou,300000,284594,2022-07-08
CASH_OUT,5325,Maggie Martinez,9253,3928,Agence_moov_Cotonou,300000,294675,2022-07-09
TRANSFER,1826,Maggie Martinez,3928,2102,Constance Bourdon-Millet,77095,75269,2022-07-16
TRANSFER,17480,Constance Bourdon-Millet,75269,57789,Maggie Martinez,2102,19582,2022-07-16
CASH_OUT,8419,Maggie Martinez,19582,11163,Agence_moov_Cotonou,300000,291581,2022-07-17
CASH_IN,145325,Agence_moov_Abomey,300000,154675,Hélène Le Chauvin,-303179,-157854,2022-07-04
CASH_IN,164169,Agence_moov_Abomey,300000,135831,Hélène Le Chauvin,-157854,6315,2022-07-04
TRANSFER,4888,Hélène Le Chauvin,6315,1427,Paulette Loiseau,391277,386389,2022-07-05
CASH_OUT,370,Hélène Le Chauvin,1427,1057,Agence_moov_Cotonou,300000,299630,2022-07-07
TRANSFER,68615,Aimé Pages,126650,58035,Hélène Le Chauvin,1057,69672,2022-07-07
CASH_OUT,2414,Hélène Le Chauvin,69672,67258,Agence_moov_Cotonou,300000,297586,2022-07-08
TRANSFER,46993,Hélène Le Chauvin,67258,20265,Paulette Loiseau,386389,339396,2022-07-08
CASH_IN,228908,Agence_moov_Abomey,300000,71092,Hélène Le Chauvin,20265,249173,2022-07-11
CASH_IN,165960,Agence_moov_Cotonou,300000,134040,Hélène Le Chauvin,249173,415133,2022-07-11
CASH_OUT,133783,Hélène Le Chauvin,415133,281350,Agence_moov_Abomey,300000,166217,2022-07-12
TRANSFER,28156,Constance Bourdon-Millet,57789,29633,Hélène Le Chauvin,281350,309506,2022-07-14
CASH_OUT,133493,Hélène Le Chauvin,309506,176013,Agence_moov_Cotonou,300000,166507,2022-07-17
CASH_IN,186417,Agence_moov_Abomey,300000,113583,Hélène Le Chauvin,176013,362430,2022-07-24
TRANSFER,253399,Hélène Le Chauvin,362430,109031,Paulette Loiseau,339396,85997,2022-07-27
CASH_IN,131169,Agence_moov_Ouidah,300000,168831,Robert-Louis Gosselin,-430413,-299244,2022-07-01
CASH_IN,44183,Agence_moov_Cotonou,300000,255817,Robert-Louis Gosselin,-299244,-255061,2022-07-01
CASH_IN,286727,Agence_moov_Ouidah,300000,13273,Robert-Louis Gosselin,-255061,31666,2022-07-05
TRANSFER,58148,Paulette Loiseau,85997,27849,Robert-Louis Gosselin,31666,89814,2022-07-06
CASH_OUT,77566,Robert-Louis Gosselin,89814,12248,Agence_moov_Ouidah,300000,222434,2022-07-09
CASH_OUT,6074,Robert-Louis Gosselin,12248,6174,Agence_moov_Ouidah,300000,293926,2022-07-13
CASH_OUT,3371,Robert-Louis Gosselin,6174,2803,Agence_moov_Cotonou,300000,296629,2022-07-13
CASH_IN,154446,Agence_moov_Ouidah,300000,145554,Robert-Louis Gosselin,2803,157249,2022-07-17
CASH_IN,188646,Agence_moov_Ouidah,300000,111354,Robert-Louis Gosselin,157249,345895,2022-07-18
CASH_IN,18005,Agence_moov_Ouidah,300000,281995,Robert-Louis Gosselin,345895,363900,2022-07-20
TRANSFER,49008,Aimé Pages,58035,9027,Robert-Louis Gosselin,363900,412908,2022-07-23
CASH_IN,142665,Agence_moov_Ouidah,300000,157335,Robert-Louis Gosselin,412908,555573,2022-07-24
CASH_OUT,26238,Robert-Louis Gosselin,555573,529335,Agence_moov_Abomey,300000,273762,2022-07-25
CASH_IN,15274,Agence_moov_Ouidah,300000,284726,Robert-Louis Gosselin,529335,544609,2022-07-26
CASH_IN,214976,Agence_moov_Abomey,300000,85024,Audrey Julien de Leleu,-545342,-330366,2022-07-05
CASH_IN,228423,Agence_moov_Cotonou,300000,71577,Audrey Julien de Leleu,-330366,-101943,2022-07-06
CASH_IN,204307,Agence_moov_Abomey,300000,95693,Audrey Julien de Leleu,-101943,102364,2022-07-06
CASH_OUT,46971,Audrey Julien de Leleu,102364,55393,Agence_moov_Ouidah,300000,253029,2022-07-07
CASH_OUT,47985,Audrey Julien de Leleu,55393,7408,Agence_moov_Abomey,300000,252015,2022-07-07
CASH_IN,209175,Agence_moov_Cotonou,300000,90825,Audrey Julien de Leleu,7408,216583,2022-07-10
CASH_OUT,33762,Audrey Julien de Leleu,216583,182821,Agence_moov_Abomey,300000,266238,2022-07-11
CASH_IN,241026,Agence_moov_Ouidah,300000,58974,Audrey Julien de Leleu,182821,423847,2022-07-15
TRANSFER,279976,Audrey Julien de Leleu,423847,143871,Audrey Julien de Leleu,423847,143871,2022-07-15
CASH_OUT,24237,Audrey Julien de Leleu,143871,119634,Agence_moov_Ouidah,300000,275763,2022-07-16
TRANSFER,70667,Audrey Julien de Leleu,119634,48967,Aimé Pages,9027,-61640,2022-07-18
TRANSFER,1927,Audrey Julien de Leleu,48967,47040,Paulette Loiseau,27849,25922,2022-07-18
CASH_OUT,46865,Audrey Julien de Leleu,47040,175,Agence_moov_Abomey,300000,253135,2022-07-21
CASH_IN,257088,Agence_moov_Abomey,300000,42912,Audrey Julien de Leleu,175,257263,2022-07-24
CASH_OUT,68804,Audrey Julien de Leleu,257263,188459,Agence_moov_Ouidah,300000,231196,2022-07-25
CASH_IN,89404,Agence_moov_Abomey,300000,210596,Audrey Julien de Leleu,188459,277863,2022-07-26
CASH_OUT,60543,Audrey Julien de Leleu,277863,217320,Agence_moov_Abomey,300000,239457,2022-07-26
CASH_IN,142858,Agence_moov_Abomey,300000,157142,Alphonse Gomes,-37419,105439,2022-07-01
CASH_IN,46373,Agence_moov_Ouidah,300000,253627,Alphonse Gomes,105439,151812,2022-07-02
TRANSFER,147082,Alphonse Gomes,151812,4730,Alphonse Gomes,151812,298894,2022-07-02
CASH_IN,86181,Agence_moov_Cotonou,300000,213819,Alphonse Gomes,4730,90911,2022-07-05
CASH_IN,5916,Agence_moov_Abomey,300000,294084,Alphonse Gomes,90911,96827,2022-07-06
CASH_IN,259973,Agence_moov_Ouidah,300000,40027,Alphonse Gomes,96827,356800,2022-07-07
CASH_IN,246588,Agence_moov_Cotonou,300000,53412,Alphonse Gomes,356800,603388,2022-07-07
CASH_OUT,284731,Alphonse Gomes,603388,318657,Agence_moov_Abomey,300000,15269,2022-07-07
TRANSFER,24512,Alphonse Gomes,318657,294145,Alphonse Gomes,318657,294145,2022-07-09
CASH_IN,34316,Agence_moov_Cotonou,300000,265684,Alphonse Gomes,294145,328461,2022-07-10
CASH_IN,200695,Agence_moov_Cotonou,300000,99305,Alphonse Gomes,328461,529156,2022-07-14
CASH_IN,149716,Agence_moov_Ouidah,300000,150284,Alphonse Gomes,529156,678872,2022-07-15
CASH_IN,33764,Agence_moov_Cotonou,300000,266236,Alphonse Gomes,678872,712636,2022-07-16
CASH_OUT,178955,Alphonse Gomes,712636,533681,Agence_moov_Ouidah,300000,121045,2022-07-16
CASH_OUT,315402,Alphonse Gomes,533681,218279,Agence_moov_Abomey,300000,-15402,2022-07-17
CASH_IN,71424,Agence_moov_Abomey,300000,228576,Alphonse Gomes,218279,289703,2022-07-21
CASH_IN,80446,Agence_moov_Abomey,300000,219554,Thibaut de la Lombard,-34797,45649,2022-07-01
CASH_OUT,32727,Thibaut de la Lombard,45649,12922,Agence_moov_Abomey,300000,267273,2022-07-02
CASH_IN,54241,Agence_moov_Abomey,300000,245759,Thibaut de la Lombard,12922,67163,2022-07-05
TRANSFER,57910,Thibaut de la Lombard,67163,9253,Thibaut de la Lombard,67163,9253,2022-07-05
CASH_IN,28573,Agence_moov_Abomey,300000,271427,Thibaut de la Lombard,9253,37826,2022-07-06
TRANSFER,17464,Paulette Loiseau,25922,8458,Thibaut de la Lombard,37826,55290,2022-07-12
TRANSFER,27210,Thibaut de la Lombard,55290,28080,Paulette Loiseau,8458,-18752,2022-07-15
CASH_OUT,6110,Thibaut de la Lombard,28080,21970,Agence_moov_Ouidah,300000,293890,2022-07-15
CASH_IN,211640,Agence_moov_Abomey,300000,88360,Thibaut de la Lombard,21970,233610,2022-07-16
CASH_OUT,112100,Thibaut de la Lombard,233610,121510,Agence_moov_Ouidah,300000,187900,2022-07-19
TRANSFER,62827,Thibaut de la Lombard,121510,58683,Thibaut de la Lombard,121510,184337,2022-07-20
CASH_IN,64656,Agence_moov_Abomey,300000,235344,Thibaut de la Lombard,58683,123339,2022-07-22
CASH_IN,154388,Agence_moov_Ouidah,300000,145612,Thibaut de la Lombard,123339,277727,2022-07-23
CASH_IN,6873,Agence_moov_Abomey,300000,293127,Thibaut de la Lombard,277727,284600,2022-07-24
CASH_OUT,89090,Thibaut de la Lombard,284600,195510,Agence_moov_Abomey,300000,210910,2022-07-24
CASH_OUT,272,Thibaut de la Lombard,195510,195238,Agence_moov_Abomey,300000,299728,2022-07-24
CASH_OUT,45177,Thibaut de la Lombard,195238,150061,Agence_moov_Cotonou,300000,254823,2022-07-25
CASH_IN,144998,Agence_moov_Ouidah,300000,155002,Thibaut de la Lombard,150061,295059,2022-07-26
CASH_IN,168636,Agence_moov_Ouidah,300000,131364,Thibaut de la Lombard,295059,463695,2022-07-27
CASH_IN,289556,Agence_moov_Abomey,300000,10444,Stéphane Munoz,-50059,239497,2022-07-03
CASH_IN,119681,Agence_moov_Ouidah,300000,180319,Stéphane Munoz,239497,359178,2022-07-04
TRANSFER,339244,Stéphane Munoz,359178,19934,Stéphane Munoz,359178,19934,2022-07-06
CASH_IN,189853,Agence_moov_Cotonou,300000,110147,Stéphane Munoz,19934,209787,2022-07-09
CASH_OUT,8875,Stéphane Munoz,209787,200912,Agence_moov_Ouidah,300000,291125,2022-07-20
CASH_OUT,150289,Stéphane Munoz,200912,50623,Agence_moov_Ouidah,300000,149711,2022-07-20
CASH_IN,32851,Agence_moov_Ouidah,300000,267149,Stéphane Munoz,50623,83474,2022-07-26
CASH_IN,183561,Agence_moov_Ouidah,300000,116439,Simone Muller de la Brun,-15656,167905,2022-07-01
TRANSFER,80722,Simone Muller de la Brun,167905,87183,Simone Muller de la Brun,167905,87183,2022-07-02
CASH_IN,144129,Agence_moov_Cotonou,300000,155871,Simone Muller de la Brun,87183,231312,2022-07-03
TRANSFER,10117,Simone Muller de la Brun,231312,221195,Simone Muller de la Brun,231312,221195,2022-07-05
CASH_OUT,40879,Simone Muller de la Brun,221195,180316,Agence_moov_Abomey,300000,259121,2022-07-06
CASH_OUT,34813,Simone Muller de la Brun,180316,145503,Agence_moov_Abomey,300000,265187,2022-07-07
CASH_IN,265318,Agence_moov_Cotonou,300000,34682,Simone Muller de la Brun,145503,410821,2022-07-11
CASH_OUT,118323,Simone Muller de la Brun,410821,292498,Agence_moov_Ouidah,300000,181677,2022-07-22
CASH_OUT,28413,Simone Muller de la Brun,292498,264085,Agence_moov_Cotonou,300000,271587,2022-07-23
CASH_OUT,226656,Simone Muller de la Brun,264085,37429,Agence_moov_Cotonou,300000,73344,2022-07-27
CASH_IN,135477,Agence_moov_Ouidah,300000,164523,Thomas-Robert Morvan,-797087,-661610,2022-07-01
CASH_IN,49222,Agence_moov_Cotonou,300000,250778,Thomas-Robert Morvan,-661610,-612388,2022-07-07
CASH_IN,282568,Agence_moov_Ouidah,300000,17432,Thomas-Robert Morvan,-612388,-329820,2022-07-07
CASH_IN,250297,Agence_moov_Cotonou,300000,49703,Thomas-Robert Morvan,-329820,-79523,2022-07-07
CASH_IN,264675,Agence_moov_Ouidah,300000,35325,Thomas-Robert Morvan,-79523,185152,2022-07-07
CASH_OUT,142662,Thomas-Robert Morvan,185152,42490,Agence_moov_Cotonou,300000,157338,2022-07-16
CASH_OUT,15011,Thomas-Robert Morvan,42490,27479,Agence_moov_Abomey,300000,284989,2022-07-20
CASH_OUT,3586,Thomas-Robert Morvan,27479,23893,Agence_moov_Abomey,300000,296414,2022-07-21
CASH_OUT,20929,Thomas-Robert Morvan,23893,2964,Agence_moov_Abomey,300000,279071,2022-07-21
CASH_OUT,2319,Thomas-Robert Morvan,2964,645,Agence_moov_Ouidah,300000,297681,2022-07-23
CASH_IN,200743,Agence_moov_Cotonou,300000,99257,Thomas-Robert Morvan,645,201388,2022-07-26
CASH_IN,130816,Agence_moov_Abomey,300000,169184,Colette-Sophie Prévost,-227949,-97133,2022-07-04
CASH_IN,299376,Agence_moov_Cotonou,300000,624,Colette-Sophie Prévost,-97133,202243,2022-07-05
CASH_OUT,13223,Colette-Sophie Prévost,202243,189020,Agence_moov_Cotonou,300000,286777,2022-07-06
CASH_IN,186815,Agence_moov_Ouidah,300000,113185,Colette-Sophie Prévost,189020,375835,2022-07-24
CASH_IN,196706,Agence_moov_Abomey,300000,103294,Colette-Sophie Prévost,375835,572541,2022-07-24
CASH_IN,194459,Agence_moov_Cotonou,300000,105541,Thomas de Blin,-525772,-331313,2022-07-06
CASH_IN,219481,Agence_moov_Abomey,300000,80519,Thomas de Blin,-331313,-111832,2022-07-06
CASH_IN,107886,Agence_moov_Cotonou,300000,192114,Thomas de Blin,-111832,-3946,2022-07-07
CASH_IN,16385,Agence_moov_Abomey,300000,283615,Thomas de Blin,-3946,12439,2022-07-11
TRANSFER,1144,Thomas de Blin,12439,11295,Thomas de Blin,12439,11295,2022-07-12
TRANSFER,8282,Thomas de Blin,11295,3013,Thomas de Blin,11295,3013,2022-07-12
CASH_OUT,2779,Thomas de Blin,3013,234,Agence_moov_Ouidah,300000,297221,2022-07-16
CASH_IN,250273,Agence_moov_Abomey,300000,49727,Thomas de Blin,234,250507,2022-07-16
TRANSFER,98636,Thomas de Blin,250507,151871,Thomas de Blin,250507,349143,2022-07-17
CASH_IN,205070,Agence_moov_Ouidah,300000,94930,Thomas de Blin,151871,356941,2022-07-19
TRANSFER,77378,Thomas de Blin,356941,279563,Thomas de Blin,356941,279563,2022-07-20
TRANSFER,134393,Thomas de Blin,279563,145170,Thomas de Blin,279563,413956,2022-07-21
CASH_OUT,22514,Thomas de Blin,145170,122656,Agence_moov_Abomey,300000,277486,2022-07-21
CASH_OUT,11158,Thomas de Blin,122656,111498,Agence_moov_Cotonou,300000,288842,2022-07-22
CASH_OUT,28112,Thomas de Blin,111498,83386,Agence_moov_Ouidah,300000,271888,2022-07-23
CASH_IN,249922,Agence_moov_Ouidah,300000,50078,Thomas de Blin,83386,333308,2022-07-24
CASH_OUT,158907,Thomas de Blin,333308,174401,Agence_moov_Ouidah,300000,141093,2022-07-26
CASH_IN,84701,Agence_moov_Abomey,300000,215299,Anastasie Cousin,-1212294,-1127593,2022-07-02
CASH_IN,241126,Agence_moov_Abomey,300000,58874,Anastasie Cousin,-1127593,-886467,2022-07-02
CASH_IN,5094,Agence_moov_Cotonou,300000,294906,Anastasie Cousin,-886467,-881373,2022-07-04
CASH_IN,173207,Agence_moov_Abomey,300000,126793,Anastasie Cousin,-881373,-708166,2022-07-07
CASH_IN,175667,Agence_moov_Ouidah,300000,124333,Anastasie Cousin,-708166,-532499,2022-07-09
CASH_IN,263286,Agence_moov_Cotonou,300000,36714,Anastasie Cousin,-532499,-269213,2022-07-09
CASH_IN,154427,Agence_moov_Cotonou,300000,145573,Anastasie Cousin,-269213,-114786,2022-07-10
CASH_IN,296977,Agence_moov_Ouidah,300000,3023,Anastasie Cousin,-114786,182191,2022-07-17
CASH_IN,9140,Agence_moov_Ouidah,300000,290860,Anastasie Cousin,182191,191331,2022-07-19
CASH_IN,129087,Agence_moov_Ouidah,300000,170913,Lucy Gillet,-1248845,-1119758,2022-07-01
CASH_IN,292503,Agence_moov_Ouidah,300000,7497,Lucy Gillet,-1119758,-827255,2022-07-02
CASH_IN,228350,Agence_moov_Ouidah,300000,71650,Lucy Gillet,-827255,-598905,2022-07-02
CASH_IN,121230,Agence_moov_Ouidah,300000,178770,Lucy Gillet,-598905,-477675,2022-07-03
CASH_IN,283637,Agence_moov_Cotonou,300000,16363,Lucy Gillet,-477675,-194038,2022-07-06
CASH_IN,144978,Agence_moov_Cotonou,300000,155022,Lucy Gillet,-194038,-49060,2022-07-07
CASH_IN,247093,Agence_moov_Cotonou,300000,52907,Lucy Gillet,-49060,198033,2022-07-09
CASH_IN,254016,Agence_moov_Abomey,300000,45984,Lucy Gillet,198033,452049,2022-07-09
CASH_OUT,142050,Lucy Gillet,452049,309999,Agence_moov_Cotonou,300000,157950,2022-07-13
TRANSFER,149280,Lucy Gillet,309999,160719,Lucy Gillet,309999,459279,2022-07-14
CASH_OUT,84293,Lucy Gillet,160719,76426,Agence_moov_Abomey,300000,215707,2022-07-14
TRANSFER,8206,Lucy Gillet,76426,68220,Lucy Gillet,76426,68220,2022-07-19
TRANSFER,8212,Lucy Gillet,68220,60008,Lucy Gillet,68220,76432,2022-07-19
CASH_OUT,58247,Lucy Gillet,60008,1761,Agence_moov_Abomey,300000,241753,2022-07-24
CASH_OUT,880,Lucy Gillet,1761,881,Agence_moov_Abomey,300000,299120,2022-07-25
CASH_OUT,183,Lucy Gillet,881,698,Agence_moov_Abomey,300000,299817,2022-07-27
CASH_IN,80455,Agence_moov_Abomey,300000,219545,Michelle de Étienne,-278493,-198038,2022-07-03
CASH_IN,53358,Agence_moov_Ouidah,300000,246642,Michelle de Étienne,-198038,-144680,2022-07-04
CASH_IN,41588,Agence_moov_Cotonou,300000,258412,Michelle de Étienne,-144680,-103092,2022-07-06
CASH_IN,93197,Agence_moov_Abomey,300000,206803,Michelle de Étienne,-103092,-9895,2022-07-06
CASH_IN,43015,Agence_moov_Abomey,300000,256985,Michelle de Étienne,-9895,33120,2022-07-09
CASH_IN,153231,Agence_moov_Ouidah,300000,146769,Michelle de Étienne,33120,186351,2022-07-10
CASH_OUT,139179,Michelle de Étienne,186351,47172,Agence_moov_Ouidah,300000,160821,2022-07-11
CASH_OUT,5200,Michelle de Étienne,47172,41972,Agence_moov_Cotonou,300000,294800,2022-07-24
CASH_OUT,15946,Michelle de Étienne,41972,26026,Agence_moov_Cotonou,300000,284054,2022-07-25
CASH_IN,29552,Agence_moov_Abomey,300000,270448,Lucie Aubert,-108126,-78574,2022-07-02
CASH_IN,15911,Agence_moov_Cotonou,300000,284089,Lucie Aubert,-78574,-62663,2022-07-02
CASH_IN,274769,Agence_moov_Cotonou,300000,25231,Lucie Aubert,-62663,212106,2022-07-04
TRANSFER,137262,Lucie Aubert,212106,74844,Lucie Aubert,212106,349368,2022-07-05
CASH_OUT,7126,Lucie Aubert,74844,67718,Agence_moov_Cotonou,300000,292874,2022-07-06
CASH_IN,253526,Agence_moov_Cotonou,300000,46474,Lucie Aubert,67718,321244,2022-07-06
CASH_OUT,90689,Lucie Aubert,321244,230555,Agence_moov_Ouidah,300000,209311,2022-07-06
CASH_IN,113795,Agence_moov_Ouidah,300000,186205,Lucie Aubert,230555,344350,2022-07-07
CASH_OUT,312886,Lucie Aubert,344350,31464,Agence_moov_Cotonou,300000,-12886,2022-07-07
CASH_OUT,11322,Lucie Aubert,31464,20142,Agence_moov_Cotonou,300000,288678,2022-07-07
CASH_IN,106191,Agence_moov_Ouidah,300000,193809,Lucie Aubert,20142,126333,2022-07-09
CASH_IN,232479,Agence_moov_Ouidah,300000,67521,Lucie Aubert,126333,358812,2022-07-09
CASH_IN,282049,Agence_moov_Abomey,300000,17951,Lucie Aubert,358812,640861,2022-07-14
CASH_OUT,623724,Lucie Aubert,640861,17137,Agence_moov_Cotonou,300000,-323724,2022-07-15
CASH_OUT,11656,Lucie Aubert,17137,5481,Agence_moov_Ouidah,300000,288344,2022-07-19
CASH_IN,96174,Agence_moov_Ouidah,300000,203826,Lucie Aubert,5481,101655,2022-07-21
CASH_IN,233197,Agence_moov_Ouidah,300000,66803,Lucie Aubert,101655,334852,2022-07-26
CASH_IN,77072,Agence_moov_Abomey,300000,222928,Paulette Loiseau,-18752,58320,2022-07-01
CASH_OUT,4735,Paulette Loiseau,58320,53585,Agence_moov_Abomey,300000,295265,2022-07-06
TRANSFER,34802,Paulette Loiseau,53585,18783,Paulette Loiseau,53585,18783,2022-07-07
CASH_IN,79073,Agence_moov_Cotonou,300000,220927,Paulette Loiseau,18783,97856,2022-07-09
CASH_OUT,60962,Paulette Loiseau,97856,36894,Agence_moov_Ouidah,300000,239038,2022-07-10
CASH_IN,122711,Agence_moov_Cotonou,300000,177289,Paulette Loiseau,36894,159605,2022-07-13
CASH_IN,281731,Agence_moov_Abomey,300000,18269,Paulette Loiseau,159605,441336,2022-07-15
CASH_OUT,372659,Paulette Loiseau,441336,68677,Agence_moov_Cotonou,300000,-72659,2022-07-17
CASH_OUT,47834,Paulette Loiseau,68677,20843,Agence_moov_Abomey,300000,252166,2022-07-17
CASH_OUT,16474,Paulette Loiseau,20843,4369,Agence_moov_Cotonou,300000,283526,2022-07-18
CASH_IN,170107,Agence_moov_Abomey,300000,129893,Paulette Loiseau,4369,174476,2022-07-23
CASH_IN,184482,Agence_moov_Cotonou,300000,115518,Paulette Loiseau,174476,358958,2022-07-25
CASH_OUT,69055,Paulette Loiseau,358958,289903,Agence_moov_Ouidah,300000,230945,2022-07-26
CASH_IN,47110,Agence_moov_Abomey,300000,252890,Paul Perez,-295022,-247912,2022-07-02
CASH_IN,158113,Agence_moov_Abomey,300000,141887,Paul Perez,-247912,-89799,2022-07-04
CASH_IN,7959,Agence_moov_Cotonou,300000,292041,Paul Perez,-89799,-81840,2022-07-06
CASH_IN,180290,Agence_moov_Abomey,300000,119710,Paul Perez,-81840,98450,2022-07-06
TRANSFER,74822,Paul Perez,98450,23628,Paul Perez,98450,23628,2022-07-07
TRANSFER,18952,Paul Perez,23628,4676,Paul Perez,23628,4676,2022-07-10
CASH_OUT,2991,Paul Perez,4676,1685,Agence_moov_Cotonou,300000,297009,2022-07-11
CASH_IN,243175,Agence_moov_Abomey,300000,56825,Paul Perez,1685,244860,2022-07-27
CASH_IN,3664,Agence_moov_Ouidah,300000,296336,Andrée-Thérèse Mendès,-16420,-12756,2022-07-02
CASH_IN,291429,Agence_moov_Cotonou,300000,8571,Andrée-Thérèse Mendès,-12756,278673,2022-07-09
TRANSFER,180136,Andrée-Thérèse Mendès,278673,98537,Andrée-Thérèse Mendès,278673,98537,2022-07-10
CASH_IN,38158,Agence_moov_Abomey,300000,261842,Andrée-Thérèse Mendès,98537,136695,2022-07-14
CASH_IN,8321,Agence_moov_Abomey,300000,291679,Andrée-Thérèse Mendès,136695,145016,2022-07-18
CASH_OUT,44588,Andrée-Thérèse Mendès,145016,100428,Agence_moov_Cotonou,300000,255412,2022-07-18
CASH_OUT,95153,Andrée-Thérèse Mendès,100428,5275,Agence_moov_Ouidah,300000,204847,2022-07-21
CASH_OUT,2290,Andrée-Thérèse Mendès,5275,2985,Agence_moov_Cotonou,300000,297710,2022-07-21
CASH_OUT,2631,Andrée-Thérèse Mendès,2985,354,Agence_moov_Abomey,300000,297369,2022-07-22
CASH_IN,43604,Agence_moov_Cotonou,300000,256396,Andrée-Thérèse Mendès,354,43958,2022-07-23
CASH_IN,50136,Agence_moov_Ouidah,300000,249864,Aimé Pages,-61640,-11504,2022-07-02
CASH_IN,82800,Agence_moov_Cotonou,300000,217200,Aimé Pages,-11504,71296,2022-07-02
TRANSFER,53643,Aimé Pages,71296,17653,Aimé Pages,71296,17653,2022-07-02
CASH_IN,51467,Agence_moov_Abomey,300000,248533,Aimé Pages,17653,69120,2022-07-11
CASH_IN,259136,Agence_moov_Abomey,300000,40864,Aimé Pages,69120,328256,2022-07-12
CASH_OUT,143143,Aimé Pages,328256,185113,Agence_moov_Abomey,300000,156857,2022-07-13
CASH_OUT,3624,Aimé Pages,185113,181489,Agence_moov_Cotonou,300000,296376,2022-07-13
CASH_IN,25573,Agence_moov_Ouidah,300000,274427,Aimé Pages,181489,207062,2022-07-13
CASH_IN,141429,Agence_moov_Abomey,300000,158571,Aimé Pages,207062,348491,2022-07-14
CASH_IN,27395,Agence_moov_Ouidah,300000,272605,Aimé Pages,348491,375886,2022-07-15
CASH_OUT,373836,Aimé Pages,375886,2050,Agence_moov_Ouidah,300000,-73836,2022-07-21
CASH_IN,202429,Agence_moov_Ouidah,300000,97571,Camille Morvan,-44741,157688,2022-07-01
CASH_OUT,47003,Camille Morvan,157688,110685,Agence_moov_Abomey,300000,252997,2022-07-05
CASH_IN,254471,Agence_moov_Abomey,300000,45529,Camille Morvan,110685,365156,2022-07-07
CASH_OUT,268488,Camille Morvan,365156,96668,Agence_moov_Cotonou,300000,31512,2022-07-07
CASH_IN,95106,Agence_moov_Ouidah,300000,204894,Camille Morvan,96668,191774,2022-07-09
CASH_OUT,118834,Camille Morvan,191774,72940,Agence_moov_Abomey,300000,181166,2022-07-10
CASH_OUT,34299,Camille Morvan,72940,38641,Agence_moov_Abomey,300000,265701,2022-07-13
CASH_OUT,12823,Camille Morvan,38641,25818,Agence_moov_Abomey,300000,287177,2022-07-13
CASH_IN,119690,Agence_moov_Cotonou,300000,180310,Camille Morvan,25818,145508,2022-07-13
CASH_IN,191113,Agence_moov_Cotonou,300000,108887,Camille Morvan,145508,336621,2022-07-15
CASH_OUT,25225,Camille Morvan,336621,311396,Agence_moov_Ouidah,300000,274775,2022-07-15
CASH_OUT,194707,Camille Morvan,311396,116689,Agence_moov_Abomey,300000,105293,2022-07-16
CASH_IN,129355,Agence_moov_Ouidah,300000,170645,Anastasie Richard-Neveu,-3193,126162,2022-07-10
TRANSFER,106739,Anastasie Richard-Neveu,126162,19423,Anastasie Richard-Neveu,126162,19423,2022-07-11
CASH_IN,194397,Agence_moov_Cotonou,300000,105603,Anastasie Richard-Neveu,19423,213820,2022-07-12
TRANSFER,87769,Anastasie Richard-Neveu,213820,126051,Anastasie Richard-Neveu,213820,301589,2022-07-13
TRANSFER,43932,Anastasie Richard-Neveu,126051,82119,Anastasie Richard-Neveu,126051,169983,2022-07-13
TRANSFER,58397,Anastasie Richard-Neveu,82119,23722,Anastasie Richard-Neveu,82119,23722,2022-07-15
CASH_IN,220724,Agence_moov_Cotonou,300000,79276,Anastasie Richard-Neveu,23722,244446,2022-07-16
CASH_OUT,157433,Anastasie Richard-Neveu,244446,87013,Agence_moov_Ouidah,300000,142567,2022-07-17
CASH_IN,160283,Agence_moov_Ouidah,300000,139717,Anastasie Richard-Neveu,87013,247296,2022-07-23
CASH_OUT,181841,Anastasie Richard-Neveu,247296,65455,Agence_moov_Abomey,300000,118159,2022-07-27
CASH_IN,136745,Agence_moov_Ouidah,300000,163255,Anastasie Richard-Neveu,65455,202200,2022-07-27
CASH_IN,50595,Agence_moov_Abomey,300000,249405,Nathalie Bonnin-Joubert,-400471,-349876,2022-07-06
CASH_IN,224611,Agence_moov_Ouidah,300000,75389,Nathalie Bonnin-Joubert,-349876,-125265,2022-07-09
CASH_IN,163397,Agence_moov_Abomey,300000,136603,Nathalie Bonnin-Joubert,-125265,38132,2022-07-13
CASH_IN,60101,Agence_moov_Ouidah,300000,239899,Nathalie Bonnin-Joubert,38132,98233,2022-07-14
CASH_OUT,60210,Nathalie Bonnin-Joubert,98233,38023,Agence_moov_Cotonou,300000,239790,2022-07-14
TRANSFER,18857,Nathalie Bonnin-Joubert,38023,19166,Nathalie Bonnin-Joubert,38023,19166,2022-07-15
CASH_OUT,8297,Nathalie Bonnin-Joubert,19166,10869,Agence_moov_Cotonou,300000,291703,2022-07-17
TRANSFER,1062,Nathalie Bonnin-Joubert,10869,9807,Nathalie Bonnin-Joubert,10869,11931,2022-07-18
CASH_IN,231462,Agence_moov_Abomey,300000,68538,Nathalie Bonnin-Joubert,9807,241269,2022-07-21
CASH_OUT,26143,Nathalie Bonnin-Joubert,241269,215126,Agence_moov_Cotonou,300000,273857,2022-07-21
CASH_OUT,19317,Nathalie Bonnin-Joubert,215126,195809,Agence_moov_Cotonou,300000,280683,2022-07-25
CASH_IN,172852,Agence_moov_Ouidah,300000,127148,Nathalie Bonnin-Joubert,195809,368661,2022-07-25
CASH_OUT,301264,Nathalie Bonnin-Joubert,368661,67397,Agence_moov_Abomey,300000,-1264,2022-07-25
CASH_IN,164598,Agence_moov_Ouidah,300000,135402,Clémence-Véronique Munoz,-17751,146847,2022-07-01
TRANSFER,77123,Clémence-Véronique Munoz,146847,69724,Clémence-Véronique Munoz,146847,223970,2022-07-03
TRANSFER,65807,Clémence-Véronique Munoz,69724,3917,Clémence-Véronique Munoz,69724,3917,2022-07-03
CASH_OUT,1719,Clémence-Véronique Munoz,3917,2198,Agence_moov_Abomey,300000,298281,2022-07-09
CASH_OUT,638,Clémence-Véronique Munoz,2198,1560,Agence_moov_Abomey,300000,299362,2022-07-26
CASH_IN,153468,Agence_moov_Cotonou,300000,146532,Mathilde de la Samson,-79776,73692,2022-07-04
CASH_OUT,71217,Mathilde de la Samson,73692,2475,Agence_moov_Cotonou,300000,228783,2022-07-06
TRANSFER,2023,Mathilde de la Samson,2475,452,Mathilde de la Samson,2475,4498,2022-07-07
TRANSFER,175,Mathilde de la Samson,452,277,Mathilde de la Samson,452,277,2022-07-07
CASH_OUT,113,Mathilde de la Samson,277,164,Agence_moov_Cotonou,300000,299887,2022-07-09
TRANSFER,100,Mathilde de la Samson,164,64,Mathilde de la Samson,164,264,2022-07-09
CASH_IN,46473,Agence_moov_Ouidah,300000,253527,Mathilde de la Samson,64,46537,2022-07-10
CASH_OUT,19503,Mathilde de la Samson,46537,27034,Agence_moov_Cotonou,300000,280497,2022-07-10
CASH_OUT,20666,Mathilde de la Samson,27034,6368,Agence_moov_Abomey,300000,279334,2022-07-12
CASH_IN,141115,Agence_moov_Ouidah,300000,158885,Mathilde de la Samson,6368,147483,2022-07-13
CASH_IN,203130,Agence_moov_Abomey,300000,96870,Mathilde de la Samson,147483,350613,2022-07-18
CASH_IN,179529,Agence_moov_Cotonou,300000,120471,Mathilde de la Samson,350613,530142,2022-07-18
CASH_IN,205356,Agence_moov_Ouidah,300000,94644,Mathilde de la Samson,530142,735498,2022-07-18
CASH_IN,290948,Agence_moov_Ouidah,300000,9052,Mathilde de la Samson,735498,1026446,2022-07-19
CASH_IN,280359,Agence_moov_Cotonou,300000,19641,Mathilde de la Samson,1026446,1306805,2022-07-21
CASH_IN,119398,Agence_moov_Cotonou,300000,180602,Mathilde de la Samson,1306805,1426203,2022-07-24
CASH_IN,280362,Agence_moov_Cotonou,300000,19638,Mathilde de la Samson,1426203,1706565,2022-07-26
CASH_OUT,318295,Rémy Grondin,383000,64705,Agence_moov_Ouidah,300000,-18295,2022-08-24
TRANSFER,16058,Rémy Grondin,64705,48647,Thomas-Robert Morvan,543000,526942,2022-08-27
TRANSFER,753322,Philippe Philippe,1201600,448278,Manon Lebon,98100,-655222,2022-08-06
CASH_IN,111380,Agence_moov_Cotonou,300000,188620,Philippe Philippe,448278,559658,2022-08-26
CASH_OUT,417537,Tristan Bousquet-Gros,436900,19363,Agence_moov_Ouidah,300000,-117537,2022-08-10
TRANSFER,6130,Vincent Joubert,37200,31070,Anastasie Richard-Neveu,924800,930930,2022-08-05
TRANSFER,104245,Manon Chevalier,1648000,1543755,Anastasie Richard-Neveu,930930,1035175,2022-08-24
CASH_IN,199703,Agence_moov_Abomey,300000,100297,Anastasie Richard-Neveu,1035175,1234878,2022-08-24
TRANSFER,1261258,Michel Bouchet,1444500,183242,Audrey Julien de Leleu,33700,1294958,2022-08-06
CASH_OUT,558862,Audrey Julien de Leleu,1294958,736096,Agence_moov_Ouidah,300000,-258862,2022-08-17
TRANSFER,39939,Audrey Julien de Leleu,736096,696157,Françoise Morin,934600,894661,2022-08-20
CASH_IN,251449,Agence_moov_Abomey,300000,48551,Audrey Julien de Leleu,696157,947606,2022-08-27
TRANSFER,592611,Richard Le Lévêque,1520500,927889,Thérèse Hubert,1517500,924889,2022-08-20
CASH_IN,274865,Agence_moov_Abomey,300000,25135,Thomas Guichard du Renault,1109500,1384365,2022-08-17
CASH_IN,71093,Agence_moov_Abomey,300000,228907,Tristan Delahaye,1526100,1597193,2022-08-01
CASH_IN,171579,Agence_moov_Ouidah,300000,128421,Tristan Delahaye,1597193,1768772,2022-08-09
CASH_OUT,33730,Tristan Delahaye,1768772,1735042,Agence_moov_Cotonou,300000,266270,2022-08-25
CASH_IN,175254,Agence_moov_Ouidah,300000,124746,Tristan Delahaye,1735042,1910296,2022-08-27
TRANSFER,457095,Émile-René Baudry,803500,346405,Vincent de la Dumont,1535200,1078105,2022-08-02
CASH_OUT,297465,Émile-René Baudry,346405,48940,Agence_moov_Ouidah,300000,2535,2022-08-06
CASH_OUT,29703,Émile-René Baudry,48940,19237,Agence_moov_Ouidah,300000,270297,2022-08-13
CASH_OUT,36452,Matthieu-Matthieu Bigot,957900,921448,Agence_moov_Abomey,300000,263548,2022-08-13
CASH_OUT,624556,Matthieu-Matthieu Bigot,921448,296892,Agence_moov_Ouidah,300000,-324556,2022-08-14
CASH_IN,19363,Agence_moov_Abomey,300000,280637,Matthieu-Matthieu Bigot,296892,316255,2022-08-15
CASH_IN,76710,Agence_moov_Ouidah,300000,223290,Matthieu-Matthieu Bigot,316255,392965,2022-08-20
CASH_IN,298970,Agence_moov_Abomey,300000,1030,Matthieu-Matthieu Bigot,392965,691935,2022-08-25
CASH_OUT,510267,Nath Loiseau,581800,71533,Agence_moov_Ouidah,300000,-210267,2022-08-02
CASH_IN,285584,Agence_moov_Cotonou,300000,14416,Nath Loiseau,71533,357117,2022-08-07
CASH_OUT,11850,Nath Loiseau,357117,345267,Agence_moov_Abomey,300000,288150,2022-08-13
CASH_IN,207470,Agence_moov_Abomey,300000,92530,Nath Loiseau,345267,552737,2022-08-17
TRANSFER,440030,Nath Loiseau,552737,112707,Jules-Roland Bousquet,314300,-125730,2022-08-25
TRANSFER,1042643,Alphonse Joly,1860400,817757,Théodore Joseph-Lefebvre,613800,1656443,2022-08-12
TRANSFER,395897,Théodore Joseph-Lefebvre,1656443,1260546,Andrée-Thérèse Mendès,1010400,614503,2022-08-27
CASH_OUT,176132,Aimé Pages,258000,81868,Agence_moov_Cotonou,300000,123868,2022-08-14
CASH_IN,243325,Agence_moov_Ouidah,300000,56675,Aimé Pages,81868,325193,2022-08-19
CASH_IN,232429,Agence_moov_Ouidah,300000,67571,Gérard de la Martinez,237400,469829,2022-08-08
CASH_OUT,267549,Gérard de la Martinez,469829,202280,Agence_moov_Ouidah,300000,32451,2022-08-11
CASH_IN,274238,Agence_moov_Cotonou,300000,25762,Gérard de la Martinez,202280,476518,2022-08-11
TRANSFER,20780,Michelle Samson,97800,77020,Gérard de la Martinez,476518,497298,2022-08-18
CASH_OUT,332138,Gérard de la Martinez,497298,165160,Agence_moov_Cotonou,300000,-32138,2022-08-26
CASH_IN,251463,Agence_moov_Cotonou,300000,48537,Bernard Maurice,666500,917963,2022-08-01
CASH_IN,211874,Agence_moov_Cotonou,300000,88126,Bernard Maurice,917963,1129837,2022-08-25
CASH_OUT,609556,Constance Guillon,1462700,853144,Agence_moov_Cotonou,300000,-309556,2022-08-03
CASH_OUT,787083,Constance Guillon,853144,66061,Agence_moov_Ouidah,300000,-487083,2022-08-11
CASH_OUT,22732,Constance Guillon,66061,43329,Agence_moov_Cotonou,300000,277268,2022-08-18
CASH_OUT,19828,Constance Guillon,43329,23501,Agence_moov_Cotonou,300000,280172,2022-08-26
TRANSFER,422964,Maggie Martinez,1076100,653136,Bertrand Regnier,1456400,1879364,2022-08-10
CASH_IN,195689,Agence_moov_Ouidah,300000,104311,Céline Collin-Hervé,994100,1189789,2022-08-03
CASH_IN,298588,Agence_moov_Abomey,300000,1412,Céline Collin-Hervé,1189789,1488377,2022-08-07
CASH_IN,216541,Agence_moov_Ouidah,300000,83459,Céline Collin-Hervé,1488377,1704918,2022-08-16
CASH_OUT,890824,Céline Collin-Hervé,1704918,814094,Agence_moov_Cotonou,300000,-590824,2022-08-17
CASH_OUT,87856,Céline Collin-Hervé,814094,726238,Agence_moov_Cotonou,300000,212144,2022-08-25
TRANSFER,466394,Manon Valette,867000,400606,Thibaut de la Roy,203800,670194,2022-08-08
CASH_IN,283218,Agence_moov_Cotonou,300000,16782,Thibaut de la Roy,670194,953412,2022-08-11
CASH_OUT,141117,Thibaut de la Roy,953412,812295,Agence_moov_Cotonou,300000,158883,2022-08-12
TRANSFER,342609,Thibaut de la Roy,812295,469686,Tristan Gomez,1540800,1198191,2022-08-14
CASH_IN,287488,Agence_moov_Ouidah,300000,12512,Thibaut de la Roy,469686,757174,2022-08-17
TRANSFER,619580,Michelle-Dorothée Lévêque,668200,48620,Alphonse Joly,817757,198177,2022-08-03
TRANSFER,22894,Michelle-Dorothée Lévêque,48620,25726,Thérèse François,457700,434806,2022-08-05
CASH_IN,207317,Agence_moov_Abomey,300000,92683,Michelle-Dorothée Lévêque,25726,233043,2022-08-05
CASH_OUT,223268,Michelle-Dorothée Lévêque,233043,9775,Agence_moov_Cotonou,300000,76732,2022-08-14
CASH_OUT,451781,Robert Clerc,696600,244819,Agence_moov_Abomey,300000,-151781,2022-08-06
CASH_IN,256484,Agence_moov_Ouidah,300000,43516,Robert Clerc,244819,501303,2022-08-11
CASH_IN,271949,Agence_moov_Abomey,300000,28051,Robert Clerc,501303,773252,2022-08-17
CASH_IN,175486,Agence_moov_Cotonou,300000,124514,Robert Clerc,773252,948738,2022-08-19
CASH_OUT,372363,Thibaut de la Lombard,633800,261437,Agence_moov_Cotonou,300000,-72363,2022-08-07
CASH_OUT,111259,Thibaut de la Lombard,261437,150178,Agence_moov_Abomey,300000,188741,2022-08-11
TRANSFER,954610,Bernadette de Jourdan,1327000,372390,Thibaut de la Lombard,150178,1104788,2022-08-12
CASH_OUT,576076,Thibaut de la Lombard,1104788,528712,Agence_moov_Abomey,300000,-276076,2022-08-22
CASH_OUT,260547,Timothée-René Blanchard,1012800,752253,Agence_moov_Ouidah,300000,39453,2022-08-05
TRANSFER,617300,Timothée-René Blanchard,752253,134953,Victor Michel,1613300,996000,2022-08-17
CASH_IN,117832,Agence_moov_Cotonou,300000,182168,Clémence-Véronique Munoz,1353100,1470932,2022-08-02
CASH_OUT,812517,Clémence-Véronique Munoz,1470932,658415,Agence_moov_Abomey,300000,-512517,2022-08-03
TRANSFER,94214,Martine Aubert,622200,527986,Clémence-Véronique Munoz,658415,752629,2022-08-05
TRANSFER,319198,Adèle Da Silva-Klein,344700,25502,Clémence-Véronique Munoz,752629,1071827,2022-08-06
CASH_IN,215014,Agence_moov_Abomey,300000,84986,Clémence-Véronique Munoz,1071827,1286841,2022-08-07
TRANSFER,706238,Clémence-Véronique Munoz,1286841,580603,Manon Chevalier,1543755,837517,2022-08-07
TRANSFER,561106,Clémence-Véronique Munoz,580603,19497,Thomas Dupont,1281100,719994,2022-08-09
CASH_OUT,3567,Clémence-Véronique Munoz,19497,15930,Agence_moov_Cotonou,300000,296433,2022-08-09
CASH_OUT,10868,Clémence-Véronique Munoz,15930,5062,Agence_moov_Cotonou,300000,289132,2022-08-09
CASH_OUT,2453,Clémence-Véronique Munoz,5062,2609,Agence_moov_Ouidah,300000,297547,2022-08-10
CASH_OUT,2376,Clémence-Véronique Munoz,2609,233,Agence_moov_Abomey,300000,297624,2022-08-11
TRANSFER,588168,Michelle de Étienne,959800,371632,Clémence-Véronique Munoz,233,588401,2022-08-12
CASH_OUT,283657,Clémence-Véronique Munoz,588401,304744,Agence_moov_Abomey,300000,16343,2022-08-12
CASH_OUT,291805,Clémence-Véronique Munoz,304744,12939,Agence_moov_Ouidah,300000,8195,2022-08-12
TRANSFER,6594,Clémence-Véronique Munoz,12939,6345,Paul Rocher-Maillet,735500,728906,2022-08-12
CASH_IN,265555,Agence_moov_Ouidah,300000,34445,Clémence-Véronique Munoz,6345,271900,2022-08-15
TRANSFER,189505,Marthe Gilles,646000,456495,Clémence-Véronique Munoz,271900,461405,2022-08-17
CASH_OUT,344132,Clémence-Véronique Munoz,461405,117273,Agence_moov_Cotonou,300000,-44132,2022-08-17
TRANSFER,411736,Camille Morvan,1486900,1075164,Clémence-Véronique Munoz,117273,529009,2022-08-17
CASH_OUT,299276,Clémence-Véronique Munoz,529009,229733,Agence_moov_Ouidah,300000,724,2022-08-18
CASH_OUT,147680,Clémence-Véronique Munoz,229733,82053,Agence_moov_Abomey,300000,152320,2022-08-19
TRANSFER,403972,Marthe Gilles,456495,52523,Clémence-Véronique Munoz,82053,486025,2022-08-19
CASH_OUT,137944,Clémence-Véronique Munoz,486025,348081,Agence_moov_Abomey,300000,162056,2022-08-19
TRANSFER,41669,Clémence-Véronique Munoz,348081,306412,Raymond Lévy,1313600,1271931,2022-08-20
TRANSFER,237174,Michelle de Étienne,371632,134458,Clémence-Véronique Munoz,306412,543586,2022-08-21
CASH_IN,67406,Agence_moov_Ouidah,300000,232594,Clémence-Véronique Munoz,543586,610992,2022-08-24
CASH_OUT,305492,Clémence-Véronique Munoz,610992,305500,Agence_moov_Cotonou,300000,-5492,2022-08-25
CASH_OUT,1140436,Frédérique Fernandes du Bouchet,1351000,210564,Agence_moov_Abomey,300000,-840436,2022-08-01
CASH_IN,146348,Agence_moov_Cotonou,300000,153652,Frédérique Fernandes du Bouchet,210564,356912,2022-08-08
CASH_OUT,90300,Frédérique Fernandes du Bouchet,356912,266612,Agence_moov_Abomey,300000,209700,2022-08-08
CASH_IN,198050,Agence_moov_Ouidah,300000,101950,Frédérique Fernandes du Bouchet,266612,464662,2022-08-08
TRANSFER,33107,Frédérique Fernandes du Bouchet,464662,431555,Paul Rocher-Maillet,728906,695799,2022-08-08
CASH_OUT,254387,Frédérique Fernandes du Bouchet,431555,177168,Agence_moov_Abomey,300000,45613,2022-08-09
TRANSFER,13929,Marthe Gilles,52523,38594,Frédérique Fernandes du Bouchet,177168,191097,2022-08-09
CASH_IN,104276,Agence_moov_Cotonou,300000,195724,Frédérique Fernandes du Bouchet,191097,295373,2022-08-09
CASH_OUT,175073,Frédérique Fernandes du Bouchet,295373,120300,Agence_moov_Ouidah,300000,124927,2022-08-10
CASH_OUT,93017,Frédérique Fernandes du Bouchet,120300,27283,Agence_moov_Cotonou,300000,206983,2022-08-11
CASH_IN,107856,Agence_moov_Cotonou,300000,192144,Frédérique Fernandes du Bouchet,27283,135139,2022-08-13
TRANSFER,15823,Frédérique Fernandes du Bouchet,135139,119316,Camille Prévost,1784600,1768777,2022-08-13
TRANSFER,692,Frédérique Fernandes du Bouchet,119316,118624,Adèle Da Silva-Klein,25502,24810,2022-08-15
CASH_IN,126424,Agence_moov_Ouidah,300000,173576,Frédérique Fernandes du Bouchet,118624,245048,2022-08-15
CASH_IN,96018,Agence_moov_Cotonou,300000,203982,Frédérique Fernandes du Bouchet,245048,341066,2022-08-16
CASH_OUT,56499,Frédérique Fernandes du Bouchet,341066,284567,Agence_moov_Ouidah,300000,243501,2022-08-17
TRANSFER,187936,Frédérique Fernandes du Bouchet,284567,96631,Astrid Lecoq,1872600,1684664,2022-08-18
CASH_IN,169787,Agence_moov_Abomey,300000,130213,Frédérique Fernandes du Bouchet,96631,266418,2022-08-19
TRANSFER,132332,Frédérique Fernandes du Bouchet,266418,134086,Camille Morvan,1075164,942832,2022-08-22
TRANSFER,877524,Camille Morvan,942832,65308,Frédérique Fernandes du Bouchet,134086,1011610,2022-08-22
CASH_IN,81201,Agence_moov_Abomey,300000,218799,Frédérique Fernandes du Bouchet,1011610,1092811,2022-08-22
CASH_OUT,47259,Frédérique Fernandes du Bouchet,1092811,1045552,Agence_moov_Ouidah,300000,252741,2022-08-23
CASH_OUT,253751,Frédérique Fernandes du Bouchet,1045552,791801,Agence_moov_Abomey,300000,46249,2022-08-24
TRANSFER,259033,Frédérique Fernandes du Bouchet,791801,532768,Alphonse Joly,198177,-60856,2022-08-25
CASH_IN,280365,Agence_moov_Cotonou,300000,19635,Frédérique Fernandes du Bouchet,532768,813133,2022-08-26
CASH_OUT,578165,Frédérique Fernandes du Bouchet,813133,234968,Agence_moov_Cotonou,300000,-278165,2022-08-27
TRANSFER,163705,Frédérique Fernandes du Bouchet,234968,71263,Constance Bourdon-Millet,6400,-157305,2022-08-27
CASH_IN,288035,Agence_moov_Abomey,300000,11965,Frédérique Fernandes du Bouchet,71263,359298,2022-08-27
CASH_IN,101113,Agence_moov_Ouidah,300000,198887,Thomas de Blin,735400,836513,2022-08-01
CASH_OUT,788780,Thomas de Blin,836513,47733,Agence_moov_Cotonou,300000,-488780,2022-08-02
CASH_OUT,8059,Thomas de Blin,47733,39674,Agence_moov_Cotonou,300000,291941,2022-08-03
TRANSFER,7978,Thomas de Blin,39674,31696,Léon Da Costa,1763200,1755222,2022-08-04
TRANSFER,384228,Manon Valette,400606,16378,Thomas de Blin,31696,415924,2022-08-05
CASH_OUT,310463,Thomas de Blin,415924,105461,Agence_moov_Ouidah,300000,-10463,2022-08-05
CASH_IN,100876,Agence_moov_Abomey,300000,199124,Thomas de Blin,105461,206337,2022-08-06
CASH_IN,78671,Agence_moov_Ouidah,300000,221329,Thomas de Blin,206337,285008,2022-08-08
CASH_IN,87957,Agence_moov_Ouidah,300000,212043,Thomas de Blin,285008,372965,2022-08-08
CASH_OUT,148691,Thomas de Blin,372965,224274,Agence_moov_Abomey,300000,151309,2022-08-11
CASH_IN,248528,Agence_moov_Ouidah,300000,51472,Thomas de Blin,224274,472802,2022-08-11
TRANSFER,109232,Hélène Le Chauvin,428200,318968,Thomas de Blin,472802,582034,2022-08-12
TRANSFER,524117,Thomas de Blin,582034,57917,Bernadette de Jourdan,372390,-151727,2022-08-12
CASH_IN,190728,Agence_moov_Abomey,300000,109272,Thomas de Blin,57917,248645,2022-08-13
TRANSFER,108359,Thomas de Blin,248645,140286,Nicolas Salmon Le Hamon,318800,210441,2022-08-15
CASH_IN,242820,Agence_moov_Cotonou,300000,57180,Thomas de Blin,140286,383106,2022-08-16
TRANSFER,154551,Thomas de Blin,383106,228555,Mathilde Picard du Delmas,367000,212449,2022-08-18
CASH_IN,222442,Agence_moov_Ouidah,300000,77558,Thomas de Blin,228555,450997,2022-08-20
CASH_IN,24003,Agence_moov_Ouidah,300000,275997,Thomas de Blin,450997,475000,2022-08-21
CASH_OUT,55849,Thomas de Blin,475000,419151,Agence_moov_Ouidah,300000,244151,2022-08-21
CASH_IN,35273,Agence_moov_Ouidah,300000,264727,Thomas de Blin,419151,454424,2022-08-24
CASH_OUT,150344,Thomas de Blin,454424,304080,Agence_moov_Ouidah,300000,149656,2022-08-24
CASH_IN,11631,Agence_moov_Abomey,300000,288369,Thomas de Blin,304080,315711,2022-08-25
CASH_OUT,31038,Thomas de Blin,315711,284673,Agence_moov_Cotonou,300000,268962,2022-08-26
TRANSFER,444970,Véronique Martins de Fleury,907200,462230,Thomas de Blin,284673,729643,2022-08-26
TRANSFER,166675,Thomas de Blin,729643,562968,Paul Rocher-Maillet,695799,529124,2022-08-26
CASH_IN,115659,Agence_moov_Cotonou,300000,184341,Thomas de Blin,562968,678627,2022-08-26
CASH_OUT,182072,Thomas de Blin,678627,496555,Agence_moov_Abomey,300000,117928,2022-08-27
TRANSFER,403243,Thomas de Blin,496555,93312,Émilie du Allain,1376400,973157,2022-08-27
CASH_OUT,370956,Victor Michel,996000,625044,Agence_moov_Ouidah,300000,-70956,2022-08-01
CASH_OUT,489370,Victor Michel,625044,135674,Agence_moov_Cotonou,300000,-189370,2022-08-02
TRANSFER,3637,Victor Michel,135674,132037,Paul Perez,1718200,1714563,2022-08-02
CASH_IN,61688,Agence_moov_Ouidah,300000,238312,Victor Michel,132037,193725,2022-08-04
TRANSFER,42440,Victor Michel,193725,151285,Nathalie Bonnin-Joubert,1867100,1824660,2022-08-05
TRANSFER,34168,Christine Texier,451200,417032,Victor Michel,151285,185453,2022-08-07
TRANSFER,39173,Victor Michel,185453,146280,Renée Le Diaz,244300,205127,2022-08-07
TRANSFER,131106,Victor Michel,146280,15174,Colette-Sophie Prévost,750700,619594,2022-08-08
CASH_OUT,10536,Victor Michel,15174,4638,Agence_moov_Ouidah,300000,289464,2022-08-08
CASH_OUT,2582,Victor Michel,4638,2056,Agence_moov_Abomey,300000,297418,2022-08-09
TRANSFER,210520,Thomas-Robert Morvan,526942,316422,Victor Michel,2056,212576,2022-08-09
TRANSFER,133966,Victor Michel,212576,78610,Martine Aubert,527986,394020,2022-08-15
CASH_OUT,2268,Victor Michel,78610,76342,Agence_moov_Ouidah,300000,297732,2022-08-15
TRANSFER,389394,Anne Peltier-Raynaud,812000,422606,Victor Michel,76342,465736,2022-08-17
CASH_OUT,351577,Victor Michel,465736,114159,Agence_moov_Abomey,300000,-51577,2022-08-18
CASH_IN,60840,Agence_moov_Cotonou,300000,239160,Victor Michel,114159,174999,2022-08-20
CASH_IN,163919,Agence_moov_Ouidah,300000,136081,Victor Michel,174999,338918,2022-08-23
TRANSFER,65684,Michel Bouchet,183242,117558,Victor Michel,338918,404602,2022-08-23
CASH_OUT,152891,Victor Michel,404602,251711,Agence_moov_Cotonou,300000,147109,2022-08-24
CASH_IN,59084,Agence_moov_Cotonou,300000,240916,Victor Michel,251711,310795,2022-08-25
TRANSFER,178495,Luc Lévêque-Carre,232500,54005,Victor Michel,310795,489290,2022-08-26
TRANSFER,326953,Paul Rocher-Maillet,529124,202171,Victor Michel,489290,816243,2022-08-26
CASH_IN,18264,Agence_moov_Cotonou,300000,281736,Astrid Lecoq,1684664,1702928,2022-08-02
CASH_IN,98149,Agence_moov_Abomey,300000,201851,Astrid Lecoq,1702928,1801077,2022-08-02
TRANSFER,539785,Astrid Lecoq,1801077,1261292,Anne Peltier-Raynaud,422606,-117179,2022-08-02
CASH_IN,66581,Agence_moov_Cotonou,300000,233419,Astrid Lecoq,1261292,1327873,2022-08-03
CASH_IN,242155,Agence_moov_Cotonou,300000,57845,Astrid Lecoq,1327873,1570028,2022-08-03
CASH_OUT,1131578,Astrid Lecoq,1570028,438450,Agence_moov_Abomey,300000,-831578,2022-08-05
CASH_OUT,343051,Astrid Lecoq,438450,95399,Agence_moov_Ouidah,300000,-43051,2022-08-05
CASH_OUT,93806,Astrid Lecoq,95399,1593,Agence_moov_Cotonou,300000,206194,2022-08-07
TRANSFER,1097,Astrid Lecoq,1593,496,Thérèse Hubert,924889,923792,2022-08-09
CASH_OUT,146,Astrid Lecoq,496,350,Agence_moov_Ouidah,300000,299854,2022-08-11
TRANSFER,1670822,Richard Michel,1909200,238378,Astrid Lecoq,350,1671172,2022-08-12
CASH_OUT,288795,Astrid Lecoq,1671172,1382377,Agence_moov_Ouidah,300000,11205,2022-08-12
CASH_IN,203603,Agence_moov_Ouidah,300000,96397,Astrid Lecoq,1382377,1585980,2022-08-12
TRANSFER,9505,Manon Valette,16378,6873,Astrid Lecoq,1585980,1595485,2022-08-12
TRANSFER,427,Manon Valette,6873,6446,Astrid Lecoq,1595485,1595912,2022-08-13
CASH_OUT,1290238,Astrid Lecoq,1595912,305674,Agence_moov_Abomey,300000,-990238,2022-08-15
CASH_IN,47202,Agence_moov_Cotonou,300000,252798,Astrid Lecoq,305674,352876,2022-08-15
CASH_IN,28951,Agence_moov_Ouidah,300000,271049,Astrid Lecoq,352876,381827,2022-08-15
CASH_IN,96494,Agence_moov_Ouidah,300000,203506,Astrid Lecoq,381827,478321,2022-08-15
CASH_IN,52666,Agence_moov_Ouidah,300000,247334,Astrid Lecoq,478321,530987,2022-08-21
CASH_OUT,64948,Astrid Lecoq,530987,466039,Agence_moov_Ouidah,300000,235052,2022-08-21
TRANSFER,313805,Astrid Lecoq,466039,152234,Nathalie Bonnin-Joubert,1824660,1510855,2022-08-21
CASH_OUT,10932,Astrid Lecoq,152234,141302,Agence_moov_Cotonou,300000,289068,2022-08-22
CASH_IN,241177,Agence_moov_Abomey,300000,58823,Astrid Lecoq,141302,382479,2022-08-22
CASH_OUT,64484,Astrid Lecoq,382479,317995,Agence_moov_Cotonou,300000,235516,2022-08-22
TRANSFER,101977,Astrid Lecoq,317995,216018,Camille Morvan,65308,-36669,2022-08-22
TRANSFER,467059,Emmanuel Grégoire,890100,423041,Astrid Lecoq,216018,683077,2022-08-25
CASH_OUT,335100,Astrid Lecoq,683077,347977,Agence_moov_Ouidah,300000,-35100,2022-08-26
TRANSFER,891523,Nathalie Bonnin-Joubert,1510855,619332,Astrid Lecoq,347977,1239500,2022-08-27
CASH_IN,89867,Agence_moov_Cotonou,300000,210133,Paulette Loiseau,1261200,1351067,2022-08-01
CASH_OUT,709211,Paulette Loiseau,1351067,641856,Agence_moov_Cotonou,300000,-409211,2022-08-05
CASH_OUT,116650,Paulette Loiseau,641856,525206,Agence_moov_Abomey,300000,183350,2022-08-06
TRANSFER,1653471,Paul Perez,1714563,61092,Paulette Loiseau,525206,2178677,2022-08-07
CASH_IN,106240,Agence_moov_Cotonou,300000,193760,Paulette Loiseau,2178677,2284917,2022-08-08
TRANSFER,16926,Vincent Joubert,31070,14144,Paulette Loiseau,2284917,2301843,2022-08-09
CASH_OUT,1472683,Paulette Loiseau,2301843,829160,Agence_moov_Abomey,300000,-1172683,2022-08-09
CASH_OUT,256265,Paulette Loiseau,829160,572895,Agence_moov_Abomey,300000,43735,2022-08-09
TRANSFER,171105,Paulette Loiseau,572895,401790,Robert-Louis Gosselin,772000,600895,2022-08-10
TRANSFER,162766,Paulette Loiseau,401790,239024,Nicolas Salmon Le Hamon,210441,47675,2022-08-10
TRANSFER,256128,Christine Texier,417032,160904,Paulette Loiseau,239024,495152,2022-08-11
TRANSFER,338724,Paulette Loiseau,495152,156428,Christine Texier,160904,-177820,2022-08-12
CASH_IN,277397,Agence_moov_Cotonou,300000,22603,Paulette Loiseau,156428,433825,2022-08-15
CASH_OUT,397502,Paulette Loiseau,433825,36323,Agence_moov_Cotonou,300000,-97502,2022-08-17
TRANSFER,16612,Paulette Loiseau,36323,19711,Vincent Joubert,14144,-2468,2022-08-19
TRANSFER,6043,Paulette Loiseau,19711,13668,Frédéric Guillou,1668500,1662457,2022-08-21
TRANSFER,3821,Paulette Loiseau,13668,9847,Mathilde de la Samson,1569000,1565179,2022-08-22
TRANSFER,169721,Hélène Le Chauvin,318968,149247,Paulette Loiseau,9847,179568,2022-08-23
CASH_OUT,8281,Paulette Loiseau,179568,171287,Agence_moov_Abomey,300000,291719,2022-08-23
TRANSFER,18047,Paulette Loiseau,171287,153240,Luc Lévêque-Carre,54005,35958,2022-08-24
CASH_IN,182194,Agence_moov_Abomey,300000,117806,Paulette Loiseau,153240,335434,2022-08-24
CASH_IN,248786,Agence_moov_Abomey,300000,51214,Paulette Loiseau,335434,584220,2022-08-25
CASH_OUT,223493,Paulette Loiseau,584220,360727,Agence_moov_Ouidah,300000,76507,2022-08-25
CASH_IN,241604,Agence_moov_Ouidah,300000,58396,Paulette Loiseau,360727,602331,2022-08-27
CASH_IN,208561,Agence_moov_Ouidah,300000,91439,Jules-Roland Bousquet,-125730,82831,2022-08-01
CASH_OUT,25635,Jules-Roland Bousquet,82831,57196,Agence_moov_Cotonou,300000,274365,2022-08-01
CASH_IN,241170,Agence_moov_Abomey,300000,58830,Jules-Roland Bousquet,57196,298366,2022-08-03
CASH_IN,220352,Agence_moov_Abomey,300000,79648,Jules-Roland Bousquet,298366,518718,2022-08-04
CASH_OUT,178751,Jules-Roland Bousquet,518718,339967,Agence_moov_Abomey,300000,121249,2022-08-06
TRANSFER,1293,Jules-Roland Bousquet,339967,338674,Aurore Charrier,1951500,1950207,2022-08-07
CASH_OUT,29180,Jules-Roland Bousquet,338674,309494,Agence_moov_Ouidah,300000,270820,2022-08-07
TRANSFER,846813,Jules Fernandes,1363500,516687,Jules-Roland Bousquet,309494,1156307,2022-08-07
CASH_IN,104747,Agence_moov_Abomey,300000,195253,Jules-Roland Bousquet,1156307,1261054,2022-08-08
CASH_IN,4656,Agence_moov_Ouidah,300000,295344,Jules-Roland Bousquet,1261054,1265710,2022-08-08
TRANSFER,1059958,Simone Muller de la Brun,1922400,862442,Jules-Roland Bousquet,1265710,2325668,2022-08-09
TRANSFER,1450025,Jules-Roland Bousquet,2325668,875643,Mathilde Picard du Delmas,212449,-1237576,2022-08-09
CASH_IN,13191,Agence_moov_Abomey,300000,286809,Jules-Roland Bousquet,875643,888834,2022-08-11
CASH_OUT,799277,Jules-Roland Bousquet,888834,89557,Agence_moov_Abomey,300000,-499277,2022-08-12
CASH_OUT,18854,Jules-Roland Bousquet,89557,70703,Agence_moov_Ouidah,300000,281146,2022-08-12
CASH_IN,80651,Agence_moov_Cotonou,300000,219349,Jules-Roland Bousquet,70703,151354,2022-08-13
CASH_OUT,122698,Jules-Roland Bousquet,151354,28656,Agence_moov_Ouidah,300000,177302,2022-08-14
CASH_OUT,21605,Jules-Roland Bousquet,28656,7051,Agence_moov_Cotonou,300000,278395,2022-08-16
CASH_IN,279819,Agence_moov_Ouidah,300000,20181,Jules-Roland Bousquet,7051,286870,2022-08-16
CASH_IN,121580,Agence_moov_Ouidah,300000,178420,Jules-Roland Bousquet,286870,408450,2022-08-17
TRANSFER,46759,Jules-Roland Bousquet,408450,361691,Virginie Bouvet,274600,227841,2022-08-17
CASH_IN,135228,Agence_moov_Ouidah,300000,164772,Jules-Roland Bousquet,361691,496919,2022-08-18
CASH_IN,32728,Agence_moov_Abomey,300000,267272,Jules-Roland Bousquet,496919,529647,2022-08-20
CASH_IN,298737,Agence_moov_Cotonou,300000,1263,Jules-Roland Bousquet,529647,828384,2022-08-21
CASH_IN,231792,Agence_moov_Abomey,300000,68208,Jules-Roland Bousquet,828384,1060176,2022-08-26
TRANSFER,123272,Jules-Roland Bousquet,1060176,936904,Luc Lévêque-Carre,35958,-87314,2022-08-26
TRANSFER,59185,André Renault,583200,524015,Thérèse Hubert,923792,982977,2022-08-02
CASH_OUT,132070,Thérèse Hubert,982977,850907,Agence_moov_Cotonou,300000,167930,2022-08-06
TRANSFER,496665,Thérèse Hubert,850907,354242,Martine Aubert,394020,-102645,2022-08-07
CASH_OUT,352518,Thérèse Hubert,354242,1724,Agence_moov_Abomey,300000,-52518,2022-08-07
TRANSFER,1261,Thérèse Hubert,1724,463,Thomas Dupont,719994,718733,2022-08-08
CASH_OUT,426,Thérèse Hubert,463,37,Agence_moov_Abomey,300000,299574,2022-08-08
CASH_IN,178218,Agence_moov_Abomey,300000,121782,Thérèse Hubert,37,178255,2022-08-10
CASH_OUT,133151,Thérèse Hubert,178255,45104,Agence_moov_Ouidah,300000,166849,2022-08-10
TRANSFER,113113,Paul Rocher-Maillet,202171,89058,Thérèse Hubert,45104,158217,2022-08-11
CASH_IN,77628,Agence_moov_Ouidah,300000,222372,Thérèse Hubert,158217,235845,2022-08-12
CASH_OUT,91137,Thérèse Hubert,235845,144708,Agence_moov_Cotonou,300000,208863,2022-08-13
TRANSFER,31113,Nicolas Salmon Le Hamon,47675,16562,Thérèse Hubert,144708,175821,2022-08-14
TRANSFER,281351,Raymond Lévy,1271931,990580,Thérèse Hubert,175821,457172,2022-08-15
CASH_OUT,69215,Thérèse Hubert,457172,387957,Agence_moov_Cotonou,300000,230785,2022-08-16
CASH_OUT,378981,Thérèse Hubert,387957,8976,Agence_moov_Cotonou,300000,-78981,2022-08-16
CASH_IN,179713,Agence_moov_Cotonou,300000,120287,Thérèse Hubert,8976,188689,2022-08-16
CASH_OUT,100793,Thérèse Hubert,188689,87896,Agence_moov_Cotonou,300000,199207,2022-08-18
CASH_OUT,64179,Thérèse Hubert,87896,23717,Agence_moov_Ouidah,300000,235821,2022-08-20
CASH_OUT,16467,Thérèse Hubert,23717,7250,Agence_moov_Cotonou,300000,283533,2022-08-22
TRANSFER,523,Thérèse Hubert,7250,6727,Émilie du Allain,973157,972634,2022-08-23
CASH_OUT,842,Thérèse Hubert,6727,5885,Agence_moov_Abomey,300000,299158,2022-08-24
CASH_IN,167368,Agence_moov_Ouidah,300000,132632,Aurore Charrier,1950207,2117575,2022-08-01
CASH_OUT,1791463,Aurore Charrier,2117575,326112,Agence_moov_Abomey,300000,-1491463,2022-08-01
CASH_OUT,140317,Aurore Charrier,326112,185795,Agence_moov_Ouidah,300000,159683,2022-08-01
CASH_IN,18788,Agence_moov_Ouidah,300000,281212,Aurore Charrier,185795,204583,2022-08-03
TRANSFER,52669,Robert-Louis Gosselin,600895,548226,Aurore Charrier,204583,257252,2022-08-03
CASH_OUT,153821,Aurore Charrier,257252,103431,Agence_moov_Abomey,300000,146179,2022-08-04
TRANSFER,536800,Lucy Gillet,655400,118600,Aurore Charrier,103431,640231,2022-08-05
CASH_IN,248109,Agence_moov_Ouidah,300000,51891,Aurore Charrier,640231,888340,2022-08-07
CASH_OUT,84286,Aurore Charrier,888340,804054,Agence_moov_Abomey,300000,215714,2022-08-07
TRANSFER,622136,Manon Chevalier,837517,215381,Aurore Charrier,804054,1426190,2022-08-08
CASH_IN,142696,Agence_moov_Ouidah,300000,157304,Aurore Charrier,1426190,1568886,2022-08-09
TRANSFER,383105,Gabriel Bègue,712300,329195,Aurore Charrier,1568886,1951991,2022-08-10
CASH_OUT,449282,Aurore Charrier,1951991,1502709,Agence_moov_Abomey,300000,-149282,2022-08-11
CASH_OUT,422786,Aurore Charrier,1502709,1079923,Agence_moov_Abomey,300000,-122786,2022-08-12
CASH_OUT,215528,Aurore Charrier,1079923,864395,Agence_moov_Abomey,300000,84472,2022-08-15
CASH_OUT,104798,Aurore Charrier,864395,759597,Agence_moov_Cotonou,300000,195202,2022-08-17
TRANSFER,757185,Aurore Charrier,759597,2412,Mathilde de la Samson,1565179,807994,2022-08-18
CASH_IN,224838,Agence_moov_Cotonou,300000,75162,Aurore Charrier,2412,227250,2022-08-18
CASH_IN,243562,Agence_moov_Cotonou,300000,56438,Aurore Charrier,227250,470812,2022-08-18
CASH_OUT,203763,Aurore Charrier,470812,267049,Agence_moov_Abomey,300000,96237,2022-08-22
CASH_IN,231302,Agence_moov_Ouidah,300000,68698,Aurore Charrier,267049,498351,2022-08-24
CASH_OUT,360853,Aurore Charrier,498351,137498,Agence_moov_Cotonou,300000,-60853,2022-08-26
CASH_IN,104306,Agence_moov_Cotonou,300000,195694,Aurore Charrier,137498,241804,2022-08-26
CASH_IN,283809,Agence_moov_Ouidah,300000,16191,Aurore Charrier,241804,525613,2022-08-27
CASH_IN,28989,Agence_moov_Ouidah,300000,271011,Aurore Charrier,525613,554602,2022-08-27
CASH_OUT,519782,Aurore Charrier,554602,34820,Agence_moov_Abomey,300000,-219782,2022-08-27
CASH_OUT,252088,Colette-Sophie Prévost,619594,367506,Agence_moov_Abomey,300000,47912,2022-08-01
CASH_OUT,41663,Colette-Sophie Prévost,367506,325843,Agence_moov_Abomey,300000,258337,2022-08-02
CASH_IN,297817,Agence_moov_Cotonou,300000,2183,Colette-Sophie Prévost,325843,623660,2022-08-02
CASH_IN,42735,Agence_moov_Ouidah,300000,257265,Colette-Sophie Prévost,623660,666395,2022-08-03
TRANSFER,390309,Sabine Pineau,771300,380991,Colette-Sophie Prévost,666395,1056704,2022-08-03
CASH_OUT,391209,Colette-Sophie Prévost,1056704,665495,Agence_moov_Cotonou,300000,-91209,2022-08-05
CASH_OUT,443208,Colette-Sophie Prévost,665495,222287,Agence_moov_Cotonou,300000,-143208,2022-08-06
CASH_IN,133715,Agence_moov_Cotonou,300000,166285,Colette-Sophie Prévost,222287,356002,2022-08-08
TRANSFER,150834,Colette-Sophie Prévost,356002,205168,Nicolas Salmon Le Hamon,16562,-134272,2022-08-08
CASH_IN,91192,Agence_moov_Cotonou,300000,208808,Colette-Sophie Prévost,205168,296360,2022-08-08
TRANSFER,131205,Colette-Sophie Prévost,296360,165155,Lucy Gillet,118600,-12605,2022-08-09
CASH_IN,191400,Agence_moov_Abomey,300000,108600,Colette-Sophie Prévost,165155,356555,2022-08-09
CASH_IN,152881,Agence_moov_Abomey,300000,147119,Colette-Sophie Prévost,356555,509436,2022-08-10
TRANSFER,60729,Colette-Sophie Prévost,509436,448707,Virginie Bouvet,227841,167112,2022-08-11
TRANSFER,298175,Suzanne Bodin,1332300,1034125,Colette-Sophie Prévost,448707,746882,2022-08-11
CASH_IN,120415,Agence_moov_Ouidah,300000,179585,Colette-Sophie Prévost,746882,867297,2022-08-13
CASH_IN,228748,Agence_moov_Abomey,300000,71252,Colette-Sophie Prévost,867297,1096045,2022-08-15
CASH_IN,228737,Agence_moov_Abomey,300000,71263,Colette-Sophie Prévost,1096045,1324782,2022-08-16
CASH_OUT,110347,Colette-Sophie Prévost,1324782,1214435,Agence_moov_Abomey,300000,189653,2022-08-16
CASH_IN,30174,Agence_moov_Cotonou,300000,269826,Colette-Sophie Prévost,1214435,1244609,2022-08-17
CASH_IN,53524,Agence_moov_Cotonou,300000,246476,Colette-Sophie Prévost,1244609,1298133,2022-08-17
CASH_OUT,233757,Colette-Sophie Prévost,1298133,1064376,Agence_moov_Abomey,300000,66243,2022-08-20
TRANSFER,932863,Colette-Sophie Prévost,1064376,131513,Gabriel Bègue,329195,-603668,2022-08-20
TRANSFER,21585,Michelle de Étienne,134458,112873,Colette-Sophie Prévost,131513,153098,2022-08-21
CASH_OUT,73740,Colette-Sophie Prévost,153098,79358,Agence_moov_Cotonou,300000,226260,2022-08-23
CASH_IN,115456,Agence_moov_Cotonou,300000,184544,Colette-Sophie Prévost,79358,194814,2022-08-25
TRANSFER,185212,Jules Fernandes,516687,331475,Colette-Sophie Prévost,194814,380026,2022-08-25
CASH_IN,129224,Agence_moov_Ouidah,300000,170776,Colette-Sophie Prévost,380026,509250,2022-08-26
CASH_IN,171707,Agence_moov_Abomey,300000,128293,Colette-Sophie Prévost,509250,680957,2022-08-27
CASH_IN,78774,Agence_moov_Abomey,300000,221226,Colette-Sophie Prévost,680957,759731,2022-08-27
CASH_IN,209156,Agence_moov_Ouidah,300000,90844,Camille Prévost,1768777,1977933,2022-08-01
TRANSFER,129617,Virginie Bouvet,167112,37495,Camille Prévost,1977933,2107550,2022-08-03
TRANSFER,634378,Benoît Guyot,685300,50922,Camille Prévost,2107550,2741928,2022-08-03
TRANSFER,196485,André Renault,524015,327530,Camille Prévost,2741928,2938413,2022-08-04
CASH_OUT,1403925,Camille Prévost,2938413,1534488,Agence_moov_Ouidah,300000,-1103925,2022-08-04
CASH_IN,199383,Agence_moov_Abomey,300000,100617,Camille Prévost,1534488,1733871,2022-08-05
CASH_OUT,127093,Camille Prévost,1733871,1606778,Agence_moov_Cotonou,300000,172907,2022-08-08
CASH_IN,26444,Agence_moov_Abomey,300000,273556,Camille Prévost,1606778,1633222,2022-08-08
TRANSFER,41145,Benoît Guyot,50922,9777,Camille Prévost,1633222,1674367,2022-08-10
CASH_OUT,1003165,Camille Prévost,1674367,671202,Agence_moov_Cotonou,300000,-703165,2022-08-11
TRANSFER,164215,André Renault,327530,163315,Camille Prévost,671202,835417,2022-08-12
CASH_OUT,246172,Camille Prévost,835417,589245,Agence_moov_Ouidah,300000,53828,2022-08-17
CASH_IN,25439,Agence_moov_Ouidah,300000,274561,Camille Prévost,589245,614684,2022-08-17
CASH_OUT,582885,Camille Prévost,614684,31799,Agence_moov_Ouidah,300000,-282885,2022-08-19
TRANSFER,6115,Camille Prévost,31799,25684,Véronique Martins de Fleury,462230,456115,2022-08-21
TRANSFER,25463,Camille Prévost,25684,221,Michelle Samson,77020,51557,2022-08-22
TRANSFER,175,Camille Prévost,221,46,Hélène Le Chauvin,149247,149072,2022-08-23
CASH_IN,222516,Agence_moov_Abomey,300000,77484,Camille Prévost,46,222562,2022-08-24
TRANSFER,32050,Thomas-Robert Morvan,316422,284372,Camille Prévost,222562,254612,2022-08-24
TRANSFER,35678,Camille Prévost,254612,218934,Vincent de la Dumont,1078105,1042427,2022-08-26
CASH_OUT,77858,Camille Prévost,218934,141076,Agence_moov_Ouidah,300000,222142,2022-08-26
TRANSFER,75306,Camille Prévost,141076,65770,Lucie Aubert,202900,127594,2022-08-27
CASH_IN,135458,Agence_moov_Cotonou,300000,164542,Gabriel Bègue,-603668,-468210,2022-08-02
CASH_IN,9018,Agence_moov_Abomey,300000,290982,Gabriel Bègue,-468210,-459192,2022-08-02
CASH_IN,229303,Agence_moov_Abomey,300000,70697,Gabriel Bègue,-459192,-229889,2022-08-07
CASH_IN,161037,Agence_moov_Abomey,300000,138963,Gabriel Bègue,-229889,-68852,2022-08-07
CASH_IN,67648,Agence_moov_Abomey,300000,232352,Gabriel Bègue,-68852,-1204,2022-08-08
CASH_IN,102162,Agence_moov_Cotonou,300000,197838,Gabriel Bègue,-1204,100958,2022-08-09
TRANSFER,33580,Agnès Le Giraud,42900,9320,Gabriel Bègue,100958,134538,2022-08-10
CASH_IN,138969,Agence_moov_Ouidah,300000,161031,Gabriel Bègue,134538,273507,2022-08-12
TRANSFER,74354,Gabriel Bègue,273507,199153,Marthe Gilles,38594,-35760,2022-08-17
TRANSFER,182194,Manon Chevalier,215381,33187,Gabriel Bègue,199153,381347,2022-08-17
CASH_IN,79383,Agence_moov_Cotonou,300000,220617,Gabriel Bègue,381347,460730,2022-08-18
CASH_IN,76526,Agence_moov_Abomey,300000,223474,Gabriel Bègue,460730,537256,2022-08-18
TRANSFER,25492,Hélène Le Chauvin,149072,123580,Gabriel Bègue,537256,562748,2022-08-19
CASH_OUT,233715,Gabriel Bègue,562748,329033,Agence_moov_Abomey,300000,66285,2022-08-19
CASH_OUT,296590,Gabriel Bègue,329033,32443,Agence_moov_Cotonou,300000,3410,2022-08-20
CASH_OUT,21880,Gabriel Bègue,32443,10563,Agence_moov_Abomey,300000,278120,2022-08-20
CASH_OUT,2196,Gabriel Bègue,10563,8367,Agence_moov_Abomey,300000,297804,2022-08-20
CASH_IN,232050,Agence_moov_Abomey,300000,67950,Gabriel Bègue,8367,240417,2022-08-22
CASH_OUT,139329,Gabriel Bègue,240417,101088,Agence_moov_Abomey,300000,160671,2022-08-22
TRANSFER,120150,Robert-Louis Gosselin,548226,428076,Gabriel Bègue,101088,221238,2022-08-23
CASH_OUT,128779,Gabriel Bègue,221238,92459,Agence_moov_Ouidah,300000,171221,2022-08-23
TRANSFER,84337,Gabriel Bègue,92459,8122,Manon Valette,6446,-77891,2022-08-24
TRANSFER,60872,Michel Bouchet,117558,56686,Gabriel Bègue,8122,68994,2022-08-24
CASH_IN,203966,Agence_moov_Cotonou,300000,96034,Gabriel Bègue,68994,272960,2022-08-25
CASH_IN,135818,Agence_moov_Cotonou,300000,164182,Gabriel Bègue,272960,408778,2022-08-25
CASH_IN,20371,Agence_moov_Cotonou,300000,279629,Gabriel Bègue,408778,429149,2022-08-25
CASH_OUT,227207,Gabriel Bègue,429149,201942,Agence_moov_Ouidah,300000,72793,2022-08-26
CASH_OUT,18913,Gabriel Bègue,201942,183029,Agence_moov_Abomey,300000,281087,2022-08-27
CASH_IN,4487,Agence_moov_Cotonou,300000,295513,Paul Rocher-Maillet,89058,93545,2022-08-01
TRANSFER,16771,Paul Rocher-Maillet,93545,76774,Marcelle-Valentine Guibert,121400,104629,2022-08-01
CASH_IN,265257,Agence_moov_Cotonou,300000,34743,Paul Rocher-Maillet,76774,342031,2022-08-03
CASH_IN,195413,Agence_moov_Ouidah,300000,104587,Paul Rocher-Maillet,342031,537444,2022-08-03
CASH_IN,136160,Agence_moov_Cotonou,300000,163840,Paul Rocher-Maillet,537444,673604,2022-08-04
CASH_IN,144560,Agence_moov_Cotonou,300000,155440,Paul Rocher-Maillet,673604,818164,2022-08-04
TRANSFER,437085,Paul Rocher-Maillet,818164,381079,Jules Fernandes,331475,-105610,2022-08-07
CASH_OUT,94747,Paul Rocher-Maillet,381079,286332,Agence_moov_Abomey,300000,205253,2022-08-07
CASH_IN,84941,Agence_moov_Cotonou,300000,215059,Paul Rocher-Maillet,286332,371273,2022-08-09
TRANSFER,526925,Mathilde de la Samson,807994,281069,Paul Rocher-Maillet,371273,898198,2022-08-11
CASH_OUT,137172,Paul Rocher-Maillet,898198,761026,Agence_moov_Cotonou,300000,162828,2022-08-12
CASH_IN,284421,Agence_moov_Ouidah,300000,15579,Paul Rocher-Maillet,761026,1045447,2022-08-13
CASH_OUT,245270,Paul Rocher-Maillet,1045447,800177,Agence_moov_Ouidah,300000,54730,2022-08-14
TRANSFER,243333,Paul Rocher-Maillet,800177,556844,Suzanne Bodin,1034125,790792,2022-08-15
TRANSFER,152183,Paul Rocher-Maillet,556844,404661,Thomas-Robert Morvan,284372,132189,2022-08-16
CASH_IN,213662,Agence_moov_Ouidah,300000,86338,Paul Rocher-Maillet,404661,618323,2022-08-17
CASH_IN,233861,Agence_moov_Abomey,300000,66139,Paul Rocher-Maillet,618323,852184,2022-08-19
TRANSFER,3570,Véronique Martins de Fleury,456115,452545,Paul Rocher-Maillet,852184,855754,2022-08-19
CASH_OUT,406831,Paul Rocher-Maillet,855754,448923,Agence_moov_Cotonou,300000,-106831,2022-08-20
TRANSFER,81738,Stéphane Munoz,139400,57662,Paul Rocher-Maillet,448923,530661,2022-08-20
TRANSFER,689321,Noémi Bouvier,924600,235279,Paul Rocher-Maillet,530661,1219982,2022-08-21
CASH_OUT,332323,Paul Rocher-Maillet,1219982,887659,Agence_moov_Abomey,300000,-32323,2022-08-22
CASH_OUT,333428,Paul Rocher-Maillet,887659,554231,Agence_moov_Cotonou,300000,-33428,2022-08-22
TRANSFER,36329,Michelle Samson,51557,15228,Paul Rocher-Maillet,554231,590560,2022-08-23
CASH_IN,157104,Agence_moov_Cotonou,300000,142896,Paul Rocher-Maillet,590560,747664,2022-08-23
TRANSFER,124050,Thomas-Robert Morvan,132189,8139,Paul Rocher-Maillet,747664,871714,2022-08-24
CASH_IN,34386,Agence_moov_Abomey,300000,265614,Paul Rocher-Maillet,871714,906100,2022-08-24
CASH_OUT,715394,Paul Rocher-Maillet,906100,190706,Agence_moov_Ouidah,300000,-415394,2022-08-25
TRANSFER,362261,Thomas Dupont,718733,356472,Paul Rocher-Maillet,190706,552967,2022-08-25
CASH_IN,148831,Agence_moov_Cotonou,300000,151169,Paul Rocher-Maillet,552967,701798,2022-08-25
CASH_OUT,36081,Michel Bouchet,56686,20605,Agence_moov_Cotonou,300000,263919,2022-08-01
TRANSFER,4587,Michel Bouchet,20605,16018,Simone Muller de la Brun,862442,857855,2022-08-02
CASH_IN,175347,Agence_moov_Ouidah,300000,124653,Michel Bouchet,16018,191365,2022-08-04
CASH_IN,292575,Agence_moov_Abomey,300000,7425,Michel Bouchet,191365,483940,2022-08-09
CASH_OUT,180839,Michel Bouchet,483940,303101,Agence_moov_Abomey,300000,119161,2022-08-09
CASH_OUT,141049,Michel Bouchet,303101,162052,Agence_moov_Ouidah,300000,158951,2022-08-13
CASH_OUT,114736,Michel Bouchet,162052,47316,Agence_moov_Abomey,300000,185264,2022-08-13
CASH_IN,117093,Agence_moov_Cotonou,300000,182907,Michel Bouchet,47316,164409,2022-08-13
CASH_IN,99209,Agence_moov_Abomey,300000,200791,Michel Bouchet,164409,263618,2022-08-17
CASH_IN,271099,Agence_moov_Ouidah,300000,28901,Michel Bouchet,263618,534717,2022-08-17
TRANSFER,162679,Michel Bouchet,534717,372038,Hélène de la Gérard,1536800,1374121,2022-08-18
CASH_OUT,276923,Michel Bouchet,372038,95115,Agence_moov_Cotonou,300000,23077,2022-08-18
TRANSFER,24415,Michelle de Étienne,112873,88458,Michel Bouchet,95115,119530,2022-08-19
CASH_OUT,66517,Michel Bouchet,119530,53013,Agence_moov_Abomey,300000,233483,2022-08-19
CASH_OUT,2929,Michel Bouchet,53013,50084,Agence_moov_Ouidah,300000,297071,2022-08-19
CASH_IN,285188,Agence_moov_Abomey,300000,14812,Michel Bouchet,50084,335272,2022-08-20
CASH_IN,138026,Agence_moov_Ouidah,300000,161974,Michel Bouchet,335272,473298,2022-08-20
CASH_OUT,435977,Michel Bouchet,473298,37321,Agence_moov_Ouidah,300000,-135977,2022-08-20
CASH_OUT,3789,Michel Bouchet,37321,33532,Agence_moov_Abomey,300000,296211,2022-08-21
CASH_OUT,30878,Michel Bouchet,33532,2654,Agence_moov_Ouidah,300000,269122,2022-08-22
CASH_OUT,2245,Michel Bouchet,2654,409,Agence_moov_Abomey,300000,297755,2022-08-23
TRANSFER,5191,Agnès Le Giraud,9320,4129,Michel Bouchet,409,5600,2022-08-24
TRANSFER,4586,Michel Bouchet,5600,1014,Thérèse François,434806,430220,2022-08-25
CASH_OUT,676,Michel Bouchet,1014,338,Agence_moov_Abomey,300000,299324,2022-08-26
CASH_IN,182471,Agence_moov_Cotonou,300000,117529,Michel Bouchet,338,182809,2022-08-26
CASH_OUT,30427,Michel Bouchet,182809,152382,Agence_moov_Abomey,300000,269573,2022-08-26
CASH_IN,81193,Agence_moov_Abomey,300000,218807,Michel Bouchet,152382,233575,2022-08-27
CASH_IN,157816,Agence_moov_Ouidah,300000,142184,Nicolas Salmon Le Hamon,-134272,23544,2022-08-01
TRANSFER,447189,Alix Barbe,488800,41611,Nicolas Salmon Le Hamon,23544,470733,2022-08-04
CASH_IN,134308,Agence_moov_Abomey,300000,165692,Nicolas Salmon Le Hamon,470733,605041,2022-08-04
CASH_IN,225497,Agence_moov_Abomey,300000,74503,Nicolas Salmon Le Hamon,605041,830538,2022-08-09
TRANSFER,283652,Emmanuel Grégoire,423041,139389,Nicolas Salmon Le Hamon,830538,1114190,2022-08-10
CASH_IN,119341,Agence_moov_Cotonou,300000,180659,Nicolas Salmon Le Hamon,1114190,1233531,2022-08-13
CASH_OUT,171320,Nicolas Salmon Le Hamon,1233531,1062211,Agence_moov_Cotonou,300000,128680,2022-08-14
TRANSFER,393,Thomas-Robert Morvan,8139,7746,Nicolas Salmon Le Hamon,1062211,1062604,2022-08-14
CASH_IN,138023,Agence_moov_Cotonou,300000,161977,Nicolas Salmon Le Hamon,1062604,1200627,2022-08-15
TRANSFER,6194,Thomas-Robert Morvan,7746,1552,Nicolas Salmon Le Hamon,1200627,1206821,2022-08-16
CASH_IN,288020,Agence_moov_Abomey,300000,11980,Nicolas Salmon Le Hamon,1206821,1494841,2022-08-17
TRANSFER,78370,André Renault,163315,84945,Nicolas Salmon Le Hamon,1494841,1573211,2022-08-17
CASH_IN,89759,Agence_moov_Cotonou,300000,210241,Nicolas Salmon Le Hamon,1573211,1662970,2022-08-19
TRANSFER,110002,Richard Michel,238378,128376,Nicolas Salmon Le Hamon,1662970,1772972,2022-08-19
CASH_IN,226876,Agence_moov_Cotonou,300000,73124,Nicolas Salmon Le Hamon,1772972,1999848,2022-08-21
TRANSFER,63438,Tristan Gomez,1198191,1134753,Nicolas Salmon Le Hamon,1999848,2063286,2022-08-22
TRANSFER,36445,Stéphane Munoz,57662,21217,Nicolas Salmon Le Hamon,2063286,2099731,2022-08-22
CASH_IN,118829,Agence_moov_Cotonou,300000,181171,Nicolas Salmon Le Hamon,2099731,2218560,2022-08-23
CASH_IN,219986,Agence_moov_Cotonou,300000,80014,Nicolas Salmon Le Hamon,2218560,2438546,2022-08-24
CASH_IN,17906,Agence_moov_Ouidah,300000,282094,Nicolas Salmon Le Hamon,2438546,2456452,2022-08-24
TRANSFER,2037869,Nicolas Salmon Le Hamon,2456452,418583,Robert-Louis Gosselin,428076,-1609793,2022-08-24
CASH_IN,59829,Agence_moov_Ouidah,300000,240171,Nicolas Salmon Le Hamon,418583,478412,2022-08-25
TRANSFER,1276584,Anastasie Cousin,1486900,210316,Nicolas Salmon Le Hamon,478412,1754996,2022-08-26
TRANSFER,1690681,Nicolas Salmon Le Hamon,1754996,64315,Tristan Gomez,1134753,-555928,2022-08-27
CASH_IN,161695,Agence_moov_Abomey,300000,138305,Constance Bourdon-Millet,-157305,4390,2022-08-02
CASH_IN,280357,Agence_moov_Cotonou,300000,19643,Constance Bourdon-Millet,4390,284747,2022-08-02
CASH_OUT,54527,Constance Bourdon-Millet,284747,230220,Agence_moov_Ouidah,300000,245473,2022-08-03
CASH_IN,277606,Agence_moov_Abomey,300000,22394,Constance Bourdon-Millet,230220,507826,2022-08-04
CASH_IN,285734,Agence_moov_Abomey,300000,14266,Constance Bourdon-Millet,507826,793560,2022-08-05
CASH_OUT,400985,Constance Bourdon-Millet,793560,392575,Agence_moov_Abomey,300000,-100985,2022-08-06
TRANSFER,177113,Constance Bourdon-Millet,392575,215462,Thomas Dupont,356472,179359,2022-08-06
CASH_OUT,89891,Constance Bourdon-Millet,215462,125571,Agence_moov_Cotonou,300000,210109,2022-08-07
CASH_IN,166146,Agence_moov_Abomey,300000,133854,Constance Bourdon-Millet,125571,291717,2022-08-07
TRANSFER,182937,Constance Bourdon-Millet,291717,108780,Virginie Bouvet,37495,-145442,2022-08-07
CASH_IN,298315,Agence_moov_Abomey,300000,1685,Constance Bourdon-Millet,108780,407095,2022-08-08
TRANSFER,28038,Constance Bourdon-Millet,407095,379057,Thomas-Robert Morvan,1552,-26486,2022-08-09
CASH_OUT,126600,Constance Bourdon-Millet,379057,252457,Agence_moov_Ouidah,300000,173400,2022-08-13
CASH_OUT,200298,Constance Bourdon-Millet,252457,52159,Agence_moov_Abomey,300000,99702,2022-08-15
CASH_OUT,15601,Constance Bourdon-Millet,52159,36558,Agence_moov_Abomey,300000,284399,2022-08-16
TRANSFER,70908,Marcelle-Valentine Guibert,104629,33721,Constance Bourdon-Millet,36558,107466,2022-08-17
CASH_IN,99672,Agence_moov_Cotonou,300000,200328,Constance Bourdon-Millet,107466,207138,2022-08-17
CASH_OUT,33122,Constance Bourdon-Millet,207138,174016,Agence_moov_Ouidah,300000,266878,2022-08-18
TRANSFER,47766,Hélène Le Chauvin,123580,75814,Constance Bourdon-Millet,174016,221782,2022-08-18
TRANSFER,647827,Raymond Lévy,990580,342753,Constance Bourdon-Millet,221782,869609,2022-08-19
TRANSFER,75269,Mathilde de la Samson,281069,205800,Constance Bourdon-Millet,869609,944878,2022-08-21
TRANSFER,535013,Constance Bourdon-Millet,944878,409865,Adèle Da Silva-Klein,24810,-510203,2022-08-23
CASH_IN,59350,Agence_moov_Ouidah,300000,240650,Constance Bourdon-Millet,409865,469215,2022-08-24
CASH_OUT,209984,Constance Bourdon-Millet,469215,259231,Agence_moov_Ouidah,300000,90016,2022-08-25
CASH_IN,285256,Agence_moov_Abomey,300000,14744,Constance Bourdon-Millet,259231,544487,2022-08-25
CASH_IN,151972,Agence_moov_Ouidah,300000,148028,Constance Bourdon-Millet,544487,696459,2022-08-26
CASH_OUT,203259,Constance Bourdon-Millet,696459,493200,Agence_moov_Ouidah,300000,96741,2022-08-26
TRANSFER,1273566,Antoinette de Dupuis,1632600,359034,Constance Bourdon-Millet,493200,1766766,2022-08-27
CASH_IN,188315,Agence_moov_Abomey,300000,111685,Adèle Da Silva-Klein,-510203,-321888,2022-08-01
CASH_IN,295956,Agence_moov_Cotonou,300000,4044,Adèle Da Silva-Klein,-321888,-25932,2022-08-01
CASH_IN,226525,Agence_moov_Cotonou,300000,73475,Adèle Da Silva-Klein,-25932,200593,2022-08-03
CASH_OUT,21240,Adèle Da Silva-Klein,200593,179353,Agence_moov_Cotonou,300000,278760,2022-08-06
CASH_OUT,90542,Adèle Da Silva-Klein,179353,88811,Agence_moov_Cotonou,300000,209458,2022-08-09
TRANSFER,323516,Suzanne Bodin,790792,467276,Adèle Da Silva-Klein,88811,412327,2022-08-10
CASH_IN,36527,Agence_moov_Ouidah,300000,263473,Adèle Da Silva-Klein,412327,448854,2022-08-10
TRANSFER,435400,Adèle Da Silva-Klein,448854,13454,Hélène de la Gérard,1374121,938721,2022-08-11
TRANSFER,2078,Adèle Da Silva-Klein,13454,11376,Vincent de la Dumont,1042427,1040349,2022-08-11
TRANSFER,7854,Adèle Da Silva-Klein,11376,3522,Michelle Samson,15228,7374,2022-08-12
CASH_IN,98406,Agence_moov_Abomey,300000,201594,Adèle Da Silva-Klein,3522,101928,2022-08-13
TRANSFER,329737,Raymond Lévy,342753,13016,Adèle Da Silva-Klein,101928,431665,2022-08-16
CASH_OUT,294260,Adèle Da Silva-Klein,431665,137405,Agence_moov_Abomey,300000,5740,2022-08-17
TRANSFER,105273,Noémi Bouvier,235279,130006,Adèle Da Silva-Klein,137405,242678,2022-08-19
CASH_IN,73141,Agence_moov_Cotonou,300000,226859,Adèle Da Silva-Klein,242678,315819,2022-08-20
TRANSFER,201587,Adèle Da Silva-Klein,315819,114232,Léon Da Costa,1755222,1553635,2022-08-21
TRANSFER,104607,Adèle Da Silva-Klein,114232,9625,Manon Chevalier,33187,-71420,2022-08-22
CASH_IN,279864,Agence_moov_Abomey,300000,20136,Adèle Da Silva-Klein,9625,289489,2022-08-22
CASH_IN,27828,Agence_moov_Cotonou,300000,272172,Adèle Da Silva-Klein,289489,317317,2022-08-26
TRANSFER,115898,Richard Michel,128376,12478,Adèle Da Silva-Klein,317317,433215,2022-08-26
CASH_OUT,383232,Adèle Da Silva-Klein,433215,49983,Agence_moov_Ouidah,300000,-83232,2022-08-27
CASH_IN,46976,Agence_moov_Ouidah,300000,253024,Bernadette de Jourdan,-151727,-104751,2022-08-01
CASH_IN,241624,Agence_moov_Abomey,300000,58376,Bernadette de Jourdan,-104751,136873,2022-08-02
TRANSFER,22227,Bernadette de Jourdan,136873,114646,Noémi Bouvier,130006,107779,2022-08-03
CASH_OUT,28755,Bernadette de Jourdan,114646,85891,Agence_moov_Ouidah,300000,271245,2022-08-06
CASH_IN,248857,Agence_moov_Abomey,300000,51143,Bernadette de Jourdan,85891,334748,2022-08-06
CASH_OUT,87756,Bernadette de Jourdan,334748,246992,Agence_moov_Ouidah,300000,212244,2022-08-07
TRANSFER,98139,Bernadette de Jourdan,246992,148853,Alix Barbe,41611,-56528,2022-08-08
CASH_IN,105620,Agence_moov_Ouidah,300000,194380,Bernadette de Jourdan,148853,254473,2022-08-08
CASH_IN,224342,Agence_moov_Ouidah,300000,75658,Bernadette de Jourdan,254473,478815,2022-08-10
CASH_IN,54704,Agence_moov_Abomey,300000,245296,Bernadette de Jourdan,478815,533519,2022-08-11
CASH_OUT,62552,Bernadette de Jourdan,533519,470967,Agence_moov_Ouidah,300000,237448,2022-08-13
CASH_IN,53382,Agence_moov_Abomey,300000,246618,Bernadette de Jourdan,470967,524349,2022-08-13
CASH_IN,292211,Agence_moov_Cotonou,300000,7789,Bernadette de Jourdan,524349,816560,2022-08-14
CASH_IN,24694,Agence_moov_Ouidah,300000,275306,Bernadette de Jourdan,816560,841254,2022-08-14
CASH_IN,178204,Agence_moov_Cotonou,300000,121796,Bernadette de Jourdan,841254,1019458,2022-08-21
TRANSFER,649164,Maggie Martinez,653136,3972,Bernadette de Jourdan,1019458,1668622,2022-08-21
TRANSFER,1417816,Léon Da Costa,1553635,135819,Bernadette de Jourdan,1668622,3086438,2022-08-22
CASH_IN,136234,Agence_moov_Cotonou,300000,163766,Bernadette de Jourdan,3086438,3222672,2022-08-23
CASH_OUT,264555,Bernadette de Jourdan,3222672,2958117,Agence_moov_Ouidah,300000,35445,2022-08-24
CASH_OUT,2736409,Bernadette de Jourdan,2958117,221708,Agence_moov_Ouidah,300000,-2436409,2022-08-24
TRANSFER,123638,Bernadette de Jourdan,221708,98070,Marcelle-Valentine Guibert,33721,-89917,2022-08-26
CASH_OUT,67558,Bernadette de Jourdan,98070,30512,Agence_moov_Abomey,300000,232442,2022-08-26
CASH_IN,125561,Agence_moov_Abomey,300000,174439,Marthe Gilles,-35760,89801,2022-08-01
CASH_IN,99951,Agence_moov_Ouidah,300000,200049,Marthe Gilles,89801,189752,2022-08-03
CASH_OUT,160573,Marthe Gilles,189752,29179,Agence_moov_Cotonou,300000,139427,2022-08-07
CASH_IN,157838,Agence_moov_Abomey,300000,142162,Marthe Gilles,29179,187017,2022-08-07
TRANSFER,149715,Marthe Gilles,187017,37302,Paul Perez,61092,-88623,2022-08-09
TRANSFER,4190,Marthe Gilles,37302,33112,Simone Muller de la Brun,857855,853665,2022-08-11
CASH_IN,63347,Agence_moov_Ouidah,300000,236653,Marthe Gilles,33112,96459,2022-08-11
CASH_OUT,64893,Marthe Gilles,96459,31566,Agence_moov_Abomey,300000,235107,2022-08-14
CASH_OUT,23016,Marthe Gilles,31566,8550,Agence_moov_Ouidah,300000,276984,2022-08-14
TRANSFER,62592,Noémi Bouvier,107779,45187,Marthe Gilles,8550,71142,2022-08-15
TRANSFER,7090,Benoît Guyot,9777,2687,Marthe Gilles,71142,78232,2022-08-16
CASH_IN,218961,Agence_moov_Abomey,300000,81039,Marthe Gilles,78232,297193,2022-08-17
CASH_IN,109321,Agence_moov_Cotonou,300000,190679,Marthe Gilles,297193,406514,2022-08-18
CASH_OUT,352515,Marthe Gilles,406514,53999,Agence_moov_Ouidah,300000,-52515,2022-08-20
CASH_IN,196706,Agence_moov_Ouidah,300000,103294,Marthe Gilles,53999,250705,2022-08-22
CASH_OUT,85906,Marthe Gilles,250705,164799,Agence_moov_Cotonou,300000,214094,2022-08-22
TRANSFER,5527,Raymond Lévy,13016,7489,Marthe Gilles,164799,170326,2022-08-22
CASH_IN,49139,Agence_moov_Ouidah,300000,250861,Marthe Gilles,170326,219465,2022-08-25
CASH_IN,141560,Agence_moov_Ouidah,300000,158440,Marthe Gilles,219465,361025,2022-08-25
TRANSFER,267757,Marthe Gilles,361025,93268,Noémi Bouvier,45187,-222570,2022-08-26
CASH_IN,141191,Agence_moov_Cotonou,300000,158809,Marthe Gilles,93268,234459,2022-08-26
CASH_OUT,73172,Marthe Gilles,234459,161287,Agence_moov_Ouidah,300000,226828,2022-08-27
CASH_IN,15675,Agence_moov_Ouidah,300000,284325,Marthe Gilles,161287,176962,2022-08-27
CASH_IN,288639,Agence_moov_Ouidah,300000,11361,Manon Lebon,-655222,-366583,2022-08-02
CASH_IN,185058,Agence_moov_Cotonou,300000,114942,Manon Lebon,-366583,-181525,2022-08-07
CASH_IN,232186,Agence_moov_Abomey,300000,67814,Manon Lebon,-181525,50661,2022-08-08
CASH_OUT,34372,Manon Lebon,50661,16289,Agence_moov_Ouidah,300000,265628,2022-08-09
CASH_IN,214819,Agence_moov_Ouidah,300000,85181,Manon Lebon,16289,231108,2022-08-09
CASH_IN,26205,Agence_moov_Ouidah,300000,273795,Manon Lebon,231108,257313,2022-08-10
CASH_IN,31891,Agence_moov_Ouidah,300000,268109,Manon Lebon,257313,289204,2022-08-11
CASH_IN,133162,Agence_moov_Cotonou,300000,166838,Manon Lebon,289204,422366,2022-08-11
TRANSFER,339593,Manon Lebon,422366,82773,Michelle de Étienne,88458,-251135,2022-08-12
CASH_OUT,44917,Manon Lebon,82773,37856,Agence_moov_Abomey,300000,255083,2022-08-12
CASH_OUT,27199,Manon Lebon,37856,10657,Agence_moov_Abomey,300000,272801,2022-08-12
TRANSFER,17679,Stéphane Munoz,21217,3538,Manon Lebon,10657,28336,2022-08-13
CASH_IN,239564,Agence_moov_Cotonou,300000,60436,Manon Lebon,28336,267900,2022-08-13
CASH_OUT,202751,Manon Lebon,267900,65149,Agence_moov_Cotonou,300000,97249,2022-08-15
CASH_IN,243804,Agence_moov_Ouidah,300000,56196,Manon Lebon,65149,308953,2022-08-16
CASH_OUT,177786,Manon Lebon,308953,131167,Agence_moov_Ouidah,300000,122214,2022-08-18
CASH_IN,110009,Agence_moov_Abomey,300000,189991,Manon Lebon,131167,241176,2022-08-18
CASH_IN,147258,Agence_moov_Cotonou,300000,152742,Manon Lebon,241176,388434,2022-08-18
TRANSFER,188986,Manon Lebon,388434,199448,Simone Muller de la Brun,853665,664679,2022-08-19
TRANSFER,81133,Manon Lebon,199448,118315,Frédéric Guillou,1662457,1581324,2022-08-21
CASH_IN,37293,Agence_moov_Abomey,300000,262707,Manon Lebon,118315,155608,2022-08-22
CASH_IN,136036,Agence_moov_Abomey,300000,163964,Manon Lebon,155608,291644,2022-08-23
CASH_OUT,104339,Manon Lebon,291644,187305,Agence_moov_Cotonou,300000,195661,2022-08-24
CASH_OUT,110088,Manon Lebon,187305,77217,Agence_moov_Cotonou,300000,189912,2022-08-24
CASH_IN,16998,Agence_moov_Abomey,300000,283002,Manon Lebon,77217,94215,2022-08-24
CASH_OUT,92895,Manon Lebon,94215,1320,Agence_moov_Cotonou,300000,207105,2022-08-26
CASH_OUT,512,Manon Lebon,1320,808,Agence_moov_Cotonou,300000,299488,2022-08-26
CASH_OUT,358,Manon Lebon,808,450,Agence_moov_Abomey,300000,299642,2022-08-27
CASH_OUT,822,Agnès Le Giraud,4129,3307,Agence_moov_Abomey,300000,299178,2022-08-03
CASH_OUT,3204,Agnès Le Giraud,3307,103,Agence_moov_Cotonou,300000,296796,2022-08-04
TRANSFER,192638,Vincent de la Dumont,1040349,847711,Agnès Le Giraud,103,192741,2022-08-04
TRANSFER,135672,Agnès Le Giraud,192741,57069,Benoît Guyot,2687,-132985,2022-08-05
CASH_OUT,43186,Agnès Le Giraud,57069,13883,Agence_moov_Abomey,300000,256814,2022-08-08
CASH_OUT,9658,Agnès Le Giraud,13883,4225,Agence_moov_Abomey,300000,290342,2022-08-09
CASH_OUT,2751,Agnès Le Giraud,4225,1474,Agence_moov_Abomey,300000,297249,2022-08-14
CASH_OUT,360,Agnès Le Giraud,1474,1114,Agence_moov_Abomey,300000,299640,2022-08-15
CASH_OUT,894,Agnès Le Giraud,1114,220,Agence_moov_Abomey,300000,299106,2022-08-15
CASH_IN,65783,Agence_moov_Ouidah,300000,234217,Agnès Le Giraud,220,66003,2022-08-16
TRANSFER,18190,Agnès Le Giraud,66003,47813,Léon Da Costa,135819,117629,2022-08-17
TRANSFER,38278,Agnès Le Giraud,47813,9535,Renée Le Diaz,205127,166849,2022-08-19
TRANSFER,44707,Vincent de la Dumont,847711,803004,Agnès Le Giraud,9535,54242,2022-08-23
CASH_OUT,27847,Agnès Le Giraud,54242,26395,Agence_moov_Ouidah,300000,272153,2022-08-24
CASH_OUT,15963,Agnès Le Giraud,26395,10432,Agence_moov_Abomey,300000,284037,2022-08-24
CASH_IN,118055,Agence_moov_Cotonou,300000,181945,Agnès Le Giraud,10432,128487,2022-08-25
CASH_OUT,4335,Agnès Le Giraud,128487,124152,Agence_moov_Ouidah,300000,295665,2022-08-25
CASH_OUT,102426,Agnès Le Giraud,124152,21726,Agence_moov_Abomey,300000,197574,2022-08-26
TRANSFER,878,Michelle Samson,7374,6496,Mathilde de la Samson,205800,206678,2022-08-01
CASH_OUT,186338,Mathilde de la Samson,206678,20340,Agence_moov_Abomey,300000,113662,2022-08-05
CASH_IN,63824,Agence_moov_Cotonou,300000,236176,Mathilde de la Samson,20340,84164,2022-08-05
TRANSFER,44772,Nathalie Bonnin-Joubert,619332,574560,Mathilde de la Samson,84164,128936,2022-08-09
CASH_OUT,104780,Mathilde de la Samson,128936,24156,Agence_moov_Cotonou,300000,195220,2022-08-10
CASH_IN,93044,Agence_moov_Cotonou,300000,206956,Mathilde de la Samson,24156,117200,2022-08-10
CASH_OUT,79835,Mathilde de la Samson,117200,37365,Agence_moov_Cotonou,300000,220165,2022-08-14
CASH_IN,203760,Agence_moov_Abomey,300000,96240,Mathilde de la Samson,37365,241125,2022-08-15
CASH_OUT,185304,Mathilde de la Samson,241125,55821,Agence_moov_Abomey,300000,114696,2022-08-17
CASH_IN,93030,Agence_moov_Cotonou,300000,206970,Mathilde de la Samson,55821,148851,2022-08-17
TRANSFER,378480,Véronique Martins de Fleury,452545,74065,Mathilde de la Samson,148851,527331,2022-08-18
CASH_OUT,285792,Mathilde de la Samson,527331,241539,Agence_moov_Ouidah,300000,14208,2022-08-27
CASH_IN,279058,Agence_moov_Ouidah,300000,20942,Véronique Martins de Fleury,74065,353123,2022-08-02
TRANSFER,163164,Véronique Martins de Fleury,353123,189959,Simone Muller de la Brun,664679,501515,2022-08-08
TRANSFER,229266,Nathalie Bonnin-Joubert,574560,345294,Véronique Martins de Fleury,189959,419225,2022-08-13
CASH_OUT,290713,Véronique Martins de Fleury,419225,128512,Agence_moov_Abomey,300000,9287,2022-08-15
TRANSFER,58527,Sabine Pineau,380991,322464,Véronique Martins de Fleury,128512,187039,2022-08-16
CASH_IN,127186,Agence_moov_Cotonou,300000,172814,Véronique Martins de Fleury,187039,314225,2022-08-21
TRANSFER,5790,Richard Michel,12478,6688,Véronique Martins de Fleury,314225,320015,2022-08-22
CASH_IN,227449,Agence_moov_Cotonou,300000,72551,Noémi Bouvier,-222570,4879,2022-08-01
CASH_OUT,4229,Noémi Bouvier,4879,650,Agence_moov_Ouidah,300000,295771,2022-08-02
CASH_OUT,588,Noémi Bouvier,650,62,Agence_moov_Ouidah,300000,299412,2022-08-03
CASH_IN,187654,Agence_moov_Abomey,300000,112346,Noémi Bouvier,62,187716,2022-08-07
CASH_OUT,108321,Noémi Bouvier,187716,79395,Agence_moov_Abomey,300000,191679,2022-08-08
TRANSFER,69914,Antoinette de Dupuis,359034,289120,Noémi Bouvier,79395,149309,2022-08-09
TRANSFER,113803,Noémi Bouvier,149309,35506,André Renault,84945,-28858,2022-08-09
TRANSFER,3363,Raymond Lévy,7489,4126,Noémi Bouvier,35506,38869,2022-08-12
CASH_IN,189768,Agence_moov_Cotonou,300000,110232,Noémi Bouvier,38869,228637,2022-08-17
TRANSFER,6352,Noémi Bouvier,228637,222285,Hélène Le Chauvin,75814,69462,2022-08-20
TRANSFER,3200,Raymond Lévy,4126,926,Noémi Bouvier,222285,225485,2022-08-20
CASH_IN,3693,Agence_moov_Cotonou,300000,296307,Noémi Bouvier,225485,229178,2022-08-21
CASH_IN,198949,Agence_moov_Abomey,300000,101051,Noémi Bouvier,229178,428127,2022-08-22
CASH_IN,21388,Agence_moov_Ouidah,300000,278612,Noémi Bouvier,428127,449515,2022-08-25
CASH_IN,218524,Agence_moov_Cotonou,300000,81476,Noémi Bouvier,449515,668039,2022-08-26
CASH_IN,7121,Agence_moov_Cotonou,300000,292879,Noémi Bouvier,668039,675160,2022-08-27
CASH_IN,163959,Agence_moov_Abomey,300000,136041,Noémi Bouvier,675160,839119,2022-08-27
TRANSFER,848875,Émilie du Allain,972634,123759,Frédéric Guillou,1581324,732449,2022-08-03
CASH_OUT,9481,Émilie du Allain,123759,114278,Agence_moov_Cotonou,300000,290519,2022-08-07
TRANSFER,653642,Frédéric Guillou,732449,78807,Émilie du Allain,114278,767920,2022-08-08
CASH_IN,216309,Agence_moov_Ouidah,300000,83691,Émilie du Allain,767920,984229,2022-08-08
CASH_IN,215339,Agence_moov_Cotonou,300000,84661,Émilie du Allain,984229,1199568,2022-08-11
CASH_OUT,805925,Émilie du Allain,1199568,393643,Agence_moov_Ouidah,300000,-505925,2022-08-12
TRANSFER,109732,Émilie du Allain,393643,283911,Émilie du Allain,393643,503375,2022-08-13
TRANSFER,81142,Lucie Aubert,127594,46452,Émilie du Allain,283911,365053,2022-08-15
TRANSFER,76306,Léon Da Costa,117629,41323,Émilie du Allain,365053,441359,2022-08-17
CASH_IN,607,Agence_moov_Ouidah,300000,299393,Émilie du Allain,441359,441966,2022-08-18
TRANSFER,231468,Vincent de la Dumont,803004,571536,Émilie du Allain,441966,673434,2022-08-21
TRANSFER,512944,Émilie du Allain,673434,160490,Émilie du Allain,673434,1186378,2022-08-21
CASH_IN,230325,Agence_moov_Abomey,300000,69675,Émilie du Allain,160490,390815,2022-08-21
TRANSFER,192566,Anastasie Cousin,210316,17750,Émilie du Allain,390815,583381,2022-08-21
TRANSFER,850682,Hélène de la Gérard,938721,88039,Émilie du Allain,583381,1434063,2022-08-24
CASH_OUT,749010,Émilie du Allain,1434063,685053,Agence_moov_Cotonou,300000,-449010,2022-08-26
CASH_OUT,503136,Émilie du Allain,685053,181917,Agence_moov_Cotonou,300000,-203136,2022-08-26
TRANSFER,470544,Simone Muller de la Brun,501515,30971,Émilie du Allain,181917,652461,2022-08-27
CASH_IN,273242,Agence_moov_Ouidah,300000,26758,Paul Perez,-88623,184619,2022-08-02
CASH_IN,180569,Agence_moov_Ouidah,300000,119431,Paul Perez,184619,365188,2022-08-03
TRANSFER,253597,Andrée-Thérèse Mendès,614503,360906,Paul Perez,365188,618785,2022-08-05
CASH_OUT,532458,Paul Perez,618785,86327,Agence_moov_Abomey,300000,-232458,2022-08-06
CASH_OUT,33779,Paul Perez,86327,52548,Agence_moov_Abomey,300000,266221,2022-08-09
TRANSFER,240507,Marc Leleu,1809500,1568993,Paul Perez,52548,293055,2022-08-12
CASH_IN,73381,Agence_moov_Abomey,300000,226619,Paul Perez,293055,366436,2022-08-14
TRANSFER,45482,Paul Perez,366436,320954,Hélène Le Chauvin,69462,23980,2022-08-14
CASH_OUT,295769,Paul Perez,320954,25185,Agence_moov_Ouidah,300000,4231,2022-08-17
CASH_IN,215057,Agence_moov_Ouidah,300000,84943,Paul Perez,25185,240242,2022-08-20
CASH_OUT,2858,Paul Perez,240242,237384,Agence_moov_Cotonou,300000,297142,2022-08-20
CASH_IN,276722,Agence_moov_Abomey,300000,23278,Paul Perez,237384,514106,2022-08-21
CASH_IN,197629,Agence_moov_Cotonou,300000,102371,Paul Perez,514106,711735,2022-08-22
CASH_IN,103701,Agence_moov_Abomey,300000,196299,Paul Perez,711735,815436,2022-08-23
TRANSFER,78694,Paul Perez,815436,736742,Richard Michel,6688,-72006,2022-08-24
CASH_OUT,174386,Thomas Dupont,179359,4973,Agence_moov_Abomey,300000,125614,2022-08-02
CASH_IN,47508,Agence_moov_Cotonou,300000,252492,Thomas Dupont,4973,52481,2022-08-03
CASH_IN,252938,Agence_moov_Cotonou,300000,47062,Thomas Dupont,52481,305419,2022-08-05
CASH_IN,111499,Agence_moov_Cotonou,300000,188501,Thomas Dupont,305419,416918,2022-08-05
TRANSFER,384,Raymond Lévy,926,542,Thomas Dupont,416918,417302,2022-08-07
TRANSFER,3264,Léon Da Costa,41323,38059,Thomas Dupont,417302,420566,2022-08-08
CASH_IN,263016,Agence_moov_Ouidah,300000,36984,Thomas Dupont,420566,683582,2022-08-09
CASH_IN,73882,Agence_moov_Abomey,300000,226118,Thomas Dupont,683582,757464,2022-08-11
CASH_OUT,45189,Thomas Dupont,757464,712275,Agence_moov_Abomey,300000,254811,2022-08-12
TRANSFER,471739,Thomas Dupont,712275,240536,Anastasie Cousin,17750,-453989,2022-08-14
CASH_IN,100522,Agence_moov_Cotonou,300000,199478,Thomas Dupont,240536,341058,2022-08-16
CASH_OUT,302024,Thomas Dupont,341058,39034,Agence_moov_Cotonou,300000,-2024,2022-08-18
CASH_IN,142076,Agence_moov_Abomey,300000,157924,Thomas Dupont,39034,181110,2022-08-19
CASH_OUT,103998,Thomas Dupont,181110,77112,Agence_moov_Cotonou,300000,196002,2022-08-21
CASH_IN,187980,Agence_moov_Ouidah,300000,112020,Thomas Dupont,77112,265092,2022-08-22
CASH_IN,286561,Agence_moov_Abomey,300000,13439,Thomas Dupont,265092,551653,2022-08-26
CASH_IN,144000,Agence_moov_Abomey,300000,156000,Thomas Dupont,551653,695653,2022-08-27
TRANSFER,11788,Lucie Aubert,46452,34664,Simone Muller de la Brun,30971,19183,2022-08-01
TRANSFER,212296,Sabine Pineau,322464,110168,Lucie Aubert,34664,246960,2022-08-05
CASH_OUT,136151,Lucie Aubert,246960,110809,Agence_moov_Abomey,300000,163849,2022-08-06
TRANSFER,103226,Lucie Aubert,110809,7583,Emmanuel Grégoire,139389,36163,2022-08-07
TRANSFER,5423,Lucie Aubert,7583,2160,Michelle Samson,6496,1073,2022-08-08
TRANSFER,1459,Lucie Aubert,2160,701,Nathalie Bonnin-Joubert,345294,343835,2022-08-09
CASH_IN,186878,Agence_moov_Abomey,300000,113122,Lucie Aubert,701,187579,2022-08-09
TRANSFER,60668,Frédéric Guillou,78807,18139,Lucie Aubert,187579,248247,2022-08-10
CASH_IN,269103,Agence_moov_Abomey,300000,30897,Lucie Aubert,248247,517350,2022-08-10
TRANSFER,362198,Lucie Aubert,517350,155152,Frédéric Guillou,18139,-344059,2022-08-12
TRANSFER,14494,Léon Da Costa,38059,23565,Lucie Aubert,155152,169646,2022-08-19
TRANSFER,5980,Léon Da Costa,23565,17585,Lucie Aubert,169646,175626,2022-08-20
CASH_IN,226512,Agence_moov_Abomey,300000,73488,Lucie Aubert,175626,402138,2022-08-20
TRANSFER,358315,Lucie Aubert,402138,43823,Michelle Samson,1073,-357242,2022-08-21
CASH_OUT,33205,Lucie Aubert,43823,10618,Agence_moov_Abomey,300000,266795,2022-08-26
CASH_IN,155453,Agence_moov_Cotonou,300000,144547,Lucie Aubert,10618,166071,2022-08-27
CASH_IN,21394,Agence_moov_Abomey,300000,278606,Lucie Aubert,166071,187465,2022-08-27
CASH_IN,58222,Agence_moov_Cotonou,300000,241778,Simone Muller de la Brun,19183,77405,2022-08-01
CASH_OUT,25754,Simone Muller de la Brun,77405,51651,Agence_moov_Ouidah,300000,274246,2022-08-02
TRANSFER,17248,Simone Muller de la Brun,51651,34403,Nathalie Bonnin-Joubert,343835,326587,2022-08-04
CASH_IN,12654,Agence_moov_Cotonou,300000,287346,Simone Muller de la Brun,34403,47057,2022-08-04
TRANSFER,28331,Simone Muller de la Brun,47057,18726,Hélène de la Gérard,88039,59708,2022-08-04
CASH_OUT,14567,Simone Muller de la Brun,18726,4159,Agence_moov_Cotonou,300000,285433,2022-08-07
CASH_IN,238480,Agence_moov_Ouidah,300000,61520,Simone Muller de la Brun,4159,242639,2022-08-10
TRANSFER,417115,Suzanne Bodin,467276,50161,Simone Muller de la Brun,242639,659754,2022-08-10
CASH_OUT,322267,Simone Muller de la Brun,659754,337487,Agence_moov_Ouidah,300000,-22267,2022-08-11
CASH_IN,232844,Agence_moov_Cotonou,300000,67156,Simone Muller de la Brun,337487,570331,2022-08-13
TRANSFER,21476,Thérèse François,430220,408744,Simone Muller de la Brun,570331,591807,2022-08-14
CASH_OUT,581455,Simone Muller de la Brun,591807,10352,Agence_moov_Ouidah,300000,-281455,2022-08-17
CASH_OUT,1452,Simone Muller de la Brun,10352,8900,Agence_moov_Abomey,300000,298548,2022-08-17
CASH_IN,130997,Agence_moov_Abomey,300000,169003,Simone Muller de la Brun,8900,139897,2022-08-18
CASH_OUT,10584,Simone Muller de la Brun,139897,129313,Agence_moov_Ouidah,300000,289416,2022-08-18
TRANSFER,491806,Vincent de la Dumont,571536,79730,Simone Muller de la Brun,129313,621119,2022-08-21
CASH_IN,247017,Agence_moov_Ouidah,300000,52983,Simone Muller de la Brun,621119,868136,2022-08-22
CASH_OUT,734072,Simone Muller de la Brun,868136,134064,Agence_moov_Ouidah,300000,-434072,2022-08-23
TRANSFER,22178,Simone Muller de la Brun,134064,111886,Vincent de la Dumont,79730,57552,2022-08-24
CASH_IN,244720,Agence_moov_Abomey,300000,55280,Tristan Gomez,-555928,-311208,2022-08-01
CASH_IN,280531,Agence_moov_Cotonou,300000,19469,Tristan Gomez,-311208,-30677,2022-08-03
CASH_IN,209360,Agence_moov_Ouidah,300000,90640,Tristan Gomez,-30677,178683,2022-08-03
CASH_IN,285474,Agence_moov_Cotonou,300000,14526,Tristan Gomez,178683,464157,2022-08-06
TRANSFER,220,Maggie Martinez,3972,3752,Tristan Gomez,464157,464377,2022-08-08
TRANSFER,2038,Stéphane Munoz,3538,1500,Tristan Gomez,464377,466415,2022-08-10
CASH_IN,96812,Agence_moov_Abomey,300000,203188,Tristan Gomez,466415,563227,2022-08-11
TRANSFER,230144,Tristan Gomez,563227,333083,Suzanne Bodin,50161,-179983,2022-08-14
TRANSFER,158194,Andrée-Thérèse Mendès,360906,202712,Tristan Gomez,333083,491277,2022-08-15
CASH_OUT,54364,Tristan Gomez,491277,436913,Agence_moov_Abomey,300000,245636,2022-08-15
CASH_OUT,342661,Tristan Gomez,436913,94252,Agence_moov_Cotonou,300000,-42661,2022-08-17
TRANSFER,71308,Tristan Gomez,94252,22944,Maggie Martinez,3752,-67556,2022-08-17
CASH_IN,260533,Agence_moov_Cotonou,300000,39467,Tristan Gomez,22944,283477,2022-08-19
CASH_OUT,49584,Tristan Gomez,283477,233893,Agence_moov_Cotonou,300000,250416,2022-08-21
CASH_OUT,222222,Tristan Gomez,233893,11671,Agence_moov_Ouidah,300000,77778,2022-08-22
TRANSFER,46000,Hélène de la Gérard,59708,13708,Tristan Gomez,11671,57671,2022-08-26
CASH_OUT,41894,Tristan Gomez,57671,15777,Agence_moov_Cotonou,300000,258106,2022-08-27
CASH_IN,219782,Agence_moov_Ouidah,300000,80218,Richard Michel,-72006,147776,2022-08-01
TRANSFER,25000,Richard Michel,147776,122776,Emmanuel Grégoire,36163,11163,2022-08-02
CASH_IN,195273,Agence_moov_Abomey,300000,104727,Richard Michel,122776,318049,2022-08-04
CASH_OUT,219465,Richard Michel,318049,98584,Agence_moov_Cotonou,300000,80535,2022-08-06
TRANSFER,680938,Marc Leleu,1568993,888055,Richard Michel,98584,779522,2022-08-07
TRANSFER,7299,Hélène de la Gérard,13708,6409,Richard Michel,779522,786821,2022-08-12
TRANSFER,16469,Hélène Le Chauvin,23980,7511,Richard Michel,786821,803290,2022-08-13
CASH_IN,69643,Agence_moov_Cotonou,300000,230357,Thomas-Robert Morvan,-26486,43157,2022-08-01
TRANSFER,38226,Vincent de la Dumont,57552,19326,Thomas-Robert Morvan,43157,81383,2022-08-03
CASH_OUT,44431,Thomas-Robert Morvan,81383,36952,Agence_moov_Cotonou,300000,255569,2022-08-05
CASH_IN,55695,Agence_moov_Ouidah,300000,244305,Thomas-Robert Morvan,36952,92647,2022-08-06
CASH_IN,73528,Agence_moov_Abomey,300000,226472,Thomas-Robert Morvan,92647,166175,2022-08-06
CASH_IN,140538,Agence_moov_Abomey,300000,159462,Thomas-Robert Morvan,166175,306713,2022-08-06
CASH_IN,296514,Agence_moov_Ouidah,300000,3486,Thomas-Robert Morvan,306713,603227,2022-08-11
CASH_OUT,434953,Thomas-Robert Morvan,603227,168274,Agence_moov_Abomey,300000,-134953,2022-08-12
TRANSFER,55793,Nathalie Bonnin-Joubert,326587,270794,Thomas-Robert Morvan,168274,224067,2022-08-12
TRANSFER,51848,Thomas-Robert Morvan,224067,172219,Vincent de la Dumont,19326,-32522,2022-08-13
CASH_IN,94257,Agence_moov_Ouidah,300000,205743,Thomas-Robert Morvan,172219,266476,2022-08-17
TRANSFER,263065,Thomas-Robert Morvan,266476,3411,Antoinette de Dupuis,289120,26055,2022-08-20
CASH_OUT,2560,Thomas-Robert Morvan,3411,851,Agence_moov_Abomey,300000,297440,2022-08-21
TRANSFER,9606,Nathalie Bonnin-Joubert,270794,261188,Thomas-Robert Morvan,851,10457,2022-08-21
CASH_OUT,5359,Thomas-Robert Morvan,10457,5098,Agence_moov_Abomey,300000,294641,2022-08-24
CASH_IN,170734,Agence_moov_Abomey,300000,129266,Thomas-Robert Morvan,5098,175832,2022-08-25
CASH_IN,257710,Agence_moov_Abomey,300000,42290,Thomas-Robert Morvan,175832,433542,2022-08-27
CASH_IN,240353,Agence_moov_Ouidah,300000,59647,Anastasie Cousin,-453989,-213636,2022-08-01
CASH_IN,170848,Agence_moov_Cotonou,300000,129152,Anastasie Cousin,-213636,-42788,2022-08-02
CASH_IN,297795,Agence_moov_Abomey,300000,2205,Anastasie Cousin,-42788,255007,2022-08-02
CASH_OUT,146815,Anastasie Cousin,255007,108192,Agence_moov_Abomey,300000,153185,2022-08-04
CASH_IN,72510,Agence_moov_Ouidah,300000,227490,Anastasie Cousin,108192,180702,2022-08-06
CASH_OUT,71606,Anastasie Cousin,180702,109096,Agence_moov_Cotonou,300000,228394,2022-08-13
CASH_IN,217444,Agence_moov_Abomey,300000,82556,Anastasie Cousin,109096,326540,2022-08-14
CASH_IN,95403,Agence_moov_Ouidah,300000,204597,Anastasie Cousin,326540,421943,2022-08-15
CASH_OUT,193914,Anastasie Cousin,421943,228029,Agence_moov_Abomey,300000,106086,2022-08-16
TRANSFER,100871,Anastasie Cousin,228029,127158,Anastasie Cousin,228029,127158,2022-08-17
TRANSFER,658307,Marc Leleu,888055,229748,Anastasie Cousin,127158,785465,2022-08-21
CASH_IN,54382,Agence_moov_Abomey,300000,245618,Anastasie Cousin,785465,839847,2022-08-25
TRANSFER,734566,Anastasie Cousin,839847,105281,Sabine Pineau,110168,-624398,2022-08-26
CASH_OUT,88352,Anastasie Cousin,105281,16929,Agence_moov_Ouidah,300000,211648,2022-08-27
CASH_IN,294196,Agence_moov_Abomey,300000,5804,Suzanne Bodin,-179983,114213,2022-08-01
TRANSFER,1569,Hélène de la Gérard,6409,4840,Suzanne Bodin,114213,115782,2022-08-11
CASH_IN,36116,Agence_moov_Abomey,300000,263884,Suzanne Bodin,115782,151898,2022-08-15
CASH_OUT,2914,Suzanne Bodin,151898,148984,Agence_moov_Cotonou,300000,297086,2022-08-17
CASH_IN,200168,Agence_moov_Ouidah,300000,99832,Suzanne Bodin,148984,349152,2022-08-17
CASH_IN,272521,Agence_moov_Cotonou,300000,27479,Suzanne Bodin,349152,621673,2022-08-18
TRANSFER,389062,Suzanne Bodin,621673,232611,Renée Le Diaz,166849,-222213,2022-08-27
CASH_IN,166378,Agence_moov_Ouidah,300000,133622,Frédéric Guillou,-344059,-177681,2022-08-01
CASH_IN,185303,Agence_moov_Abomey,300000,114697,Frédéric Guillou,-177681,7622,2022-08-01
TRANSFER,2396,Frédéric Guillou,7622,5226,Thérèse François,408744,406348,2022-08-02
CASH_OUT,5036,Frédéric Guillou,5226,190,Agence_moov_Ouidah,300000,294964,2022-08-03
CASH_IN,82084,Agence_moov_Abomey,300000,217916,Frédéric Guillou,190,82274,2022-08-05
TRANSFER,1325,Frédéric Guillou,82274,80949,Hélène Le Chauvin,7511,6186,2022-08-06
CASH_IN,184272,Agence_moov_Ouidah,300000,115728,Frédéric Guillou,80949,265221,2022-08-07
CASH_OUT,160289,Frédéric Guillou,265221,104932,Agence_moov_Abomey,300000,139711,2022-08-11
CASH_OUT,91115,Frédéric Guillou,104932,13817,Agence_moov_Abomey,300000,208885,2022-08-11
TRANSFER,1287,Stéphane Munoz,1500,213,Frédéric Guillou,13817,15104,2022-08-15
TRANSFER,8786,Frédéric Guillou,15104,6318,Hélène Le Chauvin,6186,-2600,2022-08-19
TRANSFER,178,Stéphane Munoz,213,35,Frédéric Guillou,6318,6496,2022-08-23
CASH_OUT,4968,Frédéric Guillou,6496,1528,Agence_moov_Ouidah,300000,295032,2022-08-24
CASH_OUT,957,Frédéric Guillou,1528,571,Agence_moov_Ouidah,300000,299043,2022-08-26
TRANSFER,3907,Hélène de la Gérard,4840,933,Frédéric Guillou,571,4478,2022-08-27
CASH_IN,284080,Agence_moov_Ouidah,300000,15920,Benoît Guyot,-132985,151095,2022-08-01
CASH_IN,195259,Agence_moov_Abomey,300000,104741,Benoît Guyot,151095,346354,2022-08-01
TRANSFER,183428,Benoît Guyot,346354,162926,Benoît Guyot,346354,529782,2022-08-03
CASH_OUT,136593,Benoît Guyot,162926,26333,Agence_moov_Ouidah,300000,163407,2022-08-05
CASH_IN,99931,Agence_moov_Abomey,300000,200069,Benoît Guyot,26333,126264,2022-08-06
CASH_OUT,59848,Benoît Guyot,126264,66416,Agence_moov_Ouidah,300000,240152,2022-08-06
CASH_OUT,38904,Benoît Guyot,66416,27512,Agence_moov_Cotonou,300000,261096,2022-08-08
CASH_OUT,14423,Benoît Guyot,27512,13089,Agence_moov_Cotonou,300000,285577,2022-08-08
TRANSFER,10154,Benoît Guyot,13089,2935,Emmanuel Grégoire,11163,1009,2022-08-16
CASH_OUT,617,Benoît Guyot,2935,2318,Agence_moov_Abomey,300000,299383,2022-08-16
CASH_IN,233405,Agence_moov_Abomey,300000,66595,Benoît Guyot,2318,235723,2022-08-18
CASH_OUT,233528,Benoît Guyot,235723,2195,Agence_moov_Cotonou,300000,66472,2022-08-24
CASH_IN,160889,Agence_moov_Ouidah,300000,139111,Benoît Guyot,2195,163084,2022-08-25
CASH_IN,63552,Agence_moov_Cotonou,300000,236448,Benoît Guyot,163084,226636,2022-08-26
CASH_IN,176155,Agence_moov_Ouidah,300000,123845,Jules Fernandes,-105610,70545,2022-08-01
CASH_OUT,67034,Jules Fernandes,70545,3511,Agence_moov_Cotonou,300000,232966,2022-08-01
CASH_IN,253883,Agence_moov_Ouidah,300000,46117,Jules Fernandes,3511,257394,2022-08-04
TRANSFER,73512,Jules Fernandes,257394,183882,Jules Fernandes,257394,183882,2022-08-06
CASH_IN,281007,Agence_moov_Abomey,300000,18993,Jules Fernandes,183882,464889,2022-08-08
CASH_OUT,450966,Jules Fernandes,464889,13923,Agence_moov_Ouidah,300000,-150966,2022-08-11
CASH_OUT,13021,Jules Fernandes,13923,902,Agence_moov_Abomey,300000,286979,2022-08-18
CASH_IN,162494,Agence_moov_Ouidah,300000,137506,Jules Fernandes,902,163396,2022-08-19
TRANSFER,19860,Jules Fernandes,163396,143536,Andrée-Thérèse Mendès,202712,182852,2022-08-20
CASH_OUT,47966,Jules Fernandes,143536,95570,Agence_moov_Ouidah,300000,252034,2022-08-20
CASH_IN,61198,Agence_moov_Cotonou,300000,238802,Jules Fernandes,95570,156768,2022-08-21
TRANSFER,27015,Jules Fernandes,156768,129753,Emmanuel Grégoire,1009,-26006,2022-08-26
TRANSFER,27879,Marc Leleu,229748,201869,Jules Fernandes,129753,157632,2022-08-26
TRANSFER,418,Raymond Lévy,542,124,Antoinette de Dupuis,26055,25637,2022-08-01
CASH_IN,147675,Agence_moov_Cotonou,300000,152325,Raymond Lévy,124,147799,2022-08-02
CASH_OUT,143426,Raymond Lévy,147799,4373,Agence_moov_Abomey,300000,156574,2022-08-02
CASH_OUT,2062,Raymond Lévy,4373,2311,Agence_moov_Ouidah,300000,297938,2022-08-03
CASH_IN,139298,Agence_moov_Cotonou,300000,160702,Raymond Lévy,2311,141609,2022-08-04
CASH_OUT,29216,Raymond Lévy,141609,112393,Agence_moov_Cotonou,300000,270784,2022-08-06
CASH_OUT,25035,Raymond Lévy,112393,87358,Agence_moov_Abomey,300000,274965,2022-08-07
CASH_OUT,58530,Raymond Lévy,87358,28828,Agence_moov_Abomey,300000,241470,2022-08-14
CASH_OUT,1284,Raymond Lévy,28828,27544,Agence_moov_Abomey,300000,298716,2022-08-16
TRANSFER,13098,Antoinette de Dupuis,25637,12539,Raymond Lévy,27544,40642,2022-08-16
CASH_OUT,6293,Raymond Lévy,40642,34349,Agence_moov_Ouidah,300000,293707,2022-08-21
CASH_OUT,10103,Raymond Lévy,34349,24246,Agence_moov_Abomey,300000,289897,2022-08-22
CASH_IN,246391,Agence_moov_Cotonou,300000,53609,Raymond Lévy,24246,270637,2022-08-23
CASH_IN,70601,Agence_moov_Abomey,300000,229399,Martine Aubert,-102645,-32044,2022-08-01
CASH_IN,220898,Agence_moov_Abomey,300000,79102,Martine Aubert,-32044,188854,2022-08-03
TRANSFER,171117,Martine Aubert,188854,17737,Antoinette de Dupuis,12539,-158578,2022-08-04
CASH_IN,3934,Agence_moov_Abomey,300000,296066,Martine Aubert,17737,21671,2022-08-05
TRANSFER,19749,Martine Aubert,21671,1922,Hélène de la Gérard,933,-18816,2022-08-08
CASH_OUT,1684,Martine Aubert,1922,238,Agence_moov_Ouidah,300000,298316,2022-08-10
CASH_IN,59810,Agence_moov_Cotonou,300000,240190,Martine Aubert,238,60048,2022-08-11
CASH_OUT,59888,Martine Aubert,60048,160,Agence_moov_Cotonou,300000,240112,2022-08-13
CASH_OUT,126,Martine Aubert,160,34,Agence_moov_Cotonou,300000,299874,2022-08-20
CASH_IN,156019,Agence_moov_Ouidah,300000,143981,Martine Aubert,34,156053,2022-08-20
TRANSFER,137506,Martine Aubert,156053,18547,Thérèse François,406348,268842,2022-08-22
CASH_IN,18047,Agence_moov_Cotonou,300000,281953,Martine Aubert,18547,36594,2022-08-22
CASH_OUT,17933,Martine Aubert,36594,18661,Agence_moov_Cotonou,300000,282067,2022-08-23
CASH_OUT,10722,Martine Aubert,18661,7939,Agence_moov_Ouidah,300000,289278,2022-08-24
TRANSFER,96158,Thérèse François,268842,172684,Martine Aubert,7939,104097,2022-08-25
CASH_IN,192490,Agence_moov_Ouidah,300000,107510,Martine Aubert,104097,296587,2022-08-26
CASH_IN,85543,Agence_moov_Ouidah,300000,214457,Virginie Bouvet,-145442,-59899,2022-08-01
CASH_IN,66622,Agence_moov_Abomey,300000,233378,Virginie Bouvet,-59899,6723,2022-08-02
TRANSFER,733,Virginie Bouvet,6723,5990,Virginie Bouvet,6723,5990,2022-08-02
CASH_OUT,4753,Virginie Bouvet,5990,1237,Agence_moov_Ouidah,300000,295247,2022-08-07
TRANSFER,947,Virginie Bouvet,1237,290,Thérèse François,172684,171737,2022-08-13
CASH_OUT,197,Virginie Bouvet,290,93,Agence_moov_Ouidah,300000,299803,2022-08-15
CASH_IN,42235,Agence_moov_Ouidah,300000,257765,Virginie Bouvet,93,42328,2022-08-22
CASH_IN,55298,Agence_moov_Cotonou,300000,244702,Antoinette de Dupuis,-158578,-103280,2022-08-03
CASH_IN,274750,Agence_moov_Abomey,300000,25250,Antoinette de Dupuis,-103280,171470,2022-08-03
TRANSFER,176154,Andrée-Thérèse Mendès,182852,6698,Antoinette de Dupuis,171470,347624,2022-08-06
TRANSFER,255023,Antoinette de Dupuis,347624,92601,Antoinette de Dupuis,347624,92601,2022-08-09
CASH_IN,210881,Agence_moov_Ouidah,300000,89119,Antoinette de Dupuis,92601,303482,2022-08-16
CASH_IN,36423,Agence_moov_Abomey,300000,263577,Antoinette de Dupuis,303482,339905,2022-08-16
TRANSFER,90036,Antoinette de Dupuis,339905,249869,Antoinette de Dupuis,339905,249869,2022-08-16
CASH_IN,211082,Agence_moov_Cotonou,300000,88918,Antoinette de Dupuis,249869,460951,2022-08-18
CASH_IN,195969,Agence_moov_Cotonou,300000,104031,Antoinette de Dupuis,460951,656920,2022-08-18
CASH_OUT,62204,Antoinette de Dupuis,656920,594716,Agence_moov_Cotonou,300000,237796,2022-08-19
TRANSFER,42978,Marc Leleu,201869,158891,Antoinette de Dupuis,594716,637694,2022-08-19
CASH_IN,173767,Agence_moov_Cotonou,300000,126233,Antoinette de Dupuis,637694,811461,2022-08-22
CASH_IN,12748,Agence_moov_Abomey,300000,287252,Antoinette de Dupuis,811461,824209,2022-08-23
TRANSFER,460036,Antoinette de Dupuis,824209,364173,Andrée-Thérèse Mendès,6698,-453338,2022-08-23
CASH_OUT,305419,Antoinette de Dupuis,364173,58754,Agence_moov_Cotonou,300000,-5419,2022-08-24
CASH_OUT,26508,Antoinette de Dupuis,58754,32246,Agence_moov_Ouidah,300000,273492,2022-08-26
CASH_IN,176337,Agence_moov_Cotonou,300000,123663,Antoinette de Dupuis,32246,208583,2022-08-27
CASH_IN,173995,Agence_moov_Cotonou,300000,126005,Andrée-Thérèse Mendès,-453338,-279343,2022-08-08
CASH_IN,82465,Agence_moov_Abomey,300000,217535,Andrée-Thérèse Mendès,-279343,-196878,2022-08-09
CASH_IN,184910,Agence_moov_Ouidah,300000,115090,Andrée-Thérèse Mendès,-196878,-11968,2022-08-11
CASH_IN,59246,Agence_moov_Cotonou,300000,240754,Andrée-Thérèse Mendès,-11968,47278,2022-08-19
CASH_OUT,28737,Andrée-Thérèse Mendès,47278,18541,Agence_moov_Abomey,300000,271263,2022-08-23
CASH_IN,116513,Agence_moov_Abomey,300000,183487,Andrée-Thérèse Mendès,18541,135054,2022-08-25
CASH_IN,68590,Agence_moov_Cotonou,300000,231410,Andrée-Thérèse Mendès,135054,203644,2022-08-25
CASH_OUT,102704,Thérèse François,171737,69033,Agence_moov_Cotonou,300000,197296,2022-08-01
TRANSFER,11035,Marc Leleu,158891,147856,Thérèse François,69033,80068,2022-08-02
CASH_IN,151615,Agence_moov_Abomey,300000,148385,Thérèse François,80068,231683,2022-08-06
CASH_OUT,168987,Thérèse François,231683,62696,Agence_moov_Cotonou,300000,131013,2022-08-08
CASH_IN,292673,Agence_moov_Cotonou,300000,7327,Thérèse François,62696,355369,2022-08-09
TRANSFER,71301,Thérèse François,355369,284068,Marc Leleu,147856,76555,2022-08-10
CASH_IN,146068,Agence_moov_Ouidah,300000,153932,Thérèse François,284068,430136,2022-08-13
CASH_OUT,255036,Thérèse François,430136,175100,Agence_moov_Cotonou,300000,44964,2022-08-14
CASH_IN,280046,Agence_moov_Cotonou,300000,19954,Thérèse François,175100,455146,2022-08-15
TRANSFER,58800,Marc Leleu,76555,17755,Thérèse François,455146,513946,2022-08-20
CASH_OUT,187892,Thérèse François,513946,326054,Agence_moov_Ouidah,300000,112108,2022-08-21
TRANSFER,101112,Thérèse François,326054,224942,Marc Leleu,17755,-83357,2022-08-26
CASH_IN,149924,Agence_moov_Ouidah,300000,150076,Anne Peltier-Raynaud,-117179,32745,2022-08-02
CASH_IN,99950,Agence_moov_Abomey,300000,200050,Anne Peltier-Raynaud,32745,132695,2022-08-03
TRANSFER,97715,Anne Peltier-Raynaud,132695,34980,Anne Peltier-Raynaud,132695,34980,2022-08-06
CASH_IN,84316,Agence_moov_Cotonou,300000,215684,Anne Peltier-Raynaud,34980,119296,2022-08-06
CASH_IN,5573,Agence_moov_Cotonou,300000,294427,Anne Peltier-Raynaud,119296,124869,2022-08-07
TRANSFER,113057,Anne Peltier-Raynaud,124869,11812,Anne Peltier-Raynaud,124869,11812,2022-08-08
CASH_OUT,4170,Anne Peltier-Raynaud,11812,7642,Agence_moov_Abomey,300000,295830,2022-08-14
CASH_OUT,836,Anne Peltier-Raynaud,7642,6806,Agence_moov_Ouidah,300000,299164,2022-08-16
TRANSFER,2278,Anne Peltier-Raynaud,6806,4528,Anne Peltier-Raynaud,6806,4528,2022-08-17
CASH_OUT,351,Anne Peltier-Raynaud,4528,4177,Agence_moov_Abomey,300000,299649,2022-08-19
CASH_OUT,3887,Anne Peltier-Raynaud,4177,290,Agence_moov_Abomey,300000,296113,2022-08-21
CASH_IN,50851,Agence_moov_Abomey,300000,249149,Alphonse Joly,-60856,-10005,2022-08-05
CASH_IN,56674,Agence_moov_Cotonou,300000,243326,Alphonse Joly,-10005,46669,2022-08-15
TRANSFER,2376,Alphonse Joly,46669,44293,Alphonse Joly,46669,44293,2022-08-18
CASH_OUT,25935,Alphonse Joly,44293,18358,Agence_moov_Cotonou,300000,274065,2022-08-18
CASH_OUT,7610,Alphonse Joly,18358,10748,Agence_moov_Cotonou,300000,292390,2022-08-19
CASH_IN,72811,Agence_moov_Ouidah,300000,227189,Alphonse Joly,10748,83559,2022-08-27
CASH_IN,94798,Agence_moov_Ouidah,300000,205202,Luc Lévêque-Carre,-87314,7484,2022-08-03
CASH_IN,224446,Agence_moov_Ouidah,300000,75554,Luc Lévêque-Carre,7484,231930,2022-08-11
CASH_OUT,60092,Luc Lévêque-Carre,231930,171838,Agence_moov_Ouidah,300000,239908,2022-08-11
TRANSFER,2407,Luc Lévêque-Carre,171838,169431,Luc Lévêque-Carre,171838,174245,2022-08-12
CASH_IN,220874,Agence_moov_Cotonou,300000,79126,Luc Lévêque-Carre,169431,390305,2022-08-14
CASH_OUT,67069,Luc Lévêque-Carre,390305,323236,Agence_moov_Cotonou,300000,232931,2022-08-18
CASH_IN,238281,Agence_moov_Cotonou,300000,61719,Luc Lévêque-Carre,323236,561517,2022-08-18
CASH_IN,249220,Agence_moov_Cotonou,300000,50780,Luc Lévêque-Carre,561517,810737,2022-08-21
CASH_IN,31616,Agence_moov_Cotonou,300000,268384,Luc Lévêque-Carre,810737,842353,2022-08-22
CASH_IN,204729,Agence_moov_Cotonou,300000,95271,Luc Lévêque-Carre,842353,1047082,2022-08-24
CASH_IN,143446,Agence_moov_Abomey,300000,156554,Lucy Gillet,-12605,130841,2022-08-04
CASH_IN,39839,Agence_moov_Ouidah,300000,260161,Lucy Gillet,130841,170680,2022-08-05
CASH_OUT,116655,Lucy Gillet,170680,54025,Agence_moov_Ouidah,300000,183345,2022-08-08
TRANSFER,6291,Lucy Gillet,54025,47734,Lucy Gillet,54025,60316,2022-08-08
TRANSFER,45369,Lucy Gillet,47734,2365,Lucy Gillet,47734,93103,2022-08-09
TRANSFER,2185,Lucy Gillet,2365,180,Lucy Gillet,2365,4550,2022-08-10
CASH_OUT,160,Lucy Gillet,180,20,Agence_moov_Abomey,300000,299840,2022-08-14
CASH_IN,251337,Agence_moov_Cotonou,300000,48663,Lucy Gillet,20,251357,2022-08-14
CASH_IN,100599,Agence_moov_Abomey,300000,199401,Lucy Gillet,251357,351956,2022-08-18
CASH_IN,298221,Agence_moov_Cotonou,300000,1779,Michelle de Étienne,-251135,47086,2022-08-05
CASH_OUT,24763,Michelle de Étienne,47086,22323,Agence_moov_Ouidah,300000,275237,2022-08-07
TRANSFER,4585,Michelle de Étienne,22323,17738,Michelle de Étienne,22323,26908,2022-08-07
CASH_OUT,12936,Michelle de Étienne,17738,4802,Agence_moov_Ouidah,300000,287064,2022-08-11
CASH_IN,277509,Agence_moov_Ouidah,300000,22491,Michelle de Étienne,4802,282311,2022-08-20
CASH_OUT,217900,Michelle de Étienne,282311,64411,Agence_moov_Cotonou,300000,82100,2022-08-22
CASH_IN,17448,Agence_moov_Ouidah,300000,282552,Stéphane Munoz,35,17483,2022-08-09
CASH_OUT,7693,Stéphane Munoz,17483,9790,Agence_moov_Abomey,300000,292307,2022-08-09
CASH_IN,225186,Agence_moov_Abomey,300000,74814,Stéphane Munoz,9790,234976,2022-08-13
CASH_IN,58654,Agence_moov_Abomey,300000,241346,Stéphane Munoz,234976,293630,2022-08-13
CASH_OUT,192437,Stéphane Munoz,293630,101193,Agence_moov_Abomey,300000,107563,2022-08-26
CASH_IN,26721,Agence_moov_Cotonou,300000,273279,Robert-Louis Gosselin,-1609793,-1583072,2022-08-03
CASH_IN,35170,Agence_moov_Abomey,300000,264830,Robert-Louis Gosselin,-1583072,-1547902,2022-08-03
CASH_IN,43673,Agence_moov_Abomey,300000,256327,Robert-Louis Gosselin,-1547902,-1504229,2022-08-03
CASH_IN,194114,Agence_moov_Cotonou,300000,105886,Robert-Louis Gosselin,-1504229,-1310115,2022-08-05
CASH_IN,211079,Agence_moov_Abomey,300000,88921,Robert-Louis Gosselin,-1310115,-1099036,2022-08-05
CASH_IN,62071,Agence_moov_Abomey,300000,237929,Robert-Louis Gosselin,-1099036,-1036965,2022-08-07
CASH_IN,136242,Agence_moov_Abomey,300000,163758,Robert-Louis Gosselin,-1036965,-900723,2022-08-10
CASH_IN,174896,Agence_moov_Ouidah,300000,125104,Robert-Louis Gosselin,-900723,-725827,2022-08-17
CASH_IN,189815,Agence_moov_Cotonou,300000,110185,Robert-Louis Gosselin,-725827,-536012,2022-08-20
CASH_IN,180331,Agence_moov_Cotonou,300000,119669,Robert-Louis Gosselin,-536012,-355681,2022-08-21
CASH_IN,267423,Agence_moov_Ouidah,300000,32577,Robert-Louis Gosselin,-355681,-88258,2022-08-23
CASH_IN,18198,Agence_moov_Cotonou,300000,281802,Robert-Louis Gosselin,-88258,-70060,2022-08-24
CASH_IN,79516,Agence_moov_Abomey,300000,220484,Robert-Louis Gosselin,-70060,9456,2022-08-24
CASH_IN,34710,Agence_moov_Ouidah,300000,265290,Robert-Louis Gosselin,9456,44166,2022-08-26
CASH_IN,1974,Agence_moov_Abomey,300000,298026,Renée Le Diaz,-222213,-220239,2022-08-06
CASH_IN,288555,Agence_moov_Abomey,300000,11445,Renée Le Diaz,-220239,68316,2022-08-11
TRANSFER,24153,Renée Le Diaz,68316,44163,Renée Le Diaz,68316,44163,2022-08-12
CASH_OUT,23088,Renée Le Diaz,44163,21075,Agence_moov_Ouidah,300000,276912,2022-08-14
CASH_IN,189529,Agence_moov_Abomey,300000,110471,Renée Le Diaz,21075,210604,2022-08-16
CASH_IN,34010,Agence_moov_Ouidah,300000,265990,Renée Le Diaz,210604,244614,2022-08-23
CASH_IN,174262,Agence_moov_Ouidah,300000,125738,Renée Le Diaz,244614,418876,2022-08-26
CASH_IN,120376,Agence_moov_Cotonou,300000,179624,Renée Le Diaz,418876,539252,2022-08-27
CASH_IN,127302,Agence_moov_Ouidah,300000,172698,Vincent de la Dumont,-32522,94780,2022-08-03
CASH_IN,254613,Agence_moov_Abomey,300000,45387,Vincent de la Dumont,94780,349393,2022-08-05
CASH_IN,119927,Agence_moov_Cotonou,300000,180073,Vincent de la Dumont,349393,469320,2022-08-05
CASH_IN,197798,Agence_moov_Abomey,300000,102202,Vincent de la Dumont,469320,667118,2022-08-07
CASH_OUT,278660,Vincent de la Dumont,667118,388458,Agence_moov_Cotonou,300000,21340,2022-08-09
CASH_IN,179464,Agence_moov_Cotonou,300000,120536,Vincent de la Dumont,388458,567922,2022-08-10
CASH_OUT,303235,Vincent de la Dumont,567922,264687,Agence_moov_Abomey,300000,-3235,2022-08-24
CASH_IN,229395,Agence_moov_Ouidah,300000,70605,Hélène de la Gérard,-18816,210579,2022-08-03
TRANSFER,136649,Hélène de la Gérard,210579,73930,Hélène de la Gérard,210579,347228,2022-08-03
CASH_OUT,64823,Hélène de la Gérard,73930,9107,Agence_moov_Abomey,300000,235177,2022-08-04
TRANSFER,7744,Hélène de la Gérard,9107,1363,Hélène de la Gérard,9107,1363,2022-08-05
CASH_IN,67447,Agence_moov_Abomey,300000,232553,Hélène de la Gérard,1363,68810,2022-08-07
CASH_IN,298733,Agence_moov_Abomey,300000,1267,Hélène de la Gérard,68810,367543,2022-08-10
TRANSFER,331002,Hélène de la Gérard,367543,36541,Hélène de la Gérard,367543,36541,2022-08-13
CASH_IN,47889,Agence_moov_Cotonou,300000,252111,Hélène de la Gérard,36541,84430,2022-08-14
CASH_OUT,45199,Hélène de la Gérard,84430,39231,Agence_moov_Cotonou,300000,254801,2022-08-15
CASH_IN,49878,Agence_moov_Abomey,300000,250122,Hélène de la Gérard,39231,89109,2022-08-15
CASH_IN,180389,Agence_moov_Ouidah,300000,119611,Hélène de la Gérard,89109,269498,2022-08-15
CASH_IN,144691,Agence_moov_Ouidah,300000,155309,Hélène de la Gérard,269498,414189,2022-08-22
CASH_OUT,32521,Hélène de la Gérard,414189,381668,Agence_moov_Cotonou,300000,267479,2022-08-22
CASH_IN,65122,Agence_moov_Cotonou,300000,234878,Hélène de la Gérard,381668,446790,2022-08-24
CASH_OUT,372675,Hélène de la Gérard,446790,74115,Agence_moov_Ouidah,300000,-72675,2022-08-25
CASH_IN,277138,Agence_moov_Ouidah,300000,22862,Hélène de la Gérard,74115,351253,2022-08-25
CASH_IN,191228,Agence_moov_Abomey,300000,108772,Hélène de la Gérard,351253,542481,2022-08-25
CASH_IN,69648,Agence_moov_Abomey,300000,230352,Hélène de la Gérard,542481,612129,2022-08-27
CASH_IN,126107,Agence_moov_Ouidah,300000,173893,Manon Valette,-77891,48216,2022-08-01
TRANSFER,20060,Manon Valette,48216,28156,Manon Valette,48216,28156,2022-08-04
CASH_OUT,27948,Manon Valette,28156,208,Agence_moov_Ouidah,300000,272052,2022-08-06
TRANSFER,206,Manon Valette,208,2,Manon Valette,208,414,2022-08-09
CASH_IN,44573,Agence_moov_Cotonou,300000,255427,Manon Valette,2,44575,2022-08-10
TRANSFER,26034,Manon Valette,44575,18541,Manon Valette,44575,18541,2022-08-11
CASH_IN,234447,Agence_moov_Cotonou,300000,65553,Manon Valette,18541,252988,2022-08-13
CASH_IN,58438,Agence_moov_Cotonou,300000,241562,Manon Valette,252988,311426,2022-08-13
CASH_IN,21537,Agence_moov_Cotonou,300000,278463,Manon Valette,311426,332963,2022-08-16
CASH_OUT,68866,Manon Valette,332963,264097,Agence_moov_Abomey,300000,231134,2022-08-18
CASH_OUT,114566,Manon Valette,264097,149531,Agence_moov_Abomey,300000,185434,2022-08-19
CASH_IN,83804,Agence_moov_Cotonou,300000,216196,Manon Valette,149531,233335,2022-08-20
CASH_OUT,100972,Manon Valette,233335,132363,Agence_moov_Abomey,300000,199028,2022-08-22
CASH_IN,226037,Agence_moov_Cotonou,300000,73963,Camille Morvan,-36669,189368,2022-08-02
TRANSFER,116762,Camille Morvan,189368,72606,Camille Morvan,189368,72606,2022-08-04
TRANSFER,44313,Camille Morvan,72606,28293,Camille Morvan,72606,116919,2022-08-06
CASH_OUT,26386,Camille Morvan,28293,1907,Agence_moov_Abomey,300000,273614,2022-08-06
CASH_OUT,377,Camille Morvan,1907,1530,Agence_moov_Ouidah,300000,299623,2022-08-15
CASH_OUT,1387,Camille Morvan,1530,143,Agence_moov_Ouidah,300000,298613,2022-08-18
CASH_OUT,119,Camille Morvan,143,24,Agence_moov_Ouidah,300000,299881,2022-08-24
CASH_IN,4969,Agence_moov_Abomey,300000,295031,Emmanuel Grégoire,-26006,-21037,2022-08-01
CASH_IN,20299,Agence_moov_Cotonou,300000,279701,Emmanuel Grégoire,-21037,-738,2022-08-01
CASH_IN,35212,Agence_moov_Cotonou,300000,264788,Emmanuel Grégoire,-738,34474,2022-08-03
TRANSFER,18306,Emmanuel Grégoire,34474,16168,Emmanuel Grégoire,34474,52780,2022-08-04
CASH_IN,56891,Agence_moov_Cotonou,300000,243109,Emmanuel Grégoire,16168,73059,2022-08-05
CASH_OUT,56594,Emmanuel Grégoire,73059,16465,Agence_moov_Cotonou,300000,243406,2022-08-06
CASH_OUT,13311,Emmanuel Grégoire,16465,3154,Agence_moov_Abomey,300000,286689,2022-08-06
CASH_OUT,575,Emmanuel Grégoire,3154,2579,Agence_moov_Abomey,300000,299425,2022-08-07
CASH_IN,39163,Agence_moov_Cotonou,300000,260837,Emmanuel Grégoire,2579,41742,2022-08-07
TRANSFER,15137,Emmanuel Grégoire,41742,26605,Emmanuel Grégoire,41742,56879,2022-08-10
CASH_IN,256277,Agence_moov_Cotonou,300000,43723,Emmanuel Grégoire,26605,282882,2022-08-12
CASH_OUT,162391,Emmanuel Grégoire,282882,120491,Agence_moov_Cotonou,300000,137609,2022-08-14
CASH_OUT,68405,Emmanuel Grégoire,120491,52086,Agence_moov_Cotonou,300000,231595,2022-08-16
CASH_IN,16523,Agence_moov_Abomey,300000,283477,Emmanuel Grégoire,52086,68609,2022-08-19
CASH_OUT,61282,Emmanuel Grégoire,68609,7327,Agence_moov_Abomey,300000,238718,2022-08-20
CASH_OUT,2481,Emmanuel Grégoire,7327,4846,Agence_moov_Cotonou,300000,297519,2022-08-21
CASH_IN,4003,Agence_moov_Abomey,300000,295997,Emmanuel Grégoire,4846,8849,2022-08-22
CASH_IN,46853,Agence_moov_Cotonou,300000,253147,Hélène Le Chauvin,-2600,44253,2022-08-02
CASH_OUT,37749,Hélène Le Chauvin,44253,6504,Agence_moov_Ouidah,300000,262251,2022-08-02
TRANSFER,5243,Hélène Le Chauvin,6504,1261,Hélène Le Chauvin,6504,11747,2022-08-04
TRANSFER,230,Hélène Le Chauvin,1261,1031,Hélène Le Chauvin,1261,1491,2022-08-04
CASH_OUT,256,Hélène Le Chauvin,1031,775,Agence_moov_Ouidah,300000,299744,2022-08-08
CASH_OUT,487,Hélène Le Chauvin,775,288,Agence_moov_Ouidah,300000,299513,2022-08-11
CASH_IN,29863,Agence_moov_Ouidah,300000,270137,Hélène Le Chauvin,288,30151,2022-08-13
CASH_IN,164942,Agence_moov_Abomey,300000,135058,Hélène Le Chauvin,30151,195093,2022-08-14
CASH_IN,183419,Agence_moov_Cotonou,300000,116581,Hélène Le Chauvin,195093,378512,2022-08-18
CASH_OUT,243633,Hélène Le Chauvin,378512,134879,Agence_moov_Abomey,300000,56367,2022-08-22
CASH_OUT,101517,Hélène Le Chauvin,134879,33362,Agence_moov_Ouidah,300000,198483,2022-08-23
CASH_OUT,18216,Hélène Le Chauvin,33362,15146,Agence_moov_Ouidah,300000,281784,2022-08-25
CASH_IN,68485,Agence_moov_Cotonou,300000,231515,Vincent Joubert,-2468,66017,2022-08-06
CASH_IN,22101,Agence_moov_Cotonou,300000,277899,Vincent Joubert,66017,88118,2022-08-13
TRANSFER,1627,Vincent Joubert,88118,86491,Vincent Joubert,88118,89745,2022-08-19
CASH_IN,276679,Agence_moov_Ouidah,300000,23321,Vincent Joubert,86491,363170,2022-08-21
CASH_IN,284028,Agence_moov_Ouidah,300000,15972,Alix Barbe,-56528,227500,2022-08-01
CASH_IN,169792,Agence_moov_Ouidah,300000,130208,Alix Barbe,227500,397292,2022-08-05
CASH_OUT,374609,Alix Barbe,397292,22683,Agence_moov_Abomey,300000,-74609,2022-08-07
CASH_IN,125294,Agence_moov_Cotonou,300000,174706,Alix Barbe,22683,147977,2022-08-09
CASH_OUT,28454,Alix Barbe,147977,119523,Agence_moov_Cotonou,300000,271546,2022-08-13
CASH_OUT,101968,Alix Barbe,119523,17555,Agence_moov_Cotonou,300000,198032,2022-08-13
TRANSFER,13836,Alix Barbe,17555,3719,Alix Barbe,17555,3719,2022-08-13
CASH_OUT,3248,Alix Barbe,3719,471,Agence_moov_Abomey,300000,296752,2022-08-16
CASH_OUT,301,Alix Barbe,471,170,Agence_moov_Ouidah,300000,299699,2022-08-16
TRANSFER,103,Alix Barbe,170,67,Alix Barbe,170,67,2022-08-17
CASH_IN,77363,Agence_moov_Ouidah,300000,222637,Alix Barbe,67,77430,2022-08-19
CASH_IN,209264,Agence_moov_Abomey,300000,90736,Alix Barbe,77430,286694,2022-08-19
CASH_IN,251434,Agence_moov_Ouidah,300000,48566,Alix Barbe,286694,538128,2022-08-22
CASH_OUT,217099,Alix Barbe,538128,321029,Agence_moov_Abomey,300000,82901,2022-08-24
CASH_IN,8992,Agence_moov_Cotonou,300000,291008,Alix Barbe,321029,330021,2022-08-24
CASH_OUT,104296,Alix Barbe,330021,225725,Agence_moov_Ouidah,300000,195704,2022-08-24
CASH_IN,107903,Agence_moov_Abomey,300000,192097,Christine Texier,-177820,-69917,2022-08-04
CASH_IN,75708,Agence_moov_Cotonou,300000,224292,Christine Texier,-69917,5791,2022-08-05
TRANSFER,1564,Christine Texier,5791,4227,Christine Texier,5791,4227,2022-08-09
CASH_IN,271508,Agence_moov_Abomey,300000,28492,Christine Texier,4227,275735,2022-08-10
CASH_OUT,64836,Christine Texier,275735,210899,Agence_moov_Abomey,300000,235164,2022-08-12
CASH_OUT,137450,Christine Texier,210899,73449,Agence_moov_Abomey,300000,162550,2022-08-14
CASH_OUT,41944,Christine Texier,73449,31505,Agence_moov_Abomey,300000,258056,2022-08-26
CASH_IN,64903,Agence_moov_Cotonou,300000,235097,Marc Leleu,-83357,-18454,2022-08-02
CASH_IN,116819,Agence_moov_Ouidah,300000,183181,Marc Leleu,-18454,98365,2022-08-06
CASH_OUT,79435,Marc Leleu,98365,18930,Agence_moov_Abomey,300000,220565,2022-08-07
CASH_OUT,16149,Marc Leleu,18930,2781,Agence_moov_Abomey,300000,283851,2022-08-09
CASH_IN,282870,Agence_moov_Cotonou,300000,17130,Marc Leleu,2781,285651,2022-08-13
CASH_OUT,33423,Marc Leleu,285651,252228,Agence_moov_Cotonou,300000,266577,2022-08-20
CASH_IN,12547,Agence_moov_Abomey,300000,287453,Marc Leleu,252228,264775,2022-08-21
CASH_OUT,31574,Marc Leleu,264775,233201,Agence_moov_Abomey,300000,268426,2022-08-26
CASH_IN,233157,Agence_moov_Abomey,300000,66843,Sabine Pineau,-624398,-391241,2022-08-04
CASH_IN,278768,Agence_moov_Cotonou,300000,21232,Sabine Pineau,-391241,-112473,2022-08-05
CASH_IN,221753,Agence_moov_Cotonou,300000,78247,Sabine Pineau,-112473,109280,2022-08-06
TRANSFER,81662,Sabine Pineau,109280,27618,Sabine Pineau,109280,27618,2022-08-06
TRANSFER,9868,Sabine Pineau,27618,17750,Sabine Pineau,27618,17750,2022-08-07
CASH_OUT,13666,Sabine Pineau,17750,4084,Agence_moov_Ouidah,300000,286334,2022-08-07
CASH_IN,127575,Agence_moov_Abomey,300000,172425,Sabine Pineau,4084,131659,2022-08-14
CASH_IN,240872,Agence_moov_Cotonou,300000,59128,Sabine Pineau,131659,372531,2022-08-20
CASH_OUT,276274,Sabine Pineau,372531,96257,Agence_moov_Ouidah,300000,23726,2022-08-26
CASH_OUT,91862,Sabine Pineau,96257,4395,Agence_moov_Cotonou,300000,208138,2022-08-27
CASH_IN,89030,Agence_moov_Ouidah,300000,210970,Mathilde Picard du Delmas,-1237576,-1148546,2022-08-07
CASH_IN,12800,Agence_moov_Ouidah,300000,287200,Mathilde Picard du Delmas,-1148546,-1135746,2022-08-08
CASH_IN,151215,Agence_moov_Abomey,300000,148785,Mathilde Picard du Delmas,-1135746,-984531,2022-08-09
CASH_IN,79919,Agence_moov_Abomey,300000,220081,Mathilde Picard du Delmas,-984531,-904612,2022-08-11
CASH_IN,184471,Agence_moov_Ouidah,300000,115529,Mathilde Picard du Delmas,-904612,-720141,2022-08-14
CASH_IN,213400,Agence_moov_Ouidah,300000,86600,Mathilde Picard du Delmas,-720141,-506741,2022-08-14
CASH_IN,79657,Agence_moov_Ouidah,300000,220343,Mathilde Picard du Delmas,-506741,-427084,2022-08-18
CASH_IN,170417,Agence_moov_Abomey,300000,129583,Mathilde Picard du Delmas,-427084,-256667,2022-08-22
CASH_IN,188212,Agence_moov_Cotonou,300000,111788,Mathilde Picard du Delmas,-256667,-68455,2022-08-25
CASH_IN,40663,Agence_moov_Cotonou,300000,259337,André Renault,-28858,11805,2022-08-02
CASH_OUT,6630,André Renault,11805,5175,Agence_moov_Ouidah,300000,293370,2022-08-03
CASH_OUT,2146,André Renault,5175,3029,Agence_moov_Abomey,300000,297854,2022-08-15
CASH_IN,251336,Agence_moov_Cotonou,300000,48664,André Renault,3029,254365,2022-08-15
CASH_OUT,53447,André Renault,254365,200918,Agence_moov_Ouidah,300000,246553,2022-08-19
CASH_IN,18733,Agence_moov_Abomey,300000,281267,André Renault,200918,219651,2022-08-23
CASH_IN,156160,Agence_moov_Ouidah,300000,143840,Maggie Martinez,-67556,88604,2022-08-12
TRANSFER,33743,Maggie Martinez,88604,54861,Maggie Martinez,88604,122347,2022-08-13
CASH_OUT,43805,Maggie Martinez,54861,11056,Agence_moov_Cotonou,300000,256195,2022-08-15
CASH_IN,94512,Agence_moov_Cotonou,300000,205488,Maggie Martinez,11056,105568,2022-08-16
CASH_OUT,96072,Maggie Martinez,105568,9496,Agence_moov_Ouidah,300000,203928,2022-08-20
CASH_OUT,4939,Maggie Martinez,9496,4557,Agence_moov_Cotonou,300000,295061,2022-08-24
CASH_IN,282357,Agence_moov_Cotonou,300000,17643,Maggie Martinez,4557,286914,2022-08-25
CASH_IN,172563,Agence_moov_Cotonou,300000,127437,Maggie Martinez,286914,459477,2022-08-27
CASH_IN,209600,Agence_moov_Cotonou,300000,90400,Marcelle-Valentine Guibert,-89917,119683,2022-08-05
TRANSFER,18073,Marcelle-Valentine Guibert,119683,101610,Marcelle-Valentine Guibert,119683,101610,2022-08-07
CASH_OUT,81364,Marcelle-Valentine Guibert,101610,20246,Agence_moov_Abomey,300000,218636,2022-08-09
TRANSFER,19537,Marcelle-Valentine Guibert,20246,709,Marcelle-Valentine Guibert,20246,39783,2022-08-11
CASH_IN,170251,Agence_moov_Ouidah,300000,129749,Marcelle-Valentine Guibert,709,170960,2022-08-13
TRANSFER,132000,Marcelle-Valentine Guibert,170960,38960,Marcelle-Valentine Guibert,170960,302960,2022-08-13
CASH_OUT,4042,Marcelle-Valentine Guibert,38960,34918,Agence_moov_Cotonou,300000,295958,2022-08-15
CASH_IN,104937,Agence_moov_Cotonou,300000,195063,Marcelle-Valentine Guibert,34918,139855,2022-08-15
CASH_OUT,60176,Marcelle-Valentine Guibert,139855,79679,Agence_moov_Abomey,300000,239824,2022-08-15
CASH_OUT,39159,Marcelle-Valentine Guibert,79679,40520,Agence_moov_Abomey,300000,260841,2022-08-16
CASH_OUT,17860,Marcelle-Valentine Guibert,40520,22660,Agence_moov_Cotonou,300000,282140,2022-08-18
CASH_OUT,14727,Marcelle-Valentine Guibert,22660,7933,Agence_moov_Abomey,300000,285273,2022-08-18
CASH_IN,289264,Agence_moov_Abomey,300000,10736,Marcelle-Valentine Guibert,7933,297197,2022-08-23
CASH_OUT,137068,Marcelle-Valentine Guibert,297197,160129,Agence_moov_Ouidah,300000,162932,2022-08-24
CASH_IN,41772,Agence_moov_Ouidah,300000,258228,Michelle Samson,-357242,-315470,2022-08-04
CASH_IN,124050,Agence_moov_Cotonou,300000,175950,Michelle Samson,-315470,-191420,2022-08-06
CASH_IN,82769,Agence_moov_Cotonou,300000,217231,Michelle Samson,-191420,-108651,2022-08-09
CASH_IN,9508,Agence_moov_Ouidah,300000,290492,Michelle Samson,-108651,-99143,2022-08-09
CASH_IN,262806,Agence_moov_Abomey,300000,37194,Michelle Samson,-99143,163663,2022-08-11
CASH_OUT,128565,Michelle Samson,163663,35098,Agence_moov_Ouidah,300000,171435,2022-08-11
CASH_OUT,1580,Michelle Samson,35098,33518,Agence_moov_Ouidah,300000,298420,2022-08-12
CASH_OUT,13223,Michelle Samson,33518,20295,Agence_moov_Ouidah,300000,286777,2022-08-13
TRANSFER,12750,Michelle Samson,20295,7545,Michelle Samson,20295,33045,2022-08-14
CASH_OUT,1061,Michelle Samson,7545,6484,Agence_moov_Ouidah,300000,298939,2022-08-14
TRANSFER,2730,Michelle Samson,6484,3754,Michelle Samson,6484,3754,2022-08-17
CASH_IN,88023,Agence_moov_Abomey,300000,211977,Michelle Samson,3754,91777,2022-08-18
CASH_OUT,90194,Michelle Samson,91777,1583,Agence_moov_Ouidah,300000,209806,2022-08-18
CASH_IN,81171,Agence_moov_Ouidah,300000,218829,Michelle Samson,1583,82754,2022-08-19
CASH_OUT,4672,Michelle Samson,82754,78082,Agence_moov_Cotonou,300000,295328,2022-08-20
CASH_OUT,72064,Michelle Samson,78082,6018,Agence_moov_Abomey,300000,227936,2022-08-21
CASH_OUT,5811,Michelle Samson,6018,207,Agence_moov_Ouidah,300000,294189,2022-08-21
CASH_IN,75065,Agence_moov_Cotonou,300000,224935,Michelle Samson,207,75272,2022-08-23
CASH_IN,265293,Agence_moov_Cotonou,300000,34707,Michelle Samson,75272,340565,2022-08-26
CASH_IN,78978,Agence_moov_Ouidah,300000,221022,Manon Chevalier,-71420,7558,2022-08-01
TRANSFER,2573,Manon Chevalier,7558,4985,Manon Chevalier,7558,4985,2022-08-05
CASH_IN,176878,Agence_moov_Abomey,300000,123122,Manon Chevalier,4985,181863,2022-08-07
CASH_IN,294231,Agence_moov_Ouidah,300000,5769,Manon Chevalier,181863,476094,2022-08-09
TRANSFER,213648,Manon Chevalier,476094,262446,Manon Chevalier,476094,689742,2022-08-12
CASH_IN,10918,Agence_moov_Cotonou,300000,289082,Manon Chevalier,262446,273364,2022-08-12
CASH_OUT,38694,Manon Chevalier,273364,234670,Agence_moov_Ouidah,300000,261306,2022-08-12
CASH_IN,122726,Agence_moov_Cotonou,300000,177274,Manon Chevalier,234670,357396,2022-08-13
TRANSFER,238450,Manon Chevalier,357396,118946,Manon Chevalier,357396,595846,2022-08-15
TRANSFER,16588,Manon Chevalier,118946,102358,Manon Chevalier,118946,135534,2022-08-15
CASH_OUT,87327,Manon Chevalier,102358,15031,Agence_moov_Cotonou,300000,212673,2022-08-17
CASH_OUT,10479,Manon Chevalier,15031,4552,Agence_moov_Cotonou,300000,289521,2022-08-22
CASH_OUT,1798,Manon Chevalier,4552,2754,Agence_moov_Abomey,300000,298202,2022-08-25
CASH_OUT,1221,Manon Chevalier,2754,1533,Agence_moov_Ouidah,300000,298779,2022-08-26
CASH_OUT,1293,Manon Chevalier,1533,240,Agence_moov_Abomey,300000,298707,2022-08-26
CASH_OUT,216,Manon Chevalier,240,24,Agence_moov_Ouidah,300000,299784,2022-08-27
CASH_IN,231398,Agence_moov_Cotonou,300000,68602,Marcelle-Valentine Guibert,363800,595198,2022-09-22
CASH_IN,261918,Agence_moov_Abomey,300000,38082,Marcelle-Valentine Guibert,595198,857116,2022-09-23
TRANSFER,197935,Bertrand Regnier,1792100,1594165,Marcelle-Valentine Guibert,857116,1055051,2022-09-26
TRANSFER,1568875,Bertrand Regnier,1594165,25290,Lucie Aubert,1309300,2878175,2022-09-14
TRANSFER,1470658,Véronique Martins de Fleury,1875300,404642,Marthe Gilles,1651100,3121758,2022-09-01
CASH_IN,70857,Agence_moov_Ouidah,300000,229143,Marthe Gilles,3121758,3192615,2022-09-12
CASH_OUT,410110,Marthe Gilles,3192615,2782505,Agence_moov_Ouidah,300000,-110110,2022-09-17
CASH_OUT,1582934,Marthe Gilles,2782505,1199571,Agence_moov_Abomey,300000,-1282934,2022-09-21
TRANSFER,282463,Robert Clerc,371600,89137,Marthe Gilles,1199571,1482034,2022-09-25
CASH_IN,37679,Agence_moov_Ouidah,300000,262321,Michelle-Dorothée Lévêque,210300,247979,2022-09-02
TRANSFER,114822,Michelle-Dorothée Lévêque,247979,133157,Frédéric Guillou,1092600,977778,2022-09-08
TRANSFER,800699,Thibaut de la Lombard,1663300,862601,Michelle-Dorothée Lévêque,133157,933856,2022-09-13
TRANSFER,619448,Michelle-Dorothée Lévêque,933856,314408,Richard Le Lévêque,1166000,546552,2022-09-20
CASH_OUT,532803,Céline Collin-Hervé,1897400,1364597,Agence_moov_Abomey,300000,-232803,2022-09-05
TRANSFER,1120841,Raymond Lévy,1303300,182459,Céline Collin-Hervé,1364597,2485438,2022-09-16
TRANSFER,1179469,Céline Collin-Hervé,2485438,1305969,Bertrand Regnier,25290,-1154179,2022-09-25
TRANSFER,168064,Andrée-Thérèse Mendès,1066100,898036,Anastasie Cousin,1533600,1701664,2022-09-02
CASH_OUT,780952,Anastasie Cousin,1701664,920712,Agence_moov_Abomey,300000,-480952,2022-09-03
CASH_IN,56085,Agence_moov_Ouidah,300000,243915,Anastasie Cousin,920712,976797,2022-09-14
CASH_OUT,1391442,Paul Rocher-Maillet,1890800,499358,Agence_moov_Ouidah,300000,-1091442,2022-09-07
CASH_IN,27206,Agence_moov_Cotonou,300000,272794,Paul Rocher-Maillet,499358,526564,2022-09-19
TRANSFER,862978,Aurore Charrier,1771800,908822,Manon Valette,167900,1030878,2022-09-11
TRANSFER,903945,Manon Valette,1030878,126933,Virginie Bouvet,1940800,1036855,2022-09-25
TRANSFER,832198,Virginie Bouvet,1036855,204657,Thérèse Hubert,1538000,705802,2022-09-04
TRANSFER,529438,Suzanne Bodin,1748500,1219062,Virginie Bouvet,204657,734095,2022-09-04
CASH_IN,79798,Agence_moov_Ouidah,300000,220202,Virginie Bouvet,734095,813893,2022-09-09
CASH_IN,9092,Agence_moov_Ouidah,300000,290908,Virginie Bouvet,813893,822985,2022-09-16
CASH_OUT,179571,Stéphane Munoz,851600,672029,Agence_moov_Abomey,300000,120429,2022-09-26
CASH_IN,23174,Agence_moov_Abomey,300000,276826,Timothée-René Blanchard,1664800,1687974,2022-09-26
TRANSFER,17732,Émile-René Baudry,1181200,1163468,Alphonse Gomes,141100,158832,2022-09-05
CASH_OUT,16889,Alphonse Gomes,158832,141943,Agence_moov_Abomey,300000,283111,2022-09-22
CASH_OUT,141266,Alphonse Gomes,141943,677,Agence_moov_Cotonou,300000,158734,2022-09-25
CASH_IN,197501,Agence_moov_Abomey,300000,102499,Renée Le Diaz,1374100,1571601,2022-09-14
CASH_OUT,277734,Renée Le Diaz,1571601,1293867,Agence_moov_Cotonou,300000,22266,2022-09-15
TRANSFER,918096,Théodore Joseph-Lefebvre,1907900,989804,Renée Le Diaz,1293867,2211963,2022-09-16
TRANSFER,229653,Simone Muller de la Brun,1800000,1570347,Renée Le Diaz,2211963,2441616,2022-09-25
CASH_IN,70416,Agence_moov_Ouidah,300000,229584,Raymond Lévy,182459,252875,2022-09-12
TRANSFER,63488,Raymond Lévy,252875,189387,Tristan Delahaye,1858000,1794512,2022-09-17
TRANSFER,14718,Manon Chevalier,517500,502782,Raymond Lévy,189387,204105,2022-09-23
CASH_IN,214496,Agence_moov_Cotonou,300000,85504,Bernadette de Jourdan,391400,605896,2022-09-01
TRANSFER,489966,Philippe Philippe,1016600,526634,Noémi Bouvier,1012900,522934,2022-09-08
TRANSFER,1258688,Jules-Roland Bousquet,1757000,498312,Richard Michel,575300,-683388,2022-09-02
CASH_OUT,282211,Jules-Roland Bousquet,498312,216101,Agence_moov_Cotonou,300000,17789,2022-09-10
CASH_IN,163054,Agence_moov_Cotonou,300000,136946,Jules-Roland Bousquet,216101,379155,2022-09-18
TRANSFER,106934,Jules-Roland Bousquet,379155,272221,Alix Barbe,326700,219766,2022-09-19
CASH_IN,231691,Agence_moov_Ouidah,300000,68309,Jules-Roland Bousquet,272221,503912,2022-09-25
CASH_IN,216974,Agence_moov_Abomey,300000,83026,Richard Michel,-683388,-466414,2022-09-08
CASH_IN,176387,Agence_moov_Ouidah,300000,123613,Richard Michel,-466414,-290027,2022-09-11
CASH_IN,191784,Agence_moov_Cotonou,300000,108216,Richard Michel,-290027,-98243,2022-09-12
CASH_IN,248814,Agence_moov_Abomey,300000,51186,Richard Michel,-98243,150571,2022-09-21
TRANSFER,84012,Suzanne Bodin,1219062,1135050,Paulette Loiseau,968300,884288,2022-09-17
CASH_IN,232562,Agence_moov_Abomey,300000,67438,Suzanne Bodin,1135050,1367612,2022-09-27
CASH_OUT,706985,Vincent de la Dumont,1450300,743315,Agence_moov_Cotonou,300000,-406985,2022-09-05
CASH_OUT,434398,Vincent de la Dumont,743315,308917,Agence_moov_Cotonou,300000,-134398,2022-09-10
TRANSFER,50321,Michelle Samson,1478900,1428579,Thérèse Hubert,705802,756123,2022-09-01
CASH_OUT,470530,Thérèse Hubert,756123,285593,Agence_moov_Ouidah,300000,-170530,2022-09-07
CASH_IN,221686,Agence_moov_Ouidah,300000,78314,Thérèse Hubert,285593,507279,2022-09-16
TRANSFER,218293,Thérèse Hubert,507279,288986,Thomas Dupont,921700,703407,2022-09-16
TRANSFER,535801,Aurore Charrier,908822,373021,Thérèse Hubert,288986,824787,2022-09-27
CASH_OUT,732215,Colette-Sophie Prévost,1236700,504485,Agence_moov_Cotonou,300000,-432215,2022-09-24
TRANSFER,103831,Lucy Gillet,449600,345769,Colette-Sophie Prévost,504485,608316,2022-09-25
CASH_IN,81835,Agence_moov_Ouidah,300000,218165,Noémi Bouvier,522934,604769,2022-09-02
CASH_IN,64332,Agence_moov_Cotonou,300000,235668,Noémi Bouvier,604769,669101,2022-09-04
CASH_OUT,642332,Noémi Bouvier,669101,26769,Agence_moov_Ouidah,300000,-342332,2022-09-11
CASH_OUT,18848,Noémi Bouvier,26769,7921,Agence_moov_Ouidah,300000,281152,2022-09-13
CASH_IN,230159,Agence_moov_Cotonou,300000,69841,Noémi Bouvier,7921,238080,2022-09-14
TRANSFER,830282,Paulette Loiseau,884288,54006,Constance Guillon,1617900,787618,2022-09-04
CASH_OUT,38961,Paulette Loiseau,54006,15045,Agence_moov_Cotonou,300000,261039,2022-09-06
CASH_IN,78597,Agence_moov_Cotonou,300000,221403,Paulette Loiseau,15045,93642,2022-09-07
CASH_IN,112351,Agence_moov_Ouidah,300000,187649,Paulette Loiseau,93642,205993,2022-09-26
TRANSFER,811054,Émile-René Baudry,1163468,352414,Aimé Pages,724400,-86654,2022-09-18
TRANSFER,245481,Frédéric Guillou,977778,732297,Émile-René Baudry,352414,597895,2022-09-19
CASH_IN,261772,Agence_moov_Ouidah,300000,38228,Bertrand Regnier,-1154179,-892407,2022-09-09
CASH_IN,119985,Agence_moov_Ouidah,300000,180015,Bertrand Regnier,-892407,-772422,2022-09-11
CASH_IN,51094,Agence_moov_Ouidah,300000,248906,Bertrand Regnier,-772422,-721328,2022-09-19
CASH_IN,13530,Agence_moov_Ouidah,300000,286470,Bertrand Regnier,-721328,-707798,2022-09-19
CASH_OUT,516583,Thibaut de la Roy,1297000,780417,Agence_moov_Cotonou,300000,-216583,2022-09-01
CASH_IN,280615,Agence_moov_Ouidah,300000,19385,Thibaut de la Roy,780417,1061032,2022-09-03
TRANSFER,600820,Thibaut de la Roy,1061032,460212,Hélène Le Chauvin,100200,-500620,2022-09-06
CASH_OUT,435729,Thibaut de la Roy,460212,24483,Agence_moov_Cotonou,300000,-135729,2022-09-08
TRANSFER,19513,Thibaut de la Roy,24483,4970,Paul Perez,506800,487287,2022-09-09
TRANSFER,364709,Christine Texier,611400,246691,Thibaut de la Roy,4970,369679,2022-09-10
CASH_IN,120529,Agence_moov_Cotonou,300000,179471,Thibaut de la Roy,369679,490208,2022-09-10
CASH_OUT,204378,Thibaut de la Roy,490208,285830,Agence_moov_Abomey,300000,95622,2022-09-10
CASH_OUT,107640,Thibaut de la Roy,285830,178190,Agence_moov_Abomey,300000,192360,2022-09-11
CASH_IN,47027,Agence_moov_Abomey,300000,252973,Thibaut de la Roy,178190,225217,2022-09-12
TRANSFER,371556,Théodore Joseph-Lefebvre,989804,618248,Thibaut de la Roy,225217,596773,2022-09-12
TRANSFER,593010,Thibaut de la Roy,596773,3763,Victor Michel,926500,333490,2022-09-16
CASH_OUT,1354,Thibaut de la Roy,3763,2409,Agence_moov_Cotonou,300000,298646,2022-09-17
TRANSFER,2028,Thibaut de la Roy,2409,381,Tristan Bousquet-Gros,324200,322172,2022-09-18
TRANSFER,196,Thibaut de la Roy,381,185,Gérard de la Martinez,898100,897904,2022-09-19
CASH_IN,7801,Agence_moov_Ouidah,300000,292199,Thibaut de la Roy,185,7986,2022-09-20
CASH_IN,187203,Agence_moov_Cotonou,300000,112797,Thibaut de la Roy,7986,195189,2022-09-21
CASH_OUT,36492,Thibaut de la Roy,195189,158697,Agence_moov_Abomey,300000,263508,2022-09-21
CASH_IN,1361,Agence_moov_Cotonou,300000,298639,Thibaut de la Roy,158697,160058,2022-09-22
CASH_OUT,92910,Thibaut de la Roy,160058,67148,Agence_moov_Cotonou,300000,207090,2022-09-22
CASH_IN,15816,Agence_moov_Cotonou,300000,284184,Thibaut de la Roy,67148,82964,2022-09-22
CASH_OUT,38898,Thibaut de la Roy,82964,44066,Agence_moov_Cotonou,300000,261102,2022-09-23
TRANSFER,46081,Thomas Guichard du Renault,93100,47019,Thibaut de la Roy,44066,90147,2022-09-23
CASH_OUT,73884,Thibaut de la Roy,90147,16263,Agence_moov_Abomey,300000,226116,2022-09-23
CASH_IN,247833,Agence_moov_Ouidah,300000,52167,Thibaut de la Roy,16263,264096,2022-09-24
CASH_IN,1100,Agence_moov_Ouidah,300000,298900,Thibaut de la Roy,264096,265196,2022-09-24
TRANSFER,438537,Michelle de Étienne,593600,155063,Thibaut de la Roy,265196,703733,2022-09-25
CASH_OUT,205021,Thibaut de la Roy,703733,498712,Agence_moov_Abomey,300000,94979,2022-09-25
CASH_OUT,493105,Thibaut de la Roy,498712,5607,Agence_moov_Cotonou,300000,-193105,2022-09-26
CASH_IN,264960,Agence_moov_Ouidah,300000,35040,Thibaut de la Roy,5607,270567,2022-09-27
CASH_IN,173891,Agence_moov_Cotonou,300000,126109,Françoise Morin,450400,624291,2022-09-02
TRANSFER,125931,Émilie du Allain,1661900,1535969,Françoise Morin,624291,750222,2022-09-03
CASH_IN,96043,Agence_moov_Ouidah,300000,203957,Françoise Morin,750222,846265,2022-09-03
TRANSFER,436503,Françoise Morin,846265,409762,Constance Guillon,787618,351115,2022-09-04
CASH_IN,3451,Agence_moov_Abomey,300000,296549,Françoise Morin,409762,413213,2022-09-05
CASH_OUT,299555,Françoise Morin,413213,113658,Agence_moov_Ouidah,300000,445,2022-09-07
CASH_IN,181247,Agence_moov_Abomey,300000,118753,Françoise Morin,113658,294905,2022-09-08
TRANSFER,210752,Manon Chevalier,502782,292030,Françoise Morin,294905,505657,2022-09-09
CASH_OUT,454903,Françoise Morin,505657,50754,Agence_moov_Cotonou,300000,-154903,2022-09-09
TRANSFER,287687,Noël Bourgeois,1130600,842913,Françoise Morin,50754,338441,2022-09-10
CASH_IN,248035,Agence_moov_Abomey,300000,51965,Françoise Morin,338441,586476,2022-09-11
CASH_IN,21545,Agence_moov_Cotonou,300000,278455,Françoise Morin,586476,608021,2022-09-11
TRANSFER,450965,Françoise Morin,608021,157056,Nath Loiseau,1344100,893135,2022-09-14
CASH_OUT,131813,Françoise Morin,157056,25243,Agence_moov_Abomey,300000,168187,2022-09-15
CASH_OUT,976,Françoise Morin,25243,24267,Agence_moov_Abomey,300000,299024,2022-09-16
TRANSFER,3740,Françoise Morin,24267,20527,André Renault,77200,73460,2022-09-17
CASH_IN,246969,Agence_moov_Cotonou,300000,53031,Françoise Morin,20527,267496,2022-09-22
CASH_IN,262147,Agence_moov_Ouidah,300000,37853,Françoise Morin,267496,529643,2022-09-23
CASH_OUT,146692,Françoise Morin,529643,382951,Agence_moov_Abomey,300000,153308,2022-09-23
CASH_OUT,307665,Françoise Morin,382951,75286,Agence_moov_Abomey,300000,-7665,2022-09-23
TRANSFER,70825,Françoise Morin,75286,4461,Théodore Joseph-Lefebvre,618248,547423,2022-09-24
CASH_OUT,3905,Françoise Morin,4461,556,Agence_moov_Ouidah,300000,296095,2022-09-25
CASH_OUT,443,Françoise Morin,556,113,Agence_moov_Ouidah,300000,299557,2022-09-25
CASH_IN,117292,Agence_moov_Cotonou,300000,182708,Françoise Morin,113,117405,2022-09-27
CASH_OUT,8446,Françoise Morin,117405,108959,Agence_moov_Cotonou,300000,291554,2022-09-27
CASH_OUT,72927,Richard Le Lévêque,546552,473625,Agence_moov_Cotonou,300000,227073,2022-09-01
CASH_OUT,431997,Richard Le Lévêque,473625,41628,Agence_moov_Ouidah,300000,-131997,2022-09-01
CASH_OUT,35983,Richard Le Lévêque,41628,5645,Agence_moov_Cotonou,300000,264017,2022-09-03
CASH_OUT,359,Richard Le Lévêque,5645,5286,Agence_moov_Ouidah,300000,299641,2022-09-03
CASH_OUT,2090,Richard Le Lévêque,5286,3196,Agence_moov_Cotonou,300000,297910,2022-09-04
CASH_OUT,2697,Richard Le Lévêque,3196,499,Agence_moov_Ouidah,300000,297303,2022-09-05
CASH_IN,80790,Agence_moov_Cotonou,300000,219210,Richard Le Lévêque,499,81289,2022-09-06
CASH_IN,11855,Agence_moov_Cotonou,300000,288145,Richard Le Lévêque,81289,93144,2022-09-10
CASH_IN,31133,Agence_moov_Abomey,300000,268867,Richard Le Lévêque,93144,124277,2022-09-10
CASH_OUT,4824,Richard Le Lévêque,124277,119453,Agence_moov_Abomey,300000,295176,2022-09-12
TRANSFER,109793,Richard Le Lévêque,119453,9660,Thomas Guichard du Renault,47019,-62774,2022-09-12
CASH_OUT,4012,Richard Le Lévêque,9660,5648,Agence_moov_Cotonou,300000,295988,2022-09-13
CASH_IN,97645,Agence_moov_Abomey,300000,202355,Richard Le Lévêque,5648,103293,2022-09-13
CASH_OUT,44553,Richard Le Lévêque,103293,58740,Agence_moov_Abomey,300000,255447,2022-09-16
CASH_OUT,20750,Richard Le Lévêque,58740,37990,Agence_moov_Abomey,300000,279250,2022-09-16
TRANSFER,26022,Richard Le Lévêque,37990,11968,Camille Morvan,635900,609878,2022-09-17
CASH_IN,283996,Agence_moov_Abomey,300000,16004,Richard Le Lévêque,11968,295964,2022-09-17
CASH_OUT,193272,Richard Le Lévêque,295964,102692,Agence_moov_Abomey,300000,106728,2022-09-20
CASH_IN,6536,Agence_moov_Abomey,300000,293464,Richard Le Lévêque,102692,109228,2022-09-21
CASH_OUT,24796,Richard Le Lévêque,109228,84432,Agence_moov_Ouidah,300000,275204,2022-09-24
CASH_IN,217560,Agence_moov_Ouidah,300000,82440,Richard Le Lévêque,84432,301992,2022-09-24
TRANSFER,111348,Richard Le Lévêque,301992,190644,Vincent Joubert,137600,26252,2022-09-26
CASH_IN,99000,Agence_moov_Ouidah,300000,201000,Richard Le Lévêque,190644,289644,2022-09-26
CASH_IN,239658,Agence_moov_Ouidah,300000,60342,Richard Le Lévêque,289644,529302,2022-09-26
CASH_OUT,161730,Manon Chevalier,292030,130300,Agence_moov_Cotonou,300000,138270,2022-09-01
CASH_IN,197592,Agence_moov_Cotonou,300000,102408,Manon Chevalier,130300,327892,2022-09-02
CASH_OUT,53508,Manon Chevalier,327892,274384,Agence_moov_Abomey,300000,246492,2022-09-03
CASH_IN,27536,Agence_moov_Abomey,300000,272464,Manon Chevalier,274384,301920,2022-09-03
CASH_IN,194023,Agence_moov_Cotonou,300000,105977,Manon Chevalier,301920,495943,2022-09-03
TRANSFER,6492,Mathilde de la Samson,1647400,1640908,Manon Chevalier,495943,502435,2022-09-05
TRANSFER,132273,Manon Chevalier,502435,370162,Gabriel Bègue,456900,324627,2022-09-06
TRANSFER,114963,Manon Chevalier,370162,255199,Émilie du Allain,1535969,1421006,2022-09-06
TRANSFER,144856,Manon Chevalier,255199,110343,André Renault,73460,-71396,2022-09-07
CASH_OUT,83385,Manon Chevalier,110343,26958,Agence_moov_Abomey,300000,216615,2022-09-08
CASH_OUT,19463,Manon Chevalier,26958,7495,Agence_moov_Ouidah,300000,280537,2022-09-08
TRANSFER,2663,Lucy Lamy,10200,7537,Manon Chevalier,7495,10158,2022-09-08
TRANSFER,2269,Manon Chevalier,10158,7889,Simone Muller de la Brun,1570347,1568078,2022-09-13
CASH_OUT,1900,Manon Chevalier,7889,5989,Agence_moov_Ouidah,300000,298100,2022-09-13
CASH_OUT,587,Manon Chevalier,5989,5402,Agence_moov_Ouidah,300000,299413,2022-09-14
TRANSFER,5145,Manon Chevalier,5402,257,Gabriel Bègue,324627,319482,2022-09-15
TRANSFER,10663,Matthieu-Matthieu Bigot,106500,95837,Manon Chevalier,257,10920,2022-09-15
TRANSFER,485064,Frédérique Fernandes du Bouchet,1301200,816136,Manon Chevalier,10920,495984,2022-09-16
CASH_OUT,344837,Manon Chevalier,495984,151147,Agence_moov_Ouidah,300000,-44837,2022-09-18
TRANSFER,19518,Manon Chevalier,151147,131629,Constance Guillon,351115,331597,2022-09-19
TRANSFER,13690,Nathalie Bonnin-Joubert,44500,30810,Manon Chevalier,131629,145319,2022-09-20
CASH_IN,84931,Agence_moov_Cotonou,300000,215069,Manon Chevalier,145319,230250,2022-09-21
CASH_OUT,20526,Manon Chevalier,230250,209724,Agence_moov_Cotonou,300000,279474,2022-09-21
CASH_OUT,185913,Manon Chevalier,209724,23811,Agence_moov_Abomey,300000,114087,2022-09-24
CASH_IN,273592,Agence_moov_Ouidah,300000,26408,Manon Chevalier,23811,297403,2022-09-24
CASH_OUT,251369,Manon Chevalier,297403,46034,Agence_moov_Ouidah,300000,48631,2022-09-25
TRANSFER,8955,Manon Chevalier,46034,37079,Manon Lebon,1566900,1557945,2022-09-26
TRANSFER,1520197,Clémence-Véronique Munoz,1698300,178103,Tristan Bousquet-Gros,322172,-1198025,2022-09-01
CASH_IN,235713,Agence_moov_Ouidah,300000,64287,Clémence-Véronique Munoz,178103,413816,2022-09-01
CASH_IN,83481,Agence_moov_Ouidah,300000,216519,Clémence-Véronique Munoz,413816,497297,2022-09-02
CASH_IN,4441,Agence_moov_Ouidah,300000,295559,Clémence-Véronique Munoz,497297,501738,2022-09-02
TRANSFER,366112,Clémence-Véronique Munoz,501738,135626,Paul Perez,487287,121175,2022-09-03
TRANSFER,545680,Théodore Joseph-Lefebvre,547423,1743,Clémence-Véronique Munoz,135626,681306,2022-09-04
CASH_OUT,23124,Clémence-Véronique Munoz,681306,658182,Agence_moov_Cotonou,300000,276876,2022-09-06
TRANSFER,315420,Clémence-Véronique Munoz,658182,342762,Benoît Guyot,603000,287580,2022-09-07
TRANSFER,164084,Gérard de la Martinez,897904,733820,Clémence-Véronique Munoz,342762,506846,2022-09-07
CASH_IN,191111,Agence_moov_Ouidah,300000,108889,Clémence-Véronique Munoz,506846,697957,2022-09-09
TRANSFER,443617,Clémence-Véronique Munoz,697957,254340,Bernard Maurice,41000,-402617,2022-09-11
CASH_OUT,249104,Clémence-Véronique Munoz,254340,5236,Agence_moov_Abomey,300000,50896,2022-09-12
CASH_OUT,284,Clémence-Véronique Munoz,5236,4952,Agence_moov_Ouidah,300000,299716,2022-09-12
TRANSFER,4354,Clémence-Véronique Munoz,4952,598,Colette Merle Le Robert,999700,995346,2022-09-13
CASH_IN,34123,Agence_moov_Ouidah,300000,265877,Clémence-Véronique Munoz,598,34721,2022-09-15
CASH_IN,13689,Agence_moov_Ouidah,300000,286311,Clémence-Véronique Munoz,34721,48410,2022-09-16
CASH_OUT,37592,Clémence-Véronique Munoz,48410,10818,Agence_moov_Abomey,300000,262408,2022-09-16
TRANSFER,625615,Nicolas Salmon Le Hamon,705400,79785,Clémence-Véronique Munoz,10818,636433,2022-09-18
CASH_IN,18443,Agence_moov_Abomey,300000,281557,Clémence-Véronique Munoz,636433,654876,2022-09-19
CASH_OUT,624893,Clémence-Véronique Munoz,654876,29983,Agence_moov_Cotonou,300000,-324893,2022-09-20
CASH_OUT,22775,Clémence-Véronique Munoz,29983,7208,Agence_moov_Ouidah,300000,277225,2022-09-20
CASH_OUT,3847,Clémence-Véronique Munoz,7208,3361,Agence_moov_Cotonou,300000,296153,2022-09-26
TRANSFER,2675,Clémence-Véronique Munoz,3361,686,Aurore Charrier,373021,370346,2022-09-26
TRANSFER,206,Clémence-Véronique Munoz,686,480,Camille Morvan,609878,609672,2022-09-27
CASH_IN,139758,Agence_moov_Cotonou,300000,160242,Clémence-Véronique Munoz,480,140238,2022-09-27
CASH_OUT,829,Théodore Joseph-Lefebvre,1743,914,Agence_moov_Abomey,300000,299171,2022-09-01
CASH_OUT,502,Théodore Joseph-Lefebvre,914,412,Agence_moov_Abomey,300000,299498,2022-09-01
CASH_OUT,302,Théodore Joseph-Lefebvre,412,110,Agence_moov_Ouidah,300000,299698,2022-09-01
CASH_OUT,100,Théodore Joseph-Lefebvre,110,10,Agence_moov_Abomey,300000,299900,2022-09-02
CASH_IN,262056,Agence_moov_Ouidah,300000,37944,Théodore Joseph-Lefebvre,10,262066,2022-09-03
CASH_OUT,111809,Théodore Joseph-Lefebvre,262066,150257,Agence_moov_Abomey,300000,188191,2022-09-04
CASH_OUT,105700,Théodore Joseph-Lefebvre,150257,44557,Agence_moov_Abomey,300000,194300,2022-09-05
CASH_IN,215459,Agence_moov_Ouidah,300000,84541,Théodore Joseph-Lefebvre,44557,260016,2022-09-06
TRANSFER,106094,Théodore Joseph-Lefebvre,260016,153922,Noël Bourgeois,842913,736819,2022-09-07
CASH_IN,135306,Agence_moov_Ouidah,300000,164694,Théodore Joseph-Lefebvre,153922,289228,2022-09-08
TRANSFER,38823,Théodore Joseph-Lefebvre,289228,250405,Benoît Guyot,287580,248757,2022-09-08
CASH_OUT,213765,Théodore Joseph-Lefebvre,250405,36640,Agence_moov_Abomey,300000,86235,2022-09-09
CASH_OUT,17581,Théodore Joseph-Lefebvre,36640,19059,Agence_moov_Abomey,300000,282419,2022-09-09
CASH_IN,37657,Agence_moov_Cotonou,300000,262343,Théodore Joseph-Lefebvre,19059,56716,2022-09-09
CASH_IN,164022,Agence_moov_Abomey,300000,135978,Théodore Joseph-Lefebvre,56716,220738,2022-09-10
CASH_IN,39631,Agence_moov_Cotonou,300000,260369,Théodore Joseph-Lefebvre,220738,260369,2022-09-12
CASH_IN,153400,Agence_moov_Cotonou,300000,146600,Théodore Joseph-Lefebvre,260369,413769,2022-09-13
CASH_IN,217619,Agence_moov_Abomey,300000,82381,Théodore Joseph-Lefebvre,413769,631388,2022-09-14
CASH_OUT,173604,Théodore Joseph-Lefebvre,631388,457784,Agence_moov_Abomey,300000,126396,2022-09-16
CASH_OUT,144199,Théodore Joseph-Lefebvre,457784,313585,Agence_moov_Abomey,300000,155801,2022-09-16
CASH_IN,89810,Agence_moov_Abomey,300000,210190,Théodore Joseph-Lefebvre,313585,403395,2022-09-17
CASH_IN,129662,Agence_moov_Ouidah,300000,170338,Théodore Joseph-Lefebvre,403395,533057,2022-09-18
CASH_OUT,466117,Théodore Joseph-Lefebvre,533057,66940,Agence_moov_Cotonou,300000,-166117,2022-09-20
TRANSFER,808401,Michelle Samson,1428579,620178,Théodore Joseph-Lefebvre,66940,875341,2022-09-20
CASH_IN,74195,Agence_moov_Ouidah,300000,225805,Théodore Joseph-Lefebvre,875341,949536,2022-09-23
CASH_OUT,720171,Théodore Joseph-Lefebvre,949536,229365,Agence_moov_Abomey,300000,-420171,2022-09-25
CASH_IN,78207,Agence_moov_Abomey,300000,221793,Théodore Joseph-Lefebvre,229365,307572,2022-09-26
CASH_OUT,37818,Théodore Joseph-Lefebvre,307572,269754,Agence_moov_Abomey,300000,262182,2022-09-27
CASH_OUT,89691,Robert-Louis Gosselin,93800,4109,Agence_moov_Abomey,300000,210309,2022-09-01
TRANSFER,653766,Émilie du Allain,1421006,767240,Robert-Louis Gosselin,4109,657875,2022-09-01
CASH_IN,271153,Agence_moov_Abomey,300000,28847,Robert-Louis Gosselin,657875,929028,2022-09-02
TRANSFER,858695,Robert-Louis Gosselin,929028,70333,Maggie Martinez,1924900,1066205,2022-09-03
TRANSFER,54232,Robert-Louis Gosselin,70333,16101,Robert-Louis Gosselin,70333,124565,2022-09-04
TRANSFER,285647,Andrée-Thérèse Mendès,898036,612389,Robert-Louis Gosselin,16101,301748,2022-09-04
CASH_OUT,62118,Robert-Louis Gosselin,301748,239630,Agence_moov_Abomey,300000,237882,2022-09-06
CASH_OUT,116822,Robert-Louis Gosselin,239630,122808,Agence_moov_Cotonou,300000,183178,2022-09-06
TRANSFER,392311,Frédérique Fernandes du Bouchet,816136,423825,Robert-Louis Gosselin,122808,515119,2022-09-07
CASH_IN,255553,Agence_moov_Abomey,300000,44447,Robert-Louis Gosselin,515119,770672,2022-09-09
TRANSFER,614097,Robert-Louis Gosselin,770672,156575,Lucy Lamy,7537,-606560,2022-09-13
CASH_OUT,19296,Robert-Louis Gosselin,156575,137279,Agence_moov_Ouidah,300000,280704,2022-09-13
CASH_IN,146323,Agence_moov_Ouidah,300000,153677,Robert-Louis Gosselin,137279,283602,2022-09-13
TRANSFER,368533,Simone Muller de la Brun,1568078,1199545,Robert-Louis Gosselin,283602,652135,2022-09-14
TRANSFER,566680,Emmanuel Grégoire,681900,115220,Robert-Louis Gosselin,652135,1218815,2022-09-14
CASH_OUT,974178,Robert-Louis Gosselin,1218815,244637,Agence_moov_Cotonou,300000,-674178,2022-09-15
CASH_OUT,15676,Robert-Louis Gosselin,244637,228961,Agence_moov_Ouidah,300000,284324,2022-09-16
CASH_OUT,62124,Robert-Louis Gosselin,228961,166837,Agence_moov_Ouidah,300000,237876,2022-09-17
CASH_OUT,129899,Robert-Louis Gosselin,166837,36938,Agence_moov_Abomey,300000,170101,2022-09-17
TRANSFER,15551,Robert-Louis Gosselin,36938,21387,Gérard de la Martinez,733820,718269,2022-09-17
TRANSFER,60532,Michelle Samson,620178,559646,Robert-Louis Gosselin,21387,81919,2022-09-18
TRANSFER,3661,Robert-Louis Gosselin,81919,78258,Hélène de la Gérard,155200,151539,2022-09-19
TRANSFER,16049,Robert-Louis Gosselin,78258,62209,Constance Guillon,331597,315548,2022-09-22
CASH_OUT,61935,Robert-Louis Gosselin,62209,274,Agence_moov_Ouidah,300000,238065,2022-09-24
CASH_OUT,213,Robert-Louis Gosselin,274,61,Agence_moov_Ouidah,300000,299787,2022-09-25
CASH_IN,195650,Agence_moov_Abomey,300000,104350,Robert-Louis Gosselin,61,195711,2022-09-25
CASH_OUT,19819,Robert-Louis Gosselin,195711,175892,Agence_moov_Abomey,300000,280181,2022-09-27
CASH_IN,158,Agence_moov_Ouidah,300000,299842,Robert-Louis Gosselin,175892,176050,2022-09-27
CASH_OUT,851006,Camille Prévost,1785900,934894,Agence_moov_Abomey,300000,-551006,2022-09-02
CASH_OUT,17424,Camille Prévost,934894,917470,Agence_moov_Abomey,300000,282576,2022-09-03
CASH_OUT,401676,Camille Prévost,917470,515794,Agence_moov_Ouidah,300000,-101676,2022-09-03
TRANSFER,495162,Camille Prévost,515794,20632,Robert Laroche,1273000,777838,2022-09-04
CASH_IN,27597,Agence_moov_Abomey,300000,272403,Camille Prévost,20632,48229,2022-09-05
CASH_IN,7807,Agence_moov_Ouidah,300000,292193,Camille Prévost,48229,56036,2022-09-05
CASH_OUT,24388,Camille Prévost,56036,31648,Agence_moov_Abomey,300000,275612,2022-09-06
CASH_OUT,8078,Camille Prévost,31648,23570,Agence_moov_Ouidah,300000,291922,2022-09-08
TRANSFER,18718,Camille Prévost,23570,4852,Victor Michel,333490,314772,2022-09-08
CASH_IN,160103,Agence_moov_Cotonou,300000,139897,Camille Prévost,4852,164955,2022-09-08
CASH_OUT,162019,Camille Prévost,164955,2936,Agence_moov_Abomey,300000,137981,2022-09-09
CASH_IN,118236,Agence_moov_Ouidah,300000,181764,Camille Prévost,2936,121172,2022-09-10
CASH_IN,58697,Agence_moov_Cotonou,300000,241303,Camille Prévost,121172,179869,2022-09-11
CASH_OUT,19333,Camille Prévost,179869,160536,Agence_moov_Cotonou,300000,280667,2022-09-12
TRANSFER,149097,Constance Guillon,315548,166451,Camille Prévost,160536,309633,2022-09-12
CASH_IN,162199,Agence_moov_Ouidah,300000,137801,Camille Prévost,309633,471832,2022-09-12
CASH_OUT,242271,Camille Prévost,471832,229561,Agence_moov_Ouidah,300000,57729,2022-09-12
TRANSFER,191867,Nath Loiseau,893135,701268,Camille Prévost,229561,421428,2022-09-13
TRANSFER,70342,Camille Prévost,421428,351086,Nicolas Salmon Le Hamon,79785,9443,2022-09-13
CASH_OUT,143329,Camille Prévost,351086,207757,Agence_moov_Ouidah,300000,156671,2022-09-14
CASH_OUT,147334,Camille Prévost,207757,60423,Agence_moov_Cotonou,300000,152666,2022-09-14
CASH_OUT,10589,Camille Prévost,60423,49834,Agence_moov_Ouidah,300000,289411,2022-09-17
TRANSFER,40270,Camille Prévost,49834,9564,Sabine Pineau,1029500,989230,2022-09-17
CASH_IN,263740,Agence_moov_Cotonou,300000,36260,Camille Prévost,9564,273304,2022-09-17
CASH_OUT,1928,Camille Prévost,273304,271376,Agence_moov_Cotonou,300000,298072,2022-09-19
CASH_IN,14172,Agence_moov_Cotonou,300000,285828,Camille Prévost,271376,285548,2022-09-20
CASH_IN,246933,Agence_moov_Abomey,300000,53067,Camille Prévost,285548,532481,2022-09-21
CASH_OUT,104627,Camille Prévost,532481,427854,Agence_moov_Abomey,300000,195373,2022-09-21
CASH_IN,102509,Agence_moov_Ouidah,300000,197491,Camille Prévost,427854,530363,2022-09-22
TRANSFER,599344,Frédéric Guillou,732297,132953,Camille Prévost,530363,1129707,2022-09-23
CASH_OUT,71509,Alix Barbe,219766,148257,Agence_moov_Abomey,300000,228491,2022-09-01
CASH_OUT,8153,Alix Barbe,148257,140104,Agence_moov_Ouidah,300000,291847,2022-09-01
CASH_IN,87929,Agence_moov_Abomey,300000,212071,Alix Barbe,140104,228033,2022-09-01
CASH_OUT,62410,Alix Barbe,228033,165623,Agence_moov_Cotonou,300000,237590,2022-09-02
CASH_IN,217103,Agence_moov_Abomey,300000,82897,Alix Barbe,165623,382726,2022-09-03
CASH_IN,193471,Agence_moov_Abomey,300000,106529,Alix Barbe,382726,576197,2022-09-04
CASH_OUT,421915,Alix Barbe,576197,154282,Agence_moov_Cotonou,300000,-121915,2022-09-05
CASH_OUT,135398,Alix Barbe,154282,18884,Agence_moov_Ouidah,300000,164602,2022-09-05
TRANSFER,17690,Alix Barbe,18884,1194,Agnès Le Giraud,203100,185410,2022-09-07
TRANSFER,246472,Michelle Samson,559646,313174,Alix Barbe,1194,247666,2022-09-08
TRANSFER,120159,Alix Barbe,247666,127507,Andrée-Thérèse Mendès,612389,492230,2022-09-11
TRANSFER,73672,Alix Barbe,127507,53835,Paul Perez,121175,47503,2022-09-12
CASH_OUT,2511,Alix Barbe,53835,51324,Agence_moov_Abomey,300000,297489,2022-09-14
CASH_IN,126523,Agence_moov_Cotonou,300000,173477,Alix Barbe,51324,177847,2022-09-14
TRANSFER,69999,Alix Barbe,177847,107848,Thomas Dupont,703407,633408,2022-09-15
CASH_IN,35651,Agence_moov_Ouidah,300000,264349,Alix Barbe,107848,143499,2022-09-15
TRANSFER,13938,Alix Barbe,143499,129561,Tristan Delahaye,1794512,1780574,2022-09-15
CASH_IN,63641,Agence_moov_Ouidah,300000,236359,Alix Barbe,129561,193202,2022-09-17
TRANSFER,6067,Alix Barbe,193202,187135,Matthieu-Matthieu Bigot,95837,89770,2022-09-17
TRANSFER,3162,Vincent Joubert,26252,23090,Alix Barbe,187135,190297,2022-09-17
TRANSFER,29857,Alix Barbe,190297,160440,Michelle de Étienne,155063,125206,2022-09-19
TRANSFER,30938,Alix Barbe,160440,129502,Emmanuel Grégoire,115220,84282,2022-09-22
CASH_IN,69258,Agence_moov_Cotonou,300000,230742,Alix Barbe,129502,198760,2022-09-23
TRANSFER,91378,Alix Barbe,198760,107382,Sabine Pineau,989230,897852,2022-09-25
CASH_IN,10388,Agence_moov_Abomey,300000,289612,Alphonse Joly,1827900,1838288,2022-09-01
CASH_OUT,1319202,Alphonse Joly,1838288,519086,Agence_moov_Cotonou,300000,-1019202,2022-09-02
CASH_IN,27030,Agence_moov_Cotonou,300000,272970,Alphonse Joly,519086,546116,2022-09-06
CASH_OUT,270460,Alphonse Joly,546116,275656,Agence_moov_Ouidah,300000,29540,2022-09-06
TRANSFER,27069,Alphonse Joly,275656,248587,Astrid Lecoq,1042600,1015531,2022-09-07
TRANSFER,163100,Alphonse Joly,248587,85487,Jules Fernandes,1530400,1367300,2022-09-07
CASH_OUT,29501,Alphonse Joly,85487,55986,Agence_moov_Ouidah,300000,270499,2022-09-10
TRANSFER,26226,Alphonse Joly,55986,29760,Paul Perez,47503,21277,2022-09-12
CASH_IN,36125,Agence_moov_Abomey,300000,263875,Alphonse Joly,29760,65885,2022-09-12
CASH_OUT,26207,Alphonse Joly,65885,39678,Agence_moov_Cotonou,300000,273793,2022-09-14
TRANSFER,1554,Alphonse Joly,39678,38124,Alphonse Joly,39678,38124,2022-09-15
CASH_IN,173245,Agence_moov_Cotonou,300000,126755,Alphonse Joly,38124,211369,2022-09-16
CASH_IN,76762,Agence_moov_Abomey,300000,223238,Alphonse Joly,211369,288131,2022-09-17
CASH_OUT,23632,Alphonse Joly,288131,264499,Agence_moov_Cotonou,300000,276368,2022-09-17
TRANSFER,441585,Andrée-Thérèse Mendès,492230,50645,Alphonse Joly,264499,706084,2022-09-18
CASH_IN,22497,Agence_moov_Abomey,300000,277503,Alphonse Joly,706084,728581,2022-09-19
CASH_IN,129129,Agence_moov_Cotonou,300000,170871,Alphonse Joly,728581,857710,2022-09-19
CASH_IN,258484,Agence_moov_Cotonou,300000,41516,Alphonse Joly,857710,1116194,2022-09-24
CASH_OUT,790615,Alphonse Joly,1116194,325579,Agence_moov_Abomey,300000,-490615,2022-09-26
CASH_IN,87496,Agence_moov_Cotonou,300000,212504,Alphonse Joly,325579,413075,2022-09-26
CASH_IN,133766,Agence_moov_Cotonou,300000,166234,Alphonse Joly,413075,546841,2022-09-27
CASH_IN,144619,Agence_moov_Cotonou,300000,155381,Robert Clerc,89137,233756,2022-09-02
CASH_OUT,22681,Robert Clerc,233756,211075,Agence_moov_Cotonou,300000,277319,2022-09-03
TRANSFER,47122,Robert Clerc,211075,163953,Noël Bourgeois,736819,689697,2022-09-03
CASH_IN,67798,Agence_moov_Cotonou,300000,232202,Robert Clerc,163953,231751,2022-09-05
CASH_OUT,30577,Robert Clerc,231751,201174,Agence_moov_Cotonou,300000,269423,2022-09-06
TRANSFER,122110,Robert Clerc,201174,79064,Constance Bourdon-Millet,1047700,925590,2022-09-07
CASH_IN,279109,Agence_moov_Cotonou,300000,20891,Robert Clerc,79064,358173,2022-09-09
TRANSFER,185985,Robert Clerc,358173,172188,Robert Laroche,777838,591853,2022-09-09
CASH_IN,109911,Agence_moov_Cotonou,300000,190089,Robert Clerc,172188,282099,2022-09-09
CASH_IN,10959,Agence_moov_Abomey,300000,289041,Robert Clerc,282099,293058,2022-09-10
CASH_IN,16332,Agence_moov_Ouidah,300000,283668,Robert Clerc,293058,309390,2022-09-12
CASH_IN,263722,Agence_moov_Ouidah,300000,36278,Robert Clerc,309390,573112,2022-09-14
CASH_IN,202532,Agence_moov_Cotonou,300000,97468,Robert Clerc,573112,775644,2022-09-14
CASH_IN,244851,Agence_moov_Cotonou,300000,55149,Robert Clerc,775644,1020495,2022-09-16
CASH_IN,6516,Agence_moov_Ouidah,300000,293484,Robert Clerc,1020495,1027011,2022-09-18
TRANSFER,622910,Robert Clerc,1027011,404101,Audrey Julien de Leleu,1408100,785190,2022-09-19
TRANSFER,73301,Emmanuel Grégoire,84282,10981,Robert Clerc,404101,477402,2022-09-20
CASH_OUT,202647,Robert Clerc,477402,274755,Agence_moov_Ouidah,300000,97353,2022-09-20
CASH_IN,298070,Agence_moov_Cotonou,300000,1930,Robert Clerc,274755,572825,2022-09-21
TRANSFER,8325,Paul Perez,21277,12952,Robert Clerc,572825,581150,2022-09-22
CASH_OUT,167902,Robert Clerc,581150,413248,Agence_moov_Ouidah,300000,132098,2022-09-22
CASH_OUT,161987,Robert Clerc,413248,251261,Agence_moov_Abomey,300000,138013,2022-09-22
TRANSFER,44022,Robert Clerc,251261,207239,Thérèse François,425300,381278,2022-09-23
CASH_OUT,67711,Robert Clerc,207239,139528,Agence_moov_Ouidah,300000,232289,2022-09-23
CASH_OUT,96112,Robert Clerc,139528,43416,Agence_moov_Cotonou,300000,203888,2022-09-24
CASH_OUT,40250,Robert Clerc,43416,3166,Agence_moov_Abomey,300000,259750,2022-09-24
CASH_IN,74787,Agence_moov_Ouidah,300000,225213,Robert Clerc,3166,77953,2022-09-25
CASH_OUT,73284,Robert Clerc,77953,4669,Agence_moov_Cotonou,300000,226716,2022-09-26
TRANSFER,449141,Constance Bourdon-Millet,925590,476449,Robert Clerc,4669,453810,2022-09-27
CASH_IN,122710,Agence_moov_Abomey,300000,177290,Thérèse François,381278,503988,2022-09-02
CASH_OUT,30332,Thérèse François,503988,473656,Agence_moov_Abomey,300000,269668,2022-09-04
TRANSFER,337898,Martine Aubert,1826900,1489002,Thérèse François,473656,811554,2022-09-05
TRANSFER,440430,Renée Rousseau-Henry,733700,293270,Thérèse François,811554,1251984,2022-09-06
TRANSFER,1246043,Thérèse François,1251984,5941,Christine Texier,246691,-999352,2022-09-07
CASH_IN,113882,Agence_moov_Abomey,300000,186118,Thérèse François,5941,119823,2022-09-07
CASH_OUT,91948,Thérèse François,119823,27875,Agence_moov_Ouidah,300000,208052,2022-09-07
TRANSFER,8594,Thérèse François,27875,19281,Gérard de la Martinez,718269,709675,2022-09-09
CASH_OUT,9073,Thérèse François,19281,10208,Agence_moov_Ouidah,300000,290927,2022-09-09
CASH_OUT,9859,Thérèse François,10208,349,Agence_moov_Ouidah,300000,290141,2022-09-12
CASH_IN,96891,Agence_moov_Cotonou,300000,203109,Thérèse François,349,97240,2022-09-13
CASH_OUT,92633,Thérèse François,97240,4607,Agence_moov_Cotonou,300000,207367,2022-09-14
TRANSFER,1858,Thérèse François,4607,2749,Mathilde Picard du Delmas,1609900,1608042,2022-09-15
TRANSFER,2677,Thérèse François,2749,72,Thérèse François,2749,72,2022-09-16
CASH_IN,108782,Agence_moov_Ouidah,300000,191218,Thérèse François,72,108854,2022-09-18
TRANSFER,40028,Thérèse François,108854,68826,Paul Perez,12952,-27076,2022-09-18
TRANSFER,691075,Mathilde Picard du Delmas,1608042,916967,Thérèse François,68826,759901,2022-09-18
CASH_OUT,450955,Thérèse François,759901,308946,Agence_moov_Abomey,300000,-150955,2022-09-19
TRANSFER,172871,Thomas-Robert Morvan,290600,117729,Thérèse François,308946,481817,2022-09-21
TRANSFER,423782,Jules Fernandes,1367300,943518,Thérèse François,481817,905599,2022-09-21
CASH_OUT,895017,Thérèse François,905599,10582,Agence_moov_Abomey,300000,-595017,2022-09-21
TRANSFER,312026,Robert Laroche,591853,279827,Thérèse François,10582,322608,2022-09-24
CASH_IN,190384,Agence_moov_Cotonou,300000,109616,Thérèse François,322608,512992,2022-09-24
CASH_OUT,272335,Thérèse François,512992,240657,Agence_moov_Cotonou,300000,27665,2022-09-24
TRANSFER,378221,Mathilde Picard du Delmas,916967,538746,Thérèse François,240657,618878,2022-09-25
CASH_IN,107040,Agence_moov_Abomey,300000,192960,Thérèse François,618878,725918,2022-09-25
CASH_IN,106239,Agence_moov_Cotonou,300000,193761,Thérèse François,725918,832157,2022-09-25
CASH_OUT,32969,Thérèse François,832157,799188,Agence_moov_Cotonou,300000,267031,2022-09-27
TRANSFER,190187,Victor Michel,314772,124585,Thérèse François,799188,989375,2022-09-27
CASH_IN,292552,Agence_moov_Abomey,300000,7448,Léon Da Costa,688200,980752,2022-09-02
CASH_OUT,704292,Léon Da Costa,980752,276460,Agence_moov_Ouidah,300000,-404292,2022-09-02
TRANSFER,233085,Léon Da Costa,276460,43375,Tristan Delahaye,1780574,1547489,2022-09-04
CASH_OUT,19393,Léon Da Costa,43375,23982,Agence_moov_Abomey,300000,280607,2022-09-05
CASH_OUT,9383,Léon Da Costa,23982,14599,Agence_moov_Ouidah,300000,290617,2022-09-05
CASH_IN,258133,Agence_moov_Abomey,300000,41867,Léon Da Costa,14599,272732,2022-09-07
TRANSFER,314862,Constance Bourdon-Millet,476449,161587,Léon Da Costa,272732,587594,2022-09-08
CASH_IN,137993,Agence_moov_Abomey,300000,162007,Léon Da Costa,587594,725587,2022-09-08
CASH_IN,140281,Agence_moov_Abomey,300000,159719,Léon Da Costa,725587,865868,2022-09-09
CASH_OUT,525413,Léon Da Costa,865868,340455,Agence_moov_Abomey,300000,-225413,2022-09-09
CASH_IN,129306,Agence_moov_Abomey,300000,170694,Léon Da Costa,340455,469761,2022-09-09
TRANSFER,408731,Léon Da Costa,469761,61030,Frédéric Guillou,132953,-275778,2022-09-11
TRANSFER,890622,Jules Fernandes,943518,52896,Léon Da Costa,61030,951652,2022-09-12
CASH_OUT,254412,Léon Da Costa,951652,697240,Agence_moov_Cotonou,300000,45588,2022-09-14
CASH_OUT,220725,Léon Da Costa,697240,476515,Agence_moov_Abomey,300000,79275,2022-09-15
TRANSFER,439036,Léon Da Costa,476515,37479,Tristan Gomez,1311500,872464,2022-09-17
CASH_IN,215559,Agence_moov_Abomey,300000,84441,Léon Da Costa,37479,253038,2022-09-17
CASH_OUT,113895,Léon Da Costa,253038,139143,Agence_moov_Ouidah,300000,186105,2022-09-18
TRANSFER,86599,Léon Da Costa,139143,52544,Thomas de Blin,1039700,953101,2022-09-18
TRANSFER,424597,Thomas Dupont,633408,208811,Léon Da Costa,52544,477141,2022-09-18
CASH_IN,80105,Agence_moov_Ouidah,300000,219895,Léon Da Costa,477141,557246,2022-09-22
CASH_OUT,551208,Léon Da Costa,557246,6038,Agence_moov_Cotonou,300000,-251208,2022-09-25
CASH_OUT,3144,Léon Da Costa,6038,2894,Agence_moov_Abomey,300000,296856,2022-09-27
CASH_IN,95606,Agence_moov_Cotonou,300000,204394,Mathilde de la Samson,1640908,1736514,2022-09-01
CASH_OUT,200619,Mathilde de la Samson,1736514,1535895,Agence_moov_Ouidah,300000,99381,2022-09-02
CASH_OUT,705780,Mathilde de la Samson,1535895,830115,Agence_moov_Ouidah,300000,-405780,2022-09-02
TRANSFER,378405,Sabine Pineau,897852,519447,Mathilde de la Samson,830115,1208520,2022-09-03
CASH_OUT,885261,Mathilde de la Samson,1208520,323259,Agence_moov_Abomey,300000,-585261,2022-09-04
TRANSFER,52719,Mathilde de la Samson,323259,270540,Frédérique Fernandes du Bouchet,423825,371106,2022-09-04
TRANSFER,295710,Mathilde Picard du Delmas,538746,243036,Mathilde de la Samson,270540,566250,2022-09-05
CASH_OUT,241881,Mathilde de la Samson,566250,324369,Agence_moov_Ouidah,300000,58119,2022-09-07
CASH_OUT,262746,Mathilde de la Samson,324369,61623,Agence_moov_Ouidah,300000,37254,2022-09-07
CASH_OUT,34533,Mathilde de la Samson,61623,27090,Agence_moov_Cotonou,300000,265467,2022-09-08
CASH_OUT,22245,Mathilde de la Samson,27090,4845,Agence_moov_Cotonou,300000,277755,2022-09-08
CASH_OUT,4204,Mathilde de la Samson,4845,641,Agence_moov_Ouidah,300000,295796,2022-09-08
TRANSFER,203,Mathilde de la Samson,641,438,Rémy Grondin,1874700,1874497,2022-09-09
CASH_OUT,130,Mathilde de la Samson,438,308,Agence_moov_Cotonou,300000,299870,2022-09-10
CASH_IN,189408,Agence_moov_Ouidah,300000,110592,Mathilde de la Samson,308,189716,2022-09-11
CASH_IN,162910,Agence_moov_Ouidah,300000,137090,Mathilde de la Samson,189716,352626,2022-09-13
CASH_OUT,224975,Mathilde de la Samson,352626,127651,Agence_moov_Abomey,300000,75025,2022-09-15
CASH_IN,200864,Agence_moov_Abomey,300000,99136,Mathilde de la Samson,127651,328515,2022-09-15
CASH_OUT,157804,Mathilde de la Samson,328515,170711,Agence_moov_Abomey,300000,142196,2022-09-16
TRANSFER,71205,Mathilde de la Samson,170711,99506,Jules Fernandes,52896,-18309,2022-09-16
TRANSFER,36875,Mathilde de la Samson,99506,62631,Constance Guillon,166451,129576,2022-09-17
CASH_OUT,33345,Mathilde de la Samson,62631,29286,Agence_moov_Abomey,300000,266655,2022-09-20
CASH_IN,254912,Agence_moov_Ouidah,300000,45088,Mathilde de la Samson,29286,284198,2022-09-20
CASH_OUT,76753,Mathilde de la Samson,284198,207445,Agence_moov_Abomey,300000,223247,2022-09-21
TRANSFER,116416,Thomas Dupont,208811,92395,Mathilde de la Samson,207445,323861,2022-09-22
TRANSFER,69190,Mathilde de la Samson,323861,254671,Mathilde de la Samson,323861,393051,2022-09-22
CASH_OUT,148686,Mathilde de la Samson,254671,105985,Agence_moov_Abomey,300000,151314,2022-09-25
CASH_OUT,33942,Mathilde de la Samson,105985,72043,Agence_moov_Abomey,300000,266058,2022-09-26
CASH_OUT,31172,Mathilde de la Samson,72043,40871,Agence_moov_Cotonou,300000,268828,2022-09-27
CASH_OUT,358178,Colette Merle Le Robert,995346,637168,Agence_moov_Abomey,300000,-58178,2022-09-02
CASH_OUT,498758,Colette Merle Le Robert,637168,138410,Agence_moov_Abomey,300000,-198758,2022-09-02
CASH_OUT,95886,Colette Merle Le Robert,138410,42524,Agence_moov_Abomey,300000,204114,2022-09-02
CASH_IN,273963,Agence_moov_Abomey,300000,26037,Colette Merle Le Robert,42524,316487,2022-09-03
TRANSFER,287655,Colette Merle Le Robert,316487,28832,Colette Merle Le Robert,316487,28832,2022-09-04
CASH_OUT,7300,Colette Merle Le Robert,28832,21532,Agence_moov_Abomey,300000,292700,2022-09-05
CASH_IN,24107,Agence_moov_Ouidah,300000,275893,Colette Merle Le Robert,21532,45639,2022-09-06
CASH_OUT,42165,Colette Merle Le Robert,45639,3474,Agence_moov_Ouidah,300000,257835,2022-09-08
CASH_IN,157060,Agence_moov_Cotonou,300000,142940,Colette Merle Le Robert,3474,160534,2022-09-08
CASH_IN,207659,Agence_moov_Ouidah,300000,92341,Colette Merle Le Robert,160534,368193,2022-09-12
TRANSFER,359104,Astrid Lecoq,1015531,656427,Colette Merle Le Robert,368193,727297,2022-09-12
TRANSFER,111088,Colette Merle Le Robert,727297,616209,Anne Peltier-Raynaud,196000,84912,2022-09-14
CASH_OUT,99583,Colette Merle Le Robert,616209,516626,Agence_moov_Cotonou,300000,200417,2022-09-17
CASH_OUT,41126,Colette Merle Le Robert,516626,475500,Agence_moov_Cotonou,300000,258874,2022-09-20
TRANSFER,403551,Colette Merle Le Robert,475500,71949,Nicolas Salmon Le Hamon,9443,-394108,2022-09-21
CASH_OUT,65745,Colette Merle Le Robert,71949,6204,Agence_moov_Abomey,300000,234255,2022-09-21
CASH_OUT,2977,Colette Merle Le Robert,6204,3227,Agence_moov_Abomey,300000,297023,2022-09-23
TRANSFER,11270,Constance Guillon,129576,118306,Colette Merle Le Robert,3227,14497,2022-09-24
TRANSFER,70286,Hélène de la Gérard,151539,81253,Colette Merle Le Robert,14497,84783,2022-09-25
CASH_OUT,31796,Colette Merle Le Robert,84783,52987,Agence_moov_Abomey,300000,268204,2022-09-26
CASH_IN,296927,Agence_moov_Cotonou,300000,3073,Colette Merle Le Robert,52987,349914,2022-09-27
TRANSFER,413508,Thomas de Blin,953101,539593,Sabine Pineau,519447,105939,2022-09-02
CASH_OUT,101379,Thomas de Blin,539593,438214,Agence_moov_Cotonou,300000,198621,2022-09-02
TRANSFER,284705,Thomas de Blin,438214,153509,Tristan Delahaye,1547489,1262784,2022-09-02
TRANSFER,84884,Thomas de Blin,153509,68625,Thomas Dupont,92395,7511,2022-09-02
TRANSFER,7920,Thomas de Blin,68625,60705,Maggie Martinez,1066205,1058285,2022-09-03
TRANSFER,30720,Thomas de Blin,60705,29985,Sabine Pineau,105939,75219,2022-09-04
TRANSFER,86145,Tristan Gomez,872464,786319,Thomas de Blin,29985,116130,2022-09-04
CASH_OUT,95943,Thomas de Blin,116130,20187,Agence_moov_Ouidah,300000,204057,2022-09-04
CASH_OUT,7211,Thomas de Blin,20187,12976,Agence_moov_Abomey,300000,292789,2022-09-05
CASH_OUT,2120,Thomas de Blin,12976,10856,Agence_moov_Cotonou,300000,297880,2022-09-05
CASH_IN,137158,Agence_moov_Cotonou,300000,162842,Thomas de Blin,10856,148014,2022-09-05
TRANSFER,1549563,Manon Lebon,1557945,8382,Thomas de Blin,148014,1697577,2022-09-07
TRANSFER,814087,Thomas de Blin,1697577,883490,Mathilde Picard du Delmas,243036,-571051,2022-09-08
TRANSFER,810815,Luc Lévêque-Carre,877400,66585,Thomas de Blin,883490,1694305,2022-09-09
CASH_OUT,117330,Thomas de Blin,1694305,1576975,Agence_moov_Abomey,300000,182670,2022-09-09
CASH_OUT,605435,Thomas de Blin,1576975,971540,Agence_moov_Abomey,300000,-305435,2022-09-15
CASH_OUT,582300,Thomas de Blin,971540,389240,Agence_moov_Abomey,300000,-282300,2022-09-16
CASH_IN,263665,Agence_moov_Abomey,300000,36335,Thomas de Blin,389240,652905,2022-09-16
CASH_IN,259676,Agence_moov_Ouidah,300000,40324,Thomas de Blin,652905,912581,2022-09-17
CASH_OUT,803155,Thomas de Blin,912581,109426,Agence_moov_Ouidah,300000,-503155,2022-09-19
CASH_IN,85250,Agence_moov_Ouidah,300000,214750,Thomas de Blin,109426,194676,2022-09-22
CASH_OUT,190027,Thomas de Blin,194676,4649,Agence_moov_Ouidah,300000,109973,2022-09-22
CASH_IN,162759,Agence_moov_Ouidah,300000,137241,Jules Fernandes,-18309,144450,2022-09-02
CASH_OUT,97457,Jules Fernandes,144450,46993,Agence_moov_Cotonou,300000,202543,2022-09-02
CASH_IN,195360,Agence_moov_Ouidah,300000,104640,Jules Fernandes,46993,242353,2022-09-03
TRANSFER,2479,Emmanuel Grégoire,10981,8502,Jules Fernandes,242353,244832,2022-09-04
CASH_IN,65968,Agence_moov_Abomey,300000,234032,Jules Fernandes,244832,310800,2022-09-06
CASH_IN,69397,Agence_moov_Abomey,300000,230603,Jules Fernandes,310800,380197,2022-09-07
CASH_OUT,279512,Jules Fernandes,380197,100685,Agence_moov_Ouidah,300000,20488,2022-09-08
CASH_IN,4603,Agence_moov_Abomey,300000,295397,Jules Fernandes,100685,105288,2022-09-09
CASH_OUT,50963,Jules Fernandes,105288,54325,Agence_moov_Cotonou,300000,249037,2022-09-11
CASH_IN,138137,Agence_moov_Ouidah,300000,161863,Jules Fernandes,54325,192462,2022-09-13
TRANSFER,185842,Jules Fernandes,192462,6620,Michelle Samson,313174,127332,2022-09-14
CASH_OUT,4767,Jules Fernandes,6620,1853,Agence_moov_Ouidah,300000,295233,2022-09-15
CASH_IN,182011,Agence_moov_Ouidah,300000,117989,Jules Fernandes,1853,183864,2022-09-16
CASH_OUT,83733,Jules Fernandes,183864,100131,Agence_moov_Ouidah,300000,216267,2022-09-18
TRANSFER,3604,Manon Lebon,8382,4778,Jules Fernandes,100131,103735,2022-09-19
TRANSFER,34326,Jules Fernandes,103735,69409,Émilie du Allain,767240,732914,2022-09-21
TRANSFER,59282,Jules Fernandes,69409,10127,Nathalie Bonnin-Joubert,30810,-28472,2022-09-22
CASH_IN,148384,Agence_moov_Ouidah,300000,151616,Jules Fernandes,10127,158511,2022-09-24
TRANSFER,123978,Jules Fernandes,158511,34533,Robert Laroche,279827,155849,2022-09-25
CASH_IN,290046,Agence_moov_Abomey,300000,9954,Jules Fernandes,34533,324579,2022-09-26
CASH_IN,130664,Agence_moov_Ouidah,300000,169336,Jules Fernandes,324579,455243,2022-09-27
CASH_IN,73857,Agence_moov_Ouidah,300000,226143,Nathalie Bonnin-Joubert,-28472,45385,2022-09-01
CASH_IN,256065,Agence_moov_Abomey,300000,43935,Nathalie Bonnin-Joubert,45385,301450,2022-09-02
CASH_OUT,185201,Nathalie Bonnin-Joubert,301450,116249,Agence_moov_Cotonou,300000,114799,2022-09-04
TRANSFER,62468,Nathalie Bonnin-Joubert,116249,53781,Constance Guillon,118306,55838,2022-09-04
TRANSFER,86154,Astrid Lecoq,656427,570273,Nathalie Bonnin-Joubert,53781,139935,2022-09-04
CASH_OUT,39939,Nathalie Bonnin-Joubert,139935,99996,Agence_moov_Abomey,300000,260061,2022-09-06
CASH_OUT,27317,Nathalie Bonnin-Joubert,99996,72679,Agence_moov_Ouidah,300000,272683,2022-09-08
CASH_OUT,26391,Nathalie Bonnin-Joubert,72679,46288,Agence_moov_Abomey,300000,273609,2022-09-08
CASH_IN,185892,Agence_moov_Ouidah,300000,114108,Nathalie Bonnin-Joubert,46288,232180,2022-09-09
CASH_IN,191673,Agence_moov_Cotonou,300000,108327,Nathalie Bonnin-Joubert,232180,423853,2022-09-09
TRANSFER,133790,Nathalie Bonnin-Joubert,423853,290063,Frédérique Fernandes du Bouchet,371106,237316,2022-09-10
CASH_IN,42635,Agence_moov_Ouidah,300000,257365,Nathalie Bonnin-Joubert,290063,332698,2022-09-11
CASH_OUT,290587,Nathalie Bonnin-Joubert,332698,42111,Agence_moov_Ouidah,300000,9413,2022-09-12
CASH_IN,1224,Agence_moov_Abomey,300000,298776,Nathalie Bonnin-Joubert,42111,43335,2022-09-13
CASH_IN,262515,Agence_moov_Ouidah,300000,37485,Nathalie Bonnin-Joubert,43335,305850,2022-09-14
CASH_IN,79988,Agence_moov_Abomey,300000,220012,Nathalie Bonnin-Joubert,305850,385838,2022-09-16
CASH_IN,244713,Agence_moov_Cotonou,300000,55287,Nathalie Bonnin-Joubert,385838,630551,2022-09-17
CASH_OUT,517464,Nathalie Bonnin-Joubert,630551,113087,Agence_moov_Ouidah,300000,-217464,2022-09-18
CASH_IN,98172,Agence_moov_Abomey,300000,201828,Nathalie Bonnin-Joubert,113087,211259,2022-09-20
CASH_IN,202521,Agence_moov_Ouidah,300000,97479,Nathalie Bonnin-Joubert,211259,413780,2022-09-22
CASH_OUT,53661,Nathalie Bonnin-Joubert,413780,360119,Agence_moov_Abomey,300000,246339,2022-09-23
CASH_IN,133084,Agence_moov_Abomey,300000,166916,Nathalie Bonnin-Joubert,360119,493203,2022-09-25
TRANSFER,3618,Thomas Dupont,7511,3893,Nathalie Bonnin-Joubert,493203,496821,2022-09-26
CASH_OUT,74269,Nathalie Bonnin-Joubert,496821,422552,Agence_moov_Ouidah,300000,225731,2022-09-27
CASH_IN,43379,Agence_moov_Cotonou,300000,256621,André Renault,-71396,-28017,2022-09-03
CASH_IN,116086,Agence_moov_Cotonou,300000,183914,André Renault,-28017,88069,2022-09-04
TRANSFER,87768,André Renault,88069,301,Rémy Grondin,1874497,1786729,2022-09-05
TRANSFER,533455,Gérard de la Martinez,709675,176220,André Renault,301,533756,2022-09-07
TRANSFER,210764,André Renault,533756,322992,Martine Aubert,1489002,1278238,2022-09-07
TRANSFER,77944,André Renault,322992,245048,Constance Bourdon-Millet,161587,83643,2022-09-07
CASH_OUT,57324,André Renault,245048,187724,Agence_moov_Abomey,300000,242676,2022-09-10
TRANSFER,12938,Victor Michel,124585,111647,André Renault,187724,200662,2022-09-10
CASH_IN,133877,Agence_moov_Ouidah,300000,166123,André Renault,200662,334539,2022-09-12
CASH_IN,244918,Agence_moov_Ouidah,300000,55082,André Renault,334539,579457,2022-09-13
CASH_IN,6451,Agence_moov_Cotonou,300000,293549,André Renault,579457,585908,2022-09-14
TRANSFER,295074,André Renault,585908,290834,Noël Bourgeois,689697,394623,2022-09-15
TRANSFER,615572,Martine Aubert,1278238,662666,André Renault,290834,906406,2022-09-15
TRANSFER,118900,André Renault,906406,787506,Astrid Lecoq,570273,451373,2022-09-18
CASH_IN,175859,Agence_moov_Abomey,300000,124141,André Renault,787506,963365,2022-09-19
TRANSFER,67964,Victor Michel,111647,43683,André Renault,963365,1031329,2022-09-20
CASH_OUT,49233,André Renault,1031329,982096,Agence_moov_Ouidah,300000,250767,2022-09-20
CASH_IN,269757,Agence_moov_Abomey,300000,30243,André Renault,982096,1251853,2022-09-20
CASH_OUT,798469,André Renault,1251853,453384,Agence_moov_Abomey,300000,-498469,2022-09-21
TRANSFER,427795,André Renault,453384,25589,Constance Bourdon-Millet,83643,-344152,2022-09-23
CASH_OUT,11811,André Renault,25589,13778,Agence_moov_Abomey,300000,288189,2022-09-23
TRANSFER,41320,Luc Lévêque-Carre,66585,25265,André Renault,13778,55098,2022-09-24
CASH_OUT,44634,André Renault,55098,10464,Agence_moov_Cotonou,300000,255366,2022-09-24
CASH_OUT,3477,André Renault,10464,6987,Agence_moov_Ouidah,300000,296523,2022-09-25
CASH_IN,236699,Agence_moov_Abomey,300000,63301,André Renault,6987,243686,2022-09-25
CASH_OUT,161908,André Renault,243686,81778,Agence_moov_Ouidah,300000,138092,2022-09-26
CASH_IN,220223,Agence_moov_Abomey,300000,79777,Marc Leleu,1703000,1923223,2022-09-01
CASH_OUT,1426255,Marc Leleu,1923223,496968,Agence_moov_Abomey,300000,-1126255,2022-09-01
TRANSFER,380600,Marc Leleu,496968,116368,Manon Lebon,4778,-375822,2022-09-02
CASH_IN,65945,Agence_moov_Ouidah,300000,234055,Marc Leleu,116368,182313,2022-09-02
CASH_OUT,137079,Marc Leleu,182313,45234,Agence_moov_Cotonou,300000,162921,2022-09-03
CASH_OUT,34490,Marc Leleu,45234,10744,Agence_moov_Ouidah,300000,265510,2022-09-03
CASH_IN,190426,Agence_moov_Abomey,300000,109574,Marc Leleu,10744,201170,2022-09-04
CASH_IN,39660,Agence_moov_Ouidah,300000,260340,Marc Leleu,201170,240830,2022-09-04
CASH_IN,164250,Agence_moov_Abomey,300000,135750,Marc Leleu,240830,405080,2022-09-05
CASH_IN,206326,Agence_moov_Abomey,300000,93674,Marc Leleu,405080,611406,2022-09-07
TRANSFER,201878,Marc Leleu,611406,409528,Gérard de la Martinez,176220,-25658,2022-09-10
TRANSFER,43386,Frédérique Fernandes du Bouchet,237316,193930,Marc Leleu,409528,452914,2022-09-12
CASH_OUT,42513,Marc Leleu,452914,410401,Agence_moov_Abomey,300000,257487,2022-09-12
TRANSFER,3522,Noël Bourgeois,394623,391101,Marc Leleu,410401,413923,2022-09-12
CASH_OUT,33020,Marc Leleu,413923,380903,Agence_moov_Ouidah,300000,266980,2022-09-12
CASH_IN,109349,Agence_moov_Abomey,300000,190651,Marc Leleu,380903,490252,2022-09-15
TRANSFER,8389,Victor Michel,43683,35294,Marc Leleu,490252,498641,2022-09-16
TRANSFER,10411,Constance Guillon,55838,45427,Marc Leleu,498641,509052,2022-09-17
TRANSFER,199148,Marc Leleu,509052,309904,Emmanuel Grégoire,8502,-190646,2022-09-17
TRANSFER,117002,Michelle Samson,127332,10330,Marc Leleu,309904,426906,2022-09-18
CASH_OUT,257412,Marc Leleu,426906,169494,Agence_moov_Abomey,300000,42588,2022-09-19
CASH_IN,270039,Agence_moov_Ouidah,300000,29961,Marc Leleu,169494,439533,2022-09-20
CASH_OUT,388078,Marc Leleu,439533,51455,Agence_moov_Cotonou,300000,-88078,2022-09-20
TRANSFER,18937,Marc Leleu,51455,32518,Matthieu-Matthieu Bigot,89770,70833,2022-09-22
CASH_IN,275149,Agence_moov_Cotonou,300000,24851,Marc Leleu,32518,307667,2022-09-22
CASH_OUT,254788,Marc Leleu,307667,52879,Agence_moov_Ouidah,300000,45212,2022-09-24
TRANSFER,27883,Marc Leleu,52879,24996,Rémy Grondin,1786729,1758846,2022-09-24
CASH_OUT,15790,Marc Leleu,24996,9206,Agence_moov_Abomey,300000,284210,2022-09-27
CASH_OUT,7372,Anne Peltier-Raynaud,84912,77540,Agence_moov_Ouidah,300000,292628,2022-09-01
CASH_OUT,58137,Anne Peltier-Raynaud,77540,19403,Agence_moov_Ouidah,300000,241863,2022-09-03
CASH_OUT,14330,Anne Peltier-Raynaud,19403,5073,Agence_moov_Cotonou,300000,285670,2022-09-08
CASH_IN,184907,Agence_moov_Cotonou,300000,115093,Anne Peltier-Raynaud,5073,189980,2022-09-10
CASH_IN,157100,Agence_moov_Ouidah,300000,142900,Anne Peltier-Raynaud,189980,347080,2022-09-16
TRANSFER,223543,Anne Peltier-Raynaud,347080,123537,Nath Loiseau,701268,477725,2022-09-17
TRANSFER,85770,Anne Peltier-Raynaud,123537,37767,Simone Muller de la Brun,1199545,1113775,2022-09-21
CASH_IN,179903,Agence_moov_Abomey,300000,120097,Anne Peltier-Raynaud,37767,217670,2022-09-22
CASH_IN,275687,Agence_moov_Cotonou,300000,24313,Anne Peltier-Raynaud,217670,493357,2022-09-24
TRANSFER,272262,Anne Peltier-Raynaud,493357,221095,Matthieu-Matthieu Bigot,70833,-201429,2022-09-25
CASH_IN,14341,Agence_moov_Ouidah,300000,285659,Anne Peltier-Raynaud,221095,235436,2022-09-27
CASH_IN,130137,Agence_moov_Cotonou,300000,169863,Martine Aubert,662666,792803,2022-09-03
CASH_OUT,751697,Martine Aubert,792803,41106,Agence_moov_Cotonou,300000,-451697,2022-09-07
TRANSFER,16945,Martine Aubert,41106,24161,Michelle de Étienne,125206,108261,2022-09-13
CASH_OUT,7891,Martine Aubert,24161,16270,Agence_moov_Abomey,300000,292109,2022-09-13
CASH_OUT,6945,Martine Aubert,16270,9325,Agence_moov_Cotonou,300000,293055,2022-09-15
TRANSFER,470,Thomas Dupont,3893,3423,Martine Aubert,9325,9795,2022-09-17
CASH_IN,203525,Agence_moov_Cotonou,300000,96475,Martine Aubert,9795,213320,2022-09-20
CASH_IN,89681,Agence_moov_Ouidah,300000,210319,Martine Aubert,213320,303001,2022-09-20
TRANSFER,39703,Hélène de la Gérard,81253,41550,Martine Aubert,303001,342704,2022-09-22
CASH_IN,93506,Agence_moov_Abomey,300000,206494,Martine Aubert,342704,436210,2022-09-25
CASH_IN,67616,Agence_moov_Ouidah,300000,232384,Martine Aubert,436210,503826,2022-09-27
CASH_IN,212831,Agence_moov_Ouidah,300000,87169,Audrey Julien de Leleu,785190,998021,2022-09-01
TRANSFER,588943,Audrey Julien de Leleu,998021,409078,Audrey Julien de Leleu,998021,1586964,2022-09-02
CASH_IN,270474,Agence_moov_Cotonou,300000,29526,Audrey Julien de Leleu,409078,679552,2022-09-03
TRANSFER,256649,Aurore Charrier,370346,113697,Audrey Julien de Leleu,679552,936201,2022-09-08
CASH_IN,172998,Agence_moov_Abomey,300000,127002,Audrey Julien de Leleu,936201,1109199,2022-09-09
TRANSFER,1286718,Rémy Grondin,1758846,472128,Audrey Julien de Leleu,1109199,2395917,2022-09-09
TRANSFER,23645,Luc Lévêque-Carre,25265,1620,Audrey Julien de Leleu,2395917,2419562,2022-09-13
TRANSFER,36749,Benoît Guyot,248757,212008,Audrey Julien de Leleu,2419562,2456311,2022-09-13
CASH_OUT,1533469,Audrey Julien de Leleu,2456311,922842,Agence_moov_Cotonou,300000,-1233469,2022-09-13
CASH_IN,144001,Agence_moov_Cotonou,300000,155999,Audrey Julien de Leleu,922842,1066843,2022-09-13
CASH_IN,12230,Agence_moov_Ouidah,300000,287770,Audrey Julien de Leleu,1066843,1079073,2022-09-17
TRANSFER,274943,Véronique Martins de Fleury,404642,129699,Audrey Julien de Leleu,1079073,1354016,2022-09-17
TRANSFER,109330,Robert Laroche,155849,46519,Audrey Julien de Leleu,1354016,1463346,2022-09-19
CASH_OUT,87734,Audrey Julien de Leleu,1463346,1375612,Agence_moov_Cotonou,300000,212266,2022-09-21
CASH_IN,65089,Agence_moov_Abomey,300000,234911,Audrey Julien de Leleu,1375612,1440701,2022-09-23
TRANSFER,729099,Maggie Martinez,1058285,329186,Audrey Julien de Leleu,1440701,2169800,2022-09-25
CASH_IN,133541,Agence_moov_Cotonou,300000,166459,Audrey Julien de Leleu,2169800,2303341,2022-09-27
TRANSFER,1829513,Audrey Julien de Leleu,2303341,473828,Véronique Martins de Fleury,129699,-1699814,2022-09-27
CASH_IN,288013,Agence_moov_Ouidah,300000,11987,Matthieu-Matthieu Bigot,-201429,86584,2022-09-07
CASH_IN,271646,Agence_moov_Cotonou,300000,28354,Matthieu-Matthieu Bigot,86584,358230,2022-09-09
CASH_IN,277821,Agence_moov_Cotonou,300000,22179,Matthieu-Matthieu Bigot,358230,636051,2022-09-09
TRANSFER,84279,Matthieu-Matthieu Bigot,636051,551772,Andrée-Thérèse Mendès,50645,-33634,2022-09-10
CASH_IN,84910,Agence_moov_Abomey,300000,215090,Matthieu-Matthieu Bigot,551772,636682,2022-09-11
CASH_OUT,344427,Matthieu-Matthieu Bigot,636682,292255,Agence_moov_Abomey,300000,-44427,2022-09-13
CASH_IN,279509,Agence_moov_Abomey,300000,20491,Matthieu-Matthieu Bigot,292255,571764,2022-09-14
CASH_IN,47537,Agence_moov_Cotonou,300000,252463,Matthieu-Matthieu Bigot,571764,619301,2022-09-17
CASH_OUT,334142,Matthieu-Matthieu Bigot,619301,285159,Agence_moov_Ouidah,300000,-34142,2022-09-18
CASH_IN,234511,Agence_moov_Ouidah,300000,65489,Matthieu-Matthieu Bigot,285159,519670,2022-09-19
CASH_OUT,222889,Matthieu-Matthieu Bigot,519670,296781,Agence_moov_Ouidah,300000,77111,2022-09-20
CASH_OUT,277289,Matthieu-Matthieu Bigot,296781,19492,Agence_moov_Cotonou,300000,22711,2022-09-21
CASH_IN,283967,Agence_moov_Abomey,300000,16033,Matthieu-Matthieu Bigot,19492,303459,2022-09-25
TRANSFER,149278,Matthieu-Matthieu Bigot,303459,154181,Victor Michel,35294,-113984,2022-09-25
CASH_IN,203002,Agence_moov_Cotonou,300000,96998,Matthieu-Matthieu Bigot,154181,357183,2022-09-25
CASH_OUT,112192,Matthieu-Matthieu Bigot,357183,244991,Agence_moov_Ouidah,300000,187808,2022-09-26
TRANSFER,92909,Aurore Charrier,113697,20788,Noël Bourgeois,391101,484010,2022-09-01
CASH_IN,48341,Agence_moov_Cotonou,300000,251659,Noël Bourgeois,484010,532351,2022-09-03
CASH_IN,175199,Agence_moov_Ouidah,300000,124801,Noël Bourgeois,532351,707550,2022-09-06
CASH_IN,58843,Agence_moov_Ouidah,300000,241157,Noël Bourgeois,707550,766393,2022-09-07
CASH_OUT,253954,Noël Bourgeois,766393,512439,Agence_moov_Ouidah,300000,46046,2022-09-09
CASH_IN,95777,Agence_moov_Ouidah,300000,204223,Noël Bourgeois,512439,608216,2022-09-12
TRANSFER,122897,Benoît Guyot,212008,89111,Noël Bourgeois,608216,731113,2022-09-13
CASH_OUT,464641,Noël Bourgeois,731113,266472,Agence_moov_Cotonou,300000,-164641,2022-09-14
TRANSFER,10102,Robert Laroche,46519,36417,Noël Bourgeois,266472,276574,2022-09-14
TRANSFER,151091,Noël Bourgeois,276574,125483,Robert Laroche,36417,-114674,2022-09-17
CASH_OUT,117404,Noël Bourgeois,125483,8079,Agence_moov_Abomey,300000,182596,2022-09-18
CASH_IN,118901,Agence_moov_Abomey,300000,181099,Noël Bourgeois,8079,126980,2022-09-19
TRANSFER,84803,Noël Bourgeois,126980,42177,Agnès Le Giraud,185410,100607,2022-09-24
CASH_OUT,25807,Noël Bourgeois,42177,16370,Agence_moov_Abomey,300000,274193,2022-09-25
CASH_OUT,13901,Noël Bourgeois,16370,2469,Agence_moov_Ouidah,300000,286099,2022-09-26
CASH_IN,29635,Agence_moov_Abomey,300000,270365,Noël Bourgeois,2469,32104,2022-09-27
CASH_IN,63807,Agence_moov_Ouidah,300000,236193,Gérard de la Martinez,-25658,38149,2022-09-03
CASH_IN,235498,Agence_moov_Ouidah,300000,64502,Gérard de la Martinez,38149,273647,2022-09-03
CASH_IN,82688,Agence_moov_Ouidah,300000,217312,Gérard de la Martinez,273647,356335,2022-09-06
CASH_OUT,244888,Gérard de la Martinez,356335,111447,Agence_moov_Abomey,300000,55112,2022-09-06
CASH_IN,70220,Agence_moov_Cotonou,300000,229780,Gérard de la Martinez,111447,181667,2022-09-07
CASH_IN,296733,Agence_moov_Ouidah,300000,3267,Gérard de la Martinez,181667,478400,2022-09-07
CASH_IN,290229,Agence_moov_Cotonou,300000,9771,Gérard de la Martinez,478400,768629,2022-09-11
CASH_OUT,245680,Gérard de la Martinez,768629,522949,Agence_moov_Cotonou,300000,54320,2022-09-13
CASH_IN,74965,Agence_moov_Abomey,300000,225035,Gérard de la Martinez,522949,597914,2022-09-14
TRANSFER,288,Thomas Dupont,3423,3135,Gérard de la Martinez,597914,598202,2022-09-15
CASH_OUT,534132,Gérard de la Martinez,598202,64070,Agence_moov_Ouidah,300000,-234132,2022-09-17
CASH_OUT,46929,Gérard de la Martinez,64070,17141,Agence_moov_Abomey,300000,253071,2022-09-19
TRANSFER,41341,Rémy Grondin,472128,430787,Gérard de la Martinez,17141,58482,2022-09-19
TRANSFER,34146,Gérard de la Martinez,58482,24336,Vincent Joubert,23090,-11056,2022-09-21
TRANSFER,782305,Tristan Gomez,786319,4014,Gérard de la Martinez,24336,806641,2022-09-21
CASH_OUT,640044,Gérard de la Martinez,806641,166597,Agence_moov_Cotonou,300000,-340044,2022-09-22
CASH_IN,67691,Agence_moov_Abomey,300000,232309,Gérard de la Martinez,166597,234288,2022-09-25
CASH_OUT,103951,Gérard de la Martinez,234288,130337,Agence_moov_Abomey,300000,196049,2022-09-27
CASH_IN,50740,Agence_moov_Ouidah,300000,249260,Manon Lebon,-375822,-325082,2022-09-03
CASH_IN,267604,Agence_moov_Abomey,300000,32396,Manon Lebon,-325082,-57478,2022-09-04
CASH_IN,142383,Agence_moov_Ouidah,300000,157617,Manon Lebon,-57478,84905,2022-09-07
TRANSFER,129177,Renée Rousseau-Henry,293270,164093,Manon Lebon,84905,214082,2022-09-07
TRANSFER,156953,Manon Lebon,214082,57129,Luc Lévêque-Carre,1620,-155333,2022-09-08
CASH_OUT,56984,Manon Lebon,57129,145,Agence_moov_Cotonou,300000,243016,2022-09-08
CASH_IN,30644,Agence_moov_Ouidah,300000,269356,Manon Lebon,145,30789,2022-09-10
CASH_OUT,22668,Manon Lebon,30789,8121,Agence_moov_Cotonou,300000,277332,2022-09-13
CASH_OUT,7458,Manon Lebon,8121,663,Agence_moov_Cotonou,300000,292542,2022-09-14
TRANSFER,824,Michelle Samson,10330,9506,Manon Lebon,663,1487,2022-09-18
TRANSFER,645,Manon Lebon,1487,842,Hélène de la Gérard,41550,40905,2022-09-19
CASH_IN,163699,Agence_moov_Ouidah,300000,136301,Manon Lebon,842,164541,2022-09-19
TRANSFER,119506,Astrid Lecoq,451373,331867,Manon Lebon,164541,284047,2022-09-21
CASH_OUT,118840,Manon Lebon,284047,165207,Agence_moov_Cotonou,300000,181160,2022-09-22
TRANSFER,58275,Manon Lebon,165207,106932,Frédérique Fernandes du Bouchet,193930,135655,2022-09-22
TRANSFER,3403,Manon Lebon,106932,103529,Adèle Da Silva-Klein,317800,314397,2022-09-22
CASH_IN,160195,Agence_moov_Cotonou,300000,139805,Manon Lebon,103529,263724,2022-09-25
TRANSFER,66301,Manon Lebon,263724,197423,Frédérique Fernandes du Bouchet,135655,69354,2022-09-26
TRANSFER,133320,Manon Lebon,197423,64103,Michelle Samson,9506,-123814,2022-09-27
CASH_OUT,28371,Manon Lebon,64103,35732,Agence_moov_Abomey,300000,271629,2022-09-27
CASH_IN,225441,Agence_moov_Ouidah,300000,74559,Véronique Martins de Fleury,-1699814,-1474373,2022-09-02
CASH_IN,123381,Agence_moov_Abomey,300000,176619,Véronique Martins de Fleury,-1474373,-1350992,2022-09-03
CASH_IN,218802,Agence_moov_Cotonou,300000,81198,Véronique Martins de Fleury,-1350992,-1132190,2022-09-05
CASH_IN,139874,Agence_moov_Abomey,300000,160126,Véronique Martins de Fleury,-1132190,-992316,2022-09-07
CASH_IN,180298,Agence_moov_Abomey,300000,119702,Véronique Martins de Fleury,-992316,-812018,2022-09-12
CASH_IN,250214,Agence_moov_Cotonou,300000,49786,Véronique Martins de Fleury,-812018,-561804,2022-09-20
CASH_IN,137223,Agence_moov_Cotonou,300000,162777,Véronique Martins de Fleury,-561804,-424581,2022-09-20
CASH_IN,134349,Agence_moov_Ouidah,300000,165651,Véronique Martins de Fleury,-424581,-290232,2022-09-21
CASH_IN,197337,Agence_moov_Cotonou,300000,102663,Véronique Martins de Fleury,-290232,-92895,2022-09-24
CASH_IN,45359,Agence_moov_Abomey,300000,254641,Renée Rousseau-Henry,164093,209452,2022-09-01
TRANSFER,2547,Thomas Dupont,3135,588,Renée Rousseau-Henry,209452,211999,2022-09-02
TRANSFER,78828,Renée Rousseau-Henry,211999,133171,Renée Rousseau-Henry,211999,133171,2022-09-02
CASH_OUT,101258,Renée Rousseau-Henry,133171,31913,Agence_moov_Cotonou,300000,198742,2022-09-05
CASH_OUT,24608,Renée Rousseau-Henry,31913,7305,Agence_moov_Abomey,300000,275392,2022-09-05
CASH_IN,248178,Agence_moov_Abomey,300000,51822,Renée Rousseau-Henry,7305,255483,2022-09-05
TRANSFER,231176,Renée Rousseau-Henry,255483,24307,Frédérique Fernandes du Bouchet,69354,-161822,2022-09-07
CASH_OUT,10653,Renée Rousseau-Henry,24307,13654,Agence_moov_Cotonou,300000,289347,2022-09-07
CASH_OUT,12471,Renée Rousseau-Henry,13654,1183,Agence_moov_Cotonou,300000,287529,2022-09-09
CASH_OUT,538,Renée Rousseau-Henry,1183,645,Agence_moov_Abomey,300000,299462,2022-09-15
CASH_OUT,351,Renée Rousseau-Henry,645,294,Agence_moov_Abomey,300000,299649,2022-09-20
CASH_IN,181981,Agence_moov_Cotonou,300000,118019,Renée Rousseau-Henry,294,182275,2022-09-22
TRANSFER,120763,Renée Rousseau-Henry,182275,61512,Benoît Guyot,89111,-31652,2022-09-22
CASH_OUT,43832,Renée Rousseau-Henry,61512,17680,Agence_moov_Ouidah,300000,256168,2022-09-22
CASH_IN,263250,Agence_moov_Cotonou,300000,36750,Renée Rousseau-Henry,17680,280930,2022-09-23
TRANSFER,101693,Renée Rousseau-Henry,280930,179237,Aurore Charrier,20788,-80905,2022-09-24
CASH_OUT,134817,Renée Rousseau-Henry,179237,44420,Agence_moov_Ouidah,300000,165183,2022-09-25
CASH_OUT,25732,Renée Rousseau-Henry,44420,18688,Agence_moov_Cotonou,300000,274268,2022-09-27
CASH_IN,158697,Agence_moov_Ouidah,300000,141303,Mathilde Picard du Delmas,-571051,-412354,2022-09-08
CASH_IN,166595,Agence_moov_Abomey,300000,133405,Mathilde Picard du Delmas,-412354,-245759,2022-09-09
CASH_IN,251818,Agence_moov_Ouidah,300000,48182,Mathilde Picard du Delmas,-245759,6059,2022-09-09
CASH_OUT,5945,Mathilde Picard du Delmas,6059,114,Agence_moov_Cotonou,300000,294055,2022-09-15
CASH_IN,258062,Agence_moov_Cotonou,300000,41938,Mathilde Picard du Delmas,114,258176,2022-09-18
CASH_IN,191539,Agence_moov_Abomey,300000,108461,Mathilde Picard du Delmas,258176,449715,2022-09-19
CASH_OUT,273694,Mathilde Picard du Delmas,449715,176021,Agence_moov_Abomey,300000,26306,2022-09-20
TRANSFER,84784,Michelle de Étienne,108261,23477,Mathilde Picard du Delmas,176021,260805,2022-09-22
CASH_IN,156133,Agence_moov_Ouidah,300000,143867,Mathilde Picard du Delmas,260805,416938,2022-09-22
CASH_IN,7604,Agence_moov_Abomey,300000,292396,Mathilde Picard du Delmas,416938,424542,2022-09-23
TRANSFER,267934,Maggie Martinez,329186,61252,Mathilde Picard du Delmas,424542,692476,2022-09-23
CASH_OUT,179284,Mathilde Picard du Delmas,692476,513192,Agence_moov_Cotonou,300000,120716,2022-09-24
CASH_IN,141745,Agence_moov_Cotonou,300000,158255,Mathilde Picard du Delmas,513192,654937,2022-09-25
CASH_IN,180160,Agence_moov_Ouidah,300000,119840,Mathilde Picard du Delmas,654937,835097,2022-09-27
CASH_IN,195662,Agence_moov_Abomey,300000,104338,Nath Loiseau,477725,673387,2022-09-04
TRANSFER,121333,Rémy Grondin,430787,309454,Nath Loiseau,673387,794720,2022-09-04
CASH_OUT,650181,Nath Loiseau,794720,144539,Agence_moov_Ouidah,300000,-350181,2022-09-10
CASH_OUT,57310,Nath Loiseau,144539,87229,Agence_moov_Cotonou,300000,242690,2022-09-11
TRANSFER,157998,Lucy Gillet,345769,187771,Nath Loiseau,87229,245227,2022-09-11
CASH_OUT,118562,Nath Loiseau,245227,126665,Agence_moov_Cotonou,300000,181438,2022-09-11
CASH_IN,87958,Agence_moov_Abomey,300000,212042,Nath Loiseau,126665,214623,2022-09-12
CASH_OUT,26774,Nath Loiseau,214623,187849,Agence_moov_Cotonou,300000,273226,2022-09-12
CASH_IN,190658,Agence_moov_Ouidah,300000,109342,Nath Loiseau,187849,378507,2022-09-13
TRANSFER,28628,Lucy Gillet,187771,159143,Nath Loiseau,378507,407135,2022-09-13
TRANSFER,363113,Nath Loiseau,407135,44022,Simone Muller de la Brun,1113775,750662,2022-09-16
CASH_OUT,28131,Nath Loiseau,44022,15891,Agence_moov_Cotonou,300000,271869,2022-09-21
TRANSFER,218099,Rémy Grondin,309454,91355,Nath Loiseau,15891,233990,2022-09-22
CASH_OUT,56082,Nath Loiseau,233990,177908,Agence_moov_Abomey,300000,243918,2022-09-23
TRANSFER,127796,Nath Loiseau,177908,50112,Michelle de Étienne,23477,-104319,2022-09-24
CASH_OUT,56812,Lucy Gillet,159143,102331,Agence_moov_Abomey,300000,243188,2022-09-01
CASH_OUT,41321,Lucy Gillet,102331,61010,Agence_moov_Abomey,300000,258679,2022-09-03
TRANSFER,537,Lucy Gillet,61010,60473,Lucy Gillet,61010,61547,2022-09-03
CASH_OUT,52112,Lucy Gillet,60473,8361,Agence_moov_Abomey,300000,247888,2022-09-04
CASH_IN,239027,Agence_moov_Cotonou,300000,60973,Lucy Gillet,8361,247388,2022-09-12
CASH_OUT,125998,Lucy Gillet,247388,121390,Agence_moov_Abomey,300000,174002,2022-09-13
CASH_OUT,103268,Lucy Gillet,121390,18122,Agence_moov_Abomey,300000,196732,2022-09-15
CASH_OUT,16812,Lucy Gillet,18122,1310,Agence_moov_Abomey,300000,283188,2022-09-15
CASH_IN,237520,Agence_moov_Ouidah,300000,62480,Lucy Gillet,1310,238830,2022-09-17
CASH_IN,198500,Agence_moov_Ouidah,300000,101500,Lucy Gillet,238830,437330,2022-09-18
CASH_IN,71579,Agence_moov_Ouidah,300000,228421,Lucy Gillet,437330,508909,2022-09-18
TRANSFER,26431,Constance Guillon,45427,18996,Lucy Gillet,508909,535340,2022-09-19
CASH_OUT,342359,Lucy Gillet,535340,192981,Agence_moov_Abomey,300000,-42359,2022-09-20
CASH_OUT,144364,Lucy Gillet,192981,48617,Agence_moov_Cotonou,300000,155636,2022-09-21
CASH_OUT,40861,Lucy Gillet,48617,7756,Agence_moov_Abomey,300000,259139,2022-09-21
CASH_IN,229179,Agence_moov_Ouidah,300000,70821,Lucy Gillet,7756,236935,2022-09-22
TRANSFER,133668,Lucy Gillet,236935,103267,Adèle Da Silva-Klein,314397,180729,2022-09-25
TRANSFER,96213,Lucy Gillet,103267,7054,Thomas Dupont,588,-95625,2022-09-25
CASH_IN,9735,Agence_moov_Cotonou,300000,290265,Lucy Gillet,7054,16789,2022-09-25
TRANSFER,8096,Lucy Gillet,16789,8693,Tristan Delahaye,1262784,1254688,2022-09-27
TRANSFER,128597,Adèle Da Silva-Klein,180729,52132,Thomas-Robert Morvan,117729,-10868,2022-09-05
TRANSFER,49304,Adèle Da Silva-Klein,52132,2828,Maggie Martinez,61252,11948,2022-09-05
CASH_OUT,1603,Adèle Da Silva-Klein,2828,1225,Agence_moov_Ouidah,300000,298397,2022-09-06
CASH_OUT,1025,Adèle Da Silva-Klein,1225,200,Agence_moov_Ouidah,300000,298975,2022-09-08
TRANSFER,165,Adèle Da Silva-Klein,200,35,Émilie du Allain,732914,732749,2022-09-10
CASH_IN,288790,Agence_moov_Cotonou,300000,11210,Adèle Da Silva-Klein,35,288825,2022-09-11
CASH_IN,284142,Agence_moov_Abomey,300000,15858,Adèle Da Silva-Klein,288825,572967,2022-09-11
TRANSFER,1128563,Tristan Delahaye,1254688,126125,Adèle Da Silva-Klein,572967,1701530,2022-09-15
CASH_OUT,1634594,Adèle Da Silva-Klein,1701530,66936,Agence_moov_Cotonou,300000,-1334594,2022-09-16
TRANSFER,34669,Adèle Da Silva-Klein,66936,32267,Rémy Grondin,91355,56686,2022-09-16
CASH_IN,33852,Agence_moov_Ouidah,300000,266148,Adèle Da Silva-Klein,32267,66119,2022-09-21
TRANSFER,3464,Tristan Gomez,4014,550,Adèle Da Silva-Klein,66119,69583,2022-09-21
TRANSFER,44980,Adèle Da Silva-Klein,69583,24603,Sabine Pineau,75219,30239,2022-09-22
CASH_OUT,16984,Adèle Da Silva-Klein,24603,7619,Agence_moov_Ouidah,300000,283016,2022-09-24
CASH_OUT,2826,Adèle Da Silva-Klein,7619,4793,Agence_moov_Ouidah,300000,297174,2022-09-26
CASH_IN,117710,Agence_moov_Ouidah,300000,182290,Michelle Samson,-123814,-6104,2022-09-01
CASH_IN,230752,Agence_moov_Abomey,300000,69248,Michelle Samson,-6104,224648,2022-09-01
TRANSFER,11011,Maggie Martinez,11948,937,Michelle Samson,224648,235659,2022-09-02
CASH_IN,94250,Agence_moov_Cotonou,300000,205750,Michelle Samson,235659,329909,2022-09-02
TRANSFER,38346,Rémy Grondin,56686,18340,Michelle Samson,329909,368255,2022-09-02
CASH_OUT,233254,Michelle Samson,368255,135001,Agence_moov_Abomey,300000,66746,2022-09-06
TRANSFER,15971,Michelle Samson,135001,119030,Gabriel Bègue,319482,303511,2022-09-08
CASH_OUT,48599,Michelle Samson,119030,70431,Agence_moov_Cotonou,300000,251401,2022-09-11
CASH_OUT,1776,Michelle Samson,70431,68655,Agence_moov_Ouidah,300000,298224,2022-09-11
CASH_OUT,5649,Michelle Samson,68655,63006,Agence_moov_Cotonou,300000,294351,2022-09-13
TRANSFER,45648,Michelle Samson,63006,17358,Agnès Le Giraud,100607,54959,2022-09-17
CASH_IN,234695,Agence_moov_Cotonou,300000,65305,Michelle Samson,17358,252053,2022-09-18
CASH_IN,115791,Agence_moov_Cotonou,300000,184209,Michelle Samson,252053,367844,2022-09-19
CASH_IN,83753,Agence_moov_Cotonou,300000,216247,Michelle Samson,367844,451597,2022-09-22
CASH_OUT,28523,Michelle Samson,451597,423074,Agence_moov_Abomey,300000,271477,2022-09-24
CASH_OUT,185960,Michelle Samson,423074,237114,Agence_moov_Abomey,300000,114040,2022-09-26
CASH_OUT,157506,Michelle Samson,237114,79608,Agence_moov_Cotonou,300000,142494,2022-09-27
CASH_IN,243572,Agence_moov_Abomey,300000,56428,Agnès Le Giraud,54959,298531,2022-09-02
TRANSFER,178199,Astrid Lecoq,331867,153668,Agnès Le Giraud,298531,476730,2022-09-03
CASH_IN,292990,Agence_moov_Ouidah,300000,7010,Agnès Le Giraud,476730,769720,2022-09-05
TRANSFER,248262,Agnès Le Giraud,769720,521458,Tristan Gomez,550,-247712,2022-09-07
CASH_IN,186731,Agence_moov_Abomey,300000,113269,Agnès Le Giraud,521458,708189,2022-09-08
TRANSFER,143394,Agnès Le Giraud,708189,564795,Astrid Lecoq,153668,10274,2022-09-08
TRANSFER,240150,Agnès Le Giraud,564795,324645,Gabriel Bègue,303511,63361,2022-09-10
CASH_IN,140591,Agence_moov_Cotonou,300000,159409,Agnès Le Giraud,324645,465236,2022-09-10
CASH_IN,119457,Agence_moov_Cotonou,300000,180543,Agnès Le Giraud,465236,584693,2022-09-14
CASH_IN,296420,Agence_moov_Ouidah,300000,3580,Agnès Le Giraud,584693,881113,2022-09-16
CASH_IN,242395,Agence_moov_Cotonou,300000,57605,Agnès Le Giraud,881113,1123508,2022-09-16
CASH_OUT,977231,Agnès Le Giraud,1123508,146277,Agence_moov_Cotonou,300000,-677231,2022-09-17
TRANSFER,18029,Sabine Pineau,30239,12210,Agnès Le Giraud,146277,164306,2022-09-19
CASH_IN,212982,Agence_moov_Cotonou,300000,87018,Agnès Le Giraud,164306,377288,2022-09-20
CASH_IN,127094,Agence_moov_Cotonou,300000,172906,Agnès Le Giraud,377288,504382,2022-09-22
CASH_OUT,91839,Agnès Le Giraud,504382,412543,Agence_moov_Cotonou,300000,208161,2022-09-24
CASH_OUT,223707,Agnès Le Giraud,412543,188836,Agence_moov_Abomey,300000,76293,2022-09-24
TRANSFER,92206,Tristan Delahaye,126125,33919,Agnès Le Giraud,188836,281042,2022-09-25
CASH_IN,76632,Agence_moov_Cotonou,300000,223368,Agnès Le Giraud,281042,357674,2022-09-27
CASH_IN,183050,Agence_moov_Ouidah,300000,116950,Agnès Le Giraud,357674,540724,2022-09-27
CASH_OUT,21439,Hélène de la Gérard,40905,19466,Agence_moov_Ouidah,300000,278561,2022-09-01
CASH_OUT,8645,Hélène de la Gérard,19466,10821,Agence_moov_Abomey,300000,291355,2022-09-01
TRANSFER,2671,Hélène de la Gérard,10821,8150,Gabriel Bègue,63361,60690,2022-09-02
TRANSFER,9898,Astrid Lecoq,10274,376,Hélène de la Gérard,8150,18048,2022-09-03
CASH_OUT,3313,Hélène de la Gérard,18048,14735,Agence_moov_Abomey,300000,296687,2022-09-04
CASH_IN,77613,Agence_moov_Ouidah,300000,222387,Hélène de la Gérard,14735,92348,2022-09-05
CASH_IN,262012,Agence_moov_Abomey,300000,37988,Hélène de la Gérard,92348,354360,2022-09-07
CASH_OUT,250950,Hélène de la Gérard,354360,103410,Agence_moov_Cotonou,300000,49050,2022-09-07
TRANSFER,8257,Sabine Pineau,12210,3953,Hélène de la Gérard,103410,111667,2022-09-13
CASH_OUT,101293,Hélène de la Gérard,111667,10374,Agence_moov_Abomey,300000,198707,2022-09-15
CASH_OUT,8048,Hélène de la Gérard,10374,2326,Agence_moov_Abomey,300000,291952,2022-09-21
CASH_IN,166434,Agence_moov_Ouidah,300000,133566,Hélène de la Gérard,2326,168760,2022-09-23
CASH_IN,215793,Agence_moov_Abomey,300000,84207,Hélène de la Gérard,168760,384553,2022-09-23
TRANSFER,339396,Hélène de la Gérard,384553,45157,Émilie du Allain,732749,393353,2022-09-25
CASH_OUT,23329,Hélène de la Gérard,45157,21828,Agence_moov_Cotonou,300000,276671,2022-09-25
CASH_IN,195236,Agence_moov_Ouidah,300000,104764,Hélène de la Gérard,21828,217064,2022-09-27
CASH_IN,42882,Agence_moov_Ouidah,300000,257118,Aimé Pages,-86654,-43772,2022-09-02
CASH_IN,37335,Agence_moov_Abomey,300000,262665,Aimé Pages,-43772,-6437,2022-09-03
CASH_IN,154714,Agence_moov_Abomey,300000,145286,Aimé Pages,-6437,148277,2022-09-04
CASH_IN,182769,Agence_moov_Cotonou,300000,117231,Aimé Pages,148277,331046,2022-09-04
TRANSFER,218,Astrid Lecoq,376,158,Aimé Pages,331046,331264,2022-09-07
CASH_IN,174028,Agence_moov_Cotonou,300000,125972,Aimé Pages,331264,505292,2022-09-08
CASH_OUT,135106,Aimé Pages,505292,370186,Agence_moov_Ouidah,300000,164894,2022-09-10
CASH_OUT,192197,Aimé Pages,370186,177989,Agence_moov_Abomey,300000,107803,2022-09-10
CASH_IN,52868,Agence_moov_Abomey,300000,247132,Aimé Pages,177989,230857,2022-09-15
CASH_OUT,109872,Aimé Pages,230857,120985,Agence_moov_Ouidah,300000,190128,2022-09-16
CASH_IN,34558,Agence_moov_Ouidah,300000,265442,Aimé Pages,120985,155543,2022-09-17
CASH_IN,180256,Agence_moov_Abomey,300000,119744,Aimé Pages,155543,335799,2022-09-19
TRANSFER,167454,Aimé Pages,335799,168345,Sabine Pineau,3953,-163501,2022-09-19
TRANSFER,9744,Aimé Pages,168345,158601,Aimé Pages,168345,178089,2022-09-20
CASH_IN,21298,Agence_moov_Ouidah,300000,278702,Aimé Pages,158601,179899,2022-09-21
TRANSFER,51266,Gabriel Bègue,60690,9424,Aimé Pages,179899,231165,2022-09-24
TRANSFER,18400,Aimé Pages,231165,212765,Simone Muller de la Brun,750662,732262,2022-09-25
TRANSFER,21622,Aimé Pages,212765,191143,Aimé Pages,212765,191143,2022-09-26
TRANSFER,163974,Aimé Pages,191143,27169,Tristan Delahaye,33919,-130055,2022-09-26
CASH_OUT,6265,Aimé Pages,27169,20904,Agence_moov_Cotonou,300000,293735,2022-09-27
CASH_IN,294004,Agence_moov_Ouidah,300000,5996,Benoît Guyot,-31652,262352,2022-09-01
CASH_OUT,57691,Benoît Guyot,262352,204661,Agence_moov_Abomey,300000,242309,2022-09-01
CASH_IN,64874,Agence_moov_Abomey,300000,235126,Benoît Guyot,204661,269535,2022-09-02
CASH_IN,241778,Agence_moov_Cotonou,300000,58222,Benoît Guyot,269535,511313,2022-09-02
CASH_OUT,196831,Benoît Guyot,511313,314482,Agence_moov_Cotonou,300000,103169,2022-09-19
CASH_IN,66791,Agence_moov_Ouidah,300000,233209,Benoît Guyot,314482,381273,2022-09-26
TRANSFER,750,Maggie Martinez,937,187,Benoît Guyot,381273,382023,2022-09-26
TRANSFER,3298,Gabriel Bègue,9424,6126,Benoît Guyot,382023,385321,2022-09-27
CASH_IN,296287,Agence_moov_Abomey,300000,3713,Bernard Maurice,-402617,-106330,2022-09-09
CASH_IN,289811,Agence_moov_Ouidah,300000,10189,Bernard Maurice,-106330,183481,2022-09-14
CASH_IN,226164,Agence_moov_Ouidah,300000,73836,Bernard Maurice,183481,409645,2022-09-15
CASH_IN,235451,Agence_moov_Cotonou,300000,64549,Bernard Maurice,409645,645096,2022-09-23
CASH_IN,163801,Agence_moov_Cotonou,300000,136199,Bernard Maurice,645096,808897,2022-09-25
TRANSFER,385424,Émilie du Allain,393353,7929,Bernard Maurice,808897,1194321,2022-09-25
CASH_IN,285895,Agence_moov_Abomey,300000,14105,Thomas Dupont,-95625,190270,2022-09-05
TRANSFER,157,Maggie Martinez,187,30,Thomas Dupont,190270,190427,2022-09-05
CASH_IN,237582,Agence_moov_Abomey,300000,62418,Thomas Dupont,190427,428009,2022-09-08
TRANSFER,157395,Thomas Dupont,428009,270614,Simone Muller de la Brun,732262,574867,2022-09-08
CASH_OUT,111180,Thomas Dupont,270614,159434,Agence_moov_Ouidah,300000,188820,2022-09-10
CASH_IN,277222,Agence_moov_Ouidah,300000,22778,Thomas Dupont,159434,436656,2022-09-15
CASH_OUT,31088,Thomas Dupont,436656,405568,Agence_moov_Abomey,300000,268912,2022-09-15
CASH_OUT,181621,Thomas Dupont,405568,223947,Agence_moov_Ouidah,300000,118379,2022-09-20
CASH_OUT,66055,Thomas Dupont,223947,157892,Agence_moov_Abomey,300000,233945,2022-09-20
CASH_OUT,132822,Thomas Dupont,157892,25070,Agence_moov_Abomey,300000,167178,2022-09-20
CASH_IN,79467,Agence_moov_Abomey,300000,220533,Thomas Dupont,25070,104537,2022-09-21
TRANSFER,36201,Thomas Dupont,104537,68336,Simone Muller de la Brun,574867,538666,2022-09-22
CASH_IN,42684,Agence_moov_Cotonou,300000,257316,Thomas Dupont,68336,111020,2022-09-25
CASH_IN,287458,Agence_moov_Cotonou,300000,12542,Tristan Gomez,-247712,39746,2022-09-02
TRANSFER,1905,Tristan Gomez,39746,37841,Simone Muller de la Brun,538666,536761,2022-09-02
TRANSFER,1648,Tristan Gomez,37841,36193,Tristan Gomez,37841,39489,2022-09-03
TRANSFER,3280,Gabriel Bègue,6126,2846,Tristan Gomez,36193,39473,2022-09-08
CASH_OUT,35796,Tristan Gomez,39473,3677,Agence_moov_Cotonou,300000,264204,2022-09-09
TRANSFER,1646,Tristan Gomez,3677,2031,Tristan Gomez,3677,2031,2022-09-10
CASH_OUT,1116,Tristan Gomez,2031,915,Agence_moov_Abomey,300000,298884,2022-09-11
TRANSFER,186,Tristan Gomez,915,729,Tristan Gomez,915,1101,2022-09-13
TRANSFER,687,Tristan Gomez,729,42,Simone Muller de la Brun,536761,536074,2022-09-15
CASH_IN,115630,Agence_moov_Abomey,300000,184370,Tristan Gomez,42,115672,2022-09-21
CASH_IN,153188,Agence_moov_Cotonou,300000,146812,Tristan Gomez,115672,268860,2022-09-21
TRANSFER,84245,Tristan Gomez,268860,184615,Simone Muller de la Brun,536074,451829,2022-09-23
CASH_OUT,12281,Tristan Gomez,184615,172334,Agence_moov_Cotonou,300000,287719,2022-09-24
CASH_IN,204653,Agence_moov_Ouidah,300000,95347,Tristan Gomez,172334,376987,2022-09-26
TRANSFER,668,Émilie du Allain,7929,7261,Tristan Gomez,376987,377655,2022-09-26
CASH_IN,250836,Agence_moov_Abomey,300000,49164,Tristan Bousquet-Gros,-1198025,-947189,2022-09-01
CASH_IN,266506,Agence_moov_Ouidah,300000,33494,Tristan Bousquet-Gros,-947189,-680683,2022-09-02
CASH_IN,237006,Agence_moov_Ouidah,300000,62994,Tristan Bousquet-Gros,-680683,-443677,2022-09-03
CASH_IN,5711,Agence_moov_Ouidah,300000,294289,Tristan Bousquet-Gros,-443677,-437966,2022-09-03
CASH_IN,151144,Agence_moov_Cotonou,300000,148856,Tristan Bousquet-Gros,-437966,-286822,2022-09-03
CASH_IN,114939,Agence_moov_Ouidah,300000,185061,Tristan Bousquet-Gros,-286822,-171883,2022-09-05
CASH_IN,60685,Agence_moov_Ouidah,300000,239315,Tristan Bousquet-Gros,-171883,-111198,2022-09-07
CASH_IN,209756,Agence_moov_Ouidah,300000,90244,Tristan Bousquet-Gros,-111198,98558,2022-09-07
CASH_IN,51332,Agence_moov_Cotonou,300000,248668,Tristan Bousquet-Gros,98558,149890,2022-09-09
TRANSFER,110252,Tristan Bousquet-Gros,149890,39638,Gabriel Bègue,2846,-107406,2022-09-10
TRANSFER,25321,Tristan Bousquet-Gros,39638,14317,Tristan Bousquet-Gros,39638,14317,2022-09-13
CASH_OUT,9825,Tristan Bousquet-Gros,14317,4492,Agence_moov_Ouidah,300000,290175,2022-09-15
CASH_OUT,4315,Tristan Bousquet-Gros,4492,177,Agence_moov_Abomey,300000,295685,2022-09-19
TRANSFER,173,Tristan Bousquet-Gros,177,4,Tristan Bousquet-Gros,177,4,2022-09-21
CASH_IN,125050,Agence_moov_Abomey,300000,174950,Tristan Bousquet-Gros,4,125054,2022-09-23
TRANSFER,52605,Tristan Bousquet-Gros,125054,72449,Simone Muller de la Brun,451829,399224,2022-09-23
CASH_OUT,62401,Tristan Bousquet-Gros,72449,10048,Agence_moov_Ouidah,300000,237599,2022-09-25
TRANSFER,9583,Tristan Bousquet-Gros,10048,465,Simone Muller de la Brun,399224,389641,2022-09-27
CASH_OUT,244,Tristan Bousquet-Gros,465,221,Agence_moov_Abomey,300000,299756,2022-09-27
CASH_IN,44486,Agence_moov_Abomey,300000,255514,Frédéric Guillou,-275778,-231292,2022-09-02
CASH_IN,278041,Agence_moov_Abomey,300000,21959,Frédéric Guillou,-231292,46749,2022-09-04
CASH_OUT,37603,Frédéric Guillou,46749,9146,Agence_moov_Ouidah,300000,262397,2022-09-09
CASH_OUT,2539,Frédéric Guillou,9146,6607,Agence_moov_Cotonou,300000,297461,2022-09-10
CASH_OUT,5104,Frédéric Guillou,6607,1503,Agence_moov_Abomey,300000,294896,2022-09-11
CASH_OUT,453,Frédéric Guillou,1503,1050,Agence_moov_Cotonou,300000,299547,2022-09-25
CASH_IN,159066,Agence_moov_Abomey,300000,140934,Emmanuel Grégoire,-190646,-31580,2022-09-01
CASH_IN,246307,Agence_moov_Abomey,300000,53693,Emmanuel Grégoire,-31580,214727,2022-09-06
TRANSFER,196289,Simone Muller de la Brun,389641,193352,Emmanuel Grégoire,214727,411016,2022-09-06
CASH_OUT,160408,Emmanuel Grégoire,411016,250608,Agence_moov_Cotonou,300000,139592,2022-09-09
CASH_OUT,130065,Emmanuel Grégoire,250608,120543,Agence_moov_Cotonou,300000,169935,2022-09-11
CASH_OUT,75799,Emmanuel Grégoire,120543,44744,Agence_moov_Abomey,300000,224201,2022-09-11
CASH_IN,187078,Agence_moov_Abomey,300000,112922,Emmanuel Grégoire,44744,231822,2022-09-12
TRANSFER,62710,Emmanuel Grégoire,231822,169112,Émilie du Allain,7261,-55449,2022-09-15
TRANSFER,45032,Emmanuel Grégoire,169112,124080,Camille Morvan,609672,564640,2022-09-17
CASH_IN,233329,Agence_moov_Ouidah,300000,66671,Emmanuel Grégoire,124080,357409,2022-09-17
TRANSFER,110551,Simone Muller de la Brun,193352,82801,Emmanuel Grégoire,357409,467960,2022-09-18
CASH_IN,39003,Agence_moov_Cotonou,300000,260997,Emmanuel Grégoire,467960,506963,2022-09-18
TRANSFER,306056,Emmanuel Grégoire,506963,200907,Simone Muller de la Brun,82801,-223255,2022-09-19
CASH_OUT,157209,Emmanuel Grégoire,200907,43698,Agence_moov_Cotonou,300000,142791,2022-09-22
CASH_OUT,1558,Emmanuel Grégoire,43698,42140,Agence_moov_Abomey,300000,298442,2022-09-23
TRANSFER,11868,Emmanuel Grégoire,42140,30272,Camille Morvan,564640,552772,2022-09-24
TRANSFER,18091,Emmanuel Grégoire,30272,12181,Camille Morvan,552772,534681,2022-09-26
CASH_OUT,1743,Emmanuel Grégoire,12181,10438,Agence_moov_Abomey,300000,298257,2022-09-27
CASH_IN,164077,Agence_moov_Cotonou,300000,135923,Hélène Le Chauvin,-500620,-336543,2022-09-01
CASH_IN,292591,Agence_moov_Abomey,300000,7409,Hélène Le Chauvin,-336543,-43952,2022-09-02
CASH_IN,265580,Agence_moov_Cotonou,300000,34420,Hélène Le Chauvin,-43952,221628,2022-09-02
TRANSFER,101116,Hélène Le Chauvin,221628,120512,Hélène Le Chauvin,221628,120512,2022-09-04
CASH_OUT,64975,Hélène Le Chauvin,120512,55537,Agence_moov_Ouidah,300000,235025,2022-09-04
CASH_IN,44186,Agence_moov_Abomey,300000,255814,Hélène Le Chauvin,55537,99723,2022-09-06
CASH_OUT,29858,Hélène Le Chauvin,99723,69865,Agence_moov_Ouidah,300000,270142,2022-09-09
CASH_IN,6093,Agence_moov_Abomey,300000,293907,Hélène Le Chauvin,69865,75958,2022-09-12
TRANSFER,479168,Camille Morvan,534681,55513,Hélène Le Chauvin,75958,555126,2022-09-19
CASH_OUT,2096,Hélène Le Chauvin,555126,553030,Agence_moov_Ouidah,300000,297904,2022-09-19
TRANSFER,332611,Hélène Le Chauvin,553030,220419,Hélène Le Chauvin,553030,220419,2022-09-19
TRANSFER,28056,Hélène Le Chauvin,220419,192363,Hélène Le Chauvin,220419,248475,2022-09-20
CASH_IN,220275,Agence_moov_Cotonou,300000,79725,Hélène Le Chauvin,192363,412638,2022-09-23
CASH_OUT,277704,Hélène Le Chauvin,412638,134934,Agence_moov_Abomey,300000,22296,2022-09-24
CASH_IN,69510,Agence_moov_Ouidah,300000,230490,Robert Laroche,-114674,-45164,2022-09-01
CASH_IN,293283,Agence_moov_Ouidah,300000,6717,Robert Laroche,-45164,248119,2022-09-04
CASH_IN,232681,Agence_moov_Ouidah,300000,67319,Robert Laroche,248119,480800,2022-09-06
CASH_IN,16870,Agence_moov_Abomey,300000,283130,Robert Laroche,480800,497670,2022-09-06
TRANSFER,7330,Robert Laroche,497670,490340,Robert Laroche,497670,490340,2022-09-07
CASH_IN,17489,Agence_moov_Ouidah,300000,282511,Robert Laroche,490340,507829,2022-09-09
CASH_IN,38748,Agence_moov_Ouidah,300000,261252,Robert Laroche,507829,546577,2022-09-09
CASH_IN,168451,Agence_moov_Abomey,300000,131549,Robert Laroche,546577,715028,2022-09-20
CASH_IN,112340,Agence_moov_Cotonou,300000,187660,Robert Laroche,715028,827368,2022-09-22
CASH_IN,263476,Agence_moov_Ouidah,300000,36524,Robert Laroche,827368,1090844,2022-09-24
CASH_OUT,861387,Robert Laroche,1090844,229457,Agence_moov_Ouidah,300000,-561387,2022-09-24
CASH_IN,124818,Agence_moov_Ouidah,300000,175182,Aurore Charrier,-80905,43913,2022-09-06
CASH_IN,145737,Agence_moov_Cotonou,300000,154263,Aurore Charrier,43913,189650,2022-09-10
CASH_IN,285926,Agence_moov_Ouidah,300000,14074,Aurore Charrier,189650,475576,2022-09-11
TRANSFER,8197,Aurore Charrier,475576,467379,Aurore Charrier,475576,467379,2022-09-12
CASH_IN,269703,Agence_moov_Abomey,300000,30297,Aurore Charrier,467379,737082,2022-09-19
CASH_IN,235746,Agence_moov_Cotonou,300000,64254,Aurore Charrier,737082,972828,2022-09-19
CASH_IN,255326,Agence_moov_Ouidah,300000,44674,Aurore Charrier,972828,1228154,2022-09-20
CASH_IN,18843,Agence_moov_Cotonou,300000,281157,Aurore Charrier,1228154,1246997,2022-09-24
CASH_OUT,985362,Aurore Charrier,1246997,261635,Agence_moov_Abomey,300000,-685362,2022-09-24
CASH_OUT,49817,Aurore Charrier,261635,211818,Agence_moov_Ouidah,300000,250183,2022-09-25
CASH_OUT,155486,Aurore Charrier,211818,56332,Agence_moov_Cotonou,300000,144514,2022-09-25
CASH_OUT,9091,Aurore Charrier,56332,47241,Agence_moov_Ouidah,300000,290909,2022-09-26
CASH_OUT,43211,Aurore Charrier,47241,4030,Agence_moov_Abomey,300000,256789,2022-09-26
CASH_IN,121133,Agence_moov_Abomey,300000,178867,Aurore Charrier,4030,125163,2022-09-27
CASH_IN,131114,Agence_moov_Ouidah,300000,168886,Vincent Joubert,-11056,120058,2022-09-02
TRANSFER,20918,Vincent Joubert,120058,99140,Vincent Joubert,120058,140976,2022-09-02
TRANSFER,56434,Vincent Joubert,99140,42706,Vincent Joubert,99140,42706,2022-09-03
TRANSFER,22690,Vincent Joubert,42706,20016,Vincent Joubert,42706,65396,2022-09-04
CASH_OUT,4637,Vincent Joubert,20016,15379,Agence_moov_Ouidah,300000,295363,2022-09-05
TRANSFER,966,Vincent Joubert,15379,14413,Vincent Joubert,15379,14413,2022-09-07
CASH_IN,186720,Agence_moov_Cotonou,300000,113280,Vincent Joubert,14413,201133,2022-09-08
CASH_OUT,159196,Vincent Joubert,201133,41937,Agence_moov_Ouidah,300000,140804,2022-09-09
TRANSFER,3959,Vincent Joubert,41937,37978,Vincent Joubert,41937,37978,2022-09-11
CASH_IN,230715,Agence_moov_Ouidah,300000,69285,Vincent Joubert,37978,268693,2022-09-14
CASH_IN,139121,Agence_moov_Abomey,300000,160879,Vincent Joubert,268693,407814,2022-09-14
CASH_OUT,158665,Vincent Joubert,407814,249149,Agence_moov_Ouidah,300000,141335,2022-09-16
CASH_IN,279400,Agence_moov_Cotonou,300000,20600,Vincent Joubert,249149,528549,2022-09-18
CASH_IN,198180,Agence_moov_Cotonou,300000,101820,Vincent Joubert,528549,726729,2022-09-19
CASH_IN,17736,Agence_moov_Ouidah,300000,282264,Vincent Joubert,726729,744465,2022-09-22
CASH_IN,79937,Agence_moov_Abomey,300000,220063,Vincent Joubert,744465,824402,2022-09-23
CASH_OUT,429090,Vincent Joubert,824402,395312,Agence_moov_Abomey,300000,-129090,2022-09-27
CASH_IN,294211,Agence_moov_Cotonou,300000,5789,Simone Muller de la Brun,-223255,70956,2022-09-01
CASH_IN,296328,Agence_moov_Ouidah,300000,3672,Simone Muller de la Brun,70956,367284,2022-09-02
CASH_OUT,86500,Simone Muller de la Brun,367284,280784,Agence_moov_Ouidah,300000,213500,2022-09-02
CASH_IN,182040,Agence_moov_Cotonou,300000,117960,Simone Muller de la Brun,280784,462824,2022-09-13
CASH_IN,68378,Agence_moov_Ouidah,300000,231622,Simone Muller de la Brun,462824,531202,2022-09-16
CASH_IN,149372,Agence_moov_Ouidah,300000,150628,Simone Muller de la Brun,531202,680574,2022-09-17
CASH_OUT,522591,Simone Muller de la Brun,680574,157983,Agence_moov_Ouidah,300000,-222591,2022-09-20
CASH_IN,82510,Agence_moov_Cotonou,300000,217490,Lucy Lamy,-606560,-524050,2022-09-04
CASH_IN,260618,Agence_moov_Cotonou,300000,39382,Lucy Lamy,-524050,-263432,2022-09-04
CASH_IN,58359,Agence_moov_Cotonou,300000,241641,Lucy Lamy,-263432,-205073,2022-09-04
CASH_IN,74061,Agence_moov_Ouidah,300000,225939,Lucy Lamy,-205073,-131012,2022-09-07
CASH_IN,294768,Agence_moov_Abomey,300000,5232,Lucy Lamy,-131012,163756,2022-09-07
CASH_IN,106482,Agence_moov_Abomey,300000,193518,Lucy Lamy,163756,270238,2022-09-08
CASH_OUT,46342,Lucy Lamy,270238,223896,Agence_moov_Abomey,300000,253658,2022-09-15
TRANSFER,72885,Lucy Lamy,223896,151011,Lucy Lamy,223896,151011,2022-09-17
CASH_IN,10077,Agence_moov_Cotonou,300000,289923,Lucy Lamy,151011,161088,2022-09-18
CASH_IN,98790,Agence_moov_Abomey,300000,201210,Lucy Lamy,161088,259878,2022-09-19
CASH_IN,190372,Agence_moov_Cotonou,300000,109628,Lucy Lamy,259878,450250,2022-09-19
CASH_OUT,151880,Lucy Lamy,450250,298370,Agence_moov_Ouidah,300000,148120,2022-09-19
CASH_IN,118900,Agence_moov_Abomey,300000,181100,Lucy Lamy,298370,417270,2022-09-22
CASH_IN,278518,Agence_moov_Abomey,300000,21482,Lucy Lamy,417270,695788,2022-09-27
CASH_IN,40040,Agence_moov_Ouidah,300000,259960,Thomas Guichard du Renault,-62774,-22734,2022-09-01
CASH_IN,231328,Agence_moov_Ouidah,300000,68672,Thomas Guichard du Renault,-22734,208594,2022-09-05
TRANSFER,124775,Thomas Guichard du Renault,208594,83819,Thomas Guichard du Renault,208594,83819,2022-09-12
TRANSFER,81112,Thomas Guichard du Renault,83819,2707,Thomas Guichard du Renault,83819,2707,2022-09-15
CASH_OUT,2591,Thomas Guichard du Renault,2707,116,Agence_moov_Ouidah,300000,297409,2022-09-16
CASH_IN,265567,Agence_moov_Cotonou,300000,34433,Thomas Guichard du Renault,116,265683,2022-09-16
CASH_OUT,71030,Thomas Guichard du Renault,265683,194653,Agence_moov_Abomey,300000,228970,2022-09-18
CASH_IN,116587,Agence_moov_Abomey,300000,183413,Thomas Guichard du Renault,194653,311240,2022-09-23
CASH_OUT,302879,Thomas Guichard du Renault,311240,8361,Agence_moov_Cotonou,300000,-2879,2022-09-25
CASH_IN,90607,Agence_moov_Ouidah,300000,209393,Thomas Guichard du Renault,8361,98968,2022-09-25
CASH_IN,192756,Agence_moov_Ouidah,300000,107244,Constance Bourdon-Millet,-344152,-151396,2022-09-03
CASH_IN,140945,Agence_moov_Cotonou,300000,159055,Constance Bourdon-Millet,-151396,-10451,2022-09-07
CASH_IN,166100,Agence_moov_Cotonou,300000,133900,Constance Bourdon-Millet,-10451,155649,2022-09-10
CASH_IN,136589,Agence_moov_Cotonou,300000,163411,Constance Bourdon-Millet,155649,292238,2022-09-10
TRANSFER,108969,Constance Bourdon-Millet,292238,183269,Constance Bourdon-Millet,292238,183269,2022-09-11
TRANSFER,88983,Constance Bourdon-Millet,183269,94286,Constance Bourdon-Millet,183269,94286,2022-09-11
CASH_IN,232523,Agence_moov_Cotonou,300000,67477,Constance Bourdon-Millet,94286,326809,2022-09-12
TRANSFER,259982,Constance Bourdon-Millet,326809,66827,Constance Bourdon-Millet,326809,586791,2022-09-12
CASH_IN,156295,Agence_moov_Abomey,300000,143705,Constance Bourdon-Millet,66827,223122,2022-09-13
CASH_IN,233178,Agence_moov_Cotonou,300000,66822,Constance Bourdon-Millet,223122,456300,2022-09-15
CASH_IN,44840,Agence_moov_Cotonou,300000,255160,Constance Bourdon-Millet,456300,501140,2022-09-16
CASH_IN,235925,Agence_moov_Ouidah,300000,64075,Constance Bourdon-Millet,501140,737065,2022-09-18
CASH_IN,274966,Agence_moov_Cotonou,300000,25034,Constance Bourdon-Millet,737065,1012031,2022-09-19
CASH_OUT,434184,Constance Bourdon-Millet,1012031,577847,Agence_moov_Abomey,300000,-134184,2022-09-21
CASH_IN,292243,Agence_moov_Abomey,300000,7757,Constance Bourdon-Millet,577847,870090,2022-09-26
CASH_IN,126799,Agence_moov_Cotonou,300000,173201,Paul Perez,-27076,99723,2022-09-01
CASH_OUT,20349,Paul Perez,99723,79374,Agence_moov_Cotonou,300000,279651,2022-09-01
CASH_OUT,13633,Paul Perez,79374,65741,Agence_moov_Ouidah,300000,286367,2022-09-02
TRANSFER,36272,Paul Perez,65741,29469,Paul Perez,65741,29469,2022-09-04
CASH_IN,297873,Agence_moov_Abomey,300000,2127,Paul Perez,29469,327342,2022-09-05
CASH_OUT,306297,Paul Perez,327342,21045,Agence_moov_Cotonou,300000,-6297,2022-09-06
CASH_OUT,17472,Paul Perez,21045,3573,Agence_moov_Abomey,300000,282528,2022-09-06
CASH_IN,174543,Agence_moov_Cotonou,300000,125457,Paul Perez,3573,178116,2022-09-09
CASH_OUT,173299,Paul Perez,178116,4817,Agence_moov_Ouidah,300000,126701,2022-09-09
TRANSFER,657,Paul Perez,4817,4160,Paul Perez,4817,4160,2022-09-12
CASH_IN,147150,Agence_moov_Cotonou,300000,152850,Paul Perez,4160,151310,2022-09-16
CASH_OUT,42842,Paul Perez,151310,108468,Agence_moov_Abomey,300000,257158,2022-09-17
CASH_IN,294268,Agence_moov_Cotonou,300000,5732,Paul Perez,108468,402736,2022-09-19
CASH_OUT,7114,Paul Perez,402736,395622,Agence_moov_Cotonou,300000,292886,2022-09-23
CASH_OUT,358029,Paul Perez,395622,37593,Agence_moov_Cotonou,300000,-58029,2022-09-24
CASH_IN,258112,Agence_moov_Ouidah,300000,41888,Paul Perez,37593,295705,2022-09-27
CASH_IN,132480,Agence_moov_Abomey,300000,167520,Nicolas Salmon Le Hamon,-394108,-261628,2022-09-02
CASH_IN,206207,Agence_moov_Ouidah,300000,93793,Nicolas Salmon Le Hamon,-261628,-55421,2022-09-03
CASH_IN,24602,Agence_moov_Abomey,300000,275398,Nicolas Salmon Le Hamon,-55421,-30819,2022-09-04
CASH_IN,261915,Agence_moov_Cotonou,300000,38085,Nicolas Salmon Le Hamon,-30819,231096,2022-09-07
CASH_OUT,90709,Nicolas Salmon Le Hamon,231096,140387,Agence_moov_Ouidah,300000,209291,2022-09-07
CASH_OUT,5265,Nicolas Salmon Le Hamon,140387,135122,Agence_moov_Cotonou,300000,294735,2022-09-08
CASH_IN,82256,Agence_moov_Ouidah,300000,217744,Nicolas Salmon Le Hamon,135122,217378,2022-09-09
TRANSFER,171545,Nicolas Salmon Le Hamon,217378,45833,Nicolas Salmon Le Hamon,217378,45833,2022-09-09
CASH_OUT,23820,Nicolas Salmon Le Hamon,45833,22013,Agence_moov_Abomey,300000,276180,2022-09-17
CASH_IN,11442,Agence_moov_Ouidah,300000,288558,Thomas-Robert Morvan,-10868,574,2022-09-02
TRANSFER,193,Thomas-Robert Morvan,574,381,Thomas-Robert Morvan,574,381,2022-09-02
CASH_OUT,321,Thomas-Robert Morvan,381,60,Agence_moov_Cotonou,300000,299679,2022-09-04
CASH_IN,235151,Agence_moov_Ouidah,300000,64849,Thomas-Robert Morvan,60,235211,2022-09-05
TRANSFER,45930,Thomas-Robert Morvan,235211,189281,Thomas-Robert Morvan,235211,189281,2022-09-09
CASH_OUT,180648,Thomas-Robert Morvan,189281,8633,Agence_moov_Cotonou,300000,119352,2022-09-18
CASH_IN,126651,Agence_moov_Cotonou,300000,173349,Luc Lévêque-Carre,-155333,-28682,2022-09-01
CASH_IN,294762,Agence_moov_Cotonou,300000,5238,Luc Lévêque-Carre,-28682,266080,2022-09-02
CASH_IN,9580,Agence_moov_Abomey,300000,290420,Luc Lévêque-Carre,266080,275660,2022-09-03
TRANSFER,129337,Luc Lévêque-Carre,275660,146323,Luc Lévêque-Carre,275660,146323,2022-09-08
CASH_OUT,63729,Luc Lévêque-Carre,146323,82594,Agence_moov_Cotonou,300000,236271,2022-09-09
CASH_IN,164238,Agence_moov_Ouidah,300000,135762,Luc Lévêque-Carre,82594,246832,2022-09-12
TRANSFER,86159,Luc Lévêque-Carre,246832,160673,Luc Lévêque-Carre,246832,332991,2022-09-13
CASH_IN,282061,Agence_moov_Ouidah,300000,17939,Luc Lévêque-Carre,160673,442734,2022-09-13
CASH_IN,221907,Agence_moov_Cotonou,300000,78093,Luc Lévêque-Carre,442734,664641,2022-09-14
TRANSFER,132586,Luc Lévêque-Carre,664641,532055,Luc Lévêque-Carre,664641,532055,2022-09-15
CASH_IN,232442,Agence_moov_Cotonou,300000,67558,Luc Lévêque-Carre,532055,764497,2022-09-18
CASH_IN,199050,Agence_moov_Abomey,300000,100950,Luc Lévêque-Carre,764497,963547,2022-09-20
CASH_IN,64832,Agence_moov_Cotonou,300000,235168,Luc Lévêque-Carre,963547,1028379,2022-09-21
CASH_IN,282029,Agence_moov_Ouidah,300000,17971,Luc Lévêque-Carre,1028379,1310408,2022-09-22
CASH_IN,71893,Agence_moov_Abomey,300000,228107,Andrée-Thérèse Mendès,-33634,38259,2022-09-01
CASH_OUT,2434,Andrée-Thérèse Mendès,38259,35825,Agence_moov_Cotonou,300000,297566,2022-09-01
TRANSFER,12957,Andrée-Thérèse Mendès,35825,22868,Andrée-Thérèse Mendès,35825,48782,2022-09-02
CASH_IN,92159,Agence_moov_Ouidah,300000,207841,Andrée-Thérèse Mendès,22868,115027,2022-09-03
CASH_OUT,7763,Andrée-Thérèse Mendès,115027,107264,Agence_moov_Cotonou,300000,292237,2022-09-07
CASH_OUT,33617,Andrée-Thérèse Mendès,107264,73647,Agence_moov_Abomey,300000,266383,2022-09-12
CASH_OUT,16562,Andrée-Thérèse Mendès,73647,57085,Agence_moov_Abomey,300000,283438,2022-09-14
CASH_OUT,31349,Andrée-Thérèse Mendès,57085,25736,Agence_moov_Ouidah,300000,268651,2022-09-14
TRANSFER,19250,Andrée-Thérèse Mendès,25736,6486,Andrée-Thérèse Mendès,25736,6486,2022-09-14
CASH_IN,194023,Agence_moov_Abomey,300000,105977,Andrée-Thérèse Mendès,6486,200509,2022-09-18
CASH_OUT,41627,Andrée-Thérèse Mendès,200509,158882,Agence_moov_Ouidah,300000,258373,2022-09-18
CASH_OUT,10078,Andrée-Thérèse Mendès,158882,148804,Agence_moov_Ouidah,300000,289922,2022-09-19
CASH_OUT,93785,Andrée-Thérèse Mendès,148804,55019,Agence_moov_Cotonou,300000,206215,2022-09-20
CASH_IN,112351,Agence_moov_Cotonou,300000,187649,Andrée-Thérèse Mendès,55019,167370,2022-09-22
CASH_IN,92173,Agence_moov_Abomey,300000,207827,Andrée-Thérèse Mendès,167370,259543,2022-09-25
CASH_IN,160465,Agence_moov_Abomey,300000,139535,Maggie Martinez,30,160495,2022-09-01
CASH_OUT,147575,Maggie Martinez,160495,12920,Agence_moov_Ouidah,300000,152425,2022-09-02
CASH_IN,189901,Agence_moov_Abomey,300000,110099,Maggie Martinez,12920,202821,2022-09-03
CASH_OUT,14132,Maggie Martinez,202821,188689,Agence_moov_Ouidah,300000,285868,2022-09-03
CASH_OUT,92055,Maggie Martinez,188689,96634,Agence_moov_Abomey,300000,207945,2022-09-06
TRANSFER,55950,Maggie Martinez,96634,40684,Maggie Martinez,96634,152584,2022-09-06
TRANSFER,9817,Maggie Martinez,40684,30867,Maggie Martinez,40684,50501,2022-09-08
CASH_OUT,7144,Maggie Martinez,30867,23723,Agence_moov_Cotonou,300000,292856,2022-09-08
CASH_IN,51348,Agence_moov_Ouidah,300000,248652,Maggie Martinez,23723,75071,2022-09-10
CASH_IN,274563,Agence_moov_Ouidah,300000,25437,Maggie Martinez,75071,349634,2022-09-13
CASH_IN,96826,Agence_moov_Ouidah,300000,203174,Maggie Martinez,349634,446460,2022-09-13
CASH_OUT,77177,Maggie Martinez,446460,369283,Agence_moov_Cotonou,300000,222823,2022-09-14
CASH_IN,78617,Agence_moov_Ouidah,300000,221383,Maggie Martinez,369283,447900,2022-09-23
CASH_IN,18642,Agence_moov_Cotonou,300000,281358,Gabriel Bègue,-107406,-88764,2022-09-01
CASH_IN,237530,Agence_moov_Abomey,300000,62470,Gabriel Bègue,-88764,148766,2022-09-01
CASH_OUT,15376,Gabriel Bègue,148766,133390,Agence_moov_Cotonou,300000,284624,2022-09-02
CASH_OUT,6352,Gabriel Bègue,133390,127038,Agence_moov_Cotonou,300000,293648,2022-09-06
CASH_IN,268133,Agence_moov_Ouidah,300000,31867,Gabriel Bègue,127038,395171,2022-09-08
CASH_IN,241357,Agence_moov_Abomey,300000,58643,Gabriel Bègue,395171,636528,2022-09-09
CASH_IN,273059,Agence_moov_Abomey,300000,26941,Gabriel Bègue,636528,909587,2022-09-09
CASH_OUT,608375,Gabriel Bègue,909587,301212,Agence_moov_Ouidah,300000,-308375,2022-09-10
TRANSFER,185998,Gabriel Bègue,301212,115214,Gabriel Bègue,301212,487210,2022-09-13
CASH_OUT,39682,Gabriel Bègue,115214,75532,Agence_moov_Cotonou,300000,260318,2022-09-13
CASH_IN,109457,Agence_moov_Ouidah,300000,190543,Gabriel Bègue,75532,184989,2022-09-15
CASH_OUT,63788,Gabriel Bègue,184989,121201,Agence_moov_Abomey,300000,236212,2022-09-15
CASH_OUT,67254,Gabriel Bègue,121201,53947,Agence_moov_Ouidah,300000,232746,2022-09-17
CASH_IN,136059,Agence_moov_Cotonou,300000,163941,Gabriel Bègue,53947,190006,2022-09-19
CASH_IN,60832,Agence_moov_Ouidah,300000,239168,Gabriel Bègue,190006,250838,2022-09-21
CASH_OUT,73058,Gabriel Bègue,250838,177780,Agence_moov_Abomey,300000,226942,2022-09-24
CASH_IN,249965,Agence_moov_Abomey,300000,50035,Gabriel Bègue,177780,427745,2022-09-25
CASH_IN,148134,Agence_moov_Cotonou,300000,151866,Frédérique Fernandes du Bouchet,-161822,-13688,2022-09-01
CASH_IN,231964,Agence_moov_Abomey,300000,68036,Frédérique Fernandes du Bouchet,-13688,218276,2022-09-03
CASH_IN,248701,Agence_moov_Cotonou,300000,51299,Frédérique Fernandes du Bouchet,218276,466977,2022-09-04
CASH_IN,83492,Agence_moov_Cotonou,300000,216508,Frédérique Fernandes du Bouchet,466977,550469,2022-09-05
TRANSFER,461170,Frédérique Fernandes du Bouchet,550469,89299,Frédérique Fernandes du Bouchet,550469,89299,2022-09-05
TRANSFER,68477,Frédérique Fernandes du Bouchet,89299,20822,Frédérique Fernandes du Bouchet,89299,157776,2022-09-09
CASH_OUT,14451,Frédérique Fernandes du Bouchet,20822,6371,Agence_moov_Cotonou,300000,285549,2022-09-13
CASH_IN,55768,Agence_moov_Ouidah,300000,244232,Frédérique Fernandes du Bouchet,6371,62139,2022-09-15
CASH_IN,299293,Agence_moov_Abomey,300000,707,Frédérique Fernandes du Bouchet,62139,361432,2022-09-18
CASH_OUT,74560,Frédérique Fernandes du Bouchet,361432,286872,Agence_moov_Cotonou,300000,225440,2022-09-21
CASH_IN,92618,Agence_moov_Cotonou,300000,207382,Frédérique Fernandes du Bouchet,286872,379490,2022-09-24
CASH_IN,12370,Agence_moov_Abomey,300000,287630,Tristan Delahaye,-130055,-117685,2022-09-01
CASH_IN,280888,Agence_moov_Ouidah,300000,19112,Tristan Delahaye,-117685,163203,2022-09-01
TRANSFER,161000,Tristan Delahaye,163203,2203,Tristan Delahaye,163203,324203,2022-09-05
CASH_IN,8259,Agence_moov_Cotonou,300000,291741,Tristan Delahaye,2203,10462,2022-09-21
CASH_OUT,10047,Tristan Delahaye,10462,415,Agence_moov_Ouidah,300000,289953,2022-09-27
CASH_IN,29030,Agence_moov_Abomey,300000,270970,Tristan Delahaye,415,29445,2022-09-27
CASH_IN,3041,Agence_moov_Ouidah,300000,296959,Michelle de Étienne,-104319,-101278,2022-09-02
CASH_IN,142535,Agence_moov_Cotonou,300000,157465,Michelle de Étienne,-101278,41257,2022-09-07
CASH_OUT,10272,Michelle de Étienne,41257,30985,Agence_moov_Abomey,300000,289728,2022-09-23
CASH_IN,154824,Agence_moov_Cotonou,300000,145176,Sabine Pineau,-163501,-8677,2022-09-01
CASH_IN,127119,Agence_moov_Abomey,300000,172881,Sabine Pineau,-8677,118442,2022-09-02
CASH_IN,266548,Agence_moov_Ouidah,300000,33452,Sabine Pineau,118442,384990,2022-09-03
CASH_OUT,237568,Sabine Pineau,384990,147422,Agence_moov_Cotonou,300000,62432,2022-09-04
CASH_OUT,30614,Sabine Pineau,147422,116808,Agence_moov_Ouidah,300000,269386,2022-09-06
TRANSFER,82932,Sabine Pineau,116808,33876,Sabine Pineau,116808,33876,2022-09-08
CASH_OUT,33109,Sabine Pineau,33876,767,Agence_moov_Cotonou,300000,266891,2022-09-09
CASH_OUT,144,Sabine Pineau,767,623,Agence_moov_Abomey,300000,299856,2022-09-12
CASH_IN,27042,Agence_moov_Ouidah,300000,272958,Sabine Pineau,623,27665,2022-09-13
CASH_OUT,12303,Sabine Pineau,27665,15362,Agence_moov_Abomey,300000,287697,2022-09-14
CASH_OUT,8478,Sabine Pineau,15362,6884,Agence_moov_Ouidah,300000,291522,2022-09-16
CASH_IN,191400,Agence_moov_Cotonou,300000,108600,Sabine Pineau,6884,198284,2022-09-18
CASH_OUT,91551,Sabine Pineau,198284,106733,Agence_moov_Cotonou,300000,208449,2022-09-21
CASH_IN,296849,Agence_moov_Ouidah,300000,3151,Sabine Pineau,106733,403582,2022-09-25
CASH_OUT,295374,Sabine Pineau,403582,108208,Agence_moov_Abomey,300000,4626,2022-09-26
CASH_IN,31278,Agence_moov_Cotonou,300000,268722,Christine Texier,-999352,-968074,2022-09-03
CASH_IN,47929,Agence_moov_Abomey,300000,252071,Christine Texier,-968074,-920145,2022-09-04
CASH_IN,113448,Agence_moov_Abomey,300000,186552,Christine Texier,-920145,-806697,2022-09-04
CASH_IN,40626,Agence_moov_Cotonou,300000,259374,Christine Texier,-806697,-766071,2022-09-06
CASH_IN,18025,Agence_moov_Abomey,300000,281975,Christine Texier,-766071,-748046,2022-09-08
CASH_IN,106187,Agence_moov_Cotonou,300000,193813,Christine Texier,-748046,-641859,2022-09-10
CASH_IN,85874,Agence_moov_Ouidah,300000,214126,Christine Texier,-641859,-555985,2022-09-14
CASH_IN,250064,Agence_moov_Ouidah,300000,49936,Christine Texier,-555985,-305921,2022-09-18
CASH_IN,269926,Agence_moov_Cotonou,300000,30074,Christine Texier,-305921,-35995,2022-09-18
CASH_IN,262864,Agence_moov_Ouidah,300000,37136,Christine Texier,-35995,226869,2022-09-21
CASH_IN,115582,Agence_moov_Cotonou,300000,184418,Christine Texier,226869,342451,2022-09-24
CASH_OUT,1096999,Vincent Joubert,1264000,167001,Agence_moov_Cotonou,300000,-796999,2022-10-04
CASH_OUT,45474,Vincent Joubert,167001,121527,Agence_moov_Ouidah,300000,254526,2022-10-08
TRANSFER,3099,Vincent Joubert,121527,118428,Rémy Grondin,476700,473601,2022-10-11
TRANSFER,50656,Vincent Joubert,118428,67772,Adèle Da Silva-Klein,978200,927544,2022-10-23
CASH_OUT,1502472,Raymond Lévy,1784600,282128,Agence_moov_Abomey,300000,-1202472,2022-10-08
TRANSFER,576733,Véronique Martins de Fleury,752200,175467,Raymond Lévy,282128,858861,2022-10-09
TRANSFER,507576,Camille Morvan,639800,132224,Raymond Lévy,858861,1366437,2022-10-10
CASH_OUT,60699,Raymond Lévy,1366437,1305738,Agence_moov_Cotonou,300000,239301,2022-10-22
CASH_IN,277854,Agence_moov_Cotonou,300000,22146,Émile-René Baudry,1405600,1683454,2022-10-11
CASH_OUT,27895,Émile-René Baudry,1683454,1655559,Agence_moov_Abomey,300000,272105,2022-10-17
TRANSFER,1258017,Émile-René Baudry,1655559,397542,Paulette Loiseau,263800,-994217,2022-10-22
TRANSFER,270947,Émile-René Baudry,397542,126595,Nathalie Bonnin-Joubert,314600,43653,2022-10-27
TRANSFER,912579,Noël Bourgeois,1345900,433321,Michelle-Dorothée Lévêque,492500,-420079,2022-10-04
CASH_OUT,144047,Noël Bourgeois,433321,289274,Agence_moov_Ouidah,300000,155953,2022-10-09
CASH_IN,204338,Agence_moov_Abomey,300000,95662,Noël Bourgeois,289274,493612,2022-10-10
CASH_IN,114884,Agence_moov_Ouidah,300000,185116,Noël Bourgeois,493612,608496,2022-10-10
TRANSFER,476180,Thérèse Hubert,1905100,1428920,Virginie Bouvet,1094300,1570480,2022-10-08
CASH_OUT,1560872,Virginie Bouvet,1570480,9608,Agence_moov_Ouidah,300000,-1260872,2022-10-10
CASH_IN,254812,Agence_moov_Cotonou,300000,45188,Richard Le Lévêque,263200,518012,2022-10-14
CASH_IN,9921,Agence_moov_Cotonou,300000,290079,Richard Le Lévêque,518012,527933,2022-10-27
CASH_IN,63948,Agence_moov_Abomey,300000,236052,Noémi Bouvier,920800,984748,2022-10-03
CASH_IN,32924,Agence_moov_Abomey,300000,267076,Noémi Bouvier,984748,1017672,2022-10-08
TRANSFER,102628,Alphonse Gomes,835200,732572,Noémi Bouvier,1017672,1120300,2022-10-09
CASH_IN,67492,Agence_moov_Abomey,300000,232508,Noémi Bouvier,1120300,1187792,2022-10-12
TRANSFER,573841,Christine Texier,1392300,818459,Noémi Bouvier,1187792,1761633,2022-10-20
TRANSFER,565651,Hélène de la Gérard,612100,46449,Matthieu-Matthieu Bigot,1788500,1222849,2022-10-22
TRANSFER,473907,Michelle Samson,1247100,773193,Manon Valette,1991500,2465407,2022-10-12
TRANSFER,967569,Thibaut de la Lombard,1608900,641331,Manon Valette,2465407,3432976,2022-10-15
CASH_OUT,1915364,Manon Valette,3432976,1517612,Agence_moov_Ouidah,300000,-1615364,2022-10-16
TRANSFER,129578,Thérèse Hubert,1428920,1299342,Marc Leleu,1091500,1221078,2022-10-02
CASH_OUT,1004484,Marc Leleu,1221078,216594,Agence_moov_Cotonou,300000,-704484,2022-10-09
CASH_IN,84645,Agence_moov_Cotonou,300000,215355,Marc Leleu,216594,301239,2022-10-18
TRANSFER,672364,Michelle de Étienne,960300,287936,Marc Leleu,301239,973603,2022-10-23
CASH_OUT,219923,Marc Leleu,973603,753680,Agence_moov_Ouidah,300000,80077,2022-10-25
CASH_IN,151763,Agence_moov_Ouidah,300000,148237,Suzanne Bodin,13600,165363,2022-10-13
CASH_IN,272169,Agence_moov_Ouidah,300000,27831,Sabine Pineau,46200,318369,2022-10-12
CASH_OUT,165163,Sabine Pineau,318369,153206,Agence_moov_Cotonou,300000,134837,2022-10-14
CASH_OUT,74618,Sabine Pineau,153206,78588,Agence_moov_Cotonou,300000,225382,2022-10-23
CASH_IN,254913,Agence_moov_Cotonou,300000,45087,Maggie Martinez,488800,743713,2022-10-21
CASH_IN,220958,Agence_moov_Ouidah,300000,79042,Luc Lévêque-Carre,1496000,1716958,2022-10-25
CASH_OUT,93230,Léon Da Costa,1495400,1402170,Agence_moov_Ouidah,300000,206770,2022-10-05
TRANSFER,289357,Renée Rousseau-Henry,1053500,764143,Léon Da Costa,1402170,1691527,2022-10-10
CASH_OUT,475307,Léon Da Costa,1691527,1216220,Agence_moov_Cotonou,300000,-175307,2022-10-13
CASH_IN,123339,Agence_moov_Abomey,300000,176661,Stéphane Munoz,211600,334939,2022-10-02
TRANSFER,541234,Colette Merle Le Robert,625000,83766,Stéphane Munoz,334939,876173,2022-10-16
CASH_OUT,40973,Jules Fernandes,195600,154627,Agence_moov_Cotonou,300000,259027,2022-10-05
TRANSFER,10169,Jules Fernandes,154627,144458,Anastasie Cousin,462400,452231,2022-10-12
CASH_IN,99994,Agence_moov_Cotonou,300000,200006,Jules Fernandes,144458,244452,2022-10-14
CASH_OUT,133887,Jules Fernandes,244452,110565,Agence_moov_Abomey,300000,166113,2022-10-24
CASH_OUT,4626,Jules Fernandes,110565,105939,Agence_moov_Abomey,300000,295374,2022-10-26
TRANSFER,634099,Thibaut de la Lombard,641331,7232,Paul Perez,486000,1120099,2022-10-06
TRANSFER,1473,Simone Muller de la Brun,490300,488827,Bertrand Regnier,1194000,1192527,2022-10-01
CASH_IN,64066,Agence_moov_Cotonou,300000,235934,Simone Muller de la Brun,488827,552893,2022-10-10
CASH_IN,42662,Agence_moov_Abomey,300000,257338,Simone Muller de la Brun,552893,595555,2022-10-12
CASH_IN,193319,Agence_moov_Cotonou,300000,106681,Simone Muller de la Brun,595555,788874,2022-10-14
CASH_OUT,706120,Simone Muller de la Brun,788874,82754,Agence_moov_Cotonou,300000,-406120,2022-10-24
CASH_IN,283290,Agence_moov_Abomey,300000,16710,Tristan Gomez,995500,1278790,2022-10-24
TRANSFER,61396,Émilie du Allain,139100,77704,Richard Michel,238600,299996,2022-10-04
TRANSFER,182968,Richard Michel,299996,117028,Tristan Bousquet-Gros,69300,-113668,2022-10-09
CASH_OUT,16779,Richard Michel,117028,100249,Agence_moov_Cotonou,300000,283221,2022-10-14
CASH_IN,272871,Agence_moov_Abomey,300000,27129,Richard Michel,100249,373120,2022-10-16
CASH_OUT,183522,Richard Michel,373120,189598,Agence_moov_Ouidah,300000,116478,2022-10-21
CASH_IN,253814,Agence_moov_Abomey,300000,46186,Thomas-Robert Morvan,816600,1070414,2022-10-16
TRANSFER,590157,Thomas-Robert Morvan,1070414,480257,Bertrand Regnier,1192527,602370,2022-10-16
CASH_OUT,38787,Thomas-Robert Morvan,480257,441470,Agence_moov_Ouidah,300000,261213,2022-10-25
CASH_OUT,265111,Thomas-Robert Morvan,441470,176359,Agence_moov_Abomey,300000,34889,2022-10-25
CASH_OUT,155783,Thomas-Robert Morvan,176359,20576,Agence_moov_Ouidah,300000,144217,2022-10-27
CASH_OUT,4429,Thibaut de la Lombard,7232,2803,Agence_moov_Ouidah,300000,295571,2022-10-10
CASH_IN,158903,Agence_moov_Cotonou,300000,141097,Thibaut de la Lombard,2803,161706,2022-10-11
CASH_IN,158621,Agence_moov_Cotonou,300000,141379,Thibaut de la Lombard,161706,320327,2022-10-24
TRANSFER,65444,Thibaut de la Lombard,320327,254883,Benoît Guyot,597800,532356,2022-10-26
CASH_OUT,129769,Bernard Maurice,143700,13931,Agence_moov_Ouidah,300000,170231,2022-10-01
TRANSFER,176593,Robert Laroche,354900,178307,Bernard Maurice,13931,190524,2022-10-10
TRANSFER,5519,Bernard Maurice,190524,185005,Bertrand Regnier,602370,596851,2022-10-25
TRANSFER,96105,Bernard Maurice,185005,88900,Rémy Grondin,473601,377496,2022-10-25
CASH_IN,39613,Agence_moov_Cotonou,300000,260387,Marcelle-Valentine Guibert,1989400,2029013,2022-10-27
TRANSFER,1347861,Anastasie Richard-Neveu,1475600,127739,Frédérique Fernandes du Bouchet,219400,1567261,2022-10-15
CASH_OUT,1562728,Frédérique Fernandes du Bouchet,1567261,4533,Agence_moov_Ouidah,300000,-1262728,2022-10-26
TRANSFER,316762,Thomas de Blin,399200,82438,Antoinette de Dupuis,1989700,1672938,2022-10-05
CASH_OUT,24933,Thomas de Blin,82438,57505,Agence_moov_Ouidah,300000,275067,2022-10-16
TRANSFER,42547,Thomas de Blin,57505,14958,Bernadette de Jourdan,164700,122153,2022-10-17
TRANSFER,11335,Thomas de Blin,14958,3623,Aimé Pages,1864000,1852665,2022-10-23
TRANSFER,393426,Vincent de la Dumont,1736800,1343374,Gérard de la Martinez,121500,514926,2022-10-01
CASH_OUT,153312,Gérard de la Martinez,514926,361614,Agence_moov_Abomey,300000,146688,2022-10-01
TRANSFER,137739,Gérard de la Martinez,361614,223875,Clémence-Véronique Munoz,203800,66061,2022-10-03
TRANSFER,841150,Lucie Aubert,1800100,958950,Gérard de la Martinez,223875,1065025,2022-10-04
CASH_IN,198097,Agence_moov_Abomey,300000,101903,Gérard de la Martinez,1065025,1263122,2022-10-04
CASH_OUT,551326,Gérard de la Martinez,1263122,711796,Agence_moov_Cotonou,300000,-251326,2022-10-05
TRANSFER,1437171,Manon Lebon,1577900,140729,Gérard de la Martinez,711796,2148967,2022-10-05
CASH_IN,253269,Agence_moov_Cotonou,300000,46731,Gérard de la Martinez,2148967,2402236,2022-10-06
TRANSFER,117133,Théodore Joseph-Lefebvre,910600,793467,Gérard de la Martinez,2402236,2519369,2022-10-06
CASH_IN,172357,Agence_moov_Abomey,300000,127643,Gérard de la Martinez,2519369,2691726,2022-10-06
CASH_OUT,2579199,Gérard de la Martinez,2691726,112527,Agence_moov_Ouidah,300000,-2279199,2022-10-09
CASH_IN,142860,Agence_moov_Cotonou,300000,157140,Gérard de la Martinez,112527,255387,2022-10-09
CASH_IN,60069,Agence_moov_Cotonou,300000,239931,Gérard de la Martinez,255387,315456,2022-10-11
TRANSFER,243552,Gérard de la Martinez,315456,71904,Clémence-Véronique Munoz,66061,-177491,2022-10-11
CASH_IN,127709,Agence_moov_Abomey,300000,172291,Gérard de la Martinez,71904,199613,2022-10-11
CASH_IN,287423,Agence_moov_Cotonou,300000,12577,Gérard de la Martinez,199613,487036,2022-10-11
CASH_OUT,144484,Gérard de la Martinez,487036,342552,Agence_moov_Ouidah,300000,155516,2022-10-12
CASH_IN,272776,Agence_moov_Cotonou,300000,27224,Gérard de la Martinez,342552,615328,2022-10-14
TRANSFER,585163,Gérard de la Martinez,615328,30165,Colette Merle Le Robert,83766,-501397,2022-10-20
TRANSFER,28663,Gérard de la Martinez,30165,1502,Antoinette de Dupuis,1672938,1644275,2022-10-22
CASH_IN,70046,Agence_moov_Ouidah,300000,229954,Gérard de la Martinez,1502,71548,2022-10-22
CASH_IN,132022,Agence_moov_Ouidah,300000,167978,Gérard de la Martinez,71548,203570,2022-10-22
CASH_IN,198659,Agence_moov_Abomey,300000,101341,Gérard de la Martinez,203570,402229,2022-10-23
CASH_OUT,13651,Alix Barbe,800000,786349,Agence_moov_Cotonou,300000,286349,2022-10-02
TRANSFER,402268,Constance Bourdon-Millet,731600,329332,Alix Barbe,786349,1188617,2022-10-02
CASH_OUT,359226,Alix Barbe,1188617,829391,Agence_moov_Ouidah,300000,-59226,2022-10-04
CASH_OUT,248945,Alix Barbe,829391,580446,Agence_moov_Ouidah,300000,51055,2022-10-07
CASH_OUT,279986,Alix Barbe,580446,300460,Agence_moov_Abomey,300000,20014,2022-10-08
CASH_IN,183353,Agence_moov_Ouidah,300000,116647,Alix Barbe,300460,483813,2022-10-09
TRANSFER,190244,Alix Barbe,483813,293569,Emmanuel Grégoire,1816100,1625856,2022-10-09
TRANSFER,41942,Alix Barbe,293569,251627,Manon Lebon,140729,98787,2022-10-10
CASH_IN,114657,Agence_moov_Cotonou,300000,185343,Alix Barbe,251627,366284,2022-10-10
TRANSFER,101976,Alix Barbe,366284,264308,Aimé Pages,1852665,1750689,2022-10-12
CASH_IN,68289,Agence_moov_Ouidah,300000,231711,Alix Barbe,264308,332597,2022-10-13
TRANSFER,185114,Alix Barbe,332597,147483,Jules-Roland Bousquet,482400,297286,2022-10-14
TRANSFER,138636,Alix Barbe,147483,8847,Adèle Da Silva-Klein,927544,788908,2022-10-14
TRANSFER,8557,Alix Barbe,8847,290,Alix Barbe,8847,17404,2022-10-18
CASH_IN,236686,Agence_moov_Cotonou,300000,63314,Alix Barbe,290,236976,2022-10-18
CASH_IN,63508,Agence_moov_Ouidah,300000,236492,Alix Barbe,236976,300484,2022-10-18
TRANSFER,7412,Alix Barbe,300484,293072,Mathilde Picard du Delmas,601200,593788,2022-10-19
CASH_IN,268487,Agence_moov_Cotonou,300000,31513,Alix Barbe,293072,561559,2022-10-20
CASH_IN,184017,Agence_moov_Abomey,300000,115983,Alix Barbe,561559,745576,2022-10-20
CASH_OUT,669534,Alix Barbe,745576,76042,Agence_moov_Ouidah,300000,-369534,2022-10-21
CASH_OUT,41983,Alix Barbe,76042,34059,Agence_moov_Ouidah,300000,258017,2022-10-21
CASH_IN,89933,Agence_moov_Abomey,300000,210067,Alix Barbe,34059,123992,2022-10-21
CASH_IN,13176,Agence_moov_Cotonou,300000,286824,Alix Barbe,123992,137168,2022-10-21
CASH_IN,220040,Agence_moov_Ouidah,300000,79960,Alix Barbe,137168,357208,2022-10-23
CASH_IN,227401,Agence_moov_Ouidah,300000,72599,Alix Barbe,357208,584609,2022-10-25
TRANSFER,569556,Alix Barbe,584609,15053,Frédéric Guillou,1087300,517744,2022-10-26
TRANSFER,713751,Martine Aubert,1096600,382849,Hélène Le Chauvin,1498800,785049,2022-10-01
CASH_IN,63369,Agence_moov_Abomey,300000,236631,Martine Aubert,382849,446218,2022-10-02
TRANSFER,225591,Martine Aubert,446218,220627,Tristan Delahaye,1033100,807509,2022-10-04
CASH_IN,4399,Agence_moov_Cotonou,300000,295601,Martine Aubert,220627,225026,2022-10-04
CASH_IN,17265,Agence_moov_Cotonou,300000,282735,Martine Aubert,225026,242291,2022-10-05
TRANSFER,12487,Mathilde de la Samson,80400,67913,Martine Aubert,242291,254778,2022-10-06
CASH_IN,42919,Agence_moov_Abomey,300000,257081,Martine Aubert,254778,297697,2022-10-07
TRANSFER,137017,Martine Aubert,297697,160680,Adèle Da Silva-Klein,788908,651891,2022-10-07
TRANSFER,584504,Théodore Joseph-Lefebvre,793467,208963,Martine Aubert,160680,745184,2022-10-08
TRANSFER,410137,Thérèse Hubert,1299342,889205,Martine Aubert,745184,1155321,2022-10-08
TRANSFER,162292,Thibaut de la Roy,357200,194908,Martine Aubert,1155321,1317613,2022-10-10
TRANSFER,256590,Frédéric Guillou,517744,261154,Martine Aubert,1317613,1574203,2022-10-10
CASH_OUT,582618,Martine Aubert,1574203,991585,Agence_moov_Abomey,300000,-282618,2022-10-11
CASH_OUT,705996,Martine Aubert,991585,285589,Agence_moov_Abomey,300000,-405996,2022-10-13
CASH_IN,5558,Agence_moov_Ouidah,300000,294442,Martine Aubert,285589,291147,2022-10-16
TRANSFER,150875,Martine Aubert,291147,140272,Paul Rocher-Maillet,1555900,1405025,2022-10-19
CASH_IN,153907,Agence_moov_Ouidah,300000,146093,Martine Aubert,140272,294179,2022-10-20
CASH_IN,286924,Agence_moov_Ouidah,300000,13076,Martine Aubert,294179,581103,2022-10-21
TRANSFER,554985,Martine Aubert,581103,26118,Lucy Gillet,610700,55715,2022-10-22
CASH_IN,175141,Agence_moov_Ouidah,300000,124859,Martine Aubert,26118,201259,2022-10-23
TRANSFER,256018,Andrée-Thérèse Mendès,257800,1782,Martine Aubert,201259,457277,2022-10-23
CASH_OUT,225383,Martine Aubert,457277,231894,Agence_moov_Abomey,300000,74617,2022-10-25
TRANSFER,410436,Hélène Le Chauvin,785049,374613,Martine Aubert,231894,642330,2022-10-26
CASH_IN,229087,Agence_moov_Ouidah,300000,70913,Colette Merle Le Robert,-501397,-272310,2022-10-04
CASH_IN,184202,Agence_moov_Cotonou,300000,115798,Colette Merle Le Robert,-272310,-88108,2022-10-05
CASH_IN,174504,Agence_moov_Cotonou,300000,125496,Colette Merle Le Robert,-88108,86396,2022-10-05
CASH_OUT,16378,Colette Merle Le Robert,86396,70018,Agence_moov_Abomey,300000,283622,2022-10-06
CASH_IN,24423,Agence_moov_Ouidah,300000,275577,Colette Merle Le Robert,70018,94441,2022-10-06
CASH_OUT,91135,Colette Merle Le Robert,94441,3306,Agence_moov_Ouidah,300000,208865,2022-10-07
CASH_OUT,1896,Colette Merle Le Robert,3306,1410,Agence_moov_Abomey,300000,298104,2022-10-11
CASH_OUT,919,Colette Merle Le Robert,1410,491,Agence_moov_Cotonou,300000,299081,2022-10-12
CASH_IN,65434,Agence_moov_Abomey,300000,234566,Colette Merle Le Robert,491,65925,2022-10-12
CASH_IN,69045,Agence_moov_Cotonou,300000,230955,Colette Merle Le Robert,65925,134970,2022-10-15
CASH_OUT,64803,Colette Merle Le Robert,134970,70167,Agence_moov_Ouidah,300000,235197,2022-10-15
CASH_IN,104801,Agence_moov_Abomey,300000,195199,Colette Merle Le Robert,70167,174968,2022-10-18
CASH_IN,113324,Agence_moov_Cotonou,300000,186676,Colette Merle Le Robert,174968,288292,2022-10-18
CASH_IN,74516,Agence_moov_Cotonou,300000,225484,Colette Merle Le Robert,288292,362808,2022-10-18
CASH_IN,40501,Agence_moov_Ouidah,300000,259499,Colette Merle Le Robert,362808,403309,2022-10-19
CASH_OUT,392225,Colette Merle Le Robert,403309,11084,Agence_moov_Abomey,300000,-92225,2022-10-20
CASH_OUT,6032,Colette Merle Le Robert,11084,5052,Agence_moov_Cotonou,300000,293968,2022-10-20
CASH_IN,134583,Agence_moov_Ouidah,300000,165417,Colette Merle Le Robert,5052,139635,2022-10-23
TRANSFER,50570,Colette Merle Le Robert,139635,89065,Lucy Gillet,55715,5145,2022-10-24
CASH_IN,26062,Agence_moov_Abomey,300000,273938,Colette Merle Le Robert,89065,115127,2022-10-25
TRANSFER,109737,Colette Merle Le Robert,115127,5390,Manon Chevalier,1223500,1113763,2022-10-27
CASH_OUT,1067499,Céline Collin-Hervé,1477100,409601,Agence_moov_Cotonou,300000,-767499,2022-10-01
CASH_IN,132197,Agence_moov_Abomey,300000,167803,Céline Collin-Hervé,409601,541798,2022-10-04
TRANSFER,510329,Colette-Sophie Prévost,1216100,705771,Céline Collin-Hervé,541798,1052127,2022-10-05
TRANSFER,136000,Michel Bouchet,403000,267000,Céline Collin-Hervé,1052127,1188127,2022-10-06
CASH_OUT,1072381,Céline Collin-Hervé,1188127,115746,Agence_moov_Ouidah,300000,-772381,2022-10-06
CASH_OUT,53109,Céline Collin-Hervé,115746,62637,Agence_moov_Ouidah,300000,246891,2022-10-06
CASH_OUT,4384,Céline Collin-Hervé,62637,58253,Agence_moov_Cotonou,300000,295616,2022-10-07
TRANSFER,599225,Christine Texier,818459,219234,Céline Collin-Hervé,58253,657478,2022-10-09
TRANSFER,400550,Benoît Guyot,532356,131806,Céline Collin-Hervé,657478,1058028,2022-10-11
CASH_OUT,329573,Céline Collin-Hervé,1058028,728455,Agence_moov_Abomey,300000,-29573,2022-10-12
CASH_IN,20431,Agence_moov_Cotonou,300000,279569,Céline Collin-Hervé,728455,748886,2022-10-12
CASH_IN,247628,Agence_moov_Ouidah,300000,52372,Céline Collin-Hervé,748886,996514,2022-10-13
TRANSFER,114078,Thibaut de la Roy,194908,80830,Céline Collin-Hervé,996514,1110592,2022-10-13
CASH_IN,112387,Agence_moov_Abomey,300000,187613,Céline Collin-Hervé,1110592,1222979,2022-10-14
CASH_OUT,789223,Céline Collin-Hervé,1222979,433756,Agence_moov_Cotonou,300000,-489223,2022-10-17
CASH_IN,216511,Agence_moov_Abomey,300000,83489,Céline Collin-Hervé,433756,650267,2022-10-21
TRANSFER,372202,Céline Collin-Hervé,650267,278065,Robert-Louis Gosselin,1285700,913498,2022-10-21
CASH_OUT,60887,Céline Collin-Hervé,278065,217178,Agence_moov_Ouidah,300000,239113,2022-10-21
TRANSFER,26333,Émilie du Allain,77704,51371,Céline Collin-Hervé,217178,243511,2022-10-22
CASH_OUT,149946,Céline Collin-Hervé,243511,93565,Agence_moov_Ouidah,300000,150054,2022-10-25
CASH_IN,86823,Agence_moov_Abomey,300000,213177,Céline Collin-Hervé,93565,180388,2022-10-25
CASH_OUT,46765,Céline Collin-Hervé,180388,133623,Agence_moov_Ouidah,300000,253235,2022-10-26
CASH_OUT,97572,Céline Collin-Hervé,133623,36051,Agence_moov_Ouidah,300000,202428,2022-10-27
CASH_IN,27454,Agence_moov_Ouidah,300000,272546,Paul Rocher-Maillet,1405025,1432479,2022-10-02
TRANSFER,220870,Lucie Aubert,958950,738080,Paul Rocher-Maillet,1432479,1653349,2022-10-02
CASH_OUT,382098,Paul Rocher-Maillet,1653349,1271251,Agence_moov_Cotonou,300000,-82098,2022-10-03
CASH_OUT,869884,Paul Rocher-Maillet,1271251,401367,Agence_moov_Ouidah,300000,-569884,2022-10-04
TRANSFER,244908,Paul Rocher-Maillet,401367,156459,Robert-Louis Gosselin,913498,668590,2022-10-06
TRANSFER,135970,Michelle Samson,773193,637223,Paul Rocher-Maillet,156459,292429,2022-10-08
CASH_IN,203880,Agence_moov_Cotonou,300000,96120,Paul Rocher-Maillet,292429,496309,2022-10-10
CASH_IN,31316,Agence_moov_Cotonou,300000,268684,Paul Rocher-Maillet,496309,527625,2022-10-11
CASH_IN,44902,Agence_moov_Ouidah,300000,255098,Paul Rocher-Maillet,527625,572527,2022-10-13
CASH_OUT,348144,Paul Rocher-Maillet,572527,224383,Agence_moov_Abomey,300000,-48144,2022-10-13
CASH_OUT,540,Paul Rocher-Maillet,224383,223843,Agence_moov_Ouidah,300000,299460,2022-10-13
CASH_OUT,25588,Paul Rocher-Maillet,223843,198255,Agence_moov_Ouidah,300000,274412,2022-10-13
CASH_IN,132766,Agence_moov_Ouidah,300000,167234,Paul Rocher-Maillet,198255,331021,2022-10-17
CASH_IN,266090,Agence_moov_Ouidah,300000,33910,Paul Rocher-Maillet,331021,597111,2022-10-17
CASH_OUT,13136,Paul Rocher-Maillet,597111,583975,Agence_moov_Abomey,300000,286864,2022-10-19
CASH_IN,50644,Agence_moov_Ouidah,300000,249356,Paul Rocher-Maillet,583975,634619,2022-10-20
CASH_OUT,115863,Paul Rocher-Maillet,634619,518756,Agence_moov_Ouidah,300000,184137,2022-10-21
TRANSFER,363902,Paul Rocher-Maillet,518756,154854,Manon Chevalier,1113763,749861,2022-10-22
CASH_OUT,14089,Paul Rocher-Maillet,154854,140765,Agence_moov_Ouidah,300000,285911,2022-10-24
CASH_OUT,16582,Paul Rocher-Maillet,140765,124183,Agence_moov_Abomey,300000,283418,2022-10-25
TRANSFER,16919,Paul Rocher-Maillet,124183,107264,Michelle Samson,637223,620304,2022-10-25
TRANSFER,706885,Marthe Gilles,745000,38115,Paul Rocher-Maillet,107264,814149,2022-10-26
TRANSFER,552549,Paul Rocher-Maillet,814149,261600,Agnès Le Giraud,1876200,1323651,2022-10-27
CASH_IN,121962,Agence_moov_Abomey,300000,178038,Camille Morvan,132224,254186,2022-10-01
CASH_IN,189310,Agence_moov_Cotonou,300000,110690,Camille Morvan,254186,443496,2022-10-02
TRANSFER,184885,Lucie Aubert,738080,553195,Camille Morvan,443496,628381,2022-10-03
CASH_OUT,579681,Camille Morvan,628381,48700,Agence_moov_Ouidah,300000,-279681,2022-10-04
TRANSFER,37269,Camille Morvan,48700,11431,Thibaut de la Roy,80830,43561,2022-10-04
CASH_IN,247308,Agence_moov_Cotonou,300000,52692,Camille Morvan,11431,258739,2022-10-10
CASH_OUT,248689,Camille Morvan,258739,10050,Agence_moov_Abomey,300000,51311,2022-10-10
CASH_IN,211023,Agence_moov_Cotonou,300000,88977,Camille Morvan,10050,221073,2022-10-10
CASH_IN,110875,Agence_moov_Abomey,300000,189125,Camille Morvan,221073,331948,2022-10-11
CASH_IN,279309,Agence_moov_Abomey,300000,20691,Camille Morvan,331948,611257,2022-10-11
CASH_OUT,510899,Camille Morvan,611257,100358,Agence_moov_Abomey,300000,-210899,2022-10-12
TRANSFER,3532,Marthe Gilles,38115,34583,Camille Morvan,100358,103890,2022-10-13
CASH_OUT,35783,Camille Morvan,103890,68107,Agence_moov_Abomey,300000,264217,2022-10-13
CASH_IN,193476,Agence_moov_Ouidah,300000,106524,Camille Morvan,68107,261583,2022-10-13
TRANSFER,245294,Camille Morvan,261583,16289,Frédéric Guillou,261154,15860,2022-10-16
CASH_OUT,2038,Camille Morvan,16289,14251,Agence_moov_Abomey,300000,297962,2022-10-16
CASH_OUT,554,Camille Morvan,14251,13697,Agence_moov_Ouidah,300000,299446,2022-10-16
TRANSFER,1434192,Aimé Pages,1750689,316497,Camille Morvan,13697,1447889,2022-10-19
TRANSFER,29141,Mathilde de la Samson,67913,38772,Camille Morvan,1447889,1477030,2022-10-19
CASH_OUT,570720,Camille Morvan,1477030,906310,Agence_moov_Cotonou,300000,-270720,2022-10-21
CASH_OUT,491698,Camille Morvan,906310,414612,Agence_moov_Cotonou,300000,-191698,2022-10-22
CASH_IN,19195,Agence_moov_Abomey,300000,280805,Camille Morvan,414612,433807,2022-10-22
CASH_OUT,3640,Camille Morvan,433807,430167,Agence_moov_Ouidah,300000,296360,2022-10-23
TRANSFER,153017,Robert Clerc,337800,184783,Camille Morvan,430167,583184,2022-10-24
TRANSFER,26329,Camille Morvan,583184,556855,Robert-Louis Gosselin,668590,642261,2022-10-24
CASH_OUT,225667,Camille Morvan,556855,331188,Agence_moov_Cotonou,300000,74333,2022-10-25
CASH_IN,130015,Agence_moov_Ouidah,300000,169985,Camille Morvan,331188,461203,2022-10-26
TRANSFER,48635,Camille Morvan,461203,412568,Gabriel Bègue,1926000,1877365,2022-10-26
TRANSFER,192416,Michelle de Étienne,287936,95520,Camille Morvan,412568,604984,2022-10-27
CASH_OUT,386251,Camille Morvan,604984,218733,Agence_moov_Abomey,300000,-86251,2022-10-27
TRANSFER,436891,Robert-Louis Gosselin,642261,205370,Michelle de Étienne,95520,-341371,2022-10-01
CASH_IN,35699,Agence_moov_Cotonou,300000,264301,Robert-Louis Gosselin,205370,241069,2022-10-02
CASH_IN,138072,Agence_moov_Ouidah,300000,161928,Robert-Louis Gosselin,241069,379141,2022-10-02
CASH_OUT,99729,Robert-Louis Gosselin,379141,279412,Agence_moov_Ouidah,300000,200271,2022-10-03
CASH_IN,130842,Agence_moov_Cotonou,300000,169158,Robert-Louis Gosselin,279412,410254,2022-10-04
CASH_OUT,110207,Robert-Louis Gosselin,410254,300047,Agence_moov_Ouidah,300000,189793,2022-10-06
CASH_OUT,243533,Robert-Louis Gosselin,300047,56514,Agence_moov_Cotonou,300000,56467,2022-10-07
CASH_IN,251135,Agence_moov_Cotonou,300000,48865,Robert-Louis Gosselin,56514,307649,2022-10-08
TRANSFER,303231,Robert-Louis Gosselin,307649,4418,Camille Prévost,1817800,1514569,2022-10-08
TRANSFER,582207,Michelle Samson,620304,38097,Robert-Louis Gosselin,4418,586625,2022-10-09
CASH_IN,83273,Agence_moov_Abomey,300000,216727,Robert-Louis Gosselin,586625,669898,2022-10-09
CASH_OUT,310514,Robert-Louis Gosselin,669898,359384,Agence_moov_Ouidah,300000,-10514,2022-10-09
TRANSFER,252464,Robert-Louis Gosselin,359384,106920,Vincent de la Dumont,1343374,1090910,2022-10-10
CASH_OUT,92753,Robert-Louis Gosselin,106920,14167,Agence_moov_Ouidah,300000,207247,2022-10-11
CASH_OUT,7869,Robert-Louis Gosselin,14167,6298,Agence_moov_Abomey,300000,292131,2022-10-13
TRANSFER,2700,Robert-Louis Gosselin,6298,3598,Andrée-Thérèse Mendès,1782,-918,2022-10-14
TRANSFER,73531,Timothée-René Blanchard,884900,811369,Robert-Louis Gosselin,3598,77129,2022-10-14
CASH_IN,2175,Agence_moov_Cotonou,300000,297825,Robert-Louis Gosselin,77129,79304,2022-10-15
CASH_OUT,40747,Robert-Louis Gosselin,79304,38557,Agence_moov_Ouidah,300000,259253,2022-10-16
CASH_OUT,25135,Robert-Louis Gosselin,38557,13422,Agence_moov_Ouidah,300000,274865,2022-10-17
CASH_IN,183098,Agence_moov_Cotonou,300000,116902,Robert-Louis Gosselin,13422,196520,2022-10-19
CASH_OUT,127360,Robert-Louis Gosselin,196520,69160,Agence_moov_Ouidah,300000,172640,2022-10-19
CASH_OUT,3458,Robert-Louis Gosselin,69160,65702,Agence_moov_Cotonou,300000,296542,2022-10-21
CASH_OUT,8155,Robert-Louis Gosselin,65702,57547,Agence_moov_Cotonou,300000,291845,2022-10-22
CASH_IN,212100,Agence_moov_Ouidah,300000,87900,Robert-Louis Gosselin,57547,269647,2022-10-23
CASH_IN,245099,Agence_moov_Cotonou,300000,54901,Robert-Louis Gosselin,269647,514746,2022-10-27
CASH_IN,34078,Agence_moov_Cotonou,300000,265922,Robert-Louis Gosselin,514746,548824,2022-10-27
TRANSFER,98648,Robert-Louis Gosselin,548824,450176,Rémy Grondin,377496,278848,2022-10-27
TRANSFER,91785,Robert Laroche,178307,86522,Renée Le Diaz,1588100,1679885,2022-10-01
TRANSFER,1602026,Renée Le Diaz,1679885,77859,Lucy Lamy,190000,-1412026,2022-10-01
TRANSFER,22821,Anastasie Richard-Neveu,127739,104918,Renée Le Diaz,77859,100680,2022-10-02
TRANSFER,58247,Renée Le Diaz,100680,42433,Aurore Charrier,1065600,1007353,2022-10-03
TRANSFER,53693,Bertrand Regnier,596851,543158,Renée Le Diaz,42433,96126,2022-10-03
CASH_IN,239174,Agence_moov_Cotonou,300000,60826,Renée Le Diaz,96126,335300,2022-10-06
CASH_IN,4492,Agence_moov_Abomey,300000,295508,Renée Le Diaz,335300,339792,2022-10-06
CASH_OUT,190563,Renée Le Diaz,339792,149229,Agence_moov_Abomey,300000,109437,2022-10-10
CASH_IN,30796,Agence_moov_Ouidah,300000,269204,Renée Le Diaz,149229,180025,2022-10-10
CASH_IN,299716,Agence_moov_Ouidah,300000,284,Renée Le Diaz,180025,479741,2022-10-11
CASH_OUT,449113,Renée Le Diaz,479741,30628,Agence_moov_Abomey,300000,-149113,2022-10-12
CASH_IN,83033,Agence_moov_Abomey,300000,216967,Renée Le Diaz,30628,113661,2022-10-14
TRANSFER,135981,Rémy Grondin,278848,142867,Renée Le Diaz,113661,249642,2022-10-16
TRANSFER,174025,Anne Peltier-Raynaud,392500,218475,Renée Le Diaz,249642,423667,2022-10-17
TRANSFER,107043,Renée Le Diaz,423667,316624,Emmanuel Grégoire,1625856,1518813,2022-10-17
TRANSFER,203246,Renée Le Diaz,316624,113378,Vincent de la Dumont,1090910,887664,2022-10-18
CASH_IN,140599,Agence_moov_Cotonou,300000,159401,Renée Le Diaz,113378,253977,2022-10-20
CASH_IN,141869,Agence_moov_Ouidah,300000,158131,Renée Le Diaz,253977,395846,2022-10-20
CASH_IN,113481,Agence_moov_Cotonou,300000,186519,Renée Le Diaz,395846,509327,2022-10-20
CASH_IN,240813,Agence_moov_Ouidah,300000,59187,Renée Le Diaz,509327,750140,2022-10-21
CASH_OUT,62273,Renée Le Diaz,750140,687867,Agence_moov_Abomey,300000,237727,2022-10-21
TRANSFER,166958,Renée Le Diaz,687867,520909,Renée Le Diaz,687867,854825,2022-10-22
TRANSFER,248347,Thérèse Hubert,889205,640858,Renée Le Diaz,520909,769256,2022-10-24
TRANSFER,567591,Renée Le Diaz,769256,201665,Émilie du Allain,51371,-516220,2022-10-26
CASH_OUT,96022,Renée Le Diaz,201665,105643,Agence_moov_Cotonou,300000,203978,2022-10-26
CASH_IN,30473,Agence_moov_Ouidah,300000,269527,Renée Le Diaz,105643,136116,2022-10-27
TRANSFER,5682,Hélène Le Chauvin,374613,368931,Thomas Guichard du Renault,1253900,1259582,2022-10-01
CASH_OUT,659916,Thomas Guichard du Renault,1259582,599666,Agence_moov_Ouidah,300000,-359916,2022-10-02
TRANSFER,85061,Robert Clerc,184783,99722,Thomas Guichard du Renault,599666,684727,2022-10-02
CASH_OUT,308904,Thomas Guichard du Renault,684727,375823,Agence_moov_Abomey,300000,-8904,2022-10-03
TRANSFER,165090,Thomas Guichard du Renault,375823,210733,Robert Clerc,99722,-65368,2022-10-04
TRANSFER,87104,Thomas Guichard du Renault,210733,123629,Lucie Aubert,553195,466091,2022-10-04
TRANSFER,567,Thomas Guichard du Renault,123629,123062,Antoinette de Dupuis,1644275,1643708,2022-10-08
TRANSFER,564761,Adèle Da Silva-Klein,651891,87130,Thomas Guichard du Renault,123062,687823,2022-10-09
CASH_OUT,16622,Thomas Guichard du Renault,687823,671201,Agence_moov_Abomey,300000,283378,2022-10-09
CASH_OUT,161423,Thomas Guichard du Renault,671201,509778,Agence_moov_Ouidah,300000,138577,2022-10-10
TRANSFER,97504,Bertrand Regnier,543158,445654,Thomas Guichard du Renault,509778,607282,2022-10-11
CASH_IN,178462,Agence_moov_Cotonou,300000,121538,Thomas Guichard du Renault,607282,785744,2022-10-13
CASH_OUT,285055,Thomas Guichard du Renault,785744,500689,Agence_moov_Cotonou,300000,14945,2022-10-14
CASH_OUT,379779,Thomas Guichard du Renault,500689,120910,Agence_moov_Cotonou,300000,-79779,2022-10-15
TRANSFER,24483,Thomas Guichard du Renault,120910,96427,Thomas Dupont,1351000,1326517,2022-10-15
TRANSFER,712261,Thomas Dupont,1326517,614256,Thomas Guichard du Renault,96427,808688,2022-10-15
CASH_IN,297063,Agence_moov_Ouidah,300000,2937,Thomas Guichard du Renault,808688,1105751,2022-10-18
CASH_OUT,360607,Thomas Guichard du Renault,1105751,745144,Agence_moov_Abomey,300000,-60607,2022-10-18
TRANSFER,385414,Thomas Guichard du Renault,745144,359730,Agnès Le Giraud,1323651,938237,2022-10-20
CASH_OUT,156722,Thomas Guichard du Renault,359730,203008,Agence_moov_Ouidah,300000,143278,2022-10-21
CASH_OUT,18675,Thomas Guichard du Renault,203008,184333,Agence_moov_Abomey,300000,281325,2022-10-21
TRANSFER,144624,Thomas Guichard du Renault,184333,39709,André Renault,1257600,1112976,2022-10-21
CASH_IN,130928,Agence_moov_Ouidah,300000,169072,Thomas Guichard du Renault,39709,170637,2022-10-23
TRANSFER,564154,Françoise Morin,954400,390246,Thomas Guichard du Renault,170637,734791,2022-10-23
CASH_IN,114044,Agence_moov_Ouidah,300000,185956,Thomas Guichard du Renault,734791,848835,2022-10-24
CASH_OUT,240852,Thomas Guichard du Renault,848835,607983,Agence_moov_Cotonou,300000,59148,2022-10-24
CASH_OUT,491786,Thomas Guichard du Renault,607983,116197,Agence_moov_Ouidah,300000,-191786,2022-10-25
CASH_OUT,45315,Thomas Guichard du Renault,116197,70882,Agence_moov_Abomey,300000,254685,2022-10-26
TRANSFER,63751,Nicolas Salmon Le Hamon,257500,193749,Thomas Guichard du Renault,70882,134633,2022-10-27
CASH_OUT,44576,Thomas Guichard du Renault,134633,90057,Agence_moov_Ouidah,300000,255424,2022-10-27
CASH_OUT,27740,Anne Peltier-Raynaud,218475,190735,Agence_moov_Abomey,300000,272260,2022-10-01
CASH_OUT,182277,Anne Peltier-Raynaud,190735,8458,Agence_moov_Cotonou,300000,117723,2022-10-02
TRANSFER,8133,Anne Peltier-Raynaud,8458,325,Colette-Sophie Prévost,705771,697638,2022-10-04
CASH_IN,167177,Agence_moov_Ouidah,300000,132823,Anne Peltier-Raynaud,325,167502,2022-10-06
CASH_OUT,21367,Anne Peltier-Raynaud,167502,146135,Agence_moov_Cotonou,300000,278633,2022-10-06
CASH_OUT,3701,Anne Peltier-Raynaud,146135,142434,Agence_moov_Abomey,300000,296299,2022-10-08
TRANSFER,261782,Audrey Julien de Leleu,1978800,1717018,Anne Peltier-Raynaud,142434,404216,2022-10-09
CASH_IN,186036,Agence_moov_Abomey,300000,113964,Anne Peltier-Raynaud,404216,590252,2022-10-10
CASH_IN,62642,Agence_moov_Abomey,300000,237358,Anne Peltier-Raynaud,590252,652894,2022-10-12
TRANSFER,498275,Anne Peltier-Raynaud,652894,154619,André Renault,1112976,614701,2022-10-12
CASH_IN,71155,Agence_moov_Abomey,300000,228845,Anne Peltier-Raynaud,154619,225774,2022-10-13
CASH_IN,125555,Agence_moov_Abomey,300000,174445,Anne Peltier-Raynaud,225774,351329,2022-10-14
CASH_OUT,12998,Anne Peltier-Raynaud,351329,338331,Agence_moov_Abomey,300000,287002,2022-10-14
TRANSFER,121767,Anne Peltier-Raynaud,338331,216564,Frédéric Guillou,15860,-105907,2022-10-14
TRANSFER,137699,Anne Peltier-Raynaud,216564,78865,Lucy Gillet,5145,-132554,2022-10-15
TRANSFER,78190,Anne Peltier-Raynaud,78865,675,Lucie Aubert,466091,387901,2022-10-15
TRANSFER,217,Anne Peltier-Raynaud,675,458,Michelle Samson,38097,37880,2022-10-19
TRANSFER,227,Anne Peltier-Raynaud,458,231,Hélène Le Chauvin,368931,368704,2022-10-21
CASH_OUT,167,Anne Peltier-Raynaud,231,64,Agence_moov_Cotonou,300000,299833,2022-10-22
CASH_IN,175307,Agence_moov_Abomey,300000,124693,Anne Peltier-Raynaud,64,175371,2022-10-22
CASH_IN,210457,Agence_moov_Ouidah,300000,89543,Anne Peltier-Raynaud,175371,385828,2022-10-23
CASH_IN,67336,Agence_moov_Abomey,300000,232664,Anne Peltier-Raynaud,385828,453164,2022-10-23
CASH_IN,55891,Agence_moov_Cotonou,300000,244109,Anne Peltier-Raynaud,453164,509055,2022-10-24
TRANSFER,323691,Renée Rousseau-Henry,764143,440452,Anne Peltier-Raynaud,509055,832746,2022-10-25
CASH_OUT,615493,Anne Peltier-Raynaud,832746,217253,Agence_moov_Cotonou,300000,-315493,2022-10-25
CASH_OUT,901,Anne Peltier-Raynaud,217253,216352,Agence_moov_Ouidah,300000,299099,2022-10-26
CASH_IN,946,Agence_moov_Cotonou,300000,299054,Anne Peltier-Raynaud,216352,217298,2022-10-26
CASH_OUT,43197,Anne Peltier-Raynaud,217298,174101,Agence_moov_Ouidah,300000,256803,2022-10-26
CASH_IN,264240,Agence_moov_Cotonou,300000,35760,Anne Peltier-Raynaud,174101,438341,2022-10-27
TRANSFER,28668,Marthe Gilles,34583,5915,Lucie Aubert,387901,359233,2022-10-01
CASH_OUT,4083,Marthe Gilles,5915,1832,Agence_moov_Ouidah,300000,295917,2022-10-03
CASH_IN,65934,Agence_moov_Ouidah,300000,234066,Marthe Gilles,1832,67766,2022-10-04
CASH_OUT,19147,Marthe Gilles,67766,48619,Agence_moov_Abomey,300000,280853,2022-10-06
CASH_OUT,39137,Marthe Gilles,48619,9482,Agence_moov_Ouidah,300000,260863,2022-10-07
TRANSFER,24825,Rémy Grondin,142867,118042,Marthe Gilles,9482,34307,2022-10-08
TRANSFER,26199,Marthe Gilles,34307,8108,Timothée-René Blanchard,811369,785170,2022-10-08
TRANSFER,3449,Marthe Gilles,8108,4659,Françoise Morin,390246,386797,2022-10-09
TRANSFER,2004,Marthe Gilles,4659,2655,Nicolas Salmon Le Hamon,193749,191745,2022-10-09
CASH_IN,207948,Agence_moov_Ouidah,300000,92052,Marthe Gilles,2655,210603,2022-10-10
CASH_IN,219648,Agence_moov_Ouidah,300000,80352,Marthe Gilles,210603,430251,2022-10-12
CASH_IN,115898,Agence_moov_Abomey,300000,184102,Marthe Gilles,430251,546149,2022-10-12
CASH_OUT,314317,Marthe Gilles,546149,231832,Agence_moov_Cotonou,300000,-14317,2022-10-13
CASH_OUT,111000,Marthe Gilles,231832,120832,Agence_moov_Cotonou,300000,189000,2022-10-13
CASH_IN,243262,Agence_moov_Abomey,300000,56738,Marthe Gilles,120832,364094,2022-10-13
CASH_OUT,32296,Marthe Gilles,364094,331798,Agence_moov_Cotonou,300000,267704,2022-10-14
TRANSFER,169495,Marthe Gilles,331798,162303,Gabriel Bègue,1877365,1707870,2022-10-14
CASH_IN,133275,Agence_moov_Ouidah,300000,166725,Marthe Gilles,162303,295578,2022-10-14
CASH_OUT,246438,Marthe Gilles,295578,49140,Agence_moov_Abomey,300000,53562,2022-10-17
CASH_OUT,47040,Marthe Gilles,49140,2100,Agence_moov_Cotonou,300000,252960,2022-10-20
CASH_OUT,214,Marthe Gilles,2100,1886,Agence_moov_Ouidah,300000,299786,2022-10-21
CASH_OUT,378,Marthe Gilles,1886,1508,Agence_moov_Cotonou,300000,299622,2022-10-22
TRANSFER,355635,Astrid Lecoq,730200,374565,Marthe Gilles,1508,357143,2022-10-22
CASH_OUT,215979,Marthe Gilles,357143,141164,Agence_moov_Ouidah,300000,84021,2022-10-23
CASH_OUT,44510,Marthe Gilles,141164,96654,Agence_moov_Cotonou,300000,255490,2022-10-24
CASH_OUT,69607,Marthe Gilles,96654,27047,Agence_moov_Abomey,300000,230393,2022-10-24
TRANSFER,88851,Aurore Charrier,1007353,918502,Marthe Gilles,27047,115898,2022-10-26
TRANSFER,31963,Christine Texier,219234,187271,Marthe Gilles,115898,147861,2022-10-26
TRANSFER,71365,Marthe Gilles,147861,76496,Jules-Roland Bousquet,297286,225921,2022-10-27
CASH_OUT,531350,Emmanuel Grégoire,1518813,987463,Agence_moov_Cotonou,300000,-231350,2022-10-02
TRANSFER,333015,Mathilde Picard du Delmas,593788,260773,Emmanuel Grégoire,987463,1320478,2022-10-02
CASH_OUT,76893,Emmanuel Grégoire,1320478,1243585,Agence_moov_Cotonou,300000,223107,2022-10-03
CASH_IN,232988,Agence_moov_Ouidah,300000,67012,Emmanuel Grégoire,1243585,1476573,2022-10-05
CASH_IN,235739,Agence_moov_Abomey,300000,64261,Emmanuel Grégoire,1476573,1712312,2022-10-05
CASH_IN,33799,Agence_moov_Cotonou,300000,266201,Emmanuel Grégoire,1712312,1746111,2022-10-05
CASH_OUT,990924,Emmanuel Grégoire,1746111,755187,Agence_moov_Abomey,300000,-690924,2022-10-06
TRANSFER,17289,Benoît Guyot,131806,114517,Emmanuel Grégoire,755187,772476,2022-10-08
CASH_IN,88000,Agence_moov_Abomey,300000,212000,Emmanuel Grégoire,772476,860476,2022-10-09
CASH_IN,138084,Agence_moov_Ouidah,300000,161916,Emmanuel Grégoire,860476,998560,2022-10-11
CASH_OUT,790002,Emmanuel Grégoire,998560,208558,Agence_moov_Cotonou,300000,-490002,2022-10-12
CASH_IN,84614,Agence_moov_Ouidah,300000,215386,Emmanuel Grégoire,208558,293172,2022-10-14
CASH_IN,154444,Agence_moov_Ouidah,300000,145556,Emmanuel Grégoire,293172,447616,2022-10-16
CASH_IN,89223,Agence_moov_Cotonou,300000,210777,Emmanuel Grégoire,447616,536839,2022-10-16
CASH_IN,247945,Agence_moov_Ouidah,300000,52055,Emmanuel Grégoire,536839,784784,2022-10-17
CASH_OUT,708383,Emmanuel Grégoire,784784,76401,Agence_moov_Ouidah,300000,-408383,2022-10-17
TRANSFER,68532,Emmanuel Grégoire,76401,7869,Nicolas Salmon Le Hamon,191745,123213,2022-10-18
TRANSFER,378990,Renée Rousseau-Henry,440452,61462,Emmanuel Grégoire,7869,386859,2022-10-19
CASH_IN,5848,Agence_moov_Abomey,300000,294152,Emmanuel Grégoire,386859,392707,2022-10-19
CASH_IN,241042,Agence_moov_Abomey,300000,58958,Emmanuel Grégoire,392707,633749,2022-10-22
CASH_IN,20834,Agence_moov_Abomey,300000,279166,Emmanuel Grégoire,633749,654583,2022-10-23
CASH_OUT,434039,Emmanuel Grégoire,654583,220544,Agence_moov_Abomey,300000,-134039,2022-10-24
TRANSFER,108847,Emmanuel Grégoire,220544,111697,Thérèse François,715300,606453,2022-10-26
CASH_IN,32855,Agence_moov_Abomey,300000,267145,Emmanuel Grégoire,111697,144552,2022-10-27
CASH_OUT,113667,Théodore Joseph-Lefebvre,208963,95296,Agence_moov_Cotonou,300000,186333,2022-10-02
CASH_IN,96550,Agence_moov_Cotonou,300000,203450,Théodore Joseph-Lefebvre,95296,191846,2022-10-03
TRANSFER,50886,Théodore Joseph-Lefebvre,191846,140960,Vincent de la Dumont,887664,836778,2022-10-06
CASH_IN,10954,Agence_moov_Abomey,300000,289046,Théodore Joseph-Lefebvre,140960,151914,2022-10-09
CASH_OUT,74083,Théodore Joseph-Lefebvre,151914,77831,Agence_moov_Ouidah,300000,225917,2022-10-10
CASH_OUT,53688,Théodore Joseph-Lefebvre,77831,24143,Agence_moov_Cotonou,300000,246312,2022-10-11
CASH_OUT,5082,Théodore Joseph-Lefebvre,24143,19061,Agence_moov_Ouidah,300000,294918,2022-10-13
TRANSFER,9768,Théodore Joseph-Lefebvre,19061,9293,Manon Lebon,98787,89019,2022-10-16
TRANSFER,95867,Benoît Guyot,114517,18650,Théodore Joseph-Lefebvre,9293,105160,2022-10-16
CASH_OUT,99615,Théodore Joseph-Lefebvre,105160,5545,Agence_moov_Cotonou,300000,200385,2022-10-18
TRANSFER,109304,Thomas Dupont,614256,504952,Théodore Joseph-Lefebvre,5545,114849,2022-10-18
CASH_IN,60983,Agence_moov_Cotonou,300000,239017,Théodore Joseph-Lefebvre,114849,175832,2022-10-19
TRANSFER,123702,Théodore Joseph-Lefebvre,175832,52130,Jules-Roland Bousquet,225921,102219,2022-10-20
CASH_IN,130024,Agence_moov_Ouidah,300000,169976,Théodore Joseph-Lefebvre,52130,182154,2022-10-20
CASH_IN,135079,Agence_moov_Cotonou,300000,164921,Théodore Joseph-Lefebvre,182154,317233,2022-10-21
CASH_IN,193274,Agence_moov_Abomey,300000,106726,Théodore Joseph-Lefebvre,317233,510507,2022-10-21
TRANSFER,1668758,Audrey Julien de Leleu,1717018,48260,Théodore Joseph-Lefebvre,510507,2179265,2022-10-22
TRANSFER,449739,Théodore Joseph-Lefebvre,2179265,1729526,Audrey Julien de Leleu,48260,-401479,2022-10-23
TRANSFER,16397,Astrid Lecoq,374565,358168,Théodore Joseph-Lefebvre,1729526,1745923,2022-10-24
CASH_OUT,239643,Théodore Joseph-Lefebvre,1745923,1506280,Agence_moov_Ouidah,300000,60357,2022-10-26
CASH_IN,16619,Agence_moov_Abomey,300000,283381,Théodore Joseph-Lefebvre,1506280,1522899,2022-10-26
TRANSFER,66284,Robert Laroche,86522,20238,Benoît Guyot,18650,-47634,2022-10-02
CASH_IN,247672,Agence_moov_Abomey,300000,52328,Robert Laroche,20238,267910,2022-10-02
CASH_IN,159601,Agence_moov_Abomey,300000,140399,Robert Laroche,267910,427511,2022-10-03
CASH_IN,149140,Agence_moov_Cotonou,300000,150860,Robert Laroche,427511,576651,2022-10-03
CASH_OUT,561390,Robert Laroche,576651,15261,Agence_moov_Ouidah,300000,-261390,2022-10-04
TRANSFER,233587,Manon Chevalier,749861,516274,Robert Laroche,15261,248848,2022-10-05
TRANSFER,84444,Bernadette de Jourdan,122153,37709,Robert Laroche,248848,333292,2022-10-08
TRANSFER,11938,Mathilde de la Samson,38772,26834,Robert Laroche,333292,345230,2022-10-08
TRANSFER,124801,Thomas Dupont,504952,380151,Robert Laroche,345230,470031,2022-10-10
TRANSFER,162998,Robert Laroche,470031,307033,Alphonse Gomes,732572,569574,2022-10-11
CASH_IN,124912,Agence_moov_Abomey,300000,175088,Robert Laroche,307033,431945,2022-10-13
CASH_IN,40977,Agence_moov_Ouidah,300000,259023,Robert Laroche,431945,472922,2022-10-13
CASH_IN,138362,Agence_moov_Cotonou,300000,161638,Robert Laroche,472922,611284,2022-10-14
TRANSFER,174157,Camille Prévost,1514569,1340412,Robert Laroche,611284,785441,2022-10-14
CASH_IN,129412,Agence_moov_Ouidah,300000,170588,Robert Laroche,785441,914853,2022-10-15
CASH_OUT,434612,Robert Laroche,914853,480241,Agence_moov_Cotonou,300000,-134612,2022-10-16
CASH_IN,41916,Agence_moov_Cotonou,300000,258084,Robert Laroche,480241,522157,2022-10-17
CASH_IN,1137,Agence_moov_Ouidah,300000,298863,Robert Laroche,522157,523294,2022-10-18
TRANSFER,263647,Robert Laroche,523294,259647,Thomas Dupont,380151,116504,2022-10-19
CASH_IN,97977,Agence_moov_Cotonou,300000,202023,Robert Laroche,259647,357624,2022-10-20
CASH_IN,78051,Agence_moov_Ouidah,300000,221949,Robert Laroche,357624,435675,2022-10-20
TRANSFER,91147,Christine Texier,187271,96124,Robert Laroche,435675,526822,2022-10-21
CASH_IN,242423,Agence_moov_Cotonou,300000,57577,Robert Laroche,526822,769245,2022-10-21
TRANSFER,231570,Michel Bouchet,267000,35430,Robert Laroche,769245,1000815,2022-10-22
TRANSFER,317885,Robert Laroche,1000815,682930,Alphonse Gomes,569574,251689,2022-10-22
CASH_IN,43879,Agence_moov_Cotonou,300000,256121,Robert Laroche,682930,726809,2022-10-24
TRANSFER,60189,Aimé Pages,316497,256308,Philippe Philippe,1923300,1863111,2022-10-05
CASH_IN,255718,Agence_moov_Cotonou,300000,44282,Aimé Pages,256308,512026,2022-10-08
CASH_IN,20420,Agence_moov_Cotonou,300000,279580,Aimé Pages,512026,532446,2022-10-08
CASH_IN,195740,Agence_moov_Cotonou,300000,104260,Aimé Pages,532446,728186,2022-10-08
CASH_OUT,101158,Aimé Pages,728186,627028,Agence_moov_Cotonou,300000,198842,2022-10-08
CASH_OUT,624386,Aimé Pages,627028,2642,Agence_moov_Cotonou,300000,-324386,2022-10-10
TRANSFER,2314,Aimé Pages,2642,328,Anastasie Richard-Neveu,104918,102604,2022-10-12
CASH_OUT,126,Aimé Pages,328,202,Agence_moov_Abomey,300000,299874,2022-10-13
TRANSFER,95083,Jules-Roland Bousquet,102219,7136,Aimé Pages,202,95285,2022-10-14
CASH_IN,108691,Agence_moov_Abomey,300000,191309,Aimé Pages,95285,203976,2022-10-16
CASH_OUT,113454,Aimé Pages,203976,90522,Agence_moov_Abomey,300000,186546,2022-10-16
CASH_IN,37162,Agence_moov_Ouidah,300000,262838,Aimé Pages,90522,127684,2022-10-17
TRANSFER,118992,Aimé Pages,127684,8692,Bernadette de Jourdan,37709,-81283,2022-10-18
CASH_OUT,6616,Aimé Pages,8692,2076,Agence_moov_Ouidah,300000,293384,2022-10-19
CASH_IN,128296,Agence_moov_Cotonou,300000,171704,Aimé Pages,2076,130372,2022-10-22
CASH_IN,93320,Agence_moov_Cotonou,300000,206680,Aimé Pages,130372,223692,2022-10-23
TRANSFER,695112,Timothée-René Blanchard,785170,90058,Aimé Pages,223692,918804,2022-10-23
TRANSFER,590448,Aimé Pages,918804,328356,Alphonse Joly,1954500,1364052,2022-10-24
CASH_IN,131368,Agence_moov_Ouidah,300000,168632,Aimé Pages,328356,459724,2022-10-25
CASH_OUT,284499,Aimé Pages,459724,175225,Agence_moov_Cotonou,300000,15501,2022-10-26
TRANSFER,9625,Constance Bourdon-Millet,329332,319707,Aimé Pages,175225,184850,2022-10-27
TRANSFER,36258,Constance Bourdon-Millet,319707,283449,Agnès Le Giraud,938237,974495,2022-10-02
CASH_OUT,161916,Agnès Le Giraud,974495,812579,Agence_moov_Ouidah,300000,138084,2022-10-03
TRANSFER,6403,Thérèse François,606453,600050,Agnès Le Giraud,812579,818982,2022-10-03
CASH_IN,237010,Agence_moov_Ouidah,300000,62990,Agnès Le Giraud,818982,1055992,2022-10-05
TRANSFER,469681,Thérèse Hubert,640858,171177,Agnès Le Giraud,1055992,1525673,2022-10-05
TRANSFER,112624,Antoinette de Dupuis,1643708,1531084,Agnès Le Giraud,1525673,1638297,2022-10-06
CASH_IN,261357,Agence_moov_Ouidah,300000,38643,Agnès Le Giraud,1638297,1899654,2022-10-07
TRANSFER,29899,Michel Bouchet,35430,5531,Agnès Le Giraud,1899654,1929553,2022-10-07
TRANSFER,1831619,Agnès Le Giraud,1929553,97934,Anastasie Cousin,452231,-1379388,2022-10-07
CASH_OUT,43370,Agnès Le Giraud,97934,54564,Agence_moov_Abomey,300000,256630,2022-10-08
CASH_OUT,25459,Agnès Le Giraud,54564,29105,Agence_moov_Ouidah,300000,274541,2022-10-08
CASH_IN,292939,Agence_moov_Cotonou,300000,7061,Agnès Le Giraud,29105,322044,2022-10-10
CASH_OUT,296463,Agnès Le Giraud,322044,25581,Agence_moov_Cotonou,300000,3537,2022-10-13
CASH_OUT,1145,Agnès Le Giraud,25581,24436,Agence_moov_Ouidah,300000,298855,2022-10-13
CASH_OUT,9075,Agnès Le Giraud,24436,15361,Agence_moov_Ouidah,300000,290925,2022-10-14
CASH_IN,256131,Agence_moov_Ouidah,300000,43869,Agnès Le Giraud,15361,271492,2022-10-15
CASH_OUT,133587,Agnès Le Giraud,271492,137905,Agence_moov_Abomey,300000,166413,2022-10-15
CASH_OUT,121093,Agnès Le Giraud,137905,16812,Agence_moov_Cotonou,300000,178907,2022-10-15
CASH_IN,249961,Agence_moov_Cotonou,300000,50039,Agnès Le Giraud,16812,266773,2022-10-16
TRANSFER,225918,Agnès Le Giraud,266773,40855,Astrid Lecoq,358168,132250,2022-10-16
CASH_OUT,27682,Agnès Le Giraud,40855,13173,Agence_moov_Cotonou,300000,272318,2022-10-17
TRANSFER,169512,Thérèse Hubert,171177,1665,Agnès Le Giraud,13173,182685,2022-10-18
CASH_IN,195127,Agence_moov_Ouidah,300000,104873,Agnès Le Giraud,182685,377812,2022-10-19
TRANSFER,695981,Alphonse Joly,1364052,668071,Agnès Le Giraud,377812,1073793,2022-10-19
TRANSFER,185122,Agnès Le Giraud,1073793,888671,Véronique Martins de Fleury,175467,-9655,2022-10-25
CASH_OUT,352702,Agnès Le Giraud,888671,535969,Agence_moov_Abomey,300000,-52702,2022-10-26
TRANSFER,59735,Manon Lebon,89019,29284,Agnès Le Giraud,535969,595704,2022-10-26
CASH_IN,153883,Agence_moov_Abomey,300000,146117,Agnès Le Giraud,595704,749587,2022-10-27
CASH_IN,222612,Agence_moov_Abomey,300000,77388,Bertrand Regnier,445654,668266,2022-10-01
CASH_IN,135621,Agence_moov_Cotonou,300000,164379,Bertrand Regnier,668266,803887,2022-10-01
CASH_OUT,102864,Bertrand Regnier,803887,701023,Agence_moov_Cotonou,300000,197136,2022-10-03
CASH_IN,217605,Agence_moov_Ouidah,300000,82395,Bertrand Regnier,701023,918628,2022-10-03
CASH_IN,73167,Agence_moov_Ouidah,300000,226833,Bertrand Regnier,918628,991795,2022-10-03
CASH_OUT,766082,Bertrand Regnier,991795,225713,Agence_moov_Abomey,300000,-466082,2022-10-04
CASH_IN,44213,Agence_moov_Ouidah,300000,255787,Bertrand Regnier,225713,269926,2022-10-05
CASH_OUT,76015,Bertrand Regnier,269926,193911,Agence_moov_Cotonou,300000,223985,2022-10-05
CASH_OUT,57621,Bertrand Regnier,193911,136290,Agence_moov_Ouidah,300000,242379,2022-10-05
TRANSFER,116301,Lucie Aubert,359233,242932,Bertrand Regnier,136290,252591,2022-10-06
CASH_IN,152124,Agence_moov_Ouidah,300000,147876,Bertrand Regnier,252591,404715,2022-10-06
TRANSFER,267457,Bertrand Regnier,404715,137258,Astrid Lecoq,132250,-135207,2022-10-07
TRANSFER,2569,Michel Bouchet,5531,2962,Bertrand Regnier,137258,139827,2022-10-07
TRANSFER,96940,Bertrand Regnier,139827,42887,Thérèse François,600050,503110,2022-10-08
CASH_IN,165488,Agence_moov_Cotonou,300000,134512,Bertrand Regnier,42887,208375,2022-10-09
TRANSFER,300525,Alphonse Joly,668071,367546,Bertrand Regnier,208375,508900,2022-10-10
TRANSFER,310351,Alphonse Joly,367546,57195,Bertrand Regnier,508900,819251,2022-10-12
TRANSFER,516150,Bertrand Regnier,819251,303101,Françoise Morin,386797,-129353,2022-10-13
TRANSFER,846023,Matthieu-Matthieu Bigot,1222849,376826,Bertrand Regnier,303101,1149124,2022-10-17
CASH_OUT,83008,Bertrand Regnier,1149124,1066116,Agence_moov_Abomey,300000,216992,2022-10-19
CASH_IN,34685,Agence_moov_Ouidah,300000,265315,Bertrand Regnier,1066116,1100801,2022-10-19
TRANSFER,783512,Bertrand Regnier,1100801,317289,Thibaut de la Roy,43561,-739951,2022-10-19
CASH_OUT,103320,Bertrand Regnier,317289,213969,Agence_moov_Abomey,300000,196680,2022-10-20
CASH_IN,135505,Agence_moov_Ouidah,300000,164495,Bertrand Regnier,213969,349474,2022-10-21
TRANSFER,17057,Manon Lebon,29284,12227,Bertrand Regnier,349474,366531,2022-10-25
TRANSFER,1425652,Philippe Philippe,1863111,437459,Bertrand Regnier,366531,1792183,2022-10-26
TRANSFER,1376091,Bertrand Regnier,1792183,416092,Alphonse Gomes,251689,-1124402,2022-10-27
CASH_OUT,151412,Lucie Aubert,242932,91520,Agence_moov_Ouidah,300000,148588,2022-10-03
CASH_OUT,14337,Lucie Aubert,91520,77183,Agence_moov_Abomey,300000,285663,2022-10-06
CASH_IN,228913,Agence_moov_Ouidah,300000,71087,Lucie Aubert,77183,306096,2022-10-07
CASH_IN,80371,Agence_moov_Ouidah,300000,219629,Lucie Aubert,306096,386467,2022-10-08
CASH_OUT,266322,Lucie Aubert,386467,120145,Agence_moov_Ouidah,300000,33678,2022-10-08
CASH_OUT,120001,Lucie Aubert,120145,144,Agence_moov_Abomey,300000,179999,2022-10-09
TRANSFER,117,Lucie Aubert,144,27,Constance Bourdon-Millet,283449,283332,2022-10-12
CASH_IN,151427,Agence_moov_Cotonou,300000,148573,Lucie Aubert,27,151454,2022-10-12
CASH_OUT,100150,Lucie Aubert,151454,51304,Agence_moov_Abomey,300000,199850,2022-10-12
CASH_OUT,3098,Lucie Aubert,51304,48206,Agence_moov_Abomey,300000,296902,2022-10-12
CASH_IN,230523,Agence_moov_Abomey,300000,69477,Lucie Aubert,48206,278729,2022-10-13
CASH_OUT,153283,Lucie Aubert,278729,125446,Agence_moov_Cotonou,300000,146717,2022-10-13
TRANSFER,114517,Lucie Aubert,125446,10929,Thérèse François,503110,388593,2022-10-14
TRANSFER,5267,Lucie Aubert,10929,5662,Tristan Delahaye,807509,802242,2022-10-14
CASH_OUT,1877,Lucie Aubert,5662,3785,Agence_moov_Abomey,300000,298123,2022-10-16
TRANSFER,446,Lucie Aubert,3785,3339,Thérèse François,388593,388147,2022-10-16
CASH_OUT,1119,Lucie Aubert,3339,2220,Agence_moov_Cotonou,300000,298881,2022-10-18
CASH_IN,134628,Agence_moov_Abomey,300000,165372,Lucie Aubert,2220,136848,2022-10-18
CASH_OUT,11758,Lucie Aubert,136848,125090,Agence_moov_Abomey,300000,288242,2022-10-18
CASH_OUT,71916,Lucie Aubert,125090,53174,Agence_moov_Abomey,300000,228084,2022-10-20
CASH_OUT,21827,Lucie Aubert,53174,31347,Agence_moov_Ouidah,300000,278173,2022-10-20
CASH_IN,263906,Agence_moov_Ouidah,300000,36094,Lucie Aubert,31347,295253,2022-10-20
CASH_OUT,259338,Lucie Aubert,295253,35915,Agence_moov_Ouidah,300000,40662,2022-10-22
TRANSFER,13343,Lucie Aubert,35915,22572,Mathilde Picard du Delmas,260773,247430,2022-10-22
CASH_IN,41889,Agence_moov_Abomey,300000,258111,Lucie Aubert,22572,64461,2022-10-24
CASH_OUT,57824,Lucie Aubert,64461,6637,Agence_moov_Abomey,300000,242176,2022-10-25
CASH_IN,186656,Agence_moov_Ouidah,300000,113344,Lucie Aubert,6637,193293,2022-10-25
TRANSFER,26199,Alphonse Joly,57195,30996,Lucie Aubert,193293,219492,2022-10-25
CASH_OUT,31510,Lucie Aubert,219492,187982,Agence_moov_Cotonou,300000,268490,2022-10-27
CASH_IN,252724,Agence_moov_Ouidah,300000,47276,Audrey Julien de Leleu,-401479,-148755,2022-10-01
CASH_IN,293090,Agence_moov_Cotonou,300000,6910,Audrey Julien de Leleu,-148755,144335,2022-10-01
TRANSFER,90300,Audrey Julien de Leleu,144335,54035,Christine Texier,96124,5824,2022-10-03
TRANSFER,45666,Renée Rousseau-Henry,61462,15796,Audrey Julien de Leleu,54035,99701,2022-10-03
TRANSFER,76920,Audrey Julien de Leleu,99701,22781,Christine Texier,5824,-71096,2022-10-03
CASH_OUT,10773,Audrey Julien de Leleu,22781,12008,Agence_moov_Abomey,300000,289227,2022-10-04
CASH_OUT,3467,Audrey Julien de Leleu,12008,8541,Agence_moov_Abomey,300000,296533,2022-10-05
TRANSFER,255397,Hélène Le Chauvin,368704,113307,Audrey Julien de Leleu,8541,263938,2022-10-05
CASH_OUT,191092,Audrey Julien de Leleu,263938,72846,Agence_moov_Cotonou,300000,108908,2022-10-06
CASH_IN,5149,Agence_moov_Abomey,300000,294851,Audrey Julien de Leleu,72846,77995,2022-10-06
CASH_OUT,59489,Audrey Julien de Leleu,77995,18506,Agence_moov_Abomey,300000,240511,2022-10-08
CASH_OUT,10416,Audrey Julien de Leleu,18506,8090,Agence_moov_Abomey,300000,289584,2022-10-09
CASH_IN,119847,Agence_moov_Ouidah,300000,180153,Audrey Julien de Leleu,8090,127937,2022-10-13
CASH_OUT,47950,Audrey Julien de Leleu,127937,79987,Agence_moov_Abomey,300000,252050,2022-10-13
CASH_OUT,3886,Audrey Julien de Leleu,79987,76101,Agence_moov_Ouidah,300000,296114,2022-10-17
TRANSFER,157,Thérèse Hubert,1665,1508,Audrey Julien de Leleu,76101,76258,2022-10-18
CASH_IN,224690,Agence_moov_Cotonou,300000,75310,Audrey Julien de Leleu,76258,300948,2022-10-18
CASH_OUT,240170,Audrey Julien de Leleu,300948,60778,Agence_moov_Abomey,300000,59830,2022-10-18
CASH_OUT,18493,Audrey Julien de Leleu,60778,42285,Agence_moov_Ouidah,300000,281507,2022-10-18
CASH_OUT,37714,Audrey Julien de Leleu,42285,4571,Agence_moov_Cotonou,300000,262286,2022-10-20
CASH_IN,135239,Agence_moov_Abomey,300000,164761,Audrey Julien de Leleu,4571,139810,2022-10-21
TRANSFER,1229391,Antoinette de Dupuis,1531084,301693,Audrey Julien de Leleu,139810,1369201,2022-10-22
CASH_OUT,413129,Audrey Julien de Leleu,1369201,956072,Agence_moov_Abomey,300000,-113129,2022-10-22
CASH_IN,128991,Agence_moov_Ouidah,300000,171009,Audrey Julien de Leleu,956072,1085063,2022-10-22
CASH_IN,12493,Agence_moov_Abomey,300000,287507,Audrey Julien de Leleu,1085063,1097556,2022-10-23
CASH_OUT,610493,Audrey Julien de Leleu,1097556,487063,Agence_moov_Ouidah,300000,-310493,2022-10-23
CASH_IN,60861,Agence_moov_Abomey,300000,239139,Audrey Julien de Leleu,487063,547924,2022-10-25
CASH_IN,48308,Agence_moov_Abomey,300000,251692,Bernadette de Jourdan,-81283,-32975,2022-10-02
CASH_IN,203178,Agence_moov_Cotonou,300000,96822,Bernadette de Jourdan,-32975,170203,2022-10-03
CASH_IN,77761,Agence_moov_Abomey,300000,222239,Bernadette de Jourdan,170203,247964,2022-10-03
CASH_OUT,10516,Bernadette de Jourdan,247964,237448,Agence_moov_Abomey,300000,289484,2022-10-04
CASH_IN,108327,Agence_moov_Abomey,300000,191673,Bernadette de Jourdan,237448,345775,2022-10-11
CASH_OUT,3964,Bernadette de Jourdan,345775,341811,Agence_moov_Cotonou,300000,296036,2022-10-14
CASH_OUT,297616,Bernadette de Jourdan,341811,44195,Agence_moov_Abomey,300000,2384,2022-10-15
CASH_OUT,34933,Bernadette de Jourdan,44195,9262,Agence_moov_Abomey,300000,265067,2022-10-24
CASH_IN,138776,Agence_moov_Abomey,300000,161224,Alphonse Joly,30996,169772,2022-10-03
CASH_IN,279326,Agence_moov_Abomey,300000,20674,Alphonse Joly,169772,449098,2022-10-08
CASH_OUT,128026,Alphonse Joly,449098,321072,Agence_moov_Cotonou,300000,171974,2022-10-13
TRANSFER,289315,Alphonse Joly,321072,31757,Jules-Roland Bousquet,7136,-282179,2022-10-13
TRANSFER,86901,Adèle Da Silva-Klein,87130,229,Alphonse Joly,31757,118658,2022-10-13
CASH_OUT,41978,Alphonse Joly,118658,76680,Agence_moov_Cotonou,300000,258022,2022-10-18
CASH_IN,206132,Agence_moov_Cotonou,300000,93868,Alphonse Joly,76680,282812,2022-10-20
CASH_IN,55616,Agence_moov_Abomey,300000,244384,Alphonse Joly,282812,338428,2022-10-21
CASH_OUT,212103,Alphonse Joly,338428,126325,Agence_moov_Abomey,300000,87897,2022-10-24
CASH_OUT,21505,Alphonse Joly,126325,104820,Agence_moov_Abomey,300000,278495,2022-10-27
TRANSFER,13173,Renée Rousseau-Henry,15796,2623,Thomas Dupont,116504,103331,2022-10-01
CASH_OUT,733,Renée Rousseau-Henry,2623,1890,Agence_moov_Abomey,300000,299267,2022-10-02
TRANSFER,105709,Thérèse François,388147,282438,Renée Rousseau-Henry,1890,107599,2022-10-04
CASH_OUT,32075,Renée Rousseau-Henry,107599,75524,Agence_moov_Abomey,300000,267925,2022-10-07
TRANSFER,345209,Aurore Charrier,918502,573293,Renée Rousseau-Henry,75524,420733,2022-10-08
CASH_OUT,11954,Renée Rousseau-Henry,420733,408779,Agence_moov_Ouidah,300000,288046,2022-10-23
CASH_IN,210581,Agence_moov_Ouidah,300000,89419,Michelle-Dorothée Lévêque,-420079,-209498,2022-10-04
CASH_IN,6644,Agence_moov_Abomey,300000,293356,Michelle-Dorothée Lévêque,-209498,-202854,2022-10-06
CASH_IN,194144,Agence_moov_Ouidah,300000,105856,Michelle-Dorothée Lévêque,-202854,-8710,2022-10-06
CASH_IN,2269,Agence_moov_Cotonou,300000,297731,Michelle-Dorothée Lévêque,-8710,-6441,2022-10-11
CASH_IN,259356,Agence_moov_Ouidah,300000,40644,Michelle-Dorothée Lévêque,-6441,252915,2022-10-12
CASH_IN,165991,Agence_moov_Cotonou,300000,134009,Michelle-Dorothée Lévêque,252915,418906,2022-10-12
CASH_IN,61638,Agence_moov_Cotonou,300000,238362,Michelle-Dorothée Lévêque,418906,480544,2022-10-16
CASH_OUT,66136,Michelle-Dorothée Lévêque,480544,414408,Agence_moov_Cotonou,300000,233864,2022-10-16
CASH_IN,192142,Agence_moov_Abomey,300000,107858,Michelle-Dorothée Lévêque,414408,606550,2022-10-17
CASH_OUT,362,Michelle-Dorothée Lévêque,606550,606188,Agence_moov_Abomey,300000,299638,2022-10-17
CASH_OUT,42190,Michelle-Dorothée Lévêque,606188,563998,Agence_moov_Ouidah,300000,257810,2022-10-17
TRANSFER,880,Thérèse Hubert,1508,628,Michelle-Dorothée Lévêque,563998,564878,2022-10-19
CASH_OUT,354177,Michelle-Dorothée Lévêque,564878,210701,Agence_moov_Ouidah,300000,-54177,2022-10-19
CASH_IN,245351,Agence_moov_Cotonou,300000,54649,Michelle-Dorothée Lévêque,210701,456052,2022-10-22
CASH_OUT,253026,Michelle-Dorothée Lévêque,456052,203026,Agence_moov_Cotonou,300000,46974,2022-10-25
CASH_OUT,149571,Michelle-Dorothée Lévêque,203026,53455,Agence_moov_Ouidah,300000,150429,2022-10-26
TRANSFER,476435,Vincent de la Dumont,836778,360343,Michelle-Dorothée Lévêque,53455,529890,2022-10-27
CASH_IN,93092,Agence_moov_Ouidah,300000,206908,Michelle-Dorothée Lévêque,529890,622982,2022-10-27
CASH_IN,9454,Agence_moov_Cotonou,300000,290546,Constance Bourdon-Millet,283332,292786,2022-10-04
CASH_IN,285279,Agence_moov_Ouidah,300000,14721,Constance Bourdon-Millet,292786,578065,2022-10-04
CASH_IN,197050,Agence_moov_Cotonou,300000,102950,Constance Bourdon-Millet,578065,775115,2022-10-04
CASH_IN,189751,Agence_moov_Cotonou,300000,110249,Constance Bourdon-Millet,775115,964866,2022-10-09
TRANSFER,812116,Constance Bourdon-Millet,964866,152750,Hélène Le Chauvin,113307,-698809,2022-10-12
CASH_IN,227182,Agence_moov_Ouidah,300000,72818,Constance Bourdon-Millet,152750,379932,2022-10-14
TRANSFER,97775,Constance Bourdon-Millet,379932,282157,Thérèse Hubert,628,-97147,2022-10-14
TRANSFER,171683,Manon Chevalier,516274,344591,Constance Bourdon-Millet,282157,453840,2022-10-17
CASH_IN,230073,Agence_moov_Cotonou,300000,69927,Constance Bourdon-Millet,453840,683913,2022-10-17
TRANSFER,15363,Vincent de la Dumont,360343,344980,Constance Bourdon-Millet,683913,699276,2022-10-23
CASH_IN,264622,Agence_moov_Cotonou,300000,35378,Constance Bourdon-Millet,699276,963898,2022-10-26
CASH_IN,4062,Agence_moov_Abomey,300000,295938,Véronique Martins de Fleury,-9655,-5593,2022-10-07
CASH_IN,192342,Agence_moov_Cotonou,300000,107658,Véronique Martins de Fleury,-5593,186749,2022-10-11
CASH_OUT,182340,Véronique Martins de Fleury,186749,4409,Agence_moov_Ouidah,300000,117660,2022-10-12
CASH_IN,137965,Agence_moov_Ouidah,300000,162035,Véronique Martins de Fleury,4409,142374,2022-10-12
CASH_IN,65107,Agence_moov_Abomey,300000,234893,Véronique Martins de Fleury,142374,207481,2022-10-15
CASH_OUT,49824,Véronique Martins de Fleury,207481,157657,Agence_moov_Ouidah,300000,250176,2022-10-15
CASH_OUT,153559,Véronique Martins de Fleury,157657,4098,Agence_moov_Abomey,300000,146441,2022-10-16
CASH_IN,273235,Agence_moov_Cotonou,300000,26765,Véronique Martins de Fleury,4098,277333,2022-10-21
CASH_IN,82439,Agence_moov_Cotonou,300000,217561,Véronique Martins de Fleury,277333,359772,2022-10-22
CASH_IN,276098,Agence_moov_Abomey,300000,23902,Véronique Martins de Fleury,359772,635870,2022-10-25
CASH_IN,80955,Agence_moov_Ouidah,300000,219045,Véronique Martins de Fleury,635870,716825,2022-10-26
CASH_OUT,627866,Véronique Martins de Fleury,716825,88959,Agence_moov_Cotonou,300000,-327866,2022-10-26
CASH_IN,127557,Agence_moov_Abomey,300000,172443,Matthieu-Matthieu Bigot,376826,504383,2022-10-01
CASH_OUT,219054,Matthieu-Matthieu Bigot,504383,285329,Agence_moov_Abomey,300000,80946,2022-10-02
TRANSFER,194737,Matthieu-Matthieu Bigot,285329,90592,Colette-Sophie Prévost,697638,502901,2022-10-04
TRANSFER,11000,Matthieu-Matthieu Bigot,90592,79592,Aurore Charrier,573293,562293,2022-10-07
CASH_IN,190705,Agence_moov_Abomey,300000,109295,Matthieu-Matthieu Bigot,79592,270297,2022-10-08
TRANSFER,487024,Aurore Charrier,562293,75269,Matthieu-Matthieu Bigot,270297,757321,2022-10-14
TRANSFER,5012,Timothée-René Blanchard,90058,85046,Matthieu-Matthieu Bigot,757321,762333,2022-10-19
CASH_OUT,437668,Matthieu-Matthieu Bigot,762333,324665,Agence_moov_Cotonou,300000,-137668,2022-10-22
TRANSFER,13062,Timothée-René Blanchard,85046,71984,Matthieu-Matthieu Bigot,324665,337727,2022-10-22
CASH_IN,28186,Agence_moov_Abomey,300000,271814,Matthieu-Matthieu Bigot,337727,365913,2022-10-25
CASH_IN,242275,Agence_moov_Ouidah,300000,57725,Matthieu-Matthieu Bigot,365913,608188,2022-10-27
CASH_IN,86419,Agence_moov_Abomey,300000,213581,Matthieu-Matthieu Bigot,608188,694607,2022-10-27
TRANSFER,203846,Matthieu-Matthieu Bigot,694607,490761,Rémy Grondin,118042,-85804,2022-10-27
CASH_IN,243936,Agence_moov_Ouidah,300000,56064,Astrid Lecoq,-135207,108729,2022-10-06
CASH_IN,264474,Agence_moov_Cotonou,300000,35526,Astrid Lecoq,108729,373203,2022-10-08
TRANSFER,57583,Astrid Lecoq,373203,315620,Nicolas Salmon Le Hamon,123213,65630,2022-10-09
CASH_IN,36284,Agence_moov_Abomey,300000,263716,Astrid Lecoq,315620,351904,2022-10-09
CASH_IN,3642,Agence_moov_Abomey,300000,296358,Astrid Lecoq,351904,355546,2022-10-10
CASH_OUT,52124,Astrid Lecoq,355546,303422,Agence_moov_Cotonou,300000,247876,2022-10-20
CASH_IN,76059,Agence_moov_Abomey,300000,223941,Astrid Lecoq,303422,379481,2022-10-22
CASH_IN,283378,Agence_moov_Ouidah,300000,16622,Astrid Lecoq,379481,662859,2022-10-24
TRANSFER,19869,Mathilde de la Samson,26834,6965,Tristan Delahaye,802242,782373,2022-10-03
CASH_IN,184655,Agence_moov_Ouidah,300000,115345,Mathilde de la Samson,6965,191620,2022-10-03
CASH_OUT,28609,Mathilde de la Samson,191620,163011,Agence_moov_Ouidah,300000,271391,2022-10-04
CASH_OUT,11063,Mathilde de la Samson,163011,151948,Agence_moov_Ouidah,300000,288937,2022-10-05
CASH_IN,137829,Agence_moov_Abomey,300000,162171,Mathilde de la Samson,151948,289777,2022-10-06
CASH_IN,143125,Agence_moov_Abomey,300000,156875,Mathilde de la Samson,289777,432902,2022-10-07
CASH_OUT,310689,Mathilde de la Samson,432902,122213,Agence_moov_Abomey,300000,-10689,2022-10-08
CASH_IN,17805,Agence_moov_Abomey,300000,282195,Mathilde de la Samson,122213,140018,2022-10-10
CASH_IN,52130,Agence_moov_Ouidah,300000,247870,Mathilde de la Samson,140018,192148,2022-10-17
CASH_OUT,87511,Mathilde de la Samson,192148,104637,Agence_moov_Cotonou,300000,212489,2022-10-24
CASH_IN,276710,Agence_moov_Ouidah,300000,23290,Mathilde de la Samson,104637,381347,2022-10-26
CASH_IN,122670,Agence_moov_Abomey,300000,177330,Alphonse Gomes,-1124402,-1001732,2022-10-02
CASH_IN,10057,Agence_moov_Cotonou,300000,289943,Alphonse Gomes,-1001732,-991675,2022-10-05
CASH_IN,7780,Agence_moov_Ouidah,300000,292220,Alphonse Gomes,-991675,-983895,2022-10-09
CASH_IN,179781,Agence_moov_Ouidah,300000,120219,Alphonse Gomes,-983895,-804114,2022-10-10
CASH_IN,290154,Agence_moov_Ouidah,300000,9846,Alphonse Gomes,-804114,-513960,2022-10-10
CASH_IN,179885,Agence_moov_Cotonou,300000,120115,Alphonse Gomes,-513960,-334075,2022-10-11
CASH_IN,83164,Agence_moov_Ouidah,300000,216836,Alphonse Gomes,-334075,-250911,2022-10-12
CASH_IN,255636,Agence_moov_Cotonou,300000,44364,Alphonse Gomes,-250911,4725,2022-10-14
CASH_IN,285710,Agence_moov_Abomey,300000,14290,Alphonse Gomes,4725,290435,2022-10-18
CASH_IN,297359,Agence_moov_Ouidah,300000,2641,Alphonse Gomes,290435,587794,2022-10-18
CASH_OUT,62585,Alphonse Gomes,587794,525209,Agence_moov_Abomey,300000,237415,2022-10-21
TRANSFER,17159,Mathilde Picard du Delmas,247430,230271,Alphonse Gomes,525209,542368,2022-10-26
CASH_IN,86125,Agence_moov_Abomey,300000,213875,Rémy Grondin,-85804,321,2022-10-03
CASH_IN,236785,Agence_moov_Abomey,300000,63215,Rémy Grondin,321,237106,2022-10-03
CASH_IN,185984,Agence_moov_Abomey,300000,114016,Rémy Grondin,237106,423090,2022-10-05
CASH_IN,276300,Agence_moov_Ouidah,300000,23700,Rémy Grondin,423090,699390,2022-10-06
CASH_IN,265171,Agence_moov_Abomey,300000,34829,Rémy Grondin,699390,964561,2022-10-08
CASH_OUT,456532,Rémy Grondin,964561,508029,Agence_moov_Abomey,300000,-156532,2022-10-09
CASH_OUT,385488,Rémy Grondin,508029,122541,Agence_moov_Abomey,300000,-85488,2022-10-12
CASH_IN,37894,Agence_moov_Ouidah,300000,262106,Rémy Grondin,122541,160435,2022-10-15
CASH_OUT,33974,Rémy Grondin,160435,126461,Agence_moov_Ouidah,300000,266026,2022-10-16
CASH_IN,212405,Agence_moov_Cotonou,300000,87595,Rémy Grondin,126461,338866,2022-10-17
TRANSFER,292617,Rémy Grondin,338866,46249,Nicolas Salmon Le Hamon,65630,-226987,2022-10-23
CASH_IN,117447,Agence_moov_Ouidah,300000,182553,Rémy Grondin,46249,163696,2022-10-24
CASH_IN,116046,Agence_moov_Abomey,300000,183954,Rémy Grondin,163696,279742,2022-10-26
CASH_OUT,36029,Rémy Grondin,279742,243713,Agence_moov_Ouidah,300000,263971,2022-10-26
CASH_OUT,184818,Rémy Grondin,243713,58895,Agence_moov_Abomey,300000,115182,2022-10-27
CASH_OUT,30177,Rémy Grondin,58895,28718,Agence_moov_Ouidah,300000,269823,2022-10-27
CASH_IN,56213,Agence_moov_Abomey,300000,243787,Benoît Guyot,-47634,8579,2022-10-01
TRANSFER,2398,Benoît Guyot,8579,6181,André Renault,614701,612303,2022-10-01
CASH_OUT,4418,Benoît Guyot,6181,1763,Agence_moov_Abomey,300000,295582,2022-10-02
TRANSFER,646,Benoît Guyot,1763,1117,Colette-Sophie Prévost,502901,502255,2022-10-06
CASH_IN,133176,Agence_moov_Cotonou,300000,166824,Benoît Guyot,1117,134293,2022-10-07
TRANSFER,104013,Benoît Guyot,134293,30280,Antoinette de Dupuis,301693,197680,2022-10-07
CASH_IN,195174,Agence_moov_Ouidah,300000,104826,Benoît Guyot,30280,225454,2022-10-09
TRANSFER,69688,Timothée-René Blanchard,71984,2296,Benoît Guyot,225454,295142,2022-10-09
CASH_OUT,56833,Benoît Guyot,295142,238309,Agence_moov_Abomey,300000,243167,2022-10-15
TRANSFER,153671,Benoît Guyot,238309,84638,Victor Michel,1450800,1297129,2022-10-16
CASH_IN,20467,Agence_moov_Abomey,300000,279533,Benoît Guyot,84638,105105,2022-10-18
TRANSFER,193267,Mathilde Picard du Delmas,230271,37004,Benoît Guyot,105105,298372,2022-10-18
CASH_OUT,208790,Benoît Guyot,298372,89582,Agence_moov_Cotonou,300000,91210,2022-10-20
CASH_OUT,85633,Benoît Guyot,89582,3949,Agence_moov_Ouidah,300000,214367,2022-10-24
TRANSFER,311934,Victor Michel,1297129,985195,Benoît Guyot,3949,315883,2022-10-25
TRANSFER,69385,Benoît Guyot,315883,246498,Manon Lebon,12227,-57158,2022-10-26
CASH_OUT,94093,Benoît Guyot,246498,152405,Agence_moov_Ouidah,300000,205907,2022-10-26
CASH_OUT,140531,Benoît Guyot,152405,11874,Agence_moov_Abomey,300000,159469,2022-10-27
CASH_OUT,5474,Benoît Guyot,11874,6400,Agence_moov_Cotonou,300000,294526,2022-10-27
TRANSFER,57746,Thomas Dupont,103331,45585,Colette-Sophie Prévost,502255,444509,2022-10-03
CASH_OUT,35501,Thomas Dupont,45585,10084,Agence_moov_Abomey,300000,264499,2022-10-03
CASH_IN,178822,Agence_moov_Ouidah,300000,121178,Thomas Dupont,10084,188906,2022-10-06
CASH_IN,254879,Agence_moov_Ouidah,300000,45121,Thomas Dupont,188906,443785,2022-10-09
TRANSFER,24475,Mathilde Picard du Delmas,37004,12529,Thomas Dupont,443785,468260,2022-10-12
TRANSFER,1455,Timothée-René Blanchard,2296,841,Thomas Dupont,468260,469715,2022-10-13
CASH_OUT,197527,Thomas Dupont,469715,272188,Agence_moov_Ouidah,300000,102473,2022-10-18
CASH_IN,253349,Agence_moov_Cotonou,300000,46651,Thomas Dupont,272188,525537,2022-10-19
TRANSFER,122245,Thomas Dupont,525537,403292,Camille Prévost,1340412,1218167,2022-10-23
CASH_IN,118220,Agence_moov_Ouidah,300000,181780,Thomas Dupont,403292,521512,2022-10-23
CASH_OUT,328445,Thomas Dupont,521512,193067,Agence_moov_Ouidah,300000,-28445,2022-10-23
CASH_IN,217446,Agence_moov_Ouidah,300000,82554,Thomas Dupont,193067,410513,2022-10-24
CASH_IN,156084,Agence_moov_Ouidah,300000,143916,Thomas Dupont,410513,566597,2022-10-27
CASH_IN,177339,Agence_moov_Abomey,300000,122661,Michelle de Étienne,-341371,-164032,2022-10-02
CASH_IN,194488,Agence_moov_Ouidah,300000,105512,Michelle de Étienne,-164032,30456,2022-10-08
TRANSFER,9525,Michelle de Étienne,30456,20931,André Renault,612303,602778,2022-10-12
CASH_IN,47915,Agence_moov_Cotonou,300000,252085,Michelle de Étienne,20931,68846,2022-10-13
TRANSFER,525295,Camille Prévost,1218167,692872,Michelle de Étienne,68846,594141,2022-10-22
CASH_OUT,504269,Michelle de Étienne,594141,89872,Agence_moov_Cotonou,300000,-204269,2022-10-24
CASH_IN,205425,Agence_moov_Abomey,300000,94575,Françoise Morin,-129353,76072,2022-10-01
CASH_IN,92485,Agence_moov_Cotonou,300000,207515,Françoise Morin,76072,168557,2022-10-03
CASH_OUT,78506,Françoise Morin,168557,90051,Agence_moov_Ouidah,300000,221494,2022-10-04
TRANSFER,310614,Philippe Philippe,437459,126845,Françoise Morin,90051,400665,2022-10-05
CASH_IN,121676,Agence_moov_Abomey,300000,178324,Françoise Morin,400665,522341,2022-10-10
TRANSFER,188313,Françoise Morin,522341,334028,André Renault,602778,414465,2022-10-16
TRANSFER,231260,Françoise Morin,334028,102768,Gabriel Bègue,1707870,1476610,2022-10-20
CASH_IN,160967,Agence_moov_Abomey,300000,139033,Françoise Morin,102768,263735,2022-10-26
CASH_OUT,115053,Françoise Morin,263735,148682,Agence_moov_Ouidah,300000,184947,2022-10-27
CASH_IN,104171,Agence_moov_Ouidah,300000,195829,Jules-Roland Bousquet,-282179,-178008,2022-10-01
CASH_IN,132237,Agence_moov_Ouidah,300000,167763,Jules-Roland Bousquet,-178008,-45771,2022-10-06
CASH_IN,23013,Agence_moov_Abomey,300000,276987,Jules-Roland Bousquet,-45771,-22758,2022-10-07
CASH_IN,255174,Agence_moov_Abomey,300000,44826,Jules-Roland Bousquet,-22758,232416,2022-10-08
TRANSFER,65467,Antoinette de Dupuis,197680,132213,Jules-Roland Bousquet,232416,297883,2022-10-08
CASH_IN,217578,Agence_moov_Abomey,300000,82422,Jules-Roland Bousquet,297883,515461,2022-10-11
CASH_IN,73534,Agence_moov_Cotonou,300000,226466,Jules-Roland Bousquet,515461,588995,2022-10-13
TRANSFER,156133,Jules-Roland Bousquet,588995,432862,Gabriel Bègue,1476610,1320477,2022-10-14
CASH_OUT,430178,Jules-Roland Bousquet,432862,2684,Agence_moov_Abomey,300000,-130178,2022-10-14
TRANSFER,265,Jules-Roland Bousquet,2684,2419,Manon Chevalier,344591,344326,2022-10-15
CASH_IN,87891,Agence_moov_Cotonou,300000,212109,Jules-Roland Bousquet,2419,90310,2022-10-15
CASH_OUT,62967,Jules-Roland Bousquet,90310,27343,Agence_moov_Ouidah,300000,237033,2022-10-18
TRANSFER,395190,Colette-Sophie Prévost,444509,49319,Jules-Roland Bousquet,27343,422533,2022-10-19
CASH_IN,189721,Agence_moov_Ouidah,300000,110279,Jules-Roland Bousquet,422533,612254,2022-10-25
TRANSFER,59647,Camille Prévost,692872,633225,Jules-Roland Bousquet,612254,671901,2022-10-26
TRANSFER,20968,Colette-Sophie Prévost,49319,28351,Tristan Delahaye,782373,803341,2022-10-02
CASH_IN,55105,Agence_moov_Cotonou,300000,244895,Tristan Delahaye,803341,858446,2022-10-04
TRANSFER,13423,Thérèse François,282438,269015,Tristan Delahaye,858446,871869,2022-10-04
CASH_OUT,304666,Tristan Delahaye,871869,567203,Agence_moov_Abomey,300000,-4666,2022-10-04
CASH_IN,58674,Agence_moov_Abomey,300000,241326,Tristan Delahaye,567203,625877,2022-10-04
CASH_OUT,41985,Tristan Delahaye,625877,583892,Agence_moov_Ouidah,300000,258015,2022-10-06
TRANSFER,2848,Michel Bouchet,2962,114,Tristan Delahaye,583892,586740,2022-10-09
CASH_OUT,266273,Tristan Delahaye,586740,320467,Agence_moov_Ouidah,300000,33727,2022-10-09
CASH_IN,226787,Agence_moov_Ouidah,300000,73213,Tristan Delahaye,320467,547254,2022-10-15
CASH_IN,221263,Agence_moov_Ouidah,300000,78737,Tristan Delahaye,547254,768517,2022-10-17
CASH_IN,21820,Agence_moov_Abomey,300000,278180,Tristan Delahaye,768517,790337,2022-10-18
TRANSFER,661036,Tristan Delahaye,790337,129301,Timothée-René Blanchard,841,-660195,2022-10-22
CASH_OUT,26960,Tristan Delahaye,129301,102341,Agence_moov_Cotonou,300000,273040,2022-10-23
CASH_OUT,22507,Tristan Delahaye,102341,79834,Agence_moov_Ouidah,300000,277493,2022-10-26
CASH_IN,79404,Agence_moov_Ouidah,300000,220596,Tristan Delahaye,79834,159238,2022-10-26
CASH_IN,149110,Agence_moov_Cotonou,300000,150890,Thibaut de la Roy,-739951,-590841,2022-10-03
CASH_IN,118,Agence_moov_Ouidah,300000,299882,Thibaut de la Roy,-590841,-590723,2022-10-07
CASH_IN,127828,Agence_moov_Ouidah,300000,172172,Thibaut de la Roy,-590723,-462895,2022-10-09
CASH_IN,267695,Agence_moov_Cotonou,300000,32305,Thibaut de la Roy,-462895,-195200,2022-10-09
CASH_IN,140517,Agence_moov_Cotonou,300000,159483,Thibaut de la Roy,-195200,-54683,2022-10-20
CASH_IN,149065,Agence_moov_Ouidah,300000,150935,Thibaut de la Roy,-54683,94382,2022-10-24
TRANSFER,27792,Colette-Sophie Prévost,28351,559,Victor Michel,985195,1012987,2022-10-03
CASH_OUT,20035,Victor Michel,1012987,992952,Agence_moov_Abomey,300000,279965,2022-10-04
CASH_IN,25473,Agence_moov_Abomey,300000,274527,Victor Michel,992952,1018425,2022-10-04
CASH_IN,85203,Agence_moov_Cotonou,300000,214797,Victor Michel,1018425,1103628,2022-10-05
TRANSFER,168425,Victor Michel,1103628,935203,Michelle Samson,37880,-130545,2022-10-05
CASH_OUT,488063,Victor Michel,935203,447140,Agence_moov_Ouidah,300000,-188063,2022-10-06
CASH_OUT,310006,Victor Michel,447140,137134,Agence_moov_Ouidah,300000,-10006,2022-10-06
TRANSFER,62726,Thérèse François,269015,206289,Victor Michel,137134,199860,2022-10-12
CASH_IN,198571,Agence_moov_Ouidah,300000,101429,Victor Michel,199860,398431,2022-10-12
CASH_IN,84468,Agence_moov_Cotonou,300000,215532,Victor Michel,398431,482899,2022-10-13
TRANSFER,261997,Manon Chevalier,344326,82329,Victor Michel,482899,744896,2022-10-14
CASH_IN,239045,Agence_moov_Abomey,300000,60955,Victor Michel,744896,983941,2022-10-16
CASH_OUT,207203,Victor Michel,983941,776738,Agence_moov_Abomey,300000,92797,2022-10-19
CASH_OUT,605976,Victor Michel,776738,170762,Agence_moov_Cotonou,300000,-305976,2022-10-22
CASH_OUT,142698,Victor Michel,170762,28064,Agence_moov_Ouidah,300000,157302,2022-10-24
CASH_OUT,8601,Victor Michel,28064,19463,Agence_moov_Abomey,300000,291399,2022-10-25
CASH_IN,105558,Agence_moov_Ouidah,300000,194442,Victor Michel,19463,125021,2022-10-25
CASH_OUT,22588,Victor Michel,125021,102433,Agence_moov_Abomey,300000,277412,2022-10-26
CASH_OUT,47768,Victor Michel,102433,54665,Agence_moov_Abomey,300000,252232,2022-10-26
CASH_IN,96873,Agence_moov_Cotonou,300000,203127,Robert Clerc,-65368,31505,2022-10-01
TRANSFER,36147,Philippe Philippe,126845,90698,Robert Clerc,31505,67652,2022-10-03
CASH_OUT,43648,Robert Clerc,67652,24004,Agence_moov_Ouidah,300000,256352,2022-10-05
CASH_OUT,4974,Robert Clerc,24004,19030,Agence_moov_Ouidah,300000,295026,2022-10-12
CASH_IN,83440,Agence_moov_Ouidah,300000,216560,Robert Clerc,19030,102470,2022-10-14
CASH_IN,243684,Agence_moov_Ouidah,300000,56316,Robert Clerc,102470,346154,2022-10-16
TRANSFER,210151,Robert Clerc,346154,136003,Michel Bouchet,114,-210037,2022-10-17
TRANSFER,9306,Mathilde Picard du Delmas,12529,3223,Robert Clerc,136003,145309,2022-10-23
CASH_OUT,142893,Robert Clerc,145309,2416,Agence_moov_Ouidah,300000,157107,2022-10-23
CASH_IN,12322,Agence_moov_Ouidah,300000,287678,Paulette Loiseau,-994217,-981895,2022-10-01
CASH_IN,52084,Agence_moov_Abomey,300000,247916,Paulette Loiseau,-981895,-929811,2022-10-02
CASH_IN,285830,Agence_moov_Cotonou,300000,14170,Paulette Loiseau,-929811,-643981,2022-10-03
CASH_IN,274464,Agence_moov_Ouidah,300000,25536,Paulette Loiseau,-643981,-369517,2022-10-04
CASH_IN,61424,Agence_moov_Cotonou,300000,238576,Paulette Loiseau,-369517,-308093,2022-10-05
CASH_IN,24416,Agence_moov_Cotonou,300000,275584,Paulette Loiseau,-308093,-283677,2022-10-06
CASH_IN,161117,Agence_moov_Cotonou,300000,138883,Paulette Loiseau,-283677,-122560,2022-10-06
CASH_IN,202370,Agence_moov_Abomey,300000,97630,Paulette Loiseau,-122560,79810,2022-10-07
TRANSFER,21348,Manon Chevalier,82329,60981,Paulette Loiseau,79810,101158,2022-10-10
TRANSFER,7565,Paulette Loiseau,101158,93593,André Renault,414465,406900,2022-10-10
TRANSFER,398216,Gabriel Bègue,1320477,922261,Paulette Loiseau,93593,491809,2022-10-11
TRANSFER,333371,Paulette Loiseau,491809,158438,Gabriel Bègue,922261,588890,2022-10-12
TRANSFER,67655,Aurore Charrier,75269,7614,Paulette Loiseau,158438,226093,2022-10-13
TRANSFER,146,Adèle Da Silva-Klein,229,83,Paulette Loiseau,226093,226239,2022-10-17
CASH_IN,167685,Agence_moov_Cotonou,300000,132315,Paulette Loiseau,226239,393924,2022-10-17
CASH_OUT,6762,Paulette Loiseau,393924,387162,Agence_moov_Ouidah,300000,293238,2022-10-18
CASH_IN,234056,Agence_moov_Abomey,300000,65944,Paulette Loiseau,387162,621218,2022-10-24
CASH_IN,79094,Agence_moov_Abomey,300000,220906,Paulette Loiseau,621218,700312,2022-10-25
CASH_OUT,66688,Paulette Loiseau,700312,633624,Agence_moov_Ouidah,300000,233312,2022-10-25
TRANSFER,176329,Paulette Loiseau,633624,457295,Manon Chevalier,60981,-115348,2022-10-27
CASH_IN,103382,Agence_moov_Ouidah,300000,196618,André Renault,406900,510282,2022-10-01
CASH_OUT,282259,André Renault,510282,228023,Agence_moov_Cotonou,300000,17741,2022-10-03
CASH_OUT,22435,André Renault,228023,205588,Agence_moov_Ouidah,300000,277565,2022-10-04
CASH_IN,148593,Agence_moov_Ouidah,300000,151407,André Renault,205588,354181,2022-10-04
CASH_OUT,109059,André Renault,354181,245122,Agence_moov_Cotonou,300000,190941,2022-10-04
CASH_OUT,140181,André Renault,245122,104941,Agence_moov_Cotonou,300000,159819,2022-10-04
CASH_IN,177306,Agence_moov_Abomey,300000,122694,André Renault,104941,282247,2022-10-05
TRANSFER,210885,André Renault,282247,71362,Philippe Philippe,90698,-120187,2022-10-07
TRANSFER,129996,Gabriel Bègue,588890,458894,André Renault,71362,201358,2022-10-09
TRANSFER,83794,Camille Prévost,633225,549431,André Renault,201358,285152,2022-10-11
TRANSFER,40241,Camille Prévost,549431,509190,André Renault,285152,325393,2022-10-11
TRANSFER,307840,André Renault,325393,17553,Aurore Charrier,7614,-300226,2022-10-14
CASH_OUT,7231,André Renault,17553,10322,Agence_moov_Abomey,300000,292769,2022-10-15
CASH_IN,275813,Agence_moov_Ouidah,300000,24187,André Renault,10322,286135,2022-10-16
CASH_IN,97140,Agence_moov_Abomey,300000,202860,André Renault,286135,383275,2022-10-19
CASH_IN,62891,Agence_moov_Ouidah,300000,237109,André Renault,383275,446166,2022-10-25
CASH_OUT,138443,André Renault,446166,307723,Agence_moov_Ouidah,300000,161557,2022-10-26
TRANSFER,134561,André Renault,307723,173162,Vincent de la Dumont,344980,210419,2022-10-27
CASH_IN,15485,Agence_moov_Cotonou,300000,284515,Manon Lebon,-57158,-41673,2022-10-03
CASH_IN,160060,Agence_moov_Abomey,300000,139940,Manon Lebon,-41673,118387,2022-10-03
TRANSFER,68781,Anastasie Richard-Neveu,102604,33823,Manon Lebon,118387,187168,2022-10-05
TRANSFER,137138,Thérèse François,206289,69151,Manon Lebon,187168,324306,2022-10-05
CASH_IN,169281,Agence_moov_Ouidah,300000,130719,Manon Lebon,324306,493587,2022-10-06
CASH_OUT,286797,Manon Lebon,493587,206790,Agence_moov_Ouidah,300000,13203,2022-10-07
TRANSFER,165,Colette-Sophie Prévost,559,394,Manon Lebon,206790,206955,2022-10-10
CASH_OUT,196690,Manon Lebon,206955,10265,Agence_moov_Cotonou,300000,103310,2022-10-12
CASH_OUT,5439,Manon Lebon,10265,4826,Agence_moov_Cotonou,300000,294561,2022-10-15
TRANSFER,335,Colette-Sophie Prévost,394,59,Manon Lebon,4826,5161,2022-10-16
TRANSFER,1032,Manon Lebon,5161,4129,Gabriel Bègue,458894,457862,2022-10-20
CASH_OUT,2547,Manon Lebon,4129,1582,Agence_moov_Cotonou,300000,297453,2022-10-20
CASH_OUT,250,Manon Lebon,1582,1332,Agence_moov_Ouidah,300000,299750,2022-10-25
CASH_IN,295425,Agence_moov_Cotonou,300000,4575,Manon Lebon,1332,296757,2022-10-27
TRANSFER,166821,Manon Lebon,296757,129936,Gabriel Bègue,457862,291041,2022-10-27
CASH_OUT,50054,Manon Lebon,129936,79882,Agence_moov_Ouidah,300000,249946,2022-10-27
CASH_IN,88628,Agence_moov_Cotonou,300000,211372,Lucy Gillet,-132554,-43926,2022-10-03
CASH_IN,24207,Agence_moov_Cotonou,300000,275793,Lucy Gillet,-43926,-19719,2022-10-04
CASH_IN,269441,Agence_moov_Abomey,300000,30559,Lucy Gillet,-19719,249722,2022-10-10
CASH_OUT,206838,Lucy Gillet,249722,42884,Agence_moov_Cotonou,300000,93162,2022-10-12
TRANSFER,9262,Lucy Gillet,42884,33622,Antoinette de Dupuis,132213,122951,2022-10-12
TRANSFER,17390,Lucy Gillet,33622,16232,Gabriel Bègue,291041,273651,2022-10-13
TRANSFER,97416,Vincent de la Dumont,210419,113003,Lucy Gillet,16232,113648,2022-10-14
TRANSFER,113118,Lucy Gillet,113648,530,Thérèse François,69151,-43967,2022-10-17
CASH_OUT,341,Lucy Gillet,530,189,Agence_moov_Ouidah,300000,299659,2022-10-17
TRANSFER,20066,Anastasie Richard-Neveu,33823,13757,Lucy Gillet,189,20255,2022-10-19
CASH_OUT,8322,Lucy Gillet,20255,11933,Agence_moov_Cotonou,300000,291678,2022-10-19
CASH_OUT,2165,Lucy Gillet,11933,9768,Agence_moov_Cotonou,300000,297835,2022-10-20
CASH_OUT,2450,Lucy Gillet,9768,7318,Agence_moov_Abomey,300000,297550,2022-10-23
CASH_IN,299086,Agence_moov_Ouidah,300000,914,Lucy Gillet,7318,306404,2022-10-23
CASH_OUT,272183,Lucy Gillet,306404,34221,Agence_moov_Abomey,300000,27817,2022-10-24
CASH_IN,6508,Agence_moov_Cotonou,300000,293492,Lucy Gillet,34221,40729,2022-10-25
CASH_IN,59411,Agence_moov_Ouidah,300000,240589,Lucy Gillet,40729,100140,2022-10-27
CASH_IN,275572,Agence_moov_Abomey,300000,24428,Hélène Le Chauvin,-698809,-423237,2022-10-02
CASH_IN,294197,Agence_moov_Abomey,300000,5803,Hélène Le Chauvin,-423237,-129040,2022-10-09
CASH_IN,7528,Agence_moov_Abomey,300000,292472,Hélène Le Chauvin,-129040,-121512,2022-10-10
CASH_IN,52156,Agence_moov_Abomey,300000,247844,Hélène Le Chauvin,-121512,-69356,2022-10-10
CASH_IN,290689,Agence_moov_Ouidah,300000,9311,Hélène Le Chauvin,-69356,221333,2022-10-10
CASH_IN,1158,Agence_moov_Abomey,300000,298842,Hélène Le Chauvin,221333,222491,2022-10-12
TRANSFER,3123,Antoinette de Dupuis,122951,119828,Hélène Le Chauvin,222491,225614,2022-10-13
CASH_OUT,210147,Hélène Le Chauvin,225614,15467,Agence_moov_Ouidah,300000,89853,2022-10-15
CASH_IN,240964,Agence_moov_Ouidah,300000,59036,Hélène Le Chauvin,15467,256431,2022-10-18
CASH_IN,175129,Agence_moov_Ouidah,300000,124871,Hélène Le Chauvin,256431,431560,2022-10-19
TRANSFER,358275,Hélène Le Chauvin,431560,73285,Camille Prévost,509190,150915,2022-10-20
TRANSFER,4845,Anastasie Richard-Neveu,13757,8912,Hélène Le Chauvin,73285,78130,2022-10-21
CASH_IN,265372,Agence_moov_Abomey,300000,34628,Hélène Le Chauvin,78130,343502,2022-10-27
CASH_IN,190638,Agence_moov_Cotonou,300000,109362,Frédéric Guillou,-105907,84731,2022-10-01
CASH_OUT,26204,Frédéric Guillou,84731,58527,Agence_moov_Ouidah,300000,273796,2022-10-02
CASH_OUT,23598,Frédéric Guillou,58527,34929,Agence_moov_Ouidah,300000,276402,2022-10-04
CASH_OUT,27847,Frédéric Guillou,34929,7082,Agence_moov_Cotonou,300000,272153,2022-10-06
CASH_IN,144047,Agence_moov_Ouidah,300000,155953,Frédéric Guillou,7082,151129,2022-10-08
TRANSFER,26726,Frédéric Guillou,151129,124403,Frédéric Guillou,151129,177855,2022-10-08
CASH_IN,210089,Agence_moov_Cotonou,300000,89911,Frédéric Guillou,124403,334492,2022-10-12
CASH_OUT,36256,Frédéric Guillou,334492,298236,Agence_moov_Ouidah,300000,263744,2022-10-13
CASH_OUT,279433,Frédéric Guillou,298236,18803,Agence_moov_Cotonou,300000,20567,2022-10-13
TRANSFER,6037,Anastasie Richard-Neveu,8912,2875,Frédéric Guillou,18803,24840,2022-10-15
CASH_OUT,22713,Frédéric Guillou,24840,2127,Agence_moov_Abomey,300000,277287,2022-10-21
CASH_IN,86642,Agence_moov_Abomey,300000,213358,Frédéric Guillou,2127,88769,2022-10-22
TRANSFER,88450,Vincent de la Dumont,113003,24553,Frédéric Guillou,88769,177219,2022-10-22
CASH_IN,10805,Agence_moov_Cotonou,300000,289195,Frédéric Guillou,177219,188024,2022-10-27
CASH_IN,113527,Agence_moov_Abomey,300000,186473,Lucy Lamy,-1412026,-1298499,2022-10-01
CASH_IN,198525,Agence_moov_Cotonou,300000,101475,Lucy Lamy,-1298499,-1099974,2022-10-02
CASH_IN,173766,Agence_moov_Abomey,300000,126234,Lucy Lamy,-1099974,-926208,2022-10-03
CASH_IN,73711,Agence_moov_Abomey,300000,226289,Lucy Lamy,-926208,-852497,2022-10-04
CASH_IN,270614,Agence_moov_Abomey,300000,29386,Lucy Lamy,-852497,-581883,2022-10-05
CASH_IN,179370,Agence_moov_Abomey,300000,120630,Lucy Lamy,-581883,-402513,2022-10-05
CASH_IN,153230,Agence_moov_Ouidah,300000,146770,Lucy Lamy,-402513,-249283,2022-10-05
CASH_IN,226163,Agence_moov_Cotonou,300000,73837,Lucy Lamy,-249283,-23120,2022-10-08
CASH_IN,185112,Agence_moov_Abomey,300000,114888,Lucy Lamy,-23120,161992,2022-10-09
TRANSFER,144820,Lucy Lamy,161992,17172,Vincent de la Dumont,24553,-120267,2022-10-09
CASH_IN,275080,Agence_moov_Ouidah,300000,24920,Lucy Lamy,17172,292252,2022-10-12
TRANSFER,1394,Anastasie Richard-Neveu,2875,1481,Lucy Lamy,292252,293646,2022-10-13
CASH_IN,29002,Agence_moov_Abomey,300000,270998,Lucy Lamy,293646,322648,2022-10-13
CASH_IN,44954,Agence_moov_Abomey,300000,255046,Lucy Lamy,322648,367602,2022-10-16
TRANSFER,81814,Camille Prévost,150915,69101,Lucy Lamy,367602,449416,2022-10-25
CASH_IN,107709,Agence_moov_Ouidah,300000,192291,Lucy Lamy,449416,557125,2022-10-26
TRANSFER,1070,Anastasie Richard-Neveu,1481,411,Lucy Lamy,557125,558195,2022-10-26
CASH_OUT,71722,Lucy Lamy,558195,486473,Agence_moov_Cotonou,300000,228278,2022-10-26
CASH_IN,21114,Agence_moov_Ouidah,300000,278886,Lucy Lamy,486473,507587,2022-10-27
CASH_IN,114411,Agence_moov_Ouidah,300000,185589,Tristan Bousquet-Gros,-113668,743,2022-10-02
TRANSFER,361,Anastasie Richard-Neveu,411,50,Tristan Bousquet-Gros,743,1104,2022-10-03
TRANSFER,902,Tristan Bousquet-Gros,1104,202,Tristan Bousquet-Gros,1104,2006,2022-10-04
CASH_OUT,201,Tristan Bousquet-Gros,202,1,Agence_moov_Cotonou,300000,299799,2022-10-06
CASH_IN,207444,Agence_moov_Cotonou,300000,92556,Tristan Bousquet-Gros,1,207445,2022-10-11
CASH_OUT,163712,Tristan Bousquet-Gros,207445,43733,Agence_moov_Abomey,300000,136288,2022-10-13
TRANSFER,2817,Tristan Bousquet-Gros,43733,40916,Tristan Bousquet-Gros,43733,40916,2022-10-13
CASH_OUT,29939,Tristan Bousquet-Gros,40916,10977,Agence_moov_Cotonou,300000,270061,2022-10-14
CASH_IN,289712,Agence_moov_Cotonou,300000,10288,Tristan Bousquet-Gros,10977,300689,2022-10-15
CASH_OUT,67922,Tristan Bousquet-Gros,300689,232767,Agence_moov_Abomey,300000,232078,2022-10-15
TRANSFER,218858,Tristan Bousquet-Gros,232767,13909,Tristan Bousquet-Gros,232767,451625,2022-10-16
CASH_OUT,11219,Tristan Bousquet-Gros,13909,2690,Agence_moov_Cotonou,300000,288781,2022-10-18
CASH_IN,83397,Agence_moov_Ouidah,300000,216603,Tristan Bousquet-Gros,2690,86087,2022-10-21
CASH_IN,116023,Agence_moov_Ouidah,300000,183977,Tristan Bousquet-Gros,86087,202110,2022-10-23
CASH_IN,245113,Agence_moov_Cotonou,300000,54887,Tristan Bousquet-Gros,202110,447223,2022-10-27
CASH_IN,108303,Agence_moov_Abomey,300000,191697,Adèle Da Silva-Klein,83,108386,2022-10-02
CASH_IN,179505,Agence_moov_Cotonou,300000,120495,Adèle Da Silva-Klein,108386,287891,2022-10-04
TRANSFER,225383,Adèle Da Silva-Klein,287891,62508,Adèle Da Silva-Klein,287891,62508,2022-10-04
CASH_IN,120932,Agence_moov_Abomey,300000,179068,Adèle Da Silva-Klein,62508,183440,2022-10-13
CASH_OUT,61734,Adèle Da Silva-Klein,183440,121706,Agence_moov_Ouidah,300000,238266,2022-10-14
CASH_IN,210277,Agence_moov_Cotonou,300000,89723,Adèle Da Silva-Klein,121706,331983,2022-10-19
CASH_OUT,318886,Adèle Da Silva-Klein,331983,13097,Agence_moov_Ouidah,300000,-18886,2022-10-27
CASH_IN,270663,Agence_moov_Ouidah,300000,29337,Thérèse François,-43967,226696,2022-10-02
TRANSFER,121454,Thérèse François,226696,105242,Thérèse François,226696,348150,2022-10-05
CASH_OUT,96350,Thérèse François,105242,8892,Agence_moov_Abomey,300000,203650,2022-10-06
CASH_IN,54989,Agence_moov_Cotonou,300000,245011,Thérèse François,8892,63881,2022-10-07
CASH_IN,219107,Agence_moov_Abomey,300000,80893,Thérèse François,63881,282988,2022-10-08
CASH_IN,143868,Agence_moov_Cotonou,300000,156132,Thérèse François,282988,426856,2022-10-09
CASH_IN,221814,Agence_moov_Ouidah,300000,78186,Thérèse François,426856,648670,2022-10-12
CASH_OUT,18636,Thérèse François,648670,630034,Agence_moov_Cotonou,300000,281364,2022-10-18
CASH_OUT,167087,Thérèse François,630034,462947,Agence_moov_Ouidah,300000,132913,2022-10-21
CASH_OUT,298341,Thérèse François,462947,164606,Agence_moov_Cotonou,300000,1659,2022-10-23
CASH_IN,46064,Agence_moov_Abomey,300000,253936,Anastasie Cousin,-1379388,-1333324,2022-10-02
CASH_IN,245429,Agence_moov_Ouidah,300000,54571,Anastasie Cousin,-1333324,-1087895,2022-10-02
CASH_IN,255710,Agence_moov_Abomey,300000,44290,Anastasie Cousin,-1087895,-832185,2022-10-05
CASH_IN,157169,Agence_moov_Cotonou,300000,142831,Anastasie Cousin,-832185,-675016,2022-10-09
CASH_IN,70554,Agence_moov_Ouidah,300000,229446,Anastasie Cousin,-675016,-604462,2022-10-10
CASH_IN,225874,Agence_moov_Abomey,300000,74126,Anastasie Cousin,-604462,-378588,2022-10-12
CASH_IN,161160,Agence_moov_Abomey,300000,138840,Anastasie Cousin,-378588,-217428,2022-10-18
CASH_IN,16766,Agence_moov_Cotonou,300000,283234,Anastasie Cousin,-217428,-200662,2022-10-19
CASH_IN,63442,Agence_moov_Abomey,300000,236558,Anastasie Cousin,-200662,-137220,2022-10-24
CASH_IN,92619,Agence_moov_Cotonou,300000,207381,Aurore Charrier,-300226,-207607,2022-10-01
CASH_IN,171391,Agence_moov_Cotonou,300000,128609,Aurore Charrier,-207607,-36216,2022-10-03
CASH_IN,229378,Agence_moov_Ouidah,300000,70622,Aurore Charrier,-36216,193162,2022-10-07
CASH_OUT,69664,Aurore Charrier,193162,123498,Agence_moov_Abomey,300000,230336,2022-10-07
CASH_OUT,24963,Aurore Charrier,123498,98535,Agence_moov_Cotonou,300000,275037,2022-10-14
CASH_IN,291617,Agence_moov_Ouidah,300000,8383,Aurore Charrier,98535,390152,2022-10-18
CASH_IN,108308,Agence_moov_Cotonou,300000,191692,Aurore Charrier,390152,498460,2022-10-22
CASH_IN,74617,Agence_moov_Cotonou,300000,225383,Aurore Charrier,498460,573077,2022-10-24
CASH_IN,147857,Agence_moov_Ouidah,300000,152143,Aurore Charrier,573077,720934,2022-10-27
CASH_IN,286858,Agence_moov_Abomey,300000,13142,Clémence-Véronique Munoz,-177491,109367,2022-10-01
CASH_IN,259884,Agence_moov_Cotonou,300000,40116,Clémence-Véronique Munoz,109367,369251,2022-10-04
CASH_OUT,124030,Clémence-Véronique Munoz,369251,245221,Agence_moov_Cotonou,300000,175970,2022-10-14
CASH_IN,3053,Agence_moov_Cotonou,300000,296947,Clémence-Véronique Munoz,245221,248274,2022-10-15
CASH_IN,146634,Agence_moov_Ouidah,300000,153366,Clémence-Véronique Munoz,248274,394908,2022-10-17
CASH_IN,111327,Agence_moov_Cotonou,300000,188673,Clémence-Véronique Munoz,394908,506235,2022-10-20
CASH_IN,5854,Agence_moov_Abomey,300000,294146,Clémence-Véronique Munoz,506235,512089,2022-10-20
CASH_OUT,454040,Clémence-Véronique Munoz,512089,58049,Agence_moov_Abomey,300000,-154040,2022-10-21
CASH_IN,213440,Agence_moov_Abomey,300000,86560,Michel Bouchet,-210037,3403,2022-10-05
CASH_OUT,2550,Michel Bouchet,3403,853,Agence_moov_Ouidah,300000,297450,2022-10-07
CASH_IN,242506,Agence_moov_Cotonou,300000,57494,Michel Bouchet,853,243359,2022-10-07
TRANSFER,182335,Michel Bouchet,243359,61024,Michel Bouchet,243359,61024,2022-10-09
CASH_OUT,55856,Michel Bouchet,61024,5168,Agence_moov_Ouidah,300000,244144,2022-10-09
TRANSFER,1571,Michel Bouchet,5168,3597,Michel Bouchet,5168,6739,2022-10-14
CASH_OUT,3099,Michel Bouchet,3597,498,Agence_moov_Ouidah,300000,296901,2022-10-19
CASH_OUT,417,Michel Bouchet,498,81,Agence_moov_Abomey,300000,299583,2022-10-21
CASH_IN,56778,Agence_moov_Ouidah,300000,243222,Michel Bouchet,81,56859,2022-10-22
CASH_OUT,45348,Michel Bouchet,56859,11511,Agence_moov_Cotonou,300000,254652,2022-10-23
CASH_OUT,5543,Michel Bouchet,11511,5968,Agence_moov_Abomey,300000,294457,2022-10-26
CASH_OUT,1486,Michel Bouchet,5968,4482,Agence_moov_Cotonou,300000,298514,2022-10-27
CASH_IN,131134,Agence_moov_Ouidah,300000,168866,Philippe Philippe,-120187,10947,2022-10-03
TRANSFER,2604,Philippe Philippe,10947,8343,Philippe Philippe,10947,8343,2022-10-05
TRANSFER,5420,Philippe Philippe,8343,2923,Philippe Philippe,8343,2923,2022-10-05
CASH_IN,206546,Agence_moov_Abomey,300000,93454,Philippe Philippe,2923,209469,2022-10-10
CASH_OUT,37575,Philippe Philippe,209469,171894,Agence_moov_Ouidah,300000,262425,2022-10-10
CASH_OUT,94098,Philippe Philippe,171894,77796,Agence_moov_Ouidah,300000,205902,2022-10-11
TRANSFER,69071,Philippe Philippe,77796,8725,Philippe Philippe,77796,146867,2022-10-13
CASH_OUT,2182,Philippe Philippe,8725,6543,Agence_moov_Cotonou,300000,297818,2022-10-14
CASH_IN,232559,Agence_moov_Ouidah,300000,67441,Philippe Philippe,6543,239102,2022-10-15
CASH_OUT,190177,Philippe Philippe,239102,48925,Agence_moov_Abomey,300000,109823,2022-10-18
CASH_OUT,18381,Philippe Philippe,48925,30544,Agence_moov_Abomey,300000,281619,2022-10-19
CASH_OUT,26800,Philippe Philippe,30544,3744,Agence_moov_Ouidah,300000,273200,2022-10-19
CASH_OUT,1099,Philippe Philippe,3744,2645,Agence_moov_Cotonou,300000,298901,2022-10-27
CASH_IN,28060,Agence_moov_Ouidah,300000,271940,Timothée-René Blanchard,-660195,-632135,2022-10-01
CASH_IN,2640,Agence_moov_Abomey,300000,297360,Timothée-René Blanchard,-632135,-629495,2022-10-03
CASH_IN,51109,Agence_moov_Ouidah,300000,248891,Timothée-René Blanchard,-629495,-578386,2022-10-03
CASH_IN,216953,Agence_moov_Abomey,300000,83047,Timothée-René Blanchard,-578386,-361433,2022-10-05
CASH_IN,10665,Agence_moov_Abomey,300000,289335,Timothée-René Blanchard,-361433,-350768,2022-10-07
CASH_IN,191952,Agence_moov_Ouidah,300000,108048,Timothée-René Blanchard,-350768,-158816,2022-10-09
CASH_IN,133108,Agence_moov_Ouidah,300000,166892,Timothée-René Blanchard,-158816,-25708,2022-10-10
CASH_IN,261654,Agence_moov_Abomey,300000,38346,Timothée-René Blanchard,-25708,235946,2022-10-10
CASH_IN,17484,Agence_moov_Ouidah,300000,282516,Timothée-René Blanchard,235946,253430,2022-10-10
CASH_OUT,151808,Timothée-René Blanchard,253430,101622,Agence_moov_Cotonou,300000,148192,2022-10-14
CASH_IN,154797,Agence_moov_Cotonou,300000,145203,Timothée-René Blanchard,101622,256419,2022-10-17
CASH_IN,108344,Agence_moov_Ouidah,300000,191656,Timothée-René Blanchard,256419,364763,2022-10-18
CASH_IN,88090,Agence_moov_Ouidah,300000,211910,Timothée-René Blanchard,364763,452853,2022-10-25
CASH_OUT,358829,Timothée-René Blanchard,452853,94024,Agence_moov_Abomey,300000,-58829,2022-10-26
CASH_IN,104508,Agence_moov_Ouidah,300000,195492,Christine Texier,-71096,33412,2022-10-01
CASH_OUT,15452,Christine Texier,33412,17960,Agence_moov_Abomey,300000,284548,2022-10-06
CASH_IN,217550,Agence_moov_Abomey,300000,82450,Christine Texier,17960,235510,2022-10-10
CASH_OUT,128643,Christine Texier,235510,106867,Agence_moov_Abomey,300000,171357,2022-10-14
CASH_OUT,17660,Christine Texier,106867,89207,Agence_moov_Ouidah,300000,282340,2022-10-16
CASH_IN,211715,Agence_moov_Ouidah,300000,88285,Christine Texier,89207,300922,2022-10-16
TRANSFER,17050,Christine Texier,300922,283872,Christine Texier,300922,283872,2022-10-18
CASH_IN,212806,Agence_moov_Abomey,300000,87194,Christine Texier,283872,496678,2022-10-20
CASH_IN,249115,Agence_moov_Ouidah,300000,50885,Christine Texier,496678,745793,2022-10-20
CASH_IN,89209,Agence_moov_Cotonou,300000,210791,Christine Texier,745793,835002,2022-10-22
CASH_IN,241835,Agence_moov_Cotonou,300000,58165,Christine Texier,835002,1076837,2022-10-25
CASH_IN,240832,Agence_moov_Abomey,300000,59168,Manon Chevalier,-115348,125484,2022-10-07
TRANSFER,79002,Manon Chevalier,125484,46482,Manon Chevalier,125484,204486,2022-10-13
CASH_OUT,18763,Manon Chevalier,46482,27719,Agence_moov_Abomey,300000,281237,2022-10-17
CASH_OUT,5479,Manon Chevalier,27719,22240,Agence_moov_Cotonou,300000,294521,2022-10-19
CASH_OUT,21998,Manon Chevalier,22240,242,Agence_moov_Abomey,300000,278002,2022-10-22
CASH_IN,61452,Agence_moov_Cotonou,300000,238548,Manon Chevalier,242,61694,2022-10-23
CASH_IN,225942,Agence_moov_Cotonou,300000,74058,Manon Chevalier,61694,287636,2022-10-25
CASH_IN,128286,Agence_moov_Cotonou,300000,171714,Thérèse Hubert,-97147,31139,2022-10-01
CASH_IN,290708,Agence_moov_Abomey,300000,9292,Thérèse Hubert,31139,321847,2022-10-01
TRANSFER,259135,Thérèse Hubert,321847,62712,Thérèse Hubert,321847,580982,2022-10-03
CASH_IN,83779,Agence_moov_Cotonou,300000,216221,Thérèse Hubert,62712,146491,2022-10-04
CASH_OUT,129344,Thérèse Hubert,146491,17147,Agence_moov_Cotonou,300000,170656,2022-10-14
CASH_OUT,8912,Thérèse Hubert,17147,8235,Agence_moov_Abomey,300000,291088,2022-10-16
CASH_IN,112999,Agence_moov_Cotonou,300000,187001,Thérèse Hubert,8235,121234,2022-10-19
CASH_IN,98794,Agence_moov_Cotonou,300000,201206,Thérèse Hubert,121234,220028,2022-10-22
CASH_IN,267087,Agence_moov_Abomey,300000,32913,Thérèse Hubert,220028,487115,2022-10-22
CASH_IN,51138,Agence_moov_Cotonou,300000,248862,Thérèse Hubert,487115,538253,2022-10-23
CASH_IN,154921,Agence_moov_Abomey,300000,145079,Thérèse Hubert,538253,693174,2022-10-25
CASH_IN,144362,Agence_moov_Abomey,300000,155638,Nicolas Salmon Le Hamon,-226987,-82625,2022-10-01
CASH_IN,43052,Agence_moov_Ouidah,300000,256948,Nicolas Salmon Le Hamon,-82625,-39573,2022-10-02
CASH_IN,175722,Agence_moov_Ouidah,300000,124278,Nicolas Salmon Le Hamon,-39573,136149,2022-10-13
CASH_OUT,29482,Nicolas Salmon Le Hamon,136149,106667,Agence_moov_Ouidah,300000,270518,2022-10-17
TRANSFER,32952,Nicolas Salmon Le Hamon,106667,73715,Nicolas Salmon Le Hamon,106667,139619,2022-10-18
CASH_OUT,19006,Nicolas Salmon Le Hamon,73715,54709,Agence_moov_Ouidah,300000,280994,2022-10-18
CASH_OUT,30595,Nicolas Salmon Le Hamon,54709,24114,Agence_moov_Abomey,300000,269405,2022-10-21
CASH_OUT,4667,Nicolas Salmon Le Hamon,24114,19447,Agence_moov_Cotonou,300000,295333,2022-10-21
CASH_OUT,4130,Nicolas Salmon Le Hamon,19447,15317,Agence_moov_Abomey,300000,295870,2022-10-22
CASH_IN,67263,Agence_moov_Cotonou,300000,232737,Nicolas Salmon Le Hamon,15317,82580,2022-10-27
CASH_IN,275523,Agence_moov_Abomey,300000,24477,Michelle Samson,-130545,144978,2022-10-01
CASH_IN,44288,Agence_moov_Abomey,300000,255712,Michelle Samson,144978,189266,2022-10-05
CASH_IN,266057,Agence_moov_Cotonou,300000,33943,Michelle Samson,189266,455323,2022-10-08
CASH_OUT,48353,Michelle Samson,455323,406970,Agence_moov_Abomey,300000,251647,2022-10-23
CASH_IN,124918,Agence_moov_Abomey,300000,175082,Anastasie Richard-Neveu,50,124968,2022-10-02
TRANSFER,47183,Anastasie Richard-Neveu,124968,77785,Anastasie Richard-Neveu,124968,77785,2022-10-10
CASH_IN,288597,Agence_moov_Cotonou,300000,11403,Anastasie Richard-Neveu,77785,366382,2022-10-11
CASH_IN,56923,Agence_moov_Ouidah,300000,243077,Anastasie Richard-Neveu,366382,423305,2022-10-12
CASH_OUT,355533,Anastasie Richard-Neveu,423305,67772,Agence_moov_Cotonou,300000,-55533,2022-10-12
CASH_OUT,16634,Anastasie Richard-Neveu,67772,51138,Agence_moov_Abomey,300000,283366,2022-10-17
CASH_OUT,35390,Anastasie Richard-Neveu,51138,15748,Agence_moov_Abomey,300000,264610,2022-10-21
CASH_IN,237984,Agence_moov_Cotonou,300000,62016,Andrée-Thérèse Mendès,-918,237066,2022-10-01
CASH_IN,276010,Agence_moov_Ouidah,300000,23990,Andrée-Thérèse Mendès,237066,513076,2022-10-07
TRANSFER,68101,Andrée-Thérèse Mendès,513076,444975,Andrée-Thérèse Mendès,513076,581177,2022-10-08
CASH_IN,190398,Agence_moov_Ouidah,300000,109602,Andrée-Thérèse Mendès,444975,635373,2022-10-13
CASH_IN,212947,Agence_moov_Abomey,300000,87053,Andrée-Thérèse Mendès,635373,848320,2022-10-23
CASH_IN,3614,Agence_moov_Ouidah,300000,296386,Andrée-Thérèse Mendès,848320,851934,2022-10-27
CASH_IN,753,Agence_moov_Ouidah,300000,299247,Andrée-Thérèse Mendès,851934,852687,2022-10-27
CASH_IN,188178,Agence_moov_Abomey,300000,111822,Émilie du Allain,-516220,-328042,2022-10-01
CASH_IN,76815,Agence_moov_Abomey,300000,223185,Émilie du Allain,-328042,-251227,2022-10-05
CASH_IN,210835,Agence_moov_Abomey,300000,89165,Émilie du Allain,-251227,-40392,2022-10-06
CASH_IN,244867,Agence_moov_Ouidah,300000,55133,Émilie du Allain,-40392,204475,2022-10-09
CASH_IN,160187,Agence_moov_Ouidah,300000,139813,Émilie du Allain,204475,364662,2022-10-11
CASH_OUT,306438,Émilie du Allain,364662,58224,Agence_moov_Abomey,300000,-6438,2022-10-13
TRANSFER,54455,Émilie du Allain,58224,3769,Émilie du Allain,58224,3769,2022-10-13
CASH_IN,78620,Agence_moov_Ouidah,300000,221380,Émilie du Allain,3769,82389,2022-10-17
CASH_IN,71280,Agence_moov_Cotonou,300000,228720,Émilie du Allain,82389,153669,2022-10-17
CASH_IN,134039,Agence_moov_Cotonou,300000,165961,Émilie du Allain,153669,287708,2022-10-18
CASH_IN,57128,Agence_moov_Ouidah,300000,242872,Émilie du Allain,287708,344836,2022-10-26
CASH_IN,33009,Agence_moov_Abomey,300000,266991,Vincent de la Dumont,-120267,-87258,2022-10-01
CASH_IN,210096,Agence_moov_Ouidah,300000,89904,Vincent de la Dumont,-87258,122838,2022-10-02
TRANSFER,108493,Vincent de la Dumont,122838,14345,Vincent de la Dumont,122838,231331,2022-10-03
CASH_IN,103771,Agence_moov_Cotonou,300000,196229,Vincent de la Dumont,14345,118116,2022-10-03
CASH_IN,279643,Agence_moov_Ouidah,300000,20357,Vincent de la Dumont,118116,397759,2022-10-04
TRANSFER,2512,Vincent de la Dumont,397759,395247,Vincent de la Dumont,397759,400271,2022-10-05
CASH_IN,223877,Agence_moov_Ouidah,300000,76123,Vincent de la Dumont,395247,619124,2022-10-07
CASH_IN,9779,Agence_moov_Abomey,300000,290221,Vincent de la Dumont,619124,628903,2022-10-12
CASH_IN,51369,Agence_moov_Abomey,300000,248631,Vincent de la Dumont,628903,680272,2022-10-12
CASH_IN,175693,Agence_moov_Cotonou,300000,124307,Vincent de la Dumont,680272,855965,2022-10-16
CASH_IN,59853,Agence_moov_Cotonou,300000,240147,Vincent de la Dumont,855965,915818,2022-10-17
CASH_IN,248223,Agence_moov_Abomey,300000,51777,Vincent de la Dumont,915818,1164041,2022-10-18
CASH_IN,51353,Agence_moov_Cotonou,300000,248647,Vincent de la Dumont,1164041,1215394,2022-10-23
CASH_IN,154625,Agence_moov_Abomey,300000,145375,Vincent de la Dumont,1215394,1370019,2022-10-24
CASH_OUT,590031,Vincent de la Dumont,1370019,779988,Agence_moov_Ouidah,300000,-290031,2022-10-25
CASH_IN,611,Agence_moov_Cotonou,300000,299389,Colette-Sophie Prévost,59,670,2022-10-03
CASH_OUT,340,Colette-Sophie Prévost,670,330,Agence_moov_Ouidah,300000,299660,2022-10-05
CASH_IN,186746,Agence_moov_Abomey,300000,113254,Colette-Sophie Prévost,330,187076,2022-10-05
CASH_OUT,3925,Colette-Sophie Prévost,187076,183151,Agence_moov_Ouidah,300000,296075,2022-10-11
CASH_IN,289310,Agence_moov_Ouidah,300000,10690,Colette-Sophie Prévost,183151,472461,2022-10-13
CASH_IN,249279,Agence_moov_Abomey,300000,50721,Colette-Sophie Prévost,472461,721740,2022-10-15
CASH_IN,296896,Agence_moov_Abomey,300000,3104,Colette-Sophie Prévost,721740,1018636,2022-10-16
CASH_IN,153760,Agence_moov_Ouidah,300000,146240,Colette-Sophie Prévost,1018636,1172396,2022-10-17
CASH_OUT,384246,Colette-Sophie Prévost,1172396,788150,Agence_moov_Abomey,300000,-84246,2022-10-18
CASH_OUT,870961,Michelle Samson,945200,74239,Agence_moov_Abomey,300000,-570961,2022-11-03
TRANSFER,89791,Tristan Bousquet-Gros,1037000,947209,Michelle Samson,74239,164030,2022-11-05
CASH_OUT,93918,Michelle Samson,164030,70112,Agence_moov_Cotonou,300000,206082,2022-11-06
TRANSFER,63660,Michelle Samson,70112,6452,Gérard de la Martinez,1418400,1354740,2022-11-06
CASH_IN,25047,Agence_moov_Abomey,300000,274953,Audrey Julien de Leleu,718500,743547,2022-11-08
CASH_OUT,298114,Audrey Julien de Leleu,743547,445433,Agence_moov_Ouidah,300000,1886,2022-11-25
CASH_IN,56216,Agence_moov_Ouidah,300000,243784,Agnès Le Giraud,45800,102016,2022-11-02
TRANSFER,22052,Agnès Le Giraud,102016,79964,Alix Barbe,1898800,1876748,2022-11-24
CASH_IN,278071,Agence_moov_Abomey,300000,21929,Gérard de la Martinez,1354740,1632811,2022-11-05
CASH_OUT,1382710,Gérard de la Martinez,1632811,250101,Agence_moov_Ouidah,300000,-1082710,2022-11-18
CASH_OUT,191734,Gérard de la Martinez,250101,58367,Agence_moov_Ouidah,300000,108266,2022-11-20
CASH_OUT,31201,Gérard de la Martinez,58367,27166,Agence_moov_Ouidah,300000,268799,2022-11-26
CASH_IN,111660,Agence_moov_Ouidah,300000,188340,Stéphane Munoz,1019700,1131360,2022-11-13
CASH_IN,230881,Agence_moov_Abomey,300000,69119,Clémence-Véronique Munoz,1517700,1748581,2022-11-03
CASH_OUT,147382,Clémence-Véronique Munoz,1748581,1601199,Agence_moov_Ouidah,300000,152618,2022-11-08
CASH_IN,139686,Agence_moov_Ouidah,300000,160314,Clémence-Véronique Munoz,1601199,1740885,2022-11-14
CASH_OUT,185641,Andrée-Thérèse Mendès,1042200,856559,Agence_moov_Cotonou,300000,114359,2022-11-02
CASH_IN,104027,Agence_moov_Ouidah,300000,195973,Andrée-Thérèse Mendès,856559,960586,2022-11-03
TRANSFER,106747,Sabine Pineau,112600,5853,Andrée-Thérèse Mendès,960586,1067333,2022-11-11
CASH_IN,206907,Agence_moov_Ouidah,300000,93093,Andrée-Thérèse Mendès,1067333,1274240,2022-11-16
CASH_IN,3541,Agence_moov_Abomey,300000,296459,Andrée-Thérèse Mendès,1274240,1277781,2022-11-22
CASH_OUT,464952,Noël Bourgeois,1627400,1162448,Agence_moov_Cotonou,300000,-164952,2022-11-10
CASH_OUT,93782,Noël Bourgeois,1162448,1068666,Agence_moov_Cotonou,300000,206218,2022-11-12
CASH_OUT,321732,Noël Bourgeois,1068666,746934,Agence_moov_Ouidah,300000,-21732,2022-11-16
CASH_OUT,321357,Noël Bourgeois,746934,425577,Agence_moov_Ouidah,300000,-21357,2022-11-20
TRANSFER,743702,Anastasie Cousin,842200,98498,Manon Lebon,707600,-36102,2022-11-11
CASH_IN,140943,Agence_moov_Cotonou,300000,159057,Anastasie Cousin,98498,239441,2022-11-12
CASH_OUT,218877,Anastasie Cousin,239441,20564,Agence_moov_Cotonou,300000,81123,2022-11-15
TRANSFER,18033,Anastasie Cousin,20564,2531,Matthieu-Matthieu Bigot,451600,433567,2022-11-18
CASH_IN,51827,Agence_moov_Cotonou,300000,248173,Anastasie Cousin,2531,54358,2022-11-26
CASH_IN,75338,Agence_moov_Cotonou,300000,224662,Adèle Da Silva-Klein,1089300,1164638,2022-11-16
CASH_OUT,280615,Thibaut de la Lombard,371700,91085,Agence_moov_Ouidah,300000,19385,2022-11-07
CASH_IN,92340,Agence_moov_Abomey,300000,207660,Thibaut de la Lombard,91085,183425,2022-11-09
TRANSFER,102429,Thibaut de la Lombard,183425,80996,Michelle-Dorothée Lévêque,439800,337371,2022-11-23
TRANSFER,34716,Thibaut de la Lombard,80996,46280,Manon Chevalier,1648900,1614184,2022-11-27
TRANSFER,154439,Tristan Bousquet-Gros,947209,792770,Raymond Lévy,607400,452961,2022-11-02
CASH_IN,11296,Agence_moov_Ouidah,300000,288704,Tristan Bousquet-Gros,792770,804066,2022-11-07
CASH_OUT,1264665,Alphonse Joly,1523700,259035,Agence_moov_Abomey,300000,-964665,2022-11-04
CASH_OUT,178459,Alphonse Joly,259035,80576,Agence_moov_Cotonou,300000,121541,2022-11-17
CASH_OUT,10212,Alphonse Joly,80576,70364,Agence_moov_Abomey,300000,289788,2022-11-23
CASH_OUT,5528,Camille Prévost,8500,2972,Agence_moov_Abomey,300000,294472,2022-11-07
CASH_IN,270934,Agence_moov_Cotonou,300000,29066,Colette Merle Le Robert,1055800,1326734,2022-11-09
CASH_IN,173570,Agence_moov_Abomey,300000,126430,Colette Merle Le Robert,1326734,1500304,2022-11-11
CASH_IN,248995,Agence_moov_Ouidah,300000,51005,Colette Merle Le Robert,1500304,1749299,2022-11-17
TRANSFER,1722574,Colette Merle Le Robert,1749299,26725,Mathilde de la Samson,310800,-1411774,2022-11-18
CASH_IN,146572,Agence_moov_Cotonou,300000,153428,Virginie Bouvet,1483500,1630072,2022-11-13
CASH_IN,49822,Agence_moov_Abomey,300000,250178,Virginie Bouvet,1630072,1679894,2022-11-27
CASH_OUT,306128,Philippe Philippe,959700,653572,Agence_moov_Abomey,300000,-6128,2022-11-02
CASH_OUT,342414,Philippe Philippe,653572,311158,Agence_moov_Cotonou,300000,-42414,2022-11-24
TRANSFER,782540,Tristan Delahaye,1543300,760760,Bertrand Regnier,1936800,2719340,2022-11-10
CASH_IN,45136,Agence_moov_Ouidah,300000,254864,Bertrand Regnier,2719340,2764476,2022-11-11
TRANSFER,211948,Thomas Guichard du Renault,830400,618452,Bertrand Regnier,2764476,2976424,2022-11-13
CASH_IN,46679,Agence_moov_Ouidah,300000,253321,Bertrand Regnier,2976424,3023103,2022-11-19
CASH_OUT,1632628,Bertrand Regnier,3023103,1390475,Agence_moov_Cotonou,300000,-1332628,2022-11-20
TRANSFER,1479609,Bernadette de Jourdan,1807800,328191,Suzanne Bodin,900700,-578909,2022-11-13
CASH_OUT,303091,Bernadette de Jourdan,328191,25100,Agence_moov_Abomey,300000,-3091,2022-11-19
CASH_OUT,10687,Bernadette de Jourdan,25100,14413,Agence_moov_Cotonou,300000,289313,2022-11-20
CASH_OUT,7769,Bernadette de Jourdan,14413,6644,Agence_moov_Abomey,300000,292231,2022-11-23
CASH_IN,46670,Agence_moov_Cotonou,300000,253330,Bernadette de Jourdan,6644,53314,2022-11-26
CASH_IN,9002,Agence_moov_Ouidah,300000,290998,Alix Barbe,1876748,1885750,2022-11-03
TRANSFER,704948,Mathilde Picard du Delmas,1067700,362752,Alix Barbe,1885750,2590698,2022-11-06
TRANSFER,64187,Thérèse Hubert,1253700,1189513,Alix Barbe,2590698,2654885,2022-11-17
CASH_IN,52672,Agence_moov_Abomey,300000,247328,Alix Barbe,2654885,2707557,2022-11-18
CASH_IN,251001,Agence_moov_Ouidah,300000,48999,Alix Barbe,2707557,2958558,2022-11-24
CASH_IN,158319,Agence_moov_Abomey,300000,141681,Constance Bourdon-Millet,1122300,1280619,2022-11-26
CASH_OUT,12800,Michelle-Dorothée Lévêque,337371,324571,Agence_moov_Abomey,300000,287200,2022-11-01
TRANSFER,559871,Richard Michel,1897900,1338029,Michelle-Dorothée Lévêque,324571,884442,2022-11-03
TRANSFER,294270,Maggie Martinez,573500,279230,Michelle-Dorothée Lévêque,884442,1178712,2022-11-05
CASH_IN,117908,Agence_moov_Abomey,300000,182092,Michelle-Dorothée Lévêque,1178712,1296620,2022-11-10
CASH_OUT,1103937,Michelle-Dorothée Lévêque,1296620,192683,Agence_moov_Abomey,300000,-803937,2022-11-19
CASH_IN,244793,Agence_moov_Ouidah,300000,55207,Mathilde de la Samson,-1411774,-1166981,2022-11-02
CASH_IN,54098,Agence_moov_Ouidah,300000,245902,Mathilde de la Samson,-1166981,-1112883,2022-11-03
CASH_IN,262399,Agence_moov_Ouidah,300000,37601,Mathilde de la Samson,-1112883,-850484,2022-11-05
CASH_IN,143875,Agence_moov_Ouidah,300000,156125,Mathilde de la Samson,-850484,-706609,2022-11-11
TRANSFER,516,Christine Texier,122300,121784,Robert Laroche,871200,870684,2022-11-16
TRANSFER,294391,Frédérique Fernandes du Bouchet,1861000,1566609,Christine Texier,121784,416175,2022-11-17
TRANSFER,1640790,Frédéric Guillou,1778800,138010,Christine Texier,416175,2056965,2022-11-22
TRANSFER,1680381,Christine Texier,2056965,376584,Manon Valette,1675900,-4481,2022-11-22
CASH_IN,6523,Agence_moov_Ouidah,300000,293477,Richard Le Lévêque,675700,682223,2022-11-04
CASH_OUT,636705,Richard Le Lévêque,682223,45518,Agence_moov_Cotonou,300000,-336705,2022-11-07
CASH_OUT,8342,Richard Le Lévêque,45518,37176,Agence_moov_Cotonou,300000,291658,2022-11-21
CASH_OUT,31765,Richard Le Lévêque,37176,5411,Agence_moov_Cotonou,300000,268235,2022-11-22
CASH_OUT,5189,Richard Le Lévêque,5411,222,Agence_moov_Abomey,300000,294811,2022-11-27
TRANSFER,658389,Rémy Grondin,851900,193511,Martine Aubert,899800,1558189,2022-11-01
CASH_OUT,721337,Martine Aubert,1558189,836852,Agence_moov_Abomey,300000,-421337,2022-11-01
TRANSFER,297951,Martine Aubert,836852,538901,Paul Rocher-Maillet,1417700,1119749,2022-11-03
TRANSFER,440855,Martine Aubert,538901,98046,Thomas-Robert Morvan,1571900,1131045,2022-11-03
TRANSFER,112771,Hélène Le Chauvin,195400,82629,Martine Aubert,98046,210817,2022-11-04
CASH_OUT,148243,Martine Aubert,210817,62574,Agence_moov_Cotonou,300000,151757,2022-11-04
TRANSFER,67187,Michel Bouchet,1305700,1238513,Martine Aubert,62574,129761,2022-11-05
TRANSFER,112972,Robert Clerc,580300,467328,Martine Aubert,129761,242733,2022-11-06
CASH_OUT,182667,Martine Aubert,242733,60066,Agence_moov_Abomey,300000,117333,2022-11-07
CASH_IN,245782,Agence_moov_Cotonou,300000,54218,Martine Aubert,60066,305848,2022-11-10
TRANSFER,1539682,Colette-Sophie Prévost,1661400,121718,Martine Aubert,305848,1845530,2022-11-12
CASH_OUT,914575,Martine Aubert,1845530,930955,Agence_moov_Ouidah,300000,-614575,2022-11-13
CASH_IN,252033,Agence_moov_Cotonou,300000,47967,Martine Aubert,930955,1182988,2022-11-13
CASH_IN,71820,Agence_moov_Cotonou,300000,228180,Martine Aubert,1182988,1254808,2022-11-13
CASH_IN,297062,Agence_moov_Ouidah,300000,2938,Martine Aubert,1254808,1551870,2022-11-14
CASH_IN,73606,Agence_moov_Ouidah,300000,226394,Martine Aubert,1551870,1625476,2022-11-14
CASH_OUT,62386,Martine Aubert,1625476,1563090,Agence_moov_Abomey,300000,237614,2022-11-14
CASH_OUT,235328,Martine Aubert,1563090,1327762,Agence_moov_Abomey,300000,64672,2022-11-14
CASH_OUT,470266,Martine Aubert,1327762,857496,Agence_moov_Ouidah,300000,-170266,2022-11-15
CASH_OUT,218148,Martine Aubert,857496,639348,Agence_moov_Cotonou,300000,81852,2022-11-15
CASH_IN,21006,Agence_moov_Abomey,300000,278994,Martine Aubert,639348,660354,2022-11-15
TRANSFER,203165,Martine Aubert,660354,457189,Hélène de la Gérard,982100,778935,2022-11-16
TRANSFER,230780,Martine Aubert,457189,226409,Émilie du Allain,1848100,1617320,2022-11-18
CASH_OUT,90875,Martine Aubert,226409,135534,Agence_moov_Cotonou,300000,209125,2022-11-20
TRANSFER,63130,Noémi Bouvier,134600,71470,Martine Aubert,135534,198664,2022-11-23
TRANSFER,187866,Martine Aubert,198664,10798,Camille Morvan,1186500,998634,2022-11-24
CASH_IN,1058,Agence_moov_Cotonou,300000,298942,Martine Aubert,10798,11856,2022-11-24
TRANSFER,1005486,Bernard Maurice,1107400,101914,Martine Aubert,11856,1017342,2022-11-26
TRANSFER,459913,Martine Aubert,1017342,557429,André Renault,1884100,1424187,2022-11-27
CASH_OUT,92533,Tristan Gomez,819400,726867,Agence_moov_Ouidah,300000,207467,2022-11-01
TRANSFER,63662,Tristan Gomez,726867,663205,Constance Guillon,1478900,1415238,2022-11-02
CASH_OUT,12938,Tristan Gomez,663205,650267,Agence_moov_Cotonou,300000,287062,2022-11-03
CASH_OUT,386698,Tristan Gomez,650267,263569,Agence_moov_Cotonou,300000,-86698,2022-11-04
CASH_OUT,78723,Tristan Gomez,263569,184846,Agence_moov_Ouidah,300000,221277,2022-11-05
CASH_OUT,7267,Tristan Gomez,184846,177579,Agence_moov_Abomey,300000,292733,2022-11-05
CASH_OUT,4375,Tristan Gomez,177579,173204,Agence_moov_Cotonou,300000,295625,2022-11-08
CASH_OUT,25862,Tristan Gomez,173204,147342,Agence_moov_Cotonou,300000,274138,2022-11-08
CASH_IN,246186,Agence_moov_Abomey,300000,53814,Tristan Gomez,147342,393528,2022-11-10
CASH_IN,223586,Agence_moov_Abomey,300000,76414,Tristan Gomez,393528,617114,2022-11-10
CASH_IN,293769,Agence_moov_Abomey,300000,6231,Tristan Gomez,617114,910883,2022-11-11
CASH_OUT,37739,Tristan Gomez,910883,873144,Agence_moov_Cotonou,300000,262261,2022-11-12
CASH_OUT,384248,Tristan Gomez,873144,488896,Agence_moov_Cotonou,300000,-84248,2022-11-12
TRANSFER,10565,Rémy Grondin,193511,182946,Tristan Gomez,488896,499461,2022-11-13
CASH_IN,71099,Agence_moov_Cotonou,300000,228901,Tristan Gomez,499461,570560,2022-11-13
CASH_IN,276954,Agence_moov_Ouidah,300000,23046,Tristan Gomez,570560,847514,2022-11-15
CASH_OUT,79112,Tristan Gomez,847514,768402,Agence_moov_Ouidah,300000,220888,2022-11-15
CASH_IN,16162,Agence_moov_Cotonou,300000,283838,Tristan Gomez,768402,784564,2022-11-16
TRANSFER,765325,Tristan Gomez,784564,19239,Antoinette de Dupuis,1343600,578275,2022-11-17
CASH_OUT,14717,Tristan Gomez,19239,4522,Agence_moov_Ouidah,300000,285283,2022-11-20
CASH_OUT,3265,Tristan Gomez,4522,1257,Agence_moov_Abomey,300000,296735,2022-11-20
CASH_OUT,741,Tristan Gomez,1257,516,Agence_moov_Abomey,300000,299259,2022-11-22
CASH_OUT,396,Tristan Gomez,516,120,Agence_moov_Cotonou,300000,299604,2022-11-24
CASH_OUT,102,Tristan Gomez,120,18,Agence_moov_Abomey,300000,299898,2022-11-25
CASH_IN,105056,Agence_moov_Ouidah,300000,194944,Tristan Gomez,18,105074,2022-11-26
CASH_OUT,31250,Tristan Gomez,105074,73824,Agence_moov_Abomey,300000,268750,2022-11-26
CASH_OUT,61351,Tristan Gomez,73824,12473,Agence_moov_Abomey,300000,238649,2022-11-27
TRANSFER,6622,Tristan Gomez,12473,5851,André Renault,1424187,1417565,2022-11-27
CASH_IN,235395,Agence_moov_Cotonou,300000,64605,Tristan Gomez,5851,241246,2022-11-27
CASH_OUT,33957,Marcelle-Valentine Guibert,293400,259443,Agence_moov_Abomey,300000,266043,2022-11-03
CASH_IN,84261,Agence_moov_Abomey,300000,215739,Marcelle-Valentine Guibert,259443,343704,2022-11-04
CASH_OUT,293303,Marcelle-Valentine Guibert,343704,50401,Agence_moov_Abomey,300000,6697,2022-11-04
TRANSFER,428,Marcelle-Valentine Guibert,50401,49973,Michelle de Étienne,1852000,1851572,2022-11-06
CASH_OUT,11140,Marcelle-Valentine Guibert,49973,38833,Agence_moov_Abomey,300000,288860,2022-11-07
TRANSFER,11545,Marcelle-Valentine Guibert,38833,27288,Robert Clerc,467328,455783,2022-11-07
TRANSFER,1206834,Renée Rousseau-Henry,1238200,31366,Marcelle-Valentine Guibert,27288,1234122,2022-11-08
CASH_IN,75391,Agence_moov_Ouidah,300000,224609,Marcelle-Valentine Guibert,1234122,1309513,2022-11-08
TRANSFER,29764,Marcelle-Valentine Guibert,1309513,1279749,Marcelle-Valentine Guibert,1309513,1339277,2022-11-09
CASH_OUT,966092,Marcelle-Valentine Guibert,1279749,313657,Agence_moov_Cotonou,300000,-666092,2022-11-09
CASH_OUT,152710,Marcelle-Valentine Guibert,313657,160947,Agence_moov_Cotonou,300000,147290,2022-11-12
TRANSFER,1439999,Anastasie Richard-Neveu,1687000,247001,Marcelle-Valentine Guibert,160947,1600946,2022-11-13
CASH_IN,122641,Agence_moov_Cotonou,300000,177359,Marcelle-Valentine Guibert,1600946,1723587,2022-11-13
CASH_IN,1645,Agence_moov_Ouidah,300000,298355,Marcelle-Valentine Guibert,1723587,1725232,2022-11-14
CASH_OUT,1647726,Marcelle-Valentine Guibert,1725232,77506,Agence_moov_Cotonou,300000,-1347726,2022-11-14
CASH_IN,201316,Agence_moov_Cotonou,300000,98684,Marcelle-Valentine Guibert,77506,278822,2022-11-17
CASH_OUT,196859,Marcelle-Valentine Guibert,278822,81963,Agence_moov_Abomey,300000,103141,2022-11-18
CASH_IN,10959,Agence_moov_Cotonou,300000,289041,Marcelle-Valentine Guibert,81963,92922,2022-11-18
TRANSFER,26984,Marcelle-Valentine Guibert,92922,65938,Tristan Delahaye,760760,733776,2022-11-19
TRANSFER,79309,Colette-Sophie Prévost,121718,42409,Marcelle-Valentine Guibert,65938,145247,2022-11-20
CASH_OUT,21782,Marcelle-Valentine Guibert,145247,123465,Agence_moov_Abomey,300000,278218,2022-11-24
CASH_IN,148387,Agence_moov_Abomey,300000,151613,Marcelle-Valentine Guibert,123465,271852,2022-11-24
CASH_OUT,41210,Marcelle-Valentine Guibert,271852,230642,Agence_moov_Cotonou,300000,258790,2022-11-25
TRANSFER,15560,Marcelle-Valentine Guibert,230642,215082,Sabine Pineau,5853,-9707,2022-11-26
CASH_IN,136017,Agence_moov_Cotonou,300000,163983,Marcelle-Valentine Guibert,215082,351099,2022-11-27
CASH_IN,78329,Agence_moov_Cotonou,300000,221671,Benoît Guyot,539000,617329,2022-11-02
TRANSFER,116056,Benoît Guyot,617329,501273,Hélène Le Chauvin,82629,-33427,2022-11-03
CASH_OUT,396421,Benoît Guyot,501273,104852,Agence_moov_Abomey,300000,-96421,2022-11-04
TRANSFER,1266451,Frédérique Fernandes du Bouchet,1566609,300158,Benoît Guyot,104852,1371303,2022-11-06
TRANSFER,543965,Benoît Guyot,1371303,827338,Léon Da Costa,1144700,600735,2022-11-06
CASH_IN,32518,Agence_moov_Cotonou,300000,267482,Benoît Guyot,827338,859856,2022-11-09
TRANSFER,146944,Benoît Guyot,859856,712912,Mathilde Picard du Delmas,362752,215808,2022-11-09
CASH_OUT,93380,Benoît Guyot,712912,619532,Agence_moov_Ouidah,300000,206620,2022-11-09
CASH_IN,280086,Agence_moov_Ouidah,300000,19914,Benoît Guyot,619532,899618,2022-11-09
CASH_IN,112101,Agence_moov_Cotonou,300000,187899,Benoît Guyot,899618,1011719,2022-11-10
CASH_IN,186823,Agence_moov_Cotonou,300000,113177,Benoît Guyot,1011719,1198542,2022-11-10
CASH_IN,86352,Agence_moov_Cotonou,300000,213648,Benoît Guyot,1198542,1284894,2022-11-11
CASH_IN,216461,Agence_moov_Ouidah,300000,83539,Benoît Guyot,1284894,1501355,2022-11-11
TRANSFER,1237400,Benoît Guyot,1501355,263955,Vincent Joubert,947800,-289600,2022-11-12
CASH_OUT,36701,Benoît Guyot,263955,227254,Agence_moov_Ouidah,300000,263299,2022-11-12
CASH_OUT,50550,Benoît Guyot,227254,176704,Agence_moov_Ouidah,300000,249450,2022-11-12
CASH_IN,53596,Agence_moov_Ouidah,300000,246404,Benoît Guyot,176704,230300,2022-11-15
TRANSFER,370097,Gabriel Bègue,495700,125603,Benoît Guyot,230300,600397,2022-11-16
CASH_OUT,9602,Benoît Guyot,600397,590795,Agence_moov_Ouidah,300000,290398,2022-11-18
CASH_IN,286224,Agence_moov_Ouidah,300000,13776,Benoît Guyot,590795,877019,2022-11-19
CASH_IN,203698,Agence_moov_Abomey,300000,96302,Benoît Guyot,877019,1080717,2022-11-19
TRANSFER,587749,Benoît Guyot,1080717,492968,Émile-René Baudry,13700,-574049,2022-11-19
CASH_OUT,430098,Benoît Guyot,492968,62870,Agence_moov_Cotonou,300000,-130098,2022-11-20
CASH_OUT,32472,Benoît Guyot,62870,30398,Agence_moov_Cotonou,300000,267528,2022-11-22
CASH_IN,274962,Agence_moov_Ouidah,300000,25038,Benoît Guyot,30398,305360,2022-11-23
CASH_IN,72022,Agence_moov_Ouidah,300000,227978,Benoît Guyot,305360,377382,2022-11-24
TRANSFER,68773,Léon Da Costa,600735,531962,Benoît Guyot,377382,446155,2022-11-25
TRANSFER,84727,Benoît Guyot,446155,361428,Nicolas Salmon Le Hamon,1030900,946173,2022-11-25
CASH_OUT,117942,Benoît Guyot,361428,243486,Agence_moov_Ouidah,300000,182058,2022-11-26
CASH_IN,6143,Agence_moov_Ouidah,300000,293857,Manon Lebon,-36102,-29959,2022-11-01
CASH_IN,13200,Agence_moov_Cotonou,300000,286800,Manon Lebon,-29959,-16759,2022-11-02
CASH_IN,78588,Agence_moov_Ouidah,300000,221412,Manon Lebon,-16759,61829,2022-11-03
CASH_OUT,22619,Manon Lebon,61829,39210,Agence_moov_Cotonou,300000,277381,2022-11-05
CASH_IN,230711,Agence_moov_Abomey,300000,69289,Manon Lebon,39210,269921,2022-11-05
CASH_OUT,102756,Manon Lebon,269921,167165,Agence_moov_Abomey,300000,197244,2022-11-06
CASH_OUT,40695,Manon Lebon,167165,126470,Agence_moov_Cotonou,300000,259305,2022-11-08
CASH_OUT,103948,Manon Lebon,126470,22522,Agence_moov_Cotonou,300000,196052,2022-11-08
CASH_OUT,10203,Manon Lebon,22522,12319,Agence_moov_Ouidah,300000,289797,2022-11-08
TRANSFER,9995,Manon Lebon,12319,2324,Camille Morvan,998634,988639,2022-11-10
CASH_IN,44541,Agence_moov_Cotonou,300000,255459,Manon Lebon,2324,46865,2022-11-11
CASH_IN,161990,Agence_moov_Abomey,300000,138010,Manon Lebon,46865,208855,2022-11-12
TRANSFER,551364,Antoinette de Dupuis,578275,26911,Manon Lebon,208855,760219,2022-11-12
CASH_OUT,316875,Manon Lebon,760219,443344,Agence_moov_Ouidah,300000,-16875,2022-11-12
CASH_IN,295237,Agence_moov_Ouidah,300000,4763,Manon Lebon,443344,738581,2022-11-12
TRANSFER,719098,Manon Lebon,738581,19483,Simone Muller de la Brun,1118100,399002,2022-11-13
CASH_OUT,1406,Manon Lebon,19483,18077,Agence_moov_Abomey,300000,298594,2022-11-13
CASH_OUT,11377,Manon Lebon,18077,6700,Agence_moov_Cotonou,300000,288623,2022-11-14
CASH_OUT,4788,Manon Lebon,6700,1912,Agence_moov_Ouidah,300000,295212,2022-11-17
CASH_IN,33291,Agence_moov_Abomey,300000,266709,Manon Lebon,1912,35203,2022-11-17
TRANSFER,18382,Manon Lebon,35203,16821,Paul Perez,1144600,1126218,2022-11-20
TRANSFER,529280,Marc Leleu,553400,24120,Manon Lebon,16821,546101,2022-11-21
CASH_IN,145803,Agence_moov_Abomey,300000,154197,Manon Lebon,546101,691904,2022-11-21
CASH_IN,157769,Agence_moov_Ouidah,300000,142231,Manon Lebon,691904,849673,2022-11-22
TRANSFER,782933,Manon Lebon,849673,66740,Vincent de la Dumont,1392000,609067,2022-11-22
CASH_IN,171257,Agence_moov_Abomey,300000,128743,Manon Lebon,66740,237997,2022-11-22
CASH_OUT,55400,Manon Lebon,237997,182597,Agence_moov_Ouidah,300000,244600,2022-11-22
CASH_IN,131116,Agence_moov_Abomey,300000,168884,Manon Lebon,182597,313713,2022-11-24
CASH_IN,202894,Agence_moov_Abomey,300000,97106,Manon Lebon,313713,516607,2022-11-26
TRANSFER,360974,Anne Peltier-Raynaud,936300,575326,Noémi Bouvier,71470,-289504,2022-11-02
CASH_OUT,293097,Anne Peltier-Raynaud,575326,282229,Agence_moov_Cotonou,300000,6903,2022-11-03
TRANSFER,618765,Thomas-Robert Morvan,1131045,512280,Anne Peltier-Raynaud,282229,900994,2022-11-04
CASH_OUT,73173,Anne Peltier-Raynaud,900994,827821,Agence_moov_Abomey,300000,226827,2022-11-04
CASH_IN,76775,Agence_moov_Ouidah,300000,223225,Anne Peltier-Raynaud,827821,904596,2022-11-04
CASH_OUT,698621,Anne Peltier-Raynaud,904596,205975,Agence_moov_Cotonou,300000,-398621,2022-11-05
CASH_IN,171912,Agence_moov_Abomey,300000,128088,Anne Peltier-Raynaud,205975,377887,2022-11-05
TRANSFER,148738,Thomas Guichard du Renault,618452,469714,Anne Peltier-Raynaud,377887,526625,2022-11-06
CASH_IN,273032,Agence_moov_Abomey,300000,26968,Anne Peltier-Raynaud,526625,799657,2022-11-07
CASH_IN,248242,Agence_moov_Ouidah,300000,51758,Anne Peltier-Raynaud,799657,1047899,2022-11-07
CASH_IN,190766,Agence_moov_Abomey,300000,109234,Anne Peltier-Raynaud,1047899,1238665,2022-11-08
TRANSFER,287499,Raymond Lévy,452961,165462,Anne Peltier-Raynaud,1238665,1526164,2022-11-09
CASH_IN,163931,Agence_moov_Abomey,300000,136069,Anne Peltier-Raynaud,1526164,1690095,2022-11-14
TRANSFER,607281,Anne Peltier-Raynaud,1690095,1082814,Renée Rousseau-Henry,31366,-575915,2022-11-14
TRANSFER,826610,Victor Michel,1505800,679190,Anne Peltier-Raynaud,1082814,1909424,2022-11-15
CASH_OUT,1154761,Anne Peltier-Raynaud,1909424,754663,Agence_moov_Cotonou,300000,-854761,2022-11-17
CASH_IN,108865,Agence_moov_Cotonou,300000,191135,Anne Peltier-Raynaud,754663,863528,2022-11-18
CASH_OUT,304282,Anne Peltier-Raynaud,863528,559246,Agence_moov_Cotonou,300000,-4282,2022-11-18
CASH_OUT,421176,Anne Peltier-Raynaud,559246,138070,Agence_moov_Cotonou,300000,-121176,2022-11-19
CASH_IN,162693,Agence_moov_Ouidah,300000,137307,Anne Peltier-Raynaud,138070,300763,2022-11-19
CASH_OUT,240481,Anne Peltier-Raynaud,300763,60282,Agence_moov_Abomey,300000,59519,2022-11-19
CASH_IN,14521,Agence_moov_Cotonou,300000,285479,Anne Peltier-Raynaud,60282,74803,2022-11-20
CASH_IN,165996,Agence_moov_Cotonou,300000,134004,Anne Peltier-Raynaud,74803,240799,2022-11-21
CASH_IN,2688,Agence_moov_Abomey,300000,297312,Anne Peltier-Raynaud,240799,243487,2022-11-23
CASH_IN,87476,Agence_moov_Cotonou,300000,212524,Anne Peltier-Raynaud,243487,330963,2022-11-23
CASH_IN,291679,Agence_moov_Abomey,300000,8321,Anne Peltier-Raynaud,330963,622642,2022-11-24
CASH_IN,31044,Agence_moov_Abomey,300000,268956,Anne Peltier-Raynaud,622642,653686,2022-11-24
CASH_OUT,86956,Anne Peltier-Raynaud,653686,566730,Agence_moov_Cotonou,300000,213044,2022-11-25
TRANSFER,508679,Lucie Aubert,822900,314221,Colette-Sophie Prévost,42409,551088,2022-11-01
CASH_OUT,523174,Colette-Sophie Prévost,551088,27914,Agence_moov_Abomey,300000,-223174,2022-11-01
TRANSFER,641419,Michelle de Étienne,1851572,1210153,Colette-Sophie Prévost,27914,669333,2022-11-03
CASH_IN,137722,Agence_moov_Cotonou,300000,162278,Colette-Sophie Prévost,669333,807055,2022-11-05
CASH_OUT,723872,Colette-Sophie Prévost,807055,83183,Agence_moov_Abomey,300000,-423872,2022-11-06
CASH_IN,153742,Agence_moov_Ouidah,300000,146258,Colette-Sophie Prévost,83183,236925,2022-11-07
TRANSFER,266063,Nath Loiseau,297900,31837,Colette-Sophie Prévost,236925,502988,2022-11-07
TRANSFER,34027,Vincent de la Dumont,609067,575040,Colette-Sophie Prévost,502988,537015,2022-11-08
CASH_IN,183212,Agence_moov_Abomey,300000,116788,Colette-Sophie Prévost,537015,720227,2022-11-08
TRANSFER,623657,Colette-Sophie Prévost,720227,96570,André Renault,1417565,793908,2022-11-09
CASH_IN,299691,Agence_moov_Ouidah,300000,309,Colette-Sophie Prévost,96570,396261,2022-11-10
TRANSFER,180880,Maggie Martinez,279230,98350,Colette-Sophie Prévost,396261,577141,2022-11-10
TRANSFER,8429,Marc Leleu,24120,15691,Colette-Sophie Prévost,577141,585570,2022-11-12
TRANSFER,583715,Colette-Sophie Prévost,585570,1855,Nicolas Salmon Le Hamon,946173,362458,2022-11-12
TRANSFER,134793,Mathilde Picard du Delmas,215808,81015,Colette-Sophie Prévost,1855,136648,2022-11-12
CASH_IN,172508,Agence_moov_Abomey,300000,127492,Colette-Sophie Prévost,136648,309156,2022-11-14
CASH_IN,56610,Agence_moov_Ouidah,300000,243390,Colette-Sophie Prévost,309156,365766,2022-11-15
CASH_IN,9859,Agence_moov_Abomey,300000,290141,Colette-Sophie Prévost,365766,375625,2022-11-16
TRANSFER,286787,Astrid Lecoq,692100,405313,Colette-Sophie Prévost,375625,662412,2022-11-16
CASH_IN,103075,Agence_moov_Abomey,300000,196925,Colette-Sophie Prévost,662412,765487,2022-11-18
TRANSFER,9381,Colette-Sophie Prévost,765487,756106,Michel Bouchet,1238513,1229132,2022-11-20
TRANSFER,831324,Véronique Martins de Fleury,1068800,237476,Colette-Sophie Prévost,756106,1587430,2022-11-22
CASH_IN,144323,Agence_moov_Cotonou,300000,155677,Colette-Sophie Prévost,1587430,1731753,2022-11-23
TRANSFER,358,Simone Muller de la Brun,399002,398644,Colette-Sophie Prévost,1731753,1732111,2022-11-23
CASH_IN,25351,Agence_moov_Cotonou,300000,274649,Colette-Sophie Prévost,1732111,1757462,2022-11-25
TRANSFER,1124775,Colette-Sophie Prévost,1757462,632687,Jules Fernandes,874900,-249875,2022-11-26
CASH_OUT,426721,Colette-Sophie Prévost,632687,205966,Agence_moov_Cotonou,300000,-126721,2022-11-26
TRANSFER,1147454,Constance Guillon,1415238,267784,Colette-Sophie Prévost,205966,1353420,2022-11-27
TRANSFER,579303,Colette-Sophie Prévost,1353420,774117,Thomas de Blin,65400,-513903,2022-11-27
TRANSFER,61985,Rémy Grondin,182946,120961,Anastasie Richard-Neveu,247001,308986,2022-11-01
TRANSFER,15171,Anastasie Richard-Neveu,308986,293815,Céline Collin-Hervé,1735500,1720329,2022-11-01
TRANSFER,259162,Camille Morvan,988639,729477,Anastasie Richard-Neveu,293815,552977,2022-11-02
CASH_OUT,400128,Anastasie Richard-Neveu,552977,152849,Agence_moov_Abomey,300000,-100128,2022-11-03
CASH_IN,72601,Agence_moov_Abomey,300000,227399,Anastasie Richard-Neveu,152849,225450,2022-11-04
CASH_IN,106448,Agence_moov_Ouidah,300000,193552,Anastasie Richard-Neveu,225450,331898,2022-11-04
CASH_OUT,98819,Anastasie Richard-Neveu,331898,233079,Agence_moov_Cotonou,300000,201181,2022-11-05
TRANSFER,35629,Anastasie Richard-Neveu,233079,197450,Maggie Martinez,98350,62721,2022-11-09
CASH_IN,193915,Agence_moov_Abomey,300000,106085,Anastasie Richard-Neveu,197450,391365,2022-11-10
CASH_OUT,211071,Anastasie Richard-Neveu,391365,180294,Agence_moov_Abomey,300000,88929,2022-11-11
TRANSFER,108623,Anastasie Richard-Neveu,180294,71671,Émilie du Allain,1617320,1508697,2022-11-11
TRANSFER,123195,Frédéric Guillou,138010,14815,Anastasie Richard-Neveu,71671,194866,2022-11-12
TRANSFER,75009,Anastasie Richard-Neveu,194866,119857,Lucy Gillet,733500,658491,2022-11-14
CASH_OUT,110056,Anastasie Richard-Neveu,119857,9801,Agence_moov_Cotonou,300000,189944,2022-11-15
CASH_IN,239368,Agence_moov_Ouidah,300000,60632,Anastasie Richard-Neveu,9801,249169,2022-11-16
CASH_IN,568,Agence_moov_Cotonou,300000,299432,Anastasie Richard-Neveu,249169,249737,2022-11-17
CASH_OUT,136105,Anastasie Richard-Neveu,249737,113632,Agence_moov_Abomey,300000,163895,2022-11-17
CASH_OUT,109395,Anastasie Richard-Neveu,113632,4237,Agence_moov_Abomey,300000,190605,2022-11-19
CASH_OUT,3367,Anastasie Richard-Neveu,4237,870,Agence_moov_Ouidah,300000,296633,2022-11-20
TRANSFER,416369,Léon Da Costa,531962,115593,Anastasie Richard-Neveu,870,417239,2022-11-21
TRANSFER,310660,Anastasie Richard-Neveu,417239,106579,Émilie du Allain,1508697,1198037,2022-11-21
CASH_OUT,75963,Anastasie Richard-Neveu,106579,30616,Agence_moov_Abomey,300000,224037,2022-11-23
CASH_IN,79219,Agence_moov_Cotonou,300000,220781,Anastasie Richard-Neveu,30616,109835,2022-11-23
CASH_IN,282036,Agence_moov_Abomey,300000,17964,Anastasie Richard-Neveu,109835,391871,2022-11-25
TRANSFER,83571,Anastasie Richard-Neveu,391871,308300,Luc Lévêque-Carre,1691800,1608229,2022-11-26
CASH_OUT,324066,Céline Collin-Hervé,1720329,1396263,Agence_moov_Ouidah,300000,-24066,2022-11-03
CASH_IN,110514,Agence_moov_Cotonou,300000,189486,Céline Collin-Hervé,1396263,1506777,2022-11-04
TRANSFER,205483,Céline Collin-Hervé,1506777,1301294,Camille Morvan,729477,523994,2022-11-04
CASH_IN,115999,Agence_moov_Ouidah,300000,184001,Céline Collin-Hervé,1301294,1417293,2022-11-05
TRANSFER,915034,Céline Collin-Hervé,1417293,502259,Renée Le Diaz,945200,30166,2022-11-06
CASH_IN,61887,Agence_moov_Abomey,300000,238113,Céline Collin-Hervé,502259,564146,2022-11-07
CASH_OUT,558152,Céline Collin-Hervé,564146,5994,Agence_moov_Abomey,300000,-258152,2022-11-10
TRANSFER,183935,Thomas Dupont,1306800,1122865,Céline Collin-Hervé,5994,189929,2022-11-10
TRANSFER,56618,Céline Collin-Hervé,189929,133311,Astrid Lecoq,405313,348695,2022-11-11
CASH_IN,22185,Agence_moov_Ouidah,300000,277815,Céline Collin-Hervé,133311,155496,2022-11-12
CASH_IN,184625,Agence_moov_Cotonou,300000,115375,Céline Collin-Hervé,155496,340121,2022-11-12
TRANSFER,138517,Céline Collin-Hervé,340121,201604,Victor Michel,679190,540673,2022-11-12
CASH_OUT,109014,Céline Collin-Hervé,201604,92590,Agence_moov_Cotonou,300000,190986,2022-11-12
TRANSFER,24050,Céline Collin-Hervé,92590,68540,Richard Michel,1338029,1313979,2022-11-14
TRANSFER,467855,Thérèse François,1862200,1394345,Céline Collin-Hervé,68540,536395,2022-11-17
TRANSFER,133881,Céline Collin-Hervé,536395,402514,Constance Guillon,267784,133903,2022-11-17
TRANSFER,266399,Céline Collin-Hervé,402514,136115,Vincent de la Dumont,575040,308641,2022-11-18
CASH_IN,261440,Agence_moov_Ouidah,300000,38560,Céline Collin-Hervé,136115,397555,2022-11-20
TRANSFER,25668,Céline Collin-Hervé,397555,371887,Mathilde Picard du Delmas,81015,55347,2022-11-20
CASH_OUT,234279,Céline Collin-Hervé,371887,137608,Agence_moov_Abomey,300000,65721,2022-11-21
CASH_IN,129957,Agence_moov_Cotonou,300000,170043,Céline Collin-Hervé,137608,267565,2022-11-22
TRANSFER,58295,Céline Collin-Hervé,267565,209270,Raymond Lévy,165462,107167,2022-11-22
TRANSFER,42264,Céline Collin-Hervé,209270,167006,Véronique Martins de Fleury,237476,195212,2022-11-26
CASH_IN,205171,Agence_moov_Abomey,300000,94829,Céline Collin-Hervé,167006,372177,2022-11-27
CASH_OUT,144617,Céline Collin-Hervé,372177,227560,Agence_moov_Ouidah,300000,155383,2022-11-27
TRANSFER,50589,Véronique Martins de Fleury,195212,144623,Véronique Martins de Fleury,195212,245801,2022-11-01
TRANSFER,100498,Thérèse François,1394345,1293847,Véronique Martins de Fleury,144623,245121,2022-11-02
CASH_IN,27308,Agence_moov_Ouidah,300000,272692,Véronique Martins de Fleury,245121,272429,2022-11-03
CASH_OUT,182374,Véronique Martins de Fleury,272429,90055,Agence_moov_Abomey,300000,117626,2022-11-04
CASH_IN,234594,Agence_moov_Ouidah,300000,65406,Véronique Martins de Fleury,90055,324649,2022-11-04
CASH_OUT,17787,Véronique Martins de Fleury,324649,306862,Agence_moov_Ouidah,300000,282213,2022-11-05
TRANSFER,24148,Antoinette de Dupuis,26911,2763,Véronique Martins de Fleury,306862,331010,2022-11-05
CASH_OUT,53074,Véronique Martins de Fleury,331010,277936,Agence_moov_Ouidah,300000,246926,2022-11-08
CASH_IN,49281,Agence_moov_Ouidah,300000,250719,Véronique Martins de Fleury,277936,327217,2022-11-08
CASH_IN,190845,Agence_moov_Cotonou,300000,109155,Véronique Martins de Fleury,327217,518062,2022-11-10
CASH_OUT,408899,Véronique Martins de Fleury,518062,109163,Agence_moov_Ouidah,300000,-108899,2022-11-10
CASH_IN,194379,Agence_moov_Ouidah,300000,105621,Véronique Martins de Fleury,109163,303542,2022-11-11
TRANSFER,135873,Véronique Martins de Fleury,303542,167669,Paulette Loiseau,476500,340627,2022-11-13
CASH_IN,156175,Agence_moov_Abomey,300000,143825,Véronique Martins de Fleury,167669,323844,2022-11-13
CASH_IN,85462,Agence_moov_Cotonou,300000,214538,Véronique Martins de Fleury,323844,409306,2022-11-14
CASH_IN,272903,Agence_moov_Abomey,300000,27097,Véronique Martins de Fleury,409306,682209,2022-11-15
CASH_IN,113806,Agence_moov_Abomey,300000,186194,Véronique Martins de Fleury,682209,796015,2022-11-16
CASH_IN,291714,Agence_moov_Cotonou,300000,8286,Véronique Martins de Fleury,796015,1087729,2022-11-17
CASH_OUT,858334,Véronique Martins de Fleury,1087729,229395,Agence_moov_Cotonou,300000,-558334,2022-11-17
CASH_IN,145152,Agence_moov_Abomey,300000,154848,Véronique Martins de Fleury,229395,374547,2022-11-17
TRANSFER,488021,Thomas-Robert Morvan,512280,24259,Véronique Martins de Fleury,374547,862568,2022-11-18
CASH_OUT,396294,Véronique Martins de Fleury,862568,466274,Agence_moov_Ouidah,300000,-96294,2022-11-21
CASH_IN,275753,Agence_moov_Ouidah,300000,24247,Véronique Martins de Fleury,466274,742027,2022-11-22
CASH_IN,259707,Agence_moov_Cotonou,300000,40293,Véronique Martins de Fleury,742027,1001734,2022-11-24
TRANSFER,46062,Mathilde Picard du Delmas,55347,9285,Véronique Martins de Fleury,1001734,1047796,2022-11-25
CASH_OUT,823372,Véronique Martins de Fleury,1047796,224424,Agence_moov_Ouidah,300000,-523372,2022-11-27
CASH_IN,253848,Agence_moov_Ouidah,300000,46152,Tristan Delahaye,733776,987624,2022-11-01
CASH_IN,71729,Agence_moov_Cotonou,300000,228271,Tristan Delahaye,987624,1059353,2022-11-03
TRANSFER,57668,Victor Michel,540673,483005,Tristan Delahaye,1059353,1117021,2022-11-06
CASH_OUT,691797,Tristan Delahaye,1117021,425224,Agence_moov_Abomey,300000,-391797,2022-11-07
CASH_IN,24291,Agence_moov_Cotonou,300000,275709,Tristan Delahaye,425224,449515,2022-11-07
CASH_OUT,348446,Tristan Delahaye,449515,101069,Agence_moov_Ouidah,300000,-48446,2022-11-09
CASH_IN,75861,Agence_moov_Abomey,300000,224139,Tristan Delahaye,101069,176930,2022-11-09
CASH_OUT,125695,Tristan Delahaye,176930,51235,Agence_moov_Cotonou,300000,174305,2022-11-10
CASH_IN,204217,Agence_moov_Abomey,300000,95783,Tristan Delahaye,51235,255452,2022-11-11
TRANSFER,553796,Thibaut de la Roy,1436700,882904,Tristan Delahaye,255452,809248,2022-11-13
CASH_IN,148709,Agence_moov_Cotonou,300000,151291,Tristan Delahaye,809248,957957,2022-11-13
CASH_OUT,516388,Tristan Delahaye,957957,441569,Agence_moov_Abomey,300000,-216388,2022-11-14
CASH_OUT,252574,Tristan Delahaye,441569,188995,Agence_moov_Cotonou,300000,47426,2022-11-14
TRANSFER,1040641,Luc Lévêque-Carre,1608229,567588,Tristan Delahaye,188995,1229636,2022-11-15
TRANSFER,165203,Lucie Aubert,314221,149018,Tristan Delahaye,1229636,1394839,2022-11-16
CASH_IN,122505,Agence_moov_Abomey,300000,177495,Tristan Delahaye,1394839,1517344,2022-11-16
TRANSFER,138150,Paul Rocher-Maillet,1119749,981599,Tristan Delahaye,1517344,1655494,2022-11-17
TRANSFER,11621,Bernard Maurice,101914,90293,Tristan Delahaye,1655494,1667115,2022-11-18
CASH_OUT,904095,Tristan Delahaye,1667115,763020,Agence_moov_Ouidah,300000,-604095,2022-11-20
CASH_OUT,270231,Tristan Delahaye,763020,492789,Agence_moov_Cotonou,300000,29769,2022-11-21
CASH_OUT,436460,Tristan Delahaye,492789,56329,Agence_moov_Ouidah,300000,-136460,2022-11-21
CASH_OUT,47784,Tristan Delahaye,56329,8545,Agence_moov_Ouidah,300000,252216,2022-11-22
CASH_OUT,5372,Tristan Delahaye,8545,3173,Agence_moov_Cotonou,300000,294628,2022-11-23
TRANSFER,1005,Tristan Delahaye,3173,2168,Constance Guillon,133903,132898,2022-11-26
TRANSFER,250641,Astrid Lecoq,348695,98054,André Renault,793908,1044549,2022-11-01
CASH_OUT,491159,André Renault,1044549,553390,Agence_moov_Abomey,300000,-191159,2022-11-01
CASH_IN,90261,Agence_moov_Abomey,300000,209739,André Renault,553390,643651,2022-11-02
CASH_OUT,485755,André Renault,643651,157896,Agence_moov_Abomey,300000,-185755,2022-11-06
CASH_IN,259315,Agence_moov_Abomey,300000,40685,André Renault,157896,417211,2022-11-07
CASH_IN,47936,Agence_moov_Ouidah,300000,252064,André Renault,417211,465147,2022-11-08
CASH_OUT,429246,André Renault,465147,35901,Agence_moov_Ouidah,300000,-129246,2022-11-09
CASH_IN,50009,Agence_moov_Cotonou,300000,249991,André Renault,35901,85910,2022-11-09
CASH_IN,14166,Agence_moov_Ouidah,300000,285834,André Renault,85910,100076,2022-11-10
CASH_IN,74091,Agence_moov_Abomey,300000,225909,André Renault,100076,174167,2022-11-10
CASH_OUT,157706,André Renault,174167,16461,Agence_moov_Cotonou,300000,142294,2022-11-11
TRANSFER,3323,André Renault,16461,13138,Marthe Gilles,165100,161777,2022-11-11
TRANSFER,1036950,Alphonse Gomes,1687600,650650,André Renault,13138,1050088,2022-11-12
CASH_OUT,565034,André Renault,1050088,485054,Agence_moov_Ouidah,300000,-265034,2022-11-12
CASH_OUT,33544,André Renault,485054,451510,Agence_moov_Ouidah,300000,266456,2022-11-13
CASH_IN,166915,Agence_moov_Ouidah,300000,133085,André Renault,451510,618425,2022-11-13
TRANSFER,68280,Marthe Gilles,161777,93497,André Renault,618425,686705,2022-11-14
CASH_OUT,656,André Renault,686705,686049,Agence_moov_Ouidah,300000,299344,2022-11-14
CASH_OUT,479743,André Renault,686049,206306,Agence_moov_Abomey,300000,-179743,2022-11-16
CASH_OUT,30837,André Renault,206306,175469,Agence_moov_Ouidah,300000,269163,2022-11-18
CASH_IN,98919,Agence_moov_Ouidah,300000,201081,André Renault,175469,274388,2022-11-19
CASH_OUT,35514,André Renault,274388,238874,Agence_moov_Cotonou,300000,264486,2022-11-19
TRANSFER,486756,Aimé Pages,845400,358644,André Renault,238874,725630,2022-11-20
CASH_IN,235797,Agence_moov_Cotonou,300000,64203,André Renault,725630,961427,2022-11-22
CASH_OUT,226232,André Renault,961427,735195,Agence_moov_Ouidah,300000,73768,2022-11-23
TRANSFER,571755,André Renault,735195,163440,Bernard Maurice,90293,-481462,2022-11-25
CASH_IN,21994,Agence_moov_Ouidah,300000,278006,André Renault,163440,185434,2022-11-25
TRANSFER,21437,Renée Le Diaz,30166,8729,André Renault,185434,206871,2022-11-26
CASH_OUT,639544,Lucy Lamy,983300,343756,Agence_moov_Ouidah,300000,-339544,2022-11-01
CASH_OUT,161943,Lucy Lamy,343756,181813,Agence_moov_Cotonou,300000,138057,2022-11-03
CASH_IN,44236,Agence_moov_Abomey,300000,255764,Lucy Lamy,181813,226049,2022-11-04
CASH_IN,147122,Agence_moov_Abomey,300000,152878,Lucy Lamy,226049,373171,2022-11-05
CASH_IN,77500,Agence_moov_Ouidah,300000,222500,Lucy Lamy,373171,450671,2022-11-07
CASH_OUT,383829,Lucy Lamy,450671,66842,Agence_moov_Ouidah,300000,-83829,2022-11-07
TRANSFER,14810,Marc Leleu,15691,881,Lucy Lamy,66842,81652,2022-11-08
TRANSFER,12429,Lucy Lamy,81652,69223,Mathilde Picard du Delmas,9285,-3144,2022-11-08
TRANSFER,66759,Lucy Lamy,69223,2464,Robert Laroche,870684,803925,2022-11-08
CASH_OUT,2046,Lucy Lamy,2464,418,Agence_moov_Abomey,300000,297954,2022-11-11
CASH_OUT,118,Lucy Lamy,418,300,Agence_moov_Cotonou,300000,299882,2022-11-11
CASH_IN,132270,Agence_moov_Cotonou,300000,167730,Lucy Lamy,300,132570,2022-11-12
CASH_OUT,10558,Lucy Lamy,132570,122012,Agence_moov_Cotonou,300000,289442,2022-11-14
CASH_OUT,106778,Lucy Lamy,122012,15234,Agence_moov_Ouidah,300000,193222,2022-11-14
CASH_OUT,15054,Lucy Lamy,15234,180,Agence_moov_Cotonou,300000,284946,2022-11-15
TRANSFER,115,Lucy Lamy,180,65,Victor Michel,483005,482890,2022-11-16
CASH_IN,34784,Agence_moov_Cotonou,300000,265216,Lucy Lamy,65,34849,2022-11-16
CASH_OUT,3227,Lucy Lamy,34849,31622,Agence_moov_Abomey,300000,296773,2022-11-17
TRANSFER,528533,Richard Michel,1313979,785446,Lucy Lamy,31622,560155,2022-11-17
CASH_OUT,544673,Lucy Lamy,560155,15482,Agence_moov_Cotonou,300000,-244673,2022-11-17
TRANSFER,11487,Lucy Lamy,15482,3995,Maggie Martinez,62721,51234,2022-11-18
TRANSFER,516,Lucy Lamy,3995,3479,Michel Bouchet,1229132,1228616,2022-11-18
CASH_OUT,479,Lucy Lamy,3479,3000,Agence_moov_Ouidah,300000,299521,2022-11-18
TRANSFER,2454,Lucy Lamy,3000,546,Robert Clerc,455783,453329,2022-11-20
CASH_IN,253007,Agence_moov_Abomey,300000,46993,Lucy Lamy,546,253553,2022-11-21
CASH_OUT,218436,Lucy Lamy,253553,35117,Agence_moov_Ouidah,300000,81564,2022-11-26
CASH_IN,207395,Agence_moov_Ouidah,300000,92605,Manon Valette,-4481,202914,2022-11-01
CASH_IN,220203,Agence_moov_Cotonou,300000,79797,Manon Valette,202914,423117,2022-11-01
TRANSFER,110059,Manon Valette,423117,313058,Thomas Dupont,1122865,1012806,2022-11-02
CASH_OUT,162048,Manon Valette,313058,151010,Agence_moov_Abomey,300000,137952,2022-11-03
CASH_OUT,76001,Manon Valette,151010,75009,Agence_moov_Cotonou,300000,223999,2022-11-03
TRANSFER,369160,Thibaut de la Roy,882904,513744,Manon Valette,75009,444169,2022-11-05
CASH_OUT,187304,Manon Valette,444169,256865,Agence_moov_Abomey,300000,112696,2022-11-06
CASH_OUT,147405,Manon Valette,256865,109460,Agence_moov_Cotonou,300000,152595,2022-11-07
CASH_IN,202526,Agence_moov_Abomey,300000,97474,Manon Valette,109460,311986,2022-11-08
CASH_OUT,253700,Manon Valette,311986,58286,Agence_moov_Ouidah,300000,46300,2022-11-09
CASH_IN,171081,Agence_moov_Abomey,300000,128919,Manon Valette,58286,229367,2022-11-10
CASH_IN,82785,Agence_moov_Abomey,300000,217215,Manon Valette,229367,312152,2022-11-10
TRANSFER,260587,Manon Valette,312152,51565,Paul Perez,1126218,865631,2022-11-12
CASH_IN,82290,Agence_moov_Abomey,300000,217710,Manon Valette,51565,133855,2022-11-13
TRANSFER,30659,Manon Valette,133855,103196,Théodore Joseph-Lefebvre,828200,797541,2022-11-15
CASH_OUT,13979,Manon Valette,103196,89217,Agence_moov_Abomey,300000,286021,2022-11-16
CASH_OUT,52614,Manon Valette,89217,36603,Agence_moov_Abomey,300000,247386,2022-11-16
TRANSFER,451988,Thomas Guichard du Renault,469714,17726,Manon Valette,36603,488591,2022-11-20
CASH_IN,37071,Agence_moov_Cotonou,300000,262929,Manon Valette,488591,525662,2022-11-20
CASH_IN,247369,Agence_moov_Abomey,300000,52631,Manon Valette,525662,773031,2022-11-21
TRANSFER,631333,Manon Valette,773031,141698,Robert Clerc,453329,-178004,2022-11-21
CASH_IN,133664,Agence_moov_Abomey,300000,166336,Manon Valette,141698,275362,2022-11-21
CASH_IN,237590,Agence_moov_Cotonou,300000,62410,Manon Valette,275362,512952,2022-11-23
CASH_OUT,96047,Manon Valette,512952,416905,Agence_moov_Abomey,300000,203953,2022-11-23
TRANSFER,28041,Manon Valette,416905,388864,Frédérique Fernandes du Bouchet,300158,272117,2022-11-23
CASH_IN,182369,Agence_moov_Cotonou,300000,117631,Manon Valette,388864,571233,2022-11-24
CASH_IN,261418,Agence_moov_Cotonou,300000,38582,Manon Valette,571233,832651,2022-11-24
CASH_IN,20085,Agence_moov_Cotonou,300000,279915,Manon Valette,832651,852736,2022-11-24
TRANSFER,333021,Manon Valette,852736,519715,Vincent de la Dumont,308641,-24380,2022-11-25
CASH_OUT,129919,Manon Valette,519715,389796,Agence_moov_Ouidah,300000,170081,2022-11-26
CASH_IN,277369,Agence_moov_Cotonou,300000,22631,Bernard Maurice,-481462,-204093,2022-11-01
CASH_IN,194422,Agence_moov_Cotonou,300000,105578,Bernard Maurice,-204093,-9671,2022-11-03
CASH_IN,195773,Agence_moov_Cotonou,300000,104227,Bernard Maurice,-9671,186102,2022-11-03
CASH_IN,263207,Agence_moov_Abomey,300000,36793,Bernard Maurice,186102,449309,2022-11-03
TRANSFER,38877,Marthe Gilles,93497,54620,Bernard Maurice,449309,488186,2022-11-04
TRANSFER,167549,Bernard Maurice,488186,320637,Jules-Roland Bousquet,1666300,1498751,2022-11-04
CASH_OUT,319327,Bernard Maurice,320637,1310,Agence_moov_Abomey,300000,-19327,2022-11-05
CASH_OUT,230,Bernard Maurice,1310,1080,Agence_moov_Ouidah,300000,299770,2022-11-06
CASH_IN,247482,Agence_moov_Ouidah,300000,52518,Bernard Maurice,1080,248562,2022-11-08
TRANSFER,1168500,Michel Bouchet,1228616,60116,Bernard Maurice,248562,1417062,2022-11-09
TRANSFER,332836,Bernard Maurice,1417062,1084226,Émilie du Allain,1198037,865201,2022-11-09
TRANSFER,339265,Bernard Maurice,1084226,744961,Rémy Grondin,120961,-218304,2022-11-09
CASH_OUT,497062,Bernard Maurice,744961,247899,Agence_moov_Cotonou,300000,-197062,2022-11-12
TRANSFER,390560,Alphonse Gomes,650650,260090,Bernard Maurice,247899,638459,2022-11-12
CASH_IN,206842,Agence_moov_Cotonou,300000,93158,Bernard Maurice,638459,845301,2022-11-13
TRANSFER,98687,Thérèse François,1293847,1195160,Bernard Maurice,845301,943988,2022-11-13
TRANSFER,864966,Bernard Maurice,943988,79022,Victor Michel,482890,-382076,2022-11-14
CASH_OUT,39070,Bernard Maurice,79022,39952,Agence_moov_Ouidah,300000,260930,2022-11-14
CASH_OUT,17486,Bernard Maurice,39952,22466,Agence_moov_Ouidah,300000,282514,2022-11-14
TRANSFER,10346,Bernard Maurice,22466,12120,Thibaut de la Roy,513744,503398,2022-11-17
CASH_OUT,5607,Bernard Maurice,12120,6513,Agence_moov_Cotonou,300000,294393,2022-11-17
CASH_IN,192435,Agence_moov_Ouidah,300000,107565,Bernard Maurice,6513,198948,2022-11-18
CASH_OUT,185534,Bernard Maurice,198948,13414,Agence_moov_Cotonou,300000,114466,2022-11-18
CASH_OUT,4804,Bernard Maurice,13414,8610,Agence_moov_Abomey,300000,295196,2022-11-22
TRANSFER,5711,Bernard Maurice,8610,2899,Manon Chevalier,1614184,1608473,2022-11-22
CASH_OUT,167502,Camille Morvan,523994,356492,Agence_moov_Abomey,300000,132498,2022-11-01
CASH_IN,49769,Agence_moov_Ouidah,300000,250231,Camille Morvan,356492,406261,2022-11-02
CASH_OUT,248852,Camille Morvan,406261,157409,Agence_moov_Cotonou,300000,51148,2022-11-02
CASH_IN,155279,Agence_moov_Abomey,300000,144721,Camille Morvan,157409,312688,2022-11-04
TRANSFER,265602,Camille Morvan,312688,47086,Matthieu-Matthieu Bigot,433567,167965,2022-11-04
CASH_OUT,7394,Camille Morvan,47086,39692,Agence_moov_Cotonou,300000,292606,2022-11-07
CASH_IN,108930,Agence_moov_Abomey,300000,191070,Camille Morvan,39692,148622,2022-11-07
CASH_OUT,32063,Camille Morvan,148622,116559,Agence_moov_Abomey,300000,267937,2022-11-08
CASH_OUT,107932,Camille Morvan,116559,8627,Agence_moov_Ouidah,300000,192068,2022-11-08
CASH_OUT,7903,Camille Morvan,8627,724,Agence_moov_Ouidah,300000,292097,2022-11-10
CASH_OUT,380,Camille Morvan,724,344,Agence_moov_Cotonou,300000,299620,2022-11-11
CASH_OUT,233,Camille Morvan,344,111,Agence_moov_Cotonou,300000,299767,2022-11-11
TRANSFER,27829,Nath Loiseau,31837,4008,Camille Morvan,111,27940,2022-11-12
CASH_OUT,15932,Camille Morvan,27940,12008,Agence_moov_Ouidah,300000,284068,2022-11-12
TRANSFER,5452,Camille Morvan,12008,6556,Luc Lévêque-Carre,567588,562136,2022-11-14
CASH_OUT,6006,Camille Morvan,6556,550,Agence_moov_Abomey,300000,293994,2022-11-14
TRANSFER,278,Camille Morvan,550,272,Gabriel Bègue,125603,125325,2022-11-16
TRANSFER,167,Camille Morvan,272,105,Thomas Guichard du Renault,17726,17559,2022-11-16
TRANSFER,103,Camille Morvan,105,2,Camille Morvan,105,208,2022-11-18
CASH_IN,8431,Agence_moov_Abomey,300000,291569,Camille Morvan,2,8433,2022-11-18
CASH_OUT,498,Camille Morvan,8433,7935,Agence_moov_Abomey,300000,299502,2022-11-19
CASH_OUT,974,Camille Morvan,7935,6961,Agence_moov_Cotonou,300000,299026,2022-11-20
CASH_IN,69630,Agence_moov_Ouidah,300000,230370,Camille Morvan,6961,76591,2022-11-20
TRANSFER,121894,Nicolas Salmon Le Hamon,362458,240564,Camille Morvan,76591,198485,2022-11-22
CASH_OUT,53768,Camille Morvan,198485,144717,Agence_moov_Cotonou,300000,246232,2022-11-23
CASH_IN,286904,Agence_moov_Abomey,300000,13096,Camille Morvan,144717,431621,2022-11-27
CASH_OUT,522,Marc Leleu,881,359,Agence_moov_Ouidah,300000,299478,2022-11-01
CASH_OUT,166,Marc Leleu,359,193,Agence_moov_Abomey,300000,299834,2022-11-02
TRANSFER,16280,Frédérique Fernandes du Bouchet,272117,255837,Marc Leleu,193,16473,2022-11-03
CASH_OUT,10772,Marc Leleu,16473,5701,Agence_moov_Ouidah,300000,289228,2022-11-07
TRANSFER,511,Marc Leleu,5701,5190,Nath Loiseau,4008,3497,2022-11-07
TRANSFER,217930,Alphonse Gomes,260090,42160,Marc Leleu,5190,223120,2022-11-11
CASH_IN,137752,Agence_moov_Abomey,300000,162248,Marc Leleu,223120,360872,2022-11-12
CASH_OUT,31725,Marc Leleu,360872,329147,Agence_moov_Cotonou,300000,268275,2022-11-12
CASH_OUT,207520,Marc Leleu,329147,121627,Agence_moov_Ouidah,300000,92480,2022-11-13
CASH_IN,21373,Agence_moov_Cotonou,300000,278627,Marc Leleu,121627,143000,2022-11-15
CASH_OUT,14059,Marc Leleu,143000,128941,Agence_moov_Ouidah,300000,285941,2022-11-18
TRANSFER,189061,Nicolas Salmon Le Hamon,240564,51503,Marc Leleu,128941,318002,2022-11-21
CASH_OUT,107304,Marc Leleu,318002,210698,Agence_moov_Abomey,300000,192696,2022-11-22
CASH_IN,282996,Agence_moov_Cotonou,300000,17004,Marc Leleu,210698,493694,2022-11-22
TRANSFER,79487,Marc Leleu,493694,414207,Simone Muller de la Brun,398644,319157,2022-11-23
TRANSFER,554327,Manon Chevalier,1608473,1054146,Marc Leleu,414207,968534,2022-11-23
TRANSFER,35723,Gabriel Bègue,125325,89602,Marc Leleu,968534,1004257,2022-11-23
TRANSFER,826869,Marc Leleu,1004257,177388,Nath Loiseau,3497,-823372,2022-11-23
CASH_OUT,136674,Marc Leleu,177388,40714,Agence_moov_Ouidah,300000,163326,2022-11-24
CASH_OUT,28499,Marc Leleu,40714,12215,Agence_moov_Ouidah,300000,271501,2022-11-25
CASH_OUT,10051,Marc Leleu,12215,2164,Agence_moov_Ouidah,300000,289949,2022-11-26
TRANSFER,95439,Luc Lévêque-Carre,562136,466697,Robert Laroche,803925,899364,2022-11-01
TRANSFER,309156,Robert Laroche,899364,590208,Frédérique Fernandes du Bouchet,255837,-53319,2022-11-01
TRANSFER,30540,Marthe Gilles,54620,24080,Robert Laroche,590208,620748,2022-11-02
CASH_OUT,89659,Robert Laroche,620748,531089,Agence_moov_Ouidah,300000,210341,2022-11-03
TRANSFER,340417,Thérèse Hubert,1189513,849096,Robert Laroche,531089,871506,2022-11-05
TRANSFER,222584,Robert Laroche,871506,648922,Constance Guillon,132898,-89686,2022-11-06
TRANSFER,322634,Thérèse Hubert,849096,526462,Robert Laroche,648922,971556,2022-11-09
TRANSFER,3810,Frédéric Guillou,14815,11005,Robert Laroche,971556,975366,2022-11-10
CASH_IN,147814,Agence_moov_Abomey,300000,152186,Robert Laroche,975366,1123180,2022-11-10
CASH_OUT,426102,Robert Laroche,1123180,697078,Agence_moov_Abomey,300000,-126102,2022-11-12
TRANSFER,9459,Thomas-Robert Morvan,24259,14800,Robert Laroche,697078,706537,2022-11-12
TRANSFER,25635,Léon Da Costa,115593,89958,Robert Laroche,706537,732172,2022-11-13
CASH_OUT,690322,Robert Laroche,732172,41850,Agence_moov_Abomey,300000,-390322,2022-11-15
CASH_IN,238668,Agence_moov_Abomey,300000,61332,Robert Laroche,41850,280518,2022-11-16
TRANSFER,266293,Aimé Pages,358644,92351,Robert Laroche,280518,546811,2022-11-17
TRANSFER,517845,Robert Laroche,546811,28966,Jules-Roland Bousquet,1498751,980906,2022-11-20
TRANSFER,2296,Robert Laroche,28966,26670,Renée Le Diaz,8729,6433,2022-11-20
CASH_OUT,11751,Robert Laroche,26670,14919,Agence_moov_Ouidah,300000,288249,2022-11-22
TRANSFER,9694,Jules-Roland Bousquet,980906,971212,Robert Laroche,14919,24613,2022-11-22
TRANSFER,5461,Frédéric Guillou,11005,5544,Robert Laroche,24613,30074,2022-11-23
CASH_IN,127283,Agence_moov_Abomey,300000,172717,Robert Laroche,30074,157357,2022-11-24
CASH_OUT,60513,Robert Laroche,157357,96844,Agence_moov_Abomey,300000,239487,2022-11-25
CASH_IN,20581,Agence_moov_Abomey,300000,279419,Robert Laroche,96844,117425,2022-11-25
TRANSFER,85624,Robert Laroche,117425,31801,Maggie Martinez,51234,-34390,2022-11-26
CASH_OUT,23141,Robert Laroche,31801,8660,Agence_moov_Cotonou,300000,276859,2022-11-26
CASH_OUT,3517,Robert Laroche,8660,5143,Agence_moov_Abomey,300000,296483,2022-11-27
CASH_IN,127113,Agence_moov_Cotonou,300000,172887,Renée Rousseau-Henry,-575915,-448802,2022-11-01
CASH_IN,103366,Agence_moov_Cotonou,300000,196634,Renée Rousseau-Henry,-448802,-345436,2022-11-02
CASH_IN,122268,Agence_moov_Abomey,300000,177732,Renée Rousseau-Henry,-345436,-223168,2022-11-02
CASH_IN,83722,Agence_moov_Ouidah,300000,216278,Renée Rousseau-Henry,-223168,-139446,2022-11-04
CASH_IN,95495,Agence_moov_Abomey,300000,204505,Renée Rousseau-Henry,-139446,-43951,2022-11-08
CASH_IN,235143,Agence_moov_Ouidah,300000,64857,Renée Rousseau-Henry,-43951,191192,2022-11-09
TRANSFER,69260,Renée Rousseau-Henry,191192,121932,Thomas Dupont,1012806,943546,2022-11-09
CASH_OUT,111566,Renée Rousseau-Henry,121932,10366,Agence_moov_Ouidah,300000,188434,2022-11-09
TRANSFER,3920,Frédéric Guillou,5544,1624,Renée Rousseau-Henry,10366,14286,2022-11-10
TRANSFER,6659,Renée Rousseau-Henry,14286,7627,Frédéric Guillou,1624,-5035,2022-11-11
CASH_OUT,2597,Renée Rousseau-Henry,7627,5030,Agence_moov_Cotonou,300000,297403,2022-11-11
CASH_OUT,2055,Renée Rousseau-Henry,5030,2975,Agence_moov_Abomey,300000,297945,2022-11-13
TRANSFER,1819,Renée Rousseau-Henry,2975,1156,Paul Rocher-Maillet,981599,979780,2022-11-15
CASH_IN,29567,Agence_moov_Cotonou,300000,270433,Renée Rousseau-Henry,1156,30723,2022-11-16
TRANSFER,9344,Renée Rousseau-Henry,30723,21379,Paul Perez,865631,856287,2022-11-17
CASH_OUT,13406,Renée Rousseau-Henry,21379,7973,Agence_moov_Abomey,300000,286594,2022-11-18
CASH_OUT,4737,Renée Rousseau-Henry,7973,3236,Agence_moov_Abomey,300000,295263,2022-11-18
CASH_OUT,3178,Renée Rousseau-Henry,3236,58,Agence_moov_Ouidah,300000,296822,2022-11-19
CASH_IN,151677,Agence_moov_Cotonou,300000,148323,Renée Rousseau-Henry,58,151735,2022-11-19
CASH_OUT,66114,Renée Rousseau-Henry,151735,85621,Agence_moov_Ouidah,300000,233886,2022-11-20
TRANSFER,25289,Renée Rousseau-Henry,85621,60332,Thomas Dupont,943546,918257,2022-11-21
CASH_OUT,26460,Renée Rousseau-Henry,60332,33872,Agence_moov_Abomey,300000,273540,2022-11-22
CASH_IN,137457,Agence_moov_Cotonou,300000,162543,Renée Rousseau-Henry,33872,171329,2022-11-23
CASH_OUT,117481,Renée Rousseau-Henry,171329,53848,Agence_moov_Cotonou,300000,182519,2022-11-23
CASH_IN,95878,Agence_moov_Cotonou,300000,204122,Renée Rousseau-Henry,53848,149726,2022-11-23
TRANSFER,14915,Thomas Guichard du Renault,17559,2644,Renée Rousseau-Henry,149726,164641,2022-11-24
CASH_IN,243552,Agence_moov_Ouidah,300000,56448,Renée Rousseau-Henry,164641,408193,2022-11-25
CASH_OUT,592,Renée Le Diaz,6433,5841,Agence_moov_Cotonou,300000,299408,2022-11-01
CASH_OUT,3087,Renée Le Diaz,5841,2754,Agence_moov_Abomey,300000,296913,2022-11-01
CASH_IN,298970,Agence_moov_Cotonou,300000,1030,Renée Le Diaz,2754,301724,2022-11-02
CASH_IN,213641,Agence_moov_Cotonou,300000,86359,Renée Le Diaz,301724,515365,2022-11-03
TRANSFER,462622,Renée Le Diaz,515365,52743,Paul Rocher-Maillet,979780,517158,2022-11-04
TRANSFER,238917,Simone Muller de la Brun,319157,80240,Renée Le Diaz,52743,291660,2022-11-04
CASH_IN,10559,Agence_moov_Abomey,300000,289441,Renée Le Diaz,291660,302219,2022-11-06
TRANSFER,217567,Michelle de Étienne,1210153,992586,Renée Le Diaz,302219,519786,2022-11-08
CASH_IN,6999,Agence_moov_Cotonou,300000,293001,Renée Le Diaz,519786,526785,2022-11-10
TRANSFER,120980,Renée Le Diaz,526785,405805,Jules-Roland Bousquet,971212,850232,2022-11-11
CASH_IN,283734,Agence_moov_Cotonou,300000,16266,Renée Le Diaz,405805,689539,2022-11-11
CASH_IN,179067,Agence_moov_Ouidah,300000,120933,Renée Le Diaz,689539,868606,2022-11-11
TRANSFER,7376,Simone Muller de la Brun,80240,72864,Renée Le Diaz,868606,875982,2022-11-12
CASH_IN,12662,Agence_moov_Abomey,300000,287338,Renée Le Diaz,875982,888644,2022-11-13
CASH_IN,237721,Agence_moov_Ouidah,300000,62279,Renée Le Diaz,888644,1126365,2022-11-14
CASH_IN,267001,Agence_moov_Cotonou,300000,32999,Renée Le Diaz,1126365,1393366,2022-11-16
CASH_OUT,547550,Renée Le Diaz,1393366,845816,Agence_moov_Ouidah,300000,-247550,2022-11-17
CASH_IN,133808,Agence_moov_Ouidah,300000,166192,Renée Le Diaz,845816,979624,2022-11-17
CASH_OUT,728418,Renée Le Diaz,979624,251206,Agence_moov_Cotonou,300000,-428418,2022-11-18
CASH_IN,102504,Agence_moov_Ouidah,300000,197496,Renée Le Diaz,251206,353710,2022-11-18
CASH_OUT,120177,Renée Le Diaz,353710,233533,Agence_moov_Cotonou,300000,179823,2022-11-20
CASH_OUT,193067,Renée Le Diaz,233533,40466,Agence_moov_Cotonou,300000,106933,2022-11-20
CASH_OUT,35667,Renée Le Diaz,40466,4799,Agence_moov_Abomey,300000,264333,2022-11-21
CASH_OUT,810,Renée Le Diaz,4799,3989,Agence_moov_Cotonou,300000,299190,2022-11-23
CASH_IN,41690,Agence_moov_Abomey,300000,258310,Renée Le Diaz,3989,45679,2022-11-23
CASH_IN,125216,Agence_moov_Abomey,300000,174784,Renée Le Diaz,45679,170895,2022-11-26
CASH_OUT,131764,Renée Le Diaz,170895,39131,Agence_moov_Ouidah,300000,168236,2022-11-27
CASH_OUT,19280,Renée Le Diaz,39131,19851,Agence_moov_Cotonou,300000,280720,2022-11-27
CASH_OUT,21580,Alphonse Gomes,42160,20580,Agence_moov_Abomey,300000,278420,2022-11-08
TRANSFER,5972,Alphonse Gomes,20580,14608,Aimé Pages,92351,86379,2022-11-12
CASH_OUT,1230,Alphonse Gomes,14608,13378,Agence_moov_Abomey,300000,298770,2022-11-13
CASH_OUT,12871,Alphonse Gomes,13378,507,Agence_moov_Ouidah,300000,287129,2022-11-17
CASH_IN,134299,Agence_moov_Abomey,300000,165701,Alphonse Gomes,507,134806,2022-11-21
CASH_IN,90210,Agence_moov_Cotonou,300000,209790,Alphonse Gomes,134806,225016,2022-11-27
CASH_OUT,55123,Alphonse Gomes,225016,169893,Agence_moov_Cotonou,300000,244877,2022-11-27
TRANSFER,57920,Aimé Pages,86379,28459,Raymond Lévy,107167,165087,2022-11-08
CASH_OUT,120687,Raymond Lévy,165087,44400,Agence_moov_Cotonou,300000,179313,2022-11-10
CASH_IN,138883,Agence_moov_Abomey,300000,161117,Raymond Lévy,44400,183283,2022-11-15
TRANSFER,126047,Raymond Lévy,183283,57236,Paul Perez,856287,730240,2022-11-18
CASH_OUT,930,Raymond Lévy,57236,56306,Agence_moov_Abomey,300000,299070,2022-11-23
CASH_OUT,42728,Raymond Lévy,56306,13578,Agence_moov_Ouidah,300000,257272,2022-11-24
CASH_OUT,1494,Raymond Lévy,13578,12084,Agence_moov_Ouidah,300000,298506,2022-11-25
CASH_IN,41253,Agence_moov_Cotonou,300000,258747,Raymond Lévy,12084,53337,2022-11-27
CASH_OUT,527787,Émilie du Allain,865201,337414,Agence_moov_Ouidah,300000,-227787,2022-11-01
TRANSFER,47872,Gabriel Bègue,89602,41730,Émilie du Allain,337414,385286,2022-11-03
CASH_OUT,48411,Émilie du Allain,385286,336875,Agence_moov_Cotonou,300000,251589,2022-11-06
CASH_IN,195272,Agence_moov_Abomey,300000,104728,Émilie du Allain,336875,532147,2022-11-06
TRANSFER,355897,Émilie du Allain,532147,176250,Hélène de la Gérard,778935,423038,2022-11-11
CASH_OUT,153280,Émilie du Allain,176250,22970,Agence_moov_Abomey,300000,146720,2022-11-18
TRANSFER,9461,Émilie du Allain,22970,13509,Thomas Guichard du Renault,2644,-6817,2022-11-18
CASH_IN,271625,Agence_moov_Ouidah,300000,28375,Émilie du Allain,13509,285134,2022-11-24
CASH_OUT,136528,Émilie du Allain,285134,148606,Agence_moov_Cotonou,300000,163472,2022-11-26
CASH_IN,267684,Agence_moov_Cotonou,300000,32316,Lucie Aubert,149018,416702,2022-11-02
CASH_OUT,227189,Lucie Aubert,416702,189513,Agence_moov_Abomey,300000,72811,2022-11-04
TRANSFER,290946,Paul Rocher-Maillet,517158,226212,Lucie Aubert,189513,480459,2022-11-05
CASH_OUT,54212,Lucie Aubert,480459,426247,Agence_moov_Abomey,300000,245788,2022-11-10
CASH_OUT,125813,Lucie Aubert,426247,300434,Agence_moov_Cotonou,300000,174187,2022-11-12
TRANSFER,17645,Aimé Pages,28459,10814,Lucie Aubert,300434,318079,2022-11-12
CASH_IN,147950,Agence_moov_Ouidah,300000,152050,Lucie Aubert,318079,466029,2022-11-14
CASH_OUT,170978,Jules-Roland Bousquet,850232,679254,Agence_moov_Abomey,300000,129022,2022-11-02
TRANSFER,10350,Léon Da Costa,89958,79608,Jules-Roland Bousquet,679254,689604,2022-11-02
TRANSFER,30472,Gabriel Bègue,41730,11258,Jules-Roland Bousquet,689604,720076,2022-11-10
TRANSFER,53027,Astrid Lecoq,98054,45027,Jules-Roland Bousquet,720076,773103,2022-11-10
CASH_OUT,504134,Jules-Roland Bousquet,773103,268969,Agence_moov_Cotonou,300000,-204134,2022-11-11
CASH_OUT,62674,Jules-Roland Bousquet,268969,206295,Agence_moov_Abomey,300000,237326,2022-11-13
TRANSFER,388477,Thérèse Hubert,526462,137985,Jules-Roland Bousquet,206295,594772,2022-11-15
CASH_IN,27280,Agence_moov_Ouidah,300000,272720,Manon Chevalier,1054146,1081426,2022-11-01
CASH_IN,55254,Agence_moov_Ouidah,300000,244746,Manon Chevalier,1081426,1136680,2022-11-05
CASH_IN,115600,Agence_moov_Cotonou,300000,184400,Manon Chevalier,1136680,1252280,2022-11-05
TRANSFER,38085,Michel Bouchet,60116,22031,Manon Chevalier,1252280,1290365,2022-11-05
CASH_IN,237659,Agence_moov_Ouidah,300000,62341,Manon Chevalier,1290365,1528024,2022-11-08
CASH_OUT,578835,Manon Chevalier,1528024,949189,Agence_moov_Ouidah,300000,-278835,2022-11-11
TRANSFER,551033,Manon Chevalier,949189,398156,Marthe Gilles,24080,-526953,2022-11-18
CASH_OUT,233982,Manon Chevalier,398156,164174,Agence_moov_Cotonou,300000,66018,2022-11-20
CASH_IN,93344,Agence_moov_Ouidah,300000,206656,Manon Chevalier,164174,257518,2022-11-21
CASH_OUT,193212,Manon Chevalier,257518,64306,Agence_moov_Ouidah,300000,106788,2022-11-21
CASH_OUT,38940,Manon Chevalier,64306,25366,Agence_moov_Ouidah,300000,261060,2022-11-22
TRANSFER,16036,Manon Chevalier,25366,9330,Thérèse Hubert,137985,121949,2022-11-23
CASH_OUT,497,Manon Chevalier,9330,8833,Agence_moov_Abomey,300000,299503,2022-11-27
CASH_IN,237355,Agence_moov_Cotonou,300000,62645,Astrid Lecoq,45027,282382,2022-11-04
CASH_IN,259545,Agence_moov_Ouidah,300000,40455,Astrid Lecoq,282382,541927,2022-11-05
CASH_IN,60398,Agence_moov_Abomey,300000,239602,Astrid Lecoq,541927,602325,2022-11-06
CASH_OUT,91852,Astrid Lecoq,602325,510473,Agence_moov_Cotonou,300000,208148,2022-11-07
CASH_IN,193362,Agence_moov_Cotonou,300000,106638,Astrid Lecoq,510473,703835,2022-11-07
TRANSFER,191467,Paulette Loiseau,340627,149160,Astrid Lecoq,703835,895302,2022-11-18
CASH_OUT,218311,Astrid Lecoq,895302,676991,Agence_moov_Ouidah,300000,81689,2022-11-19
CASH_IN,220984,Agence_moov_Ouidah,300000,79016,Astrid Lecoq,676991,897975,2022-11-22
CASH_OUT,732857,Astrid Lecoq,897975,165118,Agence_moov_Ouidah,300000,-432857,2022-11-22
TRANSFER,45455,Paulette Loiseau,149160,103705,Astrid Lecoq,165118,210573,2022-11-23
CASH_OUT,197170,Astrid Lecoq,210573,13403,Agence_moov_Cotonou,300000,102830,2022-11-25
CASH_OUT,8688,Astrid Lecoq,13403,4715,Agence_moov_Abomey,300000,291312,2022-11-25
CASH_IN,243,Agence_moov_Abomey,300000,299757,Astrid Lecoq,4715,4958,2022-11-26
CASH_IN,70325,Agence_moov_Abomey,300000,229675,Thomas Guichard du Renault,-6817,63508,2022-11-03
CASH_OUT,35220,Thomas Guichard du Renault,63508,28288,Agence_moov_Ouidah,300000,264780,2022-11-03
TRANSFER,5740,Léon Da Costa,79608,73868,Thomas Guichard du Renault,28288,34028,2022-11-10
CASH_OUT,25536,Thomas Guichard du Renault,34028,8492,Agence_moov_Abomey,300000,274464,2022-11-15
TRANSFER,8287,Michelle de Étienne,992586,984299,Thomas Guichard du Renault,8492,16779,2022-11-17
CASH_IN,72074,Agence_moov_Abomey,300000,227926,Thomas Guichard du Renault,16779,88853,2022-11-18
CASH_OUT,44029,Thomas Guichard du Renault,88853,44824,Agence_moov_Cotonou,300000,255971,2022-11-22
CASH_IN,52361,Agence_moov_Cotonou,300000,247639,Thomas-Robert Morvan,14800,67161,2022-11-02
CASH_OUT,30278,Thomas-Robert Morvan,67161,36883,Agence_moov_Abomey,300000,269722,2022-11-02
CASH_OUT,11382,Thomas-Robert Morvan,36883,25501,Agence_moov_Cotonou,300000,288618,2022-11-02
CASH_IN,12794,Agence_moov_Ouidah,300000,287206,Thomas-Robert Morvan,25501,38295,2022-11-05
CASH_IN,231044,Agence_moov_Cotonou,300000,68956,Thomas-Robert Morvan,38295,269339,2022-11-12
TRANSFER,497226,Thomas Dupont,918257,421031,Thomas-Robert Morvan,269339,766565,2022-11-14
TRANSFER,467059,Thomas-Robert Morvan,766565,299506,Matthieu-Matthieu Bigot,167965,-299094,2022-11-20
CASH_OUT,293323,Thomas-Robert Morvan,299506,6183,Agence_moov_Ouidah,300000,6677,2022-11-27
CASH_OUT,702654,Thérèse François,1195160,492506,Agence_moov_Cotonou,300000,-402654,2022-11-01
CASH_IN,210777,Agence_moov_Abomey,300000,89223,Thérèse François,492506,703283,2022-11-02
CASH_IN,193711,Agence_moov_Cotonou,300000,106289,Thérèse François,703283,896994,2022-11-05
TRANSFER,5737,Gabriel Bègue,11258,5521,Thérèse François,896994,902731,2022-11-05
CASH_OUT,837724,Thérèse François,902731,65007,Agence_moov_Cotonou,300000,-537724,2022-11-07
CASH_OUT,31181,Thérèse François,65007,33826,Agence_moov_Cotonou,300000,268819,2022-11-10
CASH_OUT,21201,Thérèse François,33826,12625,Agence_moov_Cotonou,300000,278799,2022-11-11
TRANSFER,58090,Paulette Loiseau,103705,45615,Thérèse François,12625,70715,2022-11-12
CASH_OUT,28029,Thérèse François,70715,42686,Agence_moov_Cotonou,300000,271971,2022-11-12
TRANSFER,557670,Lucy Gillet,658491,100821,Thérèse François,42686,600356,2022-11-13
TRANSFER,154717,Luc Lévêque-Carre,466697,311980,Thérèse François,600356,755073,2022-11-18
CASH_OUT,616303,Thérèse François,755073,138770,Agence_moov_Ouidah,300000,-316303,2022-11-19
TRANSFER,65270,Paul Rocher-Maillet,226212,160942,Thérèse François,138770,204040,2022-11-20
CASH_OUT,35142,Thérèse François,204040,168898,Agence_moov_Cotonou,300000,264858,2022-11-25
CASH_OUT,46396,Thérèse François,168898,122502,Agence_moov_Abomey,300000,253604,2022-11-25
CASH_IN,55809,Agence_moov_Abomey,300000,244191,Thérèse François,122502,178311,2022-11-26
CASH_IN,16661,Agence_moov_Abomey,300000,283339,Thérèse François,178311,194972,2022-11-26
CASH_IN,73199,Agence_moov_Cotonou,300000,226801,Thomas de Blin,-513903,-440704,2022-11-11
CASH_IN,233853,Agence_moov_Cotonou,300000,66147,Thomas de Blin,-440704,-206851,2022-11-12
CASH_IN,168898,Agence_moov_Cotonou,300000,131102,Thomas de Blin,-206851,-37953,2022-11-13
CASH_IN,284980,Agence_moov_Abomey,300000,15020,Thomas de Blin,-37953,247027,2022-11-15
CASH_OUT,87339,Thomas de Blin,247027,159688,Agence_moov_Cotonou,300000,212661,2022-11-17
CASH_IN,258460,Agence_moov_Abomey,300000,41540,Thomas de Blin,159688,418148,2022-11-18
CASH_IN,218790,Agence_moov_Ouidah,300000,81210,Thomas de Blin,418148,636938,2022-11-24
CASH_IN,148080,Agence_moov_Ouidah,300000,151920,Thomas de Blin,636938,785018,2022-11-25
CASH_IN,221089,Agence_moov_Cotonou,300000,78911,Thomas de Blin,785018,1006107,2022-11-25
TRANSFER,40714,Léon Da Costa,73868,33154,Léon Da Costa,73868,33154,2022-11-05
CASH_OUT,26536,Léon Da Costa,33154,6618,Agence_moov_Abomey,300000,273464,2022-11-05
TRANSFER,6439,Paul Rocher-Maillet,160942,154503,Léon Da Costa,6618,13057,2022-11-06
TRANSFER,12511,Léon Da Costa,13057,546,Nicolas Salmon Le Hamon,51503,38992,2022-11-07
TRANSFER,95285,Lucy Gillet,100821,5536,Léon Da Costa,546,95831,2022-11-08
CASH_OUT,45331,Léon Da Costa,95831,50500,Agence_moov_Abomey,300000,254669,2022-11-12
CASH_OUT,49263,Léon Da Costa,50500,1237,Agence_moov_Ouidah,300000,250737,2022-11-15
CASH_OUT,156,Léon Da Costa,1237,1081,Agence_moov_Cotonou,300000,299844,2022-11-19
CASH_OUT,197,Léon Da Costa,1081,884,Agence_moov_Abomey,300000,299803,2022-11-25
CASH_IN,188711,Agence_moov_Ouidah,300000,111289,Jules Fernandes,-249875,-61164,2022-11-01
CASH_IN,1138,Agence_moov_Abomey,300000,298862,Jules Fernandes,-61164,-60026,2022-11-02
CASH_IN,89345,Agence_moov_Ouidah,300000,210655,Jules Fernandes,-60026,29319,2022-11-03
TRANSFER,9888,Jules Fernandes,29319,19431,Robert-Louis Gosselin,1349900,1340012,2022-11-04
TRANSFER,763076,Richard Michel,785446,22370,Jules Fernandes,19431,782507,2022-11-06
CASH_IN,87998,Agence_moov_Ouidah,300000,212002,Jules Fernandes,782507,870505,2022-11-09
CASH_OUT,528397,Jules Fernandes,870505,342108,Agence_moov_Ouidah,300000,-228397,2022-11-21
CASH_IN,117189,Agence_moov_Ouidah,300000,182811,Jules Fernandes,342108,459297,2022-11-24
CASH_IN,26490,Agence_moov_Cotonou,300000,273510,Jules Fernandes,459297,485787,2022-11-25
CASH_IN,256206,Agence_moov_Abomey,300000,43794,Thérèse Hubert,121949,378155,2022-11-01
CASH_IN,7967,Agence_moov_Cotonou,300000,292033,Thérèse Hubert,378155,386122,2022-11-08
TRANSFER,62645,Simone Muller de la Brun,72864,10219,Thérèse Hubert,386122,448767,2022-11-08
CASH_OUT,331254,Thérèse Hubert,448767,117513,Agence_moov_Abomey,300000,-31254,2022-11-10
CASH_OUT,48263,Thérèse Hubert,117513,69250,Agence_moov_Cotonou,300000,251737,2022-11-10
CASH_OUT,21718,Thérèse Hubert,69250,47532,Agence_moov_Abomey,300000,278282,2022-11-15
TRANSFER,17129,Thérèse Hubert,47532,30403,Paul Perez,730240,713111,2022-11-16
CASH_OUT,9565,Thérèse Hubert,30403,20838,Agence_moov_Abomey,300000,290435,2022-11-18
TRANSFER,15655,Thérèse Hubert,20838,5183,Hélène de la Gérard,423038,407383,2022-11-18
TRANSFER,6992,Aimé Pages,10814,3822,Thérèse Hubert,5183,12175,2022-11-20
CASH_OUT,1320,Thérèse Hubert,12175,10855,Agence_moov_Abomey,300000,298680,2022-11-22
CASH_OUT,2162,Thérèse Hubert,10855,8693,Agence_moov_Cotonou,300000,297838,2022-11-23
CASH_IN,285780,Agence_moov_Abomey,300000,14220,Thérèse Hubert,8693,294473,2022-11-23
CASH_OUT,82859,Thérèse Hubert,294473,211614,Agence_moov_Abomey,300000,217141,2022-11-23
CASH_OUT,44823,Thérèse Hubert,211614,166791,Agence_moov_Abomey,300000,255177,2022-11-24
TRANSFER,995,Aimé Pages,3822,2827,Thomas Dupont,421031,422026,2022-11-01
CASH_OUT,298419,Thomas Dupont,422026,123607,Agence_moov_Ouidah,300000,1581,2022-11-02
TRANSFER,60323,Thomas Dupont,123607,63284,Thomas Dupont,123607,63284,2022-11-02
TRANSFER,53270,Thomas Dupont,63284,10014,Paul Perez,713111,659841,2022-11-05
CASH_OUT,1158,Thomas Dupont,10014,8856,Agence_moov_Abomey,300000,298842,2022-11-06
CASH_IN,159979,Agence_moov_Ouidah,300000,140021,Thomas Dupont,8856,168835,2022-11-08
CASH_IN,93150,Agence_moov_Cotonou,300000,206850,Thomas Dupont,168835,261985,2022-11-12
CASH_IN,270730,Agence_moov_Cotonou,300000,29270,Thomas Dupont,261985,532715,2022-11-12
TRANSFER,338013,Thomas Dupont,532715,194702,Hélène de la Gérard,407383,69370,2022-11-13
CASH_IN,102612,Agence_moov_Ouidah,300000,197388,Thomas Dupont,194702,297314,2022-11-14
CASH_OUT,44017,Thomas Dupont,297314,253297,Agence_moov_Abomey,300000,255983,2022-11-15
CASH_IN,249109,Agence_moov_Cotonou,300000,50891,Thomas Dupont,253297,502406,2022-11-16
CASH_IN,270328,Agence_moov_Cotonou,300000,29672,Thomas Dupont,502406,772734,2022-11-18
TRANSFER,431765,Thomas Dupont,772734,340969,Paul Rocher-Maillet,154503,-277262,2022-11-20
TRANSFER,625290,Michelle de Étienne,984299,359009,Thomas Dupont,340969,966259,2022-11-21
CASH_IN,93133,Agence_moov_Abomey,300000,206867,Thomas Dupont,966259,1059392,2022-11-22
CASH_IN,241297,Agence_moov_Abomey,300000,58703,Thomas Dupont,1059392,1300689,2022-11-27
CASH_IN,85463,Agence_moov_Ouidah,300000,214537,Sabine Pineau,-9707,75756,2022-11-02
CASH_IN,284295,Agence_moov_Cotonou,300000,15705,Sabine Pineau,75756,360051,2022-11-04
CASH_OUT,348619,Sabine Pineau,360051,11432,Agence_moov_Ouidah,300000,-48619,2022-11-04
CASH_OUT,10877,Sabine Pineau,11432,555,Agence_moov_Abomey,300000,289123,2022-11-07
CASH_IN,236135,Agence_moov_Ouidah,300000,63865,Sabine Pineau,555,236690,2022-11-15
CASH_IN,241673,Agence_moov_Cotonou,300000,58327,Sabine Pineau,236690,478363,2022-11-15
TRANSFER,401338,Sabine Pineau,478363,77025,Gabriel Bègue,5521,-395817,2022-11-25
CASH_OUT,5855,Simone Muller de la Brun,10219,4364,Agence_moov_Ouidah,300000,294145,2022-11-04
TRANSFER,120091,Robert-Louis Gosselin,1340012,1219921,Simone Muller de la Brun,4364,124455,2022-11-05
CASH_OUT,33208,Simone Muller de la Brun,124455,91247,Agence_moov_Cotonou,300000,266792,2022-11-07
TRANSFER,55120,Simone Muller de la Brun,91247,36127,Simone Muller de la Brun,91247,146367,2022-11-10
CASH_IN,56042,Agence_moov_Abomey,300000,243958,Simone Muller de la Brun,36127,92169,2022-11-12
CASH_IN,44864,Agence_moov_Abomey,300000,255136,Simone Muller de la Brun,92169,137033,2022-11-13
CASH_OUT,5046,Simone Muller de la Brun,137033,131987,Agence_moov_Cotonou,300000,294954,2022-11-14
CASH_IN,253270,Agence_moov_Ouidah,300000,46730,Simone Muller de la Brun,131987,385257,2022-11-14
TRANSFER,16528,Hélène de la Gérard,69370,52842,Simone Muller de la Brun,385257,401785,2022-11-16
CASH_IN,200794,Agence_moov_Ouidah,300000,99206,Simone Muller de la Brun,401785,602579,2022-11-17
CASH_IN,218822,Agence_moov_Cotonou,300000,81178,Simone Muller de la Brun,602579,821401,2022-11-17
CASH_OUT,7469,Simone Muller de la Brun,821401,813932,Agence_moov_Ouidah,300000,292531,2022-11-18
CASH_IN,215572,Agence_moov_Abomey,300000,84428,Simone Muller de la Brun,813932,1029504,2022-11-22
TRANSFER,39670,Paulette Loiseau,45615,5945,Simone Muller de la Brun,1029504,1069174,2022-11-22
CASH_OUT,1060734,Simone Muller de la Brun,1069174,8440,Agence_moov_Cotonou,300000,-760734,2022-11-23
CASH_IN,44826,Agence_moov_Ouidah,300000,255174,Simone Muller de la Brun,8440,53266,2022-11-23
CASH_OUT,44900,Simone Muller de la Brun,53266,8366,Agence_moov_Ouidah,300000,255100,2022-11-24
CASH_OUT,6598,Simone Muller de la Brun,8366,1768,Agence_moov_Ouidah,300000,293402,2022-11-24
TRANSFER,1502,Simone Muller de la Brun,1768,266,Aimé Pages,2827,1325,2022-11-24
CASH_OUT,159,Simone Muller de la Brun,266,107,Agence_moov_Ouidah,300000,299841,2022-11-25
CASH_IN,56013,Agence_moov_Abomey,300000,243987,Maggie Martinez,-34390,21623,2022-11-04
CASH_IN,458,Agence_moov_Ouidah,300000,299542,Maggie Martinez,21623,22081,2022-11-04
TRANSFER,7342,Maggie Martinez,22081,14739,Luc Lévêque-Carre,311980,304638,2022-11-05
CASH_OUT,12496,Maggie Martinez,14739,2243,Agence_moov_Ouidah,300000,287504,2022-11-06
TRANSFER,886,Maggie Martinez,2243,1357,Lucy Gillet,5536,4650,2022-11-06
CASH_OUT,308,Maggie Martinez,1357,1049,Agence_moov_Cotonou,300000,299692,2022-11-10
TRANSFER,1402,Paulette Loiseau,5945,4543,Maggie Martinez,1049,2451,2022-11-10
CASH_OUT,698,Maggie Martinez,2451,1753,Agence_moov_Abomey,300000,299302,2022-11-12
CASH_OUT,1567,Maggie Martinez,1753,186,Agence_moov_Abomey,300000,298433,2022-11-14
CASH_OUT,114,Maggie Martinez,186,72,Agence_moov_Abomey,300000,299886,2022-11-14
CASH_IN,240267,Agence_moov_Abomey,300000,59733,Maggie Martinez,72,240339,2022-11-15
CASH_OUT,119695,Maggie Martinez,240339,120644,Agence_moov_Ouidah,300000,180305,2022-11-15
TRANSFER,64544,Maggie Martinez,120644,56100,Antoinette de Dupuis,2763,-61781,2022-11-16
CASH_OUT,16008,Maggie Martinez,56100,40092,Agence_moov_Cotonou,300000,283992,2022-11-17
CASH_IN,19989,Agence_moov_Abomey,300000,280011,Maggie Martinez,40092,60081,2022-11-17
CASH_IN,287378,Agence_moov_Ouidah,300000,12622,Maggie Martinez,60081,347459,2022-11-25
CASH_OUT,218813,Maggie Martinez,347459,128646,Agence_moov_Ouidah,300000,81187,2022-11-27
CASH_OUT,2070,Paulette Loiseau,4543,2473,Agence_moov_Ouidah,300000,297930,2022-11-04
CASH_OUT,981,Paulette Loiseau,2473,1492,Agence_moov_Cotonou,300000,299019,2022-11-04
CASH_OUT,1181,Paulette Loiseau,1492,311,Agence_moov_Abomey,300000,298819,2022-11-12
CASH_OUT,168,Paulette Loiseau,311,143,Agence_moov_Cotonou,300000,299832,2022-11-13
CASH_IN,279809,Agence_moov_Cotonou,300000,20191,Paulette Loiseau,143,279952,2022-11-18
CASH_IN,65054,Agence_moov_Ouidah,300000,234946,Paulette Loiseau,279952,345006,2022-11-26
CASH_IN,20684,Agence_moov_Cotonou,300000,279316,Paulette Loiseau,345006,365690,2022-11-27
CASH_IN,181536,Agence_moov_Cotonou,300000,118464,Vincent Joubert,-289600,-108064,2022-11-04
CASH_IN,204203,Agence_moov_Cotonou,300000,95797,Vincent Joubert,-108064,96139,2022-11-04
CASH_OUT,82961,Vincent Joubert,96139,13178,Agence_moov_Abomey,300000,217039,2022-11-08
TRANSFER,43141,Michelle de Étienne,359009,315868,Vincent Joubert,13178,56319,2022-11-16
CASH_OUT,33872,Vincent Joubert,56319,22447,Agence_moov_Abomey,300000,266128,2022-11-17
CASH_OUT,7637,Vincent Joubert,22447,14810,Agence_moov_Abomey,300000,292363,2022-11-17
CASH_OUT,7346,Vincent Joubert,14810,7464,Agence_moov_Ouidah,300000,292654,2022-11-20
CASH_IN,5770,Agence_moov_Ouidah,300000,294230,Vincent Joubert,7464,13234,2022-11-22
CASH_OUT,2515,Vincent Joubert,13234,10719,Agence_moov_Cotonou,300000,297485,2022-11-24
CASH_IN,89650,Agence_moov_Abomey,300000,210350,Nath Loiseau,-823372,-733722,2022-11-06
CASH_IN,198868,Agence_moov_Ouidah,300000,101132,Nath Loiseau,-733722,-534854,2022-11-07
CASH_IN,242549,Agence_moov_Cotonou,300000,57451,Nath Loiseau,-534854,-292305,2022-11-07
CASH_IN,125514,Agence_moov_Cotonou,300000,174486,Nath Loiseau,-292305,-166791,2022-11-08
CASH_IN,173664,Agence_moov_Ouidah,300000,126336,Nath Loiseau,-166791,6873,2022-11-08
CASH_IN,76887,Agence_moov_Cotonou,300000,223113,Nath Loiseau,6873,83760,2022-11-10
CASH_OUT,67133,Nath Loiseau,83760,16627,Agence_moov_Ouidah,300000,232867,2022-11-12
CASH_OUT,12145,Nath Loiseau,16627,4482,Agence_moov_Ouidah,300000,287855,2022-11-14
CASH_OUT,2422,Nath Loiseau,4482,2060,Agence_moov_Abomey,300000,297578,2022-11-15
CASH_OUT,159,Nath Loiseau,2060,1901,Agence_moov_Abomey,300000,299841,2022-11-17
CASH_OUT,1016,Nath Loiseau,1901,885,Agence_moov_Ouidah,300000,298984,2022-11-17
CASH_OUT,378,Nath Loiseau,885,507,Agence_moov_Cotonou,300000,299622,2022-11-18
CASH_IN,155027,Agence_moov_Abomey,300000,144973,Nath Loiseau,507,155534,2022-11-18
CASH_IN,147532,Agence_moov_Ouidah,300000,152468,Nath Loiseau,155534,303066,2022-11-20
TRANSFER,168308,Nath Loiseau,303066,134758,Lucy Gillet,4650,-163658,2022-11-20
CASH_OUT,91196,Nath Loiseau,134758,43562,Agence_moov_Ouidah,300000,208804,2022-11-23
CASH_IN,68871,Agence_moov_Cotonou,300000,231129,Nath Loiseau,43562,112433,2022-11-23
TRANSFER,592856,Paul Perez,659841,66985,Nath Loiseau,112433,705289,2022-11-25
CASH_IN,133823,Agence_moov_Cotonou,300000,166177,Nath Loiseau,705289,839112,2022-11-25
CASH_IN,32398,Agence_moov_Abomey,300000,267602,Nath Loiseau,839112,871510,2022-11-26
CASH_IN,138004,Agence_moov_Abomey,300000,161996,Émile-René Baudry,-574049,-436045,2022-11-02
CASH_IN,79562,Agence_moov_Abomey,300000,220438,Émile-René Baudry,-436045,-356483,2022-11-03
CASH_IN,64855,Agence_moov_Cotonou,300000,235145,Émile-René Baudry,-356483,-291628,2022-11-14
CASH_IN,94293,Agence_moov_Abomey,300000,205707,Émile-René Baudry,-291628,-197335,2022-11-15
CASH_IN,211091,Agence_moov_Abomey,300000,88909,Émile-René Baudry,-197335,13756,2022-11-18
TRANSFER,1426,Émile-René Baudry,13756,12330,Émile-René Baudry,13756,15182,2022-11-23
TRANSFER,9230,Émile-René Baudry,12330,3100,Robert-Louis Gosselin,1219921,1210691,2022-11-24
CASH_IN,7469,Agence_moov_Ouidah,300000,292531,Émile-René Baudry,3100,10569,2022-11-24
CASH_IN,89489,Agence_moov_Abomey,300000,210511,Émile-René Baudry,10569,100058,2022-11-27
CASH_OUT,441429,Thibaut de la Roy,503398,61969,Agence_moov_Ouidah,300000,-141429,2022-11-03
CASH_IN,37511,Agence_moov_Abomey,300000,262489,Thibaut de la Roy,61969,99480,2022-11-06
CASH_IN,123898,Agence_moov_Cotonou,300000,176102,Thibaut de la Roy,99480,223378,2022-11-09
CASH_IN,213568,Agence_moov_Ouidah,300000,86432,Thibaut de la Roy,223378,436946,2022-11-11
CASH_OUT,151723,Thibaut de la Roy,436946,285223,Agence_moov_Cotonou,300000,148277,2022-11-11
CASH_OUT,7662,Thibaut de la Roy,285223,277561,Agence_moov_Cotonou,300000,292338,2022-11-13
TRANSFER,250232,Thibaut de la Roy,277561,27329,Théodore Joseph-Lefebvre,797541,547309,2022-11-15
TRANSFER,10299,Thibaut de la Roy,27329,17030,Théodore Joseph-Lefebvre,547309,537010,2022-11-18
CASH_IN,110334,Agence_moov_Cotonou,300000,189666,Thibaut de la Roy,17030,127364,2022-11-27
CASH_IN,100286,Agence_moov_Cotonou,300000,199714,Victor Michel,-382076,-281790,2022-11-02
CASH_IN,229849,Agence_moov_Ouidah,300000,70151,Victor Michel,-281790,-51941,2022-11-04
CASH_IN,175900,Agence_moov_Abomey,300000,124100,Victor Michel,-51941,123959,2022-11-05
CASH_IN,139566,Agence_moov_Abomey,300000,160434,Victor Michel,123959,263525,2022-11-09
TRANSFER,196804,Victor Michel,263525,66721,Victor Michel,263525,66721,2022-11-10
TRANSFER,21764,Michel Bouchet,22031,267,Victor Michel,66721,88485,2022-11-12
CASH_IN,118987,Agence_moov_Ouidah,300000,181013,Victor Michel,88485,207472,2022-11-17
CASH_IN,33335,Agence_moov_Cotonou,300000,266665,Victor Michel,207472,240807,2022-11-19
TRANSFER,187,Aimé Pages,1325,1138,Victor Michel,240807,240994,2022-11-19
TRANSFER,1071,Aimé Pages,1138,67,Victor Michel,240994,242065,2022-11-19
CASH_IN,143221,Agence_moov_Ouidah,300000,156779,Victor Michel,242065,385286,2022-11-25
CASH_OUT,72784,Victor Michel,385286,312502,Agence_moov_Ouidah,300000,227216,2022-11-27
CASH_IN,21196,Agence_moov_Cotonou,300000,278804,Victor Michel,312502,333698,2022-11-27
CASH_IN,5850,Agence_moov_Abomey,300000,294150,Rémy Grondin,-218304,-212454,2022-11-05
CASH_IN,36652,Agence_moov_Ouidah,300000,263348,Rémy Grondin,-212454,-175802,2022-11-06
CASH_IN,72120,Agence_moov_Cotonou,300000,227880,Rémy Grondin,-175802,-103682,2022-11-12
CASH_IN,121212,Agence_moov_Abomey,300000,178788,Rémy Grondin,-103682,17530,2022-11-17
CASH_OUT,3485,Rémy Grondin,17530,14045,Agence_moov_Abomey,300000,296515,2022-11-18
CASH_OUT,562,Rémy Grondin,14045,13483,Agence_moov_Abomey,300000,299438,2022-11-19
TRANSFER,806,Rémy Grondin,13483,12677,Robert-Louis Gosselin,1210691,1209885,2022-11-19
CASH_OUT,4454,Rémy Grondin,12677,8223,Agence_moov_Ouidah,300000,295546,2022-11-22
CASH_IN,210673,Agence_moov_Cotonou,300000,89327,Rémy Grondin,8223,218896,2022-11-25
CASH_IN,292169,Agence_moov_Ouidah,300000,7831,Frédéric Guillou,-5035,287134,2022-11-02
CASH_OUT,260743,Frédéric Guillou,287134,26391,Agence_moov_Ouidah,300000,39257,2022-11-04
CASH_OUT,534,Frédéric Guillou,26391,25857,Agence_moov_Ouidah,300000,299466,2022-11-04
CASH_OUT,10810,Frédéric Guillou,25857,15047,Agence_moov_Ouidah,300000,289190,2022-11-04
TRANSFER,13208,Nicolas Salmon Le Hamon,38992,25784,Frédéric Guillou,15047,28255,2022-11-06
TRANSFER,21254,Michelle de Étienne,315868,294614,Frédéric Guillou,28255,49509,2022-11-09
TRANSFER,8432,Frédéric Guillou,49509,41077,Paul Perez,66985,58553,2022-11-11
CASH_IN,245157,Agence_moov_Abomey,300000,54843,Frédéric Guillou,41077,286234,2022-11-11
TRANSFER,918783,Robert-Louis Gosselin,1209885,291102,Frédéric Guillou,286234,1205017,2022-11-12
CASH_IN,278923,Agence_moov_Cotonou,300000,21077,Frédéric Guillou,1205017,1483940,2022-11-13
CASH_OUT,1481683,Frédéric Guillou,1483940,2257,Agence_moov_Ouidah,300000,-1181683,2022-11-13
CASH_IN,73804,Agence_moov_Abomey,300000,226196,Frédéric Guillou,2257,76061,2022-11-14
CASH_IN,45161,Agence_moov_Cotonou,300000,254839,Frédéric Guillou,76061,121222,2022-11-14
CASH_IN,88097,Agence_moov_Abomey,300000,211903,Frédéric Guillou,121222,209319,2022-11-16
TRANSFER,21208,Richard Michel,22370,1162,Frédéric Guillou,209319,230527,2022-11-18
TRANSFER,43762,Frédéric Guillou,230527,186765,Michelle de Étienne,294614,250852,2022-11-23
TRANSFER,504,Richard Michel,1162,658,Frédéric Guillou,186765,187269,2022-11-23
CASH_OUT,10150,Frédéric Guillou,187269,177119,Agence_moov_Ouidah,300000,289850,2022-11-23
CASH_IN,28044,Agence_moov_Cotonou,300000,271956,Frédéric Guillou,177119,205163,2022-11-26
CASH_OUT,151025,Frédéric Guillou,205163,54138,Agence_moov_Ouidah,300000,148975,2022-11-26
CASH_IN,94112,Agence_moov_Ouidah,300000,205888,Robert Clerc,-178004,-83892,2022-11-02
CASH_IN,153222,Agence_moov_Ouidah,300000,146778,Robert Clerc,-83892,69330,2022-11-06
TRANSFER,10671,Robert Clerc,69330,58659,Luc Lévêque-Carre,304638,293967,2022-11-11
TRANSFER,170714,Michelle de Étienne,250852,80138,Robert Clerc,58659,229373,2022-11-14
TRANSFER,60773,Robert Clerc,229373,168600,Théodore Joseph-Lefebvre,537010,476237,2022-11-14
TRANSFER,41642,Hélène de la Gérard,52842,11200,Robert Clerc,168600,210242,2022-11-16
TRANSFER,147091,Théodore Joseph-Lefebvre,476237,329146,Robert Clerc,210242,357333,2022-11-17
CASH_IN,114162,Agence_moov_Abomey,300000,185838,Robert Clerc,357333,471495,2022-11-17
CASH_IN,254977,Agence_moov_Cotonou,300000,45023,Robert Clerc,471495,726472,2022-11-19
CASH_IN,67130,Agence_moov_Abomey,300000,232870,Robert Clerc,726472,793602,2022-11-21
CASH_OUT,185679,Robert Clerc,793602,607923,Agence_moov_Ouidah,300000,114321,2022-11-22
CASH_OUT,535925,Robert Clerc,607923,71998,Agence_moov_Cotonou,300000,-235925,2022-11-23
CASH_OUT,9258,Robert Clerc,71998,62740,Agence_moov_Abomey,300000,290742,2022-11-24
CASH_IN,47410,Agence_moov_Abomey,300000,252590,Vincent de la Dumont,-24380,23030,2022-11-01
CASH_IN,75613,Agence_moov_Ouidah,300000,224387,Vincent de la Dumont,23030,98643,2022-11-01
CASH_IN,22749,Agence_moov_Abomey,300000,277251,Vincent de la Dumont,98643,121392,2022-11-02
CASH_IN,213668,Agence_moov_Abomey,300000,86332,Vincent de la Dumont,121392,335060,2022-11-03
CASH_OUT,288459,Vincent de la Dumont,335060,46601,Agence_moov_Abomey,300000,11541,2022-11-08
CASH_OUT,37768,Vincent de la Dumont,46601,8833,Agence_moov_Cotonou,300000,262232,2022-11-10
CASH_OUT,4260,Vincent de la Dumont,8833,4573,Agence_moov_Cotonou,300000,295740,2022-11-11
CASH_IN,7499,Agence_moov_Abomey,300000,292501,Vincent de la Dumont,4573,12072,2022-11-12
CASH_OUT,9501,Vincent de la Dumont,12072,2571,Agence_moov_Ouidah,300000,290499,2022-11-17
CASH_IN,272715,Agence_moov_Cotonou,300000,27285,Vincent de la Dumont,2571,275286,2022-11-17
TRANSFER,225966,Vincent de la Dumont,275286,49320,Théodore Joseph-Lefebvre,329146,103180,2022-11-19
CASH_OUT,25392,Vincent de la Dumont,49320,23928,Agence_moov_Cotonou,300000,274608,2022-11-19
CASH_IN,168531,Agence_moov_Ouidah,300000,131469,Vincent de la Dumont,23928,192459,2022-11-21
CASH_OUT,191749,Vincent de la Dumont,192459,710,Agence_moov_Cotonou,300000,108251,2022-11-22
CASH_IN,279081,Agence_moov_Cotonou,300000,20919,Vincent de la Dumont,710,279791,2022-11-25
TRANSFER,608,Richard Michel,658,50,Vincent de la Dumont,279791,280399,2022-11-25
CASH_IN,275489,Agence_moov_Abomey,300000,24511,Mathilde Picard du Delmas,-3144,272345,2022-11-02
CASH_OUT,159184,Mathilde Picard du Delmas,272345,113161,Agence_moov_Ouidah,300000,140816,2022-11-05
TRANSFER,95860,Mathilde Picard du Delmas,113161,17301,Nicolas Salmon Le Hamon,25784,-70076,2022-11-05
CASH_IN,29213,Agence_moov_Abomey,300000,270787,Mathilde Picard du Delmas,17301,46514,2022-11-07
CASH_OUT,10758,Mathilde Picard du Delmas,46514,35756,Agence_moov_Cotonou,300000,289242,2022-11-08
TRANSFER,89824,Robert-Louis Gosselin,291102,201278,Mathilde Picard du Delmas,35756,125580,2022-11-08
CASH_IN,268847,Agence_moov_Cotonou,300000,31153,Mathilde Picard du Delmas,125580,394427,2022-11-09
CASH_IN,238641,Agence_moov_Cotonou,300000,61359,Mathilde Picard du Delmas,394427,633068,2022-11-10
CASH_IN,264447,Agence_moov_Abomey,300000,35553,Mathilde Picard du Delmas,633068,897515,2022-11-13
CASH_IN,42031,Agence_moov_Cotonou,300000,257969,Mathilde Picard du Delmas,897515,939546,2022-11-14
TRANSFER,505972,Mathilde Picard du Delmas,939546,433574,Paul Perez,58553,-447419,2022-11-15
CASH_IN,10050,Agence_moov_Abomey,300000,289950,Mathilde Picard du Delmas,433574,443624,2022-11-15
CASH_OUT,398985,Mathilde Picard du Delmas,443624,44639,Agence_moov_Abomey,300000,-98985,2022-11-22
TRANSFER,3858,Hélène de la Gérard,11200,7342,Mathilde Picard du Delmas,44639,48497,2022-11-22
CASH_OUT,33497,Mathilde Picard du Delmas,48497,15000,Agence_moov_Ouidah,300000,266503,2022-11-23
CASH_OUT,7612,Mathilde Picard du Delmas,15000,7388,Agence_moov_Abomey,300000,292388,2022-11-24
TRANSFER,3753,Mathilde Picard du Delmas,7388,3635,Michel Bouchet,267,-3486,2022-11-25
CASH_OUT,2339,Mathilde Picard du Delmas,3635,1296,Agence_moov_Ouidah,300000,297661,2022-11-27
CASH_IN,275682,Agence_moov_Cotonou,300000,24318,Gabriel Bègue,-395817,-120135,2022-11-02
CASH_IN,243344,Agence_moov_Abomey,300000,56656,Gabriel Bègue,-120135,123209,2022-11-04
TRANSFER,86948,Gabriel Bègue,123209,36261,Gabriel Bègue,123209,36261,2022-11-05
TRANSFER,4397,Hélène de la Gérard,7342,2945,Gabriel Bègue,36261,40658,2022-11-07
CASH_IN,63239,Agence_moov_Ouidah,300000,236761,Gabriel Bègue,40658,103897,2022-11-09
CASH_OUT,4823,Gabriel Bègue,103897,99074,Agence_moov_Ouidah,300000,295177,2022-11-10
CASH_OUT,58330,Gabriel Bègue,99074,40744,Agence_moov_Cotonou,300000,241670,2022-11-11
CASH_OUT,4721,Gabriel Bègue,40744,36023,Agence_moov_Cotonou,300000,295279,2022-11-11
TRANSFER,55510,Robert-Louis Gosselin,201278,145768,Gabriel Bègue,36023,91533,2022-11-16
CASH_OUT,65934,Gabriel Bègue,91533,25599,Agence_moov_Ouidah,300000,234066,2022-11-17
TRANSFER,3735,Gabriel Bègue,25599,21864,Michelle de Étienne,80138,76403,2022-11-19
CASH_IN,96215,Agence_moov_Cotonou,300000,203785,Gabriel Bègue,21864,118079,2022-11-20
CASH_IN,172351,Agence_moov_Abomey,300000,127649,Gabriel Bègue,118079,290430,2022-11-23
CASH_OUT,4463,Gabriel Bègue,290430,285967,Agence_moov_Abomey,300000,295537,2022-11-24
CASH_IN,272563,Agence_moov_Cotonou,300000,27437,Gabriel Bègue,285967,558530,2022-11-26
CASH_IN,196971,Agence_moov_Abomey,300000,103029,Gabriel Bègue,558530,755501,2022-11-27
CASH_IN,220964,Agence_moov_Ouidah,300000,79036,Frédérique Fernandes du Bouchet,-53319,167645,2022-11-01
CASH_OUT,123581,Frédérique Fernandes du Bouchet,167645,44064,Agence_moov_Cotonou,300000,176419,2022-11-03
CASH_IN,62466,Agence_moov_Abomey,300000,237534,Frédérique Fernandes du Bouchet,44064,106530,2022-11-04
CASH_OUT,40345,Frédérique Fernandes du Bouchet,106530,66185,Agence_moov_Abomey,300000,259655,2022-11-04
CASH_OUT,1502,Frédérique Fernandes du Bouchet,66185,64683,Agence_moov_Cotonou,300000,298498,2022-11-04
TRANSFER,37073,Frédérique Fernandes du Bouchet,64683,27610,Michelle de Étienne,76403,39330,2022-11-07
TRANSFER,17544,Frédérique Fernandes du Bouchet,27610,10066,Michelle de Étienne,39330,21786,2022-11-09
CASH_OUT,309,Frédérique Fernandes du Bouchet,10066,9757,Agence_moov_Abomey,300000,299691,2022-11-11
CASH_IN,77659,Agence_moov_Abomey,300000,222341,Frédérique Fernandes du Bouchet,9757,87416,2022-11-12
TRANSFER,8399,Frédérique Fernandes du Bouchet,87416,79017,Frédérique Fernandes du Bouchet,87416,95815,2022-11-12
CASH_IN,15778,Agence_moov_Ouidah,300000,284222,Frédérique Fernandes du Bouchet,79017,94795,2022-11-12
CASH_IN,219587,Agence_moov_Cotonou,300000,80413,Frédérique Fernandes du Bouchet,94795,314382,2022-11-15
CASH_OUT,37900,Frédérique Fernandes du Bouchet,314382,276482,Agence_moov_Ouidah,300000,262100,2022-11-19
CASH_OUT,140687,Frédérique Fernandes du Bouchet,276482,135795,Agence_moov_Abomey,300000,159313,2022-11-20
TRANSFER,135176,Robert-Louis Gosselin,145768,10592,Frédérique Fernandes du Bouchet,135795,270971,2022-11-24
TRANSFER,97291,Frédérique Fernandes du Bouchet,270971,173680,Robert-Louis Gosselin,10592,-86699,2022-11-25
CASH_IN,200141,Agence_moov_Ouidah,300000,99859,Frédérique Fernandes du Bouchet,173680,373821,2022-11-26
CASH_OUT,106967,Frédérique Fernandes du Bouchet,373821,266854,Agence_moov_Cotonou,300000,193033,2022-11-27
TRANSFER,236146,Frédérique Fernandes du Bouchet,266854,30708,Michelle de Étienne,21786,-214360,2022-11-27
CASH_IN,12260,Agence_moov_Abomey,300000,287740,Suzanne Bodin,-578909,-566649,2022-11-01
CASH_IN,237987,Agence_moov_Ouidah,300000,62013,Suzanne Bodin,-566649,-328662,2022-11-09
CASH_IN,291270,Agence_moov_Abomey,300000,8730,Suzanne Bodin,-328662,-37392,2022-11-09
CASH_IN,83325,Agence_moov_Ouidah,300000,216675,Suzanne Bodin,-37392,45933,2022-11-12
CASH_IN,200965,Agence_moov_Abomey,300000,99035,Suzanne Bodin,45933,246898,2022-11-13
TRANSFER,89751,Suzanne Bodin,246898,157147,Suzanne Bodin,246898,336649,2022-11-13
CASH_OUT,41472,Suzanne Bodin,157147,115675,Agence_moov_Ouidah,300000,258528,2022-11-17
CASH_IN,228773,Agence_moov_Cotonou,300000,71227,Suzanne Bodin,115675,344448,2022-11-18
CASH_OUT,189684,Suzanne Bodin,344448,154764,Agence_moov_Ouidah,300000,110316,2022-11-24
CASH_IN,281254,Agence_moov_Cotonou,300000,18746,Aimé Pages,67,281321,2022-11-02
TRANSFER,73881,Aimé Pages,281321,207440,Aimé Pages,281321,207440,2022-11-03
CASH_IN,165086,Agence_moov_Ouidah,300000,134914,Aimé Pages,207440,372526,2022-11-05
TRANSFER,86321,Aimé Pages,372526,286205,Aimé Pages,372526,458847,2022-11-06
CASH_OUT,78011,Aimé Pages,286205,208194,Agence_moov_Abomey,300000,221989,2022-11-12
CASH_IN,238038,Agence_moov_Ouidah,300000,61962,Aimé Pages,208194,446232,2022-11-12
CASH_OUT,177347,Aimé Pages,446232,268885,Agence_moov_Ouidah,300000,122653,2022-11-15
CASH_IN,108742,Agence_moov_Ouidah,300000,191258,Aimé Pages,268885,377627,2022-11-16
CASH_IN,158684,Agence_moov_Abomey,300000,141316,Aimé Pages,377627,536311,2022-11-22
CASH_OUT,535181,Aimé Pages,536311,1130,Agence_moov_Ouidah,300000,-235181,2022-11-22
CASH_OUT,883,Aimé Pages,1130,247,Agence_moov_Abomey,300000,299117,2022-11-23
CASH_IN,295401,Agence_moov_Cotonou,300000,4599,Aimé Pages,247,295648,2022-11-26
CASH_IN,141472,Agence_moov_Abomey,300000,158528,Robert-Louis Gosselin,-86699,54773,2022-11-01
CASH_IN,21467,Agence_moov_Cotonou,300000,278533,Robert-Louis Gosselin,54773,76240,2022-11-04
TRANSFER,25550,Robert-Louis Gosselin,76240,50690,Robert-Louis Gosselin,76240,50690,2022-11-05
TRANSFER,44000,Robert-Louis Gosselin,50690,6690,Robert-Louis Gosselin,50690,94690,2022-11-06
TRANSFER,5527,Robert-Louis Gosselin,6690,1163,Robert-Louis Gosselin,6690,1163,2022-11-06
CASH_OUT,1000,Robert-Louis Gosselin,1163,163,Agence_moov_Ouidah,300000,299000,2022-11-07
CASH_IN,71502,Agence_moov_Cotonou,300000,228498,Robert-Louis Gosselin,163,71665,2022-11-09
TRANSFER,24613,Robert-Louis Gosselin,71665,47052,Robert-Louis Gosselin,71665,47052,2022-11-12
CASH_OUT,44891,Robert-Louis Gosselin,47052,2161,Agence_moov_Abomey,300000,255109,2022-11-13
CASH_IN,71075,Agence_moov_Cotonou,300000,228925,Robert-Louis Gosselin,2161,73236,2022-11-16
CASH_OUT,48505,Robert-Louis Gosselin,73236,24731,Agence_moov_Cotonou,300000,251495,2022-11-17
CASH_IN,152203,Agence_moov_Abomey,300000,147797,Robert-Louis Gosselin,24731,176934,2022-11-22
CASH_OUT,62325,Robert-Louis Gosselin,176934,114609,Agence_moov_Cotonou,300000,237675,2022-11-23
CASH_IN,7361,Agence_moov_Ouidah,300000,292639,Robert-Louis Gosselin,114609,121970,2022-11-23
CASH_IN,148201,Agence_moov_Abomey,300000,151799,Robert-Louis Gosselin,121970,270171,2022-11-25
CASH_IN,275275,Agence_moov_Ouidah,300000,24725,Robert-Louis Gosselin,270171,545446,2022-11-26
CASH_IN,12248,Agence_moov_Cotonou,300000,287752,Robert-Louis Gosselin,545446,557694,2022-11-27
CASH_IN,82531,Agence_moov_Ouidah,300000,217469,Richard Michel,50,82581,2022-11-02
CASH_IN,241844,Agence_moov_Abomey,300000,58156,Richard Michel,82581,324425,2022-11-03
CASH_OUT,106186,Richard Michel,324425,218239,Agence_moov_Cotonou,300000,193814,2022-11-03
CASH_OUT,91615,Richard Michel,218239,126624,Agence_moov_Abomey,300000,208385,2022-11-04
CASH_OUT,25524,Richard Michel,126624,101100,Agence_moov_Cotonou,300000,274476,2022-11-04
TRANSFER,10176,Richard Michel,101100,90924,Richard Michel,101100,111276,2022-11-06
CASH_IN,281579,Agence_moov_Cotonou,300000,18421,Richard Michel,90924,372503,2022-11-09
TRANSFER,225832,Richard Michel,372503,146671,Richard Michel,372503,598335,2022-11-10
CASH_IN,229317,Agence_moov_Cotonou,300000,70683,Richard Michel,146671,375988,2022-11-15
CASH_IN,99074,Agence_moov_Cotonou,300000,200926,Richard Michel,375988,475062,2022-11-16
CASH_IN,240824,Agence_moov_Abomey,300000,59176,Richard Michel,475062,715886,2022-11-17
CASH_IN,259819,Agence_moov_Cotonou,300000,40181,Richard Michel,715886,975705,2022-11-17
CASH_IN,9618,Agence_moov_Ouidah,300000,290382,Richard Michel,975705,985323,2022-11-21
CASH_OUT,203103,Richard Michel,985323,782220,Agence_moov_Ouidah,300000,96897,2022-11-24
CASH_IN,250146,Agence_moov_Ouidah,300000,49854,Richard Michel,782220,1032366,2022-11-26
CASH_IN,251233,Agence_moov_Abomey,300000,48767,Paul Perez,-447419,-196186,2022-11-01
CASH_IN,151540,Agence_moov_Abomey,300000,148460,Paul Perez,-196186,-44646,2022-11-03
CASH_IN,79754,Agence_moov_Ouidah,300000,220246,Paul Perez,-44646,35108,2022-11-07
CASH_IN,204174,Agence_moov_Cotonou,300000,95826,Paul Perez,35108,239282,2022-11-11
TRANSFER,224078,Paul Perez,239282,15204,Paul Perez,239282,15204,2022-11-12
CASH_IN,202963,Agence_moov_Cotonou,300000,97037,Paul Perez,15204,218167,2022-11-13
CASH_IN,59151,Agence_moov_Abomey,300000,240849,Paul Perez,218167,277318,2022-11-13
CASH_IN,238601,Agence_moov_Abomey,300000,61399,Paul Perez,277318,515919,2022-11-13
TRANSFER,203448,Paul Perez,515919,312471,Paul Perez,515919,719367,2022-11-13
CASH_IN,227954,Agence_moov_Cotonou,300000,72046,Paul Perez,312471,540425,2022-11-15
CASH_IN,38881,Agence_moov_Abomey,300000,261119,Paul Perez,540425,579306,2022-11-17
CASH_IN,249482,Agence_moov_Cotonou,300000,50518,Paul Perez,579306,828788,2022-11-21
CASH_OUT,719933,Paul Perez,828788,108855,Agence_moov_Cotonou,300000,-419933,2022-11-25
CASH_OUT,103893,Paul Perez,108855,4962,Agence_moov_Abomey,300000,196107,2022-11-25
CASH_OUT,4913,Paul Perez,4962,49,Agence_moov_Ouidah,300000,295087,2022-11-26
CASH_IN,109954,Agence_moov_Abomey,300000,190046,Paul Perez,49,110003,2022-11-27
CASH_IN,36815,Agence_moov_Cotonou,300000,263185,Michel Bouchet,-3486,33329,2022-11-02
CASH_OUT,32979,Michel Bouchet,33329,350,Agence_moov_Ouidah,300000,267021,2022-11-02
CASH_IN,179127,Agence_moov_Cotonou,300000,120873,Michel Bouchet,350,179477,2022-11-09
CASH_IN,120506,Agence_moov_Ouidah,300000,179494,Michel Bouchet,179477,299983,2022-11-14
CASH_IN,159462,Agence_moov_Abomey,300000,140538,Michel Bouchet,299983,459445,2022-11-15
CASH_OUT,420289,Michel Bouchet,459445,39156,Agence_moov_Cotonou,300000,-120289,2022-11-23
CASH_IN,99859,Agence_moov_Ouidah,300000,200141,Michel Bouchet,39156,139015,2022-11-26
CASH_IN,156758,Agence_moov_Ouidah,300000,143242,Antoinette de Dupuis,-61781,94977,2022-11-01
TRANSFER,68062,Antoinette de Dupuis,94977,26915,Antoinette de Dupuis,94977,163039,2022-11-02
TRANSFER,3285,Antoinette de Dupuis,26915,23630,Antoinette de Dupuis,26915,23630,2022-11-03
CASH_IN,267389,Agence_moov_Ouidah,300000,32611,Antoinette de Dupuis,23630,291019,2022-11-04
CASH_IN,265409,Agence_moov_Ouidah,300000,34591,Antoinette de Dupuis,291019,556428,2022-11-05
CASH_IN,107670,Agence_moov_Abomey,300000,192330,Antoinette de Dupuis,556428,664098,2022-11-07
CASH_IN,124927,Agence_moov_Abomey,300000,175073,Antoinette de Dupuis,664098,789025,2022-11-07
CASH_IN,133138,Agence_moov_Abomey,300000,166862,Antoinette de Dupuis,789025,922163,2022-11-08
CASH_OUT,513199,Antoinette de Dupuis,922163,408964,Agence_moov_Ouidah,300000,-213199,2022-11-10
CASH_OUT,43333,Antoinette de Dupuis,408964,365631,Agence_moov_Abomey,300000,256667,2022-11-12
TRANSFER,239755,Antoinette de Dupuis,365631,125876,Antoinette de Dupuis,365631,125876,2022-11-15
CASH_IN,6897,Agence_moov_Abomey,300000,293103,Antoinette de Dupuis,125876,132773,2022-11-16
CASH_OUT,96466,Antoinette de Dupuis,132773,36307,Agence_moov_Abomey,300000,203534,2022-11-22
CASH_IN,124250,Agence_moov_Ouidah,300000,175750,Nicolas Salmon Le Hamon,-70076,54174,2022-11-02
CASH_IN,80204,Agence_moov_Cotonou,300000,219796,Nicolas Salmon Le Hamon,54174,134378,2022-11-03
TRANSFER,14618,Nicolas Salmon Le Hamon,134378,119760,Nicolas Salmon Le Hamon,134378,148996,2022-11-06
CASH_IN,250868,Agence_moov_Cotonou,300000,49132,Nicolas Salmon Le Hamon,119760,370628,2022-11-07
CASH_IN,17101,Agence_moov_Ouidah,300000,282899,Nicolas Salmon Le Hamon,370628,387729,2022-11-10
TRANSFER,184512,Nicolas Salmon Le Hamon,387729,203217,Nicolas Salmon Le Hamon,387729,203217,2022-11-10
CASH_OUT,7703,Nicolas Salmon Le Hamon,203217,195514,Agence_moov_Abomey,300000,292297,2022-11-12
CASH_IN,135752,Agence_moov_Abomey,300000,164248,Nicolas Salmon Le Hamon,195514,331266,2022-11-12
CASH_IN,50495,Agence_moov_Ouidah,300000,249505,Nicolas Salmon Le Hamon,331266,381761,2022-11-12
CASH_OUT,499,Nicolas Salmon Le Hamon,381761,381262,Agence_moov_Ouidah,300000,299501,2022-11-20
CASH_IN,219411,Agence_moov_Abomey,300000,80589,Nicolas Salmon Le Hamon,381262,600673,2022-11-21
CASH_IN,28960,Agence_moov_Cotonou,300000,271040,Nicolas Salmon Le Hamon,600673,629633,2022-11-22
CASH_IN,180618,Agence_moov_Ouidah,300000,119382,Hélène Le Chauvin,-33427,147191,2022-11-03
CASH_IN,267980,Agence_moov_Cotonou,300000,32020,Hélène Le Chauvin,147191,415171,2022-11-08
CASH_OUT,337095,Hélène Le Chauvin,415171,78076,Agence_moov_Cotonou,300000,-37095,2022-11-09
CASH_IN,168283,Agence_moov_Cotonou,300000,131717,Hélène Le Chauvin,78076,246359,2022-11-10
CASH_OUT,197919,Hélène Le Chauvin,246359,48440,Agence_moov_Cotonou,300000,102081,2022-11-11
TRANSFER,31446,Hélène Le Chauvin,48440,16994,Hélène Le Chauvin,48440,79886,2022-11-12
TRANSFER,8678,Hélène Le Chauvin,16994,8316,Hélène Le Chauvin,16994,8316,2022-11-12
TRANSFER,1067,Hélène Le Chauvin,8316,7249,Hélène Le Chauvin,8316,9383,2022-11-15
TRANSFER,6470,Hélène Le Chauvin,7249,779,Hélène Le Chauvin,7249,779,2022-11-18
CASH_OUT,686,Hélène Le Chauvin,779,93,Agence_moov_Abomey,300000,299314,2022-11-19
CASH_IN,89942,Agence_moov_Abomey,300000,210058,Hélène Le Chauvin,93,90035,2022-11-21
CASH_IN,160990,Agence_moov_Abomey,300000,139010,Hélène Le Chauvin,90035,251025,2022-11-27
CASH_IN,81667,Agence_moov_Cotonou,300000,218333,Noémi Bouvier,-289504,-207837,2022-11-01
CASH_IN,256267,Agence_moov_Abomey,300000,43733,Noémi Bouvier,-207837,48430,2022-11-10
CASH_IN,91992,Agence_moov_Abomey,300000,208008,Noémi Bouvier,48430,140422,2022-11-13
TRANSFER,81582,Noémi Bouvier,140422,58840,Noémi Bouvier,140422,58840,2022-11-14
CASH_OUT,30990,Noémi Bouvier,58840,27850,Agence_moov_Cotonou,300000,269010,2022-11-22
CASH_OUT,27094,Noémi Bouvier,27850,756,Agence_moov_Ouidah,300000,272906,2022-11-26
CASH_IN,181117,Agence_moov_Ouidah,300000,118883,Lucy Gillet,-163658,17459,2022-11-01
CASH_OUT,10713,Lucy Gillet,17459,6746,Agence_moov_Cotonou,300000,289287,2022-11-05
TRANSFER,3480,Lucy Gillet,6746,3266,Lucy Gillet,6746,3266,2022-11-05
CASH_OUT,465,Lucy Gillet,3266,2801,Agence_moov_Ouidah,300000,299535,2022-11-05
TRANSFER,2530,Lucy Gillet,2801,271,Lucy Gillet,2801,5331,2022-11-07
CASH_IN,295989,Agence_moov_Abomey,300000,4011,Lucy Gillet,271,296260,2022-11-09
CASH_OUT,112551,Lucy Gillet,296260,183709,Agence_moov_Abomey,300000,187449,2022-11-11
CASH_OUT,72358,Lucy Gillet,183709,111351,Agence_moov_Abomey,300000,227642,2022-11-13
CASH_IN,4348,Agence_moov_Ouidah,300000,295652,Lucy Gillet,111351,115699,2022-11-21
CASH_OUT,71378,Lucy Gillet,115699,44321,Agence_moov_Ouidah,300000,228622,2022-11-27
CASH_IN,213472,Agence_moov_Cotonou,300000,86528,Constance Guillon,-89686,123786,2022-11-02
CASH_IN,34341,Agence_moov_Cotonou,300000,265659,Constance Guillon,123786,158127,2022-11-03
CASH_IN,261516,Agence_moov_Ouidah,300000,38484,Constance Guillon,158127,419643,2022-11-04
CASH_OUT,35948,Constance Guillon,419643,383695,Agence_moov_Abomey,300000,264052,2022-11-05
CASH_OUT,268796,Constance Guillon,383695,114899,Agence_moov_Cotonou,300000,31204,2022-11-07
CASH_IN,216660,Agence_moov_Ouidah,300000,83340,Constance Guillon,114899,331559,2022-11-08
TRANSFER,269763,Constance Guillon,331559,61796,Constance Guillon,331559,61796,2022-11-09
CASH_IN,74990,Agence_moov_Ouidah,300000,225010,Constance Guillon,61796,136786,2022-11-15
CASH_IN,24850,Agence_moov_Cotonou,300000,275150,Constance Guillon,136786,161636,2022-11-16
TRANSFER,117571,Constance Guillon,161636,44065,Constance Guillon,161636,44065,2022-11-17
TRANSFER,38706,Constance Guillon,44065,5359,Constance Guillon,44065,5359,2022-11-19
CASH_IN,213663,Agence_moov_Cotonou,300000,86337,Constance Guillon,5359,219022,2022-11-20
CASH_IN,247025,Agence_moov_Cotonou,300000,52975,Constance Guillon,219022,466047,2022-11-22
CASH_OUT,125954,Constance Guillon,466047,340093,Agence_moov_Cotonou,300000,174046,2022-11-22
CASH_OUT,238756,Constance Guillon,340093,101337,Agence_moov_Cotonou,300000,61244,2022-11-25
CASH_OUT,25453,Constance Guillon,101337,75884,Agence_moov_Ouidah,300000,274547,2022-11-25
CASH_IN,34672,Agence_moov_Abomey,300000,265328,Matthieu-Matthieu Bigot,-299094,-264422,2022-11-01
CASH_IN,288163,Agence_moov_Cotonou,300000,11837,Matthieu-Matthieu Bigot,-264422,23741,2022-11-06
CASH_OUT,17559,Matthieu-Matthieu Bigot,23741,6182,Agence_moov_Ouidah,300000,282441,2022-11-08
CASH_OUT,200,Matthieu-Matthieu Bigot,6182,5982,Agence_moov_Cotonou,300000,299800,2022-11-08
CASH_OUT,4808,Matthieu-Matthieu Bigot,5982,1174,Agence_moov_Abomey,300000,295192,2022-11-15
CASH_OUT,188,Matthieu-Matthieu Bigot,1174,986,Agence_moov_Cotonou,300000,299812,2022-11-15
TRANSFER,740,Matthieu-Matthieu Bigot,986,246,Matthieu-Matthieu Bigot,986,246,2022-11-15
CASH_OUT,175,Matthieu-Matthieu Bigot,246,71,Agence_moov_Abomey,300000,299825,2022-11-16
CASH_IN,74256,Agence_moov_Ouidah,300000,225744,Matthieu-Matthieu Bigot,71,74327,2022-11-20
CASH_OUT,15125,Matthieu-Matthieu Bigot,74327,59202,Agence_moov_Ouidah,300000,284875,2022-11-22
CASH_OUT,3624,Matthieu-Matthieu Bigot,59202,55578,Agence_moov_Cotonou,300000,296376,2022-11-23
CASH_IN,34163,Agence_moov_Cotonou,300000,265837,Marthe Gilles,-526953,-492790,2022-11-02
CASH_IN,85134,Agence_moov_Ouidah,300000,214866,Marthe Gilles,-492790,-407656,2022-11-04
CASH_IN,47586,Agence_moov_Abomey,300000,252414,Marthe Gilles,-407656,-360070,2022-11-08
CASH_IN,291081,Agence_moov_Ouidah,300000,8919,Marthe Gilles,-360070,-68989,2022-11-11
CASH_IN,33654,Agence_moov_Ouidah,300000,266346,Marthe Gilles,-68989,-35335,2022-11-11
CASH_IN,219541,Agence_moov_Cotonou,300000,80459,Marthe Gilles,-35335,184206,2022-11-15
TRANSFER,144307,Marthe Gilles,184206,39899,Marthe Gilles,184206,39899,2022-11-16
TRANSFER,7161,Marthe Gilles,39899,32738,Marthe Gilles,39899,47060,2022-11-17
CASH_OUT,887,Marthe Gilles,32738,31851,Agence_moov_Ouidah,300000,299113,2022-11-17
CASH_OUT,9282,Marthe Gilles,31851,22569,Agence_moov_Ouidah,300000,290718,2022-11-19
CASH_IN,297806,Agence_moov_Ouidah,300000,2194,Marthe Gilles,22569,320375,2022-11-22
CASH_OUT,122894,Marthe Gilles,320375,197481,Agence_moov_Ouidah,300000,177106,2022-11-23
CASH_IN,116291,Agence_moov_Abomey,300000,183709,Constance Bourdon-Millet,1119800,1236091,2022-12-07
TRANSFER,590093,Martine Aubert,1279200,689107,Constance Bourdon-Millet,1236091,1826184,2022-12-10
CASH_OUT,1320024,Constance Bourdon-Millet,1826184,506160,Agence_moov_Ouidah,300000,-1020024,2022-12-16
TRANSFER,48574,Constance Bourdon-Millet,506160,457586,Richard Michel,1011500,962926,2022-12-23
CASH_OUT,268312,Sabine Pineau,286800,18488,Agence_moov_Abomey,300000,31688,2022-12-15
CASH_IN,18630,Agence_moov_Ouidah,300000,281370,Sabine Pineau,18488,37118,2022-12-16
CASH_IN,148860,Agence_moov_Cotonou,300000,151140,Anastasie Cousin,571500,720360,2022-12-04
CASH_OUT,421349,Anastasie Cousin,720360,299011,Agence_moov_Ouidah,300000,-121349,2022-12-23
CASH_OUT,38401,Anastasie Cousin,299011,260610,Agence_moov_Cotonou,300000,261599,2022-12-27
CASH_OUT,1029022,Richard Le Lévêque,1683700,654678,Agence_moov_Ouidah,300000,-729022,2022-12-15
CASH_IN,35317,Agence_moov_Abomey,300000,264683,Richard Le Lévêque,654678,689995,2022-12-26
CASH_OUT,1500649,Alphonse Gomes,1513200,12551,Agence_moov_Abomey,300000,-1200649,2022-12-02
TRANSFER,149251,Luc Lévêque-Carre,1909100,1759849,Alphonse Gomes,12551,161802,2022-12-02
TRANSFER,61246,Alphonse Gomes,161802,100556,Agnès Le Giraud,1916400,1855154,2022-12-08
CASH_IN,199729,Agence_moov_Cotonou,300000,100271,Alphonse Gomes,100556,300285,2022-12-13
TRANSFER,202758,Alphonse Gomes,300285,97527,Vincent de la Dumont,1443900,1241142,2022-12-15
CASH_OUT,10602,Émilie du Allain,1184500,1173898,Agence_moov_Cotonou,300000,289398,2022-12-17
TRANSFER,706095,Robert Laroche,1642400,936305,Émilie du Allain,1173898,1879993,2022-12-22
CASH_IN,117894,Agence_moov_Ouidah,300000,182106,Émilie du Allain,1879993,1997887,2022-12-26
CASH_OUT,11725,Philippe Philippe,199300,187575,Agence_moov_Ouidah,300000,288275,2022-12-01
CASH_OUT,76627,Philippe Philippe,187575,110948,Agence_moov_Cotonou,300000,223373,2022-12-14
CASH_IN,152817,Agence_moov_Ouidah,300000,147183,Philippe Philippe,110948,263765,2022-12-22
TRANSFER,1004654,Tristan Delahaye,1542700,538046,Camille Prévost,466500,1471154,2022-12-01
CASH_IN,131596,Agence_moov_Cotonou,300000,168404,Camille Prévost,1471154,1602750,2022-12-05
TRANSFER,66407,Robert Clerc,1005300,938893,Camille Prévost,1602750,1669157,2022-12-26
CASH_IN,227273,Agence_moov_Abomey,300000,72727,Marc Leleu,1256300,1483573,2022-12-02
TRANSFER,152945,Vincent de la Dumont,1241142,1088197,Audrey Julien de Leleu,1025600,1178545,2022-12-21
CASH_IN,231677,Agence_moov_Cotonou,300000,68323,Audrey Julien de Leleu,1178545,1410222,2022-12-26
CASH_IN,95053,Agence_moov_Ouidah,300000,204947,Martine Aubert,689107,784160,2022-12-01
CASH_IN,160173,Agence_moov_Abomey,300000,139827,Martine Aubert,784160,944333,2022-12-01
TRANSFER,206053,Hélène de la Gérard,413200,207147,Martine Aubert,944333,1150386,2022-12-08
CASH_IN,256388,Agence_moov_Cotonou,300000,43612,Martine Aubert,1150386,1406774,2022-12-18
TRANSFER,295150,Martine Aubert,1406774,1111624,Paulette Loiseau,430000,134850,2022-12-23
CASH_IN,212247,Agence_moov_Abomey,300000,87753,Maggie Martinez,614400,826647,2022-12-03
TRANSFER,257701,Théodore Joseph-Lefebvre,279200,21499,Maggie Martinez,826647,1084348,2022-12-10
TRANSFER,824306,Maggie Martinez,1084348,260042,Mathilde Picard du Delmas,1434800,610494,2022-12-24
CASH_IN,231438,Agence_moov_Cotonou,300000,68562,Suzanne Bodin,1431700,1663138,2022-12-09
TRANSFER,1252090,Suzanne Bodin,1663138,411048,Manon Valette,1142900,-109190,2022-12-17
TRANSFER,77370,Thomas Guichard du Renault,151800,74430,Suzanne Bodin,411048,488418,2022-12-27
CASH_OUT,413300,Véronique Martins de Fleury,1575200,1161900,Agence_moov_Abomey,300000,-113300,2022-12-09
CASH_IN,242132,Agence_moov_Cotonou,300000,57868,Véronique Martins de Fleury,1161900,1404032,2022-12-14
CASH_IN,198660,Agence_moov_Ouidah,300000,101340,Véronique Martins de Fleury,1404032,1602692,2022-12-15
CASH_IN,162497,Agence_moov_Abomey,300000,137503,Véronique Martins de Fleury,1602692,1765189,2022-12-20
CASH_IN,104830,Agence_moov_Abomey,300000,195170,Véronique Martins de Fleury,1765189,1870019,2022-12-25
CASH_OUT,93910,Agnès Le Giraud,1855154,1761244,Agence_moov_Abomey,300000,206090,2022-12-14
TRANSFER,875947,Agnès Le Giraud,1761244,885297,Bernadette de Jourdan,1803000,927053,2022-12-15
CASH_OUT,429697,Agnès Le Giraud,885297,455600,Agence_moov_Abomey,300000,-129697,2022-12-23
TRANSFER,247297,Agnès Le Giraud,455600,208303,Vincent de la Dumont,1088197,840900,2022-12-27
CASH_OUT,244524,Astrid Lecoq,1911800,1667276,Agence_moov_Cotonou,300000,55476,2022-12-07
TRANSFER,662995,Astrid Lecoq,1667276,1004281,Léon Da Costa,1584800,921805,2022-12-20
TRANSFER,206120,Astrid Lecoq,1004281,798161,Vincent de la Dumont,840900,634780,2022-12-20
TRANSFER,170846,Nathalie Bonnin-Joubert,462300,291454,Paulette Loiseau,134850,305696,2022-12-03
TRANSFER,173568,Paulette Loiseau,305696,132128,Frédéric Guillou,1324000,1150432,2022-12-03
TRANSFER,235706,Mathilde de la Samson,1791400,1555694,Paulette Loiseau,132128,367834,2022-12-04
TRANSFER,1098212,Lucy Gillet,1256200,157988,Paulette Loiseau,367834,1466046,2022-12-12
CASH_OUT,183373,Paulette Loiseau,1466046,1282673,Agence_moov_Ouidah,300000,116627,2022-12-16
CASH_IN,233053,Agence_moov_Abomey,300000,66947,Clémence-Véronique Munoz,1584800,1817853,2022-12-12
CASH_OUT,1496356,Michelle-Dorothée Lévêque,1499800,3444,Agence_moov_Abomey,300000,-1196356,2022-12-13
TRANSFER,796584,Jules-Roland Bousquet,1126100,329516,Michelle-Dorothée Lévêque,3444,800028,2022-12-23
CASH_OUT,64821,Thomas Guichard du Renault,74430,9609,Agence_moov_Cotonou,300000,235179,2022-12-08
CASH_IN,173951,Agence_moov_Ouidah,300000,126049,Thomas Guichard du Renault,9609,183560,2022-12-17
CASH_OUT,118975,Thomas Guichard du Renault,183560,64585,Agence_moov_Ouidah,300000,181025,2022-12-17
CASH_OUT,8595,Thomas Guichard du Renault,64585,55990,Agence_moov_Ouidah,300000,291405,2022-12-27
TRANSFER,388842,Vincent de la Dumont,634780,245938,Aimé Pages,891700,1280542,2022-12-03
TRANSFER,275879,Richard Michel,962926,687047,Colette-Sophie Prévost,307500,583379,2022-12-12
TRANSFER,170570,Colette-Sophie Prévost,583379,412809,Vincent de la Dumont,245938,75368,2022-12-20
CASH_OUT,185448,Michel Bouchet,1321100,1135652,Agence_moov_Abomey,300000,114552,2022-12-16
TRANSFER,163946,Nathalie Bonnin-Joubert,291454,127508,Anastasie Richard-Neveu,1677600,1513654,2022-12-02
CASH_IN,175976,Agence_moov_Cotonou,300000,124024,Nathalie Bonnin-Joubert,127508,303484,2022-12-16
CASH_OUT,508627,Marthe Gilles,1258400,749773,Agence_moov_Ouidah,300000,-208627,2022-12-06
TRANSFER,387330,Françoise Morin,683900,296570,Marthe Gilles,749773,1137103,2022-12-16
TRANSFER,444521,Frédérique Fernandes du Bouchet,1910100,1465579,Marthe Gilles,1137103,1581624,2022-12-21
CASH_IN,133517,Agence_moov_Ouidah,300000,166483,Luc Lévêque-Carre,1759849,1893366,2022-12-01
CASH_OUT,1142246,Luc Lévêque-Carre,1893366,751120,Agence_moov_Ouidah,300000,-842246,2022-12-04
CASH_OUT,132859,Luc Lévêque-Carre,751120,618261,Agence_moov_Cotonou,300000,167141,2022-12-07
TRANSFER,317771,Luc Lévêque-Carre,618261,300490,Gabriel Bègue,1613600,1295829,2022-12-10
TRANSFER,121061,Luc Lévêque-Carre,300490,179429,Emmanuel Grégoire,407700,286639,2022-12-25
TRANSFER,727459,André Renault,1196800,469341,Thibaut de la Roy,224300,951759,2022-12-01
CASH_IN,74730,Agence_moov_Cotonou,300000,225270,Thibaut de la Roy,951759,1026489,2022-12-03
CASH_IN,126926,Agence_moov_Abomey,300000,173074,Thibaut de la Roy,1026489,1153415,2022-12-03
TRANSFER,468289,Thomas de Blin,1551500,1083211,Thibaut de la Roy,1153415,1621704,2022-12-04
CASH_IN,182419,Agence_moov_Cotonou,300000,117581,Thibaut de la Roy,1621704,1804123,2022-12-04
CASH_IN,209196,Agence_moov_Ouidah,300000,90804,Thibaut de la Roy,1804123,2013319,2022-12-06
TRANSFER,51480,Michelle Samson,230200,178720,Thibaut de la Roy,2013319,2064799,2022-12-07
CASH_OUT,877858,Thibaut de la Roy,2064799,1186941,Agence_moov_Abomey,300000,-577858,2022-12-08
TRANSFER,463474,André Renault,469341,5867,Thibaut de la Roy,1186941,1650415,2022-12-10
CASH_OUT,563043,Thibaut de la Roy,1650415,1087372,Agence_moov_Abomey,300000,-263043,2022-12-10
CASH_IN,119504,Agence_moov_Abomey,300000,180496,Thibaut de la Roy,1087372,1206876,2022-12-10
CASH_OUT,895579,Thibaut de la Roy,1206876,311297,Agence_moov_Abomey,300000,-595579,2022-12-12
CASH_OUT,234767,Thibaut de la Roy,311297,76530,Agence_moov_Abomey,300000,65233,2022-12-13
TRANSFER,66124,Thibaut de la Roy,76530,10406,Vincent de la Dumont,75368,9244,2022-12-13
TRANSFER,9547,Thibaut de la Roy,10406,859,Thibaut de la Roy,10406,859,2022-12-14
CASH_OUT,132,Thibaut de la Roy,859,727,Agence_moov_Ouidah,300000,299868,2022-12-14
TRANSFER,496659,Noël Bourgeois,1372700,876041,Thibaut de la Roy,727,497386,2022-12-15
CASH_OUT,66423,Thibaut de la Roy,497386,430963,Agence_moov_Abomey,300000,233577,2022-12-15
TRANSFER,891052,Noémi Bouvier,1323100,432048,Thibaut de la Roy,430963,1322015,2022-12-18
CASH_OUT,130196,Thibaut de la Roy,1322015,1191819,Agence_moov_Abomey,300000,169804,2022-12-19
CASH_OUT,195189,Thibaut de la Roy,1191819,996630,Agence_moov_Abomey,300000,104811,2022-12-20
TRANSFER,181952,Thibaut de la Roy,996630,814678,Stéphane Munoz,1330000,1148048,2022-12-22
CASH_OUT,394339,Thibaut de la Roy,814678,420339,Agence_moov_Ouidah,300000,-94339,2022-12-22
CASH_OUT,144468,Thibaut de la Roy,420339,275871,Agence_moov_Abomey,300000,155532,2022-12-23
CASH_IN,264169,Agence_moov_Cotonou,300000,35831,Thibaut de la Roy,275871,540040,2022-12-24
TRANSFER,154793,Timothée-René Blanchard,399600,244807,Thibaut de la Roy,540040,694833,2022-12-25
TRANSFER,424629,Alphonse Joly,715000,290371,Christine Texier,143300,-281329,2022-12-01
CASH_IN,170985,Agence_moov_Abomey,300000,129015,Alphonse Joly,290371,461356,2022-12-01
CASH_IN,287618,Agence_moov_Cotonou,300000,12382,Alphonse Joly,461356,748974,2022-12-04
TRANSFER,591388,Alphonse Joly,748974,157586,Noémi Bouvier,432048,-159340,2022-12-04
CASH_IN,118708,Agence_moov_Abomey,300000,181292,Alphonse Joly,157586,276294,2022-12-06
CASH_IN,156795,Agence_moov_Ouidah,300000,143205,Alphonse Joly,276294,433089,2022-12-06
CASH_IN,166060,Agence_moov_Abomey,300000,133940,Alphonse Joly,433089,599149,2022-12-08
CASH_OUT,379600,Alphonse Joly,599149,219549,Agence_moov_Abomey,300000,-79600,2022-12-09
TRANSFER,17595,Paul Rocher-Maillet,760200,742605,Alphonse Joly,219549,237144,2022-12-09
CASH_IN,141836,Agence_moov_Abomey,300000,158164,Alphonse Joly,237144,378980,2022-12-12
TRANSFER,284901,Alphonse Joly,378980,94079,Céline Collin-Hervé,410800,125899,2022-12-13
TRANSFER,18797,Alphonse Joly,94079,75282,Richard Michel,687047,668250,2022-12-15
CASH_IN,49365,Agence_moov_Abomey,300000,250635,Alphonse Joly,75282,124647,2022-12-17
TRANSFER,107815,Alphonse Joly,124647,16832,Tristan Bousquet-Gros,995600,887785,2022-12-18
TRANSFER,731425,Thomas de Blin,1083211,351786,Alphonse Joly,16832,748257,2022-12-19
CASH_OUT,627594,Alphonse Joly,748257,120663,Agence_moov_Abomey,300000,-327594,2022-12-20
TRANSFER,27856,Françoise Morin,296570,268714,Alphonse Joly,120663,148519,2022-12-20
CASH_IN,135374,Agence_moov_Ouidah,300000,164626,Alphonse Joly,148519,283893,2022-12-20
CASH_OUT,241004,Alphonse Joly,283893,42889,Agence_moov_Cotonou,300000,58996,2022-12-21
CASH_OUT,7483,Alphonse Joly,42889,35406,Agence_moov_Ouidah,300000,292517,2022-12-22
TRANSFER,2480,Vincent de la Dumont,9244,6764,Alphonse Joly,35406,37886,2022-12-23
CASH_IN,299790,Agence_moov_Ouidah,300000,210,Alphonse Joly,37886,337676,2022-12-23
CASH_OUT,249793,Alphonse Joly,337676,87883,Agence_moov_Abomey,300000,50207,2022-12-26
CASH_IN,265933,Agence_moov_Ouidah,300000,34067,Marcelle-Valentine Guibert,540900,806833,2022-12-03
CASH_IN,135586,Agence_moov_Ouidah,300000,164414,Marcelle-Valentine Guibert,806833,942419,2022-12-03
TRANSFER,672730,Marcelle-Valentine Guibert,942419,269689,Camille Morvan,112300,-560430,2022-12-04
CASH_IN,168696,Agence_moov_Abomey,300000,131304,Marcelle-Valentine Guibert,269689,438385,2022-12-06
CASH_OUT,160954,Marcelle-Valentine Guibert,438385,277431,Agence_moov_Ouidah,300000,139046,2022-12-08
CASH_OUT,25908,Marcelle-Valentine Guibert,277431,251523,Agence_moov_Abomey,300000,274092,2022-12-09
CASH_OUT,226513,Marcelle-Valentine Guibert,251523,25010,Agence_moov_Abomey,300000,73487,2022-12-10
CASH_IN,254093,Agence_moov_Cotonou,300000,45907,Marcelle-Valentine Guibert,25010,279103,2022-12-12
CASH_OUT,99715,Marcelle-Valentine Guibert,279103,179388,Agence_moov_Abomey,300000,200285,2022-12-13
TRANSFER,173754,Marcelle-Valentine Guibert,179388,5634,Émile-René Baudry,1708000,1534246,2022-12-14
CASH_IN,51754,Agence_moov_Cotonou,300000,248246,Marcelle-Valentine Guibert,5634,57388,2022-12-14
CASH_IN,167390,Agence_moov_Ouidah,300000,132610,Marcelle-Valentine Guibert,57388,224778,2022-12-15
TRANSFER,424591,Virginie Bouvet,1050100,625509,Marcelle-Valentine Guibert,224778,649369,2022-12-18
CASH_OUT,477058,Marcelle-Valentine Guibert,649369,172311,Agence_moov_Ouidah,300000,-177058,2022-12-18
CASH_OUT,101527,Marcelle-Valentine Guibert,172311,70784,Agence_moov_Cotonou,300000,198473,2022-12-18
TRANSFER,2474,Marcelle-Valentine Guibert,70784,68310,Constance Guillon,1842600,1840126,2022-12-19
CASH_OUT,64184,Marcelle-Valentine Guibert,68310,4126,Agence_moov_Abomey,300000,235816,2022-12-19
CASH_IN,218170,Agence_moov_Abomey,300000,81830,Marcelle-Valentine Guibert,4126,222296,2022-12-20
CASH_IN,290770,Agence_moov_Abomey,300000,9230,Marcelle-Valentine Guibert,222296,513066,2022-12-21
TRANSFER,449149,Marcelle-Valentine Guibert,513066,63917,Renée Le Diaz,830000,380851,2022-12-21
CASH_IN,271970,Agence_moov_Cotonou,300000,28030,Marcelle-Valentine Guibert,63917,335887,2022-12-24
CASH_OUT,9460,Marcelle-Valentine Guibert,335887,326427,Agence_moov_Cotonou,300000,290540,2022-12-26
CASH_IN,31673,Agence_moov_Ouidah,300000,268327,Marcelle-Valentine Guibert,326427,358100,2022-12-26
TRANSFER,104640,Marcelle-Valentine Guibert,358100,253460,Vincent Joubert,788800,684160,2022-12-27
CASH_IN,237903,Agence_moov_Ouidah,300000,62097,Jules-Roland Bousquet,329516,567419,2022-12-01
CASH_IN,279188,Agence_moov_Abomey,300000,20812,Jules-Roland Bousquet,567419,846607,2022-12-01
CASH_OUT,567049,Jules-Roland Bousquet,846607,279558,Agence_moov_Ouidah,300000,-267049,2022-12-05
CASH_OUT,160005,Jules-Roland Bousquet,279558,119553,Agence_moov_Abomey,300000,139995,2022-12-07
CASH_IN,111548,Agence_moov_Abomey,300000,188452,Jules-Roland Bousquet,119553,231101,2022-12-07
CASH_IN,36891,Agence_moov_Abomey,300000,263109,Jules-Roland Bousquet,231101,267992,2022-12-08
CASH_OUT,119413,Jules-Roland Bousquet,267992,148579,Agence_moov_Abomey,300000,180587,2022-12-09
CASH_OUT,12244,Jules-Roland Bousquet,148579,136335,Agence_moov_Cotonou,300000,287756,2022-12-09
CASH_OUT,83266,Jules-Roland Bousquet,136335,53069,Agence_moov_Abomey,300000,216734,2022-12-10
TRANSFER,18175,Jules-Roland Bousquet,53069,34894,Léon Da Costa,921805,903630,2022-12-11
TRANSFER,26458,Jules-Roland Bousquet,34894,8436,Hélène de la Gérard,207147,180689,2022-12-14
CASH_IN,204881,Agence_moov_Abomey,300000,95119,Jules-Roland Bousquet,8436,213317,2022-12-15
TRANSFER,326254,Thomas de Blin,351786,25532,Jules-Roland Bousquet,213317,539571,2022-12-15
CASH_IN,147043,Agence_moov_Cotonou,300000,152957,Jules-Roland Bousquet,539571,686614,2022-12-17
TRANSFER,3265,Jules-Roland Bousquet,686614,683349,Lucy Lamy,1108400,1105135,2022-12-19
TRANSFER,407168,Stéphane Munoz,1148048,740880,Jules-Roland Bousquet,683349,1090517,2022-12-19
TRANSFER,872540,Lucie Aubert,1546300,673760,Jules-Roland Bousquet,1090517,1963057,2022-12-20
CASH_OUT,873162,Jules-Roland Bousquet,1963057,1089895,Agence_moov_Abomey,300000,-573162,2022-12-21
TRANSFER,770669,Jules-Roland Bousquet,1089895,319226,Tristan Gomez,900700,130031,2022-12-21
CASH_OUT,222934,Jules-Roland Bousquet,319226,96292,Agence_moov_Abomey,300000,77066,2022-12-22
CASH_OUT,5477,Jules-Roland Bousquet,96292,90815,Agence_moov_Cotonou,300000,294523,2022-12-22
TRANSFER,80968,Jules-Roland Bousquet,90815,9847,Frédéric Guillou,1150432,1069464,2022-12-23
TRANSFER,8305,Jules-Roland Bousquet,9847,1542,Hélène de la Gérard,180689,172384,2022-12-23
TRANSFER,155592,Aurore Charrier,1198300,1042708,Jules-Roland Bousquet,1542,157134,2022-12-24
CASH_IN,35341,Agence_moov_Cotonou,300000,264659,Jules-Roland Bousquet,157134,192475,2022-12-24
CASH_IN,98686,Agence_moov_Cotonou,300000,201314,Jules-Roland Bousquet,192475,291161,2022-12-24
CASH_IN,245248,Agence_moov_Cotonou,300000,54752,Jules-Roland Bousquet,291161,536409,2022-12-24
CASH_OUT,207415,Jules-Roland Bousquet,536409,328994,Agence_moov_Ouidah,300000,92585,2022-12-25
CASH_OUT,6083,Jules-Roland Bousquet,328994,322911,Agence_moov_Cotonou,300000,293917,2022-12-27
CASH_OUT,217766,Renée Rousseau-Henry,395100,177334,Agence_moov_Abomey,300000,82234,2022-12-03
CASH_OUT,59613,Renée Rousseau-Henry,177334,117721,Agence_moov_Ouidah,300000,240387,2022-12-03
TRANSFER,89737,Renée Rousseau-Henry,117721,27984,Paul Perez,621800,532063,2022-12-03
CASH_OUT,23312,Renée Rousseau-Henry,27984,4672,Agence_moov_Ouidah,300000,276688,2022-12-05
CASH_IN,223774,Agence_moov_Abomey,300000,76226,Renée Rousseau-Henry,4672,228446,2022-12-05
TRANSFER,146975,Renée Rousseau-Henry,228446,81471,Vincent de la Dumont,6764,-140211,2022-12-07
CASH_OUT,15609,Renée Rousseau-Henry,81471,65862,Agence_moov_Cotonou,300000,284391,2022-12-08
TRANSFER,15741,Renée Rousseau-Henry,65862,50121,Robert Laroche,936305,920564,2022-12-08
CASH_OUT,2703,Renée Rousseau-Henry,50121,47418,Agence_moov_Abomey,300000,297297,2022-12-09
CASH_IN,226820,Agence_moov_Cotonou,300000,73180,Renée Rousseau-Henry,47418,274238,2022-12-12
TRANSFER,26079,Renée Rousseau-Henry,274238,248159,Frédérique Fernandes du Bouchet,1465579,1439500,2022-12-13
CASH_IN,163728,Agence_moov_Cotonou,300000,136272,Renée Rousseau-Henry,248159,411887,2022-12-14
CASH_IN,40775,Agence_moov_Ouidah,300000,259225,Renée Rousseau-Henry,411887,452662,2022-12-15
TRANSFER,207396,Renée Rousseau-Henry,452662,245266,Hélène de la Gérard,172384,-35012,2022-12-15
TRANSFER,1256020,Nicolas Salmon Le Hamon,1413300,157280,Renée Rousseau-Henry,245266,1501286,2022-12-15
TRANSFER,629653,Renée Rousseau-Henry,1501286,871633,Bertrand Regnier,212000,-417653,2022-12-16
CASH_OUT,656265,Renée Rousseau-Henry,871633,215368,Agence_moov_Abomey,300000,-356265,2022-12-17
CASH_OUT,162358,Renée Rousseau-Henry,215368,53010,Agence_moov_Abomey,300000,137642,2022-12-17
TRANSFER,29063,Robert-Louis Gosselin,98200,69137,Renée Rousseau-Henry,53010,82073,2022-12-20
CASH_IN,277083,Agence_moov_Abomey,300000,22917,Renée Rousseau-Henry,82073,359156,2022-12-22
CASH_OUT,125642,Renée Rousseau-Henry,359156,233514,Agence_moov_Abomey,300000,174358,2022-12-24
CASH_IN,21843,Agence_moov_Abomey,300000,278157,Renée Rousseau-Henry,233514,255357,2022-12-25
CASH_IN,57134,Agence_moov_Ouidah,300000,242866,Renée Rousseau-Henry,255357,312491,2022-12-25
CASH_OUT,326997,Thomas-Robert Morvan,1379400,1052403,Agence_moov_Cotonou,300000,-26997,2022-12-01
CASH_OUT,702828,Thomas-Robert Morvan,1052403,349575,Agence_moov_Abomey,300000,-402828,2022-12-01
CASH_IN,297556,Agence_moov_Ouidah,300000,2444,Thomas-Robert Morvan,349575,647131,2022-12-01
CASH_OUT,18139,Thomas-Robert Morvan,647131,628992,Agence_moov_Ouidah,300000,281861,2022-12-03
CASH_OUT,170441,Thomas-Robert Morvan,628992,458551,Agence_moov_Ouidah,300000,129559,2022-12-07
TRANSFER,143408,Thomas-Robert Morvan,458551,315143,Tristan Gomez,130031,-13377,2022-12-08
CASH_IN,66337,Agence_moov_Abomey,300000,233663,Thomas-Robert Morvan,315143,381480,2022-12-10
CASH_IN,124784,Agence_moov_Abomey,300000,175216,Thomas-Robert Morvan,381480,506264,2022-12-11
TRANSFER,501086,Thomas-Robert Morvan,506264,5178,Vincent Joubert,684160,183074,2022-12-12
CASH_IN,173565,Agence_moov_Abomey,300000,126435,Thomas-Robert Morvan,5178,178743,2022-12-12
CASH_IN,53017,Agence_moov_Abomey,300000,246983,Thomas-Robert Morvan,178743,231760,2022-12-14
TRANSFER,385602,Mathilde Picard du Delmas,610494,224892,Thomas-Robert Morvan,231760,617362,2022-12-15
TRANSFER,1379265,Anastasie Richard-Neveu,1513654,134389,Thomas-Robert Morvan,617362,1996627,2022-12-15
CASH_IN,293258,Agence_moov_Abomey,300000,6742,Thomas-Robert Morvan,1996627,2289885,2022-12-15
CASH_IN,207866,Agence_moov_Ouidah,300000,92134,Thomas-Robert Morvan,2289885,2497751,2022-12-16
TRANSFER,631978,Paul Rocher-Maillet,742605,110627,Thomas-Robert Morvan,2497751,3129729,2022-12-16
TRANSFER,1297788,Constance Guillon,1840126,542338,Thomas-Robert Morvan,3129729,4427517,2022-12-18
CASH_IN,119417,Agence_moov_Abomey,300000,180583,Thomas-Robert Morvan,4427517,4546934,2022-12-19
CASH_IN,96441,Agence_moov_Ouidah,300000,203559,Thomas-Robert Morvan,4546934,4643375,2022-12-19
CASH_OUT,539564,Thomas-Robert Morvan,4643375,4103811,Agence_moov_Ouidah,300000,-239564,2022-12-20
CASH_IN,83938,Agence_moov_Abomey,300000,216062,Thomas-Robert Morvan,4103811,4187749,2022-12-20
TRANSFER,2549845,Thomas-Robert Morvan,4187749,1637904,Benoît Guyot,596700,-1953145,2022-12-21
CASH_OUT,166262,Thomas-Robert Morvan,1637904,1471642,Agence_moov_Cotonou,300000,133738,2022-12-22
CASH_IN,267995,Agence_moov_Ouidah,300000,32005,Thomas-Robert Morvan,1471642,1739637,2022-12-22
CASH_IN,82347,Agence_moov_Ouidah,300000,217653,Thomas-Robert Morvan,1739637,1821984,2022-12-25
CASH_IN,259279,Agence_moov_Ouidah,300000,40721,Thomas-Robert Morvan,1821984,2081263,2022-12-26
TRANSFER,19123,Mathilde Picard du Delmas,224892,205769,Noël Bourgeois,876041,856918,2022-12-01
TRANSFER,358476,Victor Michel,868100,509624,Mathilde Picard du Delmas,205769,564245,2022-12-02
CASH_OUT,354084,Mathilde Picard du Delmas,564245,210161,Agence_moov_Abomey,300000,-54084,2022-12-03
CASH_OUT,118324,Mathilde Picard du Delmas,210161,91837,Agence_moov_Cotonou,300000,181676,2022-12-04
TRANSFER,106140,Timothée-René Blanchard,244807,138667,Mathilde Picard du Delmas,91837,197977,2022-12-04
CASH_IN,151702,Agence_moov_Ouidah,300000,148298,Mathilde Picard du Delmas,197977,349679,2022-12-07
CASH_OUT,212627,Mathilde Picard du Delmas,349679,137052,Agence_moov_Ouidah,300000,87373,2022-12-11
CASH_IN,259152,Agence_moov_Cotonou,300000,40848,Mathilde Picard du Delmas,137052,396204,2022-12-14
CASH_OUT,68551,Mathilde Picard du Delmas,396204,327653,Agence_moov_Ouidah,300000,231449,2022-12-14
CASH_OUT,303277,Mathilde Picard du Delmas,327653,24376,Agence_moov_Cotonou,300000,-3277,2022-12-14
TRANSFER,413237,Simone Muller de la Brun,442800,29563,Mathilde Picard du Delmas,24376,437613,2022-12-14
CASH_OUT,15700,Mathilde Picard du Delmas,437613,421913,Agence_moov_Abomey,300000,284300,2022-12-15
TRANSFER,34450,Mathilde Picard du Delmas,421913,387463,Nath Loiseau,1261400,1226950,2022-12-15
CASH_OUT,112529,Mathilde Picard du Delmas,387463,274934,Agence_moov_Cotonou,300000,187471,2022-12-16
CASH_IN,94750,Agence_moov_Cotonou,300000,205250,Mathilde Picard du Delmas,274934,369684,2022-12-16
TRANSFER,279219,Mathilde Picard du Delmas,369684,90465,Stéphane Munoz,740880,461661,2022-12-17
CASH_OUT,69584,Mathilde Picard du Delmas,90465,20881,Agence_moov_Cotonou,300000,230416,2022-12-17
CASH_IN,126631,Agence_moov_Cotonou,300000,173369,Mathilde Picard du Delmas,20881,147512,2022-12-18
TRANSFER,10211,Thomas de Blin,25532,15321,Mathilde Picard du Delmas,147512,157723,2022-12-21
CASH_IN,34144,Agence_moov_Cotonou,300000,265856,Mathilde Picard du Delmas,157723,191867,2022-12-21
CASH_IN,22718,Agence_moov_Ouidah,300000,277282,Mathilde Picard du Delmas,191867,214585,2022-12-24
TRANSFER,355648,Aurore Charrier,1042708,687060,Mathilde Picard du Delmas,214585,570233,2022-12-24
TRANSFER,486145,Mathilde Picard du Delmas,570233,84088,Mathilde de la Samson,1555694,1069549,2022-12-25
CASH_IN,95095,Agence_moov_Cotonou,300000,204905,Mathilde Picard du Delmas,84088,179183,2022-12-27
CASH_OUT,36446,Adèle Da Silva-Klein,111300,74854,Agence_moov_Cotonou,300000,263554,2022-12-01
CASH_IN,59506,Agence_moov_Cotonou,300000,240494,Adèle Da Silva-Klein,74854,134360,2022-12-05
CASH_OUT,93210,Adèle Da Silva-Klein,134360,41150,Agence_moov_Cotonou,300000,206790,2022-12-09
TRANSFER,20114,Hélène Le Chauvin,93300,73186,Adèle Da Silva-Klein,41150,61264,2022-12-09
CASH_IN,235671,Agence_moov_Cotonou,300000,64329,Adèle Da Silva-Klein,61264,296935,2022-12-10
CASH_OUT,161884,Adèle Da Silva-Klein,296935,135051,Agence_moov_Ouidah,300000,138116,2022-12-11
CASH_IN,216936,Agence_moov_Cotonou,300000,83064,Adèle Da Silva-Klein,135051,351987,2022-12-12
CASH_OUT,91571,Adèle Da Silva-Klein,351987,260416,Agence_moov_Abomey,300000,208429,2022-12-12
TRANSFER,105379,Adèle Da Silva-Klein,260416,155037,Matthieu-Matthieu Bigot,791200,685821,2022-12-12
CASH_OUT,54674,Adèle Da Silva-Klein,155037,100363,Agence_moov_Abomey,300000,245326,2022-12-13
CASH_IN,60865,Agence_moov_Abomey,300000,239135,Adèle Da Silva-Klein,100363,161228,2022-12-13
TRANSFER,41727,Thomas Dupont,795800,754073,Adèle Da Silva-Klein,161228,202955,2022-12-13
TRANSFER,180179,Adèle Da Silva-Klein,202955,22776,Bernard Maurice,534600,354421,2022-12-13
TRANSFER,15361,Adèle Da Silva-Klein,22776,7415,Adèle Da Silva-Klein,22776,7415,2022-12-19
CASH_IN,169249,Agence_moov_Ouidah,300000,130751,Adèle Da Silva-Klein,7415,176664,2022-12-19
TRANSFER,97516,Adèle Da Silva-Klein,176664,79148,Théodore Joseph-Lefebvre,21499,-76017,2022-12-21
TRANSFER,300633,Tristan Delahaye,538046,237413,Adèle Da Silva-Klein,79148,379781,2022-12-21
CASH_IN,7866,Agence_moov_Abomey,300000,292134,Adèle Da Silva-Klein,379781,387647,2022-12-22
CASH_OUT,234210,Adèle Da Silva-Klein,387647,153437,Agence_moov_Abomey,300000,65790,2022-12-23
TRANSFER,346,André Renault,5867,5521,Adèle Da Silva-Klein,153437,153783,2022-12-23
CASH_IN,239616,Agence_moov_Cotonou,300000,60384,Adèle Da Silva-Klein,153783,393399,2022-12-23
TRANSFER,62428,Nicolas Salmon Le Hamon,157280,94852,Adèle Da Silva-Klein,393399,455827,2022-12-23
CASH_IN,192933,Agence_moov_Abomey,300000,107067,Adèle Da Silva-Klein,455827,648760,2022-12-26
CASH_OUT,307128,Matthieu-Matthieu Bigot,685821,378693,Agence_moov_Cotonou,300000,-7128,2022-12-01
CASH_OUT,176987,Matthieu-Matthieu Bigot,378693,201706,Agence_moov_Ouidah,300000,123013,2022-12-08
CASH_IN,271820,Agence_moov_Abomey,300000,28180,Matthieu-Matthieu Bigot,201706,473526,2022-12-08
CASH_IN,123765,Agence_moov_Ouidah,300000,176235,Matthieu-Matthieu Bigot,473526,597291,2022-12-09
CASH_IN,39053,Agence_moov_Abomey,300000,260947,Matthieu-Matthieu Bigot,597291,636344,2022-12-09
CASH_IN,29156,Agence_moov_Abomey,300000,270844,Matthieu-Matthieu Bigot,636344,665500,2022-12-10
CASH_IN,290139,Agence_moov_Abomey,300000,9861,Matthieu-Matthieu Bigot,665500,955639,2022-12-10
TRANSFER,51668,Manon Chevalier,1317400,1265732,Matthieu-Matthieu Bigot,955639,1007307,2022-12-11
CASH_IN,101060,Agence_moov_Ouidah,300000,198940,Matthieu-Matthieu Bigot,1007307,1108367,2022-12-13
CASH_IN,181902,Agence_moov_Abomey,300000,118098,Matthieu-Matthieu Bigot,1108367,1290269,2022-12-13
CASH_IN,141483,Agence_moov_Cotonou,300000,158517,Matthieu-Matthieu Bigot,1290269,1431752,2022-12-14
CASH_IN,166107,Agence_moov_Abomey,300000,133893,Matthieu-Matthieu Bigot,1431752,1597859,2022-12-14
CASH_OUT,1229801,Matthieu-Matthieu Bigot,1597859,368058,Agence_moov_Ouidah,300000,-929801,2022-12-15
TRANSFER,58858,Hélène Le Chauvin,73186,14328,Matthieu-Matthieu Bigot,368058,426916,2022-12-15
CASH_OUT,68473,Matthieu-Matthieu Bigot,426916,358443,Agence_moov_Cotonou,300000,231527,2022-12-16
CASH_IN,86531,Agence_moov_Ouidah,300000,213469,Matthieu-Matthieu Bigot,358443,444974,2022-12-16
CASH_OUT,114275,Matthieu-Matthieu Bigot,444974,330699,Agence_moov_Ouidah,300000,185725,2022-12-16
CASH_OUT,84564,Matthieu-Matthieu Bigot,330699,246135,Agence_moov_Ouidah,300000,215436,2022-12-18
CASH_OUT,3667,Matthieu-Matthieu Bigot,246135,242468,Agence_moov_Ouidah,300000,296333,2022-12-18
CASH_IN,128687,Agence_moov_Abomey,300000,171313,Matthieu-Matthieu Bigot,242468,371155,2022-12-19
CASH_IN,291844,Agence_moov_Cotonou,300000,8156,Matthieu-Matthieu Bigot,371155,662999,2022-12-20
CASH_OUT,597854,Matthieu-Matthieu Bigot,662999,65145,Agence_moov_Ouidah,300000,-297854,2022-12-20
CASH_IN,226169,Agence_moov_Abomey,300000,73831,Matthieu-Matthieu Bigot,65145,291314,2022-12-23
CASH_OUT,246292,Matthieu-Matthieu Bigot,291314,45022,Agence_moov_Abomey,300000,53708,2022-12-23
CASH_IN,36160,Agence_moov_Abomey,300000,263840,Matthieu-Matthieu Bigot,45022,81182,2022-12-25
CASH_IN,197385,Agence_moov_Cotonou,300000,102615,Matthieu-Matthieu Bigot,81182,278567,2022-12-25
CASH_OUT,193799,Matthieu-Matthieu Bigot,278567,84768,Agence_moov_Cotonou,300000,106201,2022-12-25
CASH_OUT,353822,Nath Loiseau,1226950,873128,Agence_moov_Ouidah,300000,-53822,2022-12-03
CASH_OUT,644302,Nath Loiseau,873128,228826,Agence_moov_Abomey,300000,-344302,2022-12-03
CASH_OUT,92831,Nath Loiseau,228826,135995,Agence_moov_Cotonou,300000,207169,2022-12-05
CASH_IN,227236,Agence_moov_Ouidah,300000,72764,Nath Loiseau,135995,363231,2022-12-05
CASH_IN,203056,Agence_moov_Cotonou,300000,96944,Nath Loiseau,363231,566287,2022-12-05
CASH_OUT,485773,Nath Loiseau,566287,80514,Agence_moov_Cotonou,300000,-185773,2022-12-05
CASH_OUT,71699,Nath Loiseau,80514,8815,Agence_moov_Ouidah,300000,228301,2022-12-06
TRANSFER,40894,Paul Rocher-Maillet,110627,69733,Nath Loiseau,8815,49709,2022-12-08
CASH_OUT,2412,Nath Loiseau,49709,47297,Agence_moov_Cotonou,300000,297588,2022-12-08
CASH_IN,12096,Agence_moov_Cotonou,300000,287904,Nath Loiseau,47297,59393,2022-12-10
CASH_OUT,51372,Nath Loiseau,59393,8021,Agence_moov_Cotonou,300000,248628,2022-12-11
TRANSFER,259033,Françoise Morin,268714,9681,Nath Loiseau,8021,267054,2022-12-13
CASH_OUT,50985,Nath Loiseau,267054,216069,Agence_moov_Abomey,300000,249015,2022-12-14
CASH_OUT,6262,Nath Loiseau,216069,209807,Agence_moov_Abomey,300000,293738,2022-12-14
CASH_IN,210965,Agence_moov_Cotonou,300000,89035,Nath Loiseau,209807,420772,2022-12-16
TRANSFER,636,Lucy Gillet,157988,157352,Nath Loiseau,420772,421408,2022-12-16
TRANSFER,154998,Nath Loiseau,421408,266410,Nicolas Salmon Le Hamon,94852,-60146,2022-12-17
CASH_OUT,182877,Nath Loiseau,266410,83533,Agence_moov_Cotonou,300000,117123,2022-12-17
CASH_OUT,18826,Nath Loiseau,83533,64707,Agence_moov_Ouidah,300000,281174,2022-12-18
CASH_IN,258398,Agence_moov_Cotonou,300000,41602,Nath Loiseau,64707,323105,2022-12-18
CASH_OUT,227590,Nath Loiseau,323105,95515,Agence_moov_Cotonou,300000,72410,2022-12-19
CASH_IN,253175,Agence_moov_Cotonou,300000,46825,Nath Loiseau,95515,348690,2022-12-20
CASH_IN,210477,Agence_moov_Cotonou,300000,89523,Nath Loiseau,348690,559167,2022-12-22
TRANSFER,143990,Nath Loiseau,559167,415177,Thérèse François,1745400,1601410,2022-12-23
TRANSFER,1028786,Lucy Lamy,1105135,76349,Nath Loiseau,415177,1443963,2022-12-25
CASH_IN,35948,Agence_moov_Cotonou,300000,264052,Nath Loiseau,1443963,1479911,2022-12-27
CASH_IN,204439,Agence_moov_Ouidah,300000,95561,Nath Loiseau,1479911,1684350,2022-12-27
CASH_OUT,1620594,Nath Loiseau,1684350,63756,Agence_moov_Ouidah,300000,-1320594,2022-12-27
CASH_IN,144186,Agence_moov_Abomey,300000,155814,Bernard Maurice,354421,498607,2022-12-03
CASH_OUT,224992,Bernard Maurice,498607,273615,Agence_moov_Cotonou,300000,75008,2022-12-04
TRANSFER,51862,Vincent Joubert,183074,131212,Bernard Maurice,273615,325477,2022-12-04
CASH_OUT,279882,Bernard Maurice,325477,45595,Agence_moov_Abomey,300000,20118,2022-12-05
CASH_OUT,6091,Bernard Maurice,45595,39504,Agence_moov_Ouidah,300000,293909,2022-12-06
TRANSFER,67497,Robert-Louis Gosselin,69137,1640,Bernard Maurice,39504,107001,2022-12-06
CASH_IN,194216,Agence_moov_Cotonou,300000,105784,Bernard Maurice,107001,301217,2022-12-07
CASH_OUT,33122,Bernard Maurice,301217,268095,Agence_moov_Cotonou,300000,266878,2022-12-09
CASH_OUT,144895,Bernard Maurice,268095,123200,Agence_moov_Cotonou,300000,155105,2022-12-10
TRANSFER,124495,Robert Clerc,938893,814398,Bernard Maurice,123200,247695,2022-12-11
CASH_IN,113043,Agence_moov_Ouidah,300000,186957,Bernard Maurice,247695,360738,2022-12-12
CASH_OUT,85783,Bernard Maurice,360738,274955,Agence_moov_Cotonou,300000,214217,2022-12-15
TRANSFER,186126,Raymond Lévy,721400,535274,Bernard Maurice,274955,461081,2022-12-16
CASH_OUT,340771,Bernard Maurice,461081,120310,Agence_moov_Cotonou,300000,-40771,2022-12-17
CASH_OUT,92490,Bernard Maurice,120310,27820,Agence_moov_Abomey,300000,207510,2022-12-19
TRANSFER,459034,Richard Michel,668250,209216,Bernard Maurice,27820,486854,2022-12-19
CASH_IN,29791,Agence_moov_Ouidah,300000,270209,Bernard Maurice,486854,516645,2022-12-20
CASH_IN,127543,Agence_moov_Cotonou,300000,172457,Bernard Maurice,516645,644188,2022-12-21
TRANSFER,88949,Bernard Maurice,644188,555239,Thomas Dupont,754073,665124,2022-12-21
CASH_IN,78383,Agence_moov_Ouidah,300000,221617,Bernard Maurice,555239,633622,2022-12-21
TRANSFER,264831,Bernard Maurice,633622,368791,Thérèse François,1601410,1336579,2022-12-24
TRANSFER,349256,Noël Bourgeois,856918,507662,Bernard Maurice,368791,718047,2022-12-26
CASH_IN,124418,Agence_moov_Cotonou,300000,175582,Nicolas Salmon Le Hamon,-60146,64272,2022-12-01
CASH_OUT,38687,Nicolas Salmon Le Hamon,64272,25585,Agence_moov_Cotonou,300000,261313,2022-12-02
CASH_IN,110642,Agence_moov_Ouidah,300000,189358,Nicolas Salmon Le Hamon,25585,136227,2022-12-02
TRANSFER,826696,Antoinette de Dupuis,1511200,684504,Nicolas Salmon Le Hamon,136227,962923,2022-12-04
TRANSFER,953857,Nicolas Salmon Le Hamon,962923,9066,Aurore Charrier,687060,-266797,2022-12-06
CASH_OUT,8125,Nicolas Salmon Le Hamon,9066,941,Agence_moov_Ouidah,300000,291875,2022-12-06
TRANSFER,187841,Robert Laroche,920564,732723,Nicolas Salmon Le Hamon,941,188782,2022-12-07
CASH_OUT,75049,Nicolas Salmon Le Hamon,188782,113733,Agence_moov_Abomey,300000,224951,2022-12-08
CASH_IN,50429,Agence_moov_Ouidah,300000,249571,Nicolas Salmon Le Hamon,113733,164162,2022-12-08
TRANSFER,4331,André Renault,5521,1190,Nicolas Salmon Le Hamon,164162,168493,2022-12-09
CASH_OUT,123913,Nicolas Salmon Le Hamon,168493,44580,Agence_moov_Ouidah,300000,176087,2022-12-10
CASH_IN,79559,Agence_moov_Abomey,300000,220441,Nicolas Salmon Le Hamon,44580,124139,2022-12-16
TRANSFER,146635,Bernadette de Jourdan,927053,780418,Nicolas Salmon Le Hamon,124139,270774,2022-12-18
TRANSFER,160584,Nicolas Salmon Le Hamon,270774,110190,Manon Chevalier,1265732,1105148,2022-12-19
TRANSFER,1101863,Manon Chevalier,1105148,3285,Nicolas Salmon Le Hamon,110190,1212053,2022-12-20
TRANSFER,253102,Nicolas Salmon Le Hamon,1212053,958951,Frédéric Guillou,1069464,816362,2022-12-21
CASH_IN,87476,Agence_moov_Cotonou,300000,212524,Nicolas Salmon Le Hamon,958951,1046427,2022-12-22
TRANSFER,229897,Raymond Lévy,535274,305377,Nicolas Salmon Le Hamon,1046427,1276324,2022-12-23
CASH_IN,58397,Agence_moov_Abomey,300000,241603,Nicolas Salmon Le Hamon,1276324,1334721,2022-12-24
TRANSFER,2416,Nicolas Salmon Le Hamon,1334721,1332305,Léon Da Costa,903630,901214,2022-12-25
CASH_IN,46458,Agence_moov_Cotonou,300000,253542,Nicolas Salmon Le Hamon,1332305,1378763,2022-12-25
CASH_IN,23210,Agence_moov_Ouidah,300000,276790,Nicolas Salmon Le Hamon,1378763,1401973,2022-12-25
TRANSFER,1269673,Nicolas Salmon Le Hamon,1401973,132300,Simone Muller de la Brun,29563,-1240110,2022-12-26
CASH_IN,196637,Agence_moov_Cotonou,300000,103363,Nicolas Salmon Le Hamon,132300,328937,2022-12-27
CASH_OUT,109085,Nicolas Salmon Le Hamon,328937,219852,Agence_moov_Cotonou,300000,190915,2022-12-27
CASH_OUT,155563,Nicolas Salmon Le Hamon,219852,64289,Agence_moov_Cotonou,300000,144437,2022-12-27
CASH_OUT,10935,Nicolas Salmon Le Hamon,64289,53354,Agence_moov_Ouidah,300000,289065,2022-12-27
TRANSFER,700379,Frédérique Fernandes du Bouchet,1439500,739121,Paul Rocher-Maillet,69733,770112,2022-12-01
CASH_IN,266608,Agence_moov_Abomey,300000,33392,Paul Rocher-Maillet,770112,1036720,2022-12-03
CASH_IN,74048,Agence_moov_Cotonou,300000,225952,Paul Rocher-Maillet,1036720,1110768,2022-12-05
CASH_OUT,485904,Paul Rocher-Maillet,1110768,624864,Agence_moov_Cotonou,300000,-185904,2022-12-05
TRANSFER,323959,Renée Le Diaz,380851,56892,Paul Rocher-Maillet,624864,948823,2022-12-07
CASH_OUT,873565,Paul Rocher-Maillet,948823,75258,Agence_moov_Cotonou,300000,-573565,2022-12-08
CASH_IN,18340,Agence_moov_Ouidah,300000,281660,Paul Rocher-Maillet,75258,93598,2022-12-09
CASH_OUT,54253,Paul Rocher-Maillet,93598,39345,Agence_moov_Ouidah,300000,245747,2022-12-11
CASH_IN,96515,Agence_moov_Abomey,300000,203485,Paul Rocher-Maillet,39345,135860,2022-12-11
TRANSFER,3060,Thomas de Blin,15321,12261,Paul Rocher-Maillet,135860,138920,2022-12-12
TRANSFER,94883,Paul Rocher-Maillet,138920,44037,Céline Collin-Hervé,125899,31016,2022-12-15
CASH_OUT,14778,Paul Rocher-Maillet,44037,29259,Agence_moov_Cotonou,300000,285222,2022-12-15
CASH_IN,256258,Agence_moov_Abomey,300000,43742,Paul Rocher-Maillet,29259,285517,2022-12-17
CASH_OUT,123177,Paul Rocher-Maillet,285517,162340,Agence_moov_Ouidah,300000,176823,2022-12-18
CASH_OUT,26918,Paul Rocher-Maillet,162340,135422,Agence_moov_Cotonou,300000,273082,2022-12-18
CASH_OUT,114235,Paul Rocher-Maillet,135422,21187,Agence_moov_Cotonou,300000,185765,2022-12-18
CASH_IN,50638,Agence_moov_Ouidah,300000,249362,Paul Rocher-Maillet,21187,71825,2022-12-18
CASH_IN,173793,Agence_moov_Ouidah,300000,126207,Paul Rocher-Maillet,71825,245618,2022-12-19
CASH_OUT,166234,Paul Rocher-Maillet,245618,79384,Agence_moov_Ouidah,300000,133766,2022-12-22
CASH_IN,111410,Agence_moov_Ouidah,300000,188590,Paul Rocher-Maillet,79384,190794,2022-12-22
CASH_IN,153765,Agence_moov_Ouidah,300000,146235,Paul Rocher-Maillet,190794,344559,2022-12-23
TRANSFER,315443,Paul Perez,532063,216620,Paul Rocher-Maillet,344559,660002,2022-12-24
CASH_IN,268712,Agence_moov_Cotonou,300000,31288,Paul Rocher-Maillet,660002,928714,2022-12-24
CASH_OUT,956,Manon Chevalier,3285,2329,Agence_moov_Cotonou,300000,299044,2022-12-01
TRANSFER,1254649,Thérèse François,1336579,81930,Manon Chevalier,2329,1256978,2022-12-01
CASH_IN,85518,Agence_moov_Ouidah,300000,214482,Manon Chevalier,1256978,1342496,2022-12-01
TRANSFER,440,André Renault,1190,750,Manon Chevalier,1342496,1342936,2022-12-01
CASH_IN,182794,Agence_moov_Ouidah,300000,117206,Manon Chevalier,1342936,1525730,2022-12-03
CASH_OUT,560433,Manon Chevalier,1525730,965297,Agence_moov_Cotonou,300000,-260433,2022-12-03
TRANSFER,319644,Manon Chevalier,965297,645653,Frédérique Fernandes du Bouchet,739121,419477,2022-12-05
TRANSFER,604907,Gabriel Bègue,1295829,690922,Manon Chevalier,645653,1250560,2022-12-05
CASH_OUT,475564,Manon Chevalier,1250560,774996,Agence_moov_Abomey,300000,-175564,2022-12-09
TRANSFER,671189,Manon Chevalier,774996,103807,Lucy Lamy,76349,-594840,2022-12-09
TRANSFER,80079,Manon Chevalier,103807,23728,Colette Merle Le Robert,853700,773621,2022-12-12
TRANSFER,781539,Tristan Bousquet-Gros,887785,106246,Manon Chevalier,23728,805267,2022-12-14
CASH_IN,25754,Agence_moov_Cotonou,300000,274246,Manon Chevalier,805267,831021,2022-12-15
CASH_IN,34435,Agence_moov_Ouidah,300000,265565,Manon Chevalier,831021,865456,2022-12-15
CASH_OUT,576151,Manon Chevalier,865456,289305,Agence_moov_Ouidah,300000,-276151,2022-12-18
TRANSFER,170297,Manon Chevalier,289305,119008,Tristan Delahaye,237413,67116,2022-12-19
TRANSFER,695550,Léon Da Costa,901214,205664,Manon Chevalier,119008,814558,2022-12-21
TRANSFER,10984,Manon Chevalier,814558,803574,Léon Da Costa,205664,194680,2022-12-22
TRANSFER,73289,Manon Chevalier,803574,730285,Manon Chevalier,803574,730285,2022-12-23
CASH_IN,231162,Agence_moov_Abomey,300000,68838,Manon Chevalier,730285,961447,2022-12-23
CASH_IN,298365,Agence_moov_Abomey,300000,1635,Manon Chevalier,961447,1259812,2022-12-23
CASH_OUT,463473,Manon Chevalier,1259812,796339,Agence_moov_Abomey,300000,-163473,2022-12-24
CASH_IN,95086,Agence_moov_Cotonou,300000,204914,Manon Chevalier,796339,891425,2022-12-27
CASH_IN,24249,Agence_moov_Abomey,300000,275751,Manon Chevalier,891425,915674,2022-12-27
CASH_OUT,9028,Françoise Morin,9681,653,Agence_moov_Ouidah,300000,290972,2022-12-01
CASH_IN,171180,Agence_moov_Ouidah,300000,128820,Françoise Morin,653,171833,2022-12-03
CASH_IN,118243,Agence_moov_Cotonou,300000,181757,Françoise Morin,171833,290076,2022-12-05
CASH_IN,164458,Agence_moov_Cotonou,300000,135542,Françoise Morin,290076,454534,2022-12-06
CASH_OUT,307195,Françoise Morin,454534,147339,Agence_moov_Abomey,300000,-7195,2022-12-06
TRANSFER,21129,Timothée-René Blanchard,138667,117538,Françoise Morin,147339,168468,2022-12-07
CASH_IN,219380,Agence_moov_Ouidah,300000,80620,Françoise Morin,168468,387848,2022-12-08
CASH_IN,83319,Agence_moov_Abomey,300000,216681,Françoise Morin,387848,471167,2022-12-09
TRANSFER,34407,Anastasie Richard-Neveu,134389,99982,Françoise Morin,471167,505574,2022-12-09
CASH_IN,98338,Agence_moov_Cotonou,300000,201662,Françoise Morin,505574,603912,2022-12-09
CASH_OUT,511954,Françoise Morin,603912,91958,Agence_moov_Abomey,300000,-211954,2022-12-10
TRANSFER,468551,Virginie Bouvet,625509,156958,Françoise Morin,91958,560509,2022-12-11
CASH_OUT,310133,Françoise Morin,560509,250376,Agence_moov_Abomey,300000,-10133,2022-12-11
TRANSFER,10525,Françoise Morin,250376,239851,Richard Michel,209216,198691,2022-12-12
CASH_OUT,171602,Françoise Morin,239851,68249,Agence_moov_Ouidah,300000,128398,2022-12-12
TRANSFER,552902,Bernadette de Jourdan,780418,227516,Françoise Morin,68249,621151,2022-12-15
TRANSFER,498093,Françoise Morin,621151,123058,Renée Le Diaz,56892,-441201,2022-12-18
CASH_OUT,60848,Françoise Morin,123058,62210,Agence_moov_Cotonou,300000,239152,2022-12-18
CASH_OUT,43568,Françoise Morin,62210,18642,Agence_moov_Cotonou,300000,256432,2022-12-19
TRANSFER,771986,Émile-René Baudry,1534246,762260,Françoise Morin,18642,790628,2022-12-19
TRANSFER,289768,Françoise Morin,790628,500860,Raymond Lévy,305377,15609,2022-12-20
TRANSFER,55816,Françoise Morin,500860,445044,Thérèse François,81930,26114,2022-12-20
TRANSFER,1228284,Manon Lebon,1924000,695716,Françoise Morin,445044,1673328,2022-12-24
CASH_IN,102141,Agence_moov_Cotonou,300000,197859,Françoise Morin,1673328,1775469,2022-12-27
CASH_OUT,414737,Françoise Morin,1775469,1360732,Agence_moov_Abomey,300000,-114737,2022-12-27
CASH_IN,82257,Agence_moov_Cotonou,300000,217743,Françoise Morin,1360732,1442989,2022-12-27
TRANSFER,483267,Rémy Grondin,1144500,661233,Vincent Joubert,131212,614479,2022-12-04
CASH_OUT,554928,Vincent Joubert,614479,59551,Agence_moov_Cotonou,300000,-254928,2022-12-05
TRANSFER,23719,Vincent Joubert,59551,35832,Rémy Grondin,661233,637514,2022-12-05
CASH_IN,278912,Agence_moov_Abomey,300000,21088,Vincent Joubert,35832,314744,2022-12-06
CASH_IN,118686,Agence_moov_Cotonou,300000,181314,Vincent Joubert,314744,433430,2022-12-06
CASH_IN,16643,Agence_moov_Abomey,300000,283357,Vincent Joubert,433430,450073,2022-12-06
CASH_IN,114915,Agence_moov_Ouidah,300000,185085,Vincent Joubert,450073,564988,2022-12-08
CASH_OUT,498700,Vincent Joubert,564988,66288,Agence_moov_Abomey,300000,-198700,2022-12-09
CASH_OUT,13655,Vincent Joubert,66288,52633,Agence_moov_Ouidah,300000,286345,2022-12-10
CASH_OUT,15572,Vincent Joubert,52633,37061,Agence_moov_Ouidah,300000,284428,2022-12-13
TRANSFER,267073,Noël Bourgeois,507662,240589,Vincent Joubert,37061,304134,2022-12-13
TRANSFER,319526,Robert Clerc,814398,494872,Vincent Joubert,304134,623660,2022-12-14
CASH_IN,198486,Agence_moov_Ouidah,300000,101514,Vincent Joubert,623660,822146,2022-12-16
CASH_IN,12056,Agence_moov_Abomey,300000,287944,Vincent Joubert,822146,834202,2022-12-19
CASH_IN,264905,Agence_moov_Cotonou,300000,35095,Vincent Joubert,834202,1099107,2022-12-22
CASH_OUT,459316,Vincent Joubert,1099107,639791,Agence_moov_Ouidah,300000,-159316,2022-12-24
TRANSFER,375379,Vincent Joubert,639791,264412,Vincent Joubert,639791,1015170,2022-12-26
TRANSFER,167905,Vincent Joubert,264412,96507,Vincent Joubert,264412,96507,2022-12-26
CASH_OUT,17286,Vincent Joubert,96507,79221,Agence_moov_Cotonou,300000,282714,2022-12-27
CASH_IN,52506,Agence_moov_Abomey,300000,247494,Vincent Joubert,79221,131727,2022-12-27
TRANSFER,56386,Vincent Joubert,131727,75341,Victor Michel,509624,453238,2022-12-27
CASH_OUT,17373,Vincent Joubert,75341,57968,Agence_moov_Cotonou,300000,282627,2022-12-27
CASH_IN,298546,Agence_moov_Abomey,300000,1454,Victor Michel,453238,751784,2022-12-01
CASH_IN,15888,Agence_moov_Abomey,300000,284112,Victor Michel,751784,767672,2022-12-02
CASH_IN,69403,Agence_moov_Abomey,300000,230597,Victor Michel,767672,837075,2022-12-04
TRANSFER,14250,Raymond Lévy,15609,1359,Victor Michel,837075,851325,2022-12-08
TRANSFER,568306,Victor Michel,851325,283019,Alix Barbe,1229200,660894,2022-12-09
TRANSFER,237366,Gabriel Bègue,690922,453556,Victor Michel,283019,520385,2022-12-11
CASH_OUT,466587,Victor Michel,520385,53798,Agence_moov_Cotonou,300000,-166587,2022-12-11
TRANSFER,38277,Victor Michel,53798,15521,Alix Barbe,660894,622617,2022-12-12
TRANSFER,12666,Victor Michel,15521,2855,Lucie Aubert,673760,661094,2022-12-13
TRANSFER,579,André Renault,750,171,Victor Michel,2855,3434,2022-12-14
CASH_IN,23079,Agence_moov_Cotonou,300000,276921,Victor Michel,3434,26513,2022-12-15
CASH_IN,229957,Agence_moov_Abomey,300000,70043,Victor Michel,26513,256470,2022-12-15
TRANSFER,12842,Céline Collin-Hervé,31016,18174,Victor Michel,256470,269312,2022-12-16
TRANSFER,199472,Constance Guillon,542338,342866,Victor Michel,269312,468784,2022-12-18
CASH_OUT,420221,Victor Michel,468784,48563,Agence_moov_Ouidah,300000,-120221,2022-12-19
CASH_IN,262251,Agence_moov_Ouidah,300000,37749,Victor Michel,48563,310814,2022-12-19
TRANSFER,4414,Thérèse François,26114,21700,Victor Michel,310814,315228,2022-12-21
CASH_IN,292707,Agence_moov_Abomey,300000,7293,Victor Michel,315228,607935,2022-12-22
CASH_OUT,314176,Victor Michel,607935,293759,Agence_moov_Abomey,300000,-14176,2022-12-24
TRANSFER,89807,Noël Bourgeois,240589,150782,Victor Michel,293759,383566,2022-12-24
CASH_OUT,276519,Victor Michel,383566,107047,Agence_moov_Abomey,300000,23481,2022-12-25
TRANSFER,22709,Victor Michel,107047,84338,Thomas de Blin,12261,-10448,2022-12-26
TRANSFER,85147,Mathilde de la Samson,1069549,984402,Victor Michel,84338,169485,2022-12-27
CASH_IN,71017,Agence_moov_Ouidah,300000,228983,Benoît Guyot,-1953145,-1882128,2022-12-02
CASH_IN,298515,Agence_moov_Abomey,300000,1485,Benoît Guyot,-1882128,-1583613,2022-12-03
CASH_IN,265396,Agence_moov_Cotonou,300000,34604,Benoît Guyot,-1583613,-1318217,2022-12-04
CASH_IN,219222,Agence_moov_Cotonou,300000,80778,Benoît Guyot,-1318217,-1098995,2022-12-04
CASH_IN,37552,Agence_moov_Cotonou,300000,262448,Benoît Guyot,-1098995,-1061443,2022-12-05
CASH_IN,212222,Agence_moov_Cotonou,300000,87778,Benoît Guyot,-1061443,-849221,2022-12-07
CASH_IN,259402,Agence_moov_Ouidah,300000,40598,Benoît Guyot,-849221,-589819,2022-12-08
CASH_IN,225025,Agence_moov_Abomey,300000,74975,Benoît Guyot,-589819,-364794,2022-12-09
CASH_IN,184034,Agence_moov_Cotonou,300000,115966,Benoît Guyot,-364794,-180760,2022-12-09
CASH_IN,234881,Agence_moov_Ouidah,300000,65119,Benoît Guyot,-180760,54121,2022-12-10
CASH_IN,285153,Agence_moov_Ouidah,300000,14847,Benoît Guyot,54121,339274,2022-12-10
TRANSFER,168040,Benoît Guyot,339274,171234,Thérèse François,21700,-146340,2022-12-10
TRANSFER,92140,Benoît Guyot,171234,79094,Anastasie Richard-Neveu,99982,7842,2022-12-10
CASH_OUT,23055,Benoît Guyot,79094,56039,Agence_moov_Ouidah,300000,276945,2022-12-11
CASH_OUT,54903,Benoît Guyot,56039,1136,Agence_moov_Abomey,300000,245097,2022-12-11
CASH_IN,132295,Agence_moov_Abomey,300000,167705,Benoît Guyot,1136,133431,2022-12-13
CASH_IN,298976,Agence_moov_Cotonou,300000,1024,Benoît Guyot,133431,432407,2022-12-14
CASH_OUT,143386,Benoît Guyot,432407,289021,Agence_moov_Cotonou,300000,156614,2022-12-16
TRANSFER,654226,Frédéric Guillou,816362,162136,Benoît Guyot,289021,943247,2022-12-17
CASH_IN,146210,Agence_moov_Ouidah,300000,153790,Benoît Guyot,943247,1089457,2022-12-18
CASH_OUT,251259,Benoît Guyot,1089457,838198,Agence_moov_Cotonou,300000,48741,2022-12-18
TRANSFER,823,Raymond Lévy,1359,536,Benoît Guyot,838198,839021,2022-12-18
TRANSFER,831157,Benoît Guyot,839021,7864,Émile-René Baudry,762260,-68897,2022-12-19
TRANSFER,5827,Benoît Guyot,7864,2037,Colette Merle Le Robert,773621,767794,2022-12-20
CASH_IN,279833,Agence_moov_Cotonou,300000,20167,Benoît Guyot,2037,281870,2022-12-21
CASH_IN,189390,Agence_moov_Abomey,300000,110610,Benoît Guyot,281870,471260,2022-12-22
TRANSFER,145390,Benoît Guyot,471260,325870,Raymond Lévy,536,-144854,2022-12-23
TRANSFER,30344,Virginie Bouvet,156958,126614,Benoît Guyot,325870,356214,2022-12-24
CASH_OUT,124871,Benoît Guyot,356214,231343,Agence_moov_Abomey,300000,175129,2022-12-24
CASH_OUT,154983,Benoît Guyot,231343,76360,Agence_moov_Abomey,300000,145017,2022-12-25
TRANSFER,78177,Emmanuel Grégoire,286639,208462,Stéphane Munoz,461661,383484,2022-12-04
TRANSFER,177177,Emmanuel Grégoire,208462,31285,Lucy Gillet,157352,-19825,2022-12-04
CASH_IN,140383,Agence_moov_Cotonou,300000,159617,Emmanuel Grégoire,31285,171668,2022-12-04
CASH_OUT,116949,Emmanuel Grégoire,171668,54719,Agence_moov_Cotonou,300000,183051,2022-12-06
CASH_OUT,19311,Emmanuel Grégoire,54719,35408,Agence_moov_Ouidah,300000,280689,2022-12-07
CASH_IN,3875,Agence_moov_Ouidah,300000,296125,Emmanuel Grégoire,35408,39283,2022-12-07
CASH_IN,119706,Agence_moov_Cotonou,300000,180294,Emmanuel Grégoire,39283,158989,2022-12-08
CASH_OUT,103969,Emmanuel Grégoire,158989,55020,Agence_moov_Abomey,300000,196031,2022-12-09
CASH_IN,56945,Agence_moov_Ouidah,300000,243055,Emmanuel Grégoire,55020,111965,2022-12-09
CASH_OUT,33304,Emmanuel Grégoire,111965,78661,Agence_moov_Abomey,300000,266696,2022-12-09
TRANSFER,38716,Emmanuel Grégoire,78661,39945,Anne Peltier-Raynaud,1241700,1202984,2022-12-10
CASH_IN,177045,Agence_moov_Abomey,300000,122955,Emmanuel Grégoire,39945,216990,2022-12-11
CASH_IN,10993,Agence_moov_Abomey,300000,289007,Emmanuel Grégoire,216990,227983,2022-12-13
CASH_OUT,62850,Emmanuel Grégoire,227983,165133,Agence_moov_Abomey,300000,237150,2022-12-13
CASH_IN,168780,Agence_moov_Ouidah,300000,131220,Emmanuel Grégoire,165133,333913,2022-12-13
CASH_OUT,233903,Emmanuel Grégoire,333913,100010,Agence_moov_Cotonou,300000,66097,2022-12-17
CASH_OUT,51530,Emmanuel Grégoire,100010,48480,Agence_moov_Cotonou,300000,248470,2022-12-18
CASH_OUT,10623,Emmanuel Grégoire,48480,37857,Agence_moov_Ouidah,300000,289377,2022-12-18
TRANSFER,12265,Emmanuel Grégoire,37857,25592,Robert Laroche,732723,720458,2022-12-18
CASH_OUT,16833,Emmanuel Grégoire,25592,8759,Agence_moov_Ouidah,300000,283167,2022-12-19
CASH_IN,158994,Agence_moov_Ouidah,300000,141006,Emmanuel Grégoire,8759,167753,2022-12-19
TRANSFER,131814,Emmanuel Grégoire,167753,35939,Robert Clerc,494872,363058,2022-12-20
CASH_OUT,4196,Emmanuel Grégoire,35939,31743,Agence_moov_Ouidah,300000,295804,2022-12-21
TRANSFER,92285,Timothée-René Blanchard,117538,25253,Emmanuel Grégoire,31743,124028,2022-12-22
CASH_OUT,44430,Emmanuel Grégoire,124028,79598,Agence_moov_Ouidah,300000,255570,2022-12-22
CASH_OUT,12306,Emmanuel Grégoire,79598,67292,Agence_moov_Ouidah,300000,287694,2022-12-23
CASH_IN,126847,Agence_moov_Cotonou,300000,173153,Emmanuel Grégoire,67292,194139,2022-12-23
CASH_IN,5716,Agence_moov_Abomey,300000,294284,Emmanuel Grégoire,194139,199855,2022-12-24
TRANSFER,27777,Noël Bourgeois,150782,123005,Emmanuel Grégoire,199855,227632,2022-12-26
CASH_IN,251464,Agence_moov_Abomey,300000,48536,Renée Le Diaz,-441201,-189737,2022-12-04
CASH_IN,175454,Agence_moov_Cotonou,300000,124546,Renée Le Diaz,-189737,-14283,2022-12-04
CASH_IN,25851,Agence_moov_Cotonou,300000,274149,Renée Le Diaz,-14283,11568,2022-12-05
TRANSFER,4408,Renée Le Diaz,11568,7160,Hélène Le Chauvin,14328,9920,2022-12-07
CASH_IN,52225,Agence_moov_Ouidah,300000,247775,Renée Le Diaz,7160,59385,2022-12-08
TRANSFER,222364,Stéphane Munoz,383484,161120,Renée Le Diaz,59385,281749,2022-12-08
CASH_OUT,174230,Renée Le Diaz,281749,107519,Agence_moov_Abomey,300000,125770,2022-12-09
CASH_OUT,19838,Renée Le Diaz,107519,87681,Agence_moov_Abomey,300000,280162,2022-12-10
CASH_IN,47009,Agence_moov_Abomey,300000,252991,Renée Le Diaz,87681,134690,2022-12-11
CASH_IN,109599,Agence_moov_Abomey,300000,190401,Renée Le Diaz,134690,244289,2022-12-11
CASH_IN,58334,Agence_moov_Cotonou,300000,241666,Renée Le Diaz,244289,302623,2022-12-11
CASH_IN,40098,Agence_moov_Abomey,300000,259902,Renée Le Diaz,302623,342721,2022-12-11
CASH_IN,246229,Agence_moov_Ouidah,300000,53771,Renée Le Diaz,342721,588950,2022-12-13
CASH_IN,271372,Agence_moov_Cotonou,300000,28628,Renée Le Diaz,588950,860322,2022-12-14
CASH_IN,157866,Agence_moov_Abomey,300000,142134,Renée Le Diaz,860322,1018188,2022-12-14
CASH_IN,228983,Agence_moov_Abomey,300000,71017,Renée Le Diaz,1018188,1247171,2022-12-14
CASH_OUT,611930,Renée Le Diaz,1247171,635241,Agence_moov_Ouidah,300000,-311930,2022-12-20
TRANSFER,555168,Renée Le Diaz,635241,80073,Antoinette de Dupuis,684504,129336,2022-12-21
CASH_OUT,4205,Renée Le Diaz,80073,75868,Agence_moov_Cotonou,300000,295795,2022-12-22
CASH_OUT,35421,Renée Le Diaz,75868,40447,Agence_moov_Abomey,300000,264579,2022-12-24
CASH_OUT,5252,Renée Le Diaz,40447,35195,Agence_moov_Ouidah,300000,294748,2022-12-24
CASH_OUT,20627,Renée Le Diaz,35195,14568,Agence_moov_Cotonou,300000,279373,2022-12-25
TRANSFER,10666,Renée Le Diaz,14568,3902,Anne Peltier-Raynaud,1202984,1192318,2022-12-27
TRANSFER,5738,Hélène Le Chauvin,9920,4182,Michelle Samson,178720,172982,2022-12-02
TRANSFER,45832,Tristan Delahaye,67116,21284,Hélène Le Chauvin,4182,50014,2022-12-05
TRANSFER,31247,Hélène Le Chauvin,50014,18767,Céline Collin-Hervé,18174,-13073,2022-12-18
CASH_OUT,18523,Hélène Le Chauvin,18767,244,Agence_moov_Ouidah,300000,281477,2022-12-21
CASH_IN,47136,Agence_moov_Ouidah,300000,252864,Hélène Le Chauvin,244,47380,2022-12-24
TRANSFER,15150,Hélène Le Chauvin,47380,32230,Mathilde de la Samson,984402,969252,2022-12-24
CASH_IN,19507,Agence_moov_Abomey,300000,280493,Hélène Le Chauvin,32230,51737,2022-12-27
CASH_IN,259327,Agence_moov_Ouidah,300000,40673,Bertrand Regnier,-417653,-158326,2022-12-01
CASH_IN,24110,Agence_moov_Ouidah,300000,275890,Bertrand Regnier,-158326,-134216,2022-12-02
CASH_IN,277066,Agence_moov_Cotonou,300000,22934,Bertrand Regnier,-134216,142850,2022-12-04
TRANSFER,23731,Manon Lebon,695716,671985,Bertrand Regnier,142850,166581,2022-12-09
CASH_IN,162138,Agence_moov_Cotonou,300000,137862,Bertrand Regnier,166581,328719,2022-12-11
CASH_IN,279223,Agence_moov_Cotonou,300000,20777,Bertrand Regnier,328719,607942,2022-12-15
CASH_IN,57371,Agence_moov_Ouidah,300000,242629,Bertrand Regnier,607942,665313,2022-12-16
CASH_IN,44029,Agence_moov_Cotonou,300000,255971,Bertrand Regnier,665313,709342,2022-12-17
CASH_IN,178709,Agence_moov_Abomey,300000,121291,Bertrand Regnier,709342,888051,2022-12-18
CASH_IN,229845,Agence_moov_Ouidah,300000,70155,Bertrand Regnier,888051,1117896,2022-12-19
CASH_IN,102426,Agence_moov_Abomey,300000,197574,Bertrand Regnier,1117896,1220322,2022-12-22
CASH_IN,103004,Agence_moov_Ouidah,300000,196996,Bertrand Regnier,1220322,1323326,2022-12-26
CASH_IN,276665,Agence_moov_Abomey,300000,23335,Bertrand Regnier,1323326,1599991,2022-12-27
CASH_IN,277878,Agence_moov_Abomey,300000,22122,Thérèse François,-146340,131538,2022-12-03
CASH_IN,56088,Agence_moov_Ouidah,300000,243912,Thérèse François,131538,187626,2022-12-08
TRANSFER,105729,Thérèse François,187626,81897,Robert-Louis Gosselin,1640,-104089,2022-12-10
CASH_IN,259872,Agence_moov_Ouidah,300000,40128,Thérèse François,81897,341769,2022-12-12
CASH_OUT,223153,Thérèse François,341769,118616,Agence_moov_Cotonou,300000,76847,2022-12-21
CASH_OUT,44563,Thérèse François,118616,74053,Agence_moov_Abomey,300000,255437,2022-12-23
CASH_OUT,29023,Thérèse François,74053,45030,Agence_moov_Abomey,300000,270977,2022-12-24
CASH_IN,168164,Agence_moov_Ouidah,300000,131836,Richard Michel,198691,366855,2022-12-03
TRANSFER,340444,Colette Merle Le Robert,767794,427350,Richard Michel,366855,707299,2022-12-09
CASH_IN,8436,Agence_moov_Cotonou,300000,291564,Richard Michel,707299,715735,2022-12-11
TRANSFER,670834,Richard Michel,715735,44901,Léon Da Costa,194680,-476154,2022-12-16
CASH_OUT,14896,Richard Michel,44901,30005,Agence_moov_Abomey,300000,285104,2022-12-19
CASH_OUT,11286,Richard Michel,30005,18719,Agence_moov_Cotonou,300000,288714,2022-12-21
TRANSFER,7738,Richard Michel,18719,10981,Lucie Aubert,661094,653356,2022-12-21
TRANSFER,275915,Frédérique Fernandes du Bouchet,419477,143562,Mathilde de la Samson,969252,1245167,2022-12-02
CASH_OUT,48745,Mathilde de la Samson,1245167,1196422,Agence_moov_Cotonou,300000,251255,2022-12-03
CASH_OUT,190210,Mathilde de la Samson,1196422,1006212,Agence_moov_Cotonou,300000,109790,2022-12-06
CASH_IN,241083,Agence_moov_Abomey,300000,58917,Mathilde de la Samson,1006212,1247295,2022-12-08
TRANSFER,758010,Mathilde de la Samson,1247295,489285,Frédéric Guillou,162136,-595874,2022-12-09
CASH_OUT,465324,Mathilde de la Samson,489285,23961,Agence_moov_Abomey,300000,-165324,2022-12-11
CASH_IN,66506,Agence_moov_Ouidah,300000,233494,Mathilde de la Samson,23961,90467,2022-12-12
CASH_IN,236259,Agence_moov_Ouidah,300000,63741,Mathilde de la Samson,90467,326726,2022-12-12
CASH_OUT,47273,Mathilde de la Samson,326726,279453,Agence_moov_Ouidah,300000,252727,2022-12-13
TRANSFER,269744,Mathilde de la Samson,279453,9709,Tristan Bousquet-Gros,106246,-163498,2022-12-13
TRANSFER,1084635,Thibaut de la Lombard,1354700,270065,Mathilde de la Samson,9709,1094344,2022-12-16
CASH_IN,137942,Agence_moov_Ouidah,300000,162058,Mathilde de la Samson,1094344,1232286,2022-12-16
CASH_IN,249448,Agence_moov_Ouidah,300000,50552,Mathilde de la Samson,1232286,1481734,2022-12-17
CASH_OUT,613357,Mathilde de la Samson,1481734,868377,Agence_moov_Cotonou,300000,-313357,2022-12-19
CASH_IN,34105,Agence_moov_Ouidah,300000,265895,Mathilde de la Samson,868377,902482,2022-12-20
CASH_OUT,631909,Mathilde de la Samson,902482,270573,Agence_moov_Ouidah,300000,-331909,2022-12-22
CASH_IN,138500,Agence_moov_Ouidah,300000,161500,Mathilde de la Samson,270573,409073,2022-12-22
CASH_OUT,111176,Mathilde de la Samson,409073,297897,Agence_moov_Ouidah,300000,188824,2022-12-23
TRANSFER,124836,Mathilde de la Samson,297897,173061,Rémy Grondin,637514,512678,2022-12-23
CASH_IN,177343,Agence_moov_Ouidah,300000,122657,Aurore Charrier,-266797,-89454,2022-12-03
CASH_IN,16646,Agence_moov_Cotonou,300000,283354,Aurore Charrier,-89454,-72808,2022-12-04
CASH_IN,166867,Agence_moov_Cotonou,300000,133133,Aurore Charrier,-72808,94059,2022-12-06
CASH_IN,60375,Agence_moov_Cotonou,300000,239625,Aurore Charrier,94059,154434,2022-12-06
TRANSFER,10830,Paul Perez,216620,205790,Aurore Charrier,154434,165264,2022-12-10
TRANSFER,66968,Aurore Charrier,165264,98296,Lucie Aubert,653356,586388,2022-12-10
TRANSFER,42258,Aurore Charrier,98296,56038,Frédérique Fernandes du Bouchet,143562,101304,2022-12-13
TRANSFER,22951,Aurore Charrier,56038,33087,Michelle Samson,172982,150031,2022-12-16
CASH_IN,293510,Agence_moov_Cotonou,300000,6490,Aurore Charrier,33087,326597,2022-12-20
CASH_OUT,149910,Aurore Charrier,326597,176687,Agence_moov_Ouidah,300000,150090,2022-12-21
TRANSFER,142684,Rémy Grondin,512678,369994,Aurore Charrier,176687,319371,2022-12-23
CASH_OUT,300194,Aurore Charrier,319371,19177,Agence_moov_Cotonou,300000,-194,2022-12-26
CASH_OUT,8740,Aurore Charrier,19177,10437,Agence_moov_Ouidah,300000,291260,2022-12-26
CASH_OUT,646688,Thomas Dupont,665124,18436,Agence_moov_Cotonou,300000,-346688,2022-12-01
CASH_OUT,231,Thomas Dupont,18436,18205,Agence_moov_Cotonou,300000,299769,2022-12-02
CASH_OUT,12512,Thomas Dupont,18205,5693,Agence_moov_Cotonou,300000,287488,2022-12-03
CASH_OUT,5001,Thomas Dupont,5693,692,Agence_moov_Abomey,300000,294999,2022-12-06
CASH_OUT,305,Thomas Dupont,692,387,Agence_moov_Ouidah,300000,299695,2022-12-06
CASH_IN,37152,Agence_moov_Abomey,300000,262848,Thomas Dupont,387,37539,2022-12-07
TRANSFER,91178,Lucie Aubert,586388,495210,Thomas Dupont,37539,128717,2022-12-12
TRANSFER,106463,Thomas Dupont,128717,22254,Lucie Aubert,495210,388747,2022-12-15
CASH_IN,136072,Agence_moov_Abomey,300000,163928,Thomas Dupont,22254,158326,2022-12-15
CASH_OUT,148235,Thomas Dupont,158326,10091,Agence_moov_Ouidah,300000,151765,2022-12-16
CASH_IN,176995,Agence_moov_Cotonou,300000,123005,Thomas Dupont,10091,187086,2022-12-20
CASH_OUT,83108,Robert Clerc,363058,279950,Agence_moov_Cotonou,300000,216892,2022-12-02
CASH_IN,276734,Agence_moov_Abomey,300000,23266,Robert Clerc,279950,556684,2022-12-02
CASH_OUT,8686,Robert Clerc,556684,547998,Agence_moov_Abomey,300000,291314,2022-12-04
CASH_IN,232987,Agence_moov_Cotonou,300000,67013,Robert Clerc,547998,780985,2022-12-07
CASH_OUT,560660,Robert Clerc,780985,220325,Agence_moov_Abomey,300000,-260660,2022-12-07
CASH_OUT,4205,Robert Clerc,220325,216120,Agence_moov_Ouidah,300000,295795,2022-12-07
CASH_OUT,146812,Robert Clerc,216120,69308,Agence_moov_Cotonou,300000,153188,2022-12-08
TRANSFER,38694,Robert Clerc,69308,30614,Thibaut de la Lombard,270065,231371,2022-12-26
TRANSFER,51344,Bernadette de Jourdan,227516,176172,Robert Clerc,30614,81958,2022-12-27
TRANSFER,38827,Stéphane Munoz,161120,122293,Bernadette de Jourdan,176172,214999,2022-12-09
TRANSFER,491860,Alix Barbe,622617,130757,Bernadette de Jourdan,214999,706859,2022-12-09
CASH_OUT,159792,Bernadette de Jourdan,706859,547067,Agence_moov_Cotonou,300000,140208,2022-12-10
CASH_IN,94145,Agence_moov_Cotonou,300000,205855,Bernadette de Jourdan,547067,641212,2022-12-10
TRANSFER,124384,Antoinette de Dupuis,129336,4952,Bernadette de Jourdan,641212,765596,2022-12-11
CASH_IN,108145,Agence_moov_Abomey,300000,191855,Bernadette de Jourdan,765596,873741,2022-12-12
CASH_OUT,525610,Bernadette de Jourdan,873741,348131,Agence_moov_Cotonou,300000,-225610,2022-12-14
CASH_IN,81521,Agence_moov_Cotonou,300000,218479,Bernadette de Jourdan,348131,429652,2022-12-17
CASH_OUT,304877,Bernadette de Jourdan,429652,124775,Agence_moov_Ouidah,300000,-4877,2022-12-17
CASH_IN,123325,Agence_moov_Cotonou,300000,176675,Bernadette de Jourdan,124775,248100,2022-12-19
TRANSFER,30580,Constance Guillon,342866,312286,Bernadette de Jourdan,248100,278680,2022-12-20
TRANSFER,268045,Bernadette de Jourdan,278680,10635,Gabriel Bègue,453556,185511,2022-12-20
TRANSFER,4920,Bernadette de Jourdan,10635,5715,Noël Bourgeois,123005,118085,2022-12-20
TRANSFER,2690,Bernadette de Jourdan,5715,3025,Anne Peltier-Raynaud,1192318,1189628,2022-12-21
TRANSFER,2989,Bernadette de Jourdan,3025,36,Virginie Bouvet,126614,123625,2022-12-21
CASH_IN,103426,Agence_moov_Abomey,300000,196574,Bernadette de Jourdan,36,103462,2022-12-23
CASH_OUT,31495,Bernadette de Jourdan,103462,71967,Agence_moov_Abomey,300000,268505,2022-12-25
TRANSFER,949024,Anne Peltier-Raynaud,1189628,240604,Bernadette de Jourdan,71967,1020991,2022-12-26
TRANSFER,68003,Alix Barbe,130757,62754,Bernadette de Jourdan,1020991,1088994,2022-12-27
CASH_IN,286141,Agence_moov_Abomey,300000,13859,Rémy Grondin,369994,656135,2022-12-07
TRANSFER,102017,Noël Bourgeois,118085,16068,Rémy Grondin,656135,758152,2022-12-08
TRANSFER,649215,Rémy Grondin,758152,108937,Alix Barbe,62754,-586461,2022-12-08
TRANSFER,67482,Rémy Grondin,108937,41455,Michelle Samson,150031,82549,2022-12-10
CASH_IN,224688,Agence_moov_Abomey,300000,75312,Rémy Grondin,41455,266143,2022-12-11
TRANSFER,70633,Rémy Grondin,266143,195510,Michelle Samson,82549,11916,2022-12-18
TRANSFER,122094,Rémy Grondin,195510,73416,Anne Peltier-Raynaud,240604,118510,2022-12-22
CASH_OUT,7693,Rémy Grondin,73416,65723,Agence_moov_Abomey,300000,292307,2022-12-22
CASH_OUT,48633,Rémy Grondin,65723,17090,Agence_moov_Ouidah,300000,251367,2022-12-24
CASH_IN,271254,Agence_moov_Cotonou,300000,28746,Rémy Grondin,17090,288344,2022-12-24
CASH_IN,107723,Agence_moov_Cotonou,300000,192277,Robert-Louis Gosselin,-104089,3634,2022-12-07
CASH_OUT,1974,Robert-Louis Gosselin,3634,1660,Agence_moov_Abomey,300000,298026,2022-12-13
TRANSFER,1064,Robert-Louis Gosselin,1660,596,Antoinette de Dupuis,4952,3888,2022-12-14
CASH_IN,25507,Agence_moov_Ouidah,300000,274493,Robert-Louis Gosselin,596,26103,2022-12-17
TRANSFER,1854,Robert-Louis Gosselin,26103,24249,Timothée-René Blanchard,25253,23399,2022-12-20
CASH_IN,26903,Agence_moov_Cotonou,300000,273097,Robert-Louis Gosselin,24249,51152,2022-12-25
CASH_OUT,24653,Robert-Louis Gosselin,51152,26499,Agence_moov_Ouidah,300000,275347,2022-12-26
CASH_OUT,15295,Robert-Louis Gosselin,26499,11204,Agence_moov_Abomey,300000,284705,2022-12-26
CASH_OUT,831,Robert-Louis Gosselin,11204,10373,Agence_moov_Cotonou,300000,299169,2022-12-26
CASH_IN,259816,Agence_moov_Ouidah,300000,40184,Robert-Louis Gosselin,10373,270189,2022-12-27
CASH_OUT,53159,Virginie Bouvet,123625,70466,Agence_moov_Abomey,300000,246841,2022-12-08
TRANSFER,5096,Tristan Delahaye,21284,16188,Virginie Bouvet,70466,75562,2022-12-09
CASH_IN,164375,Agence_moov_Abomey,300000,135625,Virginie Bouvet,75562,239937,2022-12-11
TRANSFER,113713,Gabriel Bègue,185511,71798,Virginie Bouvet,239937,353650,2022-12-11
CASH_OUT,85999,Virginie Bouvet,353650,267651,Agence_moov_Abomey,300000,214001,2022-12-13
CASH_IN,64435,Agence_moov_Ouidah,300000,235565,Virginie Bouvet,267651,332086,2022-12-14
CASH_OUT,154110,Virginie Bouvet,332086,177976,Agence_moov_Abomey,300000,145890,2022-12-15
CASH_OUT,30764,Virginie Bouvet,177976,147212,Agence_moov_Cotonou,300000,269236,2022-12-22
CASH_OUT,122778,Virginie Bouvet,147212,24434,Agence_moov_Cotonou,300000,177222,2022-12-23
TRANSFER,13798,Virginie Bouvet,24434,10636,Timothée-René Blanchard,23399,9601,2022-12-23
CASH_IN,54349,Agence_moov_Abomey,300000,245651,Virginie Bouvet,10636,64985,2022-12-24
CASH_OUT,37904,Virginie Bouvet,64985,27081,Agence_moov_Ouidah,300000,262096,2022-12-24
CASH_OUT,11398,Virginie Bouvet,27081,15683,Agence_moov_Abomey,300000,288602,2022-12-24
CASH_OUT,12033,Virginie Bouvet,15683,3650,Agence_moov_Cotonou,300000,287967,2022-12-24
CASH_IN,287406,Agence_moov_Ouidah,300000,12594,Virginie Bouvet,3650,291056,2022-12-25
TRANSFER,46264,Anne Peltier-Raynaud,118510,72246,Virginie Bouvet,291056,337320,2022-12-25
CASH_OUT,322302,Virginie Bouvet,337320,15018,Agence_moov_Abomey,300000,-22302,2022-12-27
TRANSFER,1586,Anastasie Richard-Neveu,7842,6256,Virginie Bouvet,15018,16604,2022-12-27
CASH_IN,230247,Agence_moov_Cotonou,300000,69753,Frédéric Guillou,-595874,-365627,2022-12-02
CASH_IN,147209,Agence_moov_Cotonou,300000,152791,Frédéric Guillou,-365627,-218418,2022-12-02
CASH_IN,135134,Agence_moov_Abomey,300000,164866,Frédéric Guillou,-218418,-83284,2022-12-04
CASH_IN,82204,Agence_moov_Ouidah,300000,217796,Frédéric Guillou,-83284,-1080,2022-12-06
CASH_IN,159062,Agence_moov_Ouidah,300000,140938,Frédéric Guillou,-1080,157982,2022-12-09
TRANSFER,70348,Frédéric Guillou,157982,87634,Thibaut de la Lombard,231371,161023,2022-12-10
CASH_OUT,12443,Frédéric Guillou,87634,75191,Agence_moov_Ouidah,300000,287557,2022-12-12
TRANSFER,2409,Antoinette de Dupuis,3888,1479,Frédéric Guillou,75191,77600,2022-12-13
CASH_OUT,20582,Frédéric Guillou,77600,57018,Agence_moov_Ouidah,300000,279418,2022-12-15
CASH_IN,185183,Agence_moov_Abomey,300000,114817,Frédéric Guillou,57018,242201,2022-12-16
CASH_OUT,203596,Frédéric Guillou,242201,38605,Agence_moov_Cotonou,300000,96404,2022-12-19
CASH_OUT,4889,Frédéric Guillou,38605,33716,Agence_moov_Abomey,300000,295111,2022-12-19
CASH_OUT,8735,Frédéric Guillou,33716,24981,Agence_moov_Cotonou,300000,291265,2022-12-20
TRANSFER,32004,Anne Peltier-Raynaud,72246,40242,Frédéric Guillou,24981,56985,2022-12-20
TRANSFER,22591,Frédéric Guillou,56985,34394,Jules Fernandes,1648300,1625709,2022-12-24
CASH_IN,34766,Agence_moov_Cotonou,300000,265234,Frédéric Guillou,34394,69160,2022-12-25
TRANSFER,146806,Thibaut de la Lombard,161023,14217,Frédéric Guillou,69160,215966,2022-12-27
CASH_IN,117696,Agence_moov_Ouidah,300000,182304,Émile-René Baudry,-68897,48799,2022-12-01
TRANSFER,31908,Émile-René Baudry,48799,16891,Anastasie Richard-Neveu,6256,-25652,2022-12-07
CASH_OUT,10875,Émile-René Baudry,16891,6016,Agence_moov_Abomey,300000,289125,2022-12-08
TRANSFER,578079,Robert Laroche,720458,142379,Émile-René Baudry,6016,584095,2022-12-09
CASH_IN,244635,Agence_moov_Cotonou,300000,55365,Émile-René Baudry,584095,828730,2022-12-11
CASH_IN,260257,Agence_moov_Ouidah,300000,39743,Émile-René Baudry,828730,1088987,2022-12-14
CASH_IN,198669,Agence_moov_Abomey,300000,101331,Émile-René Baudry,1088987,1287656,2022-12-16
TRANSFER,793444,Émile-René Baudry,1287656,494212,Gabriel Bègue,71798,-721646,2022-12-18
CASH_OUT,312522,Émile-René Baudry,494212,181690,Agence_moov_Cotonou,300000,-12522,2022-12-21
CASH_OUT,26844,Émile-René Baudry,181690,154846,Agence_moov_Cotonou,300000,273156,2022-12-22
CASH_OUT,93477,Émile-René Baudry,154846,61369,Agence_moov_Ouidah,300000,206523,2022-12-22
CASH_IN,57754,Agence_moov_Cotonou,300000,242246,Émile-René Baudry,61369,119123,2022-12-23
TRANSFER,17206,Émile-René Baudry,119123,101917,Timothée-René Blanchard,9601,-7605,2022-12-23
CASH_OUT,6191,Émile-René Baudry,101917,95726,Agence_moov_Cotonou,300000,293809,2022-12-24
CASH_OUT,18765,Émile-René Baudry,95726,76961,Agence_moov_Abomey,300000,281235,2022-12-27
TRANSFER,26169,Robert Laroche,142379,116210,Anne Peltier-Raynaud,40242,66411,2022-12-02
CASH_OUT,59678,Anne Peltier-Raynaud,66411,6733,Agence_moov_Cotonou,300000,240322,2022-12-03
CASH_IN,176823,Agence_moov_Cotonou,300000,123177,Anne Peltier-Raynaud,6733,183556,2022-12-05
CASH_IN,282498,Agence_moov_Ouidah,300000,17502,Anne Peltier-Raynaud,183556,466054,2022-12-14
TRANSFER,457663,Anne Peltier-Raynaud,466054,8391,Tristan Delahaye,16188,-441475,2022-12-16
TRANSFER,1007,Anne Peltier-Raynaud,8391,7384,Constance Guillon,312286,311279,2022-12-16
TRANSFER,113438,Stéphane Munoz,122293,8855,Anne Peltier-Raynaud,7384,120822,2022-12-16
TRANSFER,375,Antoinette de Dupuis,1479,1104,Anne Peltier-Raynaud,120822,121197,2022-12-17
CASH_IN,264763,Agence_moov_Abomey,300000,35237,Anne Peltier-Raynaud,121197,385960,2022-12-21
CASH_OUT,261510,Anne Peltier-Raynaud,385960,124450,Agence_moov_Ouidah,300000,38490,2022-12-21
TRANSFER,8071,Noël Bourgeois,16068,7997,Anne Peltier-Raynaud,124450,132521,2022-12-26
CASH_IN,41108,Agence_moov_Abomey,300000,258892,Lucy Lamy,-594840,-553732,2022-12-03
CASH_IN,241710,Agence_moov_Ouidah,300000,58290,Lucy Lamy,-553732,-312022,2022-12-03
CASH_IN,269154,Agence_moov_Cotonou,300000,30846,Lucy Lamy,-312022,-42868,2022-12-09
CASH_IN,160266,Agence_moov_Cotonou,300000,139734,Lucy Lamy,-42868,117398,2022-12-10
CASH_IN,259835,Agence_moov_Cotonou,300000,40165,Lucy Lamy,117398,377233,2022-12-14
TRANSFER,515005,Jules Fernandes,1625709,1110704,Lucy Lamy,377233,892238,2022-12-14
TRANSFER,532483,Lucy Lamy,892238,359755,Noël Bourgeois,7997,-524486,2022-12-15
CASH_OUT,271729,Lucy Lamy,359755,88026,Agence_moov_Ouidah,300000,28271,2022-12-20
TRANSFER,34937,Lucy Lamy,88026,53089,Stéphane Munoz,8855,-26082,2022-12-20
CASH_IN,26047,Agence_moov_Cotonou,300000,273953,Lucy Lamy,53089,79136,2022-12-20
CASH_OUT,65551,Lucy Lamy,79136,13585,Agence_moov_Abomey,300000,234449,2022-12-21
TRANSFER,169163,Paul Perez,205790,36627,Lucy Lamy,13585,182748,2022-12-21
CASH_IN,143984,Agence_moov_Ouidah,300000,156016,Thomas de Blin,-10448,133536,2022-12-08
CASH_OUT,47575,Thomas de Blin,133536,85961,Agence_moov_Abomey,300000,252425,2022-12-13
TRANSFER,40933,Thomas de Blin,85961,45028,Thomas de Blin,85961,126894,2022-12-15
CASH_OUT,37125,Thomas de Blin,45028,7903,Agence_moov_Ouidah,300000,262875,2022-12-18
CASH_OUT,6129,Thomas de Blin,7903,1774,Agence_moov_Cotonou,300000,293871,2022-12-19
TRANSFER,9051,Paul Perez,36627,27576,Thomas de Blin,1774,10825,2022-12-19
TRANSFER,1057,Antoinette de Dupuis,1104,47,Thomas de Blin,10825,11882,2022-12-21
TRANSFER,7214,Thomas de Blin,11882,4668,Constance Guillon,311279,304065,2022-12-25
TRANSFER,1837,Thomas de Blin,4668,2831,Thibaut de la Lombard,14217,12380,2022-12-25
CASH_OUT,2462,Thomas de Blin,2831,369,Agence_moov_Cotonou,300000,297538,2022-12-27
CASH_IN,292365,Agence_moov_Cotonou,300000,7635,Tristan Bousquet-Gros,-163498,128867,2022-12-14
CASH_OUT,73575,Tristan Bousquet-Gros,128867,55292,Agence_moov_Abomey,300000,226425,2022-12-19
TRANSFER,269492,Manon Lebon,671985,402493,Tristan Bousquet-Gros,55292,324784,2022-12-20
CASH_OUT,67921,Tristan Bousquet-Gros,324784,256863,Agence_moov_Cotonou,300000,232079,2022-12-20
TRANSFER,163517,Jules Fernandes,1110704,947187,Tristan Bousquet-Gros,256863,420380,2022-12-21
TRANSFER,153878,Tristan Bousquet-Gros,420380,266502,Manon Lebon,402493,248615,2022-12-26
CASH_IN,134130,Agence_moov_Abomey,300000,165870,Léon Da Costa,-476154,-342024,2022-12-06
CASH_IN,64628,Agence_moov_Ouidah,300000,235372,Léon Da Costa,-342024,-277396,2022-12-06
CASH_IN,8720,Agence_moov_Cotonou,300000,291280,Léon Da Costa,-277396,-268676,2022-12-07
CASH_IN,248130,Agence_moov_Abomey,300000,51870,Léon Da Costa,-268676,-20546,2022-12-11
CASH_IN,186950,Agence_moov_Ouidah,300000,113050,Léon Da Costa,-20546,166404,2022-12-13
CASH_IN,150102,Agence_moov_Abomey,300000,149898,Léon Da Costa,166404,316506,2022-12-14
TRANSFER,209094,Manon Lebon,248615,39521,Léon Da Costa,316506,525600,2022-12-21
CASH_OUT,411331,Léon Da Costa,525600,114269,Agence_moov_Cotonou,300000,-111331,2022-12-23
CASH_IN,67591,Agence_moov_Abomey,300000,232409,Léon Da Costa,114269,181860,2022-12-26
CASH_IN,130803,Agence_moov_Cotonou,300000,169197,Tristan Delahaye,-441475,-310672,2022-12-01
CASH_IN,39797,Agence_moov_Abomey,300000,260203,Tristan Delahaye,-310672,-270875,2022-12-02
CASH_IN,283274,Agence_moov_Cotonou,300000,16726,Tristan Delahaye,-270875,12399,2022-12-03
TRANSFER,5046,Tristan Delahaye,12399,7353,Tristan Delahaye,12399,17445,2022-12-06
CASH_OUT,3498,Tristan Delahaye,7353,3855,Agence_moov_Ouidah,300000,296502,2022-12-07
CASH_IN,249641,Agence_moov_Cotonou,300000,50359,Tristan Delahaye,3855,253496,2022-12-09
TRANSFER,179815,Tristan Delahaye,253496,73681,Thibaut de la Lombard,12380,-167435,2022-12-18
CASH_OUT,67077,Tristan Delahaye,73681,6604,Agence_moov_Cotonou,300000,232923,2022-12-19
CASH_IN,265166,Agence_moov_Abomey,300000,34834,Tristan Delahaye,6604,271770,2022-12-23
TRANSFER,26447,Manon Lebon,39521,13074,Tristan Delahaye,271770,298217,2022-12-24
TRANSFER,547759,Jules Fernandes,947187,399428,Tristan Delahaye,298217,845976,2022-12-24
TRANSFER,341001,Tristan Delahaye,845976,504975,Michelle Samson,11916,-329085,2022-12-24
CASH_IN,179022,Agence_moov_Ouidah,300000,120978,Tristan Delahaye,504975,683997,2022-12-27
TRANSFER,22745,Paul Perez,27576,4831,Tristan Delahaye,683997,706742,2022-12-27
CASH_IN,155884,Agence_moov_Ouidah,300000,144116,Céline Collin-Hervé,-13073,142811,2022-12-01
TRANSFER,127551,Céline Collin-Hervé,142811,15260,Constance Guillon,304065,176514,2022-12-03
TRANSFER,5430,Céline Collin-Hervé,15260,9830,Robert Laroche,116210,110780,2022-12-04
CASH_IN,34034,Agence_moov_Abomey,300000,265966,Céline Collin-Hervé,9830,43864,2022-12-06
CASH_IN,266051,Agence_moov_Abomey,300000,33949,Céline Collin-Hervé,43864,309915,2022-12-07
CASH_OUT,57140,Céline Collin-Hervé,309915,252775,Agence_moov_Ouidah,300000,242860,2022-12-12
CASH_IN,1364,Agence_moov_Ouidah,300000,298636,Céline Collin-Hervé,252775,254139,2022-12-15
CASH_OUT,238010,Céline Collin-Hervé,254139,16129,Agence_moov_Abomey,300000,61990,2022-12-16
TRANSFER,402,Manon Lebon,13074,12672,Céline Collin-Hervé,16129,16531,2022-12-17
CASH_OUT,9982,Céline Collin-Hervé,16531,6549,Agence_moov_Abomey,300000,290018,2022-12-19
CASH_IN,178925,Agence_moov_Abomey,300000,121075,Céline Collin-Hervé,6549,185474,2022-12-24
CASH_OUT,124500,Céline Collin-Hervé,185474,60974,Agence_moov_Ouidah,300000,175500,2022-12-25
TRANSFER,16867,Céline Collin-Hervé,60974,44107,Jules Fernandes,399428,382561,2022-12-25
CASH_IN,14494,Agence_moov_Cotonou,300000,285506,Camille Morvan,-560430,-545936,2022-12-02
CASH_IN,33116,Agence_moov_Cotonou,300000,266884,Camille Morvan,-545936,-512820,2022-12-05
CASH_IN,244754,Agence_moov_Cotonou,300000,55246,Camille Morvan,-512820,-268066,2022-12-05
CASH_IN,159020,Agence_moov_Cotonou,300000,140980,Camille Morvan,-268066,-109046,2022-12-06
CASH_IN,101318,Agence_moov_Abomey,300000,198682,Camille Morvan,-109046,-7728,2022-12-08
CASH_IN,238836,Agence_moov_Abomey,300000,61164,Camille Morvan,-7728,231108,2022-12-10
TRANSFER,3079,Paul Perez,4831,1752,Camille Morvan,231108,234187,2022-12-14
CASH_OUT,127890,Camille Morvan,234187,106297,Agence_moov_Ouidah,300000,172110,2022-12-15
TRANSFER,191426,Colette Merle Le Robert,427350,235924,Camille Morvan,106297,297723,2022-12-15
CASH_IN,42465,Agence_moov_Ouidah,300000,257535,Camille Morvan,297723,340188,2022-12-18
CASH_OUT,213889,Camille Morvan,340188,126299,Agence_moov_Abomey,300000,86111,2022-12-23
TRANSFER,127551,Constance Guillon,176514,48963,Camille Morvan,126299,253850,2022-12-26
CASH_IN,141963,Agence_moov_Ouidah,300000,158037,Jules Fernandes,382561,524524,2022-12-03
CASH_IN,74581,Agence_moov_Abomey,300000,225419,Jules Fernandes,524524,599105,2022-12-04
TRANSFER,507113,Jules Fernandes,599105,91992,Colette Merle Le Robert,235924,-271189,2022-12-06
TRANSFER,21166,Jules Fernandes,91992,70826,Jules Fernandes,91992,70826,2022-12-06
CASH_OUT,33341,Jules Fernandes,70826,37485,Agence_moov_Ouidah,300000,266659,2022-12-09
CASH_OUT,7715,Jules Fernandes,37485,29770,Agence_moov_Abomey,300000,292285,2022-12-14
CASH_IN,114273,Agence_moov_Abomey,300000,185727,Jules Fernandes,29770,144043,2022-12-22
CASH_OUT,6648,Jules Fernandes,144043,137395,Agence_moov_Cotonou,300000,293352,2022-12-22
CASH_IN,260939,Agence_moov_Ouidah,300000,39061,Jules Fernandes,137395,398334,2022-12-24
CASH_IN,63088,Agence_moov_Ouidah,300000,236912,Alix Barbe,-586461,-523373,2022-12-04
CASH_IN,149113,Agence_moov_Cotonou,300000,150887,Alix Barbe,-523373,-374260,2022-12-05
CASH_IN,104494,Agence_moov_Cotonou,300000,195506,Alix Barbe,-374260,-269766,2022-12-05
CASH_IN,53766,Agence_moov_Cotonou,300000,246234,Alix Barbe,-269766,-216000,2022-12-08
CASH_IN,131089,Agence_moov_Ouidah,300000,168911,Alix Barbe,-216000,-84911,2022-12-12
CASH_IN,163579,Agence_moov_Cotonou,300000,136421,Alix Barbe,-84911,78668,2022-12-12
TRANSFER,1083,Paul Perez,1752,669,Alix Barbe,78668,79751,2022-12-13
TRANSFER,471,Paul Perez,669,198,Alix Barbe,79751,80222,2022-12-22
TRANSFER,3484,Alix Barbe,80222,76738,Manon Lebon,12672,9188,2022-12-25
CASH_IN,279305,Agence_moov_Abomey,300000,20695,Noémi Bouvier,-159340,119965,2022-12-01
TRANSFER,181,Paul Perez,198,17,Noémi Bouvier,119965,120146,2022-12-03
CASH_OUT,29059,Noémi Bouvier,120146,91087,Agence_moov_Abomey,300000,270941,2022-12-10
CASH_IN,251919,Agence_moov_Abomey,300000,48081,Noémi Bouvier,91087,343006,2022-12-11
CASH_OUT,129558,Noémi Bouvier,343006,213448,Agence_moov_Abomey,300000,170442,2022-12-20
CASH_OUT,22090,Noémi Bouvier,213448,191358,Agence_moov_Abomey,300000,277910,2022-12-23
CASH_IN,222417,Agence_moov_Ouidah,300000,77583,Noémi Bouvier,191358,413775,2022-12-26
CASH_IN,36021,Agence_moov_Cotonou,300000,263979,Noémi Bouvier,413775,449796,2022-12-26
CASH_IN,131620,Agence_moov_Cotonou,300000,168380,Stéphane Munoz,-26082,105538,2022-12-02
TRANSFER,16868,Stéphane Munoz,105538,88670,Constance Guillon,48963,32095,2022-12-04
CASH_OUT,22185,Stéphane Munoz,88670,66485,Agence_moov_Cotonou,300000,277815,2022-12-04
TRANSFER,4236,Stéphane Munoz,66485,62249,Constance Guillon,32095,27859,2022-12-11
CASH_OUT,15384,Stéphane Munoz,62249,46865,Agence_moov_Cotonou,300000,284616,2022-12-13
CASH_IN,107077,Agence_moov_Abomey,300000,192923,Stéphane Munoz,46865,153942,2022-12-14
CASH_OUT,42033,Stéphane Munoz,153942,111909,Agence_moov_Ouidah,300000,257967,2022-12-14
CASH_IN,233167,Agence_moov_Ouidah,300000,66833,Stéphane Munoz,111909,345076,2022-12-20
CASH_IN,77376,Agence_moov_Ouidah,300000,222624,Stéphane Munoz,345076,422452,2022-12-22
TRANSFER,9905,Constance Guillon,27859,17954,Stéphane Munoz,422452,432357,2022-12-23
CASH_IN,5676,Agence_moov_Ouidah,300000,294324,Colette Merle Le Robert,-271189,-265513,2022-12-01
CASH_IN,250676,Agence_moov_Ouidah,300000,49324,Colette Merle Le Robert,-265513,-14837,2022-12-06
CASH_IN,16088,Agence_moov_Abomey,300000,283912,Colette Merle Le Robert,-14837,1251,2022-12-08
TRANSFER,121,Colette Merle Le Robert,1251,1130,Robert Laroche,110780,110659,2022-12-09
TRANSFER,944,Colette Merle Le Robert,1130,186,Colette Merle Le Robert,1130,186,2022-12-09
TRANSFER,177,Colette Merle Le Robert,186,9,Colette Merle Le Robert,186,363,2022-12-09
CASH_IN,81055,Agence_moov_Abomey,300000,218945,Colette Merle Le Robert,9,81064,2022-12-10
TRANSFER,58132,Colette Merle Le Robert,81064,22932,Constance Guillon,17954,-40178,2022-12-13
TRANSFER,11465,Colette Merle Le Robert,22932,11467,Manon Lebon,9188,-2277,2022-12-18
CASH_OUT,2890,Colette Merle Le Robert,11467,8577,Agence_moov_Abomey,300000,297110,2022-12-19
TRANSFER,7670,Colette Merle Le Robert,8577,907,Robert Laroche,110659,102989,2022-12-22
CASH_OUT,540,Colette Merle Le Robert,907,367,Agence_moov_Ouidah,300000,299460,2022-12-25
CASH_OUT,247,Colette Merle Le Robert,367,120,Agence_moov_Cotonou,300000,299753,2022-12-27
CASH_IN,265845,Agence_moov_Abomey,300000,34155,Timothée-René Blanchard,-7605,258240,2022-12-02
CASH_OUT,119114,Timothée-René Blanchard,258240,139126,Agence_moov_Cotonou,300000,180886,2022-12-04
CASH_OUT,92962,Timothée-René Blanchard,139126,46164,Agence_moov_Abomey,300000,207038,2022-12-04
CASH_OUT,30636,Timothée-René Blanchard,46164,15528,Agence_moov_Cotonou,300000,269364,2022-12-07
CASH_OUT,11538,Timothée-René Blanchard,15528,3990,Agence_moov_Abomey,300000,288462,2022-12-08
CASH_OUT,632,Timothée-René Blanchard,3990,3358,Agence_moov_Cotonou,300000,299368,2022-12-11
CASH_OUT,571,Timothée-René Blanchard,3358,2787,Agence_moov_Abomey,300000,299429,2022-12-12
CASH_OUT,2191,Timothée-René Blanchard,2787,596,Agence_moov_Cotonou,300000,297809,2022-12-12
CASH_OUT,503,Timothée-René Blanchard,596,93,Agence_moov_Ouidah,300000,299497,2022-12-15
CASH_IN,298368,Agence_moov_Cotonou,300000,1632,Timothée-René Blanchard,93,298461,2022-12-18
CASH_OUT,79825,Timothée-René Blanchard,298461,218636,Agence_moov_Ouidah,300000,220175,2022-12-21
CASH_OUT,197624,Timothée-René Blanchard,218636,21012,Agence_moov_Abomey,300000,102376,2022-12-26
CASH_OUT,4661,Timothée-René Blanchard,21012,16351,Agence_moov_Cotonou,300000,295339,2022-12-26
CASH_IN,189145,Agence_moov_Abomey,300000,110855,Gabriel Bègue,-721646,-532501,2022-12-02
CASH_IN,280276,Agence_moov_Cotonou,300000,19724,Gabriel Bègue,-532501,-252225,2022-12-02
CASH_IN,278144,Agence_moov_Cotonou,300000,21856,Gabriel Bègue,-252225,25919,2022-12-13
CASH_IN,146214,Agence_moov_Cotonou,300000,153786,Gabriel Bègue,25919,172133,2022-12-16
CASH_IN,215768,Agence_moov_Abomey,300000,84232,Gabriel Bègue,172133,387901,2022-12-16
TRANSFER,56993,Gabriel Bègue,387901,330908,Robert Laroche,102989,45996,2022-12-17
CASH_OUT,142020,Gabriel Bègue,330908,188888,Agence_moov_Cotonou,300000,157980,2022-12-23
CASH_OUT,28702,Gabriel Bègue,188888,160186,Agence_moov_Ouidah,300000,271298,2022-12-26
CASH_OUT,96786,Gabriel Bègue,160186,63400,Agence_moov_Abomey,300000,203214,2022-12-27
CASH_IN,221888,Agence_moov_Cotonou,300000,78112,Thibaut de la Lombard,-167435,54453,2022-12-01
CASH_IN,144796,Agence_moov_Abomey,300000,155204,Thibaut de la Lombard,54453,199249,2022-12-02
CASH_IN,182266,Agence_moov_Abomey,300000,117734,Thibaut de la Lombard,199249,381515,2022-12-03
CASH_OUT,105297,Thibaut de la Lombard,381515,276218,Agence_moov_Cotonou,300000,194703,2022-12-03
CASH_IN,26648,Agence_moov_Abomey,300000,273352,Thibaut de la Lombard,276218,302866,2022-12-04
CASH_OUT,250097,Thibaut de la Lombard,302866,52769,Agence_moov_Cotonou,300000,49903,2022-12-06
TRANSFER,8758,Thibaut de la Lombard,52769,44011,Thibaut de la Lombard,52769,61527,2022-12-07
TRANSFER,10153,Thibaut de la Lombard,44011,33858,Thibaut de la Lombard,44011,54164,2022-12-07
CASH_IN,4429,Agence_moov_Abomey,300000,295571,Thibaut de la Lombard,33858,38287,2022-12-08
CASH_IN,241872,Agence_moov_Ouidah,300000,58128,Thibaut de la Lombard,38287,280159,2022-12-12
CASH_IN,238443,Agence_moov_Ouidah,300000,61557,Thibaut de la Lombard,280159,518602,2022-12-12
CASH_IN,21560,Agence_moov_Abomey,300000,278440,Thibaut de la Lombard,518602,540162,2022-12-13
TRANSFER,27453,Thibaut de la Lombard,540162,512709,Robert Laroche,45996,18543,2022-12-15
CASH_OUT,73031,Thibaut de la Lombard,512709,439678,Agence_moov_Ouidah,300000,226969,2022-12-17
TRANSFER,219722,Thibaut de la Lombard,439678,219956,Robert Laroche,18543,-201179,2022-12-18
CASH_IN,12932,Agence_moov_Abomey,300000,287068,Constance Guillon,-40178,-27246,2022-12-03
CASH_IN,153540,Agence_moov_Ouidah,300000,146460,Constance Guillon,-27246,126294,2022-12-04
TRANSFER,116214,Constance Guillon,126294,10080,Constance Guillon,126294,10080,2022-12-05
CASH_IN,85409,Agence_moov_Ouidah,300000,214591,Constance Guillon,10080,95489,2022-12-06
TRANSFER,82673,Constance Guillon,95489,12816,Constance Guillon,95489,12816,2022-12-08
CASH_OUT,775,Constance Guillon,12816,12041,Agence_moov_Cotonou,300000,299225,2022-12-10
CASH_OUT,5174,Constance Guillon,12041,6867,Agence_moov_Ouidah,300000,294826,2022-12-13
CASH_IN,186093,Agence_moov_Abomey,300000,113907,Constance Guillon,6867,192960,2022-12-14
CASH_OUT,187648,Constance Guillon,192960,5312,Agence_moov_Ouidah,300000,112352,2022-12-15
CASH_OUT,2853,Constance Guillon,5312,2459,Agence_moov_Abomey,300000,297147,2022-12-15
CASH_OUT,1516,Constance Guillon,2459,943,Agence_moov_Cotonou,300000,298484,2022-12-16
CASH_IN,87641,Agence_moov_Cotonou,300000,212359,Constance Guillon,943,88584,2022-12-23
CASH_IN,284605,Agence_moov_Cotonou,300000,15395,Constance Guillon,88584,373189,2022-12-27
CASH_IN,213426,Agence_moov_Cotonou,300000,86574,Tristan Gomez,-13377,200049,2022-12-02
CASH_OUT,83096,Tristan Gomez,200049,116953,Agence_moov_Cotonou,300000,216904,2022-12-03
TRANSFER,12583,Tristan Gomez,116953,104370,Tristan Gomez,116953,104370,2022-12-08
CASH_OUT,48942,Tristan Gomez,104370,55428,Agence_moov_Ouidah,300000,251058,2022-12-08
CASH_IN,190065,Agence_moov_Cotonou,300000,109935,Tristan Gomez,55428,245493,2022-12-08
TRANSFER,188145,Tristan Gomez,245493,57348,Tristan Gomez,245493,57348,2022-12-10
CASH_IN,170443,Agence_moov_Abomey,300000,129557,Tristan Gomez,57348,227791,2022-12-11
CASH_OUT,60407,Tristan Gomez,227791,167384,Agence_moov_Abomey,300000,239593,2022-12-14
CASH_OUT,5493,Tristan Gomez,167384,161891,Agence_moov_Abomey,300000,294507,2022-12-15
TRANSFER,2602,Tristan Gomez,161891,159289,Tristan Gomez,161891,159289,2022-12-16
CASH_IN,237917,Agence_moov_Cotonou,300000,62083,Tristan Gomez,159289,397206,2022-12-17
CASH_OUT,294317,Tristan Gomez,397206,102889,Agence_moov_Cotonou,300000,5683,2022-12-21
CASH_IN,74486,Agence_moov_Abomey,300000,225514,Tristan Gomez,102889,177375,2022-12-25
CASH_IN,134594,Agence_moov_Abomey,300000,165406,Antoinette de Dupuis,47,134641,2022-12-03
CASH_OUT,56946,Antoinette de Dupuis,134641,77695,Agence_moov_Cotonou,300000,243054,2022-12-05
CASH_OUT,52546,Antoinette de Dupuis,77695,25149,Agence_moov_Abomey,300000,247454,2022-12-06
CASH_IN,221253,Agence_moov_Abomey,300000,78747,Antoinette de Dupuis,25149,246402,2022-12-06
CASH_OUT,146416,Antoinette de Dupuis,246402,99986,Agence_moov_Cotonou,300000,153584,2022-12-07
CASH_OUT,93707,Antoinette de Dupuis,99986,6279,Agence_moov_Cotonou,300000,206293,2022-12-09
CASH_OUT,780,Antoinette de Dupuis,6279,5499,Agence_moov_Cotonou,300000,299220,2022-12-12
CASH_OUT,1880,Antoinette de Dupuis,5499,3619,Agence_moov_Cotonou,300000,298120,2022-12-13
CASH_OUT,2108,Antoinette de Dupuis,3619,1511,Agence_moov_Abomey,300000,297892,2022-12-15
CASH_IN,227305,Agence_moov_Ouidah,300000,72695,Antoinette de Dupuis,1511,228816,2022-12-17
CASH_IN,91634,Agence_moov_Ouidah,300000,208366,Antoinette de Dupuis,228816,320450,2022-12-17
CASH_IN,10543,Agence_moov_Ouidah,300000,289457,Antoinette de Dupuis,320450,330993,2022-12-18
CASH_OUT,205786,Antoinette de Dupuis,330993,125207,Agence_moov_Abomey,300000,94214,2022-12-24
CASH_OUT,80465,Antoinette de Dupuis,125207,44742,Agence_moov_Abomey,300000,219535,2022-12-25
CASH_OUT,34148,Antoinette de Dupuis,44742,10594,Agence_moov_Ouidah,300000,265852,2022-12-27
CASH_IN,284666,Agence_moov_Abomey,300000,15334,Manon Valette,-109190,175476,2022-12-01
TRANSFER,139637,Manon Valette,175476,35839,Manon Valette,175476,315113,2022-12-05
CASH_OUT,17954,Manon Valette,35839,17885,Agence_moov_Cotonou,300000,282046,2022-12-10
TRANSFER,4544,Manon Valette,17885,13341,Manon Valette,17885,13341,2022-12-11
CASH_IN,284437,Agence_moov_Abomey,300000,15563,Manon Valette,13341,297778,2022-12-15
TRANSFER,110680,Manon Valette,297778,187098,Manon Valette,297778,187098,2022-12-16
TRANSFER,78846,Manon Valette,187098,108252,Manon Valette,187098,108252,2022-12-19
CASH_OUT,33132,Manon Valette,108252,75120,Agence_moov_Ouidah,300000,266868,2022-12-20
CASH_IN,234749,Agence_moov_Ouidah,300000,65251,Manon Valette,75120,309869,2022-12-20
CASH_OUT,116650,Manon Valette,309869,193219,Agence_moov_Abomey,300000,183350,2022-12-21
CASH_IN,297432,Agence_moov_Abomey,300000,2568,Manon Valette,193219,490651,2022-12-23
CASH_OUT,382845,Manon Valette,490651,107806,Agence_moov_Ouidah,300000,-82845,2022-12-24
CASH_IN,26029,Agence_moov_Abomey,300000,273971,Manon Valette,107806,133835,2022-12-25
CASH_IN,63015,Agence_moov_Ouidah,300000,236985,Manon Valette,133835,196850,2022-12-26
CASH_OUT,47702,Manon Valette,196850,149148,Agence_moov_Ouidah,300000,252298,2022-12-26
CASH_OUT,126622,Manon Valette,149148,22526,Agence_moov_Cotonou,300000,173378,2022-12-27
CASH_IN,7116,Agence_moov_Abomey,300000,292884,Manon Lebon,-2277,4839,2022-12-06
TRANSFER,4234,Manon Lebon,4839,605,Manon Lebon,4839,605,2022-12-06
CASH_IN,80457,Agence_moov_Abomey,300000,219543,Manon Lebon,605,81062,2022-12-10
CASH_OUT,75194,Manon Lebon,81062,5868,Agence_moov_Abomey,300000,224806,2022-12-10
TRANSFER,675,Manon Lebon,5868,5193,Manon Lebon,5868,6543,2022-12-10
TRANSFER,1702,Manon Lebon,5193,3491,Manon Lebon,5193,3491,2022-12-11
CASH_IN,287012,Agence_moov_Ouidah,300000,12988,Manon Lebon,3491,290503,2022-12-12
CASH_OUT,85505,Manon Lebon,290503,204998,Agence_moov_Cotonou,300000,214495,2022-12-12
CASH_IN,258198,Agence_moov_Abomey,300000,41802,Manon Lebon,204998,463196,2022-12-13
CASH_IN,242657,Agence_moov_Ouidah,300000,57343,Manon Lebon,463196,705853,2022-12-15
CASH_IN,270488,Agence_moov_Cotonou,300000,29512,Manon Lebon,705853,976341,2022-12-18
CASH_IN,258789,Agence_moov_Cotonou,300000,41211,Manon Lebon,976341,1235130,2022-12-19
CASH_IN,17965,Agence_moov_Cotonou,300000,282035,Manon Lebon,1235130,1253095,2022-12-26
CASH_IN,47873,Agence_moov_Ouidah,300000,252127,Manon Lebon,1253095,1300968,2022-12-26
CASH_IN,141852,Agence_moov_Cotonou,300000,158148,Noël Bourgeois,-524486,-382634,2022-12-01
CASH_IN,89099,Agence_moov_Abomey,300000,210901,Noël Bourgeois,-382634,-293535,2022-12-02
CASH_IN,206936,Agence_moov_Ouidah,300000,93064,Noël Bourgeois,-293535,-86599,2022-12-05
CASH_IN,29809,Agence_moov_Abomey,300000,270191,Noël Bourgeois,-86599,-56790,2022-12-06
CASH_IN,206365,Agence_moov_Abomey,300000,93635,Noël Bourgeois,-56790,149575,2022-12-06
CASH_OUT,31053,Noël Bourgeois,149575,118522,Agence_moov_Ouidah,300000,268947,2022-12-06
CASH_OUT,103060,Noël Bourgeois,118522,15462,Agence_moov_Abomey,300000,196940,2022-12-09
CASH_IN,289355,Agence_moov_Cotonou,300000,10645,Noël Bourgeois,15462,304817,2022-12-09
CASH_OUT,286469,Noël Bourgeois,304817,18348,Agence_moov_Ouidah,300000,13531,2022-12-16
CASH_IN,155456,Agence_moov_Cotonou,300000,144544,Noël Bourgeois,18348,173804,2022-12-18
CASH_IN,24661,Agence_moov_Cotonou,300000,275339,Noël Bourgeois,173804,198465,2022-12-19
CASH_IN,113692,Agence_moov_Abomey,300000,186308,Noël Bourgeois,198465,312157,2022-12-21
CASH_OUT,97825,Noël Bourgeois,312157,214332,Agence_moov_Ouidah,300000,202175,2022-12-23
CASH_IN,299632,Agence_moov_Cotonou,300000,368,Noël Bourgeois,214332,513964,2022-12-26
CASH_IN,78935,Agence_moov_Ouidah,300000,221065,Noël Bourgeois,513964,592899,2022-12-26
CASH_IN,260229,Agence_moov_Cotonou,300000,39771,Théodore Joseph-Lefebvre,-76017,184212,2022-12-01
TRANSFER,12214,Théodore Joseph-Lefebvre,184212,171998,Théodore Joseph-Lefebvre,184212,196426,2022-12-03
TRANSFER,22414,Théodore Joseph-Lefebvre,171998,149584,Théodore Joseph-Lefebvre,171998,194412,2022-12-07
TRANSFER,133000,Théodore Joseph-Lefebvre,149584,16584,Théodore Joseph-Lefebvre,149584,16584,2022-12-11
CASH_OUT,15110,Théodore Joseph-Lefebvre,16584,1474,Agence_moov_Abomey,300000,284890,2022-12-14
CASH_IN,160969,Agence_moov_Ouidah,300000,139031,Théodore Joseph-Lefebvre,1474,162443,2022-12-18
CASH_IN,230009,Agence_moov_Cotonou,300000,69991,Théodore Joseph-Lefebvre,162443,392452,2022-12-18
TRANSFER,224449,Théodore Joseph-Lefebvre,392452,168003,Théodore Joseph-Lefebvre,392452,616901,2022-12-20
CASH_OUT,104882,Théodore Joseph-Lefebvre,168003,63121,Agence_moov_Ouidah,300000,195118,2022-12-24
CASH_IN,123036,Agence_moov_Abomey,300000,176964,Théodore Joseph-Lefebvre,63121,186157,2022-12-27
CASH_OUT,100284,Théodore Joseph-Lefebvre,186157,85873,Agence_moov_Abomey,300000,199716,2022-12-27
CASH_IN,191703,Agence_moov_Abomey,300000,108297,Christine Texier,-281329,-89626,2022-12-01
CASH_IN,162432,Agence_moov_Cotonou,300000,137568,Christine Texier,-89626,72806,2022-12-02
CASH_IN,163169,Agence_moov_Cotonou,300000,136831,Christine Texier,72806,235975,2022-12-06
CASH_IN,63601,Agence_moov_Cotonou,300000,236399,Christine Texier,235975,299576,2022-12-07
CASH_IN,127925,Agence_moov_Cotonou,300000,172075,Christine Texier,299576,427501,2022-12-14
CASH_OUT,252348,Christine Texier,427501,175153,Agence_moov_Cotonou,300000,47652,2022-12-16
TRANSFER,12325,Christine Texier,175153,162828,Christine Texier,175153,162828,2022-12-17
TRANSFER,116314,Christine Texier,162828,46514,Christine Texier,162828,279142,2022-12-22
TRANSFER,2780,Christine Texier,46514,43734,Christine Texier,46514,43734,2022-12-24
CASH_OUT,12860,Christine Texier,43734,30874,Agence_moov_Ouidah,300000,287140,2022-12-25
CASH_IN,215496,Agence_moov_Ouidah,300000,84504,Christine Texier,30874,246370,2022-12-26
CASH_IN,174256,Agence_moov_Cotonou,300000,125744,Lucy Gillet,-19825,154431,2022-12-02
CASH_OUT,127097,Lucy Gillet,154431,27334,Agence_moov_Cotonou,300000,172903,2022-12-04
CASH_OUT,13650,Lucy Gillet,27334,13684,Agence_moov_Ouidah,300000,286350,2022-12-10
CASH_IN,113314,Agence_moov_Ouidah,300000,186686,Lucy Gillet,13684,126998,2022-12-10
CASH_IN,195785,Agence_moov_Abomey,300000,104215,Lucy Gillet,126998,322783,2022-12-12
TRANSFER,286647,Lucy Gillet,322783,36136,Lucy Gillet,322783,36136,2022-12-12
TRANSFER,22221,Lucy Gillet,36136,13915,Lucy Gillet,36136,58357,2022-12-14
CASH_OUT,5553,Lucy Gillet,13915,8362,Agence_moov_Cotonou,300000,294447,2022-12-15
CASH_IN,152712,Agence_moov_Cotonou,300000,147288,Lucy Gillet,8362,161074,2022-12-22
CASH_IN,137503,Agence_moov_Ouidah,300000,162497,Lucy Gillet,161074,298577,2022-12-23
CASH_IN,218530,Agence_moov_Abomey,300000,81470,Lucy Gillet,298577,517107,2022-12-24
CASH_IN,182436,Agence_moov_Ouidah,300000,117564,Raymond Lévy,-144854,37582,2022-12-01
TRANSFER,18509,Raymond Lévy,37582,19073,Raymond Lévy,37582,56091,2022-12-02
TRANSFER,3625,Raymond Lévy,19073,15448,Raymond Lévy,19073,22698,2022-12-06
CASH_OUT,12690,Raymond Lévy,15448,2758,Agence_moov_Ouidah,300000,287310,2022-12-08
CASH_IN,134301,Agence_moov_Abomey,300000,165699,Raymond Lévy,2758,137059,2022-12-08
CASH_OUT,117626,Raymond Lévy,137059,19433,Agence_moov_Cotonou,300000,182374,2022-12-09
CASH_OUT,3212,Raymond Lévy,19433,16221,Agence_moov_Abomey,300000,296788,2022-12-09
CASH_OUT,7911,Raymond Lévy,16221,8310,Agence_moov_Ouidah,300000,292089,2022-12-11
CASH_OUT,1937,Raymond Lévy,8310,6373,Agence_moov_Cotonou,300000,298063,2022-12-13
CASH_OUT,2867,Raymond Lévy,6373,3506,Agence_moov_Cotonou,300000,297133,2022-12-14
CASH_IN,155896,Agence_moov_Cotonou,300000,144104,Raymond Lévy,3506,159402,2022-12-15
CASH_OUT,149723,Raymond Lévy,159402,9679,Agence_moov_Ouidah,300000,150277,2022-12-22
CASH_IN,236294,Agence_moov_Cotonou,300000,63706,Raymond Lévy,9679,245973,2022-12-27
CASH_IN,139511,Agence_moov_Abomey,300000,160489,Paul Perez,17,139528,2022-12-02
TRANSFER,129425,Paul Perez,139528,10103,Paul Perez,139528,268953,2022-12-04
CASH_OUT,6371,Paul Perez,10103,3732,Agence_moov_Cotonou,300000,293629,2022-12-07
CASH_OUT,3707,Paul Perez,3732,25,Agence_moov_Ouidah,300000,296293,2022-12-07
CASH_IN,44083,Agence_moov_Ouidah,300000,255917,Paul Perez,25,44108,2022-12-08
CASH_OUT,16807,Paul Perez,44108,27301,Agence_moov_Ouidah,300000,283193,2022-12-11
CASH_IN,140068,Agence_moov_Cotonou,300000,159932,Paul Perez,27301,167369,2022-12-12
CASH_OUT,45289,Paul Perez,167369,122080,Agence_moov_Ouidah,300000,254711,2022-12-19
CASH_IN,3030,Agence_moov_Abomey,300000,296970,Paul Perez,122080,125110,2022-12-19
CASH_IN,17994,Agence_moov_Ouidah,300000,282006,Paul Perez,125110,143104,2022-12-22
CASH_OUT,63196,Paul Perez,143104,79908,Agence_moov_Abomey,300000,236804,2022-12-24
CASH_IN,157724,Agence_moov_Abomey,300000,142276,Paul Perez,79908,237632,2022-12-25
CASH_IN,205342,Agence_moov_Abomey,300000,94658,Paul Perez,237632,442974,2022-12-25
CASH_IN,122582,Agence_moov_Abomey,300000,177418,Hélène de la Gérard,-35012,87570,2022-12-03
CASH_OUT,58112,Hélène de la Gérard,87570,29458,Agence_moov_Abomey,300000,241888,2022-12-04
TRANSFER,20283,Hélène de la Gérard,29458,9175,Hélène de la Gérard,29458,9175,2022-12-04
CASH_OUT,4812,Hélène de la Gérard,9175,4363,Agence_moov_Abomey,300000,295188,2022-12-06
CASH_OUT,941,Hélène de la Gérard,4363,3422,Agence_moov_Ouidah,300000,299059,2022-12-06
CASH_IN,194446,Agence_moov_Ouidah,300000,105554,Hélène de la Gérard,3422,197868,2022-12-07
CASH_IN,89304,Agence_moov_Abomey,300000,210696,Hélène de la Gérard,197868,287172,2022-12-09
TRANSFER,125413,Hélène de la Gérard,287172,161759,Hélène de la Gérard,287172,161759,2022-12-10
TRANSFER,110139,Hélène de la Gérard,161759,51620,Hélène de la Gérard,161759,271898,2022-12-10
CASH_OUT,22208,Hélène de la Gérard,51620,29412,Agence_moov_Abomey,300000,277792,2022-12-16
CASH_IN,87113,Agence_moov_Abomey,300000,212887,Hélène de la Gérard,29412,116525,2022-12-16
CASH_OUT,54395,Hélène de la Gérard,116525,62130,Agence_moov_Cotonou,300000,245605,2022-12-21
CASH_IN,211017,Agence_moov_Cotonou,300000,88983,Hélène de la Gérard,62130,273147,2022-12-27
CASH_IN,269555,Agence_moov_Cotonou,300000,30445,Simone Muller de la Brun,-1240110,-970555,2022-12-01
CASH_IN,123106,Agence_moov_Abomey,300000,176894,Simone Muller de la Brun,-970555,-847449,2022-12-03
CASH_IN,216957,Agence_moov_Abomey,300000,83043,Simone Muller de la Brun,-847449,-630492,2022-12-03
CASH_IN,221331,Agence_moov_Ouidah,300000,78669,Simone Muller de la Brun,-630492,-409161,2022-12-04
CASH_IN,225533,Agence_moov_Ouidah,300000,74467,Simone Muller de la Brun,-409161,-183628,2022-12-08
CASH_IN,18017,Agence_moov_Abomey,300000,281983,Simone Muller de la Brun,-183628,-165611,2022-12-09
CASH_IN,109632,Agence_moov_Abomey,300000,190368,Simone Muller de la Brun,-165611,-55979,2022-12-09
CASH_IN,85506,Agence_moov_Ouidah,300000,214494,Simone Muller de la Brun,-55979,29527,2022-12-09
TRANSFER,3788,Simone Muller de la Brun,29527,25739,Simone Muller de la Brun,29527,33315,2022-12-10
CASH_IN,206759,Agence_moov_Cotonou,300000,93241,Simone Muller de la Brun,25739,232498,2022-12-12
TRANSFER,76142,Simone Muller de la Brun,232498,156356,Simone Muller de la Brun,232498,156356,2022-12-16
CASH_IN,87569,Agence_moov_Ouidah,300000,212431,Simone Muller de la Brun,156356,243925,2022-12-19
CASH_IN,191107,Agence_moov_Cotonou,300000,108893,Simone Muller de la Brun,243925,435032,2022-12-19
CASH_IN,53020,Agence_moov_Abomey,300000,246980,Simone Muller de la Brun,435032,488052,2022-12-20
CASH_OUT,415162,Simone Muller de la Brun,488052,72890,Agence_moov_Ouidah,300000,-115162,2022-12-23
TRANSFER,1347,Simone Muller de la Brun,72890,71543,Simone Muller de la Brun,72890,74237,2022-12-23
CASH_OUT,38350,Simone Muller de la Brun,71543,33193,Agence_moov_Cotonou,300000,261650,2022-12-24
