Type,Montant,Nom_src,Ancien_solde_src,Nouveau_solde_src,Nom_dest,Ancien_solde_dest,Nouveau_solde_dest,Date
CASH_OUT,34643,David Guérin,460800,426157,Agence_mtn_Cotonou,300000,265357,2022-01-07
CASH_OUT,298734,David Guérin,426157,127423,Agence_mtn_Ouidah,300000,1266,2022-01-12
CASH_OUT,76247,David Guérin,127423,51176,Agence_mtn_Abomey,300000,223753,2022-01-16
CASH_IN,88381,Agence_mtn_Cotonou,300000,211619,David Guérin,51176,139557,2022-01-24
CASH_IN,26205,Agence_mtn_Ouidah,300000,273795,Xavier de Lebreton,672400,698605,2022-01-04
CASH_OUT,554525,Xavier de Lebreton,698605,144080,Agence_mtn_Ouidah,300000,-254525,2022-01-08
CASH_IN,191587,Agence_mtn_Ouidah,300000,108413,Xavier de Lebreton,144080,335667,2022-01-25
CASH_OUT,1013750,Hortense Lemaire,1501400,487650,Agence_mtn_Abomey,300000,-713750,2022-01-04
CASH_OUT,351636,Hortense Lemaire,487650,136014,Agence_mtn_Cotonou,300000,-51636,2022-01-09
CASH_OUT,99870,Hortense Lemaire,136014,36144,Agence_mtn_Cotonou,300000,200130,2022-01-15
CASH_IN,143263,Agence_mtn_Cotonou,300000,156737,Thérèse-Margaux Bruneau,621000,764263,2022-01-01
TRANSFER,315743,Thérèse-Margaux Bruneau,764263,448520,Jeanne Garnier,1843100,1527357,2022-01-08
CASH_OUT,315667,Thérèse-Margaux Bruneau,448520,132853,Agence_mtn_Ouidah,300000,-15667,2022-01-21
CASH_IN,234083,Agence_mtn_Ouidah,300000,65917,Thérèse-Margaux Bruneau,132853,366936,2022-01-25
TRANSFER,244894,Thérèse-Margaux Bruneau,366936,122042,Alfred du Lesage,1195500,950606,2022-01-27
TRANSFER,224843,Pierre Reynaud,497400,272557,Valérie Dijoux,480100,704943,2022-01-03
TRANSFER,92958,Théodore De Oliveira-Nicolas,370200,277242,Valérie Dijoux,704943,797901,2022-01-25
TRANSFER,64171,Alexandre Rémy,142600,78429,Thibaut Coulon,654400,590229,2022-01-12
CASH_OUT,569616,Laurent-Bertrand Lefort,818500,248884,Agence_mtn_Abomey,300000,-269616,2022-01-14
TRANSFER,425602,Martine Wagner de la Bègue,480500,54898,Éléonore-Hélène Dubois,1175800,1601402,2022-01-05
TRANSFER,37685,William Lebrun,1194600,1156915,Éléonore-Hélène Dubois,1601402,1639087,2022-01-09
TRANSFER,209385,Théodore De Oliveira-Nicolas,277242,67857,Éléonore-Hélène Dubois,1639087,1848472,2022-01-13
TRANSFER,425357,Rémy de la Roux,725600,300243,Éléonore-Hélène Dubois,1848472,2273829,2022-01-27
TRANSFER,1352082,Éléonore-Hélène Dubois,2273829,921747,Virginie Le Gall,936300,-415782,2022-01-27
CASH_IN,38976,Agence_mtn_Abomey,300000,261024,Pénélope Ollivier,1297800,1336776,2022-01-02
TRANSFER,667744,Pénélope Ollivier,1336776,669032,Bertrand Le Roux,31000,-636744,2022-01-16
TRANSFER,1412579,Geneviève Grondin,1915200,502621,Rémy Le Michaud,1132500,-280079,2022-01-01
CASH_OUT,258489,Geneviève Grondin,502621,244132,Agence_mtn_Ouidah,300000,41511,2022-01-03
CASH_OUT,49930,Geneviève Grondin,244132,194202,Agence_mtn_Abomey,300000,250070,2022-01-10
TRANSFER,102182,Geneviève Grondin,194202,92020,David du Blondel,1540200,1438018,2022-01-11
CASH_IN,57688,Agence_mtn_Abomey,300000,242312,Geneviève Grondin,92020,149708,2022-01-26
CASH_IN,34252,Agence_mtn_Cotonou,300000,265748,Joséphine Gros,1380000,1414252,2022-01-04
TRANSFER,1465671,Jeanne Garnier,1527357,61686,Joséphine Gros,1414252,2879923,2022-01-05
CASH_OUT,1983544,Joséphine Gros,2879923,896379,Agence_mtn_Abomey,300000,-1683544,2022-01-12
TRANSFER,527423,Joséphine Gros,896379,368956,Claude Foucher,1050700,523277,2022-01-15
TRANSFER,1015136,Cécile Delattre-Arnaud,1175200,160064,Joséphine Gros,368956,1384092,2022-01-21
CASH_IN,155350,Agence_mtn_Ouidah,300000,144650,Alphonse Leclercq-Rousseau,1874500,2029850,2022-01-03
TRANSFER,1138944,Alphonse Leclercq-Rousseau,2029850,890906,Thierry Delattre-Simon,1392400,253456,2022-01-08
CASH_OUT,505388,Alphonse Leclercq-Rousseau,890906,385518,Agence_mtn_Ouidah,300000,-205388,2022-01-17
TRANSFER,285405,Alphonse Leclercq-Rousseau,385518,100113,Sébastien Vallée,1301400,1015995,2022-01-22
TRANSFER,992885,Valentine Richard-Bourdon,1135400,142515,Sophie Lévêque,337100,-655785,2022-01-14
TRANSFER,78517,Roland Garcia,269600,191083,Valentine Richard-Bourdon,142515,221032,2022-01-18
CASH_OUT,86437,Valentine Richard-Bourdon,221032,134595,Agence_mtn_Cotonou,300000,213563,2022-01-20
CASH_IN,240956,Agence_mtn_Cotonou,300000,59044,William Le Lucas,858300,1099256,2022-01-01
CASH_OUT,1005323,Gabriel Humbert,1389800,384477,Agence_mtn_Abomey,300000,-705323,2022-01-14
CASH_IN,169519,Agence_mtn_Cotonou,300000,130481,Gabriel Humbert,384477,553996,2022-01-15
CASH_IN,49767,Agence_mtn_Abomey,300000,250233,Gabriel Humbert,553996,603763,2022-01-20
CASH_IN,190943,Agence_mtn_Abomey,300000,109057,Gabriel Humbert,603763,794706,2022-01-26
TRANSFER,43197,Roland Garcia,191083,147886,Antoinette Bertrand,989200,1032397,2022-01-25
CASH_OUT,1281137,Margot Renaud,1291900,10763,Agence_mtn_Cotonou,300000,-981137,2022-01-11
CASH_IN,128124,Agence_mtn_Ouidah,300000,171876,Margot Renaud,10763,138887,2022-01-21
CASH_IN,97468,Agence_mtn_Cotonou,300000,202532,Louise Girard,657800,755268,2022-01-02
TRANSFER,520773,Claude Foucher,523277,2504,Louise Girard,755268,1276041,2022-01-05
CASH_IN,23811,Agence_mtn_Abomey,300000,276189,Louise Girard,1276041,1299852,2022-01-19
TRANSFER,1048078,Alix Maillet,1178600,130522,Vincent Mathieu,944500,-103578,2022-01-13
CASH_OUT,1120166,Nathalie Pages,1590500,470334,Agence_mtn_Cotonou,300000,-820166,2022-01-11
CASH_OUT,167153,Nathalie Pages,470334,303181,Agence_mtn_Ouidah,300000,132847,2022-01-13
TRANSFER,107708,Jean Benard,541200,433492,Honoré du Laurent,1779000,1671292,2022-01-06
CASH_IN,258591,Agence_mtn_Ouidah,300000,41409,Sophie Lévêque,-655785,-397194,2022-01-03
CASH_IN,210122,Agence_mtn_Abomey,300000,89878,Sophie Lévêque,-397194,-187072,2022-01-17
CASH_OUT,72417,Cécile Delattre-Arnaud,160064,87647,Agence_mtn_Cotonou,300000,227583,2022-01-02
CASH_IN,14018,Agence_mtn_Ouidah,300000,285982,Cécile Delattre-Arnaud,87647,101665,2022-01-03
CASH_IN,201488,Agence_mtn_Abomey,300000,98512,Cécile Delattre-Arnaud,101665,303153,2022-01-03
CASH_IN,239721,Agence_mtn_Cotonou,300000,60279,Cécile Delattre-Arnaud,303153,542874,2022-01-06
TRANSFER,223632,Gilbert-Charles Thibault,709800,486168,Cécile Delattre-Arnaud,542874,766506,2022-01-08
CASH_OUT,632194,Cécile Delattre-Arnaud,766506,134312,Agence_mtn_Cotonou,300000,-332194,2022-01-08
TRANSFER,39506,Cécile Delattre-Arnaud,134312,94806,David du Blondel,1438018,1398512,2022-01-11
CASH_OUT,44919,Cécile Delattre-Arnaud,94806,49887,Agence_mtn_Abomey,300000,255081,2022-01-12
TRANSFER,270796,Sébastien Lemaître,300900,30104,Cécile Delattre-Arnaud,49887,320683,2022-01-14
TRANSFER,218145,Cécile Delattre-Arnaud,320683,102538,Léon Lecoq,864100,645955,2022-01-15
CASH_OUT,32902,Cécile Delattre-Arnaud,102538,69636,Agence_mtn_Abomey,300000,267098,2022-01-16
TRANSFER,10112,Cécile Delattre-Arnaud,69636,59524,Renée David,555500,545388,2022-01-16
CASH_OUT,11311,Cécile Delattre-Arnaud,59524,48213,Agence_mtn_Cotonou,300000,288689,2022-01-16
TRANSFER,337318,Valentine Martinez,1255000,917682,Cécile Delattre-Arnaud,48213,385531,2022-01-17
CASH_OUT,340549,Cécile Delattre-Arnaud,385531,44982,Agence_mtn_Cotonou,300000,-40549,2022-01-18
CASH_OUT,43139,Cécile Delattre-Arnaud,44982,1843,Agence_mtn_Cotonou,300000,256861,2022-01-18
CASH_IN,45703,Agence_mtn_Abomey,300000,254297,Cécile Delattre-Arnaud,1843,47546,2022-01-19
TRANSFER,10918,Cécile Delattre-Arnaud,47546,36628,Roland Garcia,147886,136968,2022-01-19
TRANSFER,878026,Tristan Thomas,1476500,598474,Cécile Delattre-Arnaud,36628,914654,2022-01-21
CASH_OUT,316406,Cécile Delattre-Arnaud,914654,598248,Agence_mtn_Abomey,300000,-16406,2022-01-21
CASH_OUT,474272,Cécile Delattre-Arnaud,598248,123976,Agence_mtn_Abomey,300000,-174272,2022-01-24
CASH_OUT,60787,Cécile Delattre-Arnaud,123976,63189,Agence_mtn_Abomey,300000,239213,2022-01-24
CASH_IN,111781,Agence_mtn_Abomey,300000,188219,Cécile Delattre-Arnaud,63189,174970,2022-01-26
CASH_OUT,332248,David du Blondel,1398512,1066264,Agence_mtn_Abomey,300000,-32248,2022-01-01
TRANSFER,558051,David du Blondel,1066264,508213,Benjamin Evrard-Marty,1657500,1099449,2022-01-01
CASH_OUT,434156,David du Blondel,508213,74057,Agence_mtn_Ouidah,300000,-134156,2022-01-02
CASH_IN,73959,Agence_mtn_Ouidah,300000,226041,David du Blondel,74057,148016,2022-01-03
CASH_OUT,54704,David du Blondel,148016,93312,Agence_mtn_Abomey,300000,245296,2022-01-05
CASH_OUT,92899,David du Blondel,93312,413,Agence_mtn_Cotonou,300000,207101,2022-01-05
CASH_OUT,152,David du Blondel,413,261,Agence_mtn_Ouidah,300000,299848,2022-01-06
CASH_OUT,248,David du Blondel,261,13,Agence_mtn_Cotonou,300000,299752,2022-01-07
CASH_IN,141021,Agence_mtn_Cotonou,300000,158979,David du Blondel,13,141034,2022-01-07
CASH_IN,190453,Agence_mtn_Ouidah,300000,109547,David du Blondel,141034,331487,2022-01-08
TRANSFER,314943,David du Blondel,331487,16544,Pierre Roger,1357400,1042457,2022-01-09
CASH_IN,139607,Agence_mtn_Ouidah,300000,160393,David du Blondel,16544,156151,2022-01-11
CASH_IN,164734,Agence_mtn_Cotonou,300000,135266,David du Blondel,156151,320885,2022-01-11
TRANSFER,876020,Laure Philippe,885700,9680,David du Blondel,320885,1196905,2022-01-12
CASH_OUT,396034,David du Blondel,1196905,800871,Agence_mtn_Ouidah,300000,-96034,2022-01-13
CASH_OUT,16136,David du Blondel,800871,784735,Agence_mtn_Abomey,300000,283864,2022-01-14
CASH_IN,133501,Agence_mtn_Abomey,300000,166499,David du Blondel,784735,918236,2022-01-15
CASH_OUT,479845,David du Blondel,918236,438391,Agence_mtn_Ouidah,300000,-179845,2022-01-15
TRANSFER,304098,David du Blondel,438391,134293,Édouard Nguyen,1614100,1310002,2022-01-15
TRANSFER,267927,Étienne Roche,551400,283473,David du Blondel,134293,402220,2022-01-15
TRANSFER,346761,David du Blondel,402220,55459,Aurore Guyon,1449300,1102539,2022-01-19
CASH_OUT,1876,David du Blondel,55459,53583,Agence_mtn_Abomey,300000,298124,2022-01-20
CASH_OUT,50699,David du Blondel,53583,2884,Agence_mtn_Ouidah,300000,249301,2022-01-20
CASH_IN,74754,Agence_mtn_Ouidah,300000,225246,David du Blondel,2884,77638,2022-01-20
TRANSFER,70909,David du Blondel,77638,6729,Xavier Leblanc-Ferreira,1980300,1909391,2022-01-24
CASH_OUT,6703,David du Blondel,6729,26,Agence_mtn_Ouidah,300000,293297,2022-01-25
CASH_IN,76348,Agence_mtn_Cotonou,300000,223652,David du Blondel,26,76374,2022-01-27
CASH_IN,51016,Agence_mtn_Abomey,300000,248984,Corinne-Louise Valentin,1131900,1182916,2022-01-01
CASH_OUT,96329,Corinne-Louise Valentin,1182916,1086587,Agence_mtn_Ouidah,300000,203671,2022-01-01
CASH_IN,279575,Agence_mtn_Cotonou,300000,20425,Corinne-Louise Valentin,1086587,1366162,2022-01-02
CASH_OUT,1231755,Corinne-Louise Valentin,1366162,134407,Agence_mtn_Ouidah,300000,-931755,2022-01-04
TRANSFER,25639,Corinne-Louise Valentin,134407,108768,Louis Pichon,500400,474761,2022-01-06
TRANSFER,37582,Margot Riou du Fernandes,52600,15018,Corinne-Louise Valentin,108768,146350,2022-01-07
CASH_IN,175828,Agence_mtn_Cotonou,300000,124172,Corinne-Louise Valentin,146350,322178,2022-01-07
CASH_IN,119636,Agence_mtn_Abomey,300000,180364,Corinne-Louise Valentin,322178,441814,2022-01-08
CASH_OUT,373553,Corinne-Louise Valentin,441814,68261,Agence_mtn_Cotonou,300000,-73553,2022-01-11
TRANSFER,1543,Laure Philippe,9680,8137,Corinne-Louise Valentin,68261,69804,2022-01-12
TRANSFER,18319,Corinne-Louise Valentin,69804,51485,Honoré du Laurent,1671292,1652973,2022-01-12
CASH_IN,247405,Agence_mtn_Cotonou,300000,52595,Corinne-Louise Valentin,51485,298890,2022-01-14
CASH_IN,61263,Agence_mtn_Ouidah,300000,238737,Corinne-Louise Valentin,298890,360153,2022-01-14
CASH_IN,119403,Agence_mtn_Ouidah,300000,180597,Corinne-Louise Valentin,360153,479556,2022-01-14
TRANSFER,252363,Corinne-Louise Valentin,479556,227193,Philippine Courtois,723800,471437,2022-01-15
CASH_OUT,11467,Corinne-Louise Valentin,227193,215726,Agence_mtn_Abomey,300000,288533,2022-01-15
TRANSFER,508436,Sophie Gonzalez,925700,417264,Corinne-Louise Valentin,215726,724162,2022-01-15
TRANSFER,1133013,Vincent Fournier,1183400,50387,Corinne-Louise Valentin,724162,1857175,2022-01-15
CASH_IN,161232,Agence_mtn_Abomey,300000,138768,Corinne-Louise Valentin,1857175,2018407,2022-01-15
TRANSFER,251222,Corinne-Louise Valentin,2018407,1767185,Pénélope Dupuis,74100,-177122,2022-01-17
TRANSFER,218352,Étienne Roche,283473,65121,Corinne-Louise Valentin,1767185,1985537,2022-01-17
CASH_OUT,1542949,Corinne-Louise Valentin,1985537,442588,Agence_mtn_Cotonou,300000,-1242949,2022-01-19
TRANSFER,441582,Thibault Moreno,1136500,694918,Corinne-Louise Valentin,442588,884170,2022-01-19
CASH_IN,265765,Agence_mtn_Ouidah,300000,34235,Corinne-Louise Valentin,884170,1149935,2022-01-20
CASH_OUT,363054,Corinne-Louise Valentin,1149935,786881,Agence_mtn_Ouidah,300000,-63054,2022-01-20
CASH_OUT,317853,Corinne-Louise Valentin,786881,469028,Agence_mtn_Ouidah,300000,-17853,2022-01-21
CASH_OUT,132037,Corinne-Louise Valentin,469028,336991,Agence_mtn_Ouidah,300000,167963,2022-01-22
CASH_OUT,146942,Corinne-Louise Valentin,336991,190049,Agence_mtn_Cotonou,300000,153058,2022-01-22
CASH_OUT,187022,Corinne-Louise Valentin,190049,3027,Agence_mtn_Cotonou,300000,112978,2022-01-26
TRANSFER,774,Corinne-Louise Valentin,3027,2253,Inès Hamon,788500,787726,2022-01-27
TRANSFER,931174,Xavier Leblanc-Ferreira,1909391,978217,Cécile Germain,1748400,817226,2022-01-02
TRANSFER,441777,Gilbert Foucher,997000,555223,Xavier Leblanc-Ferreira,978217,1419994,2022-01-02
CASH_IN,152824,Agence_mtn_Cotonou,300000,147176,Xavier Leblanc-Ferreira,1419994,1572818,2022-01-02
CASH_IN,151821,Agence_mtn_Ouidah,300000,148179,Xavier Leblanc-Ferreira,1572818,1724639,2022-01-04
CASH_IN,249339,Agence_mtn_Ouidah,300000,50661,Xavier Leblanc-Ferreira,1724639,1973978,2022-01-08
TRANSFER,751687,Pierre Roger,1042457,290770,Xavier Leblanc-Ferreira,1973978,2725665,2022-01-09
CASH_OUT,888412,Xavier Leblanc-Ferreira,2725665,1837253,Agence_mtn_Ouidah,300000,-588412,2022-01-09
TRANSFER,127176,Céline Gomez,1563800,1436624,Xavier Leblanc-Ferreira,1837253,1964429,2022-01-09
TRANSFER,833944,Marcelle Paris,1780900,946956,Xavier Leblanc-Ferreira,1964429,2798373,2022-01-10
TRANSFER,1572630,Xavier Leblanc-Ferreira,2798373,1225743,Léon Lecoq,645955,-926675,2022-01-11
CASH_IN,296274,Agence_mtn_Abomey,300000,3726,Xavier Leblanc-Ferreira,1225743,1522017,2022-01-13
TRANSFER,68411,Geneviève De Oliveira-Michel,1014700,946289,Xavier Leblanc-Ferreira,1522017,1590428,2022-01-13
CASH_IN,242915,Agence_mtn_Abomey,300000,57085,Xavier Leblanc-Ferreira,1590428,1833343,2022-01-13
TRANSFER,110382,Rémy de la Roux,300243,189861,Xavier Leblanc-Ferreira,1833343,1943725,2022-01-14
CASH_OUT,1704278,Xavier Leblanc-Ferreira,1943725,239447,Agence_mtn_Cotonou,300000,-1404278,2022-01-15
TRANSFER,188732,Pierre Reynaud,272557,83825,Xavier Leblanc-Ferreira,239447,428179,2022-01-15
CASH_IN,179435,Agence_mtn_Cotonou,300000,120565,Xavier Leblanc-Ferreira,428179,607614,2022-01-16
TRANSFER,21566,Victoire-Nicole Lopez,34700,13134,Xavier Leblanc-Ferreira,607614,629180,2022-01-17
CASH_OUT,347383,Xavier Leblanc-Ferreira,629180,281797,Agence_mtn_Abomey,300000,-47383,2022-01-17
TRANSFER,196228,Xavier Leblanc-Ferreira,281797,85569,Cécile Clerc,1567900,1371672,2022-01-17
CASH_IN,87095,Agence_mtn_Ouidah,300000,212905,Xavier Leblanc-Ferreira,85569,172664,2022-01-18
CASH_IN,54263,Agence_mtn_Ouidah,300000,245737,Xavier Leblanc-Ferreira,172664,226927,2022-01-19
CASH_IN,282845,Agence_mtn_Abomey,300000,17155,Xavier Leblanc-Ferreira,226927,509772,2022-01-21
CASH_IN,81761,Agence_mtn_Abomey,300000,218239,Xavier Leblanc-Ferreira,509772,591533,2022-01-22
CASH_IN,85079,Agence_mtn_Ouidah,300000,214921,Xavier Leblanc-Ferreira,591533,676612,2022-01-22
TRANSFER,576566,Céline Gomez,1436624,860058,Xavier Leblanc-Ferreira,676612,1253178,2022-01-23
CASH_IN,173015,Agence_mtn_Ouidah,300000,126985,Xavier Leblanc-Ferreira,1253178,1426193,2022-01-24
CASH_IN,209515,Agence_mtn_Ouidah,300000,90485,Xavier Leblanc-Ferreira,1426193,1635708,2022-01-26
CASH_IN,105165,Agence_mtn_Cotonou,300000,194835,Édouard Nguyen,1310002,1415167,2022-01-06
CASH_IN,35507,Agence_mtn_Cotonou,300000,264493,Édouard Nguyen,1415167,1450674,2022-01-06
CASH_IN,229689,Agence_mtn_Ouidah,300000,70311,Édouard Nguyen,1450674,1680363,2022-01-06
CASH_IN,41325,Agence_mtn_Ouidah,300000,258675,Édouard Nguyen,1680363,1721688,2022-01-06
CASH_IN,295878,Agence_mtn_Ouidah,300000,4122,Édouard Nguyen,1721688,2017566,2022-01-09
TRANSFER,2016686,Édouard Nguyen,2017566,880,Renée David,545388,-1471298,2022-01-10
CASH_IN,64229,Agence_mtn_Abomey,300000,235771,Édouard Nguyen,880,65109,2022-01-11
TRANSFER,1434481,Frédéric Couturier,1765400,330919,Édouard Nguyen,65109,1499590,2022-01-12
TRANSFER,236181,Benjamin Evrard-Marty,1099449,863268,Édouard Nguyen,1499590,1735771,2022-01-12
CASH_OUT,328751,Édouard Nguyen,1735771,1407020,Agence_mtn_Cotonou,300000,-28751,2022-01-13
TRANSFER,706650,Édouard Nguyen,1407020,700370,Martine Wagner de la Bègue,54898,-651752,2022-01-16
TRANSFER,134738,Édouard Nguyen,700370,565632,Alfred du Lesage,950606,815868,2022-01-18
CASH_IN,178267,Agence_mtn_Ouidah,300000,121733,Édouard Nguyen,565632,743899,2022-01-18
TRANSFER,566304,Édouard Nguyen,743899,177595,Emmanuelle Georges,801100,234796,2022-01-20
CASH_IN,293349,Agence_mtn_Ouidah,300000,6651,Édouard Nguyen,177595,470944,2022-01-20
CASH_IN,163876,Agence_mtn_Cotonou,300000,136124,Édouard Nguyen,470944,634820,2022-01-21
TRANSFER,671789,Nath Bruneau,1092200,420411,Édouard Nguyen,634820,1306609,2022-01-21
TRANSFER,93385,Sophie Gonzalez,417264,323879,Édouard Nguyen,1306609,1399994,2022-01-21
TRANSFER,486683,Édouard Nguyen,1399994,913311,Vincent Fournier,50387,-436296,2022-01-21
CASH_IN,291485,Agence_mtn_Ouidah,300000,8515,Édouard Nguyen,913311,1204796,2022-01-22
TRANSFER,160075,Édouard Nguyen,1204796,1044721,Édouard Nguyen,1204796,1044721,2022-01-23
CASH_OUT,589129,Édouard Nguyen,1044721,455592,Agence_mtn_Abomey,300000,-289129,2022-01-25
TRANSFER,243849,Édouard Nguyen,455592,211743,Caroline-Lorraine Humbert,626300,382451,2022-01-26
CASH_OUT,178812,Édouard Nguyen,211743,32931,Agence_mtn_Abomey,300000,121188,2022-01-26
CASH_OUT,15595,Édouard Nguyen,32931,17336,Agence_mtn_Cotonou,300000,284405,2022-01-27
TRANSFER,72116,Inès de Letellier,1179300,1107184,Caroline-Lorraine Humbert,382451,310335,2022-01-01
CASH_OUT,605518,Inès de Letellier,1107184,501666,Agence_mtn_Cotonou,300000,-305518,2022-01-01
CASH_IN,256186,Agence_mtn_Ouidah,300000,43814,Inès de Letellier,501666,757852,2022-01-02
CASH_OUT,323457,Inès de Letellier,757852,434395,Agence_mtn_Cotonou,300000,-23457,2022-01-03
TRANSFER,924185,Marine Chauvet-Potier,1346700,422515,Inès de Letellier,434395,1358580,2022-01-05
TRANSFER,587258,Thibault Moreno,694918,107660,Inès de Letellier,1358580,1945838,2022-01-06
CASH_IN,66400,Agence_mtn_Ouidah,300000,233600,Inès de Letellier,1945838,2012238,2022-01-07
CASH_OUT,765988,Inès de Letellier,2012238,1246250,Agence_mtn_Abomey,300000,-465988,2022-01-07
CASH_IN,211955,Agence_mtn_Cotonou,300000,88045,Inès de Letellier,1246250,1458205,2022-01-09
TRANSFER,198723,Louis Pichon,474761,276038,Inès de Letellier,1458205,1656928,2022-01-14
CASH_OUT,240175,Inès de Letellier,1656928,1416753,Agence_mtn_Cotonou,300000,59825,2022-01-14
CASH_OUT,126010,Inès de Letellier,1416753,1290743,Agence_mtn_Cotonou,300000,173990,2022-01-14
CASH_OUT,668265,Inès de Letellier,1290743,622478,Agence_mtn_Abomey,300000,-368265,2022-01-16
CASH_OUT,59181,Inès de Letellier,622478,563297,Agence_mtn_Ouidah,300000,240819,2022-01-16
CASH_IN,281642,Agence_mtn_Cotonou,300000,18358,Inès de Letellier,563297,844939,2022-01-16
TRANSFER,538450,Cécile Germain,817226,278776,Inès de Letellier,844939,1383389,2022-01-17
CASH_OUT,830563,Inès de Letellier,1383389,552826,Agence_mtn_Ouidah,300000,-530563,2022-01-19
CASH_OUT,515391,Inès de Letellier,552826,37435,Agence_mtn_Ouidah,300000,-215391,2022-01-19
TRANSFER,15596,Inès de Letellier,37435,21839,Bertrand Charles,1929400,1913804,2022-01-19
TRANSFER,13819,Inès de Letellier,21839,8020,Frédéric Couturier,330919,317100,2022-01-20
CASH_OUT,546,Inès de Letellier,8020,7474,Agence_mtn_Cotonou,300000,299454,2022-01-20
CASH_IN,296472,Agence_mtn_Ouidah,300000,3528,Inès de Letellier,7474,303946,2022-01-21
TRANSFER,133044,Rémy de la Roux,189861,56817,Inès de Letellier,303946,436990,2022-01-21
CASH_OUT,149781,Inès de Letellier,436990,287209,Agence_mtn_Cotonou,300000,150219,2022-01-23
TRANSFER,242768,Inès de Letellier,287209,44441,Pierre Reynaud,83825,-158943,2022-01-27
CASH_OUT,14225,Inès de Letellier,44441,30216,Agence_mtn_Abomey,300000,285775,2022-01-27
CASH_IN,13087,Agence_mtn_Abomey,300000,286913,Aurore Guyon,1102539,1115626,2022-01-02
CASH_IN,83063,Agence_mtn_Ouidah,300000,216937,Aurore Guyon,1115626,1198689,2022-01-02
CASH_OUT,665116,Aurore Guyon,1198689,533573,Agence_mtn_Ouidah,300000,-365116,2022-01-05
CASH_OUT,525361,Aurore Guyon,533573,8212,Agence_mtn_Ouidah,300000,-225361,2022-01-07
CASH_OUT,7666,Aurore Guyon,8212,546,Agence_mtn_Cotonou,300000,292334,2022-01-07
CASH_IN,242448,Agence_mtn_Cotonou,300000,57552,Aurore Guyon,546,242994,2022-01-08
CASH_OUT,55350,Aurore Guyon,242994,187644,Agence_mtn_Abomey,300000,244650,2022-01-08
CASH_OUT,69484,Aurore Guyon,187644,118160,Agence_mtn_Cotonou,300000,230516,2022-01-09
CASH_OUT,108200,Aurore Guyon,118160,9960,Agence_mtn_Ouidah,300000,191800,2022-01-11
CASH_OUT,8084,Aurore Guyon,9960,1876,Agence_mtn_Cotonou,300000,291916,2022-01-11
CASH_IN,103183,Agence_mtn_Cotonou,300000,196817,Aurore Guyon,1876,105059,2022-01-13
TRANSFER,84739,Aurore Guyon,105059,20320,Caroline-Lorraine Humbert,310335,225596,2022-01-15
TRANSFER,1379,Aurore Guyon,20320,18941,François Michel-Legros,366200,364821,2022-01-15
CASH_IN,41463,Agence_mtn_Cotonou,300000,258537,Aurore Guyon,18941,60404,2022-01-16
CASH_IN,31521,Agence_mtn_Cotonou,300000,268479,Aurore Guyon,60404,91925,2022-01-17
CASH_IN,37500,Agence_mtn_Abomey,300000,262500,Aurore Guyon,91925,129425,2022-01-19
CASH_IN,187584,Agence_mtn_Cotonou,300000,112416,Aurore Guyon,129425,317009,2022-01-20
CASH_IN,4887,Agence_mtn_Abomey,300000,295113,Aurore Guyon,317009,321896,2022-01-20
TRANSFER,309044,Aurore Guyon,321896,12852,Philippine Courtois,471437,162393,2022-01-21
CASH_IN,14620,Agence_mtn_Abomey,300000,285380,Aurore Guyon,12852,27472,2022-01-21
CASH_OUT,9260,Aurore Guyon,27472,18212,Agence_mtn_Ouidah,300000,290740,2022-01-25
TRANSFER,16461,Aurore Guyon,18212,1751,Gilbert Foucher,555223,538762,2022-01-27
TRANSFER,1288,Aurore Guyon,1751,463,Frédéric Couturier,317100,315812,2022-01-27
CASH_IN,131276,Agence_mtn_Ouidah,300000,168724,Aurore Guyon,463,131739,2022-01-27
TRANSFER,117170,Frédéric Couturier,315812,198642,Claude Foucher,2504,-114666,2022-01-01
CASH_OUT,184459,Frédéric Couturier,198642,14183,Agence_mtn_Cotonou,300000,115541,2022-01-01
CASH_IN,289916,Agence_mtn_Cotonou,300000,10084,Frédéric Couturier,14183,304099,2022-01-01
TRANSFER,194340,Eugène Poulain,1082900,888560,Frédéric Couturier,304099,498439,2022-01-01
CASH_OUT,319749,Frédéric Couturier,498439,178690,Agence_mtn_Abomey,300000,-19749,2022-01-03
CASH_OUT,122684,Frédéric Couturier,178690,56006,Agence_mtn_Ouidah,300000,177316,2022-01-04
CASH_IN,235582,Agence_mtn_Abomey,300000,64418,Frédéric Couturier,56006,291588,2022-01-04
CASH_OUT,9807,Frédéric Couturier,291588,281781,Agence_mtn_Ouidah,300000,290193,2022-01-05
TRANSFER,987219,Marcelle Charrier,1007800,20581,Frédéric Couturier,281781,1269000,2022-01-05
CASH_OUT,483101,Frédéric Couturier,1269000,785899,Agence_mtn_Cotonou,300000,-183101,2022-01-08
TRANSFER,249085,Sophie Gonzalez,323879,74794,Frédéric Couturier,785899,1034984,2022-01-10
TRANSFER,772906,Honoré du Laurent,1652973,880067,Frédéric Couturier,1034984,1807890,2022-01-10
TRANSFER,1790314,Frédéric Couturier,1807890,17576,Richard Le Descamps,978600,-811714,2022-01-13
CASH_IN,29825,Agence_mtn_Ouidah,300000,270175,Frédéric Couturier,17576,47401,2022-01-13
TRANSFER,92205,Nath Bruneau,420411,328206,Frédéric Couturier,47401,139606,2022-01-13
CASH_OUT,78599,Frédéric Couturier,139606,61007,Agence_mtn_Cotonou,300000,221401,2022-01-14
TRANSFER,331563,François Michel-Legros,364821,33258,Frédéric Couturier,61007,392570,2022-01-14
TRANSFER,6579,Frédéric Couturier,392570,385991,Raymond Rossi,1310600,1304021,2022-01-14
CASH_OUT,4136,Frédéric Couturier,385991,381855,Agence_mtn_Ouidah,300000,295864,2022-01-16
CASH_OUT,129291,Frédéric Couturier,381855,252564,Agence_mtn_Cotonou,300000,170709,2022-01-17
CASH_IN,267368,Agence_mtn_Abomey,300000,32632,Frédéric Couturier,252564,519932,2022-01-17
TRANSFER,259138,Cécile Germain,278776,19638,Frédéric Couturier,519932,779070,2022-01-20
CASH_OUT,417388,Frédéric Couturier,779070,361682,Agence_mtn_Cotonou,300000,-117388,2022-01-21
TRANSFER,293431,Frédéric Couturier,361682,68251,Philippine Courtois,162393,-131038,2022-01-21
TRANSFER,220748,Gilbert Foucher,538762,318014,Frédéric Couturier,68251,288999,2022-01-23
CASH_IN,8407,Agence_mtn_Ouidah,300000,291593,Frédéric Couturier,288999,297406,2022-01-24
TRANSFER,5030,Margot Riou du Fernandes,15018,9988,Frédéric Couturier,297406,302436,2022-01-25
TRANSFER,238423,Frédéric Couturier,302436,64013,Gilbert Foucher,318014,79591,2022-01-27
CASH_OUT,1610,Margot Riou du Fernandes,9988,8378,Agence_mtn_Ouidah,300000,298390,2022-01-01
CASH_OUT,636,Margot Riou du Fernandes,8378,7742,Agence_mtn_Ouidah,300000,299364,2022-01-03
TRANSFER,402,Margot Riou du Fernandes,7742,7340,Étienne Roche,65121,64719,2022-01-04
CASH_OUT,2510,Margot Riou du Fernandes,7340,4830,Agence_mtn_Abomey,300000,297490,2022-01-04
CASH_IN,219901,Agence_mtn_Ouidah,300000,80099,Margot Riou du Fernandes,4830,224731,2022-01-04
CASH_OUT,91742,Margot Riou du Fernandes,224731,132989,Agence_mtn_Abomey,300000,208258,2022-01-05
CASH_IN,66797,Agence_mtn_Abomey,300000,233203,Margot Riou du Fernandes,132989,199786,2022-01-07
CASH_IN,52111,Agence_mtn_Abomey,300000,247889,Margot Riou du Fernandes,199786,251897,2022-01-07
TRANSFER,2736,Sophie Gonzalez,74794,72058,Margot Riou du Fernandes,251897,254633,2022-01-07
TRANSFER,382591,Bertrand Charles,1913804,1531213,Margot Riou du Fernandes,254633,637224,2022-01-08
CASH_OUT,439973,Margot Riou du Fernandes,637224,197251,Agence_mtn_Abomey,300000,-139973,2022-01-10
TRANSFER,56592,Margot Riou du Fernandes,197251,140659,Eugène Poulain,888560,831968,2022-01-11
TRANSFER,88844,Margot Riou du Fernandes,140659,51815,Gilbert Foucher,79591,-9253,2022-01-12
CASH_OUT,2722,Margot Riou du Fernandes,51815,49093,Agence_mtn_Cotonou,300000,297278,2022-01-15
CASH_IN,182258,Agence_mtn_Cotonou,300000,117742,Margot Riou du Fernandes,49093,231351,2022-01-15
CASH_OUT,57344,Margot Riou du Fernandes,231351,174007,Agence_mtn_Cotonou,300000,242656,2022-01-17
CASH_OUT,107684,Margot Riou du Fernandes,174007,66323,Agence_mtn_Ouidah,300000,192316,2022-01-19
CASH_OUT,2593,Margot Riou du Fernandes,66323,63730,Agence_mtn_Cotonou,300000,297407,2022-01-19
CASH_OUT,40446,Margot Riou du Fernandes,63730,23284,Agence_mtn_Ouidah,300000,259554,2022-01-20
CASH_OUT,22015,Margot Riou du Fernandes,23284,1269,Agence_mtn_Ouidah,300000,277985,2022-01-20
TRANSFER,638,Margot Riou du Fernandes,1269,631,Franck-Charles Texier,1106600,1105962,2022-01-20
TRANSFER,130,Margot Riou du Fernandes,631,501,Roland Garcia,136968,136838,2022-01-21
TRANSFER,636887,Sébastien Vallée,1015995,379108,Margot Riou du Fernandes,501,637388,2022-01-21
TRANSFER,5969,Honoré du Laurent,880067,874098,Margot Riou du Fernandes,637388,643357,2022-01-21
CASH_OUT,78358,Margot Riou du Fernandes,643357,564999,Agence_mtn_Cotonou,300000,221642,2022-01-21
TRANSFER,99222,Margot Riou du Fernandes,564999,465777,Rémy de la Roux,56817,-42405,2022-01-23
CASH_IN,239108,Agence_mtn_Abomey,300000,60892,Margot Riou du Fernandes,465777,704885,2022-01-25
CASH_IN,238703,Agence_mtn_Abomey,300000,61297,Margot Riou du Fernandes,704885,943588,2022-01-26
CASH_OUT,13895,Margot Riou du Fernandes,943588,929693,Agence_mtn_Cotonou,300000,286105,2022-01-26
CASH_OUT,114243,Eugène Poulain,831968,717725,Agence_mtn_Cotonou,300000,185757,2022-01-02
CASH_IN,20897,Agence_mtn_Abomey,300000,279103,Eugène Poulain,717725,738622,2022-01-04
CASH_OUT,504006,Eugène Poulain,738622,234616,Agence_mtn_Abomey,300000,-204006,2022-01-04
CASH_OUT,212502,Eugène Poulain,234616,22114,Agence_mtn_Cotonou,300000,87498,2022-01-04
TRANSFER,1149169,Raymond Marchal de Nguyen,1413000,263831,Eugène Poulain,22114,1171283,2022-01-07
TRANSFER,835096,Cécile Clerc,1371672,536576,Eugène Poulain,1171283,2006379,2022-01-07
TRANSFER,597694,Eugène Poulain,2006379,1408685,Raymond Rossi,1304021,706327,2022-01-08
CASH_OUT,391293,Eugène Poulain,1408685,1017392,Agence_mtn_Cotonou,300000,-91293,2022-01-09
TRANSFER,196042,Caroline-Lorraine Humbert,225596,29554,Eugène Poulain,1017392,1213434,2022-01-09
CASH_OUT,689470,Eugène Poulain,1213434,523964,Agence_mtn_Abomey,300000,-389470,2022-01-10
CASH_IN,190528,Agence_mtn_Abomey,300000,109472,Eugène Poulain,523964,714492,2022-01-15
TRANSFER,55968,Sophie Gonzalez,72058,16090,Eugène Poulain,714492,770460,2022-01-16
CASH_OUT,237164,Eugène Poulain,770460,533296,Agence_mtn_Abomey,300000,62836,2022-01-17
CASH_OUT,106348,Eugène Poulain,533296,426948,Agence_mtn_Ouidah,300000,193652,2022-01-17
CASH_OUT,348425,Eugène Poulain,426948,78523,Agence_mtn_Cotonou,300000,-48425,2022-01-18
TRANSFER,14069,Cécile Germain,19638,5569,Eugène Poulain,78523,92592,2022-01-19
CASH_OUT,33631,Eugène Poulain,92592,58961,Agence_mtn_Ouidah,300000,266369,2022-01-19
CASH_OUT,7714,Eugène Poulain,58961,51247,Agence_mtn_Ouidah,300000,292286,2022-01-19
CASH_OUT,31259,Eugène Poulain,51247,19988,Agence_mtn_Abomey,300000,268741,2022-01-21
TRANSFER,11986,Victoire-Nicole Lopez,13134,1148,Eugène Poulain,19988,31974,2022-01-21
CASH_IN,77044,Agence_mtn_Ouidah,300000,222956,Eugène Poulain,31974,109018,2022-01-22
CASH_OUT,67365,Eugène Poulain,109018,41653,Agence_mtn_Ouidah,300000,232635,2022-01-22
CASH_OUT,3536,Eugène Poulain,41653,38117,Agence_mtn_Ouidah,300000,296464,2022-01-22
CASH_OUT,37859,Eugène Poulain,38117,258,Agence_mtn_Abomey,300000,262141,2022-01-23
CASH_OUT,180,Eugène Poulain,258,78,Agence_mtn_Abomey,300000,299820,2022-01-23
CASH_IN,62296,Agence_mtn_Abomey,300000,237704,Eugène Poulain,78,62374,2022-01-24
CASH_IN,133973,Agence_mtn_Abomey,300000,166027,Eugène Poulain,62374,196347,2022-01-24
TRANSFER,153481,Marine Chauvet-Potier,422515,269034,Eugène Poulain,196347,349828,2022-01-25
CASH_OUT,70752,Eugène Poulain,349828,279076,Agence_mtn_Ouidah,300000,229248,2022-01-25
CASH_IN,297373,Agence_mtn_Abomey,300000,2627,Eugène Poulain,279076,576449,2022-01-26
CASH_IN,233727,Agence_mtn_Ouidah,300000,66273,Virginie Le Gall,-415782,-182055,2022-01-03
CASH_IN,71087,Agence_mtn_Abomey,300000,228913,Virginie Le Gall,-182055,-110968,2022-01-04
CASH_IN,86304,Agence_mtn_Cotonou,300000,213696,Virginie Le Gall,-110968,-24664,2022-01-04
CASH_IN,263672,Agence_mtn_Abomey,300000,36328,Virginie Le Gall,-24664,239008,2022-01-06
CASH_IN,210657,Agence_mtn_Ouidah,300000,89343,Virginie Le Gall,239008,449665,2022-01-07
CASH_OUT,164061,Virginie Le Gall,449665,285604,Agence_mtn_Cotonou,300000,135939,2022-01-07
TRANSFER,242303,Virginie Le Gall,285604,43301,Inès Hamon,787726,545423,2022-01-08
CASH_OUT,37190,Virginie Le Gall,43301,6111,Agence_mtn_Cotonou,300000,262810,2022-01-09
CASH_IN,79299,Agence_mtn_Ouidah,300000,220701,Virginie Le Gall,6111,85410,2022-01-12
TRANSFER,36496,Virginie Le Gall,85410,48914,Zoé Renaud de Boutin,1294400,1257904,2022-01-12
CASH_IN,55164,Agence_mtn_Cotonou,300000,244836,Virginie Le Gall,48914,104078,2022-01-12
TRANSFER,17822,Virginie Le Gall,104078,86256,Pierre Roger,290770,272948,2022-01-13
TRANSFER,169417,Raymond Rossi,706327,536910,Virginie Le Gall,86256,255673,2022-01-16
CASH_IN,91932,Agence_mtn_Cotonou,300000,208068,Virginie Le Gall,255673,347605,2022-01-16
TRANSFER,7368,Laure Philippe,8137,769,Virginie Le Gall,347605,354973,2022-01-18
CASH_IN,111052,Agence_mtn_Ouidah,300000,188948,Virginie Le Gall,354973,466025,2022-01-19
CASH_IN,14402,Agence_mtn_Ouidah,300000,285598,Virginie Le Gall,466025,480427,2022-01-19
CASH_OUT,151253,Virginie Le Gall,480427,329174,Agence_mtn_Abomey,300000,148747,2022-01-20
CASH_OUT,182073,Virginie Le Gall,329174,147101,Agence_mtn_Abomey,300000,117927,2022-01-21
CASH_IN,41299,Agence_mtn_Cotonou,300000,258701,Virginie Le Gall,147101,188400,2022-01-21
CASH_OUT,107098,Virginie Le Gall,188400,81302,Agence_mtn_Cotonou,300000,192902,2022-01-22
CASH_OUT,46145,Virginie Le Gall,81302,35157,Agence_mtn_Ouidah,300000,253855,2022-01-22
CASH_OUT,23348,Virginie Le Gall,35157,11809,Agence_mtn_Ouidah,300000,276652,2022-01-22
CASH_IN,67022,Agence_mtn_Abomey,300000,232978,Virginie Le Gall,11809,78831,2022-01-23
TRANSFER,470549,Marcelle Paris,946956,476407,Virginie Le Gall,78831,549380,2022-01-24
CASH_OUT,420724,Virginie Le Gall,549380,128656,Agence_mtn_Abomey,300000,-120724,2022-01-24
CASH_OUT,79942,Virginie Le Gall,128656,48714,Agence_mtn_Cotonou,300000,220058,2022-01-25
TRANSFER,31899,Virginie Le Gall,48714,16815,Théodore De Oliveira-Nicolas,67857,35958,2022-01-26
CASH_IN,153523,Agence_mtn_Abomey,300000,146477,Marcelle Paris,476407,629930,2022-01-01
CASH_OUT,271155,Marcelle Paris,629930,358775,Agence_mtn_Ouidah,300000,28845,2022-01-02
CASH_OUT,202938,Marcelle Paris,358775,155837,Agence_mtn_Abomey,300000,97062,2022-01-02
CASH_IN,168746,Agence_mtn_Abomey,300000,131254,Marcelle Paris,155837,324583,2022-01-04
TRANSFER,312997,Marcelle Paris,324583,11586,Sophie Gonzalez,16090,-296907,2022-01-04
CASH_OUT,10553,Marcelle Paris,11586,1033,Agence_mtn_Ouidah,300000,289447,2022-01-04
CASH_OUT,533,Marcelle Paris,1033,500,Agence_mtn_Abomey,300000,299467,2022-01-06
CASH_OUT,398,Marcelle Paris,500,102,Agence_mtn_Cotonou,300000,299602,2022-01-06
CASH_IN,4442,Agence_mtn_Ouidah,300000,295558,Marcelle Paris,102,4544,2022-01-07
CASH_IN,280408,Agence_mtn_Cotonou,300000,19592,Marcelle Paris,4544,284952,2022-01-07
CASH_OUT,84967,Marcelle Paris,284952,199985,Agence_mtn_Abomey,300000,215033,2022-01-09
CASH_IN,246686,Agence_mtn_Cotonou,300000,53314,Marcelle Paris,199985,446671,2022-01-10
CASH_IN,288541,Agence_mtn_Cotonou,300000,11459,Marcelle Paris,446671,735212,2022-01-11
TRANSFER,145148,Marcelle Paris,735212,590064,Valentine Martinez,917682,772534,2022-01-11
CASH_OUT,442733,Marcelle Paris,590064,147331,Agence_mtn_Cotonou,300000,-142733,2022-01-17
CASH_IN,143461,Agence_mtn_Cotonou,300000,156539,Marcelle Paris,147331,290792,2022-01-18
TRANSFER,18294,Caroline-Lorraine Humbert,29554,11260,Marcelle Paris,290792,309086,2022-01-21
CASH_IN,187801,Agence_mtn_Cotonou,300000,112199,Marcelle Paris,309086,496887,2022-01-23
TRANSFER,32189,Marcelle Paris,496887,464698,Cécile Germain,5569,-26620,2022-01-25
TRANSFER,364914,Marcelle Paris,464698,99784,Zoé Renaud de Boutin,1257904,892990,2022-01-25
TRANSFER,44434,Marcelle Paris,99784,55350,Étienne Roche,64719,20285,2022-01-26
CASH_OUT,20284,Marcelle Paris,55350,35066,Agence_mtn_Abomey,300000,279716,2022-01-27
CASH_IN,213888,Agence_mtn_Cotonou,300000,86112,Marcelle Paris,35066,248954,2022-01-27
CASH_IN,231908,Agence_mtn_Cotonou,300000,68092,Roland Garcia,136838,368746,2022-01-01
CASH_OUT,178537,Roland Garcia,368746,190209,Agence_mtn_Cotonou,300000,121463,2022-01-03
TRANSFER,73993,Antoine Leleu,497500,423507,Roland Garcia,190209,264202,2022-01-04
TRANSFER,573096,Franck-Charles Texier,1105962,532866,Roland Garcia,264202,837298,2022-01-04
CASH_OUT,519037,Roland Garcia,837298,318261,Agence_mtn_Ouidah,300000,-219037,2022-01-07
CASH_OUT,130045,Roland Garcia,318261,188216,Agence_mtn_Abomey,300000,169955,2022-01-08
CASH_OUT,155626,Roland Garcia,188216,32590,Agence_mtn_Ouidah,300000,144374,2022-01-08
TRANSFER,29973,Roland Garcia,32590,2617,Simone Pineau,157100,127127,2022-01-08
TRANSFER,133532,Nath Bruneau,328206,194674,Roland Garcia,2617,136149,2022-01-09
CASH_OUT,96744,Roland Garcia,136149,39405,Agence_mtn_Abomey,300000,203256,2022-01-10
CASH_OUT,18061,Roland Garcia,39405,21344,Agence_mtn_Cotonou,300000,281939,2022-01-10
CASH_OUT,8098,Roland Garcia,21344,13246,Agence_mtn_Cotonou,300000,291902,2022-01-11
CASH_OUT,9543,Roland Garcia,13246,3703,Agence_mtn_Cotonou,300000,290457,2022-01-13
TRANSFER,633255,Benjamin Evrard-Marty,863268,230013,Roland Garcia,3703,636958,2022-01-13
TRANSFER,208232,Roland Garcia,636958,428726,François Michel-Legros,33258,-174974,2022-01-21
CASH_OUT,167203,Roland Garcia,428726,261523,Agence_mtn_Cotonou,300000,132797,2022-01-22
CASH_OUT,80174,Roland Garcia,261523,181349,Agence_mtn_Cotonou,300000,219826,2022-01-22
CASH_OUT,74309,Roland Garcia,181349,107040,Agence_mtn_Abomey,300000,225691,2022-01-24
CASH_OUT,54680,Roland Garcia,107040,52360,Agence_mtn_Ouidah,300000,245320,2022-01-24
CASH_IN,50655,Agence_mtn_Abomey,300000,249345,Roland Garcia,52360,103015,2022-01-24
TRANSFER,26934,Roland Garcia,103015,76081,Emmanuelle Georges,234796,207862,2022-01-26
CASH_OUT,20412,Roland Garcia,76081,55669,Agence_mtn_Ouidah,300000,279588,2022-01-27
CASH_IN,226664,Agence_mtn_Cotonou,300000,73336,Inès Hamon,545423,772087,2022-01-01
CASH_IN,72487,Agence_mtn_Ouidah,300000,227513,Inès Hamon,772087,844574,2022-01-02
TRANSFER,192479,Inès Hamon,844574,652095,Céline Gomez,860058,667579,2022-01-04
TRANSFER,244412,Thierry Delattre-Simon,253456,9044,Inès Hamon,652095,896507,2022-01-05
CASH_OUT,504467,Inès Hamon,896507,392040,Agence_mtn_Ouidah,300000,-204467,2022-01-06
CASH_IN,28003,Agence_mtn_Ouidah,300000,271997,Inès Hamon,392040,420043,2022-01-06
CASH_IN,257397,Agence_mtn_Cotonou,300000,42603,Inès Hamon,420043,677440,2022-01-07
TRANSFER,334179,Nathalie Peron,1245100,910921,Inès Hamon,677440,1011619,2022-01-07
TRANSFER,19363,Benjamin Evrard-Marty,230013,210650,Inès Hamon,1011619,1030982,2022-01-12
TRANSFER,179450,Benjamin Evrard-Marty,210650,31200,Inès Hamon,1030982,1210432,2022-01-13
CASH_IN,148992,Agence_mtn_Abomey,300000,151008,Inès Hamon,1210432,1359424,2022-01-14
CASH_IN,115616,Agence_mtn_Ouidah,300000,184384,Inès Hamon,1359424,1475040,2022-01-15
CASH_OUT,374180,Inès Hamon,1475040,1100860,Agence_mtn_Abomey,300000,-74180,2022-01-15
TRANSFER,3042,Thierry Delattre-Simon,9044,6002,Inès Hamon,1100860,1103902,2022-01-17
CASH_OUT,180854,Inès Hamon,1103902,923048,Agence_mtn_Abomey,300000,119146,2022-01-17
CASH_IN,256157,Agence_mtn_Ouidah,300000,43843,Inès Hamon,923048,1179205,2022-01-18
CASH_IN,190956,Agence_mtn_Cotonou,300000,109044,Inès Hamon,1179205,1370161,2022-01-19
CASH_IN,254491,Agence_mtn_Cotonou,300000,45509,Inès Hamon,1370161,1624652,2022-01-21
CASH_OUT,1231175,Inès Hamon,1624652,393477,Agence_mtn_Ouidah,300000,-931175,2022-01-21
TRANSFER,12737,Inès Hamon,393477,380740,Franck-Charles Texier,532866,520129,2022-01-22
CASH_IN,216065,Agence_mtn_Ouidah,300000,83935,Inès Hamon,380740,596805,2022-01-26
CASH_IN,243754,Agence_mtn_Ouidah,300000,56246,Inès Hamon,596805,840559,2022-01-26
TRANSFER,660630,Inès Hamon,840559,179929,Alexandrie Delmas,5900,-654730,2022-01-27
CASH_IN,111678,Agence_mtn_Abomey,300000,188322,Inès Hamon,179929,291607,2022-01-27
CASH_IN,56721,Agence_mtn_Abomey,300000,243279,François Michel-Legros,-174974,-118253,2022-01-01
CASH_IN,126492,Agence_mtn_Ouidah,300000,173508,François Michel-Legros,-118253,8239,2022-01-03
CASH_OUT,7985,François Michel-Legros,8239,254,Agence_mtn_Abomey,300000,292015,2022-01-04
TRANSFER,6640,Caroline-Lorraine Humbert,11260,4620,François Michel-Legros,254,6894,2022-01-04
CASH_IN,206093,Agence_mtn_Ouidah,300000,93907,François Michel-Legros,6894,212987,2022-01-05
TRANSFER,156973,François Michel-Legros,212987,56014,Geneviève De Oliveira-Michel,946289,789316,2022-01-05
CASH_OUT,40058,François Michel-Legros,56014,15956,Agence_mtn_Ouidah,300000,259942,2022-01-06
CASH_IN,36315,Agence_mtn_Abomey,300000,263685,François Michel-Legros,15956,52271,2022-01-06
TRANSFER,14697,François Michel-Legros,52271,37574,Isabelle Rossi,1683500,1668803,2022-01-06
CASH_IN,15146,Agence_mtn_Ouidah,300000,284854,François Michel-Legros,37574,52720,2022-01-07
TRANSFER,22447,François Michel-Legros,52720,30273,Raymond Rossi,536910,514463,2022-01-07
CASH_OUT,12002,François Michel-Legros,30273,18271,Agence_mtn_Ouidah,300000,287998,2022-01-09
CASH_IN,72292,Agence_mtn_Abomey,300000,227708,François Michel-Legros,18271,90563,2022-01-10
CASH_IN,148323,Agence_mtn_Abomey,300000,151677,François Michel-Legros,90563,238886,2022-01-12
CASH_IN,265989,Agence_mtn_Cotonou,300000,34011,François Michel-Legros,238886,504875,2022-01-13
CASH_IN,224426,Agence_mtn_Abomey,300000,75574,François Michel-Legros,504875,729301,2022-01-17
TRANSFER,399295,Céline Gomez,667579,268284,François Michel-Legros,729301,1128596,2022-01-20
CASH_IN,276182,Agence_mtn_Abomey,300000,23818,François Michel-Legros,1128596,1404778,2022-01-21
CASH_OUT,38679,François Michel-Legros,1404778,1366099,Agence_mtn_Cotonou,300000,261321,2022-01-22
TRANSFER,786318,Michelle Lebon,855400,69082,François Michel-Legros,1366099,2152417,2022-01-22
TRANSFER,1600636,François Michel-Legros,2152417,551781,Antoine Leleu,423507,-1177129,2022-01-25
CASH_IN,247776,Agence_mtn_Abomey,300000,52224,François Michel-Legros,551781,799557,2022-01-27
CASH_IN,89170,Agence_mtn_Cotonou,300000,210830,Léon Lecoq,-926675,-837505,2022-01-03
CASH_IN,161264,Agence_mtn_Ouidah,300000,138736,Léon Lecoq,-837505,-676241,2022-01-04
CASH_IN,70441,Agence_mtn_Cotonou,300000,229559,Léon Lecoq,-676241,-605800,2022-01-05
CASH_IN,264455,Agence_mtn_Ouidah,300000,35545,Léon Lecoq,-605800,-341345,2022-01-05
CASH_IN,130912,Agence_mtn_Cotonou,300000,169088,Léon Lecoq,-341345,-210433,2022-01-06
CASH_IN,133872,Agence_mtn_Ouidah,300000,166128,Léon Lecoq,-210433,-76561,2022-01-13
CASH_IN,174134,Agence_mtn_Abomey,300000,125866,Léon Lecoq,-76561,97573,2022-01-13
CASH_IN,226261,Agence_mtn_Ouidah,300000,73739,Léon Lecoq,97573,323834,2022-01-13
TRANSFER,19585,Léon Lecoq,323834,304249,Nathalie Peron,910921,891336,2022-01-15
CASH_OUT,262727,Léon Lecoq,304249,41522,Agence_mtn_Abomey,300000,37273,2022-01-15
TRANSFER,641906,William Lebrun,1156915,515009,Léon Lecoq,41522,683428,2022-01-16
CASH_IN,134776,Agence_mtn_Ouidah,300000,165224,Léon Lecoq,683428,818204,2022-01-16
TRANSFER,117248,Marine Chauvet-Potier,269034,151786,Léon Lecoq,818204,935452,2022-01-17
TRANSFER,820215,Léon Lecoq,935452,115237,Isabelle Rossi,1668803,848588,2022-01-18
CASH_OUT,40488,Léon Lecoq,115237,74749,Agence_mtn_Cotonou,300000,259512,2022-01-20
CASH_OUT,3965,Léon Lecoq,74749,70784,Agence_mtn_Abomey,300000,296035,2022-01-21
TRANSFER,21390,Léon Lecoq,70784,49394,Raymond Marchal de Nguyen,263831,242441,2022-01-21
CASH_OUT,16895,Léon Lecoq,49394,32499,Agence_mtn_Abomey,300000,283105,2022-01-22
CASH_OUT,12863,Léon Lecoq,32499,19636,Agence_mtn_Ouidah,300000,287137,2022-01-25
CASH_IN,150360,Agence_mtn_Abomey,300000,149640,Léon Lecoq,19636,169996,2022-01-26
CASH_OUT,165266,Léon Lecoq,169996,4730,Agence_mtn_Ouidah,300000,134734,2022-01-27
CASH_IN,9011,Agence_mtn_Cotonou,300000,290989,Antoine Leleu,-1177129,-1168118,2022-01-01
CASH_IN,239893,Agence_mtn_Abomey,300000,60107,Antoine Leleu,-1168118,-928225,2022-01-02
CASH_IN,36170,Agence_mtn_Abomey,300000,263830,Antoine Leleu,-928225,-892055,2022-01-04
CASH_IN,263192,Agence_mtn_Cotonou,300000,36808,Antoine Leleu,-892055,-628863,2022-01-08
CASH_IN,251199,Agence_mtn_Ouidah,300000,48801,Antoine Leleu,-628863,-377664,2022-01-10
CASH_IN,140438,Agence_mtn_Cotonou,300000,159562,Antoine Leleu,-377664,-237226,2022-01-10
CASH_IN,285805,Agence_mtn_Abomey,300000,14195,Antoine Leleu,-237226,48579,2022-01-11
CASH_IN,270669,Agence_mtn_Ouidah,300000,29331,Antoine Leleu,48579,319248,2022-01-11
CASH_IN,193310,Agence_mtn_Ouidah,300000,106690,Antoine Leleu,319248,512558,2022-01-11
CASH_IN,254657,Agence_mtn_Cotonou,300000,45343,Antoine Leleu,512558,767215,2022-01-12
CASH_OUT,466824,Antoine Leleu,767215,300391,Agence_mtn_Cotonou,300000,-166824,2022-01-12
CASH_OUT,191838,Antoine Leleu,300391,108553,Agence_mtn_Abomey,300000,108162,2022-01-13
CASH_OUT,4659,Antoine Leleu,108553,103894,Agence_mtn_Ouidah,300000,295341,2022-01-13
CASH_IN,205768,Agence_mtn_Ouidah,300000,94232,Antoine Leleu,103894,309662,2022-01-15
TRANSFER,403042,Alphonse Le Olivier,411000,7958,Antoine Leleu,309662,712704,2022-01-16
CASH_IN,101088,Agence_mtn_Cotonou,300000,198912,Antoine Leleu,712704,813792,2022-01-17
TRANSFER,518826,Nathalie Peron,891336,372510,Antoine Leleu,813792,1332618,2022-01-17
CASH_IN,131249,Agence_mtn_Abomey,300000,168751,Antoine Leleu,1332618,1463867,2022-01-18
TRANSFER,699,Laure Philippe,769,70,Antoine Leleu,1463867,1464566,2022-01-18
CASH_OUT,855687,Antoine Leleu,1464566,608879,Agence_mtn_Ouidah,300000,-555687,2022-01-19
CASH_OUT,192662,Antoine Leleu,608879,416217,Agence_mtn_Ouidah,300000,107338,2022-01-20
CASH_OUT,308315,Antoine Leleu,416217,107902,Agence_mtn_Ouidah,300000,-8315,2022-01-21
TRANSFER,84448,Antoine Leleu,107902,23454,Tristan Thomas,598474,514026,2022-01-22
TRANSFER,47647,Nathalie Peron,372510,324863,Antoine Leleu,23454,71101,2022-01-23
CASH_IN,192520,Agence_mtn_Ouidah,300000,107480,Antoine Leleu,71101,263621,2022-01-25
CASH_IN,34114,Agence_mtn_Cotonou,300000,265886,Antoine Leleu,263621,297735,2022-01-26
CASH_IN,243779,Agence_mtn_Ouidah,300000,56221,Pierre Reynaud,-158943,84836,2022-01-01
CASH_IN,68329,Agence_mtn_Abomey,300000,231671,Pierre Reynaud,84836,153165,2022-01-02
TRANSFER,32659,Pierre Reynaud,153165,120506,Céline Gomez,268284,235625,2022-01-02
CASH_OUT,33787,Pierre Reynaud,120506,86719,Agence_mtn_Ouidah,300000,266213,2022-01-04
TRANSFER,84076,Pierre Reynaud,86719,2643,Sébastien Lemaître,30104,-53972,2022-01-07
CASH_IN,274113,Agence_mtn_Abomey,300000,25887,Pierre Reynaud,2643,276756,2022-01-11
TRANSFER,155848,Pierre Reynaud,276756,120908,William Lebrun,515009,359161,2022-01-11
CASH_IN,180529,Agence_mtn_Cotonou,300000,119471,Pierre Reynaud,120908,301437,2022-01-12
CASH_IN,199196,Agence_mtn_Ouidah,300000,100804,Pierre Reynaud,301437,500633,2022-01-14
TRANSFER,23139,Pierre Reynaud,500633,477494,Zoé Renaud de Boutin,892990,869851,2022-01-15
CASH_OUT,56754,Pierre Reynaud,477494,420740,Agence_mtn_Cotonou,300000,243246,2022-01-15
CASH_OUT,215828,Pierre Reynaud,420740,204912,Agence_mtn_Cotonou,300000,84172,2022-01-15
CASH_IN,108426,Agence_mtn_Cotonou,300000,191574,Pierre Reynaud,204912,313338,2022-01-17
TRANSFER,827202,Zoé Renaud de Boutin,869851,42649,Pierre Reynaud,313338,1140540,2022-01-17
CASH_IN,25382,Agence_mtn_Cotonou,300000,274618,Pierre Reynaud,1140540,1165922,2022-01-17
CASH_IN,116386,Agence_mtn_Cotonou,300000,183614,Pierre Reynaud,1165922,1282308,2022-01-17
TRANSFER,92878,Pierre Reynaud,1282308,1189430,Pierre Reynaud,1282308,1189430,2022-01-18
CASH_IN,122779,Agence_mtn_Abomey,300000,177221,Pierre Reynaud,1189430,1312209,2022-01-19
TRANSFER,1196024,Pierre Reynaud,1312209,116185,Franck-Charles Texier,520129,-675895,2022-01-23
TRANSFER,102174,Pierre Reynaud,116185,14011,Gilbert-Charles Thibault,486168,383994,2022-01-23
CASH_OUT,9840,Pierre Reynaud,14011,4171,Agence_mtn_Abomey,300000,290160,2022-01-24
CASH_OUT,851,Pierre Reynaud,4171,3320,Agence_mtn_Cotonou,300000,299149,2022-01-24
CASH_IN,277352,Agence_mtn_Abomey,300000,22648,Pierre Reynaud,3320,280672,2022-01-25
CASH_IN,30453,Agence_mtn_Ouidah,300000,269547,Pierre Reynaud,280672,311125,2022-01-25
CASH_OUT,24780,Pierre Reynaud,311125,286345,Agence_mtn_Cotonou,300000,275220,2022-01-26
CASH_IN,67558,Agence_mtn_Abomey,300000,232442,Renée David,-1471298,-1403740,2022-01-03
CASH_IN,254008,Agence_mtn_Abomey,300000,45992,Renée David,-1403740,-1149732,2022-01-04
CASH_IN,2811,Agence_mtn_Abomey,300000,297189,Renée David,-1149732,-1146921,2022-01-04
CASH_IN,187112,Agence_mtn_Ouidah,300000,112888,Renée David,-1146921,-959809,2022-01-04
CASH_IN,278647,Agence_mtn_Ouidah,300000,21353,Renée David,-959809,-681162,2022-01-05
CASH_IN,148087,Agence_mtn_Abomey,300000,151913,Renée David,-681162,-533075,2022-01-05
CASH_IN,40214,Agence_mtn_Abomey,300000,259786,Renée David,-533075,-492861,2022-01-07
CASH_IN,113067,Agence_mtn_Cotonou,300000,186933,Renée David,-492861,-379794,2022-01-07
CASH_IN,57451,Agence_mtn_Cotonou,300000,242549,Renée David,-379794,-322343,2022-01-08
CASH_IN,1814,Agence_mtn_Ouidah,300000,298186,Renée David,-322343,-320529,2022-01-09
CASH_IN,25363,Agence_mtn_Ouidah,300000,274637,Renée David,-320529,-295166,2022-01-09
CASH_IN,188612,Agence_mtn_Abomey,300000,111388,Renée David,-295166,-106554,2022-01-12
CASH_IN,50661,Agence_mtn_Ouidah,300000,249339,Renée David,-106554,-55893,2022-01-12
CASH_IN,180870,Agence_mtn_Ouidah,300000,119130,Renée David,-55893,124977,2022-01-14
CASH_OUT,58920,Renée David,124977,66057,Agence_mtn_Cotonou,300000,241080,2022-01-14
CASH_IN,219103,Agence_mtn_Cotonou,300000,80897,Renée David,66057,285160,2022-01-15
TRANSFER,8301,Raymond Marchal de Nguyen,242441,234140,Renée David,285160,293461,2022-01-15
CASH_IN,161833,Agence_mtn_Ouidah,300000,138167,Renée David,293461,455294,2022-01-17
CASH_OUT,345114,Renée David,455294,110180,Agence_mtn_Cotonou,300000,-45114,2022-01-18
CASH_OUT,19289,Renée David,110180,90891,Agence_mtn_Ouidah,300000,280711,2022-01-18
CASH_OUT,16256,Renée David,90891,74635,Agence_mtn_Ouidah,300000,283744,2022-01-18
CASH_IN,40812,Agence_mtn_Cotonou,300000,259188,Renée David,74635,115447,2022-01-18
TRANSFER,111098,Renée David,115447,4349,Étienne Roche,20285,-90813,2022-01-18
CASH_OUT,616,Renée David,4349,3733,Agence_mtn_Ouidah,300000,299384,2022-01-19
CASH_IN,194216,Agence_mtn_Cotonou,300000,105784,Renée David,3733,197949,2022-01-19
CASH_OUT,73767,Renée David,197949,124182,Agence_mtn_Abomey,300000,226233,2022-01-21
CASH_OUT,16899,Renée David,124182,107283,Agence_mtn_Ouidah,300000,283101,2022-01-24
CASH_OUT,88961,Renée David,107283,18322,Agence_mtn_Cotonou,300000,211039,2022-01-24
CASH_IN,65266,Agence_mtn_Abomey,300000,234734,Renée David,18322,83588,2022-01-26
CASH_IN,72606,Agence_mtn_Abomey,300000,227394,Renée David,83588,156194,2022-01-27
CASH_IN,95721,Agence_mtn_Cotonou,300000,204279,Alexandrie Delmas,-654730,-559009,2022-01-01
CASH_IN,167988,Agence_mtn_Cotonou,300000,132012,Alexandrie Delmas,-559009,-391021,2022-01-02
CASH_IN,128484,Agence_mtn_Abomey,300000,171516,Alexandrie Delmas,-391021,-262537,2022-01-03
CASH_IN,67533,Agence_mtn_Abomey,300000,232467,Alexandrie Delmas,-262537,-195004,2022-01-06
CASH_IN,200441,Agence_mtn_Ouidah,300000,99559,Alexandrie Delmas,-195004,5437,2022-01-06
CASH_IN,192825,Agence_mtn_Cotonou,300000,107175,Alexandrie Delmas,5437,198262,2022-01-06
TRANSFER,11167,Alexandrie Delmas,198262,187095,Honoré du Laurent,874098,862931,2022-01-07
CASH_IN,175204,Agence_mtn_Cotonou,300000,124796,Alexandrie Delmas,187095,362299,2022-01-08
TRANSFER,88235,Alexandrie Delmas,362299,274064,Thierry Delattre-Simon,6002,-82233,2022-01-09
CASH_OUT,37058,Alexandrie Delmas,274064,237006,Agence_mtn_Ouidah,300000,262942,2022-01-10
CASH_IN,293985,Agence_mtn_Abomey,300000,6015,Alexandrie Delmas,237006,530991,2022-01-10
TRANSFER,762297,Honoré du Laurent,862931,100634,Alexandrie Delmas,530991,1293288,2022-01-11
CASH_OUT,891998,Alexandrie Delmas,1293288,401290,Agence_mtn_Abomey,300000,-591998,2022-01-11
CASH_IN,233089,Agence_mtn_Abomey,300000,66911,Alexandrie Delmas,401290,634379,2022-01-13
CASH_IN,285346,Agence_mtn_Ouidah,300000,14654,Alexandrie Delmas,634379,919725,2022-01-13
CASH_IN,154241,Agence_mtn_Abomey,300000,145759,Alexandrie Delmas,919725,1073966,2022-01-15
TRANSFER,23516,Zoé Renaud de Boutin,42649,19133,Alexandrie Delmas,1073966,1097482,2022-01-15
TRANSFER,571,Victoire-Nicole Lopez,1148,577,Alexandrie Delmas,1097482,1098053,2022-01-16
TRANSFER,92952,Alexandrie Delmas,1098053,1005101,Victoire-Nicole Lopez,577,-92375,2022-01-16
CASH_OUT,136621,Alexandrie Delmas,1005101,868480,Agence_mtn_Ouidah,300000,163379,2022-01-16
TRANSFER,22008,Benjamin Evrard-Marty,31200,9192,Alexandrie Delmas,868480,890488,2022-01-18
CASH_OUT,653315,Alexandrie Delmas,890488,237173,Agence_mtn_Abomey,300000,-353315,2022-01-18
CASH_OUT,93675,Alexandrie Delmas,237173,143498,Agence_mtn_Ouidah,300000,206325,2022-01-19
TRANSFER,11867,Alexandrie Delmas,143498,131631,Pierre Roger,272948,261081,2022-01-20
CASH_OUT,88643,Alexandrie Delmas,131631,42988,Agence_mtn_Ouidah,300000,211357,2022-01-22
CASH_OUT,14001,Alexandrie Delmas,42988,28987,Agence_mtn_Ouidah,300000,285999,2022-01-23
CASH_IN,181055,Agence_mtn_Ouidah,300000,118945,Alexandrie Delmas,28987,210042,2022-01-23
CASH_IN,299267,Agence_mtn_Ouidah,300000,733,Alexandrie Delmas,210042,509309,2022-01-24
CASH_OUT,471841,Alexandrie Delmas,509309,37468,Agence_mtn_Cotonou,300000,-171841,2022-01-27
CASH_IN,30592,Agence_mtn_Cotonou,300000,269408,Vincent Mathieu,-103578,-72986,2022-01-04
CASH_IN,269953,Agence_mtn_Abomey,300000,30047,Vincent Mathieu,-72986,196967,2022-01-04
CASH_IN,249482,Agence_mtn_Cotonou,300000,50518,Vincent Mathieu,196967,446449,2022-01-06
CASH_IN,34620,Agence_mtn_Ouidah,300000,265380,Vincent Mathieu,446449,481069,2022-01-07
TRANSFER,85554,Vincent Mathieu,481069,395515,Vincent Mathieu,481069,395515,2022-01-08
CASH_OUT,19915,Vincent Mathieu,395515,375600,Agence_mtn_Cotonou,300000,280085,2022-01-11
TRANSFER,5614,Benjamin Evrard-Marty,9192,3578,Vincent Mathieu,375600,381214,2022-01-15
CASH_IN,149381,Agence_mtn_Cotonou,300000,150619,Vincent Mathieu,381214,530595,2022-01-16
CASH_OUT,444593,Vincent Mathieu,530595,86002,Agence_mtn_Cotonou,300000,-144593,2022-01-19
TRANSFER,1912,Benjamin Evrard-Marty,3578,1666,Vincent Mathieu,86002,87914,2022-01-20
CASH_OUT,9413,Vincent Mathieu,87914,78501,Agence_mtn_Abomey,300000,290587,2022-01-22
CASH_OUT,36411,Vincent Mathieu,78501,42090,Agence_mtn_Ouidah,300000,263589,2022-01-22
CASH_IN,138775,Agence_mtn_Ouidah,300000,161225,Vincent Mathieu,42090,180865,2022-01-22
CASH_IN,112529,Agence_mtn_Cotonou,300000,187471,Vincent Mathieu,180865,293394,2022-01-23
CASH_IN,183726,Agence_mtn_Abomey,300000,116274,Vincent Mathieu,293394,477120,2022-01-25
TRANSFER,106759,Thibault Moreno,107660,901,Zoé Renaud de Boutin,19133,-87626,2022-01-06
CASH_IN,22541,Agence_mtn_Abomey,300000,277459,Thibault Moreno,901,23442,2022-01-08
CASH_OUT,19002,Thibault Moreno,23442,4440,Agence_mtn_Ouidah,300000,280998,2022-01-09
TRANSFER,2171,Thibault Moreno,4440,2269,Emmanuelle Georges,207862,205691,2022-01-11
CASH_OUT,531,Thibault Moreno,2269,1738,Agence_mtn_Cotonou,300000,299469,2022-01-12
CASH_OUT,788,Thibault Moreno,1738,950,Agence_mtn_Cotonou,300000,299212,2022-01-14
CASH_OUT,567,Thibault Moreno,950,383,Agence_mtn_Cotonou,300000,299433,2022-01-14
TRANSFER,266,Thibault Moreno,383,117,William Lebrun,359161,358895,2022-01-15
CASH_IN,13814,Agence_mtn_Abomey,300000,286186,Thibault Moreno,117,13931,2022-01-15
CASH_OUT,11445,Thibault Moreno,13931,2486,Agence_mtn_Ouidah,300000,288555,2022-01-16
CASH_OUT,1998,Thibault Moreno,2486,488,Agence_mtn_Abomey,300000,298002,2022-01-18
TRANSFER,459,Thibault Moreno,488,29,Marcelle Charrier,20581,20122,2022-01-25
CASH_IN,228715,Agence_mtn_Cotonou,300000,71285,Thibault Moreno,29,228744,2022-01-26
CASH_IN,150963,Agence_mtn_Ouidah,300000,149037,Sophie Gonzalez,-296907,-145944,2022-01-03
CASH_IN,79880,Agence_mtn_Abomey,300000,220120,Sophie Gonzalez,-145944,-66064,2022-01-06
CASH_IN,51391,Agence_mtn_Cotonou,300000,248609,Sophie Gonzalez,-66064,-14673,2022-01-06
CASH_IN,212982,Agence_mtn_Ouidah,300000,87018,Sophie Gonzalez,-14673,198309,2022-01-11
TRANSFER,240971,Nathalie Peron,324863,83892,Sophie Gonzalez,198309,439280,2022-01-12
TRANSFER,26471,Sophie Gonzalez,439280,412809,Théodore De Oliveira-Nicolas,35958,9487,2022-01-17
CASH_OUT,328094,Sophie Gonzalez,412809,84715,Agence_mtn_Ouidah,300000,-28094,2022-01-18
CASH_OUT,19368,Sophie Gonzalez,84715,65347,Agence_mtn_Cotonou,300000,280632,2022-01-18
TRANSFER,34916,Sophie Gonzalez,65347,30431,Raymond Rossi,514463,479547,2022-01-23
TRANSFER,94085,Emmanuelle Georges,205691,111606,Marcelle Charrier,20122,114207,2022-01-01
TRANSFER,52077,Marcelle Charrier,114207,62130,Alfred du Lesage,815868,763791,2022-01-02
CASH_IN,28446,Agence_mtn_Ouidah,300000,271554,Marcelle Charrier,62130,90576,2022-01-06
CASH_OUT,72026,Marcelle Charrier,90576,18550,Agence_mtn_Cotonou,300000,227974,2022-01-09
CASH_OUT,16921,Marcelle Charrier,18550,1629,Agence_mtn_Abomey,300000,283079,2022-01-09
CASH_OUT,364,Marcelle Charrier,1629,1265,Agence_mtn_Abomey,300000,299636,2022-01-09
TRANSFER,223,Marcelle Charrier,1265,1042,Honoré du Laurent,100634,100411,2022-01-13
CASH_IN,125753,Agence_mtn_Cotonou,300000,174247,Marcelle Charrier,1042,126795,2022-01-13
CASH_IN,137375,Agence_mtn_Abomey,300000,162625,Marcelle Charrier,126795,264170,2022-01-16
TRANSFER,201044,Marcelle Charrier,264170,63126,William Lebrun,358895,157851,2022-01-17
CASH_IN,159204,Agence_mtn_Ouidah,300000,140796,Marcelle Charrier,63126,222330,2022-01-18
CASH_OUT,46791,Marcelle Charrier,222330,175539,Agence_mtn_Ouidah,300000,253209,2022-01-18
CASH_IN,51214,Agence_mtn_Ouidah,300000,248786,Marcelle Charrier,175539,226753,2022-01-18
CASH_IN,222173,Agence_mtn_Cotonou,300000,77827,Marcelle Charrier,226753,448926,2022-01-19
TRANSFER,374637,Marcelle Charrier,448926,74289,Emmanuelle Georges,111606,-263031,2022-01-21
TRANSFER,539914,Isabelle Rossi,848588,308674,Marcelle Charrier,74289,614203,2022-01-21
CASH_OUT,277996,Marcelle Charrier,614203,336207,Agence_mtn_Ouidah,300000,22004,2022-01-23
TRANSFER,99111,Simone Pineau,127127,28016,Marcelle Charrier,336207,435318,2022-01-25
TRANSFER,408050,Marcelle Charrier,435318,27268,Gilbert-Charles Thibault,383994,-24056,2022-01-26
CASH_IN,177488,Agence_mtn_Ouidah,300000,122512,Marcelle Charrier,27268,204756,2022-01-27
TRANSFER,15807,Louis Pichon,276038,260231,Caroline-Lorraine Humbert,4620,20427,2022-01-04
TRANSFER,26011,William Lebrun,157851,131840,Caroline-Lorraine Humbert,20427,46438,2022-01-04
TRANSFER,1603,Caroline-Lorraine Humbert,46438,44835,Valentine Martinez,772534,770931,2022-01-07
CASH_OUT,2833,Caroline-Lorraine Humbert,44835,42002,Agence_mtn_Ouidah,300000,297167,2022-01-08
TRANSFER,2191,Caroline-Lorraine Humbert,42002,39811,Alphonse Le Olivier,7958,5767,2022-01-08
CASH_IN,180407,Agence_mtn_Ouidah,300000,119593,Caroline-Lorraine Humbert,39811,220218,2022-01-09
CASH_OUT,65641,Caroline-Lorraine Humbert,220218,154577,Agence_mtn_Ouidah,300000,234359,2022-01-10
CASH_OUT,28807,Caroline-Lorraine Humbert,154577,125770,Agence_mtn_Ouidah,300000,271193,2022-01-13
CASH_OUT,81153,Caroline-Lorraine Humbert,125770,44617,Agence_mtn_Cotonou,300000,218847,2022-01-22
CASH_IN,226574,Agence_mtn_Abomey,300000,73426,Cécile Germain,-26620,199954,2022-01-08
CASH_IN,222838,Agence_mtn_Cotonou,300000,77162,Cécile Germain,199954,422792,2022-01-09
TRANSFER,4830,Alphonse Le Olivier,5767,937,Cécile Germain,422792,427622,2022-01-11
TRANSFER,121862,Cécile Clerc,536576,414714,Cécile Germain,427622,549484,2022-01-17
CASH_OUT,76012,Cécile Germain,549484,473472,Agence_mtn_Abomey,300000,223988,2022-01-18
CASH_OUT,127890,Cécile Germain,473472,345582,Agence_mtn_Abomey,300000,172110,2022-01-20
CASH_IN,7323,Agence_mtn_Abomey,300000,292677,Cécile Germain,345582,352905,2022-01-21
TRANSFER,37418,William Lebrun,131840,94422,Cécile Germain,352905,390323,2022-01-26
TRANSFER,261393,Cécile Germain,390323,128930,Cécile Clerc,414714,153321,2022-01-27
CASH_IN,281743,Agence_mtn_Cotonou,300000,18257,Jeanne Garnier,61686,343429,2022-01-05
CASH_IN,90466,Agence_mtn_Ouidah,300000,209534,Jeanne Garnier,343429,433895,2022-01-06
CASH_IN,177660,Agence_mtn_Cotonou,300000,122340,Jeanne Garnier,433895,611555,2022-01-06
TRANSFER,69987,Isabelle Rossi,308674,238687,Jeanne Garnier,611555,681542,2022-01-07
TRANSFER,596454,Jeanne Garnier,681542,85088,Raymond Marchal de Nguyen,234140,-362314,2022-01-08
CASH_IN,9105,Agence_mtn_Cotonou,300000,290895,Jeanne Garnier,85088,94193,2022-01-09
CASH_OUT,54672,Jeanne Garnier,94193,39521,Agence_mtn_Abomey,300000,245328,2022-01-10
CASH_OUT,2385,Jeanne Garnier,39521,37136,Agence_mtn_Ouidah,300000,297615,2022-01-11
TRANSFER,342256,Tristan Thomas,514026,171770,Jeanne Garnier,37136,379392,2022-01-11
CASH_IN,251262,Agence_mtn_Cotonou,300000,48738,Jeanne Garnier,379392,630654,2022-01-11
CASH_IN,74832,Agence_mtn_Cotonou,300000,225168,Jeanne Garnier,630654,705486,2022-01-13
TRANSFER,132684,Tristan Thomas,171770,39086,Jeanne Garnier,705486,838170,2022-01-14
CASH_IN,61846,Agence_mtn_Abomey,300000,238154,Jeanne Garnier,838170,900016,2022-01-16
CASH_OUT,242608,Jeanne Garnier,900016,657408,Agence_mtn_Abomey,300000,57392,2022-01-19
CASH_OUT,8054,Jeanne Garnier,657408,649354,Agence_mtn_Ouidah,300000,291946,2022-01-21
CASH_IN,186393,Agence_mtn_Abomey,300000,113607,Jeanne Garnier,649354,835747,2022-01-21
CASH_OUT,629066,Jeanne Garnier,835747,206681,Agence_mtn_Cotonou,300000,-329066,2022-01-22
CASH_OUT,42237,Jeanne Garnier,206681,164444,Agence_mtn_Cotonou,300000,257763,2022-01-26
CASH_OUT,23687,Jeanne Garnier,164444,140757,Agence_mtn_Ouidah,300000,276313,2022-01-26
CASH_OUT,11091,Jeanne Garnier,140757,129666,Agence_mtn_Cotonou,300000,288909,2022-01-27
CASH_IN,234042,Agence_mtn_Cotonou,300000,65958,Claude Foucher,-114666,119376,2022-01-01
TRANSFER,189121,Geneviève De Oliveira-Michel,789316,600195,Claude Foucher,119376,308497,2022-01-01
CASH_OUT,281735,Claude Foucher,308497,26762,Agence_mtn_Cotonou,300000,18265,2022-01-01
CASH_OUT,8519,Claude Foucher,26762,18243,Agence_mtn_Abomey,300000,291481,2022-01-02
TRANSFER,15016,Claude Foucher,18243,3227,Geneviève De Oliveira-Michel,600195,585179,2022-01-07
TRANSFER,836,Claude Foucher,3227,2391,Claude Foucher,3227,4063,2022-01-07
CASH_IN,60845,Agence_mtn_Abomey,300000,239155,Claude Foucher,2391,63236,2022-01-09
CASH_OUT,28424,Claude Foucher,63236,34812,Agence_mtn_Cotonou,300000,271576,2022-01-12
CASH_OUT,31598,Claude Foucher,34812,3214,Agence_mtn_Abomey,300000,268402,2022-01-13
CASH_OUT,1965,Claude Foucher,3214,1249,Agence_mtn_Abomey,300000,298035,2022-01-13
CASH_OUT,319,Claude Foucher,1249,930,Agence_mtn_Abomey,300000,299681,2022-01-16
CASH_OUT,151,Claude Foucher,930,779,Agence_mtn_Cotonou,300000,299849,2022-01-16
TRANSFER,17112,Nathalie Peron,83892,66780,Claude Foucher,779,17891,2022-01-17
CASH_IN,277612,Agence_mtn_Abomey,300000,22388,Claude Foucher,17891,295503,2022-01-18
CASH_IN,104951,Agence_mtn_Abomey,300000,195049,Claude Foucher,295503,400454,2022-01-22
CASH_IN,111626,Agence_mtn_Ouidah,300000,188374,Claude Foucher,400454,512080,2022-01-22
CASH_OUT,109312,Claude Foucher,512080,402768,Agence_mtn_Abomey,300000,190688,2022-01-23
TRANSFER,10443,Tristan Thomas,39086,28643,Claude Foucher,402768,413211,2022-01-24
CASH_IN,41464,Agence_mtn_Ouidah,300000,258536,Théodore De Oliveira-Nicolas,9487,50951,2022-01-06
CASH_OUT,29254,Théodore De Oliveira-Nicolas,50951,21697,Agence_mtn_Cotonou,300000,270746,2022-01-07
TRANSFER,8260,Théodore De Oliveira-Nicolas,21697,13437,Alphonse Le Olivier,937,-7323,2022-01-08
TRANSFER,58236,Michelle Lebon,69082,10846,Théodore De Oliveira-Nicolas,13437,71673,2022-01-11
CASH_OUT,17666,Théodore De Oliveira-Nicolas,71673,54007,Agence_mtn_Abomey,300000,282334,2022-01-12
CASH_IN,141201,Agence_mtn_Cotonou,300000,158799,Théodore De Oliveira-Nicolas,54007,195208,2022-01-13
CASH_OUT,6088,Théodore De Oliveira-Nicolas,195208,189120,Agence_mtn_Abomey,300000,293912,2022-01-13
TRANSFER,117100,Louis Pichon,260231,143131,Théodore De Oliveira-Nicolas,189120,306220,2022-01-15
CASH_IN,30550,Agence_mtn_Cotonou,300000,269450,Théodore De Oliveira-Nicolas,306220,336770,2022-01-19
CASH_OUT,321158,Théodore De Oliveira-Nicolas,336770,15612,Agence_mtn_Cotonou,300000,-21158,2022-01-24
CASH_OUT,1495,Théodore De Oliveira-Nicolas,15612,14117,Agence_mtn_Cotonou,300000,298505,2022-01-27
CASH_OUT,4305,Céline Gomez,235625,231320,Agence_mtn_Ouidah,300000,295695,2022-01-03
CASH_IN,111927,Agence_mtn_Abomey,300000,188073,Céline Gomez,231320,343247,2022-01-06
TRANSFER,111233,Isabelle Rossi,238687,127454,Céline Gomez,343247,454480,2022-01-09
CASH_IN,97261,Agence_mtn_Cotonou,300000,202739,Céline Gomez,454480,551741,2022-01-09
TRANSFER,69605,Honoré du Laurent,100411,30806,Céline Gomez,551741,621346,2022-01-10
TRANSFER,4694,Michelle Lebon,10846,6152,Céline Gomez,621346,626040,2022-01-10
CASH_OUT,124735,Céline Gomez,626040,501305,Agence_mtn_Cotonou,300000,175265,2022-01-10
CASH_OUT,114225,Céline Gomez,501305,387080,Agence_mtn_Abomey,300000,185775,2022-01-12
CASH_OUT,34255,Céline Gomez,387080,352825,Agence_mtn_Abomey,300000,265745,2022-01-21
CASH_OUT,166768,Céline Gomez,352825,186057,Agence_mtn_Cotonou,300000,133232,2022-01-21
CASH_IN,160551,Agence_mtn_Cotonou,300000,139449,Céline Gomez,186057,346608,2022-01-22
CASH_IN,280691,Agence_mtn_Ouidah,300000,19309,Céline Gomez,346608,627299,2022-01-22
TRANSFER,16249,Simone Pineau,28016,11767,Céline Gomez,627299,643548,2022-01-25
CASH_OUT,244955,Céline Gomez,643548,398593,Agence_mtn_Abomey,300000,55045,2022-01-26
CASH_OUT,315276,Céline Gomez,398593,83317,Agence_mtn_Ouidah,300000,-15276,2022-01-27
CASH_IN,29086,Agence_mtn_Cotonou,300000,270914,Philippine Courtois,-131038,-101952,2022-01-02
CASH_IN,26992,Agence_mtn_Ouidah,300000,273008,Philippine Courtois,-101952,-74960,2022-01-05
CASH_IN,118631,Agence_mtn_Abomey,300000,181369,Philippine Courtois,-74960,43671,2022-01-07
CASH_IN,204228,Agence_mtn_Cotonou,300000,95772,Philippine Courtois,43671,247899,2022-01-08
CASH_IN,47350,Agence_mtn_Abomey,300000,252650,Philippine Courtois,247899,295249,2022-01-14
CASH_OUT,11969,Philippine Courtois,295249,283280,Agence_mtn_Ouidah,300000,288031,2022-01-15
TRANSFER,267896,Philippine Courtois,283280,15384,Sébastien Vallée,379108,111212,2022-01-17
TRANSFER,9062,Philippine Courtois,15384,6322,Geneviève De Oliveira-Michel,585179,576117,2022-01-20
TRANSFER,5987,Philippine Courtois,6322,335,Raymond Rossi,479547,473560,2022-01-20
CASH_OUT,248,Philippine Courtois,335,87,Agence_mtn_Cotonou,300000,299752,2022-01-21
CASH_IN,200238,Agence_mtn_Abomey,300000,99762,Philippine Courtois,87,200325,2022-01-21
TRANSFER,34927,Philippine Courtois,200325,165398,Raymond Rossi,473560,438633,2022-01-21
CASH_OUT,145166,Philippine Courtois,165398,20232,Agence_mtn_Abomey,300000,154834,2022-01-22
CASH_OUT,18357,Philippine Courtois,20232,1875,Agence_mtn_Cotonou,300000,281643,2022-01-25
CASH_OUT,591,Honoré du Laurent,30806,30215,Agence_mtn_Ouidah,300000,299409,2022-01-04
CASH_IN,233504,Agence_mtn_Abomey,300000,66496,Honoré du Laurent,30215,263719,2022-01-05
TRANSFER,125430,Honoré du Laurent,263719,138289,Raymond Rossi,438633,313203,2022-01-05
CASH_OUT,89635,Honoré du Laurent,138289,48654,Agence_mtn_Abomey,300000,210365,2022-01-07
TRANSFER,5239,Michelle Lebon,6152,913,Honoré du Laurent,48654,53893,2022-01-12
CASH_IN,296197,Agence_mtn_Abomey,300000,3803,Honoré du Laurent,53893,350090,2022-01-13
CASH_OUT,146525,Honoré du Laurent,350090,203565,Agence_mtn_Cotonou,300000,153475,2022-01-13
CASH_OUT,138898,Honoré du Laurent,203565,64667,Agence_mtn_Ouidah,300000,161102,2022-01-14
TRANSFER,20185,Tristan Thomas,28643,8458,Honoré du Laurent,64667,84852,2022-01-18
CASH_OUT,22122,Honoré du Laurent,84852,62730,Agence_mtn_Ouidah,300000,277878,2022-01-20
CASH_OUT,31175,Honoré du Laurent,62730,31555,Agence_mtn_Cotonou,300000,268825,2022-01-22
CASH_IN,37778,Agence_mtn_Ouidah,300000,262222,Honoré du Laurent,31555,69333,2022-01-23
TRANSFER,5928,Simone Pineau,11767,5839,Bertrand Charles,1531213,1525285,2022-01-05
TRANSFER,4529,Simone Pineau,5839,1310,Michelle Lebon,913,-3616,2022-01-08
CASH_IN,99531,Agence_mtn_Ouidah,300000,200469,Simone Pineau,1310,100841,2022-01-11
CASH_OUT,1143,Simone Pineau,100841,99698,Agence_mtn_Ouidah,300000,298857,2022-01-12
TRANSFER,106987,Isabelle Rossi,127454,20467,Simone Pineau,99698,206685,2022-01-12
TRANSFER,264886,Valentine Martinez,770931,506045,Simone Pineau,206685,471571,2022-01-18
TRANSFER,128526,Marine Chauvet-Potier,151786,23260,Simone Pineau,471571,600097,2022-01-24
CASH_IN,200804,Agence_mtn_Ouidah,300000,99196,Vincent Fournier,-436296,-235492,2022-01-01
CASH_IN,260843,Agence_mtn_Cotonou,300000,39157,Vincent Fournier,-235492,25351,2022-01-02
TRANSFER,1687,Vincent Fournier,25351,23664,Cécile Clerc,153321,151634,2022-01-03
CASH_IN,159947,Agence_mtn_Cotonou,300000,140053,Vincent Fournier,23664,183611,2022-01-10
CASH_IN,60128,Agence_mtn_Cotonou,300000,239872,Vincent Fournier,183611,243739,2022-01-17
TRANSFER,63438,Pierre Roger,261081,197643,Vincent Fournier,243739,307177,2022-01-17
CASH_OUT,82053,Vincent Fournier,307177,225124,Agence_mtn_Cotonou,300000,217947,2022-01-21
TRANSFER,28685,Nathalie Peron,66780,38095,Marine Chauvet-Potier,23260,-5425,2022-01-01
TRANSFER,626,Benjamin Evrard-Marty,1666,1040,Nathalie Peron,38095,38721,2022-01-03
TRANSFER,33086,Nathalie Peron,38721,5635,Louis Pichon,143131,110045,2022-01-05
TRANSFER,4002,Nathalie Peron,5635,1633,Thibaut Coulon,590229,586227,2022-01-15
TRANSFER,653,Raymond Rossi,313203,312550,Nathalie Peron,1633,2286,2022-01-16
CASH_IN,117108,Agence_mtn_Ouidah,300000,182892,Nathalie Peron,2286,119394,2022-01-16
CASH_IN,188093,Agence_mtn_Abomey,300000,111907,Nathalie Peron,119394,307487,2022-01-17
CASH_IN,121335,Agence_mtn_Ouidah,300000,178665,Nathalie Peron,307487,428822,2022-01-21
TRANSFER,76371,Nathalie Peron,428822,352451,Bertrand Charles,1525285,1448914,2022-01-22
CASH_IN,200574,Agence_mtn_Ouidah,300000,99426,Nathalie Peron,352451,553025,2022-01-23
CASH_OUT,266814,Nathalie Peron,553025,286211,Agence_mtn_Cotonou,300000,33186,2022-01-24
CASH_IN,216748,Agence_mtn_Ouidah,300000,83252,Étienne Roche,-90813,125935,2022-01-01
TRANSFER,4341,Isabelle Rossi,20467,16126,Étienne Roche,125935,130276,2022-01-04
CASH_OUT,90793,Étienne Roche,130276,39483,Agence_mtn_Ouidah,300000,209207,2022-01-06
TRANSFER,21815,Étienne Roche,39483,17668,Geneviève De Oliveira-Michel,576117,554302,2022-01-10
TRANSFER,93841,Valentine Martinez,506045,412204,Étienne Roche,17668,111509,2022-01-12
CASH_OUT,10649,Étienne Roche,111509,100860,Agence_mtn_Cotonou,300000,289351,2022-01-15
CASH_IN,70096,Agence_mtn_Abomey,300000,229904,Étienne Roche,100860,170956,2022-01-15
TRANSFER,68694,Étienne Roche,170956,102262,Thibaut Coulon,586227,517533,2022-01-16
TRANSFER,309689,Thibaut Coulon,517533,207844,Étienne Roche,102262,411951,2022-01-16
CASH_OUT,403918,Étienne Roche,411951,8033,Agence_mtn_Cotonou,300000,-103918,2022-01-21
CASH_IN,143137,Agence_mtn_Ouidah,300000,156863,Étienne Roche,8033,151170,2022-01-26
TRANSFER,124808,Alfred du Lesage,763791,638983,Étienne Roche,151170,275978,2022-01-26
CASH_IN,36446,Agence_mtn_Abomey,300000,263554,Sébastien Lemaître,-53972,-17526,2022-01-07
CASH_IN,191491,Agence_mtn_Ouidah,300000,108509,Sébastien Lemaître,-17526,173965,2022-01-11
TRANSFER,517965,Geneviève De Oliveira-Michel,554302,36337,Sébastien Lemaître,173965,691930,2022-01-13
TRANSFER,869636,Bertrand Charles,1448914,579278,Sébastien Lemaître,691930,1561566,2022-01-14
CASH_IN,201070,Agence_mtn_Abomey,300000,98930,Sébastien Lemaître,1561566,1762636,2022-01-20
CASH_OUT,494046,Sébastien Lemaître,1762636,1268590,Agence_mtn_Ouidah,300000,-194046,2022-01-20
TRANSFER,12963,Geneviève De Oliveira-Michel,36337,23374,Sébastien Lemaître,1268590,1281553,2022-01-21
CASH_IN,282121,Agence_mtn_Abomey,300000,17879,Sébastien Lemaître,1281553,1563674,2022-01-22
TRANSFER,133686,Thibaut Coulon,207844,74158,Sébastien Lemaître,1563674,1697360,2022-01-22
CASH_OUT,1415866,Sébastien Lemaître,1697360,281494,Agence_mtn_Cotonou,300000,-1115866,2022-01-24
CASH_IN,256703,Agence_mtn_Ouidah,300000,43297,Sébastien Lemaître,281494,538197,2022-01-25
TRANSFER,76344,Raymond Rossi,312550,236206,Sébastien Lemaître,538197,614541,2022-01-27
CASH_OUT,222623,Sébastien Lemaître,614541,391918,Agence_mtn_Cotonou,300000,77377,2022-01-27
CASH_IN,66946,Agence_mtn_Cotonou,300000,233054,Sébastien Vallée,111212,178158,2022-01-03
TRANSFER,38528,Sébastien Vallée,178158,139630,Sébastien Vallée,178158,139630,2022-01-03
CASH_IN,206091,Agence_mtn_Cotonou,300000,93909,Sébastien Vallée,139630,345721,2022-01-03
CASH_OUT,228368,Sébastien Vallée,345721,117353,Agence_mtn_Ouidah,300000,71632,2022-01-06
CASH_IN,191074,Agence_mtn_Abomey,300000,108926,Sébastien Vallée,117353,308427,2022-01-07
TRANSFER,218193,Sébastien Vallée,308427,90234,Sébastien Vallée,308427,526620,2022-01-07
CASH_IN,68390,Agence_mtn_Cotonou,300000,231610,Sébastien Vallée,90234,158624,2022-01-08
TRANSFER,85040,William Lebrun,94422,9382,Sébastien Vallée,158624,243664,2022-01-08
CASH_IN,161618,Agence_mtn_Ouidah,300000,138382,Sébastien Vallée,243664,405282,2022-01-09
CASH_OUT,144586,Sébastien Vallée,405282,260696,Agence_mtn_Abomey,300000,155414,2022-01-12
CASH_OUT,59103,Sébastien Vallée,260696,201593,Agence_mtn_Cotonou,300000,240897,2022-01-12
CASH_IN,29402,Agence_mtn_Cotonou,300000,270598,Sébastien Vallée,201593,230995,2022-01-12
CASH_OUT,213988,Sébastien Vallée,230995,17007,Agence_mtn_Ouidah,300000,86012,2022-01-14
TRANSFER,87369,Raymond Rossi,236206,148837,Sébastien Vallée,17007,104376,2022-01-15
CASH_OUT,78193,Sébastien Vallée,104376,26183,Agence_mtn_Ouidah,300000,221807,2022-01-17
CASH_OUT,7783,Sébastien Vallée,26183,18400,Agence_mtn_Ouidah,300000,292217,2022-01-17
CASH_IN,80166,Agence_mtn_Abomey,300000,219834,Sébastien Vallée,18400,98566,2022-01-18
CASH_IN,94869,Agence_mtn_Ouidah,300000,205131,Sébastien Vallée,98566,193435,2022-01-24
TRANSFER,62546,Pierre Roger,197643,135097,Sébastien Vallée,193435,255981,2022-01-26
CASH_OUT,46000,Sébastien Vallée,255981,209981,Agence_mtn_Ouidah,300000,254000,2022-01-27
TRANSFER,7796,William Lebrun,9382,1586,Isabelle Rossi,16126,23922,2022-01-04
CASH_OUT,11076,Isabelle Rossi,23922,12846,Agence_mtn_Cotonou,300000,288924,2022-01-04
CASH_OUT,672,Isabelle Rossi,12846,12174,Agence_mtn_Ouidah,300000,299328,2022-01-05
CASH_OUT,2482,Isabelle Rossi,12174,9692,Agence_mtn_Cotonou,300000,297518,2022-01-05
TRANSFER,3391,Isabelle Rossi,9692,6301,Bertrand Charles,579278,575887,2022-01-06
TRANSFER,188955,Nath Bruneau,194674,5719,Isabelle Rossi,6301,195256,2022-01-06
CASH_OUT,24930,Isabelle Rossi,195256,170326,Agence_mtn_Abomey,300000,275070,2022-01-10
CASH_OUT,90171,Isabelle Rossi,170326,80155,Agence_mtn_Cotonou,300000,209829,2022-01-11
TRANSFER,52153,Isabelle Rossi,80155,28002,Louis Pichon,110045,57892,2022-01-15
TRANSFER,20262,Raymond Rossi,148837,128575,Isabelle Rossi,28002,48264,2022-01-16
CASH_IN,235934,Agence_mtn_Abomey,300000,64066,Isabelle Rossi,48264,284198,2022-01-17
TRANSFER,82599,Isabelle Rossi,284198,201599,Cécile Clerc,151634,69035,2022-01-19
CASH_IN,183299,Agence_mtn_Abomey,300000,116701,Isabelle Rossi,201599,384898,2022-01-22
CASH_OUT,62201,Isabelle Rossi,384898,322697,Agence_mtn_Ouidah,300000,237799,2022-01-22
CASH_OUT,22235,Isabelle Rossi,322697,300462,Agence_mtn_Abomey,300000,277765,2022-01-22
TRANSFER,221203,Isabelle Rossi,300462,79259,William Lebrun,1586,-219617,2022-01-23
TRANSFER,22693,Louis Pichon,57892,35199,Isabelle Rossi,79259,101952,2022-01-25
CASH_IN,185198,Agence_mtn_Ouidah,300000,114802,Zoé Renaud de Boutin,-87626,97572,2022-01-02
CASH_IN,129538,Agence_mtn_Cotonou,300000,170462,Zoé Renaud de Boutin,97572,227110,2022-01-02
TRANSFER,167258,Zoé Renaud de Boutin,227110,59852,Benjamin Evrard-Marty,1040,-166218,2022-01-03
CASH_OUT,14533,Zoé Renaud de Boutin,59852,45319,Agence_mtn_Cotonou,300000,285467,2022-01-03
CASH_IN,270373,Agence_mtn_Ouidah,300000,29627,Zoé Renaud de Boutin,45319,315692,2022-01-04
TRANSFER,9990,Louis Pichon,35199,25209,Zoé Renaud de Boutin,315692,325682,2022-01-09
CASH_IN,73002,Agence_mtn_Ouidah,300000,226998,Zoé Renaud de Boutin,325682,398684,2022-01-09
TRANSFER,316,Alfred du Lesage,638983,638667,Zoé Renaud de Boutin,398684,399000,2022-01-09
TRANSFER,130142,Zoé Renaud de Boutin,399000,268858,Thibaut Coulon,74158,-55984,2022-01-09
CASH_OUT,201803,Zoé Renaud de Boutin,268858,67055,Agence_mtn_Ouidah,300000,98197,2022-01-11
CASH_OUT,43614,Zoé Renaud de Boutin,67055,23441,Agence_mtn_Abomey,300000,256386,2022-01-12
CASH_IN,30612,Agence_mtn_Cotonou,300000,269388,Zoé Renaud de Boutin,23441,54053,2022-01-12
CASH_OUT,15731,Zoé Renaud de Boutin,54053,38322,Agence_mtn_Cotonou,300000,284269,2022-01-15
CASH_IN,192938,Agence_mtn_Cotonou,300000,107062,Zoé Renaud de Boutin,38322,231260,2022-01-17
CASH_OUT,137371,Zoé Renaud de Boutin,231260,93889,Agence_mtn_Cotonou,300000,162629,2022-01-21
CASH_IN,65043,Agence_mtn_Cotonou,300000,234957,Zoé Renaud de Boutin,93889,158932,2022-01-25
TRANSFER,112119,Zoé Renaud de Boutin,158932,46813,Cécile Clerc,69035,-43084,2022-01-27
CASH_IN,53873,Agence_mtn_Cotonou,300000,246127,Michelle Lebon,-3616,50257,2022-01-01
CASH_IN,125248,Agence_mtn_Ouidah,300000,174752,Michelle Lebon,50257,175505,2022-01-07
TRANSFER,131002,Michelle Lebon,175505,44503,Geneviève De Oliveira-Michel,23374,-107628,2022-01-08
CASH_OUT,38716,Michelle Lebon,44503,5787,Agence_mtn_Abomey,300000,261284,2022-01-10
CASH_OUT,5375,Michelle Lebon,5787,412,Agence_mtn_Abomey,300000,294625,2022-01-14
CASH_OUT,328,Michelle Lebon,412,84,Agence_mtn_Abomey,300000,299672,2022-01-16
CASH_IN,297607,Agence_mtn_Ouidah,300000,2393,Michelle Lebon,84,297691,2022-01-24
CASH_OUT,68211,Michelle Lebon,297691,229480,Agence_mtn_Abomey,300000,231789,2022-01-27
CASH_IN,254631,Agence_mtn_Abomey,300000,45369,Michelle Lebon,229480,484111,2022-01-27
CASH_IN,256511,Agence_mtn_Abomey,300000,43489,Richard Le Descamps,-811714,-555203,2022-01-07
CASH_IN,2176,Agence_mtn_Abomey,300000,297824,Richard Le Descamps,-555203,-553027,2022-01-07
CASH_IN,261302,Agence_mtn_Cotonou,300000,38698,Richard Le Descamps,-553027,-291725,2022-01-07
CASH_IN,81519,Agence_mtn_Ouidah,300000,218481,Richard Le Descamps,-291725,-210206,2022-01-07
CASH_IN,72134,Agence_mtn_Abomey,300000,227866,Richard Le Descamps,-210206,-138072,2022-01-10
CASH_IN,31061,Agence_mtn_Ouidah,300000,268939,Richard Le Descamps,-138072,-107011,2022-01-11
CASH_IN,46888,Agence_mtn_Cotonou,300000,253112,Richard Le Descamps,-107011,-60123,2022-01-14
CASH_IN,252168,Agence_mtn_Ouidah,300000,47832,Richard Le Descamps,-60123,192045,2022-01-17
CASH_IN,181710,Agence_mtn_Cotonou,300000,118290,Richard Le Descamps,192045,373755,2022-01-19
CASH_IN,109469,Agence_mtn_Ouidah,300000,190531,Richard Le Descamps,373755,483224,2022-01-21
TRANSFER,145004,Richard Le Descamps,483224,338220,Richard Le Descamps,483224,338220,2022-01-22
CASH_IN,240294,Agence_mtn_Abomey,300000,59706,Richard Le Descamps,338220,578514,2022-01-23
CASH_OUT,322191,Richard Le Descamps,578514,256323,Agence_mtn_Ouidah,300000,-22191,2022-01-23
CASH_IN,206925,Agence_mtn_Abomey,300000,93075,Benjamin Evrard-Marty,-166218,40707,2022-01-02
CASH_IN,50208,Agence_mtn_Cotonou,300000,249792,Benjamin Evrard-Marty,40707,90915,2022-01-02
CASH_OUT,29105,Benjamin Evrard-Marty,90915,61810,Agence_mtn_Ouidah,300000,270895,2022-01-05
CASH_IN,268639,Agence_mtn_Abomey,300000,31361,Benjamin Evrard-Marty,61810,330449,2022-01-07
CASH_IN,67523,Agence_mtn_Abomey,300000,232477,Benjamin Evrard-Marty,330449,397972,2022-01-09
CASH_OUT,78118,Benjamin Evrard-Marty,397972,319854,Agence_mtn_Cotonou,300000,221882,2022-01-14
CASH_IN,69963,Agence_mtn_Cotonou,300000,230037,Benjamin Evrard-Marty,319854,389817,2022-01-15
TRANSFER,154963,Benjamin Evrard-Marty,389817,234854,Valentine Martinez,412204,257241,2022-01-15
CASH_OUT,126277,Benjamin Evrard-Marty,234854,108577,Agence_mtn_Cotonou,300000,173723,2022-01-16
CASH_IN,250768,Agence_mtn_Abomey,300000,49232,Benjamin Evrard-Marty,108577,359345,2022-01-16
CASH_IN,39689,Agence_mtn_Cotonou,300000,260311,Benjamin Evrard-Marty,359345,399034,2022-01-17
CASH_OUT,392471,Benjamin Evrard-Marty,399034,6563,Agence_mtn_Cotonou,300000,-92471,2022-01-21
CASH_IN,296071,Agence_mtn_Ouidah,300000,3929,Benjamin Evrard-Marty,6563,302634,2022-01-24
CASH_OUT,267837,Benjamin Evrard-Marty,302634,34797,Agence_mtn_Cotonou,300000,32163,2022-01-27
CASH_OUT,801,Nath Bruneau,5719,4918,Agence_mtn_Abomey,300000,299199,2022-01-02
CASH_OUT,4769,Nath Bruneau,4918,149,Agence_mtn_Cotonou,300000,295231,2022-01-03
TRANSFER,129,Nath Bruneau,149,20,Nath Bruneau,149,20,2022-01-10
CASH_IN,175221,Agence_mtn_Abomey,300000,124779,Nath Bruneau,20,175241,2022-01-10
CASH_IN,118577,Agence_mtn_Cotonou,300000,181423,Nath Bruneau,175241,293818,2022-01-10
CASH_OUT,54278,Nath Bruneau,293818,239540,Agence_mtn_Abomey,300000,245722,2022-01-11
CASH_IN,1845,Agence_mtn_Abomey,300000,298155,Nath Bruneau,239540,241385,2022-01-14
CASH_OUT,126606,Nath Bruneau,241385,114779,Agence_mtn_Cotonou,300000,173394,2022-01-15
TRANSFER,48015,Nath Bruneau,114779,66764,Bertrand Charles,575887,527872,2022-01-16
TRANSFER,42163,Nath Bruneau,66764,24601,Pierre Roger,135097,92934,2022-01-16
TRANSFER,4337,Nath Bruneau,24601,20264,Bertrand Charles,527872,523535,2022-01-18
CASH_IN,90715,Agence_mtn_Cotonou,300000,209285,Nath Bruneau,20264,110979,2022-01-21
CASH_OUT,75240,Nath Bruneau,110979,35739,Agence_mtn_Ouidah,300000,224760,2022-01-22
TRANSFER,243522,Valentine Martinez,257241,13719,Nath Bruneau,35739,279261,2022-01-22
CASH_OUT,147935,Nath Bruneau,279261,131326,Agence_mtn_Ouidah,300000,152065,2022-01-23
CASH_OUT,51352,Nath Bruneau,131326,79974,Agence_mtn_Cotonou,300000,248648,2022-01-23
CASH_IN,160199,Agence_mtn_Abomey,300000,139801,Nath Bruneau,79974,240173,2022-01-25
CASH_IN,186333,Agence_mtn_Abomey,300000,113667,Nath Bruneau,240173,426506,2022-01-25
CASH_OUT,337735,Nath Bruneau,426506,88771,Agence_mtn_Ouidah,300000,-37735,2022-01-27
CASH_OUT,13782,Nath Bruneau,88771,74989,Agence_mtn_Abomey,300000,286218,2022-01-27
CASH_IN,114037,Agence_mtn_Cotonou,300000,185963,Rémy de la Roux,-42405,71632,2022-01-04
CASH_OUT,15700,Rémy de la Roux,71632,55932,Agence_mtn_Cotonou,300000,284300,2022-01-07
TRANSFER,6651,Valentine Martinez,13719,7068,Rémy de la Roux,55932,62583,2022-01-08
TRANSFER,2599,Louis Pichon,25209,22610,Rémy de la Roux,62583,65182,2022-01-08
CASH_IN,225853,Agence_mtn_Cotonou,300000,74147,Rémy de la Roux,65182,291035,2022-01-10
TRANSFER,614982,Alfred du Lesage,638667,23685,Rémy de la Roux,291035,906017,2022-01-11
CASH_IN,248422,Agence_mtn_Cotonou,300000,51578,Rémy de la Roux,906017,1154439,2022-01-16
CASH_OUT,803413,Rémy de la Roux,1154439,351026,Agence_mtn_Abomey,300000,-503413,2022-01-18
TRANSFER,3665,Alfred du Lesage,23685,20020,Rémy de la Roux,351026,354691,2022-01-24
CASH_OUT,292506,Rémy de la Roux,354691,62185,Agence_mtn_Abomey,300000,7494,2022-01-25
CASH_OUT,23380,Rémy de la Roux,62185,38805,Agence_mtn_Abomey,300000,276620,2022-01-26
CASH_IN,161110,Agence_mtn_Cotonou,300000,138890,Laure Philippe,70,161180,2022-01-01
CASH_IN,102196,Agence_mtn_Ouidah,300000,197804,Laure Philippe,161180,263376,2022-01-01
CASH_IN,118762,Agence_mtn_Ouidah,300000,181238,Laure Philippe,263376,382138,2022-01-01
CASH_OUT,147011,Laure Philippe,382138,235127,Agence_mtn_Cotonou,300000,152989,2022-01-02
CASH_IN,193056,Agence_mtn_Ouidah,300000,106944,Laure Philippe,235127,428183,2022-01-03
TRANSFER,102784,Laure Philippe,428183,325399,Pierre Roger,92934,-9850,2022-01-03
CASH_IN,211769,Agence_mtn_Cotonou,300000,88231,Laure Philippe,325399,537168,2022-01-08
CASH_IN,254232,Agence_mtn_Abomey,300000,45768,Laure Philippe,537168,791400,2022-01-10
CASH_OUT,373087,Laure Philippe,791400,418313,Agence_mtn_Abomey,300000,-73087,2022-01-10
CASH_IN,290588,Agence_mtn_Cotonou,300000,9412,Laure Philippe,418313,708901,2022-01-13
CASH_IN,259383,Agence_mtn_Ouidah,300000,40617,Laure Philippe,708901,968284,2022-01-16
TRANSFER,216444,Bertrand Charles,523535,307091,Laure Philippe,968284,1184728,2022-01-17
CASH_OUT,1173179,Laure Philippe,1184728,11549,Agence_mtn_Ouidah,300000,-873179,2022-01-17
CASH_OUT,4278,Laure Philippe,11549,7271,Agence_mtn_Ouidah,300000,295722,2022-01-18
CASH_OUT,2809,Laure Philippe,7271,4462,Agence_mtn_Cotonou,300000,297191,2022-01-20
CASH_OUT,812,Laure Philippe,4462,3650,Agence_mtn_Abomey,300000,299188,2022-01-20
CASH_IN,123728,Agence_mtn_Abomey,300000,176272,Laure Philippe,3650,127378,2022-01-21
TRANSFER,6926,Louis Pichon,22610,15684,Laure Philippe,127378,134304,2022-01-26
CASH_IN,23126,Agence_mtn_Abomey,300000,276874,Bertrand Le Roux,-636744,-613618,2022-01-01
CASH_IN,198838,Agence_mtn_Cotonou,300000,101162,Bertrand Le Roux,-613618,-414780,2022-01-02
CASH_IN,215502,Agence_mtn_Cotonou,300000,84498,Bertrand Le Roux,-414780,-199278,2022-01-04
CASH_IN,208030,Agence_mtn_Ouidah,300000,91970,Bertrand Le Roux,-199278,8752,2022-01-04
TRANSFER,94323,Bertrand Charles,307091,212768,Bertrand Le Roux,8752,103075,2022-01-04
CASH_OUT,80853,Bertrand Le Roux,103075,22222,Agence_mtn_Abomey,300000,219147,2022-01-05
TRANSFER,17276,Bertrand Le Roux,22222,4946,Alfred du Lesage,20020,2744,2022-01-08
CASH_OUT,3945,Bertrand Le Roux,4946,1001,Agence_mtn_Cotonou,300000,296055,2022-01-09
CASH_IN,88581,Agence_mtn_Abomey,300000,211419,Bertrand Le Roux,1001,89582,2022-01-09
CASH_IN,258752,Agence_mtn_Abomey,300000,41248,Bertrand Le Roux,89582,348334,2022-01-10
CASH_IN,26493,Agence_mtn_Abomey,300000,273507,Bertrand Le Roux,348334,374827,2022-01-14
CASH_OUT,214844,Bertrand Le Roux,374827,159983,Agence_mtn_Abomey,300000,85156,2022-01-14
CASH_OUT,6433,Bertrand Le Roux,159983,153550,Agence_mtn_Cotonou,300000,293567,2022-01-14
TRANSFER,1097,Alfred du Lesage,2744,1647,Bertrand Le Roux,153550,154647,2022-01-16
TRANSFER,14188,Louis Pichon,15684,1496,Bertrand Le Roux,154647,168835,2022-01-17
CASH_IN,106010,Agence_mtn_Ouidah,300000,193990,Bertrand Le Roux,168835,274845,2022-01-19
CASH_IN,293062,Agence_mtn_Cotonou,300000,6938,Bertrand Le Roux,274845,567907,2022-01-23
CASH_OUT,29426,Bertrand Le Roux,567907,538481,Agence_mtn_Ouidah,300000,270574,2022-01-25
CASH_IN,216048,Agence_mtn_Ouidah,300000,83952,Marine Chauvet-Potier,-5425,210623,2022-01-03
TRANSFER,1537,Alfred du Lesage,1647,110,Marine Chauvet-Potier,210623,212160,2022-01-03
TRANSFER,392,Valentine Martinez,7068,6676,Marine Chauvet-Potier,212160,212552,2022-01-06
TRANSFER,107,Alfred du Lesage,110,3,Marine Chauvet-Potier,212552,212659,2022-01-10
CASH_IN,201190,Agence_mtn_Abomey,300000,98810,Marine Chauvet-Potier,212659,413849,2022-01-10
CASH_IN,286442,Agence_mtn_Abomey,300000,13558,Marine Chauvet-Potier,413849,700291,2022-01-12
CASH_IN,103328,Agence_mtn_Ouidah,300000,196672,Marine Chauvet-Potier,700291,803619,2022-01-12
TRANSFER,636382,Marine Chauvet-Potier,803619,167237,Louis Pichon,1496,-634886,2022-01-14
TRANSFER,2661,Valentine Martinez,6676,4015,Marine Chauvet-Potier,167237,169898,2022-01-14
CASH_IN,67128,Agence_mtn_Cotonou,300000,232872,Marine Chauvet-Potier,169898,237026,2022-01-14
CASH_IN,282077,Agence_mtn_Cotonou,300000,17923,Marine Chauvet-Potier,237026,519103,2022-01-15
CASH_IN,21114,Agence_mtn_Ouidah,300000,278886,Marine Chauvet-Potier,519103,540217,2022-01-19
CASH_OUT,192335,Marine Chauvet-Potier,540217,347882,Agence_mtn_Ouidah,300000,107665,2022-01-20
TRANSFER,553,Valentine Martinez,4015,3462,Marine Chauvet-Potier,347882,348435,2022-01-22
CASH_OUT,256883,Marine Chauvet-Potier,348435,91552,Agence_mtn_Cotonou,300000,43117,2022-01-24
CASH_OUT,26192,Marine Chauvet-Potier,91552,65360,Agence_mtn_Cotonou,300000,273808,2022-01-24
CASH_IN,249336,Agence_mtn_Abomey,300000,50664,Marine Chauvet-Potier,65360,314696,2022-01-27
CASH_IN,85184,Agence_mtn_Ouidah,300000,214816,Marine Chauvet-Potier,314696,399880,2022-01-27
CASH_IN,241024,Agence_mtn_Abomey,300000,58976,Pierre Roger,-9850,231174,2022-01-03
CASH_OUT,155897,Pierre Roger,231174,75277,Agence_mtn_Ouidah,300000,144103,2022-01-05
CASH_OUT,60238,Pierre Roger,75277,15039,Agence_mtn_Ouidah,300000,239762,2022-01-06
CASH_IN,96281,Agence_mtn_Ouidah,300000,203719,Pierre Roger,15039,111320,2022-01-09
CASH_OUT,2319,Pierre Roger,111320,109001,Agence_mtn_Cotonou,300000,297681,2022-01-11
CASH_OUT,44950,Pierre Roger,109001,64051,Agence_mtn_Abomey,300000,255050,2022-01-16
TRANSFER,57846,Pierre Roger,64051,6205,Valentine Martinez,3462,-54384,2022-01-18
CASH_IN,260317,Agence_mtn_Abomey,300000,39683,Pierre Roger,6205,266522,2022-01-20
CASH_OUT,160953,Pierre Roger,266522,105569,Agence_mtn_Ouidah,300000,139047,2022-01-24
CASH_IN,98794,Agence_mtn_Ouidah,300000,201206,Thibaut Coulon,-55984,42810,2022-01-02
CASH_IN,71565,Agence_mtn_Ouidah,300000,228435,Thibaut Coulon,42810,114375,2022-01-04
CASH_IN,128320,Agence_mtn_Abomey,300000,171680,Thibaut Coulon,114375,242695,2022-01-05
CASH_IN,241919,Agence_mtn_Ouidah,300000,58081,Thibaut Coulon,242695,484614,2022-01-07
TRANSFER,183799,Thibaut Coulon,484614,300815,Thibaut Coulon,484614,668413,2022-01-07
CASH_OUT,18772,Thibaut Coulon,300815,282043,Agence_mtn_Ouidah,300000,281228,2022-01-08
CASH_OUT,244381,Thibaut Coulon,282043,37662,Agence_mtn_Cotonou,300000,55619,2022-01-08
CASH_IN,293647,Agence_mtn_Ouidah,300000,6353,Thibaut Coulon,37662,331309,2022-01-09
CASH_IN,264705,Agence_mtn_Ouidah,300000,35295,Thibaut Coulon,331309,596014,2022-01-10
CASH_IN,101441,Agence_mtn_Cotonou,300000,198559,Thibaut Coulon,596014,697455,2022-01-11
CASH_IN,287113,Agence_mtn_Ouidah,300000,12887,Thibaut Coulon,697455,984568,2022-01-16
CASH_OUT,708015,Thibaut Coulon,984568,276553,Agence_mtn_Abomey,300000,-408015,2022-01-20
CASH_IN,229052,Agence_mtn_Abomey,300000,70948,Thibaut Coulon,276553,505605,2022-01-23
CASH_IN,276778,Agence_mtn_Abomey,300000,23222,Thibaut Coulon,505605,782383,2022-01-26
CASH_IN,72899,Agence_mtn_Cotonou,300000,227101,Emmanuelle Georges,-263031,-190132,2022-01-01
CASH_IN,211703,Agence_mtn_Abomey,300000,88297,Emmanuelle Georges,-190132,21571,2022-01-03
CASH_OUT,16501,Emmanuelle Georges,21571,5070,Agence_mtn_Cotonou,300000,283499,2022-01-06
CASH_IN,140548,Agence_mtn_Ouidah,300000,159452,Emmanuelle Georges,5070,145618,2022-01-08
TRANSFER,77144,Emmanuelle Georges,145618,68474,Emmanuelle Georges,145618,68474,2022-01-12
CASH_OUT,17084,Emmanuelle Georges,68474,51390,Agence_mtn_Abomey,300000,282916,2022-01-14
CASH_OUT,4972,Emmanuelle Georges,51390,46418,Agence_mtn_Abomey,300000,295028,2022-01-15
CASH_OUT,39844,Emmanuelle Georges,46418,6574,Agence_mtn_Ouidah,300000,260156,2022-01-17
TRANSFER,5058,Emmanuelle Georges,6574,1516,Emmanuelle Georges,6574,11632,2022-01-26
CASH_OUT,616,Emmanuelle Georges,1516,900,Agence_mtn_Cotonou,300000,299384,2022-01-26
CASH_IN,239777,Agence_mtn_Abomey,300000,60223,Emmanuelle Georges,900,240677,2022-01-26
CASH_OUT,51199,Emmanuelle Georges,240677,189478,Agence_mtn_Ouidah,300000,248801,2022-01-26
CASH_IN,284639,Agence_mtn_Abomey,300000,15361,Emmanuelle Georges,189478,474117,2022-01-27
CASH_OUT,200723,Emmanuelle Georges,474117,273394,Agence_mtn_Abomey,300000,99277,2022-01-27
CASH_IN,53194,Agence_mtn_Abomey,300000,246806,Alphonse Le Olivier,-7323,45871,2022-01-01
CASH_IN,124741,Agence_mtn_Ouidah,300000,175259,Alphonse Le Olivier,45871,170612,2022-01-06
CASH_IN,249283,Agence_mtn_Cotonou,300000,50717,Alphonse Le Olivier,170612,419895,2022-01-09
TRANSFER,355696,Alphonse Le Olivier,419895,64199,Alphonse Le Olivier,419895,64199,2022-01-09
CASH_OUT,6078,Alphonse Le Olivier,64199,58121,Agence_mtn_Abomey,300000,293922,2022-01-21
CASH_IN,229931,Agence_mtn_Cotonou,300000,70069,Martine Wagner de la Bègue,-651752,-421821,2022-01-01
CASH_IN,104438,Agence_mtn_Ouidah,300000,195562,Martine Wagner de la Bègue,-421821,-317383,2022-01-10
CASH_IN,212462,Agence_mtn_Cotonou,300000,87538,Martine Wagner de la Bègue,-317383,-104921,2022-01-12
CASH_IN,97161,Agence_mtn_Ouidah,300000,202839,Martine Wagner de la Bègue,-104921,-7760,2022-01-12
CASH_IN,42985,Agence_mtn_Cotonou,300000,257015,Martine Wagner de la Bègue,-7760,35225,2022-01-15
CASH_OUT,29842,Martine Wagner de la Bègue,35225,5383,Agence_mtn_Abomey,300000,270158,2022-01-16
CASH_OUT,4128,Martine Wagner de la Bègue,5383,1255,Agence_mtn_Cotonou,300000,295872,2022-01-16
CASH_IN,46993,Agence_mtn_Cotonou,300000,253007,Martine Wagner de la Bègue,1255,48248,2022-01-20
TRANSFER,21081,Martine Wagner de la Bègue,48248,27167,Martine Wagner de la Bègue,48248,27167,2022-01-21
CASH_OUT,8819,Martine Wagner de la Bègue,27167,18348,Agence_mtn_Ouidah,300000,291181,2022-01-22
TRANSFER,4272,Martine Wagner de la Bègue,18348,14076,Martine Wagner de la Bègue,18348,22620,2022-01-23
CASH_OUT,11688,Martine Wagner de la Bègue,14076,2388,Agence_mtn_Ouidah,300000,288312,2022-01-23
CASH_IN,181234,Agence_mtn_Ouidah,300000,118766,Valentine Martinez,-54384,126850,2022-01-01
TRANSFER,26924,Valentine Martinez,126850,99926,Valentine Martinez,126850,99926,2022-01-02
CASH_IN,89708,Agence_mtn_Abomey,300000,210292,Valentine Martinez,99926,189634,2022-01-02
CASH_IN,39389,Agence_mtn_Abomey,300000,260611,Valentine Martinez,189634,229023,2022-01-02
CASH_IN,277580,Agence_mtn_Ouidah,300000,22420,Valentine Martinez,229023,506603,2022-01-17
CASH_IN,32614,Agence_mtn_Ouidah,300000,267386,Valentine Martinez,506603,539217,2022-01-17
CASH_OUT,163122,Valentine Martinez,539217,376095,Agence_mtn_Ouidah,300000,136878,2022-01-18
CASH_OUT,318448,Valentine Martinez,376095,57647,Agence_mtn_Abomey,300000,-18448,2022-01-19
CASH_IN,30456,Agence_mtn_Cotonou,300000,269544,Valentine Martinez,57647,88103,2022-01-23
CASH_OUT,71692,Valentine Martinez,88103,16411,Agence_mtn_Abomey,300000,228308,2022-01-23
CASH_IN,47940,Agence_mtn_Abomey,300000,252060,Thierry Delattre-Simon,-82233,-34293,2022-01-01
CASH_IN,270776,Agence_mtn_Ouidah,300000,29224,Thierry Delattre-Simon,-34293,236483,2022-01-02
TRANSFER,52941,Thierry Delattre-Simon,236483,183542,Thierry Delattre-Simon,236483,183542,2022-01-07
CASH_OUT,135055,Thierry Delattre-Simon,183542,48487,Agence_mtn_Ouidah,300000,164945,2022-01-08
TRANSFER,36712,Thierry Delattre-Simon,48487,11775,Thierry Delattre-Simon,48487,11775,2022-01-10
CASH_OUT,1894,Thierry Delattre-Simon,11775,9881,Agence_mtn_Ouidah,300000,298106,2022-01-13
CASH_OUT,2617,Thierry Delattre-Simon,9881,7264,Agence_mtn_Ouidah,300000,297383,2022-01-13
CASH_IN,5247,Agence_mtn_Abomey,300000,294753,Thierry Delattre-Simon,7264,12511,2022-01-15
TRANSFER,882,Thierry Delattre-Simon,12511,11629,Thierry Delattre-Simon,12511,13393,2022-01-17
CASH_OUT,9790,Thierry Delattre-Simon,11629,1839,Agence_mtn_Abomey,300000,290210,2022-01-17
CASH_IN,197528,Agence_mtn_Cotonou,300000,102472,Thierry Delattre-Simon,1839,199367,2022-01-19
CASH_OUT,126398,Thierry Delattre-Simon,199367,72969,Agence_mtn_Abomey,300000,173602,2022-01-21
CASH_OUT,69342,Thierry Delattre-Simon,72969,3627,Agence_mtn_Abomey,300000,230658,2022-01-22
CASH_OUT,3067,Thierry Delattre-Simon,3627,560,Agence_mtn_Cotonou,300000,296933,2022-01-23
CASH_IN,28485,Agence_mtn_Ouidah,300000,271515,Gilbert Foucher,-9253,19232,2022-01-03
TRANSFER,4703,Gilbert Foucher,19232,14529,Gilbert Foucher,19232,14529,2022-01-05
CASH_OUT,4191,Gilbert Foucher,14529,10338,Agence_mtn_Abomey,300000,295809,2022-01-07
CASH_OUT,5247,Gilbert Foucher,10338,5091,Agence_mtn_Ouidah,300000,294753,2022-01-08
CASH_OUT,2867,Gilbert Foucher,5091,2224,Agence_mtn_Abomey,300000,297133,2022-01-09
TRANSFER,1835,Gilbert Foucher,2224,389,Gilbert Foucher,2224,4059,2022-01-10
CASH_OUT,233,Gilbert Foucher,389,156,Agence_mtn_Cotonou,300000,299767,2022-01-11
CASH_IN,174108,Agence_mtn_Abomey,300000,125892,Gilbert Foucher,156,174264,2022-01-15
CASH_IN,194613,Agence_mtn_Ouidah,300000,105387,Gilbert Foucher,174264,368877,2022-01-15
TRANSFER,48936,Gilbert Foucher,368877,319941,Gilbert Foucher,368877,319941,2022-01-15
CASH_IN,271035,Agence_mtn_Ouidah,300000,28965,Gilbert Foucher,319941,590976,2022-01-16
CASH_OUT,443706,Gilbert Foucher,590976,147270,Agence_mtn_Ouidah,300000,-143706,2022-01-18
CASH_OUT,76854,Gilbert Foucher,147270,70416,Agence_mtn_Ouidah,300000,223146,2022-01-21
CASH_OUT,47258,Gilbert Foucher,70416,23158,Agence_mtn_Ouidah,300000,252742,2022-01-23
CASH_IN,186000,Agence_mtn_Ouidah,300000,114000,Gilbert Foucher,23158,209158,2022-01-24
CASH_IN,237258,Agence_mtn_Cotonou,300000,62742,Gilbert Foucher,209158,446416,2022-01-26
CASH_IN,71938,Agence_mtn_Cotonou,300000,228062,Louis Pichon,-634886,-562948,2022-01-06
CASH_IN,28556,Agence_mtn_Abomey,300000,271444,Louis Pichon,-562948,-534392,2022-01-07
CASH_IN,216151,Agence_mtn_Cotonou,300000,83849,Louis Pichon,-534392,-318241,2022-01-08
CASH_IN,138441,Agence_mtn_Cotonou,300000,161559,Louis Pichon,-318241,-179800,2022-01-14
CASH_IN,131521,Agence_mtn_Abomey,300000,168479,Louis Pichon,-179800,-48279,2022-01-15
CASH_IN,6746,Agence_mtn_Abomey,300000,293254,Louis Pichon,-48279,-41533,2022-01-16
CASH_IN,256139,Agence_mtn_Ouidah,300000,43861,Louis Pichon,-41533,214606,2022-01-16
CASH_IN,214655,Agence_mtn_Ouidah,300000,85345,Louis Pichon,214606,429261,2022-01-17
CASH_IN,60079,Agence_mtn_Abomey,300000,239921,Louis Pichon,429261,489340,2022-01-19
CASH_IN,54942,Agence_mtn_Ouidah,300000,245058,Louis Pichon,489340,544282,2022-01-20
CASH_OUT,275651,Louis Pichon,544282,268631,Agence_mtn_Ouidah,300000,24349,2022-01-21
CASH_IN,236426,Agence_mtn_Cotonou,300000,63574,Louis Pichon,268631,505057,2022-01-22
CASH_IN,172608,Agence_mtn_Cotonou,300000,127392,Louis Pichon,505057,677665,2022-01-25
CASH_OUT,490901,Louis Pichon,677665,186764,Agence_mtn_Abomey,300000,-190901,2022-01-26
CASH_IN,18983,Agence_mtn_Ouidah,300000,281017,Louis Pichon,186764,205747,2022-01-27
CASH_IN,45984,Agence_mtn_Ouidah,300000,254016,Pénélope Dupuis,-177122,-131138,2022-01-03
CASH_IN,165583,Agence_mtn_Cotonou,300000,134417,Pénélope Dupuis,-131138,34445,2022-01-03
TRANSFER,23952,Pénélope Dupuis,34445,10493,Pénélope Dupuis,34445,10493,2022-01-05
TRANSFER,3736,Pénélope Dupuis,10493,6757,Pénélope Dupuis,10493,14229,2022-01-08
CASH_OUT,604,Pénélope Dupuis,6757,6153,Agence_mtn_Cotonou,300000,299396,2022-01-16
CASH_IN,13370,Agence_mtn_Ouidah,300000,286630,Rémy Le Michaud,-280079,-266709,2022-01-03
CASH_IN,77504,Agence_mtn_Ouidah,300000,222496,Rémy Le Michaud,-266709,-189205,2022-01-10
CASH_IN,193591,Agence_mtn_Abomey,300000,106409,Rémy Le Michaud,-189205,4386,2022-01-14
CASH_OUT,1228,Rémy Le Michaud,4386,3158,Agence_mtn_Ouidah,300000,298772,2022-01-17
CASH_IN,118991,Agence_mtn_Ouidah,300000,181009,Rémy Le Michaud,3158,122149,2022-01-17
TRANSFER,34639,Rémy Le Michaud,122149,87510,Rémy Le Michaud,122149,87510,2022-01-19
CASH_IN,180407,Agence_mtn_Ouidah,300000,119593,Rémy Le Michaud,87510,267917,2022-01-23
CASH_IN,237129,Agence_mtn_Abomey,300000,62871,Rémy Le Michaud,267917,505046,2022-01-26
CASH_IN,10524,Agence_mtn_Ouidah,300000,289476,Gilbert-Charles Thibault,-24056,-13532,2022-01-02
CASH_IN,13017,Agence_mtn_Abomey,300000,286983,Gilbert-Charles Thibault,-13532,-515,2022-01-06
CASH_IN,88253,Agence_mtn_Abomey,300000,211747,Gilbert-Charles Thibault,-515,87738,2022-01-06
CASH_OUT,63761,Gilbert-Charles Thibault,87738,23977,Agence_mtn_Abomey,300000,236239,2022-01-14
CASH_OUT,22483,Gilbert-Charles Thibault,23977,1494,Agence_mtn_Cotonou,300000,277517,2022-01-14
TRANSFER,368,Gilbert-Charles Thibault,1494,1126,Gilbert-Charles Thibault,1494,1126,2022-01-17
TRANSFER,544,Gilbert-Charles Thibault,1126,582,Gilbert-Charles Thibault,1126,1670,2022-01-18
CASH_OUT,313,Gilbert-Charles Thibault,582,269,Agence_mtn_Abomey,300000,299687,2022-01-20
CASH_IN,207391,Agence_mtn_Cotonou,300000,92609,Gilbert-Charles Thibault,269,207660,2022-01-21
CASH_OUT,152762,Gilbert-Charles Thibault,207660,54898,Agence_mtn_Cotonou,300000,147238,2022-01-26
CASH_IN,79760,Agence_mtn_Abomey,300000,220240,Cécile Clerc,-43084,36676,2022-01-01
TRANSFER,1402,Cécile Clerc,36676,35274,Cécile Clerc,36676,38078,2022-01-02
TRANSFER,6801,Cécile Clerc,35274,28473,Cécile Clerc,35274,28473,2022-01-11
CASH_IN,83205,Agence_mtn_Abomey,300000,216795,Cécile Clerc,28473,111678,2022-01-14
CASH_OUT,27043,Cécile Clerc,111678,84635,Agence_mtn_Cotonou,300000,272957,2022-01-14
CASH_IN,270659,Agence_mtn_Cotonou,300000,29341,Cécile Clerc,84635,355294,2022-01-16
CASH_OUT,275298,Cécile Clerc,355294,79996,Agence_mtn_Cotonou,300000,24702,2022-01-17
CASH_IN,105454,Agence_mtn_Abomey,300000,194546,Cécile Clerc,79996,185450,2022-01-18
CASH_IN,232541,Agence_mtn_Ouidah,300000,67459,Cécile Clerc,185450,417991,2022-01-25
CASH_IN,115307,Agence_mtn_Cotonou,300000,184693,Victoire-Nicole Lopez,-92375,22932,2022-01-01
TRANSFER,5087,Victoire-Nicole Lopez,22932,17845,Victoire-Nicole Lopez,22932,28019,2022-01-06
CASH_IN,108934,Agence_mtn_Cotonou,300000,191066,Victoire-Nicole Lopez,17845,126779,2022-01-07
CASH_OUT,83433,Victoire-Nicole Lopez,126779,43346,Agence_mtn_Cotonou,300000,216567,2022-01-09
TRANSFER,33176,Victoire-Nicole Lopez,43346,10170,Victoire-Nicole Lopez,43346,76522,2022-01-09
CASH_IN,208244,Agence_mtn_Abomey,300000,91756,Victoire-Nicole Lopez,10170,218414,2022-01-20
CASH_IN,3768,Agence_mtn_Cotonou,300000,296232,Victoire-Nicole Lopez,218414,222182,2022-01-23
CASH_OUT,105843,Victoire-Nicole Lopez,222182,116339,Agence_mtn_Abomey,300000,194157,2022-01-24
CASH_IN,189035,Agence_mtn_Abomey,300000,110965,Victoire-Nicole Lopez,116339,305374,2022-01-27
CASH_IN,244829,Agence_mtn_Ouidah,300000,55171,Alfred du Lesage,3,244832,2022-01-02
TRANSFER,140211,Alfred du Lesage,244832,104621,Alfred du Lesage,244832,385043,2022-01-05
CASH_IN,169205,Agence_mtn_Abomey,300000,130795,Alfred du Lesage,104621,273826,2022-01-05
CASH_OUT,90493,Alfred du Lesage,273826,183333,Agence_mtn_Ouidah,300000,209507,2022-01-14
CASH_OUT,136742,Alfred du Lesage,183333,46591,Agence_mtn_Abomey,300000,163258,2022-01-14
CASH_IN,41948,Agence_mtn_Cotonou,300000,258052,Alfred du Lesage,46591,88539,2022-01-15
CASH_IN,172790,Agence_mtn_Cotonou,300000,127210,Alfred du Lesage,88539,261329,2022-01-18
CASH_OUT,20851,Alfred du Lesage,261329,240478,Agence_mtn_Ouidah,300000,279149,2022-01-19
CASH_IN,157812,Agence_mtn_Abomey,300000,142188,Alfred du Lesage,240478,398290,2022-01-19
CASH_IN,290696,Agence_mtn_Ouidah,300000,9304,Geneviève De Oliveira-Michel,-107628,183068,2022-01-01
CASH_OUT,177035,Geneviève De Oliveira-Michel,183068,6033,Agence_mtn_Cotonou,300000,122965,2022-01-02
CASH_OUT,5651,Geneviève De Oliveira-Michel,6033,382,Agence_mtn_Abomey,300000,294349,2022-01-03
CASH_OUT,161,Geneviève De Oliveira-Michel,382,221,Agence_mtn_Abomey,300000,299839,2022-01-03
TRANSFER,190,Geneviève De Oliveira-Michel,221,31,Geneviève De Oliveira-Michel,221,31,2022-01-08
CASH_IN,239521,Agence_mtn_Cotonou,300000,60479,Geneviève De Oliveira-Michel,31,239552,2022-01-08
CASH_IN,199583,Agence_mtn_Abomey,300000,100417,Geneviève De Oliveira-Michel,239552,439135,2022-01-09
CASH_OUT,295919,Geneviève De Oliveira-Michel,439135,143216,Agence_mtn_Ouidah,300000,4081,2022-01-12
CASH_OUT,39442,Geneviève De Oliveira-Michel,143216,103774,Agence_mtn_Abomey,300000,260558,2022-01-14
CASH_IN,269039,Agence_mtn_Ouidah,300000,30961,Geneviève De Oliveira-Michel,103774,372813,2022-01-14
CASH_OUT,315458,Geneviève De Oliveira-Michel,372813,57355,Agence_mtn_Cotonou,300000,-15458,2022-01-15
CASH_IN,104688,Agence_mtn_Cotonou,300000,195312,Geneviève De Oliveira-Michel,57355,162043,2022-01-16
CASH_OUT,125026,Geneviève De Oliveira-Michel,162043,37017,Agence_mtn_Abomey,300000,174974,2022-01-26
CASH_IN,6300,Agence_mtn_Abomey,300000,293700,Franck-Charles Texier,-675895,-669595,2022-01-01
CASH_IN,170153,Agence_mtn_Abomey,300000,129847,Franck-Charles Texier,-669595,-499442,2022-01-03
CASH_IN,163300,Agence_mtn_Abomey,300000,136700,Franck-Charles Texier,-499442,-336142,2022-01-05
CASH_IN,88946,Agence_mtn_Cotonou,300000,211054,Franck-Charles Texier,-336142,-247196,2022-01-05
CASH_IN,284865,Agence_mtn_Ouidah,300000,15135,Franck-Charles Texier,-247196,37669,2022-01-06
CASH_OUT,1685,Franck-Charles Texier,37669,35984,Agence_mtn_Cotonou,300000,298315,2022-01-06
CASH_OUT,26738,Franck-Charles Texier,35984,9246,Agence_mtn_Cotonou,300000,273262,2022-01-08
TRANSFER,2811,Franck-Charles Texier,9246,6435,Franck-Charles Texier,9246,6435,2022-01-08
CASH_IN,91839,Agence_mtn_Cotonou,300000,208161,Franck-Charles Texier,6435,98274,2022-01-12
TRANSFER,24453,Franck-Charles Texier,98274,73821,Franck-Charles Texier,98274,122727,2022-01-14
CASH_OUT,838,Franck-Charles Texier,73821,72983,Agence_mtn_Cotonou,300000,299162,2022-01-19
CASH_OUT,37877,Franck-Charles Texier,72983,35106,Agence_mtn_Cotonou,300000,262123,2022-01-20
TRANSFER,32922,Franck-Charles Texier,35106,2184,Franck-Charles Texier,35106,68028,2022-01-20
CASH_OUT,158,Franck-Charles Texier,2184,2026,Agence_mtn_Cotonou,300000,299842,2022-01-24
CASH_OUT,1627,Franck-Charles Texier,2026,399,Agence_mtn_Cotonou,300000,298373,2022-01-25
CASH_OUT,145,Franck-Charles Texier,399,254,Agence_mtn_Ouidah,300000,299855,2022-01-25
CASH_IN,15621,Agence_mtn_Abomey,300000,284379,Franck-Charles Texier,254,15875,2022-01-26
CASH_IN,19710,Agence_mtn_Cotonou,300000,280290,William Lebrun,-219617,-199907,2022-01-02
CASH_IN,145491,Agence_mtn_Ouidah,300000,154509,William Lebrun,-199907,-54416,2022-01-02
CASH_IN,295882,Agence_mtn_Ouidah,300000,4118,William Lebrun,-54416,241466,2022-01-02
TRANSFER,12350,William Lebrun,241466,229116,William Lebrun,241466,253816,2022-01-07
TRANSFER,93229,William Lebrun,229116,135887,William Lebrun,229116,135887,2022-01-08
CASH_IN,187467,Agence_mtn_Abomey,300000,112533,William Lebrun,135887,323354,2022-01-09
CASH_OUT,146906,William Lebrun,323354,176448,Agence_mtn_Ouidah,300000,153094,2022-01-10
CASH_IN,77836,Agence_mtn_Ouidah,300000,222164,William Lebrun,176448,254284,2022-01-10
CASH_OUT,140245,William Lebrun,254284,114039,Agence_mtn_Cotonou,300000,159755,2022-01-12
CASH_IN,160156,Agence_mtn_Abomey,300000,139844,William Lebrun,114039,274195,2022-01-14
CASH_OUT,94308,William Lebrun,274195,179887,Agence_mtn_Ouidah,300000,205692,2022-01-15
CASH_OUT,49586,William Lebrun,179887,130301,Agence_mtn_Abomey,300000,250414,2022-01-16
CASH_OUT,84581,William Lebrun,130301,45720,Agence_mtn_Cotonou,300000,215419,2022-01-19
CASH_OUT,2254,William Lebrun,45720,43466,Agence_mtn_Cotonou,300000,297746,2022-01-21
CASH_OUT,18964,William Lebrun,43466,24502,Agence_mtn_Ouidah,300000,281036,2022-01-21
CASH_IN,173014,Agence_mtn_Cotonou,300000,126986,Raymond Marchal de Nguyen,-362314,-189300,2022-01-03
CASH_IN,258464,Agence_mtn_Cotonou,300000,41536,Raymond Marchal de Nguyen,-189300,69164,2022-01-08
CASH_OUT,22343,Raymond Marchal de Nguyen,69164,46821,Agence_mtn_Ouidah,300000,277657,2022-01-09
CASH_IN,58231,Agence_mtn_Ouidah,300000,241769,Raymond Marchal de Nguyen,46821,105052,2022-01-14
CASH_IN,88241,Agence_mtn_Ouidah,300000,211759,Raymond Marchal de Nguyen,105052,193293,2022-01-27
CASH_IN,54099,Agence_mtn_Ouidah,300000,245901,Vincent Mathieu,1321900,1375999,2022-02-01
CASH_IN,177930,Agence_mtn_Cotonou,300000,122070,Vincent Mathieu,1375999,1553929,2022-02-11
CASH_OUT,488773,Vincent Mathieu,1553929,1065156,Agence_mtn_Cotonou,300000,-188773,2022-02-19
TRANSFER,74164,Éléonore-Hélène Dubois,1004300,930136,Vincent Mathieu,1065156,1139320,2022-02-23
CASH_IN,140363,Agence_mtn_Ouidah,300000,159637,Antoinette Bertrand,165900,306263,2022-02-02
CASH_IN,137446,Agence_mtn_Cotonou,300000,162554,Antoinette Bertrand,306263,443709,2022-02-05
CASH_OUT,336195,Antoinette Bertrand,443709,107514,Agence_mtn_Ouidah,300000,-36195,2022-02-13
TRANSFER,139908,Jeanne Garnier,795900,655992,Antoinette Bertrand,107514,247422,2022-02-25
CASH_OUT,247238,Antoinette Bertrand,247422,184,Agence_mtn_Cotonou,300000,52762,2022-02-25
CASH_OUT,228802,Nathalie Peron,230100,1298,Agence_mtn_Cotonou,300000,71198,2022-02-19
TRANSFER,100938,Marie Picard,928400,827462,Nathalie Peron,1298,102236,2022-02-21
TRANSFER,166813,Tristan Thomas,597800,430987,Valentine Martinez,140600,307413,2022-02-07
TRANSFER,139343,Valentine Martinez,307413,168070,Bertrand Charles,287400,148057,2022-02-13
CASH_IN,183324,Agence_mtn_Abomey,300000,116676,Valentine Martinez,168070,351394,2022-02-15
CASH_IN,29755,Agence_mtn_Cotonou,300000,270245,Valentine Martinez,351394,381149,2022-02-16
TRANSFER,56276,Marcelle Paris,700800,644524,Valentine Martinez,381149,437425,2022-02-17
CASH_OUT,223167,Cécile Germain,812500,589333,Agence_mtn_Cotonou,300000,76833,2022-02-18
CASH_OUT,759370,Émilie Moulin,1889200,1129830,Agence_mtn_Abomey,300000,-459370,2022-02-16
CASH_OUT,711924,Émilie Moulin,1129830,417906,Agence_mtn_Cotonou,300000,-411924,2022-02-27
CASH_IN,233792,Agence_mtn_Abomey,300000,66208,Nathalie Pages,931900,1165692,2022-02-21
CASH_OUT,1004306,Sophie Gonzalez,1020800,16494,Agence_mtn_Abomey,300000,-704306,2022-02-07
TRANSFER,208003,Alphonse Le Olivier,325500,117497,Sophie Gonzalez,16494,224497,2022-02-07
CASH_OUT,132628,Sophie Gonzalez,224497,91869,Agence_mtn_Cotonou,300000,167372,2022-02-13
TRANSFER,36617,Sophie Gonzalez,91869,55252,Antoine Leleu,1484900,1448283,2022-02-26
CASH_OUT,902042,Benjamin Evrard-Marty,1380500,478458,Agence_mtn_Cotonou,300000,-602042,2022-02-12
TRANSFER,788636,Alix Maillet,1322600,533964,Benjamin Evrard-Marty,478458,1267094,2022-02-27
TRANSFER,438614,Claude Foucher,585600,146986,Sophie Lévêque,1961900,2400514,2022-02-07
CASH_OUT,1204966,Sophie Lévêque,2400514,1195548,Agence_mtn_Ouidah,300000,-904966,2022-02-17
CASH_OUT,513955,Sophie Lévêque,1195548,681593,Agence_mtn_Ouidah,300000,-213955,2022-02-22
TRANSFER,1112300,Rémy Le Michaud,1741100,628800,Alexandrie Delmas,1457500,345200,2022-02-11
TRANSFER,17896,Claude Foucher,146986,129090,Thierry Delattre-Simon,34800,52696,2022-02-05
CASH_OUT,47199,Thierry Delattre-Simon,52696,5497,Agence_mtn_Abomey,300000,252801,2022-02-11
TRANSFER,324470,Marine Chauvet-Potier,557400,232930,Thierry Delattre-Simon,5497,329967,2022-02-12
CASH_OUT,26012,Thierry Delattre-Simon,329967,303955,Agence_mtn_Ouidah,300000,273988,2022-02-23
TRANSFER,165183,Cécile Clerc,1986100,1820917,Édouard Nguyen,732100,897283,2022-02-24
TRANSFER,1192791,Geneviève Grondin,1502700,309909,Édouard Nguyen,897283,2090074,2022-02-26
TRANSFER,378800,Marcelle Charrier,580800,202000,Valérie Dijoux,1945800,1567000,2022-02-25
CASH_IN,47873,Agence_mtn_Ouidah,300000,252127,Margot Riou du Fernandes,169300,217173,2022-02-06
TRANSFER,410448,Adèle Labbé,559300,148852,Margot Riou du Fernandes,217173,627621,2022-02-16
TRANSFER,147143,Pénélope Dupuis,346700,199557,Margot Riou du Fernandes,627621,774764,2022-02-20
CASH_IN,162428,Agence_mtn_Cotonou,300000,137572,Margot Riou du Fernandes,774764,937192,2022-02-20
TRANSFER,318136,Margot Riou du Fernandes,937192,619056,Thibaut Coulon,650500,332364,2022-02-23
TRANSFER,1059457,Valentine Richard-Bourdon,1394000,334543,Sébastien Vallée,1094800,2154257,2022-02-02
TRANSFER,192526,Cécile Delattre-Arnaud,1524400,1331874,Sébastien Vallée,2154257,2346783,2022-02-03
CASH_OUT,2005687,Sébastien Vallée,2346783,341096,Agence_mtn_Cotonou,300000,-1705687,2022-02-06
TRANSFER,801626,Caroline-Lorraine Humbert,933500,131874,Sébastien Vallée,341096,1142722,2022-02-10
TRANSFER,84137,Rémy de la Roux,190400,106263,Sébastien Vallée,1142722,1226859,2022-02-24
CASH_IN,168709,Agence_mtn_Abomey,300000,131291,Gilbert-Charles Thibault,1698800,1867509,2022-02-05
CASH_IN,53101,Agence_mtn_Abomey,300000,246899,Gilbert-Charles Thibault,1867509,1920610,2022-02-22
TRANSFER,1195775,Emmanuelle Georges,1968600,772825,Vincent Fournier,1829600,633825,2022-02-07
CASH_OUT,260038,Emmanuelle Georges,772825,512787,Agence_mtn_Cotonou,300000,39962,2022-02-09
CASH_IN,52904,Agence_mtn_Ouidah,300000,247096,Emmanuelle Georges,512787,565691,2022-02-11
TRANSFER,401917,Emmanuelle Georges,565691,163774,William Le Lucas,293700,-108217,2022-02-13
CASH_OUT,42484,Emmanuelle Georges,163774,121290,Agence_mtn_Ouidah,300000,257516,2022-02-14
TRANSFER,259475,Thérèse-Margaux Bruneau,428300,168825,Bertrand Le Roux,1359500,1100025,2022-02-02
CASH_IN,114726,Agence_mtn_Abomey,300000,185274,Thérèse-Margaux Bruneau,168825,283551,2022-02-10
CASH_IN,43937,Agence_mtn_Cotonou,300000,256063,Thérèse-Margaux Bruneau,283551,327488,2022-02-20
CASH_IN,248526,Agence_mtn_Abomey,300000,51474,Adrien Chartier,821600,1070126,2022-02-12
TRANSFER,1051421,Adrien Chartier,1070126,18705,Pénélope Dupuis,199557,-851864,2022-02-16
CASH_IN,272585,Agence_mtn_Ouidah,300000,27415,Adrien Chartier,18705,291290,2022-02-19
TRANSFER,38123,Adrien Chartier,291290,253167,Richard Le Descamps,1778000,1739877,2022-02-23
CASH_OUT,12328,Adrien Chartier,253167,240839,Agence_mtn_Cotonou,300000,287672,2022-02-27
CASH_OUT,709708,Marie Picard,827462,117754,Agence_mtn_Ouidah,300000,-409708,2022-02-11
TRANSFER,667920,Isabelle Rossi,786500,118580,Marie Picard,117754,785674,2022-02-22
CASH_OUT,355513,Marie Picard,785674,430161,Agence_mtn_Abomey,300000,-55513,2022-02-22
CASH_OUT,415349,Marie Picard,430161,14812,Agence_mtn_Cotonou,300000,-115349,2022-02-26
CASH_OUT,14042,Raymond Marchal de Nguyen,276100,262058,Agence_mtn_Ouidah,300000,285958,2022-02-04
CASH_OUT,81722,Raymond Marchal de Nguyen,262058,180336,Agence_mtn_Abomey,300000,218278,2022-02-07
TRANSFER,145979,Raymond Marchal de Nguyen,180336,34357,Pénélope Ollivier,1789700,1643721,2022-02-16
CASH_IN,253571,Agence_mtn_Cotonou,300000,46429,Raymond Marchal de Nguyen,34357,287928,2022-02-22
TRANSFER,139771,Xavier Leblanc-Ferreira,1566200,1426429,Pierre Roger,65900,-73871,2022-02-07
CASH_IN,44345,Agence_mtn_Cotonou,300000,255655,Xavier Leblanc-Ferreira,1426429,1470774,2022-02-11
CASH_OUT,230216,Xavier Leblanc-Ferreira,1470774,1240558,Agence_mtn_Ouidah,300000,69784,2022-02-15
TRANSFER,53695,Claude Foucher,129090,75395,Xavier Leblanc-Ferreira,1240558,1294253,2022-02-16
CASH_IN,115148,Agence_mtn_Abomey,300000,184852,Xavier Leblanc-Ferreira,1294253,1409401,2022-02-16
CASH_IN,183305,Agence_mtn_Abomey,300000,116695,Virginie Le Gall,344000,527305,2022-02-12
TRANSFER,237624,Virginie Le Gall,527305,289681,Éléonore-Hélène Dubois,930136,692512,2022-02-19
CASH_OUT,161707,Virginie Le Gall,289681,127974,Agence_mtn_Ouidah,300000,138293,2022-02-25
TRANSFER,483997,Alfred du Lesage,738300,254303,Alix Maillet,533964,1017961,2022-02-03
CASH_IN,73171,Agence_mtn_Ouidah,300000,226829,Alix Maillet,1017961,1091132,2022-02-07
CASH_OUT,886328,Alix Maillet,1091132,204804,Agence_mtn_Cotonou,300000,-586328,2022-02-07
CASH_OUT,8771,Alix Maillet,204804,196033,Agence_mtn_Cotonou,300000,291229,2022-02-09
CASH_IN,264511,Agence_mtn_Ouidah,300000,35489,Renée David,1970400,2234911,2022-02-05
CASH_OUT,1454007,Renée David,2234911,780904,Agence_mtn_Cotonou,300000,-1154007,2022-02-10
CASH_IN,73425,Agence_mtn_Ouidah,300000,226575,Renée David,780904,854329,2022-02-18
CASH_IN,132543,Agence_mtn_Ouidah,300000,167457,Jeanne Garnier,655992,788535,2022-02-14
CASH_IN,61622,Agence_mtn_Cotonou,300000,238378,Jeanne Garnier,788535,850157,2022-02-16
CASH_IN,33708,Agence_mtn_Cotonou,300000,266292,Valérie Dijoux,1567000,1600708,2022-02-01
CASH_OUT,1125828,Valérie Dijoux,1600708,474880,Agence_mtn_Abomey,300000,-825828,2022-02-01
CASH_OUT,332683,Valérie Dijoux,474880,142197,Agence_mtn_Abomey,300000,-32683,2022-02-01
CASH_IN,268298,Agence_mtn_Abomey,300000,31702,Valérie Dijoux,142197,410495,2022-02-01
CASH_OUT,134000,Valérie Dijoux,410495,276495,Agence_mtn_Cotonou,300000,166000,2022-02-01
TRANSFER,145966,Honoré du Laurent,242600,96634,Valérie Dijoux,276495,422461,2022-02-02
CASH_OUT,322883,Valérie Dijoux,422461,99578,Agence_mtn_Ouidah,300000,-22883,2022-02-03
TRANSFER,666739,David Guérin,1168900,502161,Valérie Dijoux,99578,766317,2022-02-06
CASH_OUT,314392,Valérie Dijoux,766317,451925,Agence_mtn_Ouidah,300000,-14392,2022-02-07
CASH_IN,184182,Agence_mtn_Ouidah,300000,115818,Valérie Dijoux,451925,636107,2022-02-08
CASH_OUT,609734,Valérie Dijoux,636107,26373,Agence_mtn_Cotonou,300000,-309734,2022-02-11
TRANSFER,4336,Valérie Dijoux,26373,22037,Alfred du Lesage,254303,249967,2022-02-12
TRANSFER,19243,Inès de Letellier,203600,184357,Valérie Dijoux,22037,41280,2022-02-12
CASH_IN,66074,Agence_mtn_Cotonou,300000,233926,Valérie Dijoux,41280,107354,2022-02-16
CASH_IN,117203,Agence_mtn_Abomey,300000,182797,Valérie Dijoux,107354,224557,2022-02-16
CASH_OUT,86676,Valérie Dijoux,224557,137881,Agence_mtn_Abomey,300000,213324,2022-02-17
CASH_OUT,109072,Valérie Dijoux,137881,28809,Agence_mtn_Cotonou,300000,190928,2022-02-17
CASH_OUT,16454,Valérie Dijoux,28809,12355,Agence_mtn_Abomey,300000,283546,2022-02-19
TRANSFER,2771,Valérie Dijoux,12355,9584,Léon Martins-Briand,1819400,1816629,2022-02-19
CASH_OUT,8647,Valérie Dijoux,9584,937,Agence_mtn_Cotonou,300000,291353,2022-02-20
TRANSFER,1309950,Pénélope Ollivier,1643721,333771,Valérie Dijoux,937,1310887,2022-02-21
CASH_OUT,449640,Valérie Dijoux,1310887,861247,Agence_mtn_Abomey,300000,-149640,2022-02-21
TRANSFER,667435,Valérie Dijoux,861247,193812,Franck-Charles Texier,876900,209465,2022-02-22
CASH_IN,118883,Agence_mtn_Ouidah,300000,181117,Valérie Dijoux,193812,312695,2022-02-23
CASH_IN,180911,Agence_mtn_Ouidah,300000,119089,Valérie Dijoux,312695,493606,2022-02-23
CASH_IN,271210,Agence_mtn_Ouidah,300000,28790,Valérie Dijoux,493606,764816,2022-02-25
TRANSFER,121944,Valérie Dijoux,764816,642872,Rémy de la Roux,106263,-15681,2022-02-26
CASH_IN,218129,Agence_mtn_Ouidah,300000,81871,Valérie Dijoux,642872,861001,2022-02-26
CASH_IN,160201,Agence_mtn_Abomey,300000,139799,Valérie Dijoux,861001,1021202,2022-02-26
CASH_IN,35725,Agence_mtn_Ouidah,300000,264275,Valérie Dijoux,1021202,1056927,2022-02-27
CASH_OUT,718453,Xavier de Lebreton,868100,149647,Agence_mtn_Ouidah,300000,-418453,2022-02-01
CASH_IN,260094,Agence_mtn_Abomey,300000,39906,Xavier de Lebreton,149647,409741,2022-02-01
CASH_IN,232088,Agence_mtn_Cotonou,300000,67912,Xavier de Lebreton,409741,641829,2022-02-02
CASH_IN,76308,Agence_mtn_Cotonou,300000,223692,Xavier de Lebreton,641829,718137,2022-02-03
CASH_IN,254120,Agence_mtn_Cotonou,300000,45880,Xavier de Lebreton,718137,972257,2022-02-04
TRANSFER,391099,Éléonore-Hélène Dubois,692512,301413,Xavier de Lebreton,972257,1363356,2022-02-06
CASH_OUT,166299,Xavier de Lebreton,1363356,1197057,Agence_mtn_Ouidah,300000,133701,2022-02-06
TRANSFER,252782,Xavier de Lebreton,1197057,944275,Cécile Clerc,1820917,1568135,2022-02-07
CASH_OUT,852332,Xavier de Lebreton,944275,91943,Agence_mtn_Ouidah,300000,-552332,2022-02-07
CASH_IN,95046,Agence_mtn_Abomey,300000,204954,Xavier de Lebreton,91943,186989,2022-02-09
CASH_IN,267534,Agence_mtn_Ouidah,300000,32466,Xavier de Lebreton,186989,454523,2022-02-10
CASH_IN,60490,Agence_mtn_Ouidah,300000,239510,Xavier de Lebreton,454523,515013,2022-02-11
CASH_IN,295356,Agence_mtn_Cotonou,300000,4644,Xavier de Lebreton,515013,810369,2022-02-13
TRANSFER,323130,Xavier de Lebreton,810369,487239,Martine Wagner de la Bègue,908800,585670,2022-02-13
TRANSFER,214831,Xavier de Lebreton,487239,272408,Michelle Lebon,427800,212969,2022-02-13
CASH_OUT,258956,Xavier de Lebreton,272408,13452,Agence_mtn_Cotonou,300000,41044,2022-02-13
TRANSFER,101935,Éléonore-Hélène Dubois,301413,199478,Xavier de Lebreton,13452,115387,2022-02-16
TRANSFER,766851,François Michel-Legros,794300,27449,Xavier de Lebreton,115387,882238,2022-02-16
CASH_IN,48545,Agence_mtn_Cotonou,300000,251455,Xavier de Lebreton,882238,930783,2022-02-18
TRANSFER,772176,Simone Pineau,798100,25924,Xavier de Lebreton,930783,1702959,2022-02-19
CASH_IN,7211,Agence_mtn_Ouidah,300000,292789,Xavier de Lebreton,1702959,1710170,2022-02-20
TRANSFER,477105,Louise Girard,1187100,709995,Xavier de Lebreton,1710170,2187275,2022-02-20
CASH_IN,149035,Agence_mtn_Abomey,300000,150965,Xavier de Lebreton,2187275,2336310,2022-02-21
TRANSFER,233606,Gabriel-Tristan Marty,335600,101994,Xavier de Lebreton,2336310,2569916,2022-02-21
CASH_OUT,211171,Xavier de Lebreton,2569916,2358745,Agence_mtn_Abomey,300000,88829,2022-02-21
CASH_IN,55000,Agence_mtn_Abomey,300000,245000,Xavier de Lebreton,2358745,2413745,2022-02-24
CASH_OUT,352728,Xavier de Lebreton,2413745,2061017,Agence_mtn_Cotonou,300000,-52728,2022-02-26
TRANSFER,612303,Xavier de Lebreton,2061017,1448714,Simone Pineau,25924,-586379,2022-02-27
CASH_IN,127961,Agence_mtn_Cotonou,300000,172039,Xavier de Lebreton,1448714,1576675,2022-02-27
CASH_IN,158992,Agence_mtn_Abomey,300000,141008,Antoine Leleu,1448283,1607275,2022-02-01
TRANSFER,859771,Antoine Leleu,1607275,747504,Caroline-Lorraine Humbert,131874,-727897,2022-02-01
TRANSFER,159527,Richard Le Descamps,1739877,1580350,Antoine Leleu,747504,907031,2022-02-02
CASH_IN,172607,Agence_mtn_Ouidah,300000,127393,Antoine Leleu,907031,1079638,2022-02-03
CASH_IN,179049,Agence_mtn_Abomey,300000,120951,Antoine Leleu,1079638,1258687,2022-02-04
TRANSFER,123940,Alexandrie Delmas,345200,221260,Antoine Leleu,1258687,1382627,2022-02-04
CASH_OUT,626403,Antoine Leleu,1382627,756224,Agence_mtn_Cotonou,300000,-326403,2022-02-04
CASH_IN,210647,Agence_mtn_Ouidah,300000,89353,Antoine Leleu,756224,966871,2022-02-05
TRANSFER,7969,Pierre Reynaud,503600,495631,Antoine Leleu,966871,974840,2022-02-07
CASH_IN,205596,Agence_mtn_Cotonou,300000,94404,Antoine Leleu,974840,1180436,2022-02-08
CASH_OUT,631349,Antoine Leleu,1180436,549087,Agence_mtn_Ouidah,300000,-331349,2022-02-08
TRANSFER,464785,Antoine Leleu,549087,84302,Léon Martins-Briand,1816629,1351844,2022-02-08
CASH_OUT,7286,Antoine Leleu,84302,77016,Agence_mtn_Ouidah,300000,292714,2022-02-09
TRANSFER,417657,Eugène Poulain,750700,333043,Antoine Leleu,77016,494673,2022-02-10
TRANSFER,970502,Bertrand Le Roux,1100025,129523,Antoine Leleu,494673,1465175,2022-02-10
TRANSFER,673190,Antoine Leleu,1465175,791985,Corinne-Louise Valentin,507000,-166190,2022-02-11
CASH_IN,288248,Agence_mtn_Cotonou,300000,11752,Antoine Leleu,791985,1080233,2022-02-11
TRANSFER,605199,David du Blondel,1468700,863501,Antoine Leleu,1080233,1685432,2022-02-12
TRANSFER,764062,Antoine Leleu,1685432,921370,Léon Martins-Briand,1351844,587782,2022-02-14
CASH_IN,157541,Agence_mtn_Abomey,300000,142459,Antoine Leleu,921370,1078911,2022-02-17
CASH_OUT,659358,Antoine Leleu,1078911,419553,Agence_mtn_Abomey,300000,-359358,2022-02-17
TRANSFER,282790,Thibaut Coulon,332364,49574,Antoine Leleu,419553,702343,2022-02-18
TRANSFER,183079,Céline Gomez,212600,29521,Antoine Leleu,702343,885422,2022-02-18
CASH_IN,224993,Agence_mtn_Ouidah,300000,75007,Antoine Leleu,885422,1110415,2022-02-20
CASH_OUT,641926,Antoine Leleu,1110415,468489,Agence_mtn_Ouidah,300000,-341926,2022-02-21
TRANSFER,173840,Pierre Reynaud,495631,321791,Antoine Leleu,468489,642329,2022-02-24
CASH_OUT,487075,Antoine Leleu,642329,155254,Agence_mtn_Cotonou,300000,-187075,2022-02-24
CASH_OUT,122819,Antoine Leleu,155254,32435,Agence_mtn_Ouidah,300000,177181,2022-02-25
CASH_IN,177005,Agence_mtn_Cotonou,300000,122995,Joséphine Gros,666500,843505,2022-02-02
CASH_IN,42983,Agence_mtn_Abomey,300000,257017,Joséphine Gros,843505,886488,2022-02-03
TRANSFER,489058,Vincent Fournier,633825,144767,Joséphine Gros,886488,1375546,2022-02-05
CASH_OUT,637945,Joséphine Gros,1375546,737601,Agence_mtn_Ouidah,300000,-337945,2022-02-06
CASH_IN,40316,Agence_mtn_Ouidah,300000,259684,Joséphine Gros,737601,777917,2022-02-07
TRANSFER,770837,Joséphine Gros,777917,7080,Gabriel Humbert,835600,64763,2022-02-07
CASH_IN,214297,Agence_mtn_Cotonou,300000,85703,Joséphine Gros,7080,221377,2022-02-07
CASH_OUT,12869,Joséphine Gros,221377,208508,Agence_mtn_Abomey,300000,287131,2022-02-08
CASH_IN,97864,Agence_mtn_Cotonou,300000,202136,Joséphine Gros,208508,306372,2022-02-09
CASH_OUT,194795,Joséphine Gros,306372,111577,Agence_mtn_Abomey,300000,105205,2022-02-09
CASH_OUT,100220,Joséphine Gros,111577,11357,Agence_mtn_Ouidah,300000,199780,2022-02-10
CASH_IN,37547,Agence_mtn_Abomey,300000,262453,Joséphine Gros,11357,48904,2022-02-11
CASH_IN,136891,Agence_mtn_Abomey,300000,163109,Joséphine Gros,48904,185795,2022-02-13
CASH_IN,247103,Agence_mtn_Ouidah,300000,52897,Joséphine Gros,185795,432898,2022-02-13
TRANSFER,205591,Franck-Charles Texier,209465,3874,Joséphine Gros,432898,638489,2022-02-15
TRANSFER,341436,Joséphine Gros,638489,297053,Léon Martins-Briand,587782,246346,2022-02-15
TRANSFER,134160,Marcelle Paris,644524,510364,Joséphine Gros,297053,431213,2022-02-15
CASH_OUT,197095,Joséphine Gros,431213,234118,Agence_mtn_Cotonou,300000,102905,2022-02-15
TRANSFER,181264,Joséphine Gros,234118,52854,Raymond Rossi,1337400,1156136,2022-02-17
CASH_IN,153733,Agence_mtn_Cotonou,300000,146267,Joséphine Gros,52854,206587,2022-02-18
CASH_IN,15469,Agence_mtn_Abomey,300000,284531,Joséphine Gros,206587,222056,2022-02-19
TRANSFER,270832,Gilbert Foucher,277100,6268,Joséphine Gros,222056,492888,2022-02-19
CASH_IN,293522,Agence_mtn_Cotonou,300000,6478,Joséphine Gros,492888,786410,2022-02-19
CASH_OUT,92931,Joséphine Gros,786410,693479,Agence_mtn_Cotonou,300000,207069,2022-02-22
CASH_IN,169212,Agence_mtn_Abomey,300000,130788,Joséphine Gros,693479,862691,2022-02-23
TRANSFER,80289,Bertrand Le Roux,129523,49234,Joséphine Gros,862691,942980,2022-02-23
TRANSFER,28002,Isabelle Rossi,118580,90578,Joséphine Gros,942980,970982,2022-02-25
CASH_IN,245419,Agence_mtn_Cotonou,300000,54581,Joséphine Gros,970982,1216401,2022-02-26
CASH_OUT,948374,Joséphine Gros,1216401,268027,Agence_mtn_Ouidah,300000,-648374,2022-02-27
CASH_IN,292115,Agence_mtn_Abomey,300000,7885,Pierre Roger,-73871,218244,2022-02-01
CASH_IN,287594,Agence_mtn_Ouidah,300000,12406,Pierre Roger,218244,505838,2022-02-02
CASH_OUT,486721,Pierre Roger,505838,19117,Agence_mtn_Abomey,300000,-186721,2022-02-03
CASH_OUT,2462,Pierre Roger,19117,16655,Agence_mtn_Cotonou,300000,297538,2022-02-03
TRANSFER,16076,Pierre Roger,16655,579,Pénélope Ollivier,333771,317695,2022-02-04
CASH_IN,152905,Agence_mtn_Cotonou,300000,147095,Pierre Roger,579,153484,2022-02-04
TRANSFER,28760,Pierre Roger,153484,124724,Jean Benard,248600,219840,2022-02-04
TRANSFER,47927,Pierre Roger,124724,76797,Eugène Poulain,333043,285116,2022-02-04
CASH_OUT,4993,Pierre Roger,76797,71804,Agence_mtn_Cotonou,300000,295007,2022-02-05
CASH_IN,222856,Agence_mtn_Abomey,300000,77144,Pierre Roger,71804,294660,2022-02-10
CASH_IN,277617,Agence_mtn_Ouidah,300000,22383,Pierre Roger,294660,572277,2022-02-11
CASH_OUT,239742,Pierre Roger,572277,332535,Agence_mtn_Ouidah,300000,60258,2022-02-11
CASH_IN,202791,Agence_mtn_Abomey,300000,97209,Pierre Roger,332535,535326,2022-02-12
CASH_OUT,186058,Pierre Roger,535326,349268,Agence_mtn_Ouidah,300000,113942,2022-02-12
CASH_IN,37833,Agence_mtn_Ouidah,300000,262167,Pierre Roger,349268,387101,2022-02-12
TRANSFER,98609,Inès de Letellier,184357,85748,Pierre Roger,387101,485710,2022-02-15
CASH_OUT,113246,Pierre Roger,485710,372464,Agence_mtn_Abomey,300000,186754,2022-02-15
CASH_OUT,147429,Pierre Roger,372464,225035,Agence_mtn_Abomey,300000,152571,2022-02-17
CASH_IN,185450,Agence_mtn_Abomey,300000,114550,Pierre Roger,225035,410485,2022-02-17
CASH_IN,29498,Agence_mtn_Abomey,300000,270502,Pierre Roger,410485,439983,2022-02-19
CASH_OUT,259188,Pierre Roger,439983,180795,Agence_mtn_Ouidah,300000,40812,2022-02-20
CASH_IN,269019,Agence_mtn_Cotonou,300000,30981,Pierre Roger,180795,449814,2022-02-21
CASH_IN,262520,Agence_mtn_Abomey,300000,37480,Pierre Roger,449814,712334,2022-02-21
TRANSFER,203362,Pierre Roger,712334,508972,Hortense Lemaire,207400,4038,2022-02-22
TRANSFER,14034,Pierre Roger,508972,494938,Alphonse Leclercq-Rousseau,1720800,1706766,2022-02-22
CASH_IN,151650,Agence_mtn_Abomey,300000,148350,Pierre Roger,494938,646588,2022-02-23
CASH_OUT,86009,Pierre Roger,646588,560579,Agence_mtn_Ouidah,300000,213991,2022-02-26
TRANSFER,327104,Pierre Roger,560579,233475,Geneviève De Oliveira-Michel,80700,-246404,2022-02-26
TRANSFER,103622,Pierre Roger,233475,129853,Adèle Labbé,148852,45230,2022-02-27
CASH_OUT,8769,Pierre Roger,129853,121084,Agence_mtn_Cotonou,300000,291231,2022-02-27
CASH_OUT,16887,Bertrand Le Roux,49234,32347,Agence_mtn_Abomey,300000,283113,2022-02-03
CASH_OUT,28475,Bertrand Le Roux,32347,3872,Agence_mtn_Abomey,300000,271525,2022-02-03
TRANSFER,1185,Céline Gomez,29521,28336,Bertrand Le Roux,3872,5057,2022-02-04
TRANSFER,1616311,Astrid Gay de la Brunet,1803400,187089,Bertrand Le Roux,5057,1621368,2022-02-05
CASH_OUT,1421423,Bertrand Le Roux,1621368,199945,Agence_mtn_Ouidah,300000,-1121423,2022-02-08
CASH_OUT,132101,Bertrand Le Roux,199945,67844,Agence_mtn_Ouidah,300000,167899,2022-02-09
CASH_IN,37721,Agence_mtn_Cotonou,300000,262279,Bertrand Le Roux,67844,105565,2022-02-12
TRANSFER,784960,William Lebrun,1288400,503440,Bertrand Le Roux,105565,890525,2022-02-12
CASH_OUT,558135,Bertrand Le Roux,890525,332390,Agence_mtn_Abomey,300000,-258135,2022-02-12
CASH_IN,130068,Agence_mtn_Ouidah,300000,169932,Bertrand Le Roux,332390,462458,2022-02-12
CASH_IN,196201,Agence_mtn_Cotonou,300000,103799,Bertrand Le Roux,462458,658659,2022-02-15
CASH_OUT,575702,Bertrand Le Roux,658659,82957,Agence_mtn_Abomey,300000,-275702,2022-02-15
CASH_IN,273666,Agence_mtn_Ouidah,300000,26334,Bertrand Le Roux,82957,356623,2022-02-16
TRANSFER,136357,Vincent Fournier,144767,8410,Bertrand Le Roux,356623,492980,2022-02-17
TRANSFER,11345,Thibaut Coulon,49574,38229,Bertrand Le Roux,492980,504325,2022-02-19
TRANSFER,21931,Céline Gomez,28336,6405,Bertrand Le Roux,504325,526256,2022-02-20
CASH_IN,127010,Agence_mtn_Abomey,300000,172990,Bertrand Le Roux,526256,653266,2022-02-22
CASH_OUT,76413,Bertrand Le Roux,653266,576853,Agence_mtn_Ouidah,300000,223587,2022-02-23
TRANSFER,556881,Louis Pichon,764600,207719,Bertrand Le Roux,576853,1133734,2022-02-24
TRANSFER,7104,Thibaut Coulon,38229,31125,Bertrand Le Roux,1133734,1140838,2022-02-24
TRANSFER,872439,Frédéric Couturier,1946800,1074361,Bertrand Le Roux,1140838,2013277,2022-02-25
TRANSFER,936320,Bertrand Le Roux,2013277,1076957,Nath Bruneau,1583200,646880,2022-02-27
CASH_IN,133649,Agence_mtn_Abomey,300000,166351,Nath Bruneau,646880,780529,2022-02-01
CASH_IN,132080,Agence_mtn_Abomey,300000,167920,Nath Bruneau,780529,912609,2022-02-01
CASH_IN,117769,Agence_mtn_Ouidah,300000,182231,Nath Bruneau,912609,1030378,2022-02-01
CASH_IN,187084,Agence_mtn_Ouidah,300000,112916,Nath Bruneau,1030378,1217462,2022-02-02
CASH_IN,207674,Agence_mtn_Abomey,300000,92326,Nath Bruneau,1217462,1425136,2022-02-03
CASH_IN,36143,Agence_mtn_Abomey,300000,263857,Nath Bruneau,1425136,1461279,2022-02-04
TRANSFER,417776,Nath Bruneau,1461279,1043503,David du Blondel,863501,445725,2022-02-05
TRANSFER,180575,Louis Pichon,207719,27144,Nath Bruneau,1043503,1224078,2022-02-06
CASH_OUT,651112,Nath Bruneau,1224078,572966,Agence_mtn_Cotonou,300000,-351112,2022-02-07
CASH_IN,100727,Agence_mtn_Cotonou,300000,199273,Nath Bruneau,572966,673693,2022-02-08
TRANSFER,79574,Éléonore-Hélène Dubois,199478,119904,Nath Bruneau,673693,753267,2022-02-08
TRANSFER,271759,David Guérin,502161,230402,Nath Bruneau,753267,1025026,2022-02-10
TRANSFER,1780,François Michel-Legros,27449,25669,Nath Bruneau,1025026,1026806,2022-02-11
CASH_IN,222894,Agence_mtn_Ouidah,300000,77106,Nath Bruneau,1026806,1249700,2022-02-12
TRANSFER,848439,Nath Bruneau,1249700,401261,Alexandre Rémy,663600,-184839,2022-02-14
CASH_OUT,390674,Nath Bruneau,401261,10587,Agence_mtn_Cotonou,300000,-90674,2022-02-14
CASH_IN,52926,Agence_mtn_Abomey,300000,247074,Nath Bruneau,10587,63513,2022-02-14
CASH_OUT,41652,Nath Bruneau,63513,21861,Agence_mtn_Abomey,300000,258348,2022-02-14
CASH_IN,111421,Agence_mtn_Ouidah,300000,188579,Nath Bruneau,21861,133282,2022-02-17
CASH_OUT,123623,Nath Bruneau,133282,9659,Agence_mtn_Abomey,300000,176377,2022-02-17
CASH_OUT,5194,Nath Bruneau,9659,4465,Agence_mtn_Cotonou,300000,294806,2022-02-18
CASH_OUT,3997,Nath Bruneau,4465,468,Agence_mtn_Cotonou,300000,296003,2022-02-23
CASH_IN,58177,Agence_mtn_Abomey,300000,241823,Nath Bruneau,468,58645,2022-02-27
CASH_OUT,4834,Gilbert Foucher,6268,1434,Agence_mtn_Ouidah,300000,295166,2022-02-01
CASH_OUT,228,Gilbert Foucher,1434,1206,Agence_mtn_Ouidah,300000,299772,2022-02-01
CASH_OUT,848,Gilbert Foucher,1206,358,Agence_mtn_Abomey,300000,299152,2022-02-01
TRANSFER,115533,Alphonse Le Olivier,117497,1964,Gilbert Foucher,358,115891,2022-02-03
CASH_OUT,12234,Gilbert Foucher,115891,103657,Agence_mtn_Cotonou,300000,287766,2022-02-04
TRANSFER,10030,Louis Pichon,27144,17114,Gilbert Foucher,103657,113687,2022-02-05
TRANSFER,101445,Gilbert Foucher,113687,12242,Vincent Fournier,8410,-93035,2022-02-07
TRANSFER,2711,Gilbert Foucher,12242,9531,Honoré du Laurent,96634,93923,2022-02-07
TRANSFER,451980,Marcelle Paris,510364,58384,Gilbert Foucher,9531,461511,2022-02-10
CASH_IN,292904,Agence_mtn_Abomey,300000,7096,Gilbert Foucher,461511,754415,2022-02-11
CASH_IN,57252,Agence_mtn_Abomey,300000,242748,Gilbert Foucher,754415,811667,2022-02-12
CASH_OUT,240590,Gilbert Foucher,811667,571077,Agence_mtn_Abomey,300000,59410,2022-02-12
CASH_OUT,513265,Gilbert Foucher,571077,57812,Agence_mtn_Cotonou,300000,-213265,2022-02-12
CASH_OUT,1774,Gilbert Foucher,57812,56038,Agence_mtn_Abomey,300000,298226,2022-02-13
CASH_IN,266578,Agence_mtn_Abomey,300000,33422,Gilbert Foucher,56038,322616,2022-02-14
CASH_IN,42519,Agence_mtn_Cotonou,300000,257481,Gilbert Foucher,322616,365135,2022-02-17
CASH_IN,291804,Agence_mtn_Abomey,300000,8196,Gilbert Foucher,365135,656939,2022-02-18
CASH_IN,41474,Agence_mtn_Cotonou,300000,258526,Gilbert Foucher,656939,698413,2022-02-18
TRANSFER,683513,Gilbert Foucher,698413,14900,Victoire-Nicole Lopez,286000,-397513,2022-02-18
TRANSFER,18985,Eugène Poulain,285116,266131,Gilbert Foucher,14900,33885,2022-02-19
CASH_OUT,26371,Gilbert Foucher,33885,7514,Agence_mtn_Abomey,300000,273629,2022-02-20
CASH_OUT,5409,Gilbert Foucher,7514,2105,Agence_mtn_Abomey,300000,294591,2022-02-20
CASH_OUT,2062,Gilbert Foucher,2105,43,Agence_mtn_Abomey,300000,297938,2022-02-20
CASH_IN,232684,Agence_mtn_Abomey,300000,67316,Gilbert Foucher,43,232727,2022-02-21
CASH_OUT,118508,Gilbert Foucher,232727,114219,Agence_mtn_Cotonou,300000,181492,2022-02-26
TRANSFER,67883,Gilbert Foucher,114219,46336,Eugène Poulain,266131,198248,2022-02-27
CASH_IN,217592,Agence_mtn_Ouidah,300000,82408,Gabriel-Tristan Marty,101994,319586,2022-02-01
CASH_OUT,124698,Gabriel-Tristan Marty,319586,194888,Agence_mtn_Ouidah,300000,175302,2022-02-03
TRANSFER,117155,Gabriel-Tristan Marty,194888,77733,Zoé Renaud de Boutin,96800,-20355,2022-02-04
CASH_IN,211375,Agence_mtn_Abomey,300000,88625,Gabriel-Tristan Marty,77733,289108,2022-02-05
CASH_IN,71528,Agence_mtn_Abomey,300000,228472,Gabriel-Tristan Marty,289108,360636,2022-02-05
TRANSFER,991572,Cécile Clerc,1568135,576563,Gabriel-Tristan Marty,360636,1352208,2022-02-07
CASH_OUT,232860,Gabriel-Tristan Marty,1352208,1119348,Agence_mtn_Ouidah,300000,67140,2022-02-08
TRANSFER,573250,Gabriel-Tristan Marty,1119348,546098,Gabriel-Tristan Marty,1119348,546098,2022-02-08
CASH_IN,127379,Agence_mtn_Abomey,300000,172621,Gabriel-Tristan Marty,546098,673477,2022-02-08
CASH_IN,269824,Agence_mtn_Cotonou,300000,30176,Gabriel-Tristan Marty,673477,943301,2022-02-08
CASH_OUT,256011,Gabriel-Tristan Marty,943301,687290,Agence_mtn_Abomey,300000,43989,2022-02-09
CASH_IN,78908,Agence_mtn_Cotonou,300000,221092,Gabriel-Tristan Marty,687290,766198,2022-02-11
CASH_IN,148183,Agence_mtn_Abomey,300000,151817,Gabriel-Tristan Marty,766198,914381,2022-02-11
CASH_OUT,105819,Gabriel-Tristan Marty,914381,808562,Agence_mtn_Ouidah,300000,194181,2022-02-12
CASH_IN,92346,Agence_mtn_Ouidah,300000,207654,Gabriel-Tristan Marty,808562,900908,2022-02-12
CASH_OUT,565279,Gabriel-Tristan Marty,900908,335629,Agence_mtn_Abomey,300000,-265279,2022-02-13
CASH_OUT,94380,Gabriel-Tristan Marty,335629,241249,Agence_mtn_Ouidah,300000,205620,2022-02-14
CASH_IN,16428,Agence_mtn_Cotonou,300000,283572,Gabriel-Tristan Marty,241249,257677,2022-02-14
CASH_IN,229189,Agence_mtn_Cotonou,300000,70811,Gabriel-Tristan Marty,257677,486866,2022-02-16
CASH_IN,71677,Agence_mtn_Cotonou,300000,228323,Gabriel-Tristan Marty,486866,558543,2022-02-18
TRANSFER,5028,Louis Pichon,17114,12086,Gabriel-Tristan Marty,558543,563571,2022-02-21
TRANSFER,800342,Laurent-Bertrand Lefort,1352800,552458,Gabriel-Tristan Marty,563571,1363913,2022-02-22
TRANSFER,547269,Laurent-Bertrand Lefort,552458,5189,Gabriel-Tristan Marty,1363913,1911182,2022-02-26
CASH_IN,211012,Agence_mtn_Cotonou,300000,88988,Gabriel-Tristan Marty,1911182,2122194,2022-02-27
TRANSFER,537871,Thibault Moreno,832200,294329,Gabriel-Tristan Marty,2122194,2660065,2022-02-27
TRANSFER,36662,David Guérin,230402,193740,David Guérin,230402,193740,2022-02-02
CASH_IN,136020,Agence_mtn_Abomey,300000,163980,David Guérin,193740,329760,2022-02-02
CASH_IN,134210,Agence_mtn_Cotonou,300000,165790,David Guérin,329760,463970,2022-02-03
CASH_IN,91389,Agence_mtn_Cotonou,300000,208611,David Guérin,463970,555359,2022-02-03
CASH_OUT,446370,David Guérin,555359,108989,Agence_mtn_Cotonou,300000,-146370,2022-02-04
CASH_IN,86465,Agence_mtn_Abomey,300000,213535,David Guérin,108989,195454,2022-02-06
TRANSFER,132832,David Guérin,195454,62622,Adèle Labbé,45230,-87602,2022-02-07
CASH_OUT,8300,David Guérin,62622,54322,Agence_mtn_Cotonou,300000,291700,2022-02-07
CASH_IN,227909,Agence_mtn_Abomey,300000,72091,David Guérin,54322,282231,2022-02-08
CASH_OUT,48282,David Guérin,282231,233949,Agence_mtn_Ouidah,300000,251718,2022-02-09
CASH_OUT,33533,David Guérin,233949,200416,Agence_mtn_Ouidah,300000,266467,2022-02-09
TRANSFER,1543,Franck-Charles Texier,3874,2331,David Guérin,200416,201959,2022-02-11
CASH_OUT,110267,David Guérin,201959,91692,Agence_mtn_Ouidah,300000,189733,2022-02-13
CASH_OUT,5077,David Guérin,91692,86615,Agence_mtn_Abomey,300000,294923,2022-02-14
CASH_IN,280326,Agence_mtn_Ouidah,300000,19674,David Guérin,86615,366941,2022-02-15
TRANSFER,52827,Inès de Letellier,85748,32921,David Guérin,366941,419768,2022-02-15
CASH_IN,128861,Agence_mtn_Abomey,300000,171139,David Guérin,419768,548629,2022-02-17
TRANSFER,155550,David Guérin,548629,393079,François Michel-Legros,25669,-129881,2022-02-17
CASH_IN,68008,Agence_mtn_Abomey,300000,231992,David Guérin,393079,461087,2022-02-18
CASH_IN,51759,Agence_mtn_Cotonou,300000,248241,David Guérin,461087,512846,2022-02-18
CASH_OUT,309382,David Guérin,512846,203464,Agence_mtn_Cotonou,300000,-9382,2022-02-18
CASH_IN,287300,Agence_mtn_Abomey,300000,12700,David Guérin,203464,490764,2022-02-20
TRANSFER,776113,Raymond Rossi,1156136,380023,David Guérin,490764,1266877,2022-02-20
TRANSFER,976098,Frédéric Couturier,1074361,98263,David Guérin,1266877,2242975,2022-02-22
TRANSFER,281962,Thibault Moreno,294329,12367,Claude Foucher,75395,-206567,2022-02-01
CASH_OUT,10921,Thibault Moreno,12367,1446,Agence_mtn_Cotonou,300000,289079,2022-02-04
CASH_OUT,1349,Thibault Moreno,1446,97,Agence_mtn_Abomey,300000,298651,2022-02-04
CASH_IN,199996,Agence_mtn_Cotonou,300000,100004,Thibault Moreno,97,200093,2022-02-04
CASH_IN,57567,Agence_mtn_Ouidah,300000,242433,Thibault Moreno,200093,257660,2022-02-05
CASH_IN,103990,Agence_mtn_Ouidah,300000,196010,Thibault Moreno,257660,361650,2022-02-06
TRANSFER,80314,Alexandrie Delmas,221260,140946,Thibault Moreno,361650,441964,2022-02-06
CASH_IN,275157,Agence_mtn_Ouidah,300000,24843,Thibault Moreno,441964,717121,2022-02-06
TRANSFER,537739,Thibault Moreno,717121,179382,Étienne Roche,183900,-353839,2022-02-07
CASH_OUT,66617,Thibault Moreno,179382,112765,Agence_mtn_Cotonou,300000,233383,2022-02-08
CASH_IN,22857,Agence_mtn_Abomey,300000,277143,Thibault Moreno,112765,135622,2022-02-08
TRANSFER,184730,Marine Chauvet-Potier,232930,48200,Thibault Moreno,135622,320352,2022-02-09
CASH_OUT,170712,Thibault Moreno,320352,149640,Agence_mtn_Abomey,300000,129288,2022-02-10
CASH_IN,96257,Agence_mtn_Cotonou,300000,203743,Thibault Moreno,149640,245897,2022-02-11
CASH_IN,44800,Agence_mtn_Abomey,300000,255200,Thibault Moreno,245897,290697,2022-02-11
CASH_IN,110678,Agence_mtn_Abomey,300000,189322,Thibault Moreno,290697,401375,2022-02-12
CASH_IN,272101,Agence_mtn_Abomey,300000,27899,Thibault Moreno,401375,673476,2022-02-12
TRANSFER,654172,Thibault Moreno,673476,19304,Astrid Gay de la Brunet,187089,-467083,2022-02-12
TRANSFER,3628,Thibault Moreno,19304,15676,Inès de Letellier,32921,29293,2022-02-13
CASH_OUT,5543,Thibault Moreno,15676,10133,Agence_mtn_Abomey,300000,294457,2022-02-15
TRANSFER,31416,Éléonore-Hélène Dubois,119904,88488,Thibault Moreno,10133,41549,2022-02-16
CASH_OUT,1048,Thibault Moreno,41549,40501,Agence_mtn_Cotonou,300000,298952,2022-02-17
CASH_IN,80041,Agence_mtn_Cotonou,300000,219959,Thibault Moreno,40501,120542,2022-02-18
CASH_OUT,79218,Thibault Moreno,120542,41324,Agence_mtn_Ouidah,300000,220782,2022-02-18
CASH_IN,115050,Agence_mtn_Ouidah,300000,184950,Thibault Moreno,41324,156374,2022-02-18
CASH_OUT,134756,Thibault Moreno,156374,21618,Agence_mtn_Ouidah,300000,165244,2022-02-20
CASH_IN,18507,Agence_mtn_Ouidah,300000,281493,Thibault Moreno,21618,40125,2022-02-26
CASH_OUT,30675,Thibault Moreno,40125,9450,Agence_mtn_Abomey,300000,269325,2022-02-26
TRANSFER,4399,Thibault Moreno,9450,5051,Martine Wagner de la Bègue,585670,581271,2022-02-27
CASH_OUT,36367,Honoré du Laurent,93923,57556,Agence_mtn_Cotonou,300000,263633,2022-02-01
CASH_OUT,53011,Honoré du Laurent,57556,4545,Agence_mtn_Ouidah,300000,246989,2022-02-01
TRANSFER,3455,Honoré du Laurent,4545,1090,Alexandrie Delmas,140946,137491,2022-02-01
CASH_IN,33565,Agence_mtn_Abomey,300000,266435,Honoré du Laurent,1090,34655,2022-02-02
CASH_OUT,4569,Honoré du Laurent,34655,30086,Agence_mtn_Cotonou,300000,295431,2022-02-02
CASH_OUT,1713,Honoré du Laurent,30086,28373,Agence_mtn_Cotonou,300000,298287,2022-02-03
CASH_OUT,3707,Honoré du Laurent,28373,24666,Agence_mtn_Cotonou,300000,296293,2022-02-04
TRANSFER,1152,Honoré du Laurent,24666,23514,Léon Lecoq,1218400,1217248,2022-02-04
CASH_OUT,4482,Honoré du Laurent,23514,19032,Agence_mtn_Ouidah,300000,295518,2022-02-06
TRANSFER,10637,Michelle Lebon,212969,202332,Honoré du Laurent,19032,29669,2022-02-07
TRANSFER,1303692,Richard Le Descamps,1580350,276658,Honoré du Laurent,29669,1333361,2022-02-07
TRANSFER,435753,Honoré du Laurent,1333361,897608,Aurore Guyon,1133200,697447,2022-02-07
CASH_OUT,791355,Honoré du Laurent,897608,106253,Agence_mtn_Ouidah,300000,-491355,2022-02-08
CASH_IN,218432,Agence_mtn_Cotonou,300000,81568,Honoré du Laurent,106253,324685,2022-02-08
CASH_IN,167356,Agence_mtn_Abomey,300000,132644,Honoré du Laurent,324685,492041,2022-02-09
TRANSFER,483373,Léon Lecoq,1217248,733875,Honoré du Laurent,492041,975414,2022-02-12
CASH_OUT,532058,Honoré du Laurent,975414,443356,Agence_mtn_Cotonou,300000,-232058,2022-02-12
CASH_IN,142151,Agence_mtn_Cotonou,300000,157849,Honoré du Laurent,443356,585507,2022-02-12
CASH_OUT,271678,Honoré du Laurent,585507,313829,Agence_mtn_Cotonou,300000,28322,2022-02-13
CASH_OUT,223008,Honoré du Laurent,313829,90821,Agence_mtn_Abomey,300000,76992,2022-02-16
CASH_OUT,50189,Honoré du Laurent,90821,40632,Agence_mtn_Cotonou,300000,249811,2022-02-19
CASH_OUT,38511,Honoré du Laurent,40632,2121,Agence_mtn_Ouidah,300000,261489,2022-02-21
CASH_OUT,1170,Honoré du Laurent,2121,951,Agence_mtn_Ouidah,300000,298830,2022-02-23
TRANSFER,266239,Aurore Guyon,697447,431208,Honoré du Laurent,951,267190,2022-02-23
TRANSFER,148246,Pierre Reynaud,321791,173545,Honoré du Laurent,267190,415436,2022-02-24
TRANSFER,273626,Honoré du Laurent,415436,141810,Martine Wagner de la Bègue,581271,307645,2022-02-24
CASH_OUT,32936,Honoré du Laurent,141810,108874,Agence_mtn_Abomey,300000,267064,2022-02-27
CASH_IN,292388,Agence_mtn_Abomey,300000,7612,Marine Chauvet-Potier,48200,340588,2022-02-03
CASH_IN,136919,Agence_mtn_Abomey,300000,163081,Marine Chauvet-Potier,340588,477507,2022-02-03
TRANSFER,128721,Philippine Courtois,1379000,1250279,Marine Chauvet-Potier,477507,606228,2022-02-04
CASH_OUT,115088,Marine Chauvet-Potier,606228,491140,Agence_mtn_Abomey,300000,184912,2022-02-05
CASH_OUT,269001,Marine Chauvet-Potier,491140,222139,Agence_mtn_Abomey,300000,30999,2022-02-07
TRANSFER,380054,Aurore Guyon,431208,51154,Marine Chauvet-Potier,222139,602193,2022-02-07
TRANSFER,24583,Marine Chauvet-Potier,602193,577610,Théodore De Oliveira-Nicolas,1808500,1783917,2022-02-11
TRANSFER,374882,Marine Chauvet-Potier,577610,202728,Léon Martins-Briand,246346,-128536,2022-02-11
TRANSFER,178328,Marine Chauvet-Potier,202728,24400,Geneviève Grondin,309909,131581,2022-02-12
TRANSFER,14179,Marine Chauvet-Potier,24400,10221,Alphonse Le Olivier,1964,-12215,2022-02-12
CASH_OUT,4342,Marine Chauvet-Potier,10221,5879,Agence_mtn_Cotonou,300000,295658,2022-02-13
TRANSFER,61687,Alfred du Lesage,249967,188280,Marine Chauvet-Potier,5879,67566,2022-02-15
CASH_IN,163212,Agence_mtn_Abomey,300000,136788,Marine Chauvet-Potier,67566,230778,2022-02-15
CASH_OUT,160123,Marine Chauvet-Potier,230778,70655,Agence_mtn_Abomey,300000,139877,2022-02-16
CASH_IN,101535,Agence_mtn_Abomey,300000,198465,Marine Chauvet-Potier,70655,172190,2022-02-16
CASH_OUT,20414,Marine Chauvet-Potier,172190,151776,Agence_mtn_Cotonou,300000,279586,2022-02-17
CASH_IN,231920,Agence_mtn_Abomey,300000,68080,Marine Chauvet-Potier,151776,383696,2022-02-18
TRANSFER,313234,Marine Chauvet-Potier,383696,70462,Philippine Courtois,1250279,937045,2022-02-21
TRANSFER,57667,Marine Chauvet-Potier,70462,12795,Thibaut Coulon,31125,-26542,2022-02-22
CASH_OUT,1689,Marine Chauvet-Potier,12795,11106,Agence_mtn_Abomey,300000,298311,2022-02-26
CASH_OUT,10094,Marine Chauvet-Potier,11106,1012,Agence_mtn_Cotonou,300000,289906,2022-02-27
TRANSFER,1028627,Inès Hamon,1382100,353473,Céline Gomez,6405,1035032,2022-02-01
TRANSFER,114974,Geneviève Grondin,131581,16607,Céline Gomez,1035032,1150006,2022-02-03
TRANSFER,428113,Céline Gomez,1150006,721893,Geneviève Grondin,16607,-411506,2022-02-06
TRANSFER,524206,Céline Gomez,721893,197687,William Lebrun,503440,-20766,2022-02-07
TRANSFER,181285,Valentine Richard-Bourdon,334543,153258,Céline Gomez,197687,378972,2022-02-07
TRANSFER,300182,Raymond Rossi,380023,79841,Céline Gomez,378972,679154,2022-02-09
CASH_IN,48295,Agence_mtn_Abomey,300000,251705,Céline Gomez,679154,727449,2022-02-10
CASH_IN,52238,Agence_mtn_Abomey,300000,247762,Céline Gomez,727449,779687,2022-02-12
CASH_IN,13055,Agence_mtn_Ouidah,300000,286945,Céline Gomez,779687,792742,2022-02-13
CASH_IN,164775,Agence_mtn_Ouidah,300000,135225,Céline Gomez,792742,957517,2022-02-15
TRANSFER,347092,Inès Hamon,353473,6381,Céline Gomez,957517,1304609,2022-02-16
CASH_IN,292211,Agence_mtn_Cotonou,300000,7789,Céline Gomez,1304609,1596820,2022-02-18
TRANSFER,521830,Cécile Clerc,576563,54733,Céline Gomez,1596820,2118650,2022-02-20
CASH_IN,285340,Agence_mtn_Cotonou,300000,14660,Céline Gomez,2118650,2403990,2022-02-20
CASH_OUT,1578626,Céline Gomez,2403990,825364,Agence_mtn_Ouidah,300000,-1278626,2022-02-20
CASH_OUT,735568,Céline Gomez,825364,89796,Agence_mtn_Ouidah,300000,-435568,2022-02-20
CASH_IN,24662,Agence_mtn_Cotonou,300000,275338,Céline Gomez,89796,114458,2022-02-21
TRANSFER,22700,Céline Gomez,114458,91758,Michelle Lebon,202332,179632,2022-02-22
CASH_IN,268456,Agence_mtn_Cotonou,300000,31544,Céline Gomez,91758,360214,2022-02-23
TRANSFER,1168784,Théodore De Oliveira-Nicolas,1783917,615133,Céline Gomez,360214,1528998,2022-02-24
TRANSFER,227673,Alphonse Leclercq-Rousseau,1706766,1479093,Céline Gomez,1528998,1756671,2022-02-24
CASH_IN,70348,Agence_mtn_Cotonou,300000,229652,Céline Gomez,1756671,1827019,2022-02-25
CASH_OUT,1586724,Céline Gomez,1827019,240295,Agence_mtn_Ouidah,300000,-1286724,2022-02-26
CASH_IN,103128,Agence_mtn_Ouidah,300000,196872,Raymond Rossi,79841,182969,2022-02-02
TRANSFER,127790,Michelle Lebon,179632,51842,Raymond Rossi,182969,310759,2022-02-03
TRANSFER,210859,Léon Lecoq,733875,523016,Raymond Rossi,310759,521618,2022-02-03
CASH_IN,277121,Agence_mtn_Cotonou,300000,22879,Raymond Rossi,521618,798739,2022-02-06
CASH_OUT,106643,Raymond Rossi,798739,692096,Agence_mtn_Ouidah,300000,193357,2022-02-07
CASH_IN,107300,Agence_mtn_Abomey,300000,192700,Raymond Rossi,692096,799396,2022-02-09
CASH_IN,102416,Agence_mtn_Cotonou,300000,197584,Raymond Rossi,799396,901812,2022-02-12
CASH_OUT,674728,Raymond Rossi,901812,227084,Agence_mtn_Abomey,300000,-374728,2022-02-12
CASH_IN,245642,Agence_mtn_Ouidah,300000,54358,Raymond Rossi,227084,472726,2022-02-14
TRANSFER,108813,Raymond Rossi,472726,363913,Pénélope Ollivier,317695,208882,2022-02-15
TRANSFER,4069,Inès de Letellier,29293,25224,Raymond Rossi,363913,367982,2022-02-15
CASH_IN,218400,Agence_mtn_Cotonou,300000,81600,Raymond Rossi,367982,586382,2022-02-15
CASH_IN,155593,Agence_mtn_Abomey,300000,144407,Raymond Rossi,586382,741975,2022-02-17
TRANSFER,252712,Raymond Rossi,741975,489263,Aurore Guyon,51154,-201558,2022-02-20
TRANSFER,1541,Louis Pichon,12086,10545,Raymond Rossi,489263,490804,2022-02-20
CASH_OUT,131058,Raymond Rossi,490804,359746,Agence_mtn_Ouidah,300000,168942,2022-02-23
CASH_OUT,106891,Raymond Rossi,359746,252855,Agence_mtn_Ouidah,300000,193109,2022-02-24
CASH_IN,5632,Agence_mtn_Abomey,300000,294368,Raymond Rossi,252855,258487,2022-02-25
CASH_OUT,119689,Raymond Rossi,258487,138798,Agence_mtn_Abomey,300000,180311,2022-02-26
CASH_IN,68927,Agence_mtn_Abomey,300000,231073,Raymond Rossi,138798,207725,2022-02-27
TRANSFER,99946,Eugène Poulain,198248,98302,Raymond Rossi,207725,307671,2022-02-27
CASH_IN,275143,Agence_mtn_Ouidah,300000,24857,Raymond Rossi,307671,582814,2022-02-27
CASH_IN,137070,Agence_mtn_Ouidah,300000,162930,Raymond Rossi,582814,719884,2022-02-27
CASH_IN,162851,Agence_mtn_Ouidah,300000,137149,Aurore Guyon,-201558,-38707,2022-02-01
CASH_IN,194620,Agence_mtn_Ouidah,300000,105380,Aurore Guyon,-38707,155913,2022-02-02
CASH_OUT,94375,Aurore Guyon,155913,61538,Agence_mtn_Abomey,300000,205625,2022-02-03
CASH_IN,24165,Agence_mtn_Cotonou,300000,275835,Aurore Guyon,61538,85703,2022-02-03
CASH_IN,96342,Agence_mtn_Cotonou,300000,203658,Aurore Guyon,85703,182045,2022-02-04
CASH_IN,189110,Agence_mtn_Abomey,300000,110890,Aurore Guyon,182045,371155,2022-02-05
CASH_IN,254248,Agence_mtn_Ouidah,300000,45752,Aurore Guyon,371155,625403,2022-02-06
TRANSFER,301442,Aurore Guyon,625403,323961,Théodore De Oliveira-Nicolas,615133,313691,2022-02-07
CASH_IN,132464,Agence_mtn_Cotonou,300000,167536,Aurore Guyon,323961,456425,2022-02-08
CASH_OUT,34548,Aurore Guyon,456425,421877,Agence_mtn_Abomey,300000,265452,2022-02-08
CASH_IN,250353,Agence_mtn_Ouidah,300000,49647,Aurore Guyon,421877,672230,2022-02-09
CASH_OUT,474276,Aurore Guyon,672230,197954,Agence_mtn_Cotonou,300000,-174276,2022-02-09
CASH_OUT,147040,Aurore Guyon,197954,50914,Agence_mtn_Cotonou,300000,152960,2022-02-09
TRANSFER,57375,Martine Wagner de la Bègue,307645,250270,Aurore Guyon,50914,108289,2022-02-09
CASH_OUT,9186,Aurore Guyon,108289,99103,Agence_mtn_Ouidah,300000,290814,2022-02-10
CASH_IN,171180,Agence_mtn_Cotonou,300000,128820,Aurore Guyon,99103,270283,2022-02-14
CASH_IN,70318,Agence_mtn_Abomey,300000,229682,Aurore Guyon,270283,340601,2022-02-15
TRANSFER,58092,Eugène Poulain,98302,40210,Aurore Guyon,340601,398693,2022-02-16
CASH_OUT,279466,Aurore Guyon,398693,119227,Agence_mtn_Cotonou,300000,20534,2022-02-16
TRANSFER,38628,Valentine Richard-Bourdon,153258,114630,Aurore Guyon,119227,157855,2022-02-17
CASH_OUT,31558,Aurore Guyon,157855,126297,Agence_mtn_Ouidah,300000,268442,2022-02-17
CASH_IN,85434,Agence_mtn_Cotonou,300000,214566,Aurore Guyon,126297,211731,2022-02-18
CASH_IN,282791,Agence_mtn_Abomey,300000,17209,Aurore Guyon,211731,494522,2022-02-20
CASH_OUT,287623,Aurore Guyon,494522,206899,Agence_mtn_Ouidah,300000,12377,2022-02-22
CASH_OUT,43650,Aurore Guyon,206899,163249,Agence_mtn_Abomey,300000,256350,2022-02-22
CASH_IN,274667,Agence_mtn_Ouidah,300000,25333,Aurore Guyon,163249,437916,2022-02-23
TRANSFER,54108,Valentine Richard-Bourdon,114630,60522,Aurore Guyon,437916,492024,2022-02-23
CASH_IN,251076,Agence_mtn_Abomey,300000,48924,Aurore Guyon,492024,743100,2022-02-25
CASH_OUT,726954,Aurore Guyon,743100,16146,Agence_mtn_Abomey,300000,-426954,2022-02-27
CASH_IN,31827,Agence_mtn_Abomey,300000,268173,Simone Pineau,-586379,-554552,2022-02-01
CASH_IN,237881,Agence_mtn_Abomey,300000,62119,Simone Pineau,-554552,-316671,2022-02-01
CASH_IN,210593,Agence_mtn_Abomey,300000,89407,Simone Pineau,-316671,-106078,2022-02-02
CASH_IN,292731,Agence_mtn_Ouidah,300000,7269,Simone Pineau,-106078,186653,2022-02-03
CASH_IN,263161,Agence_mtn_Abomey,300000,36839,Simone Pineau,186653,449814,2022-02-03
CASH_OUT,289600,Simone Pineau,449814,160214,Agence_mtn_Cotonou,300000,10400,2022-02-03
CASH_OUT,19811,Simone Pineau,160214,140403,Agence_mtn_Cotonou,300000,280189,2022-02-03
CASH_OUT,4063,Simone Pineau,140403,136340,Agence_mtn_Ouidah,300000,295937,2022-02-03
TRANSFER,24236,Simone Pineau,136340,112104,Léon Lecoq,523016,498780,2022-02-04
CASH_OUT,33008,Simone Pineau,112104,79096,Agence_mtn_Ouidah,300000,266992,2022-02-06
CASH_IN,138849,Agence_mtn_Abomey,300000,161151,Simone Pineau,79096,217945,2022-02-08
CASH_OUT,24426,Simone Pineau,217945,193519,Agence_mtn_Ouidah,300000,275574,2022-02-09
CASH_OUT,133198,Simone Pineau,193519,60321,Agence_mtn_Ouidah,300000,166802,2022-02-11
CASH_IN,258025,Agence_mtn_Abomey,300000,41975,Simone Pineau,60321,318346,2022-02-13
CASH_IN,136290,Agence_mtn_Abomey,300000,163710,Simone Pineau,318346,454636,2022-02-13
CASH_IN,245419,Agence_mtn_Cotonou,300000,54581,Simone Pineau,454636,700055,2022-02-14
CASH_OUT,502659,Simone Pineau,700055,197396,Agence_mtn_Cotonou,300000,-202659,2022-02-14
CASH_OUT,20647,Simone Pineau,197396,176749,Agence_mtn_Ouidah,300000,279353,2022-02-16
TRANSFER,62633,Simone Pineau,176749,114116,Simone Pineau,176749,239382,2022-02-17
TRANSFER,67989,Simone Pineau,114116,46127,David du Blondel,445725,377736,2022-02-17
TRANSFER,24933,Simone Pineau,46127,21194,Eugène Poulain,40210,15277,2022-02-18
CASH_OUT,20529,Simone Pineau,21194,665,Agence_mtn_Ouidah,300000,279471,2022-02-21
CASH_IN,180606,Agence_mtn_Cotonou,300000,119394,Simone Pineau,665,181271,2022-02-22
CASH_OUT,95041,Simone Pineau,181271,86230,Agence_mtn_Ouidah,300000,204959,2022-02-23
CASH_IN,289539,Agence_mtn_Ouidah,300000,10461,Simone Pineau,86230,375769,2022-02-23
CASH_OUT,34627,Simone Pineau,375769,341142,Agence_mtn_Ouidah,300000,265373,2022-02-24
CASH_IN,60246,Agence_mtn_Cotonou,300000,239754,Simone Pineau,341142,401388,2022-02-25
TRANSFER,26801,Simone Pineau,401388,374587,Jean Benard,219840,193039,2022-02-26
CASH_IN,285441,Agence_mtn_Abomey,300000,14559,Simone Pineau,374587,660028,2022-02-27
CASH_OUT,284005,Simone Pineau,660028,376023,Agence_mtn_Cotonou,300000,15995,2022-02-27
CASH_IN,288656,Agence_mtn_Ouidah,300000,11344,Roland Garcia,849000,1137656,2022-02-02
CASH_OUT,370158,Roland Garcia,1137656,767498,Agence_mtn_Ouidah,300000,-70158,2022-02-02
CASH_OUT,386138,Roland Garcia,767498,381360,Agence_mtn_Cotonou,300000,-86138,2022-02-03
CASH_OUT,205741,Roland Garcia,381360,175619,Agence_mtn_Ouidah,300000,94259,2022-02-04
TRANSFER,962687,Cécile Delattre-Arnaud,1331874,369187,Roland Garcia,175619,1138306,2022-02-04
TRANSFER,49053,Cécile Clerc,54733,5680,Roland Garcia,1138306,1187359,2022-02-04
CASH_IN,94477,Agence_mtn_Abomey,300000,205523,Roland Garcia,1187359,1281836,2022-02-06
TRANSFER,142377,Roland Garcia,1281836,1139459,Gabriel Humbert,64763,-77614,2022-02-08
CASH_IN,114112,Agence_mtn_Ouidah,300000,185888,Roland Garcia,1139459,1253571,2022-02-09
CASH_IN,125154,Agence_mtn_Abomey,300000,174846,Roland Garcia,1253571,1378725,2022-02-11
CASH_IN,124096,Agence_mtn_Abomey,300000,175904,Roland Garcia,1378725,1502821,2022-02-11
TRANSFER,7667,Inès de Letellier,25224,17557,Roland Garcia,1502821,1510488,2022-02-13
CASH_IN,40626,Agence_mtn_Ouidah,300000,259374,Roland Garcia,1510488,1551114,2022-02-14
TRANSFER,1233184,Roland Garcia,1551114,317930,Catherine Faivre,1653200,420016,2022-02-14
CASH_OUT,264163,Roland Garcia,317930,53767,Agence_mtn_Abomey,300000,35837,2022-02-15
CASH_IN,226126,Agence_mtn_Abomey,300000,73874,Roland Garcia,53767,279893,2022-02-15
CASH_OUT,78038,Roland Garcia,279893,201855,Agence_mtn_Cotonou,300000,221962,2022-02-15
CASH_OUT,136967,Roland Garcia,201855,64888,Agence_mtn_Cotonou,300000,163033,2022-02-16
CASH_OUT,46690,Roland Garcia,64888,18198,Agence_mtn_Cotonou,300000,253310,2022-02-16
TRANSFER,43988,Michelle Lebon,51842,7854,Roland Garcia,18198,62186,2022-02-18
CASH_IN,182763,Agence_mtn_Abomey,300000,117237,Roland Garcia,62186,244949,2022-02-19
CASH_IN,292309,Agence_mtn_Ouidah,300000,7691,Roland Garcia,244949,537258,2022-02-20
CASH_IN,105952,Agence_mtn_Abomey,300000,194048,Roland Garcia,537258,643210,2022-02-20
CASH_IN,222036,Agence_mtn_Cotonou,300000,77964,Roland Garcia,643210,865246,2022-02-21
CASH_OUT,345112,Roland Garcia,865246,520134,Agence_mtn_Cotonou,300000,-45112,2022-02-21
TRANSFER,135302,Cécile Delattre-Arnaud,369187,233885,Roland Garcia,520134,655436,2022-02-22
CASH_IN,49785,Agence_mtn_Cotonou,300000,250215,Roland Garcia,655436,705221,2022-02-24
CASH_OUT,297879,Roland Garcia,705221,407342,Agence_mtn_Abomey,300000,2121,2022-02-25
CASH_OUT,91301,Roland Garcia,407342,316041,Agence_mtn_Ouidah,300000,208699,2022-02-26
TRANSFER,93552,Frédéric Couturier,98263,4711,Alphonse Leclercq-Rousseau,1479093,1385541,2022-02-01
CASH_IN,148651,Agence_mtn_Abomey,300000,151349,Frédéric Couturier,4711,153362,2022-02-05
TRANSFER,119659,Frédéric Couturier,153362,33703,Hortense Lemaire,4038,-115621,2022-02-09
TRANSFER,20930,Frédéric Couturier,33703,12773,David du Blondel,377736,356806,2022-02-10
CASH_OUT,12274,Frédéric Couturier,12773,499,Agence_mtn_Cotonou,300000,287726,2022-02-11
TRANSFER,592445,Louise Girard,709995,117550,Frédéric Couturier,499,592944,2022-02-11
TRANSFER,28791,Cécile Delattre-Arnaud,233885,205094,Frédéric Couturier,592944,621735,2022-02-11
CASH_OUT,265516,Frédéric Couturier,621735,356219,Agence_mtn_Abomey,300000,34484,2022-02-11
TRANSFER,81126,Frédéric Couturier,356219,275093,Pénélope Ollivier,208882,127756,2022-02-12
TRANSFER,7024,Frédéric Couturier,275093,268069,Philippine Courtois,937045,930021,2022-02-13
CASH_IN,54512,Agence_mtn_Abomey,300000,245488,Frédéric Couturier,268069,322581,2022-02-14
TRANSFER,139572,Richard Le Descamps,276658,137086,Frédéric Couturier,322581,462153,2022-02-15
CASH_IN,160485,Agence_mtn_Ouidah,300000,139515,Frédéric Couturier,462153,622638,2022-02-15
TRANSFER,37391,Valentine Richard-Bourdon,60522,23131,Frédéric Couturier,622638,660029,2022-02-16
CASH_OUT,642162,Frédéric Couturier,660029,17867,Agence_mtn_Ouidah,300000,-342162,2022-02-16
CASH_OUT,17073,Frédéric Couturier,17867,794,Agence_mtn_Ouidah,300000,282927,2022-02-19
CASH_OUT,457,Frédéric Couturier,794,337,Agence_mtn_Cotonou,300000,299543,2022-02-20
CASH_IN,104470,Agence_mtn_Ouidah,300000,195530,Frédéric Couturier,337,104807,2022-02-20
CASH_OUT,42432,Frédéric Couturier,104807,62375,Agence_mtn_Cotonou,300000,257568,2022-02-22
TRANSFER,12317,Alfred du Lesage,188280,175963,Frédéric Couturier,62375,74692,2022-02-23
CASH_IN,216635,Agence_mtn_Ouidah,300000,83365,Frédéric Couturier,74692,291327,2022-02-23
TRANSFER,86551,Frédéric Couturier,291327,204776,Cécile Clerc,5680,-80871,2022-02-24
CASH_OUT,20116,Frédéric Couturier,204776,184660,Agence_mtn_Ouidah,300000,279884,2022-02-24
CASH_OUT,38597,Frédéric Couturier,184660,146063,Agence_mtn_Cotonou,300000,261403,2022-02-24
CASH_OUT,106308,Frédéric Couturier,146063,39755,Agence_mtn_Abomey,300000,193692,2022-02-25
CASH_OUT,29692,Frédéric Couturier,39755,10063,Agence_mtn_Abomey,300000,270308,2022-02-26
TRANSFER,6008,Valentine Richard-Bourdon,23131,17123,Isabelle Rossi,90578,84570,2022-02-01
CASH_OUT,6976,Valentine Richard-Bourdon,17123,10147,Agence_mtn_Ouidah,300000,293024,2022-02-01
TRANSFER,99227,Théodore De Oliveira-Nicolas,313691,214464,Valentine Richard-Bourdon,10147,109374,2022-02-02
CASH_IN,130306,Agence_mtn_Cotonou,300000,169694,Valentine Richard-Bourdon,109374,239680,2022-02-03
TRANSFER,34844,Valentine Richard-Bourdon,239680,204836,Marcelle Paris,58384,23540,2022-02-03
CASH_IN,73421,Agence_mtn_Ouidah,300000,226579,Valentine Richard-Bourdon,204836,278257,2022-02-04
TRANSFER,225077,Valentine Richard-Bourdon,278257,53180,Pénélope Ollivier,127756,-97321,2022-02-06
TRANSFER,40195,Valentine Richard-Bourdon,53180,12985,Marcelle Paris,23540,-16655,2022-02-06
CASH_IN,170817,Agence_mtn_Abomey,300000,129183,Valentine Richard-Bourdon,12985,183802,2022-02-06
CASH_IN,69100,Agence_mtn_Cotonou,300000,230900,Valentine Richard-Bourdon,183802,252902,2022-02-07
CASH_IN,92534,Agence_mtn_Abomey,300000,207466,Valentine Richard-Bourdon,252902,345436,2022-02-07
TRANSFER,429037,Tristan Thomas,430987,1950,Valentine Richard-Bourdon,345436,774473,2022-02-08
TRANSFER,38084,Valentine Richard-Bourdon,774473,736389,Tristan Thomas,1950,-36134,2022-02-09
CASH_OUT,603714,Valentine Richard-Bourdon,736389,132675,Agence_mtn_Ouidah,300000,-303714,2022-02-11
CASH_IN,227484,Agence_mtn_Abomey,300000,72516,Valentine Richard-Bourdon,132675,360159,2022-02-12
TRANSFER,1310,Eugène Poulain,15277,13967,Valentine Richard-Bourdon,360159,361469,2022-02-16
TRANSFER,139471,Alfred du Lesage,175963,36492,Valentine Richard-Bourdon,361469,500940,2022-02-16
CASH_IN,135338,Agence_mtn_Ouidah,300000,164662,Valentine Richard-Bourdon,500940,636278,2022-02-16
TRANSFER,435644,Valentine Richard-Bourdon,636278,200634,Franck-Charles Texier,2331,-433313,2022-02-17
TRANSFER,72989,Isabelle Rossi,84570,11581,Valentine Richard-Bourdon,200634,273623,2022-02-18
CASH_IN,69160,Agence_mtn_Cotonou,300000,230840,Valentine Richard-Bourdon,273623,342783,2022-02-18
CASH_IN,181238,Agence_mtn_Cotonou,300000,118762,Valentine Richard-Bourdon,342783,524021,2022-02-18
CASH_OUT,205955,Valentine Richard-Bourdon,524021,318066,Agence_mtn_Ouidah,300000,94045,2022-02-18
CASH_IN,146577,Agence_mtn_Cotonou,300000,153423,Valentine Richard-Bourdon,318066,464643,2022-02-19
CASH_IN,112187,Agence_mtn_Abomey,300000,187813,Valentine Richard-Bourdon,464643,576830,2022-02-23
TRANSFER,338402,Valentine Richard-Bourdon,576830,238428,Inès de Letellier,17557,-320845,2022-02-25
TRANSFER,185106,Valentine Richard-Bourdon,238428,53322,Margot Renaud,1055900,870794,2022-02-25
CASH_OUT,27072,Valentine Richard-Bourdon,53322,26250,Agence_mtn_Abomey,300000,272928,2022-02-26
CASH_IN,55820,Agence_mtn_Abomey,300000,244180,William Lebrun,-20766,35054,2022-02-03
CASH_OUT,19899,William Lebrun,35054,15155,Agence_mtn_Ouidah,300000,280101,2022-02-06
CASH_IN,54692,Agence_mtn_Ouidah,300000,245308,William Lebrun,15155,69847,2022-02-12
CASH_OUT,65706,William Lebrun,69847,4141,Agence_mtn_Ouidah,300000,234294,2022-02-13
TRANSFER,208437,David du Blondel,356806,148369,William Lebrun,4141,212578,2022-02-15
CASH_IN,28464,Agence_mtn_Cotonou,300000,271536,William Lebrun,212578,241042,2022-02-17
TRANSFER,62703,Richard Le Descamps,137086,74383,William Lebrun,241042,303745,2022-02-17
TRANSFER,8673,David du Blondel,148369,139696,William Lebrun,303745,312418,2022-02-25
CASH_IN,126232,Agence_mtn_Ouidah,300000,173768,Louis Pichon,10545,136777,2022-02-01
TRANSFER,63986,Cécile Delattre-Arnaud,205094,141108,Louis Pichon,136777,200763,2022-02-08
CASH_IN,199052,Agence_mtn_Cotonou,300000,100948,Louis Pichon,200763,399815,2022-02-10
CASH_OUT,184838,Louis Pichon,399815,214977,Agence_mtn_Cotonou,300000,115162,2022-02-10
TRANSFER,7643,Richard Le Descamps,74383,66740,Louis Pichon,214977,222620,2022-02-13
TRANSFER,43800,Jean Benard,193039,149239,Louis Pichon,222620,266420,2022-02-14
TRANSFER,28772,Louis Pichon,266420,237648,Alfred du Lesage,36492,7720,2022-02-15
CASH_OUT,171321,Louis Pichon,237648,66327,Agence_mtn_Abomey,300000,128679,2022-02-17
CASH_OUT,59825,Louis Pichon,66327,6502,Agence_mtn_Ouidah,300000,240175,2022-02-19
TRANSFER,45178,Alphonse Leclercq-Rousseau,1385541,1340363,Louis Pichon,6502,51680,2022-02-19
TRANSFER,3740,Laurent-Bertrand Lefort,5189,1449,Louis Pichon,51680,55420,2022-02-20
TRANSFER,11723,Louis Pichon,55420,43697,Michelle Lebon,7854,-3869,2022-02-24
CASH_IN,255927,Agence_mtn_Cotonou,300000,44073,Louis Pichon,43697,299624,2022-02-24
CASH_IN,175199,Agence_mtn_Cotonou,300000,124801,Louis Pichon,299624,474823,2022-02-24
CASH_IN,37558,Agence_mtn_Abomey,300000,262442,Louis Pichon,474823,512381,2022-02-25
CASH_IN,33479,Agence_mtn_Cotonou,300000,266521,Louis Pichon,512381,545860,2022-02-26
CASH_IN,275853,Agence_mtn_Abomey,300000,24147,Louis Pichon,545860,821713,2022-02-27
CASH_OUT,288,Laurent-Bertrand Lefort,1449,1161,Agence_mtn_Cotonou,300000,299712,2022-02-02
TRANSFER,835,Laurent-Bertrand Lefort,1161,326,Inès Hamon,6381,5546,2022-02-04
TRANSFER,104,Laurent-Bertrand Lefort,326,222,Catherine Faivre,420016,419912,2022-02-06
TRANSFER,102,Laurent-Bertrand Lefort,222,120,Alfred du Lesage,7720,7618,2022-02-07
CASH_IN,189055,Agence_mtn_Abomey,300000,110945,Laurent-Bertrand Lefort,120,189175,2022-02-07
CASH_IN,9022,Agence_mtn_Abomey,300000,290978,Laurent-Bertrand Lefort,189175,198197,2022-02-09
CASH_IN,295050,Agence_mtn_Cotonou,300000,4950,Laurent-Bertrand Lefort,198197,493247,2022-02-09
TRANSFER,136784,Alexandrie Delmas,137491,707,Laurent-Bertrand Lefort,493247,630031,2022-02-11
CASH_OUT,115988,Laurent-Bertrand Lefort,630031,514043,Agence_mtn_Abomey,300000,184012,2022-02-13
TRANSFER,159637,Laurent-Bertrand Lefort,514043,354406,Alfred du Lesage,7618,-152019,2022-02-16
CASH_IN,226123,Agence_mtn_Cotonou,300000,73877,Laurent-Bertrand Lefort,354406,580529,2022-02-17
CASH_IN,84018,Agence_mtn_Abomey,300000,215982,Laurent-Bertrand Lefort,580529,664547,2022-02-18
CASH_OUT,150571,Laurent-Bertrand Lefort,664547,513976,Agence_mtn_Ouidah,300000,149429,2022-02-20
TRANSFER,466087,Laurent-Bertrand Lefort,513976,47889,Alexandrie Delmas,707,-465380,2022-02-21
CASH_IN,67864,Agence_mtn_Cotonou,300000,232136,Laurent-Bertrand Lefort,47889,115753,2022-02-21
CASH_OUT,40052,Laurent-Bertrand Lefort,115753,75701,Agence_mtn_Cotonou,300000,259948,2022-02-21
CASH_OUT,428,Laurent-Bertrand Lefort,75701,75273,Agence_mtn_Ouidah,300000,299572,2022-02-23
CASH_OUT,75000,Laurent-Bertrand Lefort,75273,273,Agence_mtn_Cotonou,300000,225000,2022-02-27
TRANSFER,138268,David du Blondel,139696,1428,Jean Benard,149239,10971,2022-02-05
CASH_OUT,167,David du Blondel,1428,1261,Agence_mtn_Cotonou,300000,299833,2022-02-06
CASH_IN,298325,Agence_mtn_Ouidah,300000,1675,David du Blondel,1261,299586,2022-02-06
CASH_OUT,202890,David du Blondel,299586,96696,Agence_mtn_Abomey,300000,97110,2022-02-08
CASH_IN,299034,Agence_mtn_Ouidah,300000,966,David du Blondel,96696,395730,2022-02-20
TRANSFER,138609,David du Blondel,395730,257121,Martine Wagner de la Bègue,250270,111661,2022-02-22
CASH_IN,134327,Agence_mtn_Ouidah,300000,165673,David du Blondel,257121,391448,2022-02-23
CASH_IN,209697,Agence_mtn_Cotonou,300000,90303,Geneviève Grondin,-411506,-201809,2022-02-06
CASH_IN,95198,Agence_mtn_Abomey,300000,204802,Geneviève Grondin,-201809,-106611,2022-02-09
CASH_IN,206623,Agence_mtn_Abomey,300000,93377,Geneviève Grondin,-106611,100012,2022-02-10
TRANSFER,74877,Geneviève Grondin,100012,25135,Léon Lecoq,498780,423903,2022-02-13
CASH_IN,48883,Agence_mtn_Ouidah,300000,251117,Geneviève Grondin,25135,74018,2022-02-15
CASH_OUT,58811,Geneviève Grondin,74018,15207,Agence_mtn_Cotonou,300000,241189,2022-02-17
TRANSFER,4504,Geneviève Grondin,15207,10703,Théodore De Oliveira-Nicolas,214464,209960,2022-02-20
TRANSFER,7277,Geneviève Grondin,10703,3426,Théodore De Oliveira-Nicolas,209960,202683,2022-02-27
CASH_IN,295879,Agence_mtn_Cotonou,300000,4121,Gabriel Humbert,-77614,218265,2022-02-04
TRANSFER,2474,Jean Benard,10971,8497,Gabriel Humbert,218265,220739,2022-02-05
TRANSFER,190668,Gabriel Humbert,220739,30071,Léon Lecoq,423903,233235,2022-02-07
CASH_IN,118711,Agence_mtn_Abomey,300000,181289,Gabriel Humbert,30071,148782,2022-02-09
TRANSFER,350354,Catherine Faivre,419912,69558,Gabriel Humbert,148782,499136,2022-02-11
TRANSFER,185328,Gabriel Humbert,499136,313808,Catherine Faivre,69558,-115770,2022-02-12
TRANSFER,11001,Isabelle Rossi,11581,580,Gabriel Humbert,313808,324809,2022-02-13
CASH_IN,63558,Agence_mtn_Abomey,300000,236442,Gabriel Humbert,324809,388367,2022-02-14
TRANSFER,68590,Martine Wagner de la Bègue,111661,43071,Gabriel Humbert,388367,456957,2022-02-16
CASH_IN,198727,Agence_mtn_Ouidah,300000,101273,Gabriel Humbert,456957,655684,2022-02-16
TRANSFER,503214,Philippine Courtois,930021,426807,Gabriel Humbert,655684,1158898,2022-02-18
CASH_OUT,832457,Gabriel Humbert,1158898,326441,Agence_mtn_Ouidah,300000,-532457,2022-02-20
TRANSFER,71113,Margot Renaud,870794,799681,Gabriel Humbert,326441,397554,2022-02-22
CASH_OUT,329374,Gabriel Humbert,397554,68180,Agence_mtn_Cotonou,300000,-29374,2022-02-23
TRANSFER,34476,Richard Le Descamps,66740,32264,Gabriel Humbert,68180,102656,2022-02-24
TRANSFER,206690,Alphonse Leclercq-Rousseau,1340363,1133673,Gabriel Humbert,102656,309346,2022-02-27
CASH_IN,295208,Agence_mtn_Ouidah,300000,4792,Thibaut Coulon,-26542,268666,2022-02-01
CASH_OUT,101865,Thibaut Coulon,268666,166801,Agence_mtn_Abomey,300000,198135,2022-02-01
TRANSFER,125336,Margot Renaud,799681,674345,Thibaut Coulon,166801,292137,2022-02-02
CASH_IN,170196,Agence_mtn_Cotonou,300000,129804,Thibaut Coulon,292137,462333,2022-02-10
TRANSFER,288,Isabelle Rossi,580,292,Thibaut Coulon,462333,462621,2022-02-10
CASH_IN,294179,Agence_mtn_Cotonou,300000,5821,Thibaut Coulon,462621,756800,2022-02-11
CASH_OUT,400336,Thibaut Coulon,756800,356464,Agence_mtn_Cotonou,300000,-100336,2022-02-12
CASH_IN,139389,Agence_mtn_Cotonou,300000,160611,Thibaut Coulon,356464,495853,2022-02-13
CASH_IN,143411,Agence_mtn_Abomey,300000,156589,Thibaut Coulon,495853,639264,2022-02-15
TRANSFER,53010,Thibaut Coulon,639264,586254,Jean Benard,8497,-44513,2022-02-16
CASH_OUT,475816,Thibaut Coulon,586254,110438,Agence_mtn_Ouidah,300000,-175816,2022-02-16
TRANSFER,78869,Théodore De Oliveira-Nicolas,202683,123814,Thibaut Coulon,110438,189307,2022-02-16
CASH_IN,196852,Agence_mtn_Abomey,300000,103148,Thibaut Coulon,189307,386159,2022-02-18
CASH_IN,40365,Agence_mtn_Abomey,300000,259635,Thibaut Coulon,386159,426524,2022-02-20
TRANSFER,395539,Thibaut Coulon,426524,30985,Richard Le Descamps,32264,-363275,2022-02-22
CASH_IN,208241,Agence_mtn_Cotonou,300000,91759,Thibaut Coulon,30985,239226,2022-02-23
CASH_OUT,114855,Thibaut Coulon,239226,124371,Agence_mtn_Abomey,300000,185145,2022-02-24
CASH_IN,74197,Agence_mtn_Cotonou,300000,225803,Thibaut Coulon,124371,198568,2022-02-25
CASH_OUT,16946,Thibaut Coulon,198568,181622,Agence_mtn_Abomey,300000,283054,2022-02-25
TRANSFER,45424,Thibaut Coulon,181622,136198,Margot Renaud,674345,628921,2022-02-27
CASH_IN,10560,Agence_mtn_Ouidah,300000,289440,Catherine Faivre,-115770,-105210,2022-02-02
CASH_IN,237596,Agence_mtn_Ouidah,300000,62404,Catherine Faivre,-105210,132386,2022-02-04
CASH_OUT,9542,Catherine Faivre,132386,122844,Agence_mtn_Abomey,300000,290458,2022-02-08
CASH_IN,132485,Agence_mtn_Cotonou,300000,167515,Catherine Faivre,122844,255329,2022-02-12
CASH_IN,147135,Agence_mtn_Abomey,300000,152865,Catherine Faivre,255329,402464,2022-02-13
TRANSFER,329697,Catherine Faivre,402464,72767,Catherine Faivre,402464,72767,2022-02-19
CASH_IN,1820,Agence_mtn_Abomey,300000,298180,Catherine Faivre,72767,74587,2022-02-20
CASH_OUT,34238,Catherine Faivre,74587,40349,Agence_mtn_Ouidah,300000,265762,2022-02-23
TRANSFER,236096,Alphonse Leclercq-Rousseau,1133673,897577,Catherine Faivre,40349,276445,2022-02-26
CASH_IN,146807,Agence_mtn_Cotonou,300000,153193,Catherine Faivre,276445,423252,2022-02-27
CASH_IN,113276,Agence_mtn_Ouidah,300000,186724,Inès de Letellier,-320845,-207569,2022-02-03
CASH_IN,166077,Agence_mtn_Ouidah,300000,133923,Inès de Letellier,-207569,-41492,2022-02-05
CASH_IN,50005,Agence_mtn_Ouidah,300000,249995,Inès de Letellier,-41492,8513,2022-02-08
TRANSFER,5642,Inès de Letellier,8513,2871,Cécile Delattre-Arnaud,141108,135466,2022-02-10
CASH_IN,120416,Agence_mtn_Abomey,300000,179584,Inès de Letellier,2871,123287,2022-02-11
TRANSFER,54257,Inès de Letellier,123287,69030,Cécile Delattre-Arnaud,135466,81209,2022-02-12
CASH_OUT,28862,Inès de Letellier,69030,40168,Agence_mtn_Abomey,300000,271138,2022-02-15
CASH_OUT,8259,Inès de Letellier,40168,31909,Agence_mtn_Ouidah,300000,291741,2022-02-18
TRANSFER,21277,Martine Wagner de la Bègue,43071,21794,Inès de Letellier,31909,53186,2022-02-18
CASH_IN,121247,Agence_mtn_Ouidah,300000,178753,Inès de Letellier,53186,174433,2022-02-19
TRANSFER,34713,Inès de Letellier,174433,139720,Philippine Courtois,426807,392094,2022-02-20
TRANSFER,3740,Inès Hamon,5546,1806,Inès de Letellier,139720,143460,2022-02-20
CASH_OUT,5730,Inès de Letellier,143460,137730,Agence_mtn_Cotonou,300000,294270,2022-02-23
TRANSFER,78816,Théodore De Oliveira-Nicolas,123814,44998,Inès de Letellier,137730,216546,2022-02-26
TRANSFER,110914,Louise Girard,117550,6636,Inès de Letellier,216546,327460,2022-02-26
CASH_IN,190916,Agence_mtn_Cotonou,300000,109084,William Le Lucas,-108217,82699,2022-02-01
TRANSFER,51918,William Le Lucas,82699,30781,Isabelle Rossi,292,-51626,2022-02-05
CASH_OUT,30469,William Le Lucas,30781,312,Agence_mtn_Ouidah,300000,269531,2022-02-06
TRANSFER,296966,Margot Renaud,628921,331955,William Le Lucas,312,297278,2022-02-08
CASH_IN,194770,Agence_mtn_Ouidah,300000,105230,William Le Lucas,297278,492048,2022-02-09
CASH_IN,237232,Agence_mtn_Abomey,300000,62768,William Le Lucas,492048,729280,2022-02-14
CASH_IN,63855,Agence_mtn_Abomey,300000,236145,William Le Lucas,729280,793135,2022-02-19
TRANSFER,583392,William Le Lucas,793135,209743,Margot Renaud,331955,-251437,2022-02-20
CASH_OUT,51409,William Le Lucas,209743,158334,Agence_mtn_Abomey,300000,248591,2022-02-23
CASH_OUT,30860,William Le Lucas,158334,127474,Agence_mtn_Ouidah,300000,269140,2022-02-24
CASH_IN,132196,Agence_mtn_Abomey,300000,167804,William Le Lucas,127474,259670,2022-02-25
CASH_IN,265274,Agence_mtn_Ouidah,300000,34726,Cécile Clerc,-80871,184403,2022-02-01
TRANSFER,108156,Cécile Clerc,184403,76247,Philippine Courtois,392094,283938,2022-02-04
CASH_IN,219753,Agence_mtn_Ouidah,300000,80247,Cécile Clerc,76247,296000,2022-02-06
CASH_IN,275680,Agence_mtn_Ouidah,300000,24320,Cécile Clerc,296000,571680,2022-02-10
CASH_OUT,364639,Cécile Clerc,571680,207041,Agence_mtn_Abomey,300000,-64639,2022-02-10
TRANSFER,83157,Philippine Courtois,283938,200781,Cécile Clerc,207041,290198,2022-02-18
TRANSFER,588485,Alphonse Leclercq-Rousseau,897577,309092,Cécile Clerc,290198,878683,2022-02-18
CASH_IN,290659,Agence_mtn_Cotonou,300000,9341,Cécile Clerc,878683,1169342,2022-02-18
CASH_OUT,402872,Cécile Clerc,1169342,766470,Agence_mtn_Cotonou,300000,-102872,2022-02-21
TRANSFER,80130,Cécile Clerc,766470,686340,Louise Girard,6636,-73494,2022-02-21
TRANSFER,339190,Cécile Clerc,686340,347150,Pierre Reynaud,173545,-165645,2022-02-21
CASH_IN,43561,Agence_mtn_Ouidah,300000,256439,Cécile Clerc,347150,390711,2022-02-22
CASH_OUT,309672,Cécile Clerc,390711,81039,Agence_mtn_Abomey,300000,-9672,2022-02-22
CASH_OUT,49008,Cécile Clerc,81039,32031,Agence_mtn_Cotonou,300000,250992,2022-02-23
TRANSFER,1795,Cécile Clerc,32031,30236,Théodore De Oliveira-Nicolas,44998,43203,2022-02-24
CASH_IN,222524,Agence_mtn_Ouidah,300000,77476,Alphonse Le Olivier,-12215,210309,2022-02-08
CASH_OUT,123841,Alphonse Le Olivier,210309,86468,Agence_mtn_Abomey,300000,176159,2022-02-11
CASH_IN,243171,Agence_mtn_Ouidah,300000,56829,Alphonse Le Olivier,86468,329639,2022-02-13
TRANSFER,216648,Alphonse Le Olivier,329639,112991,Alphonse Leclercq-Rousseau,309092,92444,2022-02-14
CASH_IN,226492,Agence_mtn_Ouidah,300000,73508,Alphonse Le Olivier,112991,339483,2022-02-15
CASH_OUT,211311,Alphonse Le Olivier,339483,128172,Agence_mtn_Ouidah,300000,88689,2022-02-15
CASH_IN,15202,Agence_mtn_Cotonou,300000,284798,Alphonse Le Olivier,128172,143374,2022-02-17
CASH_IN,279567,Agence_mtn_Ouidah,300000,20433,Alphonse Le Olivier,143374,422941,2022-02-20
CASH_IN,9390,Agence_mtn_Cotonou,300000,290610,Alphonse Le Olivier,422941,432331,2022-02-20
CASH_IN,125667,Agence_mtn_Ouidah,300000,174333,Alphonse Le Olivier,432331,557998,2022-02-22
CASH_OUT,170302,Alphonse Le Olivier,557998,387696,Agence_mtn_Ouidah,300000,129698,2022-02-22
CASH_IN,3022,Agence_mtn_Ouidah,300000,296978,Rémy de la Roux,-15681,-12659,2022-02-04
CASH_IN,170092,Agence_mtn_Cotonou,300000,129908,Rémy de la Roux,-12659,157433,2022-02-06
TRANSFER,155733,Rémy de la Roux,157433,1700,Alphonse Leclercq-Rousseau,92444,-63289,2022-02-06
CASH_OUT,752,Rémy de la Roux,1700,948,Agence_mtn_Ouidah,300000,299248,2022-02-10
CASH_OUT,259,Rémy de la Roux,948,689,Agence_mtn_Cotonou,300000,299741,2022-02-16
TRANSFER,307,Rémy de la Roux,689,382,Martine Wagner de la Bègue,21794,21487,2022-02-16
CASH_OUT,238,Rémy de la Roux,382,144,Agence_mtn_Cotonou,300000,299762,2022-02-20
TRANSFER,105,Rémy de la Roux,144,39,Inès Hamon,1806,1701,2022-02-26
CASH_IN,223944,Agence_mtn_Abomey,300000,76056,Léon Martins-Briand,-128536,95408,2022-02-01
TRANSFER,85628,Philippine Courtois,200781,115153,Léon Martins-Briand,95408,181036,2022-02-02
CASH_IN,219800,Agence_mtn_Cotonou,300000,80200,Léon Martins-Briand,181036,400836,2022-02-06
TRANSFER,222103,Léon Martins-Briand,400836,178733,Léon Martins-Briand,400836,622939,2022-02-06
TRANSFER,1420,Inès Hamon,1701,281,Léon Martins-Briand,178733,180153,2022-02-12
TRANSFER,110579,Philippine Courtois,115153,4574,Léon Martins-Briand,180153,290732,2022-02-12
CASH_OUT,101649,Léon Martins-Briand,290732,189083,Agence_mtn_Cotonou,300000,198351,2022-02-16
CASH_IN,118327,Agence_mtn_Abomey,300000,181673,Léon Martins-Briand,189083,307410,2022-02-17
CASH_IN,96400,Agence_mtn_Abomey,300000,203600,Léon Martins-Briand,307410,403810,2022-02-21
CASH_OUT,71083,Léon Martins-Briand,403810,332727,Agence_mtn_Cotonou,300000,228917,2022-02-22
TRANSFER,218269,Léon Martins-Briand,332727,114458,Martine Wagner de la Bègue,21487,-196782,2022-02-22
CASH_IN,177417,Agence_mtn_Cotonou,300000,122583,Léon Martins-Briand,114458,291875,2022-02-22
CASH_OUT,261582,Léon Martins-Briand,291875,30293,Agence_mtn_Ouidah,300000,38418,2022-02-23
CASH_IN,259143,Agence_mtn_Abomey,300000,40857,Léon Martins-Briand,30293,289436,2022-02-27
CASH_IN,24538,Agence_mtn_Ouidah,300000,275462,Claude Foucher,-206567,-182029,2022-02-04
CASH_IN,191359,Agence_mtn_Ouidah,300000,108641,Claude Foucher,-182029,9330,2022-02-05
CASH_IN,219544,Agence_mtn_Ouidah,300000,80456,Claude Foucher,9330,228874,2022-02-05
TRANSFER,5486,Cécile Delattre-Arnaud,81209,75723,Claude Foucher,228874,234360,2022-02-06
TRANSFER,229717,Claude Foucher,234360,4643,Claude Foucher,234360,4643,2022-02-07
CASH_OUT,2863,Claude Foucher,4643,1780,Agence_mtn_Abomey,300000,297137,2022-02-08
CASH_OUT,582,Claude Foucher,1780,1198,Agence_mtn_Ouidah,300000,299418,2022-02-09
CASH_OUT,156,Claude Foucher,1198,1042,Agence_mtn_Ouidah,300000,299844,2022-02-10
TRANSFER,42748,Théodore De Oliveira-Nicolas,43203,455,Claude Foucher,1042,43790,2022-02-11
CASH_OUT,14328,Claude Foucher,43790,29462,Agence_mtn_Ouidah,300000,285672,2022-02-13
CASH_IN,263790,Agence_mtn_Abomey,300000,36210,Claude Foucher,29462,293252,2022-02-15
TRANSFER,220,Inès Hamon,281,61,Claude Foucher,293252,293472,2022-02-17
CASH_OUT,259336,Claude Foucher,293472,34136,Agence_mtn_Cotonou,300000,40664,2022-02-18
TRANSFER,41769,Cécile Delattre-Arnaud,75723,33954,Claude Foucher,34136,75905,2022-02-20
CASH_IN,11293,Agence_mtn_Cotonou,300000,288707,Claude Foucher,75905,87198,2022-02-21
TRANSFER,31642,Cécile Delattre-Arnaud,33954,2312,Claude Foucher,87198,118840,2022-02-23
CASH_OUT,17624,Claude Foucher,118840,101216,Agence_mtn_Cotonou,300000,282376,2022-02-26
CASH_IN,204006,Agence_mtn_Abomey,300000,95994,Claude Foucher,101216,305222,2022-02-27
CASH_IN,8333,Agence_mtn_Cotonou,300000,291667,Claude Foucher,305222,313555,2022-02-27
CASH_IN,9656,Agence_mtn_Abomey,300000,290344,Claude Foucher,313555,323211,2022-02-27
CASH_IN,46963,Agence_mtn_Cotonou,300000,253037,Étienne Roche,-353839,-306876,2022-02-05
CASH_IN,74036,Agence_mtn_Ouidah,300000,225964,Étienne Roche,-306876,-232840,2022-02-06
CASH_IN,166417,Agence_mtn_Abomey,300000,133583,Étienne Roche,-232840,-66423,2022-02-07
CASH_IN,43448,Agence_mtn_Abomey,300000,256552,Étienne Roche,-66423,-22975,2022-02-08
CASH_IN,582,Agence_mtn_Cotonou,300000,299418,Étienne Roche,-22975,-22393,2022-02-09
CASH_IN,83288,Agence_mtn_Cotonou,300000,216712,Étienne Roche,-22393,60895,2022-02-09
CASH_OUT,33685,Étienne Roche,60895,27210,Agence_mtn_Cotonou,300000,266315,2022-02-11
TRANSFER,15786,Étienne Roche,27210,11424,Cécile Delattre-Arnaud,2312,-13474,2022-02-12
CASH_OUT,2616,Étienne Roche,11424,8808,Agence_mtn_Ouidah,300000,297384,2022-02-12
CASH_OUT,787,Étienne Roche,8808,8021,Agence_mtn_Abomey,300000,299213,2022-02-16
CASH_OUT,780,Étienne Roche,8021,7241,Agence_mtn_Ouidah,300000,299220,2022-02-16
CASH_OUT,3333,Étienne Roche,7241,3908,Agence_mtn_Cotonou,300000,296667,2022-02-16
CASH_OUT,653,Étienne Roche,3908,3255,Agence_mtn_Cotonou,300000,299347,2022-02-19
CASH_IN,62780,Agence_mtn_Abomey,300000,237220,Étienne Roche,3255,66035,2022-02-20
CASH_OUT,54793,Étienne Roche,66035,11242,Agence_mtn_Abomey,300000,245207,2022-02-21
TRANSFER,172,Théodore De Oliveira-Nicolas,455,283,Étienne Roche,11242,11414,2022-02-21
CASH_IN,85321,Agence_mtn_Abomey,300000,214679,Étienne Roche,11414,96735,2022-02-21
TRANSFER,18910,Étienne Roche,96735,77825,Étienne Roche,96735,77825,2022-02-23
TRANSFER,276,Théodore De Oliveira-Nicolas,283,7,Étienne Roche,77825,78101,2022-02-25
CASH_IN,99242,Agence_mtn_Abomey,300000,200758,Vincent Fournier,-93035,6207,2022-02-02
CASH_OUT,683,Vincent Fournier,6207,5524,Agence_mtn_Ouidah,300000,299317,2022-02-03
CASH_OUT,1372,Vincent Fournier,5524,4152,Agence_mtn_Cotonou,300000,298628,2022-02-03
TRANSFER,2170,Vincent Fournier,4152,1982,Vincent Fournier,4152,1982,2022-02-05
TRANSFER,967,Vincent Fournier,1982,1015,Vincent Fournier,1982,2949,2022-02-07
CASH_IN,215424,Agence_mtn_Abomey,300000,84576,Vincent Fournier,1015,216439,2022-02-09
TRANSFER,102643,Vincent Fournier,216439,113796,Vincent Fournier,216439,113796,2022-02-11
TRANSFER,65501,Vincent Fournier,113796,48295,Vincent Fournier,113796,48295,2022-02-11
TRANSFER,14074,Vincent Fournier,48295,34221,Vincent Fournier,48295,62369,2022-02-11
CASH_IN,11554,Agence_mtn_Ouidah,300000,288446,Vincent Fournier,34221,45775,2022-02-15
CASH_OUT,20833,Vincent Fournier,45775,24942,Agence_mtn_Ouidah,300000,279167,2022-02-15
CASH_OUT,659,Vincent Fournier,24942,24283,Agence_mtn_Abomey,300000,299341,2022-02-18
CASH_IN,52504,Agence_mtn_Ouidah,300000,247496,Vincent Fournier,24283,76787,2022-02-18
CASH_IN,293612,Agence_mtn_Cotonou,300000,6388,Vincent Fournier,76787,370399,2022-02-19
CASH_OUT,36230,Vincent Fournier,370399,334169,Agence_mtn_Cotonou,300000,263770,2022-02-24
CASH_IN,126002,Agence_mtn_Cotonou,300000,173998,Astrid Gay de la Brunet,-467083,-341081,2022-02-02
CASH_IN,156457,Agence_mtn_Cotonou,300000,143543,Astrid Gay de la Brunet,-341081,-184624,2022-02-03
CASH_IN,40550,Agence_mtn_Abomey,300000,259450,Astrid Gay de la Brunet,-184624,-144074,2022-02-07
CASH_IN,230683,Agence_mtn_Ouidah,300000,69317,Astrid Gay de la Brunet,-144074,86609,2022-02-09
CASH_IN,29589,Agence_mtn_Ouidah,300000,270411,Astrid Gay de la Brunet,86609,116198,2022-02-12
CASH_OUT,83046,Astrid Gay de la Brunet,116198,33152,Agence_mtn_Abomey,300000,216954,2022-02-12
CASH_IN,290935,Agence_mtn_Abomey,300000,9065,Astrid Gay de la Brunet,33152,324087,2022-02-13
TRANSFER,148448,Astrid Gay de la Brunet,324087,175639,Astrid Gay de la Brunet,324087,472535,2022-02-13
CASH_OUT,101478,Astrid Gay de la Brunet,175639,74161,Agence_mtn_Abomey,300000,198522,2022-02-16
TRANSFER,54112,Astrid Gay de la Brunet,74161,20049,Astrid Gay de la Brunet,74161,128273,2022-02-17
CASH_IN,279157,Agence_mtn_Abomey,300000,20843,Astrid Gay de la Brunet,20049,299206,2022-02-23
CASH_OUT,272452,Astrid Gay de la Brunet,299206,26754,Agence_mtn_Abomey,300000,27548,2022-02-24
CASH_IN,63102,Agence_mtn_Ouidah,300000,236898,Corinne-Louise Valentin,-166190,-103088,2022-02-02
CASH_IN,85608,Agence_mtn_Abomey,300000,214392,Corinne-Louise Valentin,-103088,-17480,2022-02-05
CASH_IN,112803,Agence_mtn_Ouidah,300000,187197,Corinne-Louise Valentin,-17480,95323,2022-02-06
CASH_IN,208990,Agence_mtn_Ouidah,300000,91010,Corinne-Louise Valentin,95323,304313,2022-02-10
CASH_IN,197255,Agence_mtn_Ouidah,300000,102745,Corinne-Louise Valentin,304313,501568,2022-02-12
CASH_IN,192916,Agence_mtn_Abomey,300000,107084,Corinne-Louise Valentin,501568,694484,2022-02-13
CASH_IN,204415,Agence_mtn_Cotonou,300000,95585,Corinne-Louise Valentin,694484,898899,2022-02-13
TRANSFER,593366,Corinne-Louise Valentin,898899,305533,Corinne-Louise Valentin,898899,1492265,2022-02-14
CASH_IN,175929,Agence_mtn_Ouidah,300000,124071,Corinne-Louise Valentin,305533,481462,2022-02-14
CASH_OUT,255909,Corinne-Louise Valentin,481462,225553,Agence_mtn_Abomey,300000,44091,2022-02-16
CASH_OUT,118932,Corinne-Louise Valentin,225553,106621,Agence_mtn_Abomey,300000,181068,2022-02-19
CASH_IN,138303,Agence_mtn_Ouidah,300000,161697,Corinne-Louise Valentin,106621,244924,2022-02-19
CASH_IN,178358,Agence_mtn_Ouidah,300000,121642,Franck-Charles Texier,-433313,-254955,2022-02-04
CASH_IN,229270,Agence_mtn_Abomey,300000,70730,Franck-Charles Texier,-254955,-25685,2022-02-04
CASH_IN,16422,Agence_mtn_Cotonou,300000,283578,Franck-Charles Texier,-25685,-9263,2022-02-04
CASH_IN,273806,Agence_mtn_Cotonou,300000,26194,Franck-Charles Texier,-9263,264543,2022-02-05
TRANSFER,1917,Franck-Charles Texier,264543,262626,Franck-Charles Texier,264543,266460,2022-02-07
CASH_OUT,166810,Franck-Charles Texier,262626,95816,Agence_mtn_Abomey,300000,133190,2022-02-07
CASH_IN,98322,Agence_mtn_Ouidah,300000,201678,Franck-Charles Texier,95816,194138,2022-02-12
CASH_OUT,89787,Franck-Charles Texier,194138,104351,Agence_mtn_Abomey,300000,210213,2022-02-15
CASH_IN,296641,Agence_mtn_Abomey,300000,3359,Franck-Charles Texier,104351,400992,2022-02-17
CASH_OUT,314512,Franck-Charles Texier,400992,86480,Agence_mtn_Cotonou,300000,-14512,2022-02-19
CASH_OUT,69786,Franck-Charles Texier,86480,16694,Agence_mtn_Abomey,300000,230214,2022-02-23
CASH_OUT,16117,Franck-Charles Texier,16694,577,Agence_mtn_Cotonou,300000,283883,2022-02-25
CASH_IN,237628,Agence_mtn_Ouidah,300000,62372,Cécile Delattre-Arnaud,-13474,224154,2022-02-06
CASH_OUT,148431,Cécile Delattre-Arnaud,224154,75723,Agence_mtn_Cotonou,300000,151569,2022-02-08
CASH_IN,267556,Agence_mtn_Abomey,300000,32444,Cécile Delattre-Arnaud,75723,343279,2022-02-09
CASH_IN,248628,Agence_mtn_Ouidah,300000,51372,Cécile Delattre-Arnaud,343279,591907,2022-02-10
CASH_IN,297497,Agence_mtn_Cotonou,300000,2503,Cécile Delattre-Arnaud,591907,889404,2022-02-13
CASH_IN,59575,Agence_mtn_Abomey,300000,240425,Cécile Delattre-Arnaud,889404,948979,2022-02-15
CASH_OUT,452296,Cécile Delattre-Arnaud,948979,496683,Agence_mtn_Ouidah,300000,-152296,2022-02-16
CASH_OUT,19661,Cécile Delattre-Arnaud,496683,477022,Agence_mtn_Cotonou,300000,280339,2022-02-19
CASH_OUT,350611,Cécile Delattre-Arnaud,477022,126411,Agence_mtn_Ouidah,300000,-50611,2022-02-21
CASH_OUT,40579,Cécile Delattre-Arnaud,126411,85832,Agence_mtn_Ouidah,300000,259421,2022-02-22
CASH_IN,166413,Agence_mtn_Abomey,300000,133587,Alexandrie Delmas,-465380,-298967,2022-02-01
CASH_IN,183683,Agence_mtn_Cotonou,300000,116317,Alexandrie Delmas,-298967,-115284,2022-02-04
CASH_IN,186519,Agence_mtn_Abomey,300000,113481,Alexandrie Delmas,-115284,71235,2022-02-07
TRANSFER,37506,Alexandrie Delmas,71235,33729,Alexandrie Delmas,71235,108741,2022-02-09
CASH_IN,79187,Agence_mtn_Abomey,300000,220813,Alexandrie Delmas,33729,112916,2022-02-12
CASH_IN,9106,Agence_mtn_Abomey,300000,290894,Alexandrie Delmas,112916,122022,2022-02-21
CASH_OUT,328,Alexandrie Delmas,122022,121694,Agence_mtn_Cotonou,300000,299672,2022-02-26
CASH_IN,244948,Agence_mtn_Cotonou,300000,55052,Hortense Lemaire,-115621,129327,2022-02-02
TRANSFER,93193,Hortense Lemaire,129327,36134,Hortense Lemaire,129327,222520,2022-02-03
CASH_IN,286789,Agence_mtn_Ouidah,300000,13211,Hortense Lemaire,36134,322923,2022-02-07
TRANSFER,107817,Hortense Lemaire,322923,215106,Hortense Lemaire,322923,430740,2022-02-11
CASH_OUT,172570,Hortense Lemaire,215106,42536,Agence_mtn_Abomey,300000,127430,2022-02-21
CASH_OUT,40245,Hortense Lemaire,42536,2291,Agence_mtn_Cotonou,300000,259755,2022-02-22
CASH_OUT,1482,Hortense Lemaire,2291,809,Agence_mtn_Cotonou,300000,298518,2022-02-25
CASH_IN,102883,Agence_mtn_Ouidah,300000,197117,Caroline-Lorraine Humbert,-727897,-625014,2022-02-02
CASH_IN,154739,Agence_mtn_Abomey,300000,145261,Caroline-Lorraine Humbert,-625014,-470275,2022-02-09
CASH_IN,73596,Agence_mtn_Abomey,300000,226404,Caroline-Lorraine Humbert,-470275,-396679,2022-02-09
CASH_IN,102851,Agence_mtn_Abomey,300000,197149,Caroline-Lorraine Humbert,-396679,-293828,2022-02-13
CASH_IN,291654,Agence_mtn_Cotonou,300000,8346,Caroline-Lorraine Humbert,-293828,-2174,2022-02-15
CASH_IN,207896,Agence_mtn_Ouidah,300000,92104,Caroline-Lorraine Humbert,-2174,205722,2022-02-17
TRANSFER,171106,Caroline-Lorraine Humbert,205722,34616,Caroline-Lorraine Humbert,205722,376828,2022-02-19
TRANSFER,1235,Caroline-Lorraine Humbert,34616,33381,Caroline-Lorraine Humbert,34616,33381,2022-02-20
CASH_OUT,4839,Caroline-Lorraine Humbert,33381,28542,Agence_mtn_Cotonou,300000,295161,2022-02-21
CASH_OUT,25392,Caroline-Lorraine Humbert,28542,3150,Agence_mtn_Abomey,300000,274608,2022-02-21
CASH_IN,87579,Agence_mtn_Abomey,300000,212421,Caroline-Lorraine Humbert,3150,90729,2022-02-24
CASH_IN,230504,Agence_mtn_Cotonou,300000,69496,Caroline-Lorraine Humbert,90729,321233,2022-02-27
CASH_IN,163789,Agence_mtn_Abomey,300000,136211,Adèle Labbé,-87602,76187,2022-02-02
CASH_IN,217561,Agence_mtn_Abomey,300000,82439,Adèle Labbé,76187,293748,2022-02-03
CASH_OUT,24094,Adèle Labbé,293748,269654,Agence_mtn_Cotonou,300000,275906,2022-02-04
CASH_OUT,142892,Adèle Labbé,269654,126762,Agence_mtn_Ouidah,300000,157108,2022-02-06
TRANSFER,122169,Adèle Labbé,126762,4593,Adèle Labbé,126762,248931,2022-02-07
CASH_IN,284054,Agence_mtn_Cotonou,300000,15946,Adèle Labbé,4593,288647,2022-02-08
CASH_IN,112092,Agence_mtn_Ouidah,300000,187908,Adèle Labbé,288647,400739,2022-02-08
TRANSFER,305784,Adèle Labbé,400739,94955,Adèle Labbé,400739,94955,2022-02-13
CASH_IN,278400,Agence_mtn_Cotonou,300000,21600,Adèle Labbé,94955,373355,2022-02-16
CASH_OUT,357834,Adèle Labbé,373355,15521,Agence_mtn_Ouidah,300000,-57834,2022-02-16
CASH_IN,268377,Agence_mtn_Abomey,300000,31623,Adèle Labbé,15521,283898,2022-02-24
CASH_IN,12206,Agence_mtn_Ouidah,300000,287794,Adèle Labbé,283898,296104,2022-02-25
CASH_IN,37599,Agence_mtn_Cotonou,300000,262401,Adèle Labbé,296104,333703,2022-02-27
CASH_IN,217212,Agence_mtn_Ouidah,300000,82788,Marcelle Paris,-16655,200557,2022-02-06
CASH_OUT,111733,Marcelle Paris,200557,88824,Agence_mtn_Ouidah,300000,188267,2022-02-07
CASH_IN,178242,Agence_mtn_Cotonou,300000,121758,Marcelle Paris,88824,267066,2022-02-10
CASH_OUT,58568,Marcelle Paris,267066,208498,Agence_mtn_Cotonou,300000,241432,2022-02-14
CASH_OUT,39296,Marcelle Paris,208498,169202,Agence_mtn_Ouidah,300000,260704,2022-02-27
CASH_IN,33998,Agence_mtn_Abomey,300000,266002,Geneviève De Oliveira-Michel,-246404,-212406,2022-02-07
CASH_IN,192458,Agence_mtn_Cotonou,300000,107542,Geneviève De Oliveira-Michel,-212406,-19948,2022-02-11
CASH_IN,115998,Agence_mtn_Cotonou,300000,184002,Geneviève De Oliveira-Michel,-19948,96050,2022-02-18
CASH_OUT,20425,Geneviève De Oliveira-Michel,96050,75625,Agence_mtn_Ouidah,300000,279575,2022-02-18
CASH_OUT,39725,Geneviève De Oliveira-Michel,75625,35900,Agence_mtn_Cotonou,300000,260275,2022-02-19
CASH_IN,126975,Agence_mtn_Abomey,300000,173025,Geneviève De Oliveira-Michel,35900,162875,2022-02-22
CASH_OUT,66205,Geneviève De Oliveira-Michel,162875,96670,Agence_mtn_Abomey,300000,233795,2022-02-23
CASH_IN,134579,Agence_mtn_Abomey,300000,165421,François Michel-Legros,-129881,4698,2022-02-02
CASH_IN,290361,Agence_mtn_Abomey,300000,9639,François Michel-Legros,4698,295059,2022-02-04
TRANSFER,261880,François Michel-Legros,295059,33179,François Michel-Legros,295059,33179,2022-02-07
CASH_OUT,7157,François Michel-Legros,33179,26022,Agence_mtn_Ouidah,300000,292843,2022-02-08
TRANSFER,22291,François Michel-Legros,26022,3731,François Michel-Legros,26022,3731,2022-02-09
CASH_OUT,1178,François Michel-Legros,3731,2553,Agence_mtn_Ouidah,300000,298822,2022-02-10
CASH_IN,55768,Agence_mtn_Ouidah,300000,244232,François Michel-Legros,2553,58321,2022-02-10
CASH_IN,287653,Agence_mtn_Ouidah,300000,12347,François Michel-Legros,58321,345974,2022-02-11
CASH_OUT,61271,François Michel-Legros,345974,284703,Agence_mtn_Cotonou,300000,238729,2022-02-12
CASH_OUT,151495,François Michel-Legros,284703,133208,Agence_mtn_Abomey,300000,148505,2022-02-14
CASH_IN,38735,Agence_mtn_Cotonou,300000,261265,François Michel-Legros,133208,171943,2022-02-15
CASH_OUT,27707,François Michel-Legros,171943,144236,Agence_mtn_Ouidah,300000,272293,2022-02-15
CASH_IN,137089,Agence_mtn_Abomey,300000,162911,Tristan Thomas,-36134,100955,2022-02-01
CASH_IN,15839,Agence_mtn_Abomey,300000,284161,Tristan Thomas,100955,116794,2022-02-03
CASH_IN,273118,Agence_mtn_Abomey,300000,26882,Tristan Thomas,116794,389912,2022-02-04
CASH_IN,267847,Agence_mtn_Abomey,300000,32153,Tristan Thomas,389912,657759,2022-02-05
TRANSFER,586440,Tristan Thomas,657759,71319,Tristan Thomas,657759,71319,2022-02-09
TRANSFER,53970,Tristan Thomas,71319,17349,Tristan Thomas,71319,17349,2022-02-10
CASH_OUT,4788,Tristan Thomas,17349,12561,Agence_mtn_Abomey,300000,295212,2022-02-10
CASH_IN,63212,Agence_mtn_Ouidah,300000,236788,Tristan Thomas,12561,75773,2022-02-20
CASH_IN,168388,Agence_mtn_Abomey,300000,131612,Tristan Thomas,75773,244161,2022-02-22
CASH_OUT,126274,Tristan Thomas,244161,117887,Agence_mtn_Ouidah,300000,173726,2022-02-24
CASH_IN,262509,Agence_mtn_Ouidah,300000,37491,Zoé Renaud de Boutin,-20355,242154,2022-02-02
CASH_OUT,128390,Zoé Renaud de Boutin,242154,113764,Agence_mtn_Cotonou,300000,171610,2022-02-05
CASH_OUT,64478,Zoé Renaud de Boutin,113764,49286,Agence_mtn_Abomey,300000,235522,2022-02-12
CASH_IN,170374,Agence_mtn_Cotonou,300000,129626,Zoé Renaud de Boutin,49286,219660,2022-02-14
CASH_IN,138627,Agence_mtn_Ouidah,300000,161373,Zoé Renaud de Boutin,219660,358287,2022-02-20
TRANSFER,303122,Zoé Renaud de Boutin,358287,55165,Zoé Renaud de Boutin,358287,661409,2022-02-21
CASH_IN,164731,Agence_mtn_Ouidah,300000,135269,Zoé Renaud de Boutin,55165,219896,2022-02-21
TRANSFER,93577,Zoé Renaud de Boutin,219896,126319,Zoé Renaud de Boutin,219896,126319,2022-02-24
CASH_OUT,23328,Zoé Renaud de Boutin,126319,102991,Agence_mtn_Ouidah,300000,276672,2022-02-25
CASH_IN,272223,Agence_mtn_Cotonou,300000,27777,Jean Benard,-44513,227710,2022-02-03
TRANSFER,130429,Jean Benard,227710,97281,Jean Benard,227710,97281,2022-02-05
CASH_OUT,15451,Jean Benard,97281,81830,Agence_mtn_Abomey,300000,284549,2022-02-06
CASH_IN,107912,Agence_mtn_Abomey,300000,192088,Jean Benard,81830,189742,2022-02-07
CASH_OUT,161679,Jean Benard,189742,28063,Agence_mtn_Cotonou,300000,138321,2022-02-07
TRANSFER,2258,Jean Benard,28063,25805,Jean Benard,28063,25805,2022-02-09
CASH_IN,129734,Agence_mtn_Ouidah,300000,170266,Jean Benard,25805,155539,2022-02-14
CASH_OUT,39380,Jean Benard,155539,116159,Agence_mtn_Cotonou,300000,260620,2022-02-15
CASH_IN,107595,Agence_mtn_Cotonou,300000,192405,Jean Benard,116159,223754,2022-02-20
CASH_OUT,118920,Jean Benard,223754,104834,Agence_mtn_Ouidah,300000,181080,2022-02-23
CASH_IN,214260,Agence_mtn_Cotonou,300000,85740,Jean Benard,104834,319094,2022-02-25
CASH_OUT,185620,Jean Benard,319094,133474,Agence_mtn_Abomey,300000,114380,2022-02-25
CASH_IN,201540,Agence_mtn_Cotonou,300000,98460,Pénélope Dupuis,-851864,-650324,2022-02-02
CASH_IN,72224,Agence_mtn_Cotonou,300000,227776,Pénélope Dupuis,-650324,-578100,2022-02-06
CASH_IN,152250,Agence_mtn_Abomey,300000,147750,Pénélope Dupuis,-578100,-425850,2022-02-07
CASH_IN,258006,Agence_mtn_Cotonou,300000,41994,Pénélope Dupuis,-425850,-167844,2022-02-08
CASH_IN,28802,Agence_mtn_Cotonou,300000,271198,Pénélope Dupuis,-167844,-139042,2022-02-09
CASH_IN,1955,Agence_mtn_Abomey,300000,298045,Pénélope Dupuis,-139042,-137087,2022-02-09
CASH_IN,276282,Agence_mtn_Abomey,300000,23718,Pénélope Dupuis,-137087,139195,2022-02-10
CASH_IN,210565,Agence_mtn_Abomey,300000,89435,Pénélope Dupuis,139195,349760,2022-02-12
TRANSFER,229285,Pénélope Dupuis,349760,120475,Pénélope Dupuis,349760,579045,2022-02-13
CASH_IN,43111,Agence_mtn_Abomey,300000,256889,Pénélope Dupuis,120475,163586,2022-02-14
CASH_OUT,112962,Pénélope Dupuis,163586,50624,Agence_mtn_Abomey,300000,187038,2022-02-16
CASH_IN,111071,Agence_mtn_Cotonou,300000,188929,Pénélope Dupuis,50624,161695,2022-02-21
CASH_IN,16021,Agence_mtn_Abomey,300000,283979,Michelle Lebon,-3869,12152,2022-02-02
CASH_IN,161646,Agence_mtn_Cotonou,300000,138354,Michelle Lebon,12152,173798,2022-02-02
CASH_IN,79450,Agence_mtn_Abomey,300000,220550,Michelle Lebon,173798,253248,2022-02-03
TRANSFER,154329,Michelle Lebon,253248,98919,Michelle Lebon,253248,98919,2022-02-04
CASH_IN,161215,Agence_mtn_Cotonou,300000,138785,Michelle Lebon,98919,260134,2022-02-05
TRANSFER,51367,Michelle Lebon,260134,208767,Michelle Lebon,260134,208767,2022-02-06
CASH_IN,26138,Agence_mtn_Abomey,300000,273862,Michelle Lebon,208767,234905,2022-02-06
CASH_OUT,123822,Michelle Lebon,234905,111083,Agence_mtn_Abomey,300000,176178,2022-02-11
CASH_OUT,85136,Michelle Lebon,111083,25947,Agence_mtn_Abomey,300000,214864,2022-02-17
CASH_IN,62309,Agence_mtn_Ouidah,300000,237691,Michelle Lebon,25947,88256,2022-02-20
CASH_IN,83532,Agence_mtn_Cotonou,300000,216468,Michelle Lebon,88256,171788,2022-02-20
CASH_IN,51106,Agence_mtn_Ouidah,300000,248894,Alphonse Leclercq-Rousseau,-63289,-12183,2022-02-02
CASH_IN,35629,Agence_mtn_Abomey,300000,264371,Alphonse Leclercq-Rousseau,-12183,23446,2022-02-03
CASH_OUT,15094,Alphonse Leclercq-Rousseau,23446,8352,Agence_mtn_Ouidah,300000,284906,2022-02-05
CASH_OUT,3034,Alphonse Leclercq-Rousseau,8352,5318,Agence_mtn_Ouidah,300000,296966,2022-02-07
CASH_OUT,2864,Alphonse Leclercq-Rousseau,5318,2454,Agence_mtn_Abomey,300000,297136,2022-02-07
CASH_OUT,275,Alphonse Leclercq-Rousseau,2454,2179,Agence_mtn_Cotonou,300000,299725,2022-02-10
CASH_OUT,465,Alphonse Leclercq-Rousseau,2179,1714,Agence_mtn_Ouidah,300000,299535,2022-02-15
CASH_IN,127535,Agence_mtn_Cotonou,300000,172465,Alphonse Leclercq-Rousseau,1714,129249,2022-02-16
CASH_IN,220887,Agence_mtn_Ouidah,300000,79113,Louise Girard,-73494,147393,2022-02-03
CASH_IN,116535,Agence_mtn_Abomey,300000,183465,Louise Girard,147393,263928,2022-02-04
CASH_OUT,34708,Louise Girard,263928,229220,Agence_mtn_Abomey,300000,265292,2022-02-04
CASH_OUT,119532,Louise Girard,229220,109688,Agence_mtn_Ouidah,300000,180468,2022-02-06
TRANSFER,106123,Louise Girard,109688,3565,Louise Girard,109688,215811,2022-02-08
TRANSFER,2449,Louise Girard,3565,1116,Louise Girard,3565,1116,2022-02-09
CASH_OUT,657,Louise Girard,1116,459,Agence_mtn_Ouidah,300000,299343,2022-02-10
CASH_OUT,456,Louise Girard,459,3,Agence_mtn_Abomey,300000,299544,2022-02-10
CASH_IN,82198,Agence_mtn_Ouidah,300000,217802,Louise Girard,3,82201,2022-02-14
CASH_IN,105223,Agence_mtn_Ouidah,300000,194777,Louise Girard,82201,187424,2022-02-15
CASH_IN,196073,Agence_mtn_Ouidah,300000,103927,Louise Girard,187424,383497,2022-02-15
TRANSFER,24981,Louise Girard,383497,358516,Louise Girard,383497,408478,2022-02-17
TRANSFER,74942,Louise Girard,358516,283574,Louise Girard,358516,433458,2022-02-18
CASH_IN,44516,Agence_mtn_Abomey,300000,255484,Louise Girard,283574,328090,2022-02-19
CASH_OUT,147271,Louise Girard,328090,180819,Agence_mtn_Ouidah,300000,152729,2022-02-20
CASH_OUT,42852,Louise Girard,180819,137967,Agence_mtn_Abomey,300000,257148,2022-02-20
CASH_OUT,58962,Louise Girard,137967,79005,Agence_mtn_Abomey,300000,241038,2022-02-23
CASH_IN,39804,Agence_mtn_Cotonou,300000,260196,Louise Girard,79005,118809,2022-02-25
CASH_IN,233279,Agence_mtn_Cotonou,300000,66721,Alexandre Rémy,-184839,48440,2022-02-05
TRANSFER,1371,Alexandre Rémy,48440,47069,Alexandre Rémy,48440,47069,2022-02-06
CASH_OUT,32645,Alexandre Rémy,47069,14424,Agence_mtn_Abomey,300000,267355,2022-02-06
TRANSFER,8859,Alexandre Rémy,14424,5565,Alexandre Rémy,14424,23283,2022-02-07
TRANSFER,1813,Alexandre Rémy,5565,3752,Alexandre Rémy,5565,3752,2022-02-07
TRANSFER,138,Alexandre Rémy,3752,3614,Alexandre Rémy,3752,3614,2022-02-09
CASH_IN,104416,Agence_mtn_Ouidah,300000,195584,Alexandre Rémy,3614,108030,2022-02-10
TRANSFER,88906,Alexandre Rémy,108030,19124,Alexandre Rémy,108030,196936,2022-02-13
CASH_IN,167833,Agence_mtn_Abomey,300000,132167,Alexandre Rémy,19124,186957,2022-02-14
CASH_OUT,59530,Alexandre Rémy,186957,127427,Agence_mtn_Ouidah,300000,240470,2022-02-14
CASH_OUT,101299,Alexandre Rémy,127427,26128,Agence_mtn_Abomey,300000,198701,2022-02-14
CASH_OUT,21416,Alexandre Rémy,26128,4712,Agence_mtn_Ouidah,300000,278584,2022-02-16
TRANSFER,3046,Alexandre Rémy,4712,1666,Alexandre Rémy,4712,7758,2022-02-17
CASH_OUT,1138,Alexandre Rémy,1666,528,Agence_mtn_Cotonou,300000,298862,2022-02-22
CASH_OUT,257,Alexandre Rémy,528,271,Agence_mtn_Cotonou,300000,299743,2022-02-22
CASH_OUT,167,Alexandre Rémy,271,104,Agence_mtn_Abomey,300000,299833,2022-02-23
CASH_IN,158876,Agence_mtn_Ouidah,300000,141124,Alexandre Rémy,104,158980,2022-02-25
CASH_IN,175061,Agence_mtn_Cotonou,300000,124939,Alexandre Rémy,158980,334041,2022-02-25
CASH_IN,151992,Agence_mtn_Cotonou,300000,148008,Alexandre Rémy,334041,486033,2022-02-26
CASH_IN,173163,Agence_mtn_Ouidah,300000,126837,Théodore De Oliveira-Nicolas,7,173170,2022-02-01
CASH_IN,268236,Agence_mtn_Ouidah,300000,31764,Théodore De Oliveira-Nicolas,173170,441406,2022-02-02
CASH_OUT,18792,Théodore De Oliveira-Nicolas,441406,422614,Agence_mtn_Cotonou,300000,281208,2022-02-03
CASH_IN,73331,Agence_mtn_Abomey,300000,226669,Théodore De Oliveira-Nicolas,422614,495945,2022-02-03
CASH_OUT,427979,Théodore De Oliveira-Nicolas,495945,67966,Agence_mtn_Abomey,300000,-127979,2022-02-05
CASH_IN,158456,Agence_mtn_Ouidah,300000,141544,Théodore De Oliveira-Nicolas,67966,226422,2022-02-06
CASH_IN,84731,Agence_mtn_Abomey,300000,215269,Théodore De Oliveira-Nicolas,226422,311153,2022-02-06
CASH_OUT,257413,Théodore De Oliveira-Nicolas,311153,53740,Agence_mtn_Ouidah,300000,42587,2022-02-11
CASH_IN,216500,Agence_mtn_Abomey,300000,83500,Théodore De Oliveira-Nicolas,53740,270240,2022-02-14
CASH_IN,276743,Agence_mtn_Cotonou,300000,23257,Théodore De Oliveira-Nicolas,270240,546983,2022-02-15
CASH_IN,94912,Agence_mtn_Cotonou,300000,205088,Théodore De Oliveira-Nicolas,546983,641895,2022-02-21
CASH_IN,112629,Agence_mtn_Ouidah,300000,187371,Théodore De Oliveira-Nicolas,641895,754524,2022-02-22
CASH_IN,69557,Agence_mtn_Cotonou,300000,230443,Théodore De Oliveira-Nicolas,754524,824081,2022-02-26
CASH_IN,90685,Agence_mtn_Cotonou,300000,209315,Pierre Reynaud,-165645,-74960,2022-02-02
CASH_IN,261302,Agence_mtn_Cotonou,300000,38698,Pierre Reynaud,-74960,186342,2022-02-03
CASH_OUT,16699,Pierre Reynaud,186342,169643,Agence_mtn_Cotonou,300000,283301,2022-02-04
CASH_OUT,150745,Pierre Reynaud,169643,18898,Agence_mtn_Ouidah,300000,149255,2022-02-04
CASH_IN,127628,Agence_mtn_Ouidah,300000,172372,Pierre Reynaud,18898,146526,2022-02-04
CASH_OUT,128488,Pierre Reynaud,146526,18038,Agence_mtn_Abomey,300000,171512,2022-02-06
TRANSFER,4867,Pierre Reynaud,18038,13171,Pierre Reynaud,18038,22905,2022-02-07
CASH_IN,174564,Agence_mtn_Cotonou,300000,125436,Pierre Reynaud,13171,187735,2022-02-07
TRANSFER,167500,Pierre Reynaud,187735,20235,Pierre Reynaud,187735,20235,2022-02-08
TRANSFER,17682,Pierre Reynaud,20235,2553,Pierre Reynaud,20235,37917,2022-02-09
CASH_IN,228244,Agence_mtn_Abomey,300000,71756,Pierre Reynaud,2553,230797,2022-02-11
CASH_IN,276296,Agence_mtn_Cotonou,300000,23704,Pierre Reynaud,230797,507093,2022-02-12
CASH_OUT,470122,Pierre Reynaud,507093,36971,Agence_mtn_Abomey,300000,-170122,2022-02-17
CASH_OUT,24318,Pierre Reynaud,36971,12653,Agence_mtn_Cotonou,300000,275682,2022-02-18
CASH_IN,260474,Agence_mtn_Ouidah,300000,39526,Richard Le Descamps,-363275,-102801,2022-02-01
CASH_IN,272799,Agence_mtn_Abomey,300000,27201,Richard Le Descamps,-102801,169998,2022-02-03
CASH_IN,127272,Agence_mtn_Cotonou,300000,172728,Richard Le Descamps,169998,297270,2022-02-04
CASH_OUT,149893,Richard Le Descamps,297270,147377,Agence_mtn_Ouidah,300000,150107,2022-02-06
CASH_IN,6021,Agence_mtn_Ouidah,300000,293979,Richard Le Descamps,147377,153398,2022-02-07
TRANSFER,125323,Richard Le Descamps,153398,28075,Richard Le Descamps,153398,28075,2022-02-09
CASH_IN,227103,Agence_mtn_Ouidah,300000,72897,Richard Le Descamps,28075,255178,2022-02-14
CASH_OUT,22699,Richard Le Descamps,255178,232479,Agence_mtn_Cotonou,300000,277301,2022-02-14
CASH_IN,280055,Agence_mtn_Abomey,300000,19945,Richard Le Descamps,232479,512534,2022-02-15
CASH_OUT,3274,Richard Le Descamps,512534,509260,Agence_mtn_Abomey,300000,296726,2022-02-17
CASH_OUT,32677,Richard Le Descamps,509260,476583,Agence_mtn_Abomey,300000,267323,2022-02-18
CASH_OUT,349177,Richard Le Descamps,476583,127406,Agence_mtn_Ouidah,300000,-49177,2022-02-21
CASH_IN,101786,Agence_mtn_Abomey,300000,198214,Richard Le Descamps,127406,229192,2022-02-24
CASH_IN,218274,Agence_mtn_Abomey,300000,81726,Victoire-Nicole Lopez,-397513,-179239,2022-02-05
CASH_IN,164928,Agence_mtn_Ouidah,300000,135072,Victoire-Nicole Lopez,-179239,-14311,2022-02-06
CASH_IN,21890,Agence_mtn_Abomey,300000,278110,Victoire-Nicole Lopez,-14311,7579,2022-02-10
CASH_IN,54663,Agence_mtn_Abomey,300000,245337,Victoire-Nicole Lopez,7579,62242,2022-02-13
CASH_IN,247851,Agence_mtn_Cotonou,300000,52149,Victoire-Nicole Lopez,62242,310093,2022-02-14
TRANSFER,74731,Victoire-Nicole Lopez,310093,235362,Victoire-Nicole Lopez,310093,235362,2022-02-15
TRANSFER,170457,Victoire-Nicole Lopez,235362,64905,Victoire-Nicole Lopez,235362,405819,2022-02-16
TRANSFER,34247,Victoire-Nicole Lopez,64905,30658,Victoire-Nicole Lopez,64905,30658,2022-02-18
CASH_IN,38879,Agence_mtn_Ouidah,300000,261121,Victoire-Nicole Lopez,30658,69537,2022-02-20
CASH_IN,18433,Agence_mtn_Abomey,300000,281567,Victoire-Nicole Lopez,69537,87970,2022-02-21
CASH_IN,178169,Agence_mtn_Cotonou,300000,121831,Victoire-Nicole Lopez,87970,266139,2022-02-21
CASH_IN,299524,Agence_mtn_Abomey,300000,476,Victoire-Nicole Lopez,266139,565663,2022-02-22
CASH_OUT,543628,Victoire-Nicole Lopez,565663,22035,Agence_mtn_Abomey,300000,-243628,2022-02-26
CASH_IN,143642,Agence_mtn_Ouidah,300000,156358,Alfred du Lesage,-152019,-8377,2022-02-01
CASH_IN,8093,Agence_mtn_Ouidah,300000,291907,Alfred du Lesage,-8377,-284,2022-02-04
CASH_IN,188719,Agence_mtn_Cotonou,300000,111281,Alfred du Lesage,-284,188435,2022-02-07
TRANSFER,95686,Alfred du Lesage,188435,92749,Alfred du Lesage,188435,92749,2022-02-07
TRANSFER,51194,Alfred du Lesage,92749,41555,Alfred du Lesage,92749,143943,2022-02-09
CASH_IN,272283,Agence_mtn_Abomey,300000,27717,Alfred du Lesage,41555,313838,2022-02-09
TRANSFER,133161,Alfred du Lesage,313838,180677,Alfred du Lesage,313838,446999,2022-02-10
TRANSFER,29552,Alfred du Lesage,180677,151125,Alfred du Lesage,180677,151125,2022-02-12
CASH_IN,28654,Agence_mtn_Ouidah,300000,271346,Alfred du Lesage,151125,179779,2022-02-13
CASH_OUT,174281,Alfred du Lesage,179779,5498,Agence_mtn_Ouidah,300000,125719,2022-02-13
CASH_IN,123484,Agence_mtn_Ouidah,300000,176516,Alfred du Lesage,5498,128982,2022-02-16
CASH_IN,215339,Agence_mtn_Cotonou,300000,84661,Alfred du Lesage,128982,344321,2022-02-20
CASH_OUT,268147,Alfred du Lesage,344321,76174,Agence_mtn_Ouidah,300000,31853,2022-02-23
CASH_IN,132193,Agence_mtn_Ouidah,300000,167807,Alfred du Lesage,76174,208367,2022-02-23
CASH_OUT,155502,Alfred du Lesage,208367,52865,Agence_mtn_Ouidah,300000,144498,2022-02-24
CASH_IN,14021,Agence_mtn_Cotonou,300000,285979,Alfred du Lesage,52865,66886,2022-02-27
CASH_OUT,14813,Alfred du Lesage,66886,52073,Agence_mtn_Cotonou,300000,285187,2022-02-27
CASH_IN,115173,Agence_mtn_Cotonou,300000,184827,Margot Renaud,-251437,-136264,2022-02-01
CASH_IN,144943,Agence_mtn_Cotonou,300000,155057,Margot Renaud,-136264,8679,2022-02-01
TRANSFER,1044,Margot Renaud,8679,7635,Margot Renaud,8679,7635,2022-02-04
CASH_IN,297337,Agence_mtn_Abomey,300000,2663,Margot Renaud,7635,304972,2022-02-09
CASH_OUT,105091,Margot Renaud,304972,199881,Agence_mtn_Cotonou,300000,194909,2022-02-10
TRANSFER,92121,Margot Renaud,199881,107760,Margot Renaud,199881,292002,2022-02-10
TRANSFER,67433,Margot Renaud,107760,40327,Margot Renaud,107760,40327,2022-02-11
CASH_OUT,21321,Margot Renaud,40327,19006,Agence_mtn_Abomey,300000,278679,2022-02-19
CASH_OUT,17429,Margot Renaud,19006,1577,Agence_mtn_Abomey,300000,282571,2022-02-21
CASH_IN,153637,Agence_mtn_Abomey,300000,146363,Margot Renaud,1577,155214,2022-02-25
CASH_IN,234799,Agence_mtn_Abomey,300000,65201,Margot Renaud,155214,390013,2022-02-25
CASH_IN,15343,Agence_mtn_Cotonou,300000,284657,Margot Renaud,390013,405356,2022-02-27
CASH_IN,291764,Agence_mtn_Ouidah,300000,8236,Caroline-Lorraine Humbert,1992900,2284664,2022-03-02
CASH_IN,190027,Agence_mtn_Abomey,300000,109973,Caroline-Lorraine Humbert,2284664,2474691,2022-03-24
TRANSFER,421616,Caroline-Lorraine Humbert,2474691,2053075,Raymond Rossi,236600,-185016,2022-03-27
TRANSFER,113402,Marie Picard,239400,125998,Alexandre Rémy,518800,632202,2022-03-01
CASH_OUT,608616,Alexandre Rémy,632202,23586,Agence_mtn_Cotonou,300000,-308616,2022-03-10
CASH_IN,149810,Agence_mtn_Ouidah,300000,150190,Alexandre Rémy,23586,173396,2022-03-21
CASH_IN,235764,Agence_mtn_Ouidah,300000,64236,Martine Wagner de la Bègue,1673900,1909664,2022-03-01
CASH_IN,299882,Agence_mtn_Abomey,300000,118,Martine Wagner de la Bègue,1909664,2209546,2022-03-12
CASH_IN,275905,Agence_mtn_Abomey,300000,24095,William Le Lucas,667700,943605,2022-03-11
CASH_OUT,59031,Isabelle Rossi,746900,687869,Agence_mtn_Abomey,300000,240969,2022-03-20
CASH_IN,240964,Agence_mtn_Cotonou,300000,59036,Roland Garcia,1744000,1984964,2022-03-03
CASH_IN,190717,Agence_mtn_Abomey,300000,109283,Roland Garcia,1984964,2175681,2022-03-07
CASH_IN,225322,Agence_mtn_Abomey,300000,74678,Roland Garcia,2175681,2401003,2022-03-20
TRANSFER,1129834,Roland Garcia,2401003,1271169,Éléonore-Hélène Dubois,290800,-839034,2022-03-25
CASH_IN,228437,Agence_mtn_Abomey,300000,71563,Louise Girard,861700,1090137,2022-03-17
CASH_IN,146453,Agence_mtn_Abomey,300000,153547,Cécile Clerc,239500,385953,2022-03-03
CASH_IN,269991,Agence_mtn_Abomey,300000,30009,Cécile Clerc,385953,655944,2022-03-18
CASH_IN,111053,Agence_mtn_Cotonou,300000,188947,Joséphine Gros,461400,572453,2022-03-18
CASH_OUT,1796467,Michelle Lebon,1947200,150733,Agence_mtn_Cotonou,300000,-1496467,2022-03-22
CASH_OUT,67118,Gilbert-Charles Thibault,530700,463582,Agence_mtn_Ouidah,300000,232882,2022-03-09
CASH_OUT,118696,Gilbert-Charles Thibault,463582,344886,Agence_mtn_Cotonou,300000,181304,2022-03-12
CASH_IN,296948,Agence_mtn_Ouidah,300000,3052,Gilbert-Charles Thibault,344886,641834,2022-03-14
CASH_OUT,487094,Gilbert-Charles Thibault,641834,154740,Agence_mtn_Ouidah,300000,-187094,2022-03-20
CASH_IN,100692,Agence_mtn_Cotonou,300000,199308,Alphonse Leclercq-Rousseau,1554000,1654692,2022-03-02
CASH_IN,246966,Agence_mtn_Ouidah,300000,53034,Alphonse Leclercq-Rousseau,1654692,1901658,2022-03-07
CASH_IN,132434,Agence_mtn_Cotonou,300000,167566,Alphonse Leclercq-Rousseau,1901658,2034092,2022-03-11
CASH_IN,270300,Agence_mtn_Cotonou,300000,29700,Pierre Reynaud,477000,747300,2022-03-19
CASH_IN,157460,Agence_mtn_Abomey,300000,142540,Alix Maillet,74200,231660,2022-03-05
CASH_IN,86918,Agence_mtn_Cotonou,300000,213082,Alix Maillet,231660,318578,2022-03-24
TRANSFER,5627,Philippine Courtois,408600,402973,Rémy de la Roux,396600,402227,2022-03-08
CASH_IN,67422,Agence_mtn_Ouidah,300000,232578,Rémy de la Roux,402227,469649,2022-03-26
CASH_IN,143008,Agence_mtn_Ouidah,300000,156992,Théodore De Oliveira-Nicolas,1047900,1190908,2022-03-16
TRANSFER,921745,Théodore De Oliveira-Nicolas,1190908,269163,Laure Philippe,1956300,1034555,2022-03-18
CASH_IN,28518,Agence_mtn_Ouidah,300000,271482,Cécile Germain,1276900,1305418,2022-03-05
CASH_OUT,168186,Cécile Germain,1305418,1137232,Agence_mtn_Cotonou,300000,131814,2022-03-06
TRANSFER,178990,Cécile Germain,1137232,958242,Margot Riou du Fernandes,1026500,847510,2022-03-07
TRANSFER,539149,Cécile Germain,958242,419093,Frédéric Couturier,1250100,710951,2022-03-21
TRANSFER,94757,Sébastien Vallée,904200,809443,Adèle Labbé,1595800,1501043,2022-03-13
CASH_OUT,626837,Sébastien Vallée,809443,182606,Agence_mtn_Abomey,300000,-326837,2022-03-26
TRANSFER,198848,François Michel-Legros,1071300,872452,Xavier de Lebreton,1708000,1906848,2022-03-01
TRANSFER,1067192,Xavier de Lebreton,1906848,839656,Victoire-Nicole Lopez,1507800,440608,2022-03-01
CASH_IN,170055,Agence_mtn_Abomey,300000,129945,Xavier de Lebreton,839656,1009711,2022-03-05
TRANSFER,138376,Bertrand Le Roux,503400,365024,Xavier de Lebreton,1009711,1148087,2022-03-08
CASH_IN,181442,Agence_mtn_Ouidah,300000,118558,Xavier de Lebreton,1148087,1329529,2022-03-11
TRANSFER,396415,Xavier de Lebreton,1329529,933114,David Guérin,1054400,657985,2022-03-11
TRANSFER,761220,Renée David,1812400,1051180,Xavier de Lebreton,933114,1694334,2022-03-11
TRANSFER,1604572,Xavier de Lebreton,1694334,89762,Philippine Courtois,402973,-1201599,2022-03-13
TRANSFER,1880809,Geneviève Grondin,1961600,80791,Xavier de Lebreton,89762,1970571,2022-03-17
CASH_OUT,1043200,Xavier de Lebreton,1970571,927371,Agence_mtn_Abomey,300000,-743200,2022-03-17
CASH_IN,293027,Agence_mtn_Cotonou,300000,6973,Xavier de Lebreton,927371,1220398,2022-03-17
CASH_IN,21423,Agence_mtn_Ouidah,300000,278577,Xavier de Lebreton,1220398,1241821,2022-03-18
CASH_IN,31543,Agence_mtn_Ouidah,300000,268457,Xavier de Lebreton,1241821,1273364,2022-03-18
CASH_OUT,1090864,Xavier de Lebreton,1273364,182500,Agence_mtn_Abomey,300000,-790864,2022-03-19
CASH_IN,266950,Agence_mtn_Ouidah,300000,33050,Xavier de Lebreton,182500,449450,2022-03-20
CASH_OUT,162286,Xavier de Lebreton,449450,287164,Agence_mtn_Abomey,300000,137714,2022-03-21
TRANSFER,148014,Xavier de Lebreton,287164,139150,Valentine Richard-Bourdon,1593500,1445486,2022-03-21
CASH_IN,296869,Agence_mtn_Abomey,300000,3131,Xavier de Lebreton,139150,436019,2022-03-22
TRANSFER,47588,Xavier de Lebreton,436019,388431,Gabriel Humbert,535800,488212,2022-03-22
CASH_OUT,360148,Xavier de Lebreton,388431,28283,Agence_mtn_Abomey,300000,-60148,2022-03-22
CASH_OUT,5372,Xavier de Lebreton,28283,22911,Agence_mtn_Ouidah,300000,294628,2022-03-22
CASH_OUT,8599,Xavier de Lebreton,22911,14312,Agence_mtn_Abomey,300000,291401,2022-03-23
TRANSFER,6511,Victoire-Nicole Lopez,440608,434097,Xavier de Lebreton,14312,20823,2022-03-24
CASH_IN,2039,Agence_mtn_Cotonou,300000,297961,Xavier de Lebreton,20823,22862,2022-03-27
TRANSFER,1402150,Laurent-Bertrand Lefort,1835500,433350,Vincent Fournier,43600,-1358550,2022-03-02
CASH_IN,162360,Agence_mtn_Cotonou,300000,137640,Laurent-Bertrand Lefort,433350,595710,2022-03-03
TRANSFER,172907,Laurent-Bertrand Lefort,595710,422803,Hortense Lemaire,1934200,1761293,2022-03-03
CASH_OUT,291395,Laurent-Bertrand Lefort,422803,131408,Agence_mtn_Abomey,300000,8605,2022-03-03
TRANSFER,79787,Marcelle Paris,543400,463613,Laurent-Bertrand Lefort,131408,211195,2022-03-04
CASH_IN,110706,Agence_mtn_Ouidah,300000,189294,Laurent-Bertrand Lefort,211195,321901,2022-03-04
TRANSFER,363960,Valentine Martinez,1011300,647340,Laurent-Bertrand Lefort,321901,685861,2022-03-08
CASH_OUT,321756,Laurent-Bertrand Lefort,685861,364105,Agence_mtn_Abomey,300000,-21756,2022-03-08
TRANSFER,31977,Laurent-Bertrand Lefort,364105,332128,David Guérin,657985,626008,2022-03-08
CASH_OUT,42055,Laurent-Bertrand Lefort,332128,290073,Agence_mtn_Ouidah,300000,257945,2022-03-09
TRANSFER,329425,Pénélope Ollivier,503800,174375,Laurent-Bertrand Lefort,290073,619498,2022-03-10
TRANSFER,972304,Nathalie Pages,1482500,510196,Laurent-Bertrand Lefort,619498,1591802,2022-03-14
TRANSFER,1279511,Corinne-Louise Valentin,1310900,31389,Laurent-Bertrand Lefort,1591802,2871313,2022-03-15
CASH_OUT,2455868,Laurent-Bertrand Lefort,2871313,415445,Agence_mtn_Ouidah,300000,-2155868,2022-03-17
CASH_OUT,261170,Laurent-Bertrand Lefort,415445,154275,Agence_mtn_Ouidah,300000,38830,2022-03-17
CASH_IN,193601,Agence_mtn_Ouidah,300000,106399,Laurent-Bertrand Lefort,154275,347876,2022-03-18
TRANSFER,534867,Richard Le Descamps,918500,383633,Laurent-Bertrand Lefort,347876,882743,2022-03-18
TRANSFER,650906,Laurent-Bertrand Lefort,882743,231837,Catherine Faivre,1936300,1285394,2022-03-19
TRANSFER,108395,Laurent-Bertrand Lefort,231837,123442,Gabriel-Tristan Marty,1420400,1312005,2022-03-20
TRANSFER,65579,Laurent-Bertrand Lefort,123442,57863,Aurore Guyon,984400,918821,2022-03-20
CASH_IN,142367,Agence_mtn_Cotonou,300000,157633,Laurent-Bertrand Lefort,57863,200230,2022-03-20
CASH_OUT,109440,Laurent-Bertrand Lefort,200230,90790,Agence_mtn_Ouidah,300000,190560,2022-03-22
CASH_OUT,66502,Laurent-Bertrand Lefort,90790,24288,Agence_mtn_Abomey,300000,233498,2022-03-23
CASH_OUT,20961,Laurent-Bertrand Lefort,24288,3327,Agence_mtn_Cotonou,300000,279039,2022-03-23
CASH_IN,256900,Agence_mtn_Cotonou,300000,43100,Laurent-Bertrand Lefort,3327,260227,2022-03-23
CASH_IN,203956,Agence_mtn_Cotonou,300000,96044,Laurent-Bertrand Lefort,260227,464183,2022-03-24
CASH_IN,69175,Agence_mtn_Abomey,300000,230825,Laurent-Bertrand Lefort,464183,533358,2022-03-25
CASH_IN,271613,Agence_mtn_Ouidah,300000,28387,Laurent-Bertrand Lefort,533358,804971,2022-03-26
TRANSFER,256917,Alexandrie Delmas,449200,192283,Laurent-Bertrand Lefort,804971,1061888,2022-03-27
CASH_OUT,95196,Marcelle Paris,463613,368417,Agence_mtn_Abomey,300000,204804,2022-03-03
CASH_IN,86309,Agence_mtn_Abomey,300000,213691,Marcelle Paris,368417,454726,2022-03-04
CASH_OUT,42258,Marcelle Paris,454726,412468,Agence_mtn_Abomey,300000,257742,2022-03-04
CASH_OUT,64346,Marcelle Paris,412468,348122,Agence_mtn_Abomey,300000,235654,2022-03-06
CASH_OUT,302264,Marcelle Paris,348122,45858,Agence_mtn_Ouidah,300000,-2264,2022-03-07
CASH_IN,285638,Agence_mtn_Ouidah,300000,14362,Marcelle Paris,45858,331496,2022-03-08
CASH_IN,173298,Agence_mtn_Abomey,300000,126702,Marcelle Paris,331496,504794,2022-03-08
CASH_OUT,328658,Marcelle Paris,504794,176136,Agence_mtn_Abomey,300000,-28658,2022-03-09
TRANSFER,170570,Marcelle Paris,176136,5566,Sophie Lévêque,561400,390830,2022-03-10
TRANSFER,272224,Antoine Leleu,636800,364576,Marcelle Paris,5566,277790,2022-03-13
CASH_IN,15944,Agence_mtn_Cotonou,300000,284056,Marcelle Paris,277790,293734,2022-03-14
CASH_OUT,270985,Marcelle Paris,293734,22749,Agence_mtn_Abomey,300000,29015,2022-03-14
CASH_IN,189077,Agence_mtn_Cotonou,300000,110923,Marcelle Paris,22749,211826,2022-03-15
CASH_IN,165529,Agence_mtn_Ouidah,300000,134471,Marcelle Paris,211826,377355,2022-03-16
CASH_OUT,158956,Marcelle Paris,377355,218399,Agence_mtn_Ouidah,300000,141044,2022-03-16
CASH_IN,27064,Agence_mtn_Abomey,300000,272936,Marcelle Paris,218399,245463,2022-03-18
CASH_IN,147091,Agence_mtn_Ouidah,300000,152909,Marcelle Paris,245463,392554,2022-03-21
CASH_OUT,134973,Marcelle Paris,392554,257581,Agence_mtn_Ouidah,300000,165027,2022-03-22
TRANSFER,40370,Franck-Charles Texier,178900,138530,Marcelle Paris,257581,297951,2022-03-23
CASH_OUT,183301,Marcelle Paris,297951,114650,Agence_mtn_Ouidah,300000,116699,2022-03-24
TRANSFER,65130,Marcelle Paris,114650,49520,Zoé Renaud de Boutin,1311000,1245870,2022-03-24
CASH_IN,63883,Agence_mtn_Cotonou,300000,236117,Marcelle Paris,49520,113403,2022-03-26
CASH_OUT,7964,Marcelle Paris,113403,105439,Agence_mtn_Cotonou,300000,292036,2022-03-26
CASH_OUT,82078,Marcelle Paris,105439,23361,Agence_mtn_Ouidah,300000,217922,2022-03-27
CASH_OUT,7808,Marcelle Paris,23361,15553,Agence_mtn_Ouidah,300000,292192,2022-03-27
TRANSFER,433200,Cécile Delattre-Arnaud,751500,318300,François Michel-Legros,872452,439252,2022-03-01
CASH_OUT,310122,Cécile Delattre-Arnaud,318300,8178,Agence_mtn_Ouidah,300000,-10122,2022-03-01
TRANSFER,609276,Laure Philippe,1034555,425279,Cécile Delattre-Arnaud,8178,617454,2022-03-01
CASH_OUT,294353,Cécile Delattre-Arnaud,617454,323101,Agence_mtn_Cotonou,300000,5647,2022-03-01
TRANSFER,853358,Pénélope Dupuis,1314300,460942,Cécile Delattre-Arnaud,323101,1176459,2022-03-01
CASH_IN,1014,Agence_mtn_Ouidah,300000,298986,Cécile Delattre-Arnaud,1176459,1177473,2022-03-04
CASH_OUT,467636,Cécile Delattre-Arnaud,1177473,709837,Agence_mtn_Cotonou,300000,-167636,2022-03-06
CASH_OUT,361731,Cécile Delattre-Arnaud,709837,348106,Agence_mtn_Cotonou,300000,-61731,2022-03-06
CASH_OUT,153606,Cécile Delattre-Arnaud,348106,194500,Agence_mtn_Cotonou,300000,146394,2022-03-07
CASH_IN,43443,Agence_mtn_Cotonou,300000,256557,Cécile Delattre-Arnaud,194500,237943,2022-03-07
CASH_IN,258951,Agence_mtn_Ouidah,300000,41049,Cécile Delattre-Arnaud,237943,496894,2022-03-09
CASH_IN,213011,Agence_mtn_Ouidah,300000,86989,Cécile Delattre-Arnaud,496894,709905,2022-03-10
TRANSFER,207617,Xavier Leblanc-Ferreira,1941100,1733483,Cécile Delattre-Arnaud,709905,917522,2022-03-13
CASH_OUT,543474,Cécile Delattre-Arnaud,917522,374048,Agence_mtn_Cotonou,300000,-243474,2022-03-15
TRANSFER,150404,Cécile Delattre-Arnaud,374048,223644,Valentine Martinez,647340,496936,2022-03-17
CASH_IN,182949,Agence_mtn_Abomey,300000,117051,Cécile Delattre-Arnaud,223644,406593,2022-03-18
CASH_IN,226893,Agence_mtn_Cotonou,300000,73107,Cécile Delattre-Arnaud,406593,633486,2022-03-20
TRANSFER,609559,Cécile Delattre-Arnaud,633486,23927,Émilie Moulin,58700,-550859,2022-03-21
CASH_IN,43376,Agence_mtn_Abomey,300000,256624,Cécile Delattre-Arnaud,23927,67303,2022-03-22
CASH_OUT,48377,Cécile Delattre-Arnaud,67303,18926,Agence_mtn_Ouidah,300000,251623,2022-03-22
CASH_IN,140171,Agence_mtn_Cotonou,300000,159829,Cécile Delattre-Arnaud,18926,159097,2022-03-23
TRANSFER,151083,Cécile Delattre-Arnaud,159097,8014,Alfred du Lesage,38300,-112783,2022-03-25
CASH_OUT,117196,Louis Pichon,149900,32704,Agence_mtn_Abomey,300000,182804,2022-03-02
TRANSFER,12984,Louis Pichon,32704,19720,David Guérin,626008,613024,2022-03-02
TRANSFER,6894,Louis Pichon,19720,12826,Xavier Leblanc-Ferreira,1733483,1726589,2022-03-03
CASH_IN,80815,Agence_mtn_Cotonou,300000,219185,Louis Pichon,12826,93641,2022-03-05
TRANSFER,57196,Louis Pichon,93641,36445,Valérie Dijoux,1491700,1434504,2022-03-06
CASH_OUT,29970,Louis Pichon,36445,6475,Agence_mtn_Abomey,300000,270030,2022-03-07
TRANSFER,4674,Louis Pichon,6475,1801,Vincent Mathieu,1304400,1299726,2022-03-08
CASH_OUT,836,Louis Pichon,1801,965,Agence_mtn_Cotonou,300000,299164,2022-03-10
CASH_OUT,283,Louis Pichon,965,682,Agence_mtn_Cotonou,300000,299717,2022-03-10
CASH_OUT,376,Louis Pichon,682,306,Agence_mtn_Cotonou,300000,299624,2022-03-12
TRANSFER,714400,Claude Foucher,1062700,348300,Louis Pichon,306,714706,2022-03-12
CASH_IN,119525,Agence_mtn_Ouidah,300000,180475,Louis Pichon,714706,834231,2022-03-15
TRANSFER,523616,Louis Pichon,834231,310615,Antoine Leleu,364576,-159040,2022-03-16
TRANSFER,441623,Honoré du Laurent,956400,514777,Louis Pichon,310615,752238,2022-03-16
CASH_OUT,278378,Louis Pichon,752238,473860,Agence_mtn_Cotonou,300000,21622,2022-03-17
TRANSFER,451242,Margot Riou du Fernandes,847510,396268,Louis Pichon,473860,925102,2022-03-18
CASH_OUT,749010,Louis Pichon,925102,176092,Agence_mtn_Ouidah,300000,-449010,2022-03-23
TRANSFER,72299,Louis Pichon,176092,103793,Sébastien Lemaître,1982700,1910401,2022-03-24
TRANSFER,338605,Inès Hamon,634900,296295,Louis Pichon,103793,442398,2022-03-24
CASH_IN,147320,Agence_mtn_Cotonou,300000,152680,Louis Pichon,442398,589718,2022-03-24
TRANSFER,267243,Louis Pichon,589718,322475,Gilbert Foucher,1738400,1471157,2022-03-25
CASH_IN,164657,Agence_mtn_Cotonou,300000,135343,Aurore Guyon,918821,1083478,2022-03-01
TRANSFER,920124,Aurore Guyon,1083478,163354,Aurore Guyon,1083478,2003602,2022-03-02
CASH_IN,17990,Agence_mtn_Cotonou,300000,282010,Aurore Guyon,163354,181344,2022-03-05
TRANSFER,92914,Aurore Guyon,181344,88430,Léon Lecoq,1097100,1004186,2022-03-08
CASH_OUT,66290,Aurore Guyon,88430,22140,Agence_mtn_Ouidah,300000,233710,2022-03-08
CASH_IN,165497,Agence_mtn_Abomey,300000,134503,Aurore Guyon,22140,187637,2022-03-09
CASH_IN,101697,Agence_mtn_Ouidah,300000,198303,Aurore Guyon,187637,289334,2022-03-10
TRANSFER,66579,Aurore Guyon,289334,222755,Richard Le Descamps,383633,317054,2022-03-12
CASH_IN,273353,Agence_mtn_Cotonou,300000,26647,Aurore Guyon,222755,496108,2022-03-13
TRANSFER,142069,Laure Philippe,425279,283210,Aurore Guyon,496108,638177,2022-03-15
CASH_OUT,3631,Aurore Guyon,638177,634546,Agence_mtn_Cotonou,300000,296369,2022-03-15
CASH_IN,205836,Agence_mtn_Abomey,300000,94164,Aurore Guyon,634546,840382,2022-03-16
CASH_IN,14437,Agence_mtn_Abomey,300000,285563,Aurore Guyon,840382,854819,2022-03-18
CASH_OUT,8900,Aurore Guyon,854819,845919,Agence_mtn_Ouidah,300000,291100,2022-03-18
TRANSFER,300394,Bertrand Le Roux,365024,64630,Aurore Guyon,845919,1146313,2022-03-18
CASH_IN,4933,Agence_mtn_Abomey,300000,295067,Aurore Guyon,1146313,1151246,2022-03-18
TRANSFER,107829,Thibault Moreno,359200,251371,Aurore Guyon,1151246,1259075,2022-03-19
TRANSFER,1083779,Aurore Guyon,1259075,175296,Zoé Renaud de Boutin,1245870,162091,2022-03-22
CASH_IN,194037,Agence_mtn_Cotonou,300000,105963,Aurore Guyon,175296,369333,2022-03-23
CASH_OUT,144438,Aurore Guyon,369333,224895,Agence_mtn_Abomey,300000,155562,2022-03-24
CASH_IN,25230,Agence_mtn_Cotonou,300000,274770,Aurore Guyon,224895,250125,2022-03-25
CASH_OUT,60758,Aurore Guyon,250125,189367,Agence_mtn_Cotonou,300000,239242,2022-03-25
CASH_OUT,85768,Aurore Guyon,189367,103599,Agence_mtn_Abomey,300000,214232,2022-03-25
CASH_OUT,23998,Aurore Guyon,103599,79601,Agence_mtn_Ouidah,300000,276002,2022-03-25
CASH_IN,251346,Agence_mtn_Cotonou,300000,48654,Aurore Guyon,79601,330947,2022-03-25
CASH_IN,221980,Agence_mtn_Cotonou,300000,78020,Aurore Guyon,330947,552927,2022-03-25
CASH_IN,88400,Agence_mtn_Abomey,300000,211600,Aurore Guyon,552927,641327,2022-03-27
CASH_IN,287390,Agence_mtn_Abomey,300000,12610,Antoine Leleu,-159040,128350,2022-03-01
CASH_IN,75611,Agence_mtn_Ouidah,300000,224389,Antoine Leleu,128350,203961,2022-03-02
TRANSFER,147812,Antoine Leleu,203961,56149,Antoine Leleu,203961,56149,2022-03-05
CASH_IN,288029,Agence_mtn_Abomey,300000,11971,Antoine Leleu,56149,344178,2022-03-07
TRANSFER,473053,Adèle Labbé,1501043,1027990,Antoine Leleu,344178,817231,2022-03-07
CASH_OUT,527028,Antoine Leleu,817231,290203,Agence_mtn_Ouidah,300000,-227028,2022-03-07
CASH_IN,197462,Agence_mtn_Abomey,300000,102538,Antoine Leleu,290203,487665,2022-03-07
CASH_IN,31404,Agence_mtn_Ouidah,300000,268596,Antoine Leleu,487665,519069,2022-03-08
TRANSFER,1354287,Margot Renaud,1484400,130113,Antoine Leleu,519069,1873356,2022-03-09
CASH_OUT,202676,Antoine Leleu,1873356,1670680,Agence_mtn_Cotonou,300000,97324,2022-03-10
CASH_OUT,388740,Antoine Leleu,1670680,1281940,Agence_mtn_Ouidah,300000,-88740,2022-03-11
CASH_OUT,1212517,Antoine Leleu,1281940,69423,Agence_mtn_Cotonou,300000,-912517,2022-03-12
TRANSFER,25023,Antoine Leleu,69423,44400,Étienne Roche,63500,38477,2022-03-13
CASH_IN,21468,Agence_mtn_Cotonou,300000,278532,Antoine Leleu,44400,65868,2022-03-13
CASH_IN,54658,Agence_mtn_Ouidah,300000,245342,Antoine Leleu,65868,120526,2022-03-15
TRANSFER,185089,Honoré du Laurent,514777,329688,Antoine Leleu,120526,305615,2022-03-16
CASH_IN,70171,Agence_mtn_Cotonou,300000,229829,Antoine Leleu,305615,375786,2022-03-17
CASH_IN,266569,Agence_mtn_Cotonou,300000,33431,Antoine Leleu,375786,642355,2022-03-18
CASH_OUT,210462,Antoine Leleu,642355,431893,Agence_mtn_Abomey,300000,89538,2022-03-20
TRANSFER,1676616,Thierry Delattre-Simon,1720800,44184,Antoine Leleu,431893,2108509,2022-03-21
CASH_OUT,184213,Antoine Leleu,2108509,1924296,Agence_mtn_Ouidah,300000,115787,2022-03-21
TRANSFER,294240,Antoine Leleu,1924296,1630056,Rémy Le Michaud,535700,241460,2022-03-23
CASH_IN,240431,Agence_mtn_Cotonou,300000,59569,Antoine Leleu,1630056,1870487,2022-03-24
TRANSFER,93417,David du Blondel,1092900,999483,Antoine Leleu,1870487,1963904,2022-03-25
TRANSFER,101187,Margot Renaud,130113,28926,Antoine Leleu,1963904,2065091,2022-03-25
CASH_OUT,975409,Antoine Leleu,2065091,1089682,Agence_mtn_Abomey,300000,-675409,2022-03-26
CASH_IN,175939,Agence_mtn_Cotonou,300000,124061,Éléonore-Hélène Dubois,-839034,-663095,2022-03-01
CASH_IN,270678,Agence_mtn_Ouidah,300000,29322,Éléonore-Hélène Dubois,-663095,-392417,2022-03-02
CASH_IN,195223,Agence_mtn_Abomey,300000,104777,Éléonore-Hélène Dubois,-392417,-197194,2022-03-02
CASH_IN,138054,Agence_mtn_Ouidah,300000,161946,Éléonore-Hélène Dubois,-197194,-59140,2022-03-03
CASH_IN,277285,Agence_mtn_Cotonou,300000,22715,Éléonore-Hélène Dubois,-59140,218145,2022-03-03
TRANSFER,138210,Éléonore-Hélène Dubois,218145,79935,David du Blondel,999483,861273,2022-03-04
CASH_OUT,17250,Éléonore-Hélène Dubois,79935,62685,Agence_mtn_Cotonou,300000,282750,2022-03-04
TRANSFER,398050,Pénélope Dupuis,460942,62892,Éléonore-Hélène Dubois,62685,460735,2022-03-08
CASH_IN,137728,Agence_mtn_Abomey,300000,162272,Éléonore-Hélène Dubois,460735,598463,2022-03-09
CASH_OUT,497546,Éléonore-Hélène Dubois,598463,100917,Agence_mtn_Ouidah,300000,-197546,2022-03-10
TRANSFER,37249,Franck-Charles Texier,138530,101281,Éléonore-Hélène Dubois,100917,138166,2022-03-10
TRANSFER,58403,Éléonore-Hélène Dubois,138166,79763,Gabriel Humbert,488212,429809,2022-03-11
CASH_OUT,23691,Éléonore-Hélène Dubois,79763,56072,Agence_mtn_Ouidah,300000,276309,2022-03-11
CASH_IN,133358,Agence_mtn_Abomey,300000,166642,Éléonore-Hélène Dubois,56072,189430,2022-03-12
CASH_OUT,187826,Éléonore-Hélène Dubois,189430,1604,Agence_mtn_Ouidah,300000,112174,2022-03-12
CASH_IN,207708,Agence_mtn_Abomey,300000,92292,Éléonore-Hélène Dubois,1604,209312,2022-03-14
TRANSFER,205405,Éléonore-Hélène Dubois,209312,3907,Thibault Moreno,251371,45966,2022-03-15
CASH_OUT,562,Éléonore-Hélène Dubois,3907,3345,Agence_mtn_Abomey,300000,299438,2022-03-17
CASH_IN,207693,Agence_mtn_Ouidah,300000,92307,Éléonore-Hélène Dubois,3345,211038,2022-03-17
TRANSFER,240382,Victoire-Nicole Lopez,434097,193715,Éléonore-Hélène Dubois,211038,451420,2022-03-17
TRANSFER,178490,Rémy Le Michaud,241460,62970,Éléonore-Hélène Dubois,451420,629910,2022-03-17
CASH_OUT,467665,Éléonore-Hélène Dubois,629910,162245,Agence_mtn_Cotonou,300000,-167665,2022-03-19
TRANSFER,77818,David Guérin,613024,535206,Éléonore-Hélène Dubois,162245,240063,2022-03-21
CASH_OUT,31570,Éléonore-Hélène Dubois,240063,208493,Agence_mtn_Abomey,300000,268430,2022-03-25
CASH_IN,208641,Agence_mtn_Cotonou,300000,91359,Éléonore-Hélène Dubois,208493,417134,2022-03-26
TRANSFER,12005,Jeanne Garnier,30400,18395,Éléonore-Hélène Dubois,417134,429139,2022-03-27
CASH_OUT,652244,Adèle Labbé,1027990,375746,Agence_mtn_Abomey,300000,-352244,2022-03-01
CASH_OUT,352129,Adèle Labbé,375746,23617,Agence_mtn_Cotonou,300000,-52129,2022-03-03
CASH_IN,290552,Agence_mtn_Abomey,300000,9448,Adèle Labbé,23617,314169,2022-03-04
TRANSFER,56516,Alphonse Le Olivier,677400,620884,Adèle Labbé,314169,370685,2022-03-06
CASH_OUT,31392,Adèle Labbé,370685,339293,Agence_mtn_Ouidah,300000,268608,2022-03-08
CASH_OUT,257639,Adèle Labbé,339293,81654,Agence_mtn_Cotonou,300000,42361,2022-03-10
TRANSFER,77469,Adèle Labbé,81654,4185,Thibault Moreno,45966,-31503,2022-03-10
CASH_OUT,3984,Adèle Labbé,4185,201,Agence_mtn_Ouidah,300000,296016,2022-03-10
CASH_OUT,175,Adèle Labbé,201,26,Agence_mtn_Abomey,300000,299825,2022-03-11
CASH_IN,240716,Agence_mtn_Cotonou,300000,59284,Adèle Labbé,26,240742,2022-03-12
CASH_IN,129057,Agence_mtn_Ouidah,300000,170943,Adèle Labbé,240742,369799,2022-03-15
CASH_OUT,21371,Adèle Labbé,369799,348428,Agence_mtn_Cotonou,300000,278629,2022-03-16
CASH_OUT,167747,Adèle Labbé,348428,180681,Agence_mtn_Cotonou,300000,132253,2022-03-16
CASH_IN,216988,Agence_mtn_Ouidah,300000,83012,Adèle Labbé,180681,397669,2022-03-16
TRANSFER,164846,Inès Hamon,296295,131449,Adèle Labbé,397669,562515,2022-03-17
CASH_OUT,272261,Adèle Labbé,562515,290254,Agence_mtn_Abomey,300000,27739,2022-03-18
CASH_OUT,68012,Adèle Labbé,290254,222242,Agence_mtn_Abomey,300000,231988,2022-03-18
CASH_IN,101265,Agence_mtn_Abomey,300000,198735,Adèle Labbé,222242,323507,2022-03-19
CASH_OUT,121401,Adèle Labbé,323507,202106,Agence_mtn_Abomey,300000,178599,2022-03-21
TRANSFER,313664,Gilbert Foucher,1471157,1157493,Adèle Labbé,202106,515770,2022-03-21
TRANSFER,147419,Adèle Labbé,515770,368351,Honoré du Laurent,329688,182269,2022-03-22
CASH_OUT,92710,Adèle Labbé,368351,275641,Agence_mtn_Abomey,300000,207290,2022-03-22
TRANSFER,191218,François Michel-Legros,439252,248034,Adèle Labbé,275641,466859,2022-03-23
CASH_OUT,150867,Adèle Labbé,466859,315992,Agence_mtn_Abomey,300000,149133,2022-03-25
CASH_IN,31940,Agence_mtn_Abomey,300000,268060,Adèle Labbé,315992,347932,2022-03-27
CASH_OUT,571227,Vincent Mathieu,1299726,728499,Agence_mtn_Ouidah,300000,-271227,2022-03-01
CASH_IN,261680,Agence_mtn_Ouidah,300000,38320,Vincent Mathieu,728499,990179,2022-03-02
TRANSFER,174032,Simone Pineau,657700,483668,Vincent Mathieu,990179,1164211,2022-03-02
TRANSFER,176233,Eugène Poulain,1146200,969967,Vincent Mathieu,1164211,1340444,2022-03-05
TRANSFER,9190,Édouard Nguyen,44100,34910,Vincent Mathieu,1340444,1349634,2022-03-07
CASH_IN,64441,Agence_mtn_Cotonou,300000,235559,Vincent Mathieu,1349634,1414075,2022-03-07
CASH_IN,2463,Agence_mtn_Abomey,300000,297537,Vincent Mathieu,1414075,1416538,2022-03-07
CASH_OUT,251234,Vincent Mathieu,1416538,1165304,Agence_mtn_Ouidah,300000,48766,2022-03-08
TRANSFER,293064,Emmanuelle Georges,1321000,1027936,Vincent Mathieu,1165304,1458368,2022-03-08
CASH_IN,135344,Agence_mtn_Cotonou,300000,164656,Vincent Mathieu,1458368,1593712,2022-03-09
CASH_IN,242336,Agence_mtn_Cotonou,300000,57664,Vincent Mathieu,1593712,1836048,2022-03-09
TRANSFER,1350246,Vincent Mathieu,1836048,485802,Nathalie Pages,510196,-840050,2022-03-10
CASH_OUT,156870,Vincent Mathieu,485802,328932,Agence_mtn_Abomey,300000,143130,2022-03-12
CASH_IN,268140,Agence_mtn_Abomey,300000,31860,Vincent Mathieu,328932,597072,2022-03-13
CASH_OUT,68692,Vincent Mathieu,597072,528380,Agence_mtn_Abomey,300000,231308,2022-03-14
CASH_OUT,140886,Vincent Mathieu,528380,387494,Agence_mtn_Abomey,300000,159114,2022-03-15
CASH_OUT,346312,Vincent Mathieu,387494,41182,Agence_mtn_Abomey,300000,-46312,2022-03-15
TRANSFER,11070,Vincent Mathieu,41182,30112,Valentine Martinez,496936,485866,2022-03-16
CASH_IN,74315,Agence_mtn_Ouidah,300000,225685,Vincent Mathieu,30112,104427,2022-03-17
TRANSFER,50687,Vincent Mathieu,104427,53740,Thierry Delattre-Simon,44184,-6503,2022-03-17
TRANSFER,134395,Renée David,1051180,916785,Vincent Mathieu,53740,188135,2022-03-18
CASH_OUT,130496,Vincent Mathieu,188135,57639,Agence_mtn_Ouidah,300000,169504,2022-03-18
CASH_OUT,2403,Vincent Mathieu,57639,55236,Agence_mtn_Abomey,300000,297597,2022-03-20
CASH_OUT,48694,Vincent Mathieu,55236,6542,Agence_mtn_Ouidah,300000,251306,2022-03-20
CASH_IN,242431,Agence_mtn_Abomey,300000,57569,Vincent Mathieu,6542,248973,2022-03-20
TRANSFER,237364,Laure Philippe,283210,45846,Vincent Mathieu,248973,486337,2022-03-21
CASH_OUT,316988,Vincent Mathieu,486337,169349,Agence_mtn_Abomey,300000,-16988,2022-03-22
CASH_IN,288256,Agence_mtn_Abomey,300000,11744,Vincent Mathieu,169349,457605,2022-03-24
CASH_IN,257031,Agence_mtn_Ouidah,300000,42969,Vincent Mathieu,457605,714636,2022-03-26
CASH_OUT,483226,Vincent Mathieu,714636,231410,Agence_mtn_Abomey,300000,-183226,2022-03-27
CASH_OUT,366185,Eugène Poulain,969967,603782,Agence_mtn_Abomey,300000,-66185,2022-03-02
CASH_IN,5482,Agence_mtn_Cotonou,300000,294518,Eugène Poulain,603782,609264,2022-03-05
CASH_OUT,110412,Eugène Poulain,609264,498852,Agence_mtn_Cotonou,300000,189588,2022-03-05
TRANSFER,202251,Eugène Poulain,498852,296601,Honoré du Laurent,182269,-19982,2022-03-06
TRANSFER,64514,Eugène Poulain,296601,232087,Sophie Lévêque,390830,326316,2022-03-06
TRANSFER,210391,Eugène Poulain,232087,21696,Valérie Dijoux,1434504,1224113,2022-03-06
CASH_OUT,3297,Eugène Poulain,21696,18399,Agence_mtn_Abomey,300000,296703,2022-03-08
TRANSFER,13628,Eugène Poulain,18399,4771,Nath Bruneau,7700,-5928,2022-03-09
TRANSFER,685,Eugène Poulain,4771,4086,Simone Pineau,483668,482983,2022-03-11
TRANSFER,119448,Zoé Renaud de Boutin,162091,42643,Eugène Poulain,4086,123534,2022-03-12
CASH_IN,192756,Agence_mtn_Abomey,300000,107244,Eugène Poulain,123534,316290,2022-03-13
TRANSFER,55556,Eugène Poulain,316290,260734,Corinne-Louise Valentin,31389,-24167,2022-03-14
CASH_OUT,172873,Eugène Poulain,260734,87861,Agence_mtn_Abomey,300000,127127,2022-03-14
CASH_IN,99045,Agence_mtn_Ouidah,300000,200955,Eugène Poulain,87861,186906,2022-03-15
CASH_OUT,115596,Eugène Poulain,186906,71310,Agence_mtn_Ouidah,300000,184404,2022-03-15
CASH_OUT,38079,Eugène Poulain,71310,33231,Agence_mtn_Abomey,300000,261921,2022-03-15
CASH_OUT,23083,Eugène Poulain,33231,10148,Agence_mtn_Cotonou,300000,276917,2022-03-16
TRANSFER,8880,Eugène Poulain,10148,1268,Renée David,916785,907905,2022-03-19
CASH_IN,78526,Agence_mtn_Ouidah,300000,221474,Eugène Poulain,1268,79794,2022-03-19
CASH_IN,124020,Agence_mtn_Abomey,300000,175980,Eugène Poulain,79794,203814,2022-03-22
CASH_IN,262223,Agence_mtn_Ouidah,300000,37777,Eugène Poulain,203814,466037,2022-03-23
TRANSFER,111035,William Lebrun,113200,2165,Eugène Poulain,466037,577072,2022-03-23
TRANSFER,471742,Eugène Poulain,577072,105330,Céline Gomez,1343700,871958,2022-03-25
TRANSFER,328562,David Guérin,535206,206644,Eugène Poulain,105330,433892,2022-03-25
CASH_OUT,314584,Eugène Poulain,433892,119308,Agence_mtn_Ouidah,300000,-14584,2022-03-25
CASH_IN,16227,Agence_mtn_Abomey,300000,283773,Eugène Poulain,119308,135535,2022-03-26
TRANSFER,19664,Étienne Roche,38477,18813,Eugène Poulain,135535,155199,2022-03-26
TRANSFER,85422,Catherine Faivre,1285394,1199972,Renée David,907905,993327,2022-03-01
TRANSFER,422502,Renée David,993327,570825,Pénélope Dupuis,62892,-359610,2022-03-03
CASH_OUT,458542,Renée David,570825,112283,Agence_mtn_Ouidah,300000,-158542,2022-03-03
CASH_OUT,83155,Renée David,112283,29128,Agence_mtn_Ouidah,300000,216845,2022-03-05
CASH_IN,1011,Agence_mtn_Abomey,300000,298989,Renée David,29128,30139,2022-03-05
CASH_IN,223864,Agence_mtn_Ouidah,300000,76136,Renée David,30139,254003,2022-03-06
CASH_IN,5964,Agence_mtn_Ouidah,300000,294036,Renée David,254003,259967,2022-03-06
CASH_IN,47856,Agence_mtn_Cotonou,300000,252144,Renée David,259967,307823,2022-03-09
TRANSFER,268111,Xavier Leblanc-Ferreira,1726589,1458478,Renée David,307823,575934,2022-03-09
CASH_OUT,552859,Renée David,575934,23075,Agence_mtn_Abomey,300000,-252859,2022-03-10
TRANSFER,244683,Hortense Lemaire,1761293,1516610,Renée David,23075,267758,2022-03-10
TRANSFER,54084,Renée David,267758,213674,Claude Foucher,348300,294216,2022-03-11
CASH_IN,25518,Agence_mtn_Ouidah,300000,274482,Renée David,213674,239192,2022-03-11
CASH_IN,8863,Agence_mtn_Cotonou,300000,291137,Renée David,239192,248055,2022-03-13
TRANSFER,230311,Renée David,248055,17744,Étienne Roche,18813,-211498,2022-03-14
CASH_IN,90738,Agence_mtn_Abomey,300000,209262,Renée David,17744,108482,2022-03-15
CASH_OUT,58078,Renée David,108482,50404,Agence_mtn_Abomey,300000,241922,2022-03-20
CASH_OUT,41894,Renée David,50404,8510,Agence_mtn_Cotonou,300000,258106,2022-03-20
CASH_IN,171672,Agence_mtn_Cotonou,300000,128328,Renée David,8510,180182,2022-03-21
TRANSFER,117519,Renée David,180182,62663,Sophie Lévêque,326316,208797,2022-03-23
CASH_OUT,16149,Renée David,62663,46514,Agence_mtn_Abomey,300000,283851,2022-03-25
CASH_OUT,6097,Renée David,46514,40417,Agence_mtn_Cotonou,300000,293903,2022-03-25
CASH_OUT,28384,Renée David,40417,12033,Agence_mtn_Abomey,300000,271616,2022-03-26
CASH_IN,54350,Agence_mtn_Ouidah,300000,245650,Renée David,12033,66383,2022-03-26
TRANSFER,52247,Renée David,66383,14136,Benjamin Evrard-Marty,281900,229653,2022-03-27
TRANSFER,319524,Gilbert Foucher,1157493,837969,Renée David,14136,333660,2022-03-27
CASH_OUT,1708,Renée David,333660,331952,Agence_mtn_Cotonou,300000,298292,2022-03-27
CASH_OUT,121500,Margot Riou du Fernandes,396268,274768,Agence_mtn_Abomey,300000,178500,2022-03-02
TRANSFER,565537,Antoinette Bertrand,906800,341263,Margot Riou du Fernandes,274768,840305,2022-03-05
CASH_IN,139703,Agence_mtn_Cotonou,300000,160297,Margot Riou du Fernandes,840305,980008,2022-03-06
CASH_OUT,303091,Margot Riou du Fernandes,980008,676917,Agence_mtn_Abomey,300000,-3091,2022-03-07
CASH_IN,150489,Agence_mtn_Cotonou,300000,149511,Margot Riou du Fernandes,676917,827406,2022-03-10
CASH_OUT,70600,Margot Riou du Fernandes,827406,756806,Agence_mtn_Ouidah,300000,229400,2022-03-13
CASH_IN,221457,Agence_mtn_Ouidah,300000,78543,Margot Riou du Fernandes,756806,978263,2022-03-13
CASH_OUT,382744,Margot Riou du Fernandes,978263,595519,Agence_mtn_Cotonou,300000,-82744,2022-03-15
CASH_OUT,524063,Margot Riou du Fernandes,595519,71456,Agence_mtn_Abomey,300000,-224063,2022-03-15
CASH_OUT,42589,Margot Riou du Fernandes,71456,28867,Agence_mtn_Cotonou,300000,257411,2022-03-15
TRANSFER,116678,Gabriel Humbert,429809,313131,Margot Riou du Fernandes,28867,145545,2022-03-16
CASH_IN,210237,Agence_mtn_Ouidah,300000,89763,Margot Riou du Fernandes,145545,355782,2022-03-18
TRANSFER,221171,Margot Riou du Fernandes,355782,134611,Franck-Charles Texier,101281,-119890,2022-03-18
CASH_OUT,30959,Margot Riou du Fernandes,134611,103652,Agence_mtn_Abomey,300000,269041,2022-03-18
TRANSFER,18762,Margot Riou du Fernandes,103652,84890,Alexandrie Delmas,192283,173521,2022-03-19
CASH_OUT,30528,Margot Riou du Fernandes,84890,54362,Agence_mtn_Ouidah,300000,269472,2022-03-19
CASH_IN,199080,Agence_mtn_Cotonou,300000,100920,Margot Riou du Fernandes,54362,253442,2022-03-20
CASH_OUT,178036,Margot Riou du Fernandes,253442,75406,Agence_mtn_Ouidah,300000,121964,2022-03-20
TRANSFER,106493,David Guérin,206644,100151,Margot Riou du Fernandes,75406,181899,2022-03-20
CASH_IN,53048,Agence_mtn_Ouidah,300000,246952,Margot Riou du Fernandes,181899,234947,2022-03-22
TRANSFER,77581,Margot Riou du Fernandes,234947,157366,Céline Gomez,871958,794377,2022-03-23
CASH_IN,232026,Agence_mtn_Cotonou,300000,67974,Margot Riou du Fernandes,157366,389392,2022-03-25
CASH_IN,51065,Agence_mtn_Ouidah,300000,248935,Corinne-Louise Valentin,-24167,26898,2022-03-03
CASH_OUT,19625,Corinne-Louise Valentin,26898,7273,Agence_mtn_Cotonou,300000,280375,2022-03-04
TRANSFER,2645,Corinne-Louise Valentin,7273,4628,Léon Lecoq,1004186,1001541,2022-03-05
CASH_IN,186692,Agence_mtn_Ouidah,300000,113308,Corinne-Louise Valentin,4628,191320,2022-03-06
CASH_IN,147678,Agence_mtn_Abomey,300000,152322,Corinne-Louise Valentin,191320,338998,2022-03-07
CASH_OUT,62691,Corinne-Louise Valentin,338998,276307,Agence_mtn_Abomey,300000,237309,2022-03-11
CASH_IN,79136,Agence_mtn_Cotonou,300000,220864,Corinne-Louise Valentin,276307,355443,2022-03-11
CASH_OUT,64784,Corinne-Louise Valentin,355443,290659,Agence_mtn_Ouidah,300000,235216,2022-03-11
CASH_IN,287468,Agence_mtn_Abomey,300000,12532,Corinne-Louise Valentin,290659,578127,2022-03-13
CASH_OUT,439138,Corinne-Louise Valentin,578127,138989,Agence_mtn_Cotonou,300000,-139138,2022-03-13
CASH_IN,144311,Agence_mtn_Cotonou,300000,155689,Corinne-Louise Valentin,138989,283300,2022-03-14
CASH_OUT,30410,Corinne-Louise Valentin,283300,252890,Agence_mtn_Cotonou,300000,269590,2022-03-14
TRANSFER,248013,Catherine Faivre,1199972,951959,Corinne-Louise Valentin,252890,500903,2022-03-15
CASH_IN,248526,Agence_mtn_Abomey,300000,51474,Corinne-Louise Valentin,500903,749429,2022-03-19
TRANSFER,693181,Corinne-Louise Valentin,749429,56248,Inès de Letellier,1664200,971019,2022-03-19
CASH_IN,210595,Agence_mtn_Abomey,300000,89405,Corinne-Louise Valentin,56248,266843,2022-03-19
TRANSFER,23264,Margot Renaud,28926,5662,Corinne-Louise Valentin,266843,290107,2022-03-21
TRANSFER,36104,Corinne-Louise Valentin,290107,254003,François Michel-Legros,248034,211930,2022-03-22
CASH_OUT,198688,Corinne-Louise Valentin,254003,55315,Agence_mtn_Cotonou,300000,101312,2022-03-22
CASH_IN,125316,Agence_mtn_Ouidah,300000,174684,Corinne-Louise Valentin,55315,180631,2022-03-23
CASH_IN,65171,Agence_mtn_Ouidah,300000,234829,Corinne-Louise Valentin,180631,245802,2022-03-26
CASH_OUT,136302,Corinne-Louise Valentin,245802,109500,Agence_mtn_Abomey,300000,163698,2022-03-26
CASH_IN,114194,Agence_mtn_Ouidah,300000,185806,Inès de Letellier,971019,1085213,2022-03-02
TRANSFER,12495,Laure Philippe,45846,33351,Inès de Letellier,1085213,1097708,2022-03-03
CASH_IN,299901,Agence_mtn_Abomey,300000,99,Inès de Letellier,1097708,1397609,2022-03-03
CASH_IN,132050,Agence_mtn_Cotonou,300000,167950,Inès de Letellier,1397609,1529659,2022-03-05
TRANSFER,413751,Inès de Letellier,1529659,1115908,Sébastien Lemaître,1910401,1496650,2022-03-05
CASH_IN,225456,Agence_mtn_Abomey,300000,74544,Inès de Letellier,1115908,1341364,2022-03-07
CASH_IN,219939,Agence_mtn_Cotonou,300000,80061,Inès de Letellier,1341364,1561303,2022-03-07
CASH_OUT,1163448,Inès de Letellier,1561303,397855,Agence_mtn_Cotonou,300000,-863448,2022-03-07
TRANSFER,218669,Inès de Letellier,397855,179186,Gabriel Humbert,313131,94462,2022-03-08
CASH_IN,281943,Agence_mtn_Ouidah,300000,18057,Inès de Letellier,179186,461129,2022-03-09
CASH_OUT,161238,Inès de Letellier,461129,299891,Agence_mtn_Cotonou,300000,138762,2022-03-10
TRANSFER,239022,Inès de Letellier,299891,60869,Richard Le Descamps,317054,78032,2022-03-10
CASH_OUT,16553,Inès de Letellier,60869,44316,Agence_mtn_Ouidah,300000,283447,2022-03-12
CASH_OUT,36628,Inès de Letellier,44316,7688,Agence_mtn_Cotonou,300000,263372,2022-03-12
CASH_OUT,2646,Inès de Letellier,7688,5042,Agence_mtn_Abomey,300000,297354,2022-03-12
CASH_IN,30837,Agence_mtn_Ouidah,300000,269163,Inès de Letellier,5042,35879,2022-03-13
TRANSFER,339937,Gabriel-Tristan Marty,1312005,972068,Inès de Letellier,35879,375816,2022-03-16
TRANSFER,101416,François Michel-Legros,211930,110514,Inès de Letellier,375816,477232,2022-03-16
TRANSFER,521761,David du Blondel,861273,339512,Inès de Letellier,477232,998993,2022-03-20
TRANSFER,8175,Jeanne Garnier,18395,10220,Inès de Letellier,998993,1007168,2022-03-23
CASH_OUT,441927,Inès de Letellier,1007168,565241,Agence_mtn_Abomey,300000,-141927,2022-03-23
CASH_IN,280605,Agence_mtn_Cotonou,300000,19395,Inès de Letellier,565241,845846,2022-03-25
CASH_OUT,95335,Inès de Letellier,845846,750511,Agence_mtn_Cotonou,300000,204665,2022-03-26
CASH_IN,201865,Agence_mtn_Ouidah,300000,98135,Inès de Letellier,750511,952376,2022-03-26
TRANSFER,73181,Céline Gomez,794377,721196,Inès de Letellier,952376,1025557,2022-03-26
TRANSFER,4199,Geneviève Grondin,80791,76592,Tristan Thomas,1255800,1251601,2022-03-02
CASH_IN,297133,Agence_mtn_Cotonou,300000,2867,Geneviève Grondin,76592,373725,2022-03-03
CASH_OUT,324804,Geneviève Grondin,373725,48921,Agence_mtn_Ouidah,300000,-24804,2022-03-04
CASH_OUT,14141,Geneviève Grondin,48921,34780,Agence_mtn_Ouidah,300000,285859,2022-03-04
TRANSFER,3276,François Michel-Legros,110514,107238,Geneviève Grondin,34780,38056,2022-03-04
CASH_IN,157019,Agence_mtn_Cotonou,300000,142981,Geneviève Grondin,38056,195075,2022-03-06
CASH_IN,50025,Agence_mtn_Cotonou,300000,249975,Geneviève Grondin,195075,245100,2022-03-07
CASH_OUT,108942,Geneviève Grondin,245100,136158,Agence_mtn_Cotonou,300000,191058,2022-03-07
CASH_OUT,110545,Geneviève Grondin,136158,25613,Agence_mtn_Ouidah,300000,189455,2022-03-09
CASH_OUT,23336,Geneviève Grondin,25613,2277,Agence_mtn_Cotonou,300000,276664,2022-03-09
CASH_IN,161978,Agence_mtn_Cotonou,300000,138022,Geneviève Grondin,2277,164255,2022-03-09
CASH_OUT,134322,Geneviève Grondin,164255,29933,Agence_mtn_Cotonou,300000,165678,2022-03-09
TRANSFER,9665,Geneviève Grondin,29933,20268,Margot Renaud,5662,-4003,2022-03-10
TRANSFER,768443,Sébastien Lemaître,1496650,728207,Geneviève Grondin,20268,788711,2022-03-11
TRANSFER,59312,Sophie Lévêque,208797,149485,Geneviève Grondin,788711,848023,2022-03-11
CASH_OUT,56476,Geneviève Grondin,848023,791547,Agence_mtn_Cotonou,300000,243524,2022-03-15
CASH_IN,164750,Agence_mtn_Ouidah,300000,135250,Geneviève Grondin,791547,956297,2022-03-17
CASH_IN,114974,Agence_mtn_Abomey,300000,185026,Geneviève Grondin,956297,1071271,2022-03-18
CASH_IN,281475,Agence_mtn_Ouidah,300000,18525,Geneviève Grondin,1071271,1352746,2022-03-19
CASH_IN,226080,Agence_mtn_Cotonou,300000,73920,Geneviève Grondin,1352746,1578826,2022-03-20
TRANSFER,7549,Pénélope Ollivier,174375,166826,Geneviève Grondin,1578826,1586375,2022-03-20
CASH_IN,116290,Agence_mtn_Ouidah,300000,183710,Geneviève Grondin,1586375,1702665,2022-03-21
CASH_IN,287486,Agence_mtn_Cotonou,300000,12514,Geneviève Grondin,1702665,1990151,2022-03-24
CASH_OUT,163409,Geneviève Grondin,1990151,1826742,Agence_mtn_Ouidah,300000,136591,2022-03-25
CASH_IN,296261,Agence_mtn_Ouidah,300000,3739,Geneviève Grondin,1826742,2123003,2022-03-26
CASH_OUT,263238,Geneviève Grondin,2123003,1859765,Agence_mtn_Ouidah,300000,36762,2022-03-27
CASH_OUT,321005,Simone Pineau,482983,161978,Agence_mtn_Ouidah,300000,-21005,2022-03-01
CASH_IN,287404,Agence_mtn_Abomey,300000,12596,Simone Pineau,161978,449382,2022-03-01
CASH_OUT,27915,Simone Pineau,449382,421467,Agence_mtn_Abomey,300000,272085,2022-03-02
CASH_OUT,410165,Simone Pineau,421467,11302,Agence_mtn_Cotonou,300000,-110165,2022-03-02
CASH_IN,135791,Agence_mtn_Abomey,300000,164209,Simone Pineau,11302,147093,2022-03-02
CASH_IN,20174,Agence_mtn_Ouidah,300000,279826,Simone Pineau,147093,167267,2022-03-05
TRANSFER,386071,Gabriel-Tristan Marty,972068,585997,Simone Pineau,167267,553338,2022-03-06
TRANSFER,24244,Simone Pineau,553338,529094,Emmanuelle Georges,1027936,1003692,2022-03-06
TRANSFER,39510,Valentine Martinez,485866,446356,Simone Pineau,529094,568604,2022-03-10
CASH_IN,120385,Agence_mtn_Ouidah,300000,179615,Simone Pineau,568604,688989,2022-03-10
CASH_OUT,372023,Simone Pineau,688989,316966,Agence_mtn_Abomey,300000,-72023,2022-03-10
CASH_IN,209422,Agence_mtn_Ouidah,300000,90578,Simone Pineau,316966,526388,2022-03-12
CASH_IN,181805,Agence_mtn_Ouidah,300000,118195,Simone Pineau,526388,708193,2022-03-14
CASH_OUT,327786,Simone Pineau,708193,380407,Agence_mtn_Cotonou,300000,-27786,2022-03-14
CASH_OUT,220436,Simone Pineau,380407,159971,Agence_mtn_Abomey,300000,79564,2022-03-14
CASH_IN,102986,Agence_mtn_Ouidah,300000,197014,Simone Pineau,159971,262957,2022-03-17
TRANSFER,53226,Simone Pineau,262957,209731,Astrid Gay de la Brunet,1292500,1239274,2022-03-20
CASH_IN,130053,Agence_mtn_Abomey,300000,169947,Simone Pineau,209731,339784,2022-03-21
TRANSFER,190580,Simone Pineau,339784,149204,Édouard Nguyen,34910,-155670,2022-03-22
CASH_IN,148047,Agence_mtn_Cotonou,300000,151953,Simone Pineau,149204,297251,2022-03-23
CASH_IN,167896,Agence_mtn_Cotonou,300000,132104,Simone Pineau,297251,465147,2022-03-23
CASH_OUT,44919,Simone Pineau,465147,420228,Agence_mtn_Cotonou,300000,255081,2022-03-24
CASH_OUT,197627,Simone Pineau,420228,222601,Agence_mtn_Cotonou,300000,102373,2022-03-24
CASH_IN,289262,Agence_mtn_Cotonou,300000,10738,Simone Pineau,222601,511863,2022-03-24
TRANSFER,60477,Hortense Lemaire,1516610,1456133,Simone Pineau,511863,572340,2022-03-25
CASH_IN,237591,Agence_mtn_Cotonou,300000,62409,Simone Pineau,572340,809931,2022-03-25
CASH_OUT,697798,Simone Pineau,809931,112133,Agence_mtn_Ouidah,300000,-397798,2022-03-25
CASH_OUT,712324,Sébastien Lemaître,728207,15883,Agence_mtn_Abomey,300000,-412324,2022-03-01
TRANSFER,63159,Pénélope Ollivier,166826,103667,Sébastien Lemaître,15883,79042,2022-03-02
CASH_OUT,76129,Sébastien Lemaître,79042,2913,Agence_mtn_Abomey,300000,223871,2022-03-03
TRANSFER,1296,Sébastien Lemaître,2913,1617,Gabriel Humbert,94462,93166,2022-03-03
CASH_IN,237969,Agence_mtn_Ouidah,300000,62031,Sébastien Lemaître,1617,239586,2022-03-04
CASH_IN,262981,Agence_mtn_Ouidah,300000,37019,Sébastien Lemaître,239586,502567,2022-03-04
CASH_IN,38377,Agence_mtn_Cotonou,300000,261623,Sébastien Lemaître,502567,540944,2022-03-07
TRANSFER,114708,Valentine Richard-Bourdon,1445486,1330778,Sébastien Lemaître,540944,655652,2022-03-10
TRANSFER,565987,Sébastien Lemaître,655652,89665,Alphonse Le Olivier,620884,54897,2022-03-11
CASH_IN,220471,Agence_mtn_Cotonou,300000,79529,Sébastien Lemaître,89665,310136,2022-03-11
CASH_IN,24057,Agence_mtn_Ouidah,300000,275943,Sébastien Lemaître,310136,334193,2022-03-11
CASH_IN,142999,Agence_mtn_Abomey,300000,157001,Sébastien Lemaître,334193,477192,2022-03-11
CASH_IN,68836,Agence_mtn_Ouidah,300000,231164,Sébastien Lemaître,477192,546028,2022-03-12
TRANSFER,76922,Claude Foucher,294216,217294,Sébastien Lemaître,546028,622950,2022-03-14
CASH_IN,253372,Agence_mtn_Abomey,300000,46628,Sébastien Lemaître,622950,876322,2022-03-14
CASH_IN,153617,Agence_mtn_Ouidah,300000,146383,Sébastien Lemaître,876322,1029939,2022-03-14
CASH_IN,196972,Agence_mtn_Cotonou,300000,103028,Sébastien Lemaître,1029939,1226911,2022-03-14
CASH_IN,207746,Agence_mtn_Abomey,300000,92254,Sébastien Lemaître,1226911,1434657,2022-03-15
CASH_OUT,142120,Sébastien Lemaître,1434657,1292537,Agence_mtn_Cotonou,300000,157880,2022-03-16
CASH_IN,239857,Agence_mtn_Ouidah,300000,60143,Sébastien Lemaître,1292537,1532394,2022-03-17
CASH_OUT,515070,Sébastien Lemaître,1532394,1017324,Agence_mtn_Ouidah,300000,-215070,2022-03-17
TRANSFER,14067,Sébastien Lemaître,1017324,1003257,Alexandrie Delmas,173521,159454,2022-03-18
CASH_IN,195443,Agence_mtn_Abomey,300000,104557,Sébastien Lemaître,1003257,1198700,2022-03-19
CASH_OUT,144840,Sébastien Lemaître,1198700,1053860,Agence_mtn_Cotonou,300000,155160,2022-03-22
TRANSFER,354629,Sébastien Lemaître,1053860,699231,Jeanne Garnier,10220,-344409,2022-03-23
CASH_OUT,504353,Sébastien Lemaître,699231,194878,Agence_mtn_Cotonou,300000,-204353,2022-03-24
CASH_OUT,6611,Sébastien Lemaître,194878,188267,Agence_mtn_Ouidah,300000,293389,2022-03-27
CASH_IN,229816,Agence_mtn_Cotonou,300000,70184,Émilie Moulin,-550859,-321043,2022-03-02
CASH_IN,255584,Agence_mtn_Ouidah,300000,44416,Émilie Moulin,-321043,-65459,2022-03-02
CASH_IN,119807,Agence_mtn_Abomey,300000,180193,Émilie Moulin,-65459,54348,2022-03-03
TRANSFER,10576,Céline Gomez,721196,710620,Émilie Moulin,54348,64924,2022-03-03
CASH_OUT,54067,Émilie Moulin,64924,10857,Agence_mtn_Ouidah,300000,245933,2022-03-04
CASH_IN,127883,Agence_mtn_Abomey,300000,172117,Émilie Moulin,10857,138740,2022-03-05
CASH_IN,95103,Agence_mtn_Ouidah,300000,204897,Émilie Moulin,138740,233843,2022-03-06
CASH_OUT,93796,Émilie Moulin,233843,140047,Agence_mtn_Abomey,300000,206204,2022-03-10
CASH_IN,14244,Agence_mtn_Ouidah,300000,285756,Émilie Moulin,140047,154291,2022-03-10
CASH_IN,19843,Agence_mtn_Ouidah,300000,280157,Émilie Moulin,154291,174134,2022-03-11
CASH_OUT,137475,Émilie Moulin,174134,36659,Agence_mtn_Ouidah,300000,162525,2022-03-13
CASH_IN,130989,Agence_mtn_Ouidah,300000,169011,Émilie Moulin,36659,167648,2022-03-14
CASH_OUT,110728,Émilie Moulin,167648,56920,Agence_mtn_Ouidah,300000,189272,2022-03-16
CASH_IN,18198,Agence_mtn_Ouidah,300000,281802,Émilie Moulin,56920,75118,2022-03-16
CASH_OUT,62836,Émilie Moulin,75118,12282,Agence_mtn_Abomey,300000,237164,2022-03-17
CASH_OUT,1114,Émilie Moulin,12282,11168,Agence_mtn_Ouidah,300000,298886,2022-03-18
TRANSFER,501837,Léon Martins-Briand,835600,333763,Émilie Moulin,11168,513005,2022-03-18
TRANSFER,72939,Émilie Moulin,513005,440066,Valentine Martinez,446356,373417,2022-03-19
CASH_OUT,41736,Émilie Moulin,440066,398330,Agence_mtn_Ouidah,300000,258264,2022-03-21
TRANSFER,386997,Émilie Moulin,398330,11333,Xavier Leblanc-Ferreira,1458478,1071481,2022-03-21
CASH_OUT,5542,Émilie Moulin,11333,5791,Agence_mtn_Abomey,300000,294458,2022-03-22
TRANSFER,282,Émilie Moulin,5791,5509,Valentine Martinez,373417,373135,2022-03-23
TRANSFER,793,Émilie Moulin,5509,4716,Marine Chauvet-Potier,681800,681007,2022-03-24
TRANSFER,193030,Benjamin Evrard-Marty,229653,36623,Émilie Moulin,4716,197746,2022-03-26
CASH_OUT,33389,Émilie Moulin,197746,164357,Agence_mtn_Cotonou,300000,266611,2022-03-27
CASH_IN,192876,Agence_mtn_Ouidah,300000,107124,Raymond Rossi,-185016,7860,2022-03-01
CASH_OUT,2321,Raymond Rossi,7860,5539,Agence_mtn_Ouidah,300000,297679,2022-03-02
CASH_OUT,3514,Raymond Rossi,5539,2025,Agence_mtn_Abomey,300000,296486,2022-03-02
TRANSFER,14447,Victoire-Nicole Lopez,193715,179268,Raymond Rossi,2025,16472,2022-03-04
CASH_IN,230627,Agence_mtn_Ouidah,300000,69373,Raymond Rossi,16472,247099,2022-03-04
CASH_IN,39554,Agence_mtn_Abomey,300000,260446,Raymond Rossi,247099,286653,2022-03-06
TRANSFER,59609,Raymond Rossi,286653,227044,Alexandrie Delmas,159454,99845,2022-03-08
CASH_OUT,123747,Raymond Rossi,227044,103297,Agence_mtn_Abomey,300000,176253,2022-03-09
CASH_IN,49569,Agence_mtn_Cotonou,300000,250431,Raymond Rossi,103297,152866,2022-03-10
TRANSFER,148987,Raymond Rossi,152866,3879,Pénélope Ollivier,103667,-45320,2022-03-10
CASH_OUT,3824,Raymond Rossi,3879,55,Agence_mtn_Ouidah,300000,296176,2022-03-10
CASH_IN,20343,Agence_mtn_Cotonou,300000,279657,Raymond Rossi,55,20398,2022-03-11
CASH_OUT,4911,Raymond Rossi,20398,15487,Agence_mtn_Cotonou,300000,295089,2022-03-11
TRANSFER,719,Inès Hamon,131449,130730,Raymond Rossi,15487,16206,2022-03-13
CASH_OUT,3693,Raymond Rossi,16206,12513,Agence_mtn_Abomey,300000,296307,2022-03-14
TRANSFER,36621,Alexandrie Delmas,99845,63224,Raymond Rossi,12513,49134,2022-03-14
TRANSFER,828670,Gilbert Foucher,837969,9299,Raymond Rossi,49134,877804,2022-03-18
TRANSFER,287078,Raymond Rossi,877804,590726,Marine Chauvet-Potier,681007,393929,2022-03-18
CASH_OUT,341822,Raymond Rossi,590726,248904,Agence_mtn_Cotonou,300000,-41822,2022-03-20
TRANSFER,601894,Céline Gomez,710620,108726,Raymond Rossi,248904,850798,2022-03-21
CASH_IN,108716,Agence_mtn_Abomey,300000,191284,Raymond Rossi,850798,959514,2022-03-22
CASH_OUT,438468,Raymond Rossi,959514,521046,Agence_mtn_Ouidah,300000,-138468,2022-03-22
TRANSFER,159412,Raymond Rossi,521046,361634,Victoire-Nicole Lopez,179268,19856,2022-03-23
TRANSFER,256161,Valentine Martinez,373135,116974,Raymond Rossi,361634,617795,2022-03-24
CASH_OUT,173786,Raymond Rossi,617795,444009,Agence_mtn_Ouidah,300000,126214,2022-03-24
TRANSFER,23649,Raymond Rossi,444009,420360,Valentine Martinez,116974,93325,2022-03-25
TRANSFER,80332,Raymond Rossi,420360,340028,Gabriel-Tristan Marty,585997,505665,2022-03-25
CASH_OUT,335010,Raymond Rossi,340028,5018,Agence_mtn_Abomey,300000,-35010,2022-03-25
CASH_IN,273097,Agence_mtn_Ouidah,300000,26903,Raymond Rossi,5018,278115,2022-03-26
CASH_OUT,63107,Raymond Rossi,278115,215008,Agence_mtn_Cotonou,300000,236893,2022-03-27
CASH_IN,44253,Agence_mtn_Abomey,300000,255747,David du Blondel,339512,383765,2022-03-04
CASH_OUT,352973,David du Blondel,383765,30792,Agence_mtn_Abomey,300000,-52973,2022-03-06
CASH_IN,167951,Agence_mtn_Abomey,300000,132049,David du Blondel,30792,198743,2022-03-06
CASH_IN,88651,Agence_mtn_Abomey,300000,211349,David du Blondel,198743,287394,2022-03-07
CASH_IN,299380,Agence_mtn_Ouidah,300000,620,David du Blondel,287394,586774,2022-03-15
CASH_OUT,388825,David du Blondel,586774,197949,Agence_mtn_Ouidah,300000,-88825,2022-03-18
CASH_OUT,111664,David du Blondel,197949,86285,Agence_mtn_Cotonou,300000,188336,2022-03-20
TRANSFER,68510,David du Blondel,86285,17775,Marie Picard,125998,57488,2022-03-21
CASH_OUT,3814,David du Blondel,17775,13961,Agence_mtn_Ouidah,300000,296186,2022-03-23
CASH_OUT,549,David du Blondel,13961,13412,Agence_mtn_Ouidah,300000,299451,2022-03-24
TRANSFER,14197,Richard Le Descamps,78032,63835,David du Blondel,13412,27609,2022-03-25
CASH_OUT,11728,David du Blondel,27609,15881,Agence_mtn_Ouidah,300000,288272,2022-03-26
CASH_OUT,2048,David du Blondel,15881,13833,Agence_mtn_Cotonou,300000,297952,2022-03-27
CASH_IN,119997,Agence_mtn_Abomey,300000,180003,Thibault Moreno,-31503,88494,2022-03-01
CASH_OUT,4222,Thibault Moreno,88494,84272,Agence_mtn_Abomey,300000,295778,2022-03-03
TRANSFER,64033,Thibault Moreno,84272,20239,Laure Philippe,33351,-30682,2022-03-04
CASH_OUT,974,Thibault Moreno,20239,19265,Agence_mtn_Abomey,300000,299026,2022-03-05
CASH_OUT,8676,Thibault Moreno,19265,10589,Agence_mtn_Ouidah,300000,291324,2022-03-12
CASH_IN,213746,Agence_mtn_Cotonou,300000,86254,Thibault Moreno,10589,224335,2022-03-19
CASH_IN,96879,Agence_mtn_Ouidah,300000,203121,Thibault Moreno,224335,321214,2022-03-21
CASH_OUT,165791,Thibault Moreno,321214,155423,Agence_mtn_Cotonou,300000,134209,2022-03-26
CASH_OUT,295257,Frédéric Couturier,710951,415694,Agence_mtn_Ouidah,300000,4743,2022-03-01
TRANSFER,200747,Frédéric Couturier,415694,214947,Valérie Dijoux,1224113,1023366,2022-03-02
TRANSFER,112957,Frédéric Couturier,214947,101990,Astrid Gay de la Brunet,1239274,1126317,2022-03-03
CASH_IN,204713,Agence_mtn_Cotonou,300000,95287,Frédéric Couturier,101990,306703,2022-03-07
CASH_IN,172946,Agence_mtn_Abomey,300000,127054,Frédéric Couturier,306703,479649,2022-03-08
CASH_IN,147688,Agence_mtn_Abomey,300000,152312,Frédéric Couturier,479649,627337,2022-03-12
CASH_IN,162230,Agence_mtn_Cotonou,300000,137770,Frédéric Couturier,627337,789567,2022-03-13
TRANSFER,266669,Tristan Thomas,1251601,984932,Frédéric Couturier,789567,1056236,2022-03-16
CASH_IN,268001,Agence_mtn_Cotonou,300000,31999,Frédéric Couturier,1056236,1324237,2022-03-16
TRANSFER,452482,Frédéric Couturier,1324237,871755,Zoé Renaud de Boutin,42643,-409839,2022-03-18
CASH_OUT,252949,Frédéric Couturier,871755,618806,Agence_mtn_Ouidah,300000,47051,2022-03-18
CASH_OUT,84084,Frédéric Couturier,618806,534722,Agence_mtn_Ouidah,300000,215916,2022-03-21
CASH_IN,38381,Agence_mtn_Abomey,300000,261619,Frédéric Couturier,534722,573103,2022-03-24
CASH_IN,219148,Agence_mtn_Ouidah,300000,80852,Victoire-Nicole Lopez,19856,239004,2022-03-01
TRANSFER,2910,Gilbert Foucher,9299,6389,Victoire-Nicole Lopez,239004,241914,2022-03-02
TRANSFER,219761,Victoire-Nicole Lopez,241914,22153,Valérie Dijoux,1023366,803605,2022-03-02
CASH_IN,149281,Agence_mtn_Abomey,300000,150719,Victoire-Nicole Lopez,22153,171434,2022-03-02
CASH_OUT,74976,Victoire-Nicole Lopez,171434,96458,Agence_mtn_Abomey,300000,225024,2022-03-10
TRANSFER,31623,Victoire-Nicole Lopez,96458,64835,Valérie Dijoux,803605,771982,2022-03-15
CASH_IN,240352,Agence_mtn_Ouidah,300000,59648,Victoire-Nicole Lopez,64835,305187,2022-03-15
CASH_OUT,110843,Victoire-Nicole Lopez,305187,194344,Agence_mtn_Cotonou,300000,189157,2022-03-17
CASH_IN,185443,Agence_mtn_Cotonou,300000,114557,Victoire-Nicole Lopez,194344,379787,2022-03-17
CASH_IN,265708,Agence_mtn_Cotonou,300000,34292,Victoire-Nicole Lopez,379787,645495,2022-03-21
CASH_IN,120066,Agence_mtn_Ouidah,300000,179934,Victoire-Nicole Lopez,645495,765561,2022-03-22
CASH_OUT,760080,Victoire-Nicole Lopez,765561,5481,Agence_mtn_Abomey,300000,-460080,2022-03-22
CASH_OUT,4595,Victoire-Nicole Lopez,5481,886,Agence_mtn_Abomey,300000,295405,2022-03-22
TRANSFER,1760,Bertrand Le Roux,64630,62870,Gilbert Foucher,6389,8149,2022-03-01
CASH_OUT,6748,Gilbert Foucher,8149,1401,Agence_mtn_Abomey,300000,293252,2022-03-02
TRANSFER,478,Gilbert Foucher,1401,923,Antoinette Bertrand,341263,340785,2022-03-03
TRANSFER,738,Gilbert Foucher,923,185,Gabriel-Tristan Marty,505665,504927,2022-03-06
TRANSFER,169,Gilbert Foucher,185,16,Gabriel-Tristan Marty,504927,504758,2022-03-08
CASH_IN,68115,Agence_mtn_Cotonou,300000,231885,Gilbert Foucher,16,68131,2022-03-09
TRANSFER,189904,Claude Foucher,217294,27390,Gilbert Foucher,68131,258035,2022-03-16
CASH_IN,134748,Agence_mtn_Cotonou,300000,165252,Gilbert Foucher,258035,392783,2022-03-16
TRANSFER,370242,Gilbert Foucher,392783,22541,Gabriel-Tristan Marty,504758,134516,2022-03-17
TRANSFER,20567,Gilbert Foucher,22541,1974,Emmanuelle Georges,1003692,983125,2022-03-18
CASH_IN,85951,Agence_mtn_Ouidah,300000,214049,Gilbert Foucher,1974,87925,2022-03-18
TRANSFER,29193,Gilbert Foucher,87925,58732,Alphonse Le Olivier,54897,25704,2022-03-19
TRANSFER,40496,Gilbert Foucher,58732,18236,Claude Foucher,27390,-13106,2022-03-19
CASH_OUT,750,Gilbert Foucher,18236,17486,Agence_mtn_Ouidah,300000,299250,2022-03-19
CASH_IN,229074,Agence_mtn_Cotonou,300000,70926,Gilbert Foucher,17486,246560,2022-03-19
CASH_OUT,49283,Gilbert Foucher,246560,197277,Agence_mtn_Cotonou,300000,250717,2022-03-20
TRANSFER,25314,Gabriel Humbert,93166,67852,Gilbert Foucher,197277,222591,2022-03-21
CASH_OUT,53169,Gilbert Foucher,222591,169422,Agence_mtn_Ouidah,300000,246831,2022-03-21
CASH_OUT,614,Gilbert Foucher,169422,168808,Agence_mtn_Ouidah,300000,299386,2022-03-22
CASH_OUT,81892,Gilbert Foucher,168808,86916,Agence_mtn_Ouidah,300000,218108,2022-03-27
CASH_OUT,377632,Emmanuelle Georges,983125,605493,Agence_mtn_Ouidah,300000,-77632,2022-03-02
CASH_OUT,529596,Emmanuelle Georges,605493,75897,Agence_mtn_Cotonou,300000,-229596,2022-03-07
TRANSFER,34049,Emmanuelle Georges,75897,41848,Gabriel Humbert,67852,33803,2022-03-13
CASH_OUT,8520,Emmanuelle Georges,41848,33328,Agence_mtn_Ouidah,300000,291480,2022-03-13
CASH_IN,215562,Agence_mtn_Abomey,300000,84438,Emmanuelle Georges,33328,248890,2022-03-14
TRANSFER,838893,Tristan Thomas,984932,146039,Emmanuelle Georges,248890,1087783,2022-03-17
TRANSFER,73532,David Guérin,100151,26619,Emmanuelle Georges,1087783,1161315,2022-03-23
CASH_IN,223158,Agence_mtn_Ouidah,300000,76842,Emmanuelle Georges,1161315,1384473,2022-03-24
CASH_OUT,37686,Bertrand Le Roux,62870,25184,Agence_mtn_Abomey,300000,262314,2022-03-03
CASH_IN,69076,Agence_mtn_Cotonou,300000,230924,Bertrand Le Roux,25184,94260,2022-03-10
TRANSFER,66852,François Michel-Legros,107238,40386,Bertrand Le Roux,94260,161112,2022-03-10
CASH_IN,167621,Agence_mtn_Abomey,300000,132379,Bertrand Le Roux,161112,328733,2022-03-11
CASH_OUT,200986,Bertrand Le Roux,328733,127747,Agence_mtn_Ouidah,300000,99014,2022-03-14
CASH_OUT,100441,Bertrand Le Roux,127747,27306,Agence_mtn_Abomey,300000,199559,2022-03-14
CASH_IN,108803,Agence_mtn_Ouidah,300000,191197,Bertrand Le Roux,27306,136109,2022-03-16
TRANSFER,31971,François Michel-Legros,40386,8415,Bertrand Le Roux,136109,168080,2022-03-19
CASH_OUT,27275,Bertrand Le Roux,168080,140805,Agence_mtn_Cotonou,300000,272725,2022-03-20
TRANSFER,158154,Léon Lecoq,1001541,843387,Bertrand Le Roux,140805,298959,2022-03-24
TRANSFER,77444,Bertrand Le Roux,298959,221515,Valentine Richard-Bourdon,1330778,1253334,2022-03-27
CASH_IN,60805,Agence_mtn_Cotonou,300000,239195,Margot Renaud,-4003,56802,2022-03-01
CASH_IN,144711,Agence_mtn_Ouidah,300000,155289,Margot Renaud,56802,201513,2022-03-03
CASH_IN,103527,Agence_mtn_Abomey,300000,196473,Margot Renaud,201513,305040,2022-03-06
TRANSFER,54769,Margot Renaud,305040,250271,Richard Le Descamps,63835,9066,2022-03-07
TRANSFER,162449,Margot Renaud,250271,87822,Catherine Faivre,951959,789510,2022-03-08
CASH_IN,73407,Agence_mtn_Abomey,300000,226593,Margot Renaud,87822,161229,2022-03-14
CASH_IN,148327,Agence_mtn_Cotonou,300000,151673,Margot Renaud,161229,309556,2022-03-14
CASH_OUT,39584,Margot Renaud,309556,269972,Agence_mtn_Cotonou,300000,260416,2022-03-17
TRANSFER,62643,Tristan Thomas,146039,83396,Margot Renaud,269972,332615,2022-03-18
CASH_IN,266817,Agence_mtn_Abomey,300000,33183,Margot Renaud,332615,599432,2022-03-20
CASH_OUT,390684,Margot Renaud,599432,208748,Agence_mtn_Cotonou,300000,-90684,2022-03-21
CASH_OUT,2202,Margot Renaud,208748,206546,Agence_mtn_Cotonou,300000,297798,2022-03-22
TRANSFER,791420,Hortense Lemaire,1456133,664713,Margot Renaud,206546,997966,2022-03-22
CASH_IN,125951,Agence_mtn_Ouidah,300000,174049,Nath Bruneau,-5928,120023,2022-03-04
CASH_IN,187523,Agence_mtn_Ouidah,300000,112477,Nath Bruneau,120023,307546,2022-03-05
TRANSFER,181009,Nath Bruneau,307546,126537,Alexandrie Delmas,63224,-117785,2022-03-07
CASH_IN,95390,Agence_mtn_Ouidah,300000,204610,Nath Bruneau,126537,221927,2022-03-08
CASH_IN,149198,Agence_mtn_Ouidah,300000,150802,Nath Bruneau,221927,371125,2022-03-08
CASH_IN,11699,Agence_mtn_Cotonou,300000,288301,Nath Bruneau,371125,382824,2022-03-18
TRANSFER,57374,Rémy Le Michaud,62970,5596,Nath Bruneau,382824,440198,2022-03-21
CASH_OUT,126215,Nath Bruneau,440198,313983,Agence_mtn_Ouidah,300000,173785,2022-03-23
CASH_IN,213501,Agence_mtn_Ouidah,300000,86499,Nath Bruneau,313983,527484,2022-03-25
CASH_IN,28801,Agence_mtn_Abomey,300000,271199,Vincent Fournier,-1358550,-1329749,2022-03-01
CASH_IN,156247,Agence_mtn_Abomey,300000,143753,Vincent Fournier,-1329749,-1173502,2022-03-01
CASH_IN,22670,Agence_mtn_Cotonou,300000,277330,Vincent Fournier,-1173502,-1150832,2022-03-01
CASH_IN,134210,Agence_mtn_Abomey,300000,165790,Vincent Fournier,-1150832,-1016622,2022-03-05
CASH_IN,233799,Agence_mtn_Cotonou,300000,66201,Vincent Fournier,-1016622,-782823,2022-03-06
CASH_IN,161584,Agence_mtn_Cotonou,300000,138416,Vincent Fournier,-782823,-621239,2022-03-09
CASH_IN,47135,Agence_mtn_Ouidah,300000,252865,Vincent Fournier,-621239,-574104,2022-03-09
CASH_IN,43257,Agence_mtn_Cotonou,300000,256743,Vincent Fournier,-574104,-530847,2022-03-12
CASH_IN,227330,Agence_mtn_Cotonou,300000,72670,Vincent Fournier,-530847,-303517,2022-03-14
CASH_IN,11798,Agence_mtn_Ouidah,300000,288202,Vincent Fournier,-303517,-291719,2022-03-14
CASH_IN,95041,Agence_mtn_Ouidah,300000,204959,Vincent Fournier,-291719,-196678,2022-03-15
CASH_IN,114734,Agence_mtn_Ouidah,300000,185266,Vincent Fournier,-196678,-81944,2022-03-21
CASH_IN,57588,Agence_mtn_Abomey,300000,242412,Vincent Fournier,-81944,-24356,2022-03-22
CASH_IN,98011,Agence_mtn_Abomey,300000,201989,Vincent Fournier,-24356,73655,2022-03-22
CASH_IN,125506,Agence_mtn_Cotonou,300000,174494,Vincent Fournier,73655,199161,2022-03-25
CASH_IN,70646,Agence_mtn_Ouidah,300000,229354,Honoré du Laurent,-19982,50664,2022-03-01
CASH_OUT,37457,Honoré du Laurent,50664,13207,Agence_mtn_Ouidah,300000,262543,2022-03-04
CASH_IN,70816,Agence_mtn_Abomey,300000,229184,Honoré du Laurent,13207,84023,2022-03-06
CASH_IN,2271,Agence_mtn_Ouidah,300000,297729,Honoré du Laurent,84023,86294,2022-03-08
CASH_IN,4973,Agence_mtn_Ouidah,300000,295027,Honoré du Laurent,86294,91267,2022-03-08
TRANSFER,16459,Léon Martins-Briand,333763,317304,Honoré du Laurent,91267,107726,2022-03-09
TRANSFER,173446,Antoinette Bertrand,340785,167339,Honoré du Laurent,107726,281172,2022-03-11
TRANSFER,38918,Honoré du Laurent,281172,242254,William Lebrun,2165,-36753,2022-03-11
CASH_IN,61234,Agence_mtn_Ouidah,300000,238766,Honoré du Laurent,242254,303488,2022-03-12
TRANSFER,47025,Honoré du Laurent,303488,256463,Inès Hamon,130730,83705,2022-03-14
CASH_OUT,236963,Honoré du Laurent,256463,19500,Agence_mtn_Ouidah,300000,63037,2022-03-16
CASH_OUT,9621,Honoré du Laurent,19500,9879,Agence_mtn_Ouidah,300000,290379,2022-03-17
TRANSFER,27717,Antoinette Bertrand,167339,139622,Honoré du Laurent,9879,37596,2022-03-23
CASH_OUT,22237,Honoré du Laurent,37596,15359,Agence_mtn_Abomey,300000,277763,2022-03-26
TRANSFER,1110690,Astrid Gay de la Brunet,1126317,15627,Honoré du Laurent,15359,1126049,2022-03-26
CASH_IN,158472,Agence_mtn_Abomey,300000,141528,Édouard Nguyen,-155670,2802,2022-03-01
TRANSFER,15567,David Guérin,26619,11052,Édouard Nguyen,2802,18369,2022-03-06
CASH_OUT,8353,Édouard Nguyen,18369,10016,Agence_mtn_Abomey,300000,291647,2022-03-06
TRANSFER,1747,Édouard Nguyen,10016,8269,Sophie Lévêque,149485,147738,2022-03-10
CASH_IN,213222,Agence_mtn_Ouidah,300000,86778,Édouard Nguyen,8269,221491,2022-03-10
CASH_OUT,31249,Édouard Nguyen,221491,190242,Agence_mtn_Abomey,300000,268751,2022-03-23
CASH_OUT,9329,Édouard Nguyen,190242,180913,Agence_mtn_Cotonou,300000,290671,2022-03-27
CASH_IN,71667,Agence_mtn_Abomey,300000,228333,Édouard Nguyen,180913,252580,2022-03-27
CASH_IN,275099,Agence_mtn_Cotonou,300000,24901,Richard Le Descamps,9066,284165,2022-03-01
CASH_IN,175379,Agence_mtn_Abomey,300000,124621,Richard Le Descamps,284165,459544,2022-03-01
TRANSFER,175809,Richard Le Descamps,459544,283735,Richard Le Descamps,459544,635353,2022-03-02
TRANSFER,168580,Richard Le Descamps,283735,115155,Céline Gomez,108726,-59854,2022-03-05
TRANSFER,495970,Valérie Dijoux,771982,276012,Richard Le Descamps,115155,611125,2022-03-06
TRANSFER,6555,David Guérin,11052,4497,Richard Le Descamps,611125,617680,2022-03-08
CASH_IN,228946,Agence_mtn_Ouidah,300000,71054,Richard Le Descamps,617680,846626,2022-03-08
TRANSFER,377022,Hortense Lemaire,664713,287691,Richard Le Descamps,846626,1223648,2022-03-09
TRANSFER,15581,Richard Le Descamps,1223648,1208067,Inès Hamon,83705,68124,2022-03-10
CASH_IN,149889,Agence_mtn_Abomey,300000,150111,Richard Le Descamps,1208067,1357956,2022-03-11
CASH_IN,9944,Agence_mtn_Cotonou,300000,290056,Richard Le Descamps,1357956,1367900,2022-03-15
CASH_IN,254137,Agence_mtn_Ouidah,300000,45863,Richard Le Descamps,1367900,1622037,2022-03-16
CASH_OUT,1579579,Richard Le Descamps,1622037,42458,Agence_mtn_Abomey,300000,-1279579,2022-03-17
CASH_OUT,22520,Richard Le Descamps,42458,19938,Agence_mtn_Cotonou,300000,277480,2022-03-17
CASH_OUT,18892,Richard Le Descamps,19938,1046,Agence_mtn_Ouidah,300000,281108,2022-03-18
TRANSFER,271,Richard Le Descamps,1046,775,Rémy Le Michaud,5596,5325,2022-03-18
CASH_OUT,160,Richard Le Descamps,775,615,Agence_mtn_Abomey,300000,299840,2022-03-19
CASH_IN,159314,Agence_mtn_Abomey,300000,140686,Richard Le Descamps,615,159929,2022-03-22
CASH_OUT,5743,Richard Le Descamps,159929,154186,Agence_mtn_Abomey,300000,294257,2022-03-23
CASH_OUT,43620,Richard Le Descamps,154186,110566,Agence_mtn_Ouidah,300000,256380,2022-03-25
TRANSFER,298694,Xavier Leblanc-Ferreira,1071481,772787,Tristan Thomas,83396,382090,2022-03-01
CASH_IN,132998,Agence_mtn_Ouidah,300000,167002,Tristan Thomas,382090,515088,2022-03-01
CASH_IN,81392,Agence_mtn_Abomey,300000,218608,Tristan Thomas,515088,596480,2022-03-02
CASH_OUT,300638,Tristan Thomas,596480,295842,Agence_mtn_Ouidah,300000,-638,2022-03-09
CASH_IN,55069,Agence_mtn_Abomey,300000,244931,Tristan Thomas,295842,350911,2022-03-13
TRANSFER,144976,Tristan Thomas,350911,205935,David Guérin,4497,-140479,2022-03-16
CASH_OUT,189606,Tristan Thomas,205935,16329,Agence_mtn_Ouidah,300000,110394,2022-03-21
CASH_OUT,14391,Tristan Thomas,16329,1938,Agence_mtn_Ouidah,300000,285609,2022-03-24
CASH_IN,154289,Agence_mtn_Cotonou,300000,145711,Alfred du Lesage,-112783,41506,2022-03-09
TRANSFER,17640,Alfred du Lesage,41506,23866,Rémy Le Michaud,5325,-12315,2022-03-12
CASH_OUT,712,Alfred du Lesage,23866,23154,Agence_mtn_Abomey,300000,299288,2022-03-12
CASH_OUT,16535,Alfred du Lesage,23154,6619,Agence_mtn_Abomey,300000,283465,2022-03-13
CASH_OUT,5601,Alfred du Lesage,6619,1018,Agence_mtn_Ouidah,300000,294399,2022-03-15
CASH_OUT,596,Alfred du Lesage,1018,422,Agence_mtn_Cotonou,300000,299404,2022-03-21
CASH_IN,282876,Agence_mtn_Ouidah,300000,17124,Gabriel Humbert,33803,316679,2022-03-01
CASH_OUT,221636,Gabriel Humbert,316679,95043,Agence_mtn_Ouidah,300000,78364,2022-03-03
CASH_IN,239446,Agence_mtn_Ouidah,300000,60554,Gabriel Humbert,95043,334489,2022-03-05
CASH_IN,215186,Agence_mtn_Ouidah,300000,84814,Gabriel Humbert,334489,549675,2022-03-07
TRANSFER,515131,Gabriel Humbert,549675,34544,François Michel-Legros,8415,-506716,2022-03-12
TRANSFER,19710,Gabriel Humbert,34544,14834,Sophie Lévêque,147738,128028,2022-03-14
CASH_OUT,5194,Gabriel Humbert,14834,9640,Agence_mtn_Cotonou,300000,294806,2022-03-19
TRANSFER,44414,Gabriel-Tristan Marty,134516,90102,Gabriel Humbert,9640,54054,2022-03-19
TRANSFER,47812,Gabriel Humbert,54054,6242,Valentine Martinez,93325,45513,2022-03-19
CASH_OUT,2596,Gabriel Humbert,6242,3646,Agence_mtn_Abomey,300000,297404,2022-03-20
TRANSFER,135943,Marine Chauvet-Potier,393929,257986,Gabriel Humbert,3646,139589,2022-03-21
CASH_OUT,7725,Gabriel Humbert,139589,131864,Agence_mtn_Cotonou,300000,292275,2022-03-24
CASH_OUT,22925,Gabriel Humbert,131864,108939,Agence_mtn_Ouidah,300000,277075,2022-03-26
TRANSFER,206208,Valérie Dijoux,276012,69804,Gabriel Humbert,108939,315147,2022-03-27
CASH_IN,150417,Agence_mtn_Ouidah,300000,149583,Sophie Lévêque,128028,278445,2022-03-03
CASH_OUT,11224,Sophie Lévêque,278445,267221,Agence_mtn_Cotonou,300000,288776,2022-03-04
CASH_OUT,223832,Sophie Lévêque,267221,43389,Agence_mtn_Abomey,300000,76168,2022-03-05
CASH_IN,125629,Agence_mtn_Ouidah,300000,174371,Sophie Lévêque,43389,169018,2022-03-05
CASH_OUT,100017,Sophie Lévêque,169018,69001,Agence_mtn_Cotonou,300000,199983,2022-03-09
TRANSFER,269443,Valentine Richard-Bourdon,1253334,983891,Sophie Lévêque,69001,338444,2022-03-11
CASH_OUT,204769,Sophie Lévêque,338444,133675,Agence_mtn_Abomey,300000,95231,2022-03-11
CASH_OUT,121737,Sophie Lévêque,133675,11938,Agence_mtn_Abomey,300000,178263,2022-03-12
TRANSFER,1510,Sophie Lévêque,11938,10428,Léon Lecoq,843387,841877,2022-03-15
CASH_IN,121851,Agence_mtn_Abomey,300000,178149,Sophie Lévêque,10428,132279,2022-03-17
CASH_OUT,5110,Sophie Lévêque,132279,127169,Agence_mtn_Cotonou,300000,294890,2022-03-17
TRANSFER,53315,Gabriel-Tristan Marty,90102,36787,Sophie Lévêque,127169,180484,2022-03-17
CASH_IN,206361,Agence_mtn_Abomey,300000,93639,Sophie Lévêque,180484,386845,2022-03-20
CASH_OUT,331203,Sophie Lévêque,386845,55642,Agence_mtn_Abomey,300000,-31203,2022-03-21
TRANSFER,23765,Sophie Lévêque,55642,31877,Valentine Martinez,45513,21748,2022-03-23
TRANSFER,6515,Sophie Lévêque,31877,25362,Valentine Richard-Bourdon,983891,977376,2022-03-25
TRANSFER,76905,Léon Martins-Briand,317304,240399,Xavier Leblanc-Ferreira,772787,695882,2022-03-04
CASH_OUT,147005,Léon Martins-Briand,240399,93394,Agence_mtn_Cotonou,300000,152995,2022-03-09
TRANSFER,217028,Hortense Lemaire,287691,70663,Léon Martins-Briand,93394,310422,2022-03-10
CASH_OUT,47009,Léon Martins-Briand,310422,263413,Agence_mtn_Abomey,300000,252991,2022-03-12
CASH_OUT,6389,Léon Martins-Briand,263413,257024,Agence_mtn_Abomey,300000,293611,2022-03-16
CASH_OUT,89162,Léon Martins-Briand,257024,167862,Agence_mtn_Ouidah,300000,210838,2022-03-16
CASH_IN,283561,Agence_mtn_Abomey,300000,16439,Léon Martins-Briand,167862,451423,2022-03-17
CASH_IN,4488,Agence_mtn_Abomey,300000,295512,Léon Martins-Briand,451423,455911,2022-03-18
CASH_OUT,144456,Léon Martins-Briand,455911,311455,Agence_mtn_Abomey,300000,155544,2022-03-20
TRANSFER,17379,Benjamin Evrard-Marty,36623,19244,Léon Martins-Briand,311455,328834,2022-03-25
CASH_IN,43908,Agence_mtn_Cotonou,300000,256092,Pénélope Ollivier,-45320,-1412,2022-03-02
CASH_IN,12018,Agence_mtn_Cotonou,300000,287982,Pénélope Ollivier,-1412,10606,2022-03-05
CASH_OUT,4645,Pénélope Ollivier,10606,5961,Agence_mtn_Abomey,300000,295355,2022-03-05
CASH_IN,79724,Agence_mtn_Ouidah,300000,220276,Pénélope Ollivier,5961,85685,2022-03-08
TRANSFER,105756,Xavier Leblanc-Ferreira,695882,590126,Pénélope Ollivier,85685,191441,2022-03-09
TRANSFER,7100,Valentine Martinez,21748,14648,Pénélope Ollivier,191441,198541,2022-03-10
CASH_OUT,166735,Pénélope Ollivier,198541,31806,Agence_mtn_Abomey,300000,133265,2022-03-11
CASH_IN,236462,Agence_mtn_Abomey,300000,63538,Pénélope Ollivier,31806,268268,2022-03-17
CASH_IN,289099,Agence_mtn_Ouidah,300000,10901,Pénélope Ollivier,268268,557367,2022-03-18
CASH_IN,7188,Agence_mtn_Ouidah,300000,292812,Pénélope Ollivier,557367,564555,2022-03-19
TRANSFER,315214,Pénélope Ollivier,564555,249341,Inès Hamon,68124,-247090,2022-03-24
CASH_IN,216164,Agence_mtn_Abomey,300000,83836,Pénélope Ollivier,249341,465505,2022-03-25
CASH_IN,146993,Agence_mtn_Cotonou,300000,153007,Pénélope Ollivier,465505,612498,2022-03-25
TRANSFER,8094,Valentine Martinez,14648,6554,Pénélope Ollivier,612498,620592,2022-03-26
CASH_IN,42161,Agence_mtn_Abomey,300000,257839,Pénélope Ollivier,620592,662753,2022-03-26
CASH_IN,181993,Agence_mtn_Ouidah,300000,118007,Pénélope Ollivier,662753,844746,2022-03-27
TRANSFER,45817,Marie Picard,57488,11671,Léon Lecoq,841877,796060,2022-03-02
TRANSFER,7448,Marie Picard,11671,4223,Marie Picard,11671,19119,2022-03-05
CASH_IN,213785,Agence_mtn_Abomey,300000,86215,Marie Picard,4223,218008,2022-03-05
CASH_IN,201240,Agence_mtn_Ouidah,300000,98760,Marie Picard,218008,419248,2022-03-06
CASH_IN,275577,Agence_mtn_Ouidah,300000,24423,Marie Picard,419248,694825,2022-03-11
CASH_OUT,610106,Marie Picard,694825,84719,Agence_mtn_Abomey,300000,-310106,2022-03-11
TRANSFER,8050,Astrid Gay de la Brunet,15627,7577,Marie Picard,84719,92769,2022-03-15
CASH_IN,183300,Agence_mtn_Abomey,300000,116700,Marie Picard,92769,276069,2022-03-16
CASH_IN,83672,Agence_mtn_Cotonou,300000,216328,Marie Picard,276069,359741,2022-03-19
CASH_OUT,311783,Marie Picard,359741,47958,Agence_mtn_Cotonou,300000,-11783,2022-03-21
CASH_IN,190083,Agence_mtn_Ouidah,300000,109917,Marie Picard,47958,238041,2022-03-22
CASH_IN,269977,Agence_mtn_Ouidah,300000,30023,Marie Picard,238041,508018,2022-03-26
CASH_IN,204647,Agence_mtn_Ouidah,300000,95353,Céline Gomez,-59854,144793,2022-03-04
CASH_IN,286346,Agence_mtn_Abomey,300000,13654,Céline Gomez,144793,431139,2022-03-05
CASH_IN,132955,Agence_mtn_Cotonou,300000,167045,Céline Gomez,431139,564094,2022-03-10
TRANSFER,389624,Céline Gomez,564094,174470,Xavier Leblanc-Ferreira,590126,200502,2022-03-18
TRANSFER,1863,Astrid Gay de la Brunet,7577,5714,Céline Gomez,174470,176333,2022-03-18
CASH_OUT,102467,Céline Gomez,176333,73866,Agence_mtn_Ouidah,300000,197533,2022-03-22
CASH_OUT,26907,Céline Gomez,73866,46959,Agence_mtn_Abomey,300000,273093,2022-03-24
CASH_OUT,43925,Céline Gomez,46959,3034,Agence_mtn_Cotonou,300000,256075,2022-03-27
TRANSFER,129755,Marine Chauvet-Potier,257986,128231,Valentine Martinez,6554,-123201,2022-03-04
TRANSFER,48717,Marine Chauvet-Potier,128231,79514,Alphonse Le Olivier,25704,-23013,2022-03-04
CASH_IN,292850,Agence_mtn_Abomey,300000,7150,Marine Chauvet-Potier,79514,372364,2022-03-11
CASH_IN,111269,Agence_mtn_Cotonou,300000,188731,Marine Chauvet-Potier,372364,483633,2022-03-14
TRANSFER,27228,Xavier Leblanc-Ferreira,200502,173274,Marine Chauvet-Potier,483633,510861,2022-03-14
CASH_OUT,433344,Marine Chauvet-Potier,510861,77517,Agence_mtn_Cotonou,300000,-133344,2022-03-15
CASH_IN,233768,Agence_mtn_Cotonou,300000,66232,Marine Chauvet-Potier,77517,311285,2022-03-18
CASH_IN,191567,Agence_mtn_Abomey,300000,108433,Marine Chauvet-Potier,311285,502852,2022-03-21
CASH_IN,33890,Agence_mtn_Ouidah,300000,266110,Marine Chauvet-Potier,502852,536742,2022-03-21
TRANSFER,45888,Valérie Dijoux,69804,23916,Marine Chauvet-Potier,536742,582630,2022-03-22
CASH_IN,257106,Agence_mtn_Ouidah,300000,42894,Marine Chauvet-Potier,582630,839736,2022-03-26
TRANSFER,10155,Antoinette Bertrand,139622,129467,Marine Chauvet-Potier,839736,849891,2022-03-27
CASH_IN,113357,Agence_mtn_Ouidah,300000,186643,Claude Foucher,-13106,100251,2022-03-01
TRANSFER,31715,Claude Foucher,100251,68536,Gabriel-Tristan Marty,36787,5072,2022-03-06
CASH_OUT,3822,Claude Foucher,68536,64714,Agence_mtn_Abomey,300000,296178,2022-03-08
CASH_IN,249962,Agence_mtn_Ouidah,300000,50038,Claude Foucher,64714,314676,2022-03-09
TRANSFER,40608,Hortense Lemaire,70663,30055,Claude Foucher,314676,355284,2022-03-11
TRANSFER,246106,Claude Foucher,355284,109178,Gabriel-Tristan Marty,5072,-241034,2022-03-12
CASH_OUT,19888,Claude Foucher,109178,89290,Agence_mtn_Abomey,300000,280112,2022-03-17
CASH_IN,124609,Agence_mtn_Cotonou,300000,175391,Claude Foucher,89290,213899,2022-03-26
CASH_OUT,117665,Claude Foucher,213899,96234,Agence_mtn_Cotonou,300000,182335,2022-03-27
CASH_IN,74379,Agence_mtn_Cotonou,300000,225621,Zoé Renaud de Boutin,-409839,-335460,2022-03-01
CASH_IN,160216,Agence_mtn_Abomey,300000,139784,Zoé Renaud de Boutin,-335460,-175244,2022-03-07
CASH_IN,4485,Agence_mtn_Ouidah,300000,295515,Zoé Renaud de Boutin,-175244,-170759,2022-03-09
CASH_IN,269202,Agence_mtn_Cotonou,300000,30798,Zoé Renaud de Boutin,-170759,98443,2022-03-10
CASH_IN,235800,Agence_mtn_Cotonou,300000,64200,Zoé Renaud de Boutin,98443,334243,2022-03-12
CASH_OUT,141032,Zoé Renaud de Boutin,334243,193211,Agence_mtn_Cotonou,300000,158968,2022-03-13
TRANSFER,1731,Benjamin Evrard-Marty,19244,17513,Zoé Renaud de Boutin,193211,194942,2022-03-18
CASH_OUT,80722,Zoé Renaud de Boutin,194942,114220,Agence_mtn_Cotonou,300000,219278,2022-03-18
CASH_OUT,106356,Zoé Renaud de Boutin,114220,7864,Agence_mtn_Ouidah,300000,193644,2022-03-23
TRANSFER,221056,Léon Lecoq,796060,575004,Zoé Renaud de Boutin,7864,228920,2022-03-24
CASH_IN,247867,Agence_mtn_Ouidah,300000,52133,Zoé Renaud de Boutin,228920,476787,2022-03-25
CASH_IN,38233,Agence_mtn_Cotonou,300000,261767,William Lebrun,-36753,1480,2022-03-06
CASH_OUT,980,William Lebrun,1480,500,Agence_mtn_Cotonou,300000,299020,2022-03-11
CASH_IN,185573,Agence_mtn_Abomey,300000,114427,William Lebrun,500,186073,2022-03-12
TRANSFER,72181,William Lebrun,186073,113892,Valérie Dijoux,23916,-48265,2022-03-15
CASH_OUT,89394,William Lebrun,113892,24498,Agence_mtn_Cotonou,300000,210606,2022-03-17
TRANSFER,1456,Astrid Gay de la Brunet,5714,4258,William Lebrun,24498,25954,2022-03-19
CASH_IN,122878,Agence_mtn_Cotonou,300000,177122,William Lebrun,25954,148832,2022-03-19
CASH_OUT,51460,William Lebrun,148832,97372,Agence_mtn_Abomey,300000,248540,2022-03-20
CASH_IN,143383,Agence_mtn_Cotonou,300000,156617,William Lebrun,97372,240755,2022-03-20
TRANSFER,488724,Catherine Faivre,789510,300786,William Lebrun,240755,729479,2022-03-22
CASH_OUT,593427,William Lebrun,729479,136052,Agence_mtn_Abomey,300000,-293427,2022-03-25
CASH_IN,122787,Agence_mtn_Ouidah,300000,177213,Jeanne Garnier,-344409,-221622,2022-03-03
CASH_IN,128505,Agence_mtn_Cotonou,300000,171495,Jeanne Garnier,-221622,-93117,2022-03-05
CASH_IN,23754,Agence_mtn_Cotonou,300000,276246,Jeanne Garnier,-93117,-69363,2022-03-05
CASH_IN,69259,Agence_mtn_Abomey,300000,230741,Jeanne Garnier,-69363,-104,2022-03-07
CASH_IN,168738,Agence_mtn_Ouidah,300000,131262,Jeanne Garnier,-104,168634,2022-03-08
TRANSFER,140286,Jeanne Garnier,168634,28348,Jeanne Garnier,168634,308920,2022-03-09
CASH_IN,193808,Agence_mtn_Abomey,300000,106192,Jeanne Garnier,28348,222156,2022-03-10
CASH_OUT,49745,Jeanne Garnier,222156,172411,Agence_mtn_Ouidah,300000,250255,2022-03-12
CASH_OUT,19024,Jeanne Garnier,172411,153387,Agence_mtn_Abomey,300000,280976,2022-03-13
CASH_OUT,50437,Jeanne Garnier,153387,102950,Agence_mtn_Cotonou,300000,249563,2022-03-15
TRANSFER,5702,Hortense Lemaire,30055,24353,Jeanne Garnier,102950,108652,2022-03-17
TRANSFER,24187,Jeanne Garnier,108652,84465,Valentine Richard-Bourdon,977376,953189,2022-03-17
CASH_OUT,39699,Jeanne Garnier,84465,44766,Agence_mtn_Abomey,300000,260301,2022-03-17
CASH_OUT,18783,Jeanne Garnier,44766,25983,Agence_mtn_Cotonou,300000,281217,2022-03-18
CASH_IN,159053,Agence_mtn_Abomey,300000,140947,Jeanne Garnier,25983,185036,2022-03-18
TRANSFER,370239,Valentine Richard-Bourdon,953189,582950,Jeanne Garnier,185036,555275,2022-03-22
TRANSFER,385177,Valentine Richard-Bourdon,582950,197773,Jeanne Garnier,555275,940452,2022-03-22
TRANSFER,65650,Jeanne Garnier,940452,874802,Antoinette Bertrand,129467,63817,2022-03-24
CASH_OUT,697596,Jeanne Garnier,874802,177206,Agence_mtn_Abomey,300000,-397596,2022-03-24
CASH_IN,64820,Agence_mtn_Ouidah,300000,235180,Pénélope Dupuis,-359610,-294790,2022-03-01
CASH_IN,147756,Agence_mtn_Abomey,300000,152244,Pénélope Dupuis,-294790,-147034,2022-03-05
CASH_IN,208111,Agence_mtn_Ouidah,300000,91889,Pénélope Dupuis,-147034,61077,2022-03-07
TRANSFER,177551,Valentine Richard-Bourdon,197773,20222,Pénélope Dupuis,61077,238628,2022-03-09
TRANSFER,86463,Xavier Leblanc-Ferreira,173274,86811,Pénélope Dupuis,238628,325091,2022-03-11
CASH_IN,42590,Agence_mtn_Ouidah,300000,257410,Pénélope Dupuis,325091,367681,2022-03-11
CASH_IN,164377,Agence_mtn_Ouidah,300000,135623,Pénélope Dupuis,367681,532058,2022-03-12
CASH_IN,270394,Agence_mtn_Cotonou,300000,29606,Pénélope Dupuis,532058,802452,2022-03-20
TRANSFER,4746,Benjamin Evrard-Marty,17513,12767,Pénélope Dupuis,802452,807198,2022-03-24
CASH_OUT,77342,Pénélope Dupuis,807198,729856,Agence_mtn_Ouidah,300000,222658,2022-03-26
CASH_IN,125324,Agence_mtn_Abomey,300000,174676,Laure Philippe,-30682,94642,2022-03-02
TRANSFER,50044,Laure Philippe,94642,44598,Laure Philippe,94642,144686,2022-03-06
TRANSFER,2137,Laure Philippe,44598,42461,Astrid Gay de la Brunet,4258,2121,2022-03-06
TRANSFER,70069,Xavier Leblanc-Ferreira,86811,16742,Laure Philippe,42461,112530,2022-03-08
CASH_OUT,11196,Laure Philippe,112530,101334,Agence_mtn_Cotonou,300000,288804,2022-03-10
TRANSFER,62200,Laure Philippe,101334,39134,Hortense Lemaire,24353,-37847,2022-03-15
CASH_OUT,13794,Laure Philippe,39134,25340,Agence_mtn_Cotonou,300000,286206,2022-03-16
CASH_IN,99355,Agence_mtn_Abomey,300000,200645,Laure Philippe,25340,124695,2022-03-19
TRANSFER,1803,Astrid Gay de la Brunet,2121,318,Laure Philippe,124695,126498,2022-03-27
TRANSFER,35962,Antoinette Bertrand,63817,27855,Laure Philippe,126498,162460,2022-03-27
CASH_OUT,231985,Catherine Faivre,300786,68801,Agence_mtn_Abomey,300000,68015,2022-03-07
CASH_OUT,42129,Catherine Faivre,68801,26672,Agence_mtn_Abomey,300000,257871,2022-03-13
CASH_OUT,6006,Catherine Faivre,26672,20666,Agence_mtn_Abomey,300000,293994,2022-03-18
TRANSFER,53797,Léon Lecoq,575004,521207,Catherine Faivre,20666,74463,2022-03-18
CASH_OUT,50292,Catherine Faivre,74463,24171,Agence_mtn_Cotonou,300000,249708,2022-03-19
CASH_OUT,5630,Catherine Faivre,24171,18541,Agence_mtn_Ouidah,300000,294370,2022-03-19
CASH_OUT,17446,Catherine Faivre,18541,1095,Agence_mtn_Ouidah,300000,282554,2022-03-20
CASH_OUT,367,Catherine Faivre,1095,728,Agence_mtn_Abomey,300000,299633,2022-03-21
CASH_OUT,653,Catherine Faivre,728,75,Agence_mtn_Ouidah,300000,299347,2022-03-22
CASH_IN,269509,Agence_mtn_Ouidah,300000,30491,Catherine Faivre,75,269584,2022-03-23
TRANSFER,446262,Léon Lecoq,521207,74945,Catherine Faivre,269584,715846,2022-03-24
CASH_OUT,347881,Catherine Faivre,715846,367965,Agence_mtn_Cotonou,300000,-47881,2022-03-27
CASH_IN,34788,Agence_mtn_Abomey,300000,265212,Valérie Dijoux,-48265,-13477,2022-03-01
CASH_IN,121918,Agence_mtn_Cotonou,300000,178082,Valérie Dijoux,-13477,108441,2022-03-01
TRANSFER,36061,Valérie Dijoux,108441,72380,Léon Lecoq,74945,38884,2022-03-05
CASH_OUT,40311,Valérie Dijoux,72380,32069,Agence_mtn_Ouidah,300000,259689,2022-03-06
CASH_IN,66763,Agence_mtn_Ouidah,300000,233237,Valérie Dijoux,32069,98832,2022-03-10
CASH_IN,138363,Agence_mtn_Abomey,300000,161637,Valérie Dijoux,98832,237195,2022-03-10
TRANSFER,138185,Valérie Dijoux,237195,99010,Valérie Dijoux,237195,99010,2022-03-10
CASH_OUT,16936,Valérie Dijoux,99010,82074,Agence_mtn_Cotonou,300000,283064,2022-03-13
TRANSFER,17081,Valérie Dijoux,82074,64993,Astrid Gay de la Brunet,318,-16763,2022-03-13
CASH_OUT,25834,Valérie Dijoux,64993,39159,Agence_mtn_Ouidah,300000,274166,2022-03-13
CASH_OUT,3349,Valérie Dijoux,39159,35810,Agence_mtn_Abomey,300000,296651,2022-03-13
CASH_OUT,24731,Valérie Dijoux,35810,11079,Agence_mtn_Ouidah,300000,275269,2022-03-19
CASH_IN,193380,Agence_mtn_Cotonou,300000,106620,Valérie Dijoux,11079,204459,2022-03-20
CASH_OUT,11034,Valérie Dijoux,204459,193425,Agence_mtn_Cotonou,300000,288966,2022-03-21
CASH_OUT,191496,Valérie Dijoux,193425,1929,Agence_mtn_Abomey,300000,108504,2022-03-23
CASH_OUT,1394,Valérie Dijoux,1929,535,Agence_mtn_Abomey,300000,298606,2022-03-23
CASH_IN,196018,Agence_mtn_Cotonou,300000,103982,Valérie Dijoux,535,196553,2022-03-24
TRANSFER,16370,Léon Lecoq,38884,22514,Valérie Dijoux,196553,212923,2022-03-25
CASH_IN,214232,Agence_mtn_Cotonou,300000,85768,Valérie Dijoux,212923,427155,2022-03-27
CASH_IN,191154,Agence_mtn_Cotonou,300000,108846,Rémy Le Michaud,-12315,178839,2022-03-01
TRANSFER,8285,Rémy Le Michaud,178839,170554,Rémy Le Michaud,178839,187124,2022-03-07
CASH_IN,255035,Agence_mtn_Abomey,300000,44965,Rémy Le Michaud,170554,425589,2022-03-11
TRANSFER,26970,Antoinette Bertrand,27855,885,Rémy Le Michaud,425589,452559,2022-03-13
CASH_OUT,57585,Rémy Le Michaud,452559,394974,Agence_mtn_Cotonou,300000,242415,2022-03-17
CASH_IN,65926,Agence_mtn_Cotonou,300000,234074,Rémy Le Michaud,394974,460900,2022-03-22
CASH_OUT,259097,Rémy Le Michaud,460900,201803,Agence_mtn_Ouidah,300000,40903,2022-03-27
TRANSFER,10277,Léon Lecoq,22514,12237,Rémy Le Michaud,201803,212080,2022-03-27
CASH_IN,104597,Agence_mtn_Abomey,300000,195403,Valentine Martinez,-123201,-18604,2022-03-01
CASH_IN,101864,Agence_mtn_Abomey,300000,198136,Valentine Martinez,-18604,83260,2022-03-01
CASH_IN,211876,Agence_mtn_Ouidah,300000,88124,Valentine Martinez,83260,295136,2022-03-03
CASH_IN,89295,Agence_mtn_Abomey,300000,210705,Valentine Martinez,295136,384431,2022-03-03
CASH_IN,86634,Agence_mtn_Abomey,300000,213366,Valentine Martinez,384431,471065,2022-03-09
TRANSFER,90448,Valentine Martinez,471065,380617,Antoinette Bertrand,885,-89563,2022-03-11
CASH_OUT,84894,Valentine Martinez,380617,295723,Agence_mtn_Ouidah,300000,215106,2022-03-12
CASH_OUT,196663,Valentine Martinez,295723,99060,Agence_mtn_Abomey,300000,103337,2022-03-13
TRANSFER,16712,Valentine Richard-Bourdon,20222,3510,Valentine Martinez,99060,115772,2022-03-13
CASH_OUT,6962,Valentine Martinez,115772,108810,Agence_mtn_Abomey,300000,293038,2022-03-13
CASH_OUT,71543,Valentine Martinez,108810,37267,Agence_mtn_Abomey,300000,228457,2022-03-15
CASH_IN,170922,Agence_mtn_Cotonou,300000,129078,Valentine Martinez,37267,208189,2022-03-17
CASH_OUT,198593,Valentine Martinez,208189,9596,Agence_mtn_Cotonou,300000,101407,2022-03-18
CASH_OUT,3313,Valentine Martinez,9596,6283,Agence_mtn_Cotonou,300000,296687,2022-03-23
CASH_IN,126438,Agence_mtn_Cotonou,300000,173562,David Guérin,-140479,-14041,2022-03-01
CASH_IN,99989,Agence_mtn_Cotonou,300000,200011,David Guérin,-14041,85948,2022-03-02
CASH_IN,94866,Agence_mtn_Ouidah,300000,205134,David Guérin,85948,180814,2022-03-02
CASH_IN,166511,Agence_mtn_Cotonou,300000,133489,David Guérin,180814,347325,2022-03-04
CASH_IN,230097,Agence_mtn_Cotonou,300000,69903,David Guérin,347325,577422,2022-03-04
CASH_IN,229583,Agence_mtn_Ouidah,300000,70417,David Guérin,577422,807005,2022-03-07
CASH_OUT,117667,David Guérin,807005,689338,Agence_mtn_Cotonou,300000,182333,2022-03-10
CASH_IN,137159,Agence_mtn_Ouidah,300000,162841,David Guérin,689338,826497,2022-03-11
CASH_OUT,122955,David Guérin,826497,703542,Agence_mtn_Cotonou,300000,177045,2022-03-15
TRANSFER,7009,Benjamin Evrard-Marty,12767,5758,David Guérin,703542,710551,2022-03-16
TRANSFER,676235,David Guérin,710551,34316,Xavier Leblanc-Ferreira,16742,-659493,2022-03-16
TRANSFER,5031,David Guérin,34316,29285,Benjamin Evrard-Marty,5758,727,2022-03-19
CASH_IN,145443,Agence_mtn_Abomey,300000,154557,David Guérin,29285,174728,2022-03-23
CASH_OUT,149328,David Guérin,174728,25400,Agence_mtn_Abomey,300000,150672,2022-03-23
CASH_OUT,9011,David Guérin,25400,16389,Agence_mtn_Ouidah,300000,290989,2022-03-24
CASH_IN,150171,Agence_mtn_Ouidah,300000,149829,Étienne Roche,-211498,-61327,2022-03-04
CASH_IN,11475,Agence_mtn_Abomey,300000,288525,Étienne Roche,-61327,-49852,2022-03-05
CASH_IN,66666,Agence_mtn_Ouidah,300000,233334,Étienne Roche,-49852,16814,2022-03-06
TRANSFER,1069,Étienne Roche,16814,15745,Léon Lecoq,12237,11168,2022-03-10
CASH_IN,173608,Agence_mtn_Abomey,300000,126392,Étienne Roche,15745,189353,2022-03-13
TRANSFER,119822,Étienne Roche,189353,69531,Étienne Roche,189353,309175,2022-03-16
TRANSFER,3491,Léon Lecoq,11168,7677,Étienne Roche,69531,73022,2022-03-20
CASH_OUT,31362,Étienne Roche,73022,41660,Agence_mtn_Ouidah,300000,268638,2022-03-22
CASH_IN,116623,Agence_mtn_Cotonou,300000,183377,Étienne Roche,41660,158283,2022-03-22
CASH_OUT,17371,Étienne Roche,158283,140912,Agence_mtn_Cotonou,300000,282629,2022-03-24
CASH_IN,146253,Agence_mtn_Cotonou,300000,153747,Étienne Roche,140912,287165,2022-03-27
CASH_IN,299688,Agence_mtn_Ouidah,300000,312,Franck-Charles Texier,-119890,179798,2022-03-02
CASH_OUT,49459,Franck-Charles Texier,179798,130339,Agence_mtn_Cotonou,300000,250541,2022-03-03
CASH_IN,37747,Agence_mtn_Ouidah,300000,262253,Franck-Charles Texier,130339,168086,2022-03-07
TRANSFER,145212,Franck-Charles Texier,168086,22874,Benjamin Evrard-Marty,727,-144485,2022-03-09
CASH_OUT,7575,Franck-Charles Texier,22874,15299,Agence_mtn_Abomey,300000,292425,2022-03-10
CASH_IN,16706,Agence_mtn_Ouidah,300000,283294,Franck-Charles Texier,15299,32005,2022-03-10
CASH_IN,168718,Agence_mtn_Abomey,300000,131282,Franck-Charles Texier,32005,200723,2022-03-11
CASH_OUT,200370,Franck-Charles Texier,200723,353,Agence_mtn_Abomey,300000,99630,2022-03-12
TRANSFER,349,Franck-Charles Texier,353,4,Léon Lecoq,7677,7328,2022-03-13
CASH_IN,224088,Agence_mtn_Abomey,300000,75912,Franck-Charles Texier,4,224092,2022-03-15
CASH_IN,287993,Agence_mtn_Ouidah,300000,12007,Franck-Charles Texier,224092,512085,2022-03-15
CASH_OUT,424745,Franck-Charles Texier,512085,87340,Agence_mtn_Abomey,300000,-124745,2022-03-16
CASH_OUT,68732,Franck-Charles Texier,87340,18608,Agence_mtn_Ouidah,300000,231268,2022-03-20
CASH_OUT,7530,Franck-Charles Texier,18608,11078,Agence_mtn_Abomey,300000,292470,2022-03-26
TRANSFER,9900,Franck-Charles Texier,11078,1178,Léon Lecoq,7328,-2572,2022-03-26
CASH_IN,9157,Agence_mtn_Cotonou,300000,290843,Léon Lecoq,-2572,6585,2022-03-05
CASH_IN,168188,Agence_mtn_Abomey,300000,131812,Léon Lecoq,6585,174773,2022-03-09
CASH_OUT,100256,Léon Lecoq,174773,74517,Agence_mtn_Abomey,300000,199744,2022-03-09
CASH_IN,1945,Agence_mtn_Abomey,300000,298055,Léon Lecoq,74517,76462,2022-03-09
CASH_IN,80406,Agence_mtn_Abomey,300000,219594,Léon Lecoq,76462,156868,2022-03-11
CASH_IN,291179,Agence_mtn_Ouidah,300000,8821,Léon Lecoq,156868,448047,2022-03-11
CASH_OUT,378543,Léon Lecoq,448047,69504,Agence_mtn_Abomey,300000,-78543,2022-03-12
CASH_OUT,47780,Léon Lecoq,69504,21724,Agence_mtn_Ouidah,300000,252220,2022-03-14
CASH_IN,287036,Agence_mtn_Abomey,300000,12964,Léon Lecoq,21724,308760,2022-03-17
CASH_OUT,87273,Léon Lecoq,308760,221487,Agence_mtn_Cotonou,300000,212727,2022-03-22
CASH_OUT,187189,Léon Lecoq,221487,34298,Agence_mtn_Ouidah,300000,112811,2022-03-23
CASH_IN,92186,Agence_mtn_Abomey,300000,207814,Léon Lecoq,34298,126484,2022-03-27
CASH_IN,162736,Agence_mtn_Ouidah,300000,137264,Antoinette Bertrand,-89563,73173,2022-03-01
CASH_OUT,22931,Antoinette Bertrand,73173,50242,Agence_mtn_Cotonou,300000,277069,2022-03-02
CASH_IN,92058,Agence_mtn_Ouidah,300000,207942,Antoinette Bertrand,50242,142300,2022-03-04
CASH_IN,39289,Agence_mtn_Abomey,300000,260711,Antoinette Bertrand,142300,181589,2022-03-08
CASH_OUT,157333,Antoinette Bertrand,181589,24256,Agence_mtn_Abomey,300000,142667,2022-03-08
CASH_IN,181580,Agence_mtn_Abomey,300000,118420,Antoinette Bertrand,24256,205836,2022-03-11
CASH_IN,35929,Agence_mtn_Cotonou,300000,264071,Antoinette Bertrand,205836,241765,2022-03-15
CASH_IN,22103,Agence_mtn_Cotonou,300000,277897,Antoinette Bertrand,241765,263868,2022-03-15
CASH_IN,36770,Agence_mtn_Cotonou,300000,263230,Antoinette Bertrand,263868,300638,2022-03-16
CASH_OUT,227695,Antoinette Bertrand,300638,72943,Agence_mtn_Ouidah,300000,72305,2022-03-27
CASH_IN,30161,Agence_mtn_Cotonou,300000,269839,Philippine Courtois,-1201599,-1171438,2022-03-01
CASH_IN,141463,Agence_mtn_Ouidah,300000,158537,Philippine Courtois,-1171438,-1029975,2022-03-01
CASH_IN,266173,Agence_mtn_Cotonou,300000,33827,Philippine Courtois,-1029975,-763802,2022-03-02
CASH_IN,246596,Agence_mtn_Ouidah,300000,53404,Philippine Courtois,-763802,-517206,2022-03-09
CASH_IN,104227,Agence_mtn_Abomey,300000,195773,Philippine Courtois,-517206,-412979,2022-03-10
CASH_IN,217589,Agence_mtn_Cotonou,300000,82411,Philippine Courtois,-412979,-195390,2022-03-10
CASH_IN,179108,Agence_mtn_Abomey,300000,120892,Philippine Courtois,-195390,-16282,2022-03-10
CASH_IN,253764,Agence_mtn_Cotonou,300000,46236,Philippine Courtois,-16282,237482,2022-03-11
CASH_IN,54080,Agence_mtn_Abomey,300000,245920,Philippine Courtois,237482,291562,2022-03-11
TRANSFER,291215,Philippine Courtois,291562,347,Philippine Courtois,291562,582777,2022-03-15
TRANSFER,330,Philippine Courtois,347,17,Philippine Courtois,347,677,2022-03-15
CASH_IN,286906,Agence_mtn_Ouidah,300000,13094,Philippine Courtois,17,286923,2022-03-15
TRANSFER,77338,Philippine Courtois,286923,209585,Philippine Courtois,286923,364261,2022-03-16
TRANSFER,128009,Philippine Courtois,209585,81576,Philippine Courtois,209585,81576,2022-03-19
CASH_IN,18555,Agence_mtn_Ouidah,300000,281445,Philippine Courtois,81576,100131,2022-03-20
CASH_OUT,22154,Philippine Courtois,100131,77977,Agence_mtn_Cotonou,300000,277846,2022-03-27
CASH_OUT,13673,Philippine Courtois,77977,64304,Agence_mtn_Ouidah,300000,286327,2022-03-27
CASH_IN,73920,Agence_mtn_Ouidah,300000,226080,Benjamin Evrard-Marty,-144485,-70565,2022-03-01
CASH_IN,233496,Agence_mtn_Abomey,300000,66504,Benjamin Evrard-Marty,-70565,162931,2022-03-01
CASH_IN,11445,Agence_mtn_Cotonou,300000,288555,Benjamin Evrard-Marty,162931,174376,2022-03-02
CASH_OUT,162004,Benjamin Evrard-Marty,174376,12372,Agence_mtn_Cotonou,300000,137996,2022-03-05
TRANSFER,2387,Benjamin Evrard-Marty,12372,9985,Benjamin Evrard-Marty,12372,9985,2022-03-06
CASH_IN,162304,Agence_mtn_Cotonou,300000,137696,Benjamin Evrard-Marty,9985,172289,2022-03-11
CASH_OUT,166938,Benjamin Evrard-Marty,172289,5351,Agence_mtn_Cotonou,300000,133062,2022-03-11
TRANSFER,2671,Benjamin Evrard-Marty,5351,2680,Benjamin Evrard-Marty,5351,8022,2022-03-12
CASH_OUT,2141,Benjamin Evrard-Marty,2680,539,Agence_mtn_Cotonou,300000,297859,2022-03-22
CASH_OUT,486,Benjamin Evrard-Marty,539,53,Agence_mtn_Cotonou,300000,299514,2022-03-25
CASH_IN,231732,Agence_mtn_Abomey,300000,68268,Benjamin Evrard-Marty,53,231785,2022-03-25
CASH_OUT,25566,Benjamin Evrard-Marty,231785,206219,Agence_mtn_Abomey,300000,274434,2022-03-26
CASH_IN,196832,Agence_mtn_Ouidah,300000,103168,Benjamin Evrard-Marty,206219,403051,2022-03-27
CASH_OUT,375709,Benjamin Evrard-Marty,403051,27342,Agence_mtn_Abomey,300000,-75709,2022-03-27
CASH_IN,38916,Agence_mtn_Abomey,300000,261084,Astrid Gay de la Brunet,-16763,22153,2022-03-04
CASH_IN,124696,Agence_mtn_Cotonou,300000,175304,Astrid Gay de la Brunet,22153,146849,2022-03-05
TRANSFER,69670,Astrid Gay de la Brunet,146849,77179,Astrid Gay de la Brunet,146849,77179,2022-03-09
CASH_IN,212894,Agence_mtn_Ouidah,300000,87106,Astrid Gay de la Brunet,77179,290073,2022-03-10
CASH_OUT,191345,Astrid Gay de la Brunet,290073,98728,Agence_mtn_Ouidah,300000,108655,2022-03-11
CASH_OUT,27232,Astrid Gay de la Brunet,98728,71496,Agence_mtn_Cotonou,300000,272768,2022-03-13
CASH_IN,259122,Agence_mtn_Abomey,300000,40878,Astrid Gay de la Brunet,71496,330618,2022-03-19
CASH_IN,22718,Agence_mtn_Ouidah,300000,277282,Astrid Gay de la Brunet,330618,353336,2022-03-23
CASH_OUT,249438,Astrid Gay de la Brunet,353336,103898,Agence_mtn_Abomey,300000,50562,2022-03-24
CASH_IN,247925,Agence_mtn_Cotonou,300000,52075,Astrid Gay de la Brunet,103898,351823,2022-03-24
CASH_IN,146817,Agence_mtn_Cotonou,300000,153183,Astrid Gay de la Brunet,351823,498640,2022-03-24
CASH_OUT,239438,Astrid Gay de la Brunet,498640,259202,Agence_mtn_Abomey,300000,60562,2022-03-25
CASH_IN,191848,Agence_mtn_Ouidah,300000,108152,Astrid Gay de la Brunet,259202,451050,2022-03-25
CASH_IN,277691,Agence_mtn_Abomey,300000,22309,Astrid Gay de la Brunet,451050,728741,2022-03-27
CASH_IN,153909,Agence_mtn_Abomey,300000,146091,Thierry Delattre-Simon,-6503,147406,2022-03-13
CASH_OUT,140054,Thierry Delattre-Simon,147406,7352,Agence_mtn_Cotonou,300000,159946,2022-03-14
CASH_IN,152303,Agence_mtn_Cotonou,300000,147697,Thierry Delattre-Simon,7352,159655,2022-03-16
CASH_IN,51558,Agence_mtn_Ouidah,300000,248442,Thierry Delattre-Simon,159655,211213,2022-03-18
TRANSFER,72268,Thierry Delattre-Simon,211213,138945,Thierry Delattre-Simon,211213,283481,2022-03-19
TRANSFER,53836,Thierry Delattre-Simon,138945,85109,Thierry Delattre-Simon,138945,85109,2022-03-19
CASH_OUT,25843,Thierry Delattre-Simon,85109,59266,Agence_mtn_Ouidah,300000,274157,2022-03-27
CASH_IN,233867,Agence_mtn_Cotonou,300000,66133,Hortense Lemaire,-37847,196020,2022-03-04
CASH_IN,130931,Agence_mtn_Cotonou,300000,169069,Hortense Lemaire,196020,326951,2022-03-07
CASH_IN,271257,Agence_mtn_Ouidah,300000,28743,Hortense Lemaire,326951,598208,2022-03-07
CASH_IN,248878,Agence_mtn_Ouidah,300000,51122,Hortense Lemaire,598208,847086,2022-03-08
CASH_IN,165834,Agence_mtn_Cotonou,300000,134166,Hortense Lemaire,847086,1012920,2022-03-08
CASH_IN,246363,Agence_mtn_Cotonou,300000,53637,Hortense Lemaire,1012920,1259283,2022-03-13
CASH_OUT,1078673,Hortense Lemaire,1259283,180610,Agence_mtn_Ouidah,300000,-778673,2022-03-15
CASH_OUT,137162,Hortense Lemaire,180610,43448,Agence_mtn_Ouidah,300000,162838,2022-03-16
CASH_IN,238010,Agence_mtn_Abomey,300000,61990,Hortense Lemaire,43448,281458,2022-03-26
CASH_IN,159861,Agence_mtn_Abomey,300000,140139,Nathalie Pages,-840050,-680189,2022-03-01
CASH_IN,219892,Agence_mtn_Ouidah,300000,80108,Nathalie Pages,-680189,-460297,2022-03-05
CASH_IN,59103,Agence_mtn_Ouidah,300000,240897,Nathalie Pages,-460297,-401194,2022-03-07
CASH_IN,244406,Agence_mtn_Abomey,300000,55594,Nathalie Pages,-401194,-156788,2022-03-08
CASH_IN,183677,Agence_mtn_Abomey,300000,116323,Nathalie Pages,-156788,26889,2022-03-09
TRANSFER,2044,Nathalie Pages,26889,24845,Nathalie Pages,26889,28933,2022-03-09
CASH_OUT,7993,Nathalie Pages,24845,16852,Agence_mtn_Abomey,300000,292007,2022-03-11
CASH_OUT,14969,Nathalie Pages,16852,1883,Agence_mtn_Cotonou,300000,285031,2022-03-13
CASH_OUT,1641,Nathalie Pages,1883,242,Agence_mtn_Ouidah,300000,298359,2022-03-13
TRANSFER,200,Nathalie Pages,242,42,Nathalie Pages,242,442,2022-03-13
CASH_IN,123918,Agence_mtn_Cotonou,300000,176082,Nathalie Pages,42,123960,2022-03-14
CASH_IN,184030,Agence_mtn_Ouidah,300000,115970,Nathalie Pages,123960,307990,2022-03-21
CASH_IN,22135,Agence_mtn_Cotonou,300000,277865,Nathalie Pages,307990,330125,2022-03-22
CASH_OUT,116624,Nathalie Pages,330125,213501,Agence_mtn_Abomey,300000,183376,2022-03-25
CASH_OUT,71025,Nathalie Pages,213501,142476,Agence_mtn_Abomey,300000,228975,2022-03-25
CASH_OUT,11282,Nathalie Pages,142476,131194,Agence_mtn_Ouidah,300000,288718,2022-03-25
CASH_IN,253277,Agence_mtn_Ouidah,300000,46723,Nathalie Pages,131194,384471,2022-03-26
CASH_IN,36595,Agence_mtn_Ouidah,300000,263405,Alphonse Le Olivier,-23013,13582,2022-03-01
CASH_OUT,142,Alphonse Le Olivier,13582,13440,Agence_mtn_Cotonou,300000,299858,2022-03-03
TRANSFER,11858,Alphonse Le Olivier,13440,1582,Alphonse Le Olivier,13440,1582,2022-03-03
TRANSFER,1453,Alphonse Le Olivier,1582,129,Alphonse Le Olivier,1582,129,2022-03-04
CASH_OUT,116,Alphonse Le Olivier,129,13,Agence_mtn_Cotonou,300000,299884,2022-03-05
CASH_IN,120859,Agence_mtn_Abomey,300000,179141,Alphonse Le Olivier,13,120872,2022-03-07
CASH_OUT,116216,Alphonse Le Olivier,120872,4656,Agence_mtn_Ouidah,300000,183784,2022-03-08
TRANSFER,2782,Alphonse Le Olivier,4656,1874,Alphonse Le Olivier,4656,7438,2022-03-10
CASH_OUT,749,Alphonse Le Olivier,1874,1125,Agence_mtn_Ouidah,300000,299251,2022-03-11
TRANSFER,308,Alphonse Le Olivier,1125,817,Alphonse Le Olivier,1125,1433,2022-03-13
CASH_OUT,488,Alphonse Le Olivier,817,329,Agence_mtn_Cotonou,300000,299512,2022-03-15
CASH_OUT,324,Alphonse Le Olivier,329,5,Agence_mtn_Abomey,300000,299676,2022-03-24
CASH_IN,228715,Agence_mtn_Abomey,300000,71285,Alphonse Le Olivier,5,228720,2022-03-25
CASH_OUT,13269,Alphonse Le Olivier,228720,215451,Agence_mtn_Abomey,300000,286731,2022-03-27
CASH_IN,277599,Agence_mtn_Ouidah,300000,22401,François Michel-Legros,-506716,-229117,2022-03-01
CASH_IN,173339,Agence_mtn_Ouidah,300000,126661,François Michel-Legros,-229117,-55778,2022-03-01
CASH_IN,178852,Agence_mtn_Cotonou,300000,121148,François Michel-Legros,-55778,123074,2022-03-04
TRANSFER,1345,François Michel-Legros,123074,121729,François Michel-Legros,123074,121729,2022-03-05
CASH_OUT,108629,François Michel-Legros,121729,13100,Agence_mtn_Cotonou,300000,191371,2022-03-05
CASH_IN,75835,Agence_mtn_Ouidah,300000,224165,François Michel-Legros,13100,88935,2022-03-06
CASH_OUT,63118,François Michel-Legros,88935,25817,Agence_mtn_Cotonou,300000,236882,2022-03-08
CASH_IN,281514,Agence_mtn_Cotonou,300000,18486,François Michel-Legros,25817,307331,2022-03-08
CASH_IN,150930,Agence_mtn_Ouidah,300000,149070,François Michel-Legros,307331,458261,2022-03-16
CASH_IN,56242,Agence_mtn_Cotonou,300000,243758,François Michel-Legros,458261,514503,2022-03-19
CASH_IN,142297,Agence_mtn_Abomey,300000,157703,François Michel-Legros,514503,656800,2022-03-20
CASH_OUT,263181,François Michel-Legros,656800,393619,Agence_mtn_Abomey,300000,36819,2022-03-20
CASH_OUT,116431,François Michel-Legros,393619,277188,Agence_mtn_Abomey,300000,183569,2022-03-27
CASH_IN,183397,Agence_mtn_Ouidah,300000,116603,François Michel-Legros,277188,460585,2022-03-27
CASH_IN,76852,Agence_mtn_Ouidah,300000,223148,Alexandrie Delmas,-117785,-40933,2022-03-02
CASH_IN,8301,Agence_mtn_Cotonou,300000,291699,Alexandrie Delmas,-40933,-32632,2022-03-03
CASH_IN,240642,Agence_mtn_Ouidah,300000,59358,Alexandrie Delmas,-32632,208010,2022-03-03
CASH_OUT,141109,Alexandrie Delmas,208010,66901,Agence_mtn_Cotonou,300000,158891,2022-03-04
CASH_IN,282112,Agence_mtn_Ouidah,300000,17888,Alexandrie Delmas,66901,349013,2022-03-04
CASH_OUT,203426,Alexandrie Delmas,349013,145587,Agence_mtn_Abomey,300000,96574,2022-03-04
CASH_IN,128861,Agence_mtn_Cotonou,300000,171139,Alexandrie Delmas,145587,274448,2022-03-07
CASH_OUT,119527,Alexandrie Delmas,274448,154921,Agence_mtn_Cotonou,300000,180473,2022-03-14
CASH_IN,153516,Agence_mtn_Ouidah,300000,146484,Alexandrie Delmas,154921,308437,2022-03-17
CASH_OUT,64615,Alexandrie Delmas,308437,243822,Agence_mtn_Cotonou,300000,235385,2022-03-18
CASH_OUT,170515,Alexandrie Delmas,243822,73307,Agence_mtn_Ouidah,300000,129485,2022-03-26
CASH_OUT,12106,Sophie Lévêque,407800,395694,Agence_mtn_Ouidah,300000,287894,2022-04-02
TRANSFER,46058,Sophie Lévêque,395694,349636,Bertrand Le Roux,526400,480342,2022-04-02
CASH_OUT,147187,Sophie Lévêque,349636,202449,Agence_mtn_Cotonou,300000,152813,2022-04-06
CASH_IN,207158,Agence_mtn_Ouidah,300000,92842,Sophie Lévêque,202449,409607,2022-04-09
CASH_OUT,172019,Sophie Lévêque,409607,237588,Agence_mtn_Abomey,300000,127981,2022-04-25
CASH_IN,102801,Agence_mtn_Abomey,300000,197199,Tristan Thomas,1192200,1295001,2022-04-01
TRANSFER,703953,Frédéric Couturier,1149000,445047,Tristan Thomas,1295001,1998954,2022-04-01
TRANSFER,493059,Inès Hamon,1035300,542241,Tristan Thomas,1998954,2492013,2022-04-12
CASH_OUT,1099732,Michelle Lebon,1914600,814868,Agence_mtn_Abomey,300000,-799732,2022-04-04
TRANSFER,233029,Michelle Lebon,814868,581839,Pénélope Dupuis,448000,214971,2022-04-09
TRANSFER,443839,Michelle Lebon,581839,138000,Caroline-Lorraine Humbert,1902600,1458761,2022-04-10
CASH_IN,38995,Agence_mtn_Ouidah,300000,261005,Théodore De Oliveira-Nicolas,888500,927495,2022-04-19
CASH_OUT,471729,Adrien Chartier,1434100,962371,Agence_mtn_Abomey,300000,-171729,2022-04-01
TRANSFER,495159,Adrien Chartier,962371,467212,William Lebrun,1291400,796241,2022-04-11
CASH_OUT,436860,Adrien Chartier,467212,30352,Agence_mtn_Ouidah,300000,-136860,2022-04-13
CASH_OUT,133873,Martine Wagner de la Bègue,855100,721227,Agence_mtn_Abomey,300000,166127,2022-04-02
TRANSFER,390981,Renée David,1424900,1033919,Martine Wagner de la Bègue,721227,1112208,2022-04-08
CASH_IN,157862,Agence_mtn_Ouidah,300000,142138,Martine Wagner de la Bègue,1112208,1270070,2022-04-13
CASH_OUT,25366,Martine Wagner de la Bègue,1270070,1244704,Agence_mtn_Abomey,300000,274634,2022-04-19
CASH_IN,262689,Agence_mtn_Cotonou,300000,37311,Martine Wagner de la Bègue,1244704,1507393,2022-04-19
CASH_OUT,15669,Aurore Guyon,984400,968731,Agence_mtn_Abomey,300000,284331,2022-04-20
CASH_OUT,14482,Laure Philippe,1408000,1393518,Agence_mtn_Abomey,300000,285518,2022-04-01
CASH_OUT,413782,Victoire-Nicole Lopez,617900,204118,Agence_mtn_Ouidah,300000,-113782,2022-04-07
CASH_IN,174891,Agence_mtn_Abomey,300000,125109,Victoire-Nicole Lopez,204118,379009,2022-04-08
TRANSFER,123222,Victoire-Nicole Lopez,379009,255787,Valentine Martinez,1494600,1371378,2022-04-15
CASH_OUT,127516,Victoire-Nicole Lopez,255787,128271,Agence_mtn_Abomey,300000,172484,2022-04-25
CASH_IN,134688,Agence_mtn_Cotonou,300000,165312,Marie Picard,1146500,1281188,2022-04-20
CASH_OUT,345638,Marie Picard,1281188,935550,Agence_mtn_Ouidah,300000,-45638,2022-04-23
CASH_OUT,36853,Marie Picard,935550,898697,Agence_mtn_Ouidah,300000,263147,2022-04-27
CASH_IN,104763,Agence_mtn_Cotonou,300000,195237,Alexandre Rémy,467000,571763,2022-04-02
TRANSFER,322839,Alexandre Rémy,571763,248924,Sébastien Lemaître,1823600,1500761,2022-04-11
CASH_IN,80547,Agence_mtn_Abomey,300000,219453,Éléonore-Hélène Dubois,1429900,1510447,2022-04-03
TRANSFER,385497,Éléonore-Hélène Dubois,1510447,1124950,Antoinette Bertrand,1015000,629503,2022-04-27
CASH_OUT,573276,Pénélope Ollivier,635900,62624,Agence_mtn_Ouidah,300000,-273276,2022-04-02
CASH_OUT,137204,Zoé Renaud de Boutin,1702700,1565496,Agence_mtn_Cotonou,300000,162796,2022-04-04
CASH_IN,198308,Agence_mtn_Abomey,300000,101692,Zoé Renaud de Boutin,1565496,1763804,2022-04-05
CASH_IN,121584,Agence_mtn_Cotonou,300000,178416,Zoé Renaud de Boutin,1763804,1885388,2022-04-13
CASH_OUT,1275216,Zoé Renaud de Boutin,1885388,610172,Agence_mtn_Cotonou,300000,-975216,2022-04-14
CASH_OUT,878747,Rémy de la Roux,921900,43153,Agence_mtn_Cotonou,300000,-578747,2022-04-14
CASH_IN,228212,Agence_mtn_Abomey,300000,71788,Inès de Letellier,1561800,1790012,2022-04-01
CASH_IN,291002,Agence_mtn_Abomey,300000,8998,Inès de Letellier,1790012,2081014,2022-04-06
CASH_IN,146651,Agence_mtn_Abomey,300000,153349,Inès de Letellier,2081014,2227665,2022-04-15
TRANSFER,1787674,Inès de Letellier,2227665,439991,Édouard Nguyen,124300,-1663374,2022-04-22
CASH_OUT,145828,Inès de Letellier,439991,294163,Agence_mtn_Cotonou,300000,154172,2022-04-27
TRANSFER,1155852,Geneviève Grondin,1283200,127348,Marcelle Charrier,895100,2050952,2022-04-13
CASH_IN,199425,Agence_mtn_Cotonou,300000,100575,Marcelle Charrier,2050952,2250377,2022-04-17
CASH_OUT,1865961,Marcelle Charrier,2250377,384416,Agence_mtn_Abomey,300000,-1565961,2022-04-20
CASH_IN,218738,Agence_mtn_Ouidah,300000,81262,Alexandrie Delmas,721900,940638,2022-04-09
CASH_OUT,49183,Geneviève Grondin,127348,78165,Agence_mtn_Cotonou,300000,250817,2022-04-02
TRANSFER,52545,Geneviève Grondin,78165,25620,Virginie Le Gall,1493400,1440855,2022-04-14
CASH_IN,183681,Agence_mtn_Ouidah,300000,116319,Geneviève Grondin,25620,209301,2022-04-16
TRANSFER,126318,Geneviève Grondin,209301,82983,Claude Foucher,1267200,1140882,2022-04-22
CASH_IN,218924,Agence_mtn_Cotonou,300000,81076,Geneviève Grondin,82983,301907,2022-04-27
CASH_IN,288201,Agence_mtn_Cotonou,300000,11799,Léon Martins-Briand,137500,425701,2022-04-03
CASH_IN,282398,Agence_mtn_Ouidah,300000,17602,Léon Martins-Briand,425701,708099,2022-04-03
TRANSFER,530801,Léon Martins-Briand,708099,177298,Inès Hamon,542241,11440,2022-04-09
CASH_IN,131000,Agence_mtn_Ouidah,300000,169000,Léon Martins-Briand,177298,308298,2022-04-27
TRANSFER,184905,Léon Martins-Briand,308298,123393,Roland Garcia,1188700,1003795,2022-04-27
TRANSFER,392820,Hortense Lemaire,720200,327380,Hortense Lemaire,720200,1113020,2022-04-02
CASH_IN,229131,Agence_mtn_Abomey,300000,70869,Hortense Lemaire,327380,556511,2022-04-08
CASH_IN,105927,Agence_mtn_Abomey,300000,194073,Hortense Lemaire,556511,662438,2022-04-10
CASH_OUT,208990,Hortense Lemaire,662438,453448,Agence_mtn_Abomey,300000,91010,2022-04-11
CASH_IN,183666,Agence_mtn_Cotonou,300000,116334,Hortense Lemaire,453448,637114,2022-04-24
TRANSFER,288358,Catherine Faivre,1130900,842542,Bertrand Charles,189600,-98758,2022-04-14
CASH_IN,262465,Agence_mtn_Abomey,300000,37535,Catherine Faivre,842542,1105007,2022-04-15
CASH_IN,282621,Agence_mtn_Ouidah,300000,17379,David Guérin,729800,1012421,2022-04-15
TRANSFER,1061251,Caroline-Lorraine Humbert,1458761,397510,David Guérin,1012421,2073672,2022-04-18
TRANSFER,144722,Isabelle Rossi,1230700,1085978,Honoré du Laurent,1318100,1462822,2022-04-08
CASH_IN,278260,Agence_mtn_Ouidah,300000,21740,Honoré du Laurent,1462822,1741082,2022-04-09
TRANSFER,330832,Gabriel Humbert,398700,67868,Honoré du Laurent,1741082,2071914,2022-04-14
TRANSFER,64665,Honoré du Laurent,2071914,2007249,Honoré du Laurent,2071914,2007249,2022-04-18
CASH_OUT,720827,Honoré du Laurent,2007249,1286422,Agence_mtn_Cotonou,300000,-420827,2022-04-20
CASH_OUT,473659,Vincent Mathieu,795500,321841,Agence_mtn_Abomey,300000,-173659,2022-04-18
TRANSFER,3648,Inès Hamon,11440,7792,Vincent Mathieu,321841,325489,2022-04-23
TRANSFER,113696,Raymond Marchal de Nguyen,387400,273704,Vincent Mathieu,325489,439185,2022-04-24
CASH_IN,137975,Agence_mtn_Abomey,300000,162025,Édouard Nguyen,-1663374,-1525399,2022-04-02
CASH_IN,256549,Agence_mtn_Cotonou,300000,43451,Édouard Nguyen,-1525399,-1268850,2022-04-03
CASH_IN,31797,Agence_mtn_Cotonou,300000,268203,Édouard Nguyen,-1268850,-1237053,2022-04-03
CASH_IN,126143,Agence_mtn_Cotonou,300000,173857,Édouard Nguyen,-1237053,-1110910,2022-04-04
CASH_IN,208576,Agence_mtn_Abomey,300000,91424,Édouard Nguyen,-1110910,-902334,2022-04-04
CASH_IN,77874,Agence_mtn_Cotonou,300000,222126,Édouard Nguyen,-902334,-824460,2022-04-05
CASH_IN,40577,Agence_mtn_Abomey,300000,259423,Édouard Nguyen,-824460,-783883,2022-04-06
CASH_IN,245497,Agence_mtn_Cotonou,300000,54503,Édouard Nguyen,-783883,-538386,2022-04-06
CASH_IN,196217,Agence_mtn_Cotonou,300000,103783,Édouard Nguyen,-538386,-342169,2022-04-07
CASH_IN,217333,Agence_mtn_Ouidah,300000,82667,Édouard Nguyen,-342169,-124836,2022-04-12
CASH_IN,272140,Agence_mtn_Cotonou,300000,27860,Édouard Nguyen,-124836,147304,2022-04-12
CASH_OUT,34974,Édouard Nguyen,147304,112330,Agence_mtn_Ouidah,300000,265026,2022-04-13
CASH_OUT,50496,Édouard Nguyen,112330,61834,Agence_mtn_Abomey,300000,249504,2022-04-13
CASH_IN,267428,Agence_mtn_Cotonou,300000,32572,Édouard Nguyen,61834,329262,2022-04-14
CASH_OUT,174708,Édouard Nguyen,329262,154554,Agence_mtn_Abomey,300000,125292,2022-04-14
CASH_OUT,28602,Édouard Nguyen,154554,125952,Agence_mtn_Abomey,300000,271398,2022-04-14
CASH_IN,16390,Agence_mtn_Abomey,300000,283610,Édouard Nguyen,125952,142342,2022-04-15
CASH_OUT,98274,Édouard Nguyen,142342,44068,Agence_mtn_Abomey,300000,201726,2022-04-20
TRANSFER,98470,Rémy Le Michaud,656100,557630,Édouard Nguyen,44068,142538,2022-04-22
CASH_IN,157416,Agence_mtn_Abomey,300000,142584,Édouard Nguyen,142538,299954,2022-04-23
TRANSFER,463273,Sébastien Lemaître,1500761,1037488,Édouard Nguyen,299954,763227,2022-04-23
CASH_OUT,117832,Édouard Nguyen,763227,645395,Agence_mtn_Cotonou,300000,182168,2022-04-23
CASH_OUT,245506,Édouard Nguyen,645395,399889,Agence_mtn_Cotonou,300000,54494,2022-04-24
CASH_IN,25358,Agence_mtn_Ouidah,300000,274642,Édouard Nguyen,399889,425247,2022-04-25
CASH_IN,209134,Agence_mtn_Abomey,300000,90866,Édouard Nguyen,425247,634381,2022-04-26
CASH_IN,281280,Agence_mtn_Ouidah,300000,18720,Pénélope Dupuis,214971,496251,2022-04-01
TRANSFER,270907,François Michel-Legros,725400,454493,Pénélope Dupuis,496251,767158,2022-04-01
TRANSFER,1316664,Gilbert Foucher,1900200,583536,Pénélope Dupuis,767158,2083822,2022-04-04
CASH_IN,26106,Agence_mtn_Abomey,300000,273894,Pénélope Dupuis,2083822,2109928,2022-04-05
CASH_OUT,83039,Pénélope Dupuis,2109928,2026889,Agence_mtn_Ouidah,300000,216961,2022-04-08
CASH_IN,133379,Agence_mtn_Abomey,300000,166621,Pénélope Dupuis,2026889,2160268,2022-04-08
CASH_IN,228380,Agence_mtn_Abomey,300000,71620,Pénélope Dupuis,2160268,2388648,2022-04-09
CASH_OUT,955568,Pénélope Dupuis,2388648,1433080,Agence_mtn_Abomey,300000,-655568,2022-04-10
CASH_OUT,338734,Pénélope Dupuis,1433080,1094346,Agence_mtn_Abomey,300000,-38734,2022-04-12
CASH_OUT,1058989,Pénélope Dupuis,1094346,35357,Agence_mtn_Abomey,300000,-758989,2022-04-12
CASH_OUT,22986,Pénélope Dupuis,35357,12371,Agence_mtn_Cotonou,300000,277014,2022-04-13
TRANSFER,929140,Philippine Courtois,1325800,396660,Pénélope Dupuis,12371,941511,2022-04-13
TRANSFER,779418,Renée David,1033919,254501,Pénélope Dupuis,941511,1720929,2022-04-13
CASH_OUT,126516,Pénélope Dupuis,1720929,1594413,Agence_mtn_Abomey,300000,173484,2022-04-14
TRANSFER,863044,Pénélope Dupuis,1594413,731369,Gilbert Foucher,583536,-279508,2022-04-17
CASH_IN,104002,Agence_mtn_Cotonou,300000,195998,Pénélope Dupuis,731369,835371,2022-04-17
CASH_OUT,415564,Pénélope Dupuis,835371,419807,Agence_mtn_Cotonou,300000,-115564,2022-04-17
CASH_IN,239931,Agence_mtn_Ouidah,300000,60069,Pénélope Dupuis,419807,659738,2022-04-20
CASH_OUT,124914,Pénélope Dupuis,659738,534824,Agence_mtn_Ouidah,300000,175086,2022-04-21
CASH_OUT,384472,Pénélope Dupuis,534824,150352,Agence_mtn_Ouidah,300000,-84472,2022-04-21
CASH_IN,193984,Agence_mtn_Abomey,300000,106016,Pénélope Dupuis,150352,344336,2022-04-23
CASH_IN,260547,Agence_mtn_Abomey,300000,39453,Pénélope Dupuis,344336,604883,2022-04-23
CASH_IN,10407,Agence_mtn_Abomey,300000,289593,Pénélope Dupuis,604883,615290,2022-04-25
TRANSFER,525108,Pénélope Dupuis,615290,90182,Céline Gomez,466000,-59108,2022-04-26
TRANSFER,1005316,Jeanne Garnier,1203900,198584,Benjamin Evrard-Marty,819200,-186116,2022-04-01
TRANSFER,86124,Jeanne Garnier,198584,112460,Jean Benard,1689100,1602976,2022-04-02
TRANSFER,78945,Jeanne Garnier,112460,33515,Valérie Dijoux,455800,376855,2022-04-03
CASH_OUT,29120,Jeanne Garnier,33515,4395,Agence_mtn_Ouidah,300000,270880,2022-04-04
CASH_OUT,3294,Jeanne Garnier,4395,1101,Agence_mtn_Cotonou,300000,296706,2022-04-05
CASH_OUT,391,Jeanne Garnier,1101,710,Agence_mtn_Cotonou,300000,299609,2022-04-05
CASH_OUT,312,Jeanne Garnier,710,398,Agence_mtn_Ouidah,300000,299688,2022-04-05
CASH_IN,270217,Agence_mtn_Cotonou,300000,29783,Jeanne Garnier,398,270615,2022-04-06
CASH_OUT,256214,Jeanne Garnier,270615,14401,Agence_mtn_Abomey,300000,43786,2022-04-07
CASH_OUT,698,Jeanne Garnier,14401,13703,Agence_mtn_Abomey,300000,299302,2022-04-08
CASH_OUT,9845,Jeanne Garnier,13703,3858,Agence_mtn_Ouidah,300000,290155,2022-04-08
TRANSFER,124769,Philippine Courtois,396660,271891,Jeanne Garnier,3858,128627,2022-04-10
CASH_OUT,106146,Jeanne Garnier,128627,22481,Agence_mtn_Ouidah,300000,193854,2022-04-12
CASH_OUT,2089,Jeanne Garnier,22481,20392,Agence_mtn_Cotonou,300000,297911,2022-04-15
CASH_OUT,3861,Jeanne Garnier,20392,16531,Agence_mtn_Ouidah,300000,296139,2022-04-17
CASH_IN,93583,Agence_mtn_Abomey,300000,206417,Jeanne Garnier,16531,110114,2022-04-18
CASH_IN,200309,Agence_mtn_Ouidah,300000,99691,Jeanne Garnier,110114,310423,2022-04-19
CASH_IN,247356,Agence_mtn_Cotonou,300000,52644,Jeanne Garnier,310423,557779,2022-04-20
CASH_IN,79404,Agence_mtn_Abomey,300000,220596,Jeanne Garnier,557779,637183,2022-04-22
CASH_OUT,621333,Jeanne Garnier,637183,15850,Agence_mtn_Cotonou,300000,-321333,2022-04-24
CASH_OUT,12674,Jeanne Garnier,15850,3176,Agence_mtn_Ouidah,300000,287326,2022-04-24
CASH_IN,147763,Agence_mtn_Abomey,300000,152237,Jeanne Garnier,3176,150939,2022-04-26
CASH_OUT,949866,Virginie Le Gall,1440855,490989,Agence_mtn_Abomey,300000,-649866,2022-04-02
CASH_IN,42729,Agence_mtn_Cotonou,300000,257271,Virginie Le Gall,490989,533718,2022-04-04
TRANSFER,1222778,Alix Maillet,1549400,326622,Virginie Le Gall,533718,1756496,2022-04-05
CASH_OUT,738294,Virginie Le Gall,1756496,1018202,Agence_mtn_Ouidah,300000,-438294,2022-04-05
CASH_IN,114873,Agence_mtn_Cotonou,300000,185127,Virginie Le Gall,1018202,1133075,2022-04-06
CASH_IN,245034,Agence_mtn_Cotonou,300000,54966,Virginie Le Gall,1133075,1378109,2022-04-08
CASH_IN,5419,Agence_mtn_Abomey,300000,294581,Virginie Le Gall,1378109,1383528,2022-04-09
TRANSFER,436015,Roland Garcia,1003795,567780,Virginie Le Gall,1383528,1819543,2022-04-11
CASH_IN,86845,Agence_mtn_Abomey,300000,213155,Virginie Le Gall,1819543,1906388,2022-04-12
TRANSFER,593479,Antoinette Bertrand,629503,36024,Virginie Le Gall,1906388,2499867,2022-04-13
CASH_IN,189280,Agence_mtn_Ouidah,300000,110720,Virginie Le Gall,2499867,2689147,2022-04-14
CASH_IN,147421,Agence_mtn_Cotonou,300000,152579,Virginie Le Gall,2689147,2836568,2022-04-14
TRANSFER,589464,Louise Girard,798700,209236,Virginie Le Gall,2836568,3426032,2022-04-15
CASH_OUT,616184,Virginie Le Gall,3426032,2809848,Agence_mtn_Cotonou,300000,-316184,2022-04-16
TRANSFER,414076,Bertrand Le Roux,480342,66266,Virginie Le Gall,2809848,3223924,2022-04-16
TRANSFER,2266695,Virginie Le Gall,3223924,957229,Sébastien Vallée,1480900,-785795,2022-04-18
CASH_IN,193543,Agence_mtn_Abomey,300000,106457,Virginie Le Gall,957229,1150772,2022-04-19
CASH_OUT,746677,Virginie Le Gall,1150772,404095,Agence_mtn_Cotonou,300000,-446677,2022-04-19
TRANSFER,209795,Caroline-Lorraine Humbert,397510,187715,Virginie Le Gall,404095,613890,2022-04-20
CASH_OUT,42807,Virginie Le Gall,613890,571083,Agence_mtn_Cotonou,300000,257193,2022-04-20
CASH_OUT,212812,Virginie Le Gall,571083,358271,Agence_mtn_Cotonou,300000,87188,2022-04-21
CASH_OUT,151289,Virginie Le Gall,358271,206982,Agence_mtn_Cotonou,300000,148711,2022-04-21
CASH_OUT,115855,Virginie Le Gall,206982,91127,Agence_mtn_Ouidah,300000,184145,2022-04-24
CASH_IN,122998,Agence_mtn_Cotonou,300000,177002,Virginie Le Gall,91127,214125,2022-04-24
TRANSFER,882,Virginie Le Gall,214125,213243,Alix Maillet,326622,325740,2022-04-24
CASH_IN,78382,Agence_mtn_Ouidah,300000,221618,Virginie Le Gall,213243,291625,2022-04-25
TRANSFER,195310,Virginie Le Gall,291625,96315,Cécile Germain,1879300,1683990,2022-04-25
CASH_OUT,54250,Margot Riou du Fernandes,98500,44250,Agence_mtn_Cotonou,300000,245750,2022-04-01
CASH_OUT,15462,Margot Riou du Fernandes,44250,28788,Agence_mtn_Cotonou,300000,284538,2022-04-01
TRANSFER,3894,Margot Riou du Fernandes,28788,24894,Rémy Le Michaud,557630,553736,2022-04-03
TRANSFER,216221,Alix Maillet,325740,109519,Margot Riou du Fernandes,24894,241115,2022-04-03
TRANSFER,420518,Cécile Clerc,1417400,996882,Margot Riou du Fernandes,241115,661633,2022-04-04
CASH_OUT,627435,Margot Riou du Fernandes,661633,34198,Agence_mtn_Ouidah,300000,-327435,2022-04-04
TRANSFER,6038,Margot Riou du Fernandes,34198,28160,Renée David,254501,248463,2022-04-05
CASH_IN,118745,Agence_mtn_Abomey,300000,181255,Margot Riou du Fernandes,28160,146905,2022-04-07
TRANSFER,80781,Margot Riou du Fernandes,146905,66124,Astrid Gay de la Brunet,654800,574019,2022-04-07
CASH_OUT,30995,Margot Riou du Fernandes,66124,35129,Agence_mtn_Cotonou,300000,269005,2022-04-08
CASH_IN,262533,Agence_mtn_Cotonou,300000,37467,Margot Riou du Fernandes,35129,297662,2022-04-11
TRANSFER,1292775,Eugène Poulain,1658500,365725,Margot Riou du Fernandes,297662,1590437,2022-04-11
TRANSFER,726444,Claude Foucher,1140882,414438,Margot Riou du Fernandes,1590437,2316881,2022-04-11
CASH_OUT,986934,Margot Riou du Fernandes,2316881,1329947,Agence_mtn_Cotonou,300000,-686934,2022-04-13
TRANSFER,2081,Inès Hamon,7792,5711,Margot Riou du Fernandes,1329947,1332028,2022-04-14
CASH_OUT,447877,Margot Riou du Fernandes,1332028,884151,Agence_mtn_Cotonou,300000,-147877,2022-04-15
CASH_IN,248921,Agence_mtn_Cotonou,300000,51079,Margot Riou du Fernandes,884151,1133072,2022-04-16
CASH_IN,49950,Agence_mtn_Cotonou,300000,250050,Margot Riou du Fernandes,1133072,1183022,2022-04-16
CASH_IN,145857,Agence_mtn_Ouidah,300000,154143,Margot Riou du Fernandes,1183022,1328879,2022-04-16
CASH_OUT,1145542,Margot Riou du Fernandes,1328879,183337,Agence_mtn_Ouidah,300000,-845542,2022-04-17
CASH_IN,108008,Agence_mtn_Abomey,300000,191992,Margot Riou du Fernandes,183337,291345,2022-04-17
CASH_OUT,46235,Margot Riou du Fernandes,291345,245110,Agence_mtn_Ouidah,300000,253765,2022-04-20
TRANSFER,217332,Valérie Dijoux,376855,159523,Margot Riou du Fernandes,245110,462442,2022-04-22
TRANSFER,153485,Margot Riou du Fernandes,462442,308957,Xavier de Lebreton,408900,255415,2022-04-22
TRANSFER,167025,Margot Riou du Fernandes,308957,141932,Nathalie Pages,761600,594575,2022-04-23
CASH_IN,232891,Agence_mtn_Ouidah,300000,67109,Margot Riou du Fernandes,141932,374823,2022-04-24
CASH_OUT,219499,Margot Riou du Fernandes,374823,155324,Agence_mtn_Abomey,300000,80501,2022-04-24
TRANSFER,150502,Nathalie Peron,427100,276598,Margot Riou du Fernandes,155324,305826,2022-04-27
CASH_OUT,976854,Antoine Leleu,1212500,235646,Agence_mtn_Abomey,300000,-676854,2022-04-01
TRANSFER,80562,Antoine Leleu,235646,155084,Eugène Poulain,365725,285163,2022-04-01
CASH_OUT,129752,Antoine Leleu,155084,25332,Agence_mtn_Cotonou,300000,170248,2022-04-01
CASH_OUT,24120,Antoine Leleu,25332,1212,Agence_mtn_Abomey,300000,275880,2022-04-02
TRANSFER,35529,Valérie Dijoux,159523,123994,Antoine Leleu,1212,36741,2022-04-04
TRANSFER,4656,Antoine Leleu,36741,32085,Xavier Leblanc-Ferreira,591700,587044,2022-04-04
TRANSFER,11701,Antoine Leleu,32085,20384,Xavier de Lebreton,255415,243714,2022-04-05
CASH_IN,27119,Agence_mtn_Ouidah,300000,272881,Antoine Leleu,20384,47503,2022-04-05
TRANSFER,270851,Claude Foucher,414438,143587,Antoine Leleu,47503,318354,2022-04-06
CASH_IN,28457,Agence_mtn_Cotonou,300000,271543,Antoine Leleu,318354,346811,2022-04-07
CASH_IN,265605,Agence_mtn_Cotonou,300000,34395,Antoine Leleu,346811,612416,2022-04-07
CASH_OUT,46743,Antoine Leleu,612416,565673,Agence_mtn_Cotonou,300000,253257,2022-04-08
CASH_OUT,350140,Antoine Leleu,565673,215533,Agence_mtn_Cotonou,300000,-50140,2022-04-09
CASH_IN,10988,Agence_mtn_Cotonou,300000,289012,Antoine Leleu,215533,226521,2022-04-10
CASH_IN,229316,Agence_mtn_Cotonou,300000,70684,Antoine Leleu,226521,455837,2022-04-11
CASH_OUT,142921,Antoine Leleu,455837,312916,Agence_mtn_Abomey,300000,157079,2022-04-11
TRANSFER,25170,Gabriel Humbert,67868,42698,Antoine Leleu,312916,338086,2022-04-14
TRANSFER,189578,Antoine Leleu,338086,148508,David du Blondel,105500,-84078,2022-04-15
CASH_OUT,102022,Antoine Leleu,148508,46486,Agence_mtn_Cotonou,300000,197978,2022-04-16
CASH_IN,40971,Agence_mtn_Cotonou,300000,259029,Antoine Leleu,46486,87457,2022-04-16
CASH_IN,296208,Agence_mtn_Cotonou,300000,3792,Antoine Leleu,87457,383665,2022-04-17
TRANSFER,385670,Frédéric Couturier,445047,59377,Antoine Leleu,383665,769335,2022-04-18
CASH_OUT,117636,Antoine Leleu,769335,651699,Agence_mtn_Cotonou,300000,182364,2022-04-18
TRANSFER,2617,Roland Garcia,567780,565163,Antoine Leleu,651699,654316,2022-04-20
TRANSFER,351338,Gilbert-Charles Thibault,1603600,1252262,Antoine Leleu,654316,1005654,2022-04-21
CASH_OUT,451231,Antoine Leleu,1005654,554423,Agence_mtn_Ouidah,300000,-151231,2022-04-25
CASH_IN,287063,Agence_mtn_Ouidah,300000,12937,Pierre Roger,1042000,1329063,2022-04-01
CASH_OUT,221811,Pierre Roger,1329063,1107252,Agence_mtn_Cotonou,300000,78189,2022-04-02
TRANSFER,611043,Pierre Roger,1107252,496209,Xavier Leblanc-Ferreira,587044,-23999,2022-04-03
CASH_OUT,104826,Pierre Roger,496209,391383,Agence_mtn_Cotonou,300000,195174,2022-04-04
CASH_OUT,279389,Pierre Roger,391383,111994,Agence_mtn_Cotonou,300000,20611,2022-04-04
CASH_IN,20240,Agence_mtn_Abomey,300000,279760,Pierre Roger,111994,132234,2022-04-05
CASH_OUT,89727,Pierre Roger,132234,42507,Agence_mtn_Ouidah,300000,210273,2022-04-05
TRANSFER,351315,Thérèse-Margaux Bruneau,372200,20885,Pierre Roger,42507,393822,2022-04-05
CASH_OUT,380233,Pierre Roger,393822,13589,Agence_mtn_Abomey,300000,-80233,2022-04-06
CASH_IN,91641,Agence_mtn_Ouidah,300000,208359,Pierre Roger,13589,105230,2022-04-07
CASH_OUT,32998,Pierre Roger,105230,72232,Agence_mtn_Ouidah,300000,267002,2022-04-08
CASH_IN,145993,Agence_mtn_Ouidah,300000,154007,Pierre Roger,72232,218225,2022-04-09
TRANSFER,806006,Marine Chauvet-Potier,869600,63594,Pierre Roger,218225,1024231,2022-04-12
CASH_OUT,912493,Pierre Roger,1024231,111738,Agence_mtn_Cotonou,300000,-612493,2022-04-14
TRANSFER,414873,Simone Pineau,733900,319027,Pierre Roger,111738,526611,2022-04-16
CASH_OUT,63418,Pierre Roger,526611,463193,Agence_mtn_Cotonou,300000,236582,2022-04-18
TRANSFER,838299,Alfred du Lesage,1154700,316401,Pierre Roger,463193,1301492,2022-04-18
CASH_IN,52168,Agence_mtn_Cotonou,300000,247832,Pierre Roger,1301492,1353660,2022-04-19
CASH_OUT,662514,Pierre Roger,1353660,691146,Agence_mtn_Ouidah,300000,-362514,2022-04-20
TRANSFER,610937,Pierre Roger,691146,80209,Frédéric Couturier,59377,-551560,2022-04-20
TRANSFER,6929,Pierre Roger,80209,73280,Émilie Moulin,514000,507071,2022-04-21
CASH_OUT,51352,Pierre Roger,73280,21928,Agence_mtn_Abomey,300000,248648,2022-04-22
CASH_IN,95130,Agence_mtn_Abomey,300000,204870,Pierre Roger,21928,117058,2022-04-22
CASH_OUT,102424,Pierre Roger,117058,14634,Agence_mtn_Abomey,300000,197576,2022-04-22
CASH_OUT,14419,Pierre Roger,14634,215,Agence_mtn_Abomey,300000,285581,2022-04-24
TRANSFER,403369,Émilie Moulin,507071,103702,Pierre Roger,215,403584,2022-04-27
CASH_IN,365,Agence_mtn_Abomey,300000,299635,Pierre Roger,403584,403949,2022-04-27
CASH_IN,32172,Agence_mtn_Cotonou,300000,267828,Eugène Poulain,285163,317335,2022-04-03
TRANSFER,351797,Franck-Charles Texier,1495600,1143803,Eugène Poulain,317335,669132,2022-04-03
CASH_IN,40193,Agence_mtn_Abomey,300000,259807,Eugène Poulain,669132,709325,2022-04-03
CASH_OUT,54538,Eugène Poulain,709325,654787,Agence_mtn_Abomey,300000,245462,2022-04-04
CASH_IN,294469,Agence_mtn_Cotonou,300000,5531,Eugène Poulain,654787,949256,2022-04-04
TRANSFER,880062,Eugène Poulain,949256,69194,Isabelle Rossi,1085978,205916,2022-04-04
CASH_IN,95659,Agence_mtn_Abomey,300000,204341,Eugène Poulain,69194,164853,2022-04-05
TRANSFER,138532,Eugène Poulain,164853,26321,Alix Maillet,109519,-29013,2022-04-08
CASH_IN,174718,Agence_mtn_Ouidah,300000,125282,Eugène Poulain,26321,201039,2022-04-09
TRANSFER,501927,Jean Benard,1602976,1101049,Eugène Poulain,201039,702966,2022-04-11
CASH_OUT,86523,Eugène Poulain,702966,616443,Agence_mtn_Abomey,300000,213477,2022-04-11
CASH_OUT,445484,Eugène Poulain,616443,170959,Agence_mtn_Ouidah,300000,-145484,2022-04-12
TRANSFER,1184315,Marcelle Paris,1445800,261485,Eugène Poulain,170959,1355274,2022-04-12
CASH_OUT,1157288,Eugène Poulain,1355274,197986,Agence_mtn_Ouidah,300000,-857288,2022-04-13
CASH_OUT,94568,Eugène Poulain,197986,103418,Agence_mtn_Cotonou,300000,205432,2022-04-14
CASH_OUT,5017,Eugène Poulain,103418,98401,Agence_mtn_Ouidah,300000,294983,2022-04-17
CASH_IN,9352,Agence_mtn_Cotonou,300000,290648,Eugène Poulain,98401,107753,2022-04-18
CASH_OUT,13732,Eugène Poulain,107753,94021,Agence_mtn_Ouidah,300000,286268,2022-04-20
TRANSFER,46395,Louise Girard,209236,162841,Eugène Poulain,94021,140416,2022-04-20
CASH_IN,54120,Agence_mtn_Abomey,300000,245880,Eugène Poulain,140416,194536,2022-04-21
CASH_OUT,154214,Eugène Poulain,194536,40322,Agence_mtn_Cotonou,300000,145786,2022-04-21
CASH_OUT,24334,Eugène Poulain,40322,15988,Agence_mtn_Ouidah,300000,275666,2022-04-22
TRANSFER,3316,Eugène Poulain,15988,12672,Louise Girard,162841,159525,2022-04-22
TRANSFER,369416,Laurent-Bertrand Lefort,720000,350584,Eugène Poulain,12672,382088,2022-04-22
CASH_IN,51009,Agence_mtn_Cotonou,300000,248991,Eugène Poulain,382088,433097,2022-04-22
CASH_IN,9723,Agence_mtn_Ouidah,300000,290277,Eugène Poulain,433097,442820,2022-04-24
TRANSFER,110121,Sébastien Lemaître,1037488,927367,Eugène Poulain,442820,552941,2022-04-24
CASH_IN,184322,Agence_mtn_Ouidah,300000,115678,Eugène Poulain,552941,737263,2022-04-24
CASH_IN,107634,Agence_mtn_Cotonou,300000,192366,Eugène Poulain,737263,844897,2022-04-27
TRANSFER,131812,Eugène Poulain,844897,713085,Jean Benard,1101049,969237,2022-04-27
CASH_OUT,781808,Franck-Charles Texier,1143803,361995,Agence_mtn_Cotonou,300000,-481808,2022-04-01
CASH_IN,68601,Agence_mtn_Abomey,300000,231399,Franck-Charles Texier,361995,430596,2022-04-03
CASH_OUT,319772,Franck-Charles Texier,430596,110824,Agence_mtn_Cotonou,300000,-19772,2022-04-03
TRANSFER,584922,Vincent Fournier,634600,49678,Franck-Charles Texier,110824,695746,2022-04-04
TRANSFER,3172,Franck-Charles Texier,695746,692574,Margot Renaud,530600,527428,2022-04-04
CASH_IN,80552,Agence_mtn_Cotonou,300000,219448,Franck-Charles Texier,692574,773126,2022-04-04
TRANSFER,552427,Franck-Charles Texier,773126,220699,Franck-Charles Texier,773126,220699,2022-04-04
CASH_OUT,139231,Franck-Charles Texier,220699,81468,Agence_mtn_Ouidah,300000,160769,2022-04-06
CASH_IN,144476,Agence_mtn_Abomey,300000,155524,Franck-Charles Texier,81468,225944,2022-04-07
CASH_OUT,93188,Franck-Charles Texier,225944,132756,Agence_mtn_Abomey,300000,206812,2022-04-09
CASH_IN,131480,Agence_mtn_Cotonou,300000,168520,Franck-Charles Texier,132756,264236,2022-04-10
CASH_OUT,162863,Franck-Charles Texier,264236,101373,Agence_mtn_Cotonou,300000,137137,2022-04-11
CASH_IN,284565,Agence_mtn_Cotonou,300000,15435,Franck-Charles Texier,101373,385938,2022-04-13
CASH_IN,169757,Agence_mtn_Ouidah,300000,130243,Franck-Charles Texier,385938,555695,2022-04-18
CASH_IN,180325,Agence_mtn_Cotonou,300000,119675,Franck-Charles Texier,555695,736020,2022-04-18
TRANSFER,170345,Isabelle Rossi,205916,35571,Franck-Charles Texier,736020,906365,2022-04-19
CASH_IN,162788,Agence_mtn_Cotonou,300000,137212,Franck-Charles Texier,906365,1069153,2022-04-19
CASH_OUT,612893,Franck-Charles Texier,1069153,456260,Agence_mtn_Ouidah,300000,-312893,2022-04-20
TRANSFER,227316,Franck-Charles Texier,456260,228944,Cécile Germain,1683990,1456674,2022-04-24
TRANSFER,67193,Franck-Charles Texier,228944,161751,Xavier de Lebreton,243714,176521,2022-04-24
CASH_OUT,125894,Franck-Charles Texier,161751,35857,Agence_mtn_Ouidah,300000,174106,2022-04-27
CASH_IN,98990,Agence_mtn_Ouidah,300000,201010,Franck-Charles Texier,35857,134847,2022-04-27
CASH_OUT,329045,Laurent-Bertrand Lefort,350584,21539,Agence_mtn_Abomey,300000,-29045,2022-04-02
CASH_IN,148820,Agence_mtn_Abomey,300000,151180,Laurent-Bertrand Lefort,21539,170359,2022-04-02
TRANSFER,264450,Raymond Marchal de Nguyen,273704,9254,Laurent-Bertrand Lefort,170359,434809,2022-04-03
CASH_IN,188959,Agence_mtn_Abomey,300000,111041,Laurent-Bertrand Lefort,434809,623768,2022-04-03
TRANSFER,228957,Laurent-Bertrand Lefort,623768,394811,Cécile Delattre-Arnaud,27500,-201457,2022-04-03
CASH_IN,5212,Agence_mtn_Abomey,300000,294788,Laurent-Bertrand Lefort,394811,400023,2022-04-03
CASH_IN,92384,Agence_mtn_Cotonou,300000,207616,Laurent-Bertrand Lefort,400023,492407,2022-04-04
CASH_OUT,38048,Laurent-Bertrand Lefort,492407,454359,Agence_mtn_Cotonou,300000,261952,2022-04-04
CASH_IN,97677,Agence_mtn_Cotonou,300000,202323,Laurent-Bertrand Lefort,454359,552036,2022-04-07
TRANSFER,285493,Laurent-Bertrand Lefort,552036,266543,Marcelle Paris,261485,-24008,2022-04-07
TRANSFER,158916,Laurent-Bertrand Lefort,266543,107627,Thérèse-Margaux Bruneau,20885,-138031,2022-04-08
TRANSFER,509231,Raymond Rossi,1860800,1351569,Laurent-Bertrand Lefort,107627,616858,2022-04-11
CASH_OUT,257680,Laurent-Bertrand Lefort,616858,359178,Agence_mtn_Cotonou,300000,42320,2022-04-12
CASH_OUT,201118,Laurent-Bertrand Lefort,359178,158060,Agence_mtn_Ouidah,300000,98882,2022-04-12
CASH_IN,279170,Agence_mtn_Ouidah,300000,20830,Laurent-Bertrand Lefort,158060,437230,2022-04-14
CASH_OUT,413192,Laurent-Bertrand Lefort,437230,24038,Agence_mtn_Cotonou,300000,-113192,2022-04-15
TRANSFER,598820,Cécile Clerc,996882,398062,Laurent-Bertrand Lefort,24038,622858,2022-04-16
TRANSFER,178639,Laurent-Bertrand Lefort,622858,444219,Alfred du Lesage,316401,137762,2022-04-18
CASH_OUT,391265,Laurent-Bertrand Lefort,444219,52954,Agence_mtn_Abomey,300000,-91265,2022-04-19
CASH_OUT,22605,Laurent-Bertrand Lefort,52954,30349,Agence_mtn_Ouidah,300000,277395,2022-04-20
CASH_IN,1202,Agence_mtn_Cotonou,300000,298798,Laurent-Bertrand Lefort,30349,31551,2022-04-22
CASH_IN,85210,Agence_mtn_Abomey,300000,214790,Laurent-Bertrand Lefort,31551,116761,2022-04-23
CASH_IN,278795,Agence_mtn_Ouidah,300000,21205,Laurent-Bertrand Lefort,116761,395556,2022-04-24
TRANSFER,310204,Laurent-Bertrand Lefort,395556,85352,Nathalie Pages,594575,284371,2022-04-24
CASH_IN,220449,Agence_mtn_Ouidah,300000,79551,Laurent-Bertrand Lefort,85352,305801,2022-04-27
CASH_OUT,222268,Laurent-Bertrand Lefort,305801,83533,Agence_mtn_Abomey,300000,77732,2022-04-27
CASH_OUT,1505670,Alphonse Le Olivier,1551300,45630,Agence_mtn_Ouidah,300000,-1205670,2022-04-02
TRANSFER,488323,Adèle Labbé,1211200,722877,Alphonse Le Olivier,45630,533953,2022-04-02
TRANSFER,316800,Simone Pineau,319027,2227,Alphonse Le Olivier,533953,850753,2022-04-02
TRANSFER,638783,Alphonse Le Olivier,850753,211970,Astrid Gay de la Brunet,574019,-64764,2022-04-02
CASH_OUT,78392,Alphonse Le Olivier,211970,133578,Agence_mtn_Abomey,300000,221608,2022-04-03
CASH_IN,197849,Agence_mtn_Ouidah,300000,102151,Alphonse Le Olivier,133578,331427,2022-04-03
TRANSFER,170662,Alphonse Le Olivier,331427,160765,Xavier de Lebreton,176521,5859,2022-04-06
CASH_IN,223289,Agence_mtn_Abomey,300000,76711,Alphonse Le Olivier,160765,384054,2022-04-08
TRANSFER,7148,Alphonse Le Olivier,384054,376906,Valérie Dijoux,123994,116846,2022-04-12
CASH_OUT,58045,Alphonse Le Olivier,376906,318861,Agence_mtn_Abomey,300000,241955,2022-04-12
CASH_OUT,38623,Alphonse Le Olivier,318861,280238,Agence_mtn_Abomey,300000,261377,2022-04-13
CASH_IN,5752,Agence_mtn_Cotonou,300000,294248,Alphonse Le Olivier,280238,285990,2022-04-14
TRANSFER,159914,Étienne Roche,639200,479286,Alphonse Le Olivier,285990,445904,2022-04-15
TRANSFER,159886,Alphonse Le Olivier,445904,286018,Simone Pineau,2227,-157659,2022-04-15
TRANSFER,57034,Nathalie Peron,276598,219564,Alphonse Le Olivier,286018,343052,2022-04-15
CASH_IN,27014,Agence_mtn_Ouidah,300000,272986,Alphonse Le Olivier,343052,370066,2022-04-16
TRANSFER,3707,Vincent Fournier,49678,45971,Alphonse Le Olivier,370066,373773,2022-04-16
CASH_OUT,61225,Alphonse Le Olivier,373773,312548,Agence_mtn_Ouidah,300000,238775,2022-04-17
CASH_IN,41352,Agence_mtn_Abomey,300000,258648,Alphonse Le Olivier,312548,353900,2022-04-17
TRANSFER,3373,Inès Hamon,5711,2338,Alphonse Le Olivier,353900,357273,2022-04-18
CASH_IN,166228,Agence_mtn_Ouidah,300000,133772,Alphonse Le Olivier,357273,523501,2022-04-20
CASH_IN,225328,Agence_mtn_Cotonou,300000,74672,Alphonse Le Olivier,523501,748829,2022-04-21
CASH_IN,81077,Agence_mtn_Cotonou,300000,218923,Alphonse Le Olivier,748829,829906,2022-04-23
CASH_OUT,46812,Alphonse Le Olivier,829906,783094,Agence_mtn_Abomey,300000,253188,2022-04-24
TRANSFER,360120,Alphonse Le Olivier,783094,422974,Rémy Le Michaud,553736,193616,2022-04-25
CASH_OUT,164640,Alphonse Le Olivier,422974,258334,Agence_mtn_Ouidah,300000,135360,2022-04-25
CASH_OUT,121006,Alphonse Le Olivier,258334,137328,Agence_mtn_Cotonou,300000,178994,2022-04-25
TRANSFER,131310,Alphonse Le Olivier,137328,6018,Philippine Courtois,271891,140581,2022-04-26
CASH_IN,196123,Agence_mtn_Ouidah,300000,103877,Raymond Marchal de Nguyen,9254,205377,2022-04-02
TRANSFER,77311,Renée David,248463,171152,Raymond Marchal de Nguyen,205377,282688,2022-04-02
CASH_IN,36747,Agence_mtn_Cotonou,300000,263253,Raymond Marchal de Nguyen,282688,319435,2022-04-02
CASH_IN,42404,Agence_mtn_Ouidah,300000,257596,Raymond Marchal de Nguyen,319435,361839,2022-04-04
CASH_IN,262966,Agence_mtn_Ouidah,300000,37034,Raymond Marchal de Nguyen,361839,624805,2022-04-06
CASH_IN,211500,Agence_mtn_Abomey,300000,88500,Raymond Marchal de Nguyen,624805,836305,2022-04-07
CASH_IN,82109,Agence_mtn_Cotonou,300000,217891,Raymond Marchal de Nguyen,836305,918414,2022-04-07
CASH_IN,154236,Agence_mtn_Ouidah,300000,145764,Raymond Marchal de Nguyen,918414,1072650,2022-04-08
TRANSFER,127443,Renée David,171152,43709,Raymond Marchal de Nguyen,1072650,1200093,2022-04-10
CASH_OUT,62434,Raymond Marchal de Nguyen,1200093,1137659,Agence_mtn_Ouidah,300000,237566,2022-04-15
CASH_OUT,1078277,Raymond Marchal de Nguyen,1137659,59382,Agence_mtn_Abomey,300000,-778277,2022-04-15
TRANSFER,18950,Renée David,43709,24759,Raymond Marchal de Nguyen,59382,78332,2022-04-15
CASH_OUT,35136,Raymond Marchal de Nguyen,78332,43196,Agence_mtn_Ouidah,300000,264864,2022-04-16
CASH_IN,83428,Agence_mtn_Ouidah,300000,216572,Raymond Marchal de Nguyen,43196,126624,2022-04-16
TRANSFER,321508,Cécile Clerc,398062,76554,Raymond Marchal de Nguyen,126624,448132,2022-04-16
CASH_OUT,362331,Raymond Marchal de Nguyen,448132,85801,Agence_mtn_Abomey,300000,-62331,2022-04-18
TRANSFER,13041,Raymond Marchal de Nguyen,85801,72760,Vincent Fournier,45971,32930,2022-04-18
TRANSFER,72582,Raymond Marchal de Nguyen,72760,178,Bertrand Le Roux,66266,-6316,2022-04-20
CASH_OUT,108,Raymond Marchal de Nguyen,178,70,Agence_mtn_Cotonou,300000,299892,2022-04-22
CASH_IN,151465,Agence_mtn_Abomey,300000,148535,Raymond Marchal de Nguyen,70,151535,2022-04-23
CASH_IN,134526,Agence_mtn_Cotonou,300000,165474,Raymond Marchal de Nguyen,151535,286061,2022-04-24
TRANSFER,27611,Valérie Dijoux,116846,89235,Raymond Marchal de Nguyen,286061,313672,2022-04-25
TRANSFER,5967,Isabelle Rossi,35571,29604,Raymond Marchal de Nguyen,313672,319639,2022-04-25
CASH_IN,4416,Agence_mtn_Ouidah,300000,295584,Raymond Marchal de Nguyen,319639,324055,2022-04-26
CASH_OUT,19195,Raymond Marchal de Nguyen,324055,304860,Agence_mtn_Ouidah,300000,280805,2022-04-27
CASH_IN,299677,Agence_mtn_Ouidah,300000,323,Raymond Marchal de Nguyen,304860,604537,2022-04-27
CASH_IN,257405,Agence_mtn_Cotonou,300000,42595,David du Blondel,-84078,173327,2022-04-01
CASH_OUT,143956,David du Blondel,173327,29371,Agence_mtn_Ouidah,300000,156044,2022-04-01
TRANSFER,206347,Roland Garcia,565163,358816,David du Blondel,29371,235718,2022-04-01
CASH_IN,277100,Agence_mtn_Abomey,300000,22900,David du Blondel,235718,512818,2022-04-02
CASH_IN,158124,Agence_mtn_Ouidah,300000,141876,David du Blondel,512818,670942,2022-04-05
CASH_OUT,534028,David du Blondel,670942,136914,Agence_mtn_Cotonou,300000,-234028,2022-04-06
TRANSFER,136073,David du Blondel,136914,841,Thibault Moreno,1509800,1373727,2022-04-09
CASH_OUT,249,David du Blondel,841,592,Agence_mtn_Abomey,300000,299751,2022-04-13
TRANSFER,187,David du Blondel,592,405,Raymond Rossi,1351569,1351382,2022-04-13
CASH_OUT,194,David du Blondel,405,211,Agence_mtn_Cotonou,300000,299806,2022-04-14
TRANSFER,130,David du Blondel,211,81,Thibaut Coulon,541600,541470,2022-04-16
CASH_IN,234555,Agence_mtn_Ouidah,300000,65445,David du Blondel,81,234636,2022-04-16
TRANSFER,42730,David du Blondel,234636,191906,Joséphine Gros,1166600,1123870,2022-04-16
CASH_IN,67706,Agence_mtn_Ouidah,300000,232294,David du Blondel,191906,259612,2022-04-20
TRANSFER,105471,David du Blondel,259612,154141,Thibaut Coulon,541470,435999,2022-04-20
CASH_IN,117922,Agence_mtn_Ouidah,300000,182078,David du Blondel,154141,272063,2022-04-20
TRANSFER,71992,David du Blondel,272063,200071,Inès Hamon,2338,-69654,2022-04-23
CASH_IN,2899,Agence_mtn_Ouidah,300000,297101,David du Blondel,200071,202970,2022-04-24
CASH_OUT,104841,David du Blondel,202970,98129,Agence_mtn_Cotonou,300000,195159,2022-04-24
TRANSFER,3017,Xavier de Lebreton,5859,2842,David du Blondel,98129,101146,2022-04-25
CASH_OUT,53236,David du Blondel,101146,47910,Agence_mtn_Abomey,300000,246764,2022-04-26
CASH_IN,17250,Agence_mtn_Cotonou,300000,282750,Marcelle Paris,-24008,-6758,2022-04-01
CASH_IN,6339,Agence_mtn_Cotonou,300000,293661,Marcelle Paris,-6758,-419,2022-04-01
CASH_IN,66450,Agence_mtn_Cotonou,300000,233550,Marcelle Paris,-419,66031,2022-04-01
CASH_OUT,62931,Marcelle Paris,66031,3100,Agence_mtn_Ouidah,300000,237069,2022-04-01
CASH_OUT,1716,Marcelle Paris,3100,1384,Agence_mtn_Abomey,300000,298284,2022-04-01
CASH_IN,112696,Agence_mtn_Cotonou,300000,187304,Marcelle Paris,1384,114080,2022-04-01
CASH_OUT,6490,Marcelle Paris,114080,107590,Agence_mtn_Ouidah,300000,293510,2022-04-03
CASH_OUT,70924,Marcelle Paris,107590,36666,Agence_mtn_Ouidah,300000,229076,2022-04-04
TRANSFER,8715,Marcelle Paris,36666,27951,Valentine Martinez,1371378,1362663,2022-04-05
CASH_OUT,5010,Marcelle Paris,27951,22941,Agence_mtn_Cotonou,300000,294990,2022-04-06
TRANSFER,172291,Nathalie Pages,284371,112080,Marcelle Paris,22941,195232,2022-04-06
CASH_OUT,62675,Marcelle Paris,195232,132557,Agence_mtn_Abomey,300000,237325,2022-04-06
CASH_OUT,34002,Marcelle Paris,132557,98555,Agence_mtn_Ouidah,300000,265998,2022-04-08
CASH_OUT,49655,Marcelle Paris,98555,48900,Agence_mtn_Cotonou,300000,250345,2022-04-09
CASH_IN,76892,Agence_mtn_Ouidah,300000,223108,Marcelle Paris,48900,125792,2022-04-11
CASH_OUT,21784,Marcelle Paris,125792,104008,Agence_mtn_Cotonou,300000,278216,2022-04-15
TRANSFER,74961,Alfred du Lesage,137762,62801,Marcelle Paris,104008,178969,2022-04-16
CASH_OUT,78442,Marcelle Paris,178969,100527,Agence_mtn_Abomey,300000,221558,2022-04-16
CASH_IN,151428,Agence_mtn_Abomey,300000,148572,Marcelle Paris,100527,251955,2022-04-17
CASH_IN,148278,Agence_mtn_Abomey,300000,151722,Marcelle Paris,251955,400233,2022-04-19
CASH_OUT,157496,Marcelle Paris,400233,242737,Agence_mtn_Ouidah,300000,142504,2022-04-19
TRANSFER,41873,Marcelle Paris,242737,200864,Roland Garcia,358816,316943,2022-04-20
TRANSFER,1460960,Pierre Reynaud,1622500,161540,Marcelle Paris,200864,1661824,2022-04-21
TRANSFER,1268095,Marcelle Paris,1661824,393729,Raymond Rossi,1351382,83287,2022-04-24
CASH_OUT,85714,Marcelle Paris,393729,308015,Agence_mtn_Abomey,300000,214286,2022-04-24
CASH_IN,269334,Agence_mtn_Cotonou,300000,30666,Marcelle Paris,308015,577349,2022-04-26
CASH_IN,245257,Agence_mtn_Cotonou,300000,54743,Cécile Germain,1456674,1701931,2022-04-03
CASH_OUT,805718,Cécile Germain,1701931,896213,Agence_mtn_Abomey,300000,-505718,2022-04-05
CASH_IN,199950,Agence_mtn_Cotonou,300000,100050,Cécile Germain,896213,1096163,2022-04-07
CASH_IN,121960,Agence_mtn_Cotonou,300000,178040,Cécile Germain,1096163,1218123,2022-04-07
CASH_OUT,256694,Cécile Germain,1218123,961429,Agence_mtn_Cotonou,300000,43306,2022-04-09
CASH_OUT,202991,Cécile Germain,961429,758438,Agence_mtn_Abomey,300000,97009,2022-04-09
TRANSFER,360764,Cécile Germain,758438,397674,Margot Renaud,527428,166664,2022-04-09
CASH_IN,229588,Agence_mtn_Cotonou,300000,70412,Cécile Germain,397674,627262,2022-04-09
CASH_IN,44805,Agence_mtn_Ouidah,300000,255195,Cécile Germain,627262,672067,2022-04-09
CASH_IN,281209,Agence_mtn_Ouidah,300000,18791,Cécile Germain,672067,953276,2022-04-09
TRANSFER,447324,Cécile Germain,953276,505952,William Lebrun,796241,348917,2022-04-09
CASH_OUT,38704,Cécile Germain,505952,467248,Agence_mtn_Abomey,300000,261296,2022-04-10
CASH_IN,249042,Agence_mtn_Ouidah,300000,50958,Cécile Germain,467248,716290,2022-04-10
CASH_IN,61714,Agence_mtn_Abomey,300000,238286,Cécile Germain,716290,778004,2022-04-10
CASH_IN,214454,Agence_mtn_Cotonou,300000,85546,Cécile Germain,778004,992458,2022-04-11
CASH_IN,151203,Agence_mtn_Cotonou,300000,148797,Cécile Germain,992458,1143661,2022-04-11
TRANSFER,935651,Cécile Germain,1143661,208010,Marine Chauvet-Potier,63594,-872057,2022-04-14
CASH_OUT,191418,Cécile Germain,208010,16592,Agence_mtn_Cotonou,300000,108582,2022-04-14
CASH_IN,34698,Agence_mtn_Abomey,300000,265302,Cécile Germain,16592,51290,2022-04-15
CASH_IN,155467,Agence_mtn_Abomey,300000,144533,Cécile Germain,51290,206757,2022-04-16
CASH_OUT,1036,Cécile Germain,206757,205721,Agence_mtn_Cotonou,300000,298964,2022-04-16
TRANSFER,108241,Cécile Germain,205721,97480,Gabriel Humbert,42698,-65543,2022-04-16
TRANSFER,2535,Xavier de Lebreton,2842,307,Cécile Germain,97480,100015,2022-04-16
CASH_IN,116894,Agence_mtn_Cotonou,300000,183106,Cécile Germain,100015,216909,2022-04-19
CASH_OUT,213478,Cécile Germain,216909,3431,Agence_mtn_Abomey,300000,86522,2022-04-22
CASH_IN,236065,Agence_mtn_Ouidah,300000,63935,Cécile Germain,3431,239496,2022-04-23
CASH_IN,251860,Agence_mtn_Cotonou,300000,48140,Cécile Germain,239496,491356,2022-04-23
CASH_IN,53251,Agence_mtn_Cotonou,300000,246749,Frédéric Couturier,-551560,-498309,2022-04-03
CASH_IN,158966,Agence_mtn_Cotonou,300000,141034,Frédéric Couturier,-498309,-339343,2022-04-04
CASH_IN,257837,Agence_mtn_Ouidah,300000,42163,Frédéric Couturier,-339343,-81506,2022-04-05
CASH_IN,114425,Agence_mtn_Cotonou,300000,185575,Frédéric Couturier,-81506,32919,2022-04-06
TRANSFER,326089,Alphonse Leclercq-Rousseau,553600,227511,Frédéric Couturier,32919,359008,2022-04-06
CASH_IN,126721,Agence_mtn_Ouidah,300000,173279,Frédéric Couturier,359008,485729,2022-04-07
CASH_OUT,221575,Frédéric Couturier,485729,264154,Agence_mtn_Cotonou,300000,78425,2022-04-08
TRANSFER,143708,Frédéric Couturier,264154,120446,Valentine Martinez,1362663,1218955,2022-04-08
CASH_IN,173687,Agence_mtn_Abomey,300000,126313,Frédéric Couturier,120446,294133,2022-04-09
CASH_IN,280592,Agence_mtn_Ouidah,300000,19408,Frédéric Couturier,294133,574725,2022-04-09
CASH_IN,121315,Agence_mtn_Cotonou,300000,178685,Frédéric Couturier,574725,696040,2022-04-11
CASH_IN,242714,Agence_mtn_Cotonou,300000,57286,Frédéric Couturier,696040,938754,2022-04-12
CASH_IN,264944,Agence_mtn_Ouidah,300000,35056,Frédéric Couturier,938754,1203698,2022-04-13
CASH_OUT,1116135,Frédéric Couturier,1203698,87563,Agence_mtn_Abomey,300000,-816135,2022-04-13
TRANSFER,377253,Geneviève De Oliveira-Michel,509500,132247,Frédéric Couturier,87563,464816,2022-04-13
TRANSFER,280394,Frédéric Couturier,464816,184422,Richard Le Descamps,1117900,837506,2022-04-14
TRANSFER,94780,Thibaut Coulon,435999,341219,Frédéric Couturier,184422,279202,2022-04-14
CASH_OUT,27016,Frédéric Couturier,279202,252186,Agence_mtn_Cotonou,300000,272984,2022-04-14
CASH_IN,174155,Agence_mtn_Abomey,300000,125845,Frédéric Couturier,252186,426341,2022-04-15
CASH_IN,156831,Agence_mtn_Cotonou,300000,143169,Frédéric Couturier,426341,583172,2022-04-19
CASH_OUT,505833,Frédéric Couturier,583172,77339,Agence_mtn_Cotonou,300000,-205833,2022-04-20
CASH_IN,23887,Agence_mtn_Cotonou,300000,276113,Frédéric Couturier,77339,101226,2022-04-20
TRANSFER,95311,Frédéric Couturier,101226,5915,Thibault Moreno,1373727,1278416,2022-04-22
TRANSFER,13506,Cécile Clerc,76554,63048,Frédéric Couturier,5915,19421,2022-04-23
CASH_OUT,8691,Frédéric Couturier,19421,10730,Agence_mtn_Cotonou,300000,291309,2022-04-24
CASH_IN,104661,Agence_mtn_Ouidah,300000,195339,Frédéric Couturier,10730,115391,2022-04-25
TRANSFER,97956,Philippine Courtois,140581,42625,Frédéric Couturier,115391,213347,2022-04-26
TRANSFER,149356,Frédéric Couturier,213347,63991,Vincent Fournier,32930,-116426,2022-04-26
CASH_IN,114704,Agence_mtn_Ouidah,300000,185296,Frédéric Couturier,63991,178695,2022-04-27
CASH_IN,240716,Agence_mtn_Abomey,300000,59284,Caroline-Lorraine Humbert,187715,428431,2022-04-04
TRANSFER,93427,Caroline-Lorraine Humbert,428431,335004,François Michel-Legros,454493,361066,2022-04-04
CASH_OUT,248536,Caroline-Lorraine Humbert,335004,86468,Agence_mtn_Abomey,300000,51464,2022-04-07
TRANSFER,60385,Caroline-Lorraine Humbert,86468,26083,Louise Girard,159525,99140,2022-04-08
TRANSFER,32984,Émilie Moulin,103702,70718,Caroline-Lorraine Humbert,26083,59067,2022-04-09
TRANSFER,44289,Caroline-Lorraine Humbert,59067,14778,Isabelle Rossi,29604,-14685,2022-04-10
CASH_IN,75951,Agence_mtn_Abomey,300000,224049,Caroline-Lorraine Humbert,14778,90729,2022-04-10
CASH_IN,30994,Agence_mtn_Cotonou,300000,269006,Caroline-Lorraine Humbert,90729,121723,2022-04-11
CASH_IN,50890,Agence_mtn_Abomey,300000,249110,Caroline-Lorraine Humbert,121723,172613,2022-04-11
TRANSFER,52281,Louis Pichon,569900,517619,Caroline-Lorraine Humbert,172613,224894,2022-04-14
TRANSFER,222860,Caroline-Lorraine Humbert,224894,2034,Émilie Moulin,70718,-152142,2022-04-14
CASH_OUT,1861,Caroline-Lorraine Humbert,2034,173,Agence_mtn_Abomey,300000,298139,2022-04-15
TRANSFER,160781,Rémy Le Michaud,193616,32835,Caroline-Lorraine Humbert,173,160954,2022-04-17
TRANSFER,24579,Alfred du Lesage,62801,38222,Caroline-Lorraine Humbert,160954,185533,2022-04-17
CASH_IN,71282,Agence_mtn_Abomey,300000,228718,Caroline-Lorraine Humbert,185533,256815,2022-04-19
TRANSFER,160350,Caroline-Lorraine Humbert,256815,96465,Adèle Labbé,722877,562527,2022-04-19
CASH_IN,222322,Agence_mtn_Abomey,300000,77678,Caroline-Lorraine Humbert,96465,318787,2022-04-23
CASH_IN,193254,Agence_mtn_Ouidah,300000,106746,Caroline-Lorraine Humbert,318787,512041,2022-04-24
CASH_IN,34635,Agence_mtn_Ouidah,300000,265365,Caroline-Lorraine Humbert,512041,546676,2022-04-25
CASH_IN,236028,Agence_mtn_Abomey,300000,63972,Caroline-Lorraine Humbert,546676,782704,2022-04-25
TRANSFER,32735,Louis Pichon,517619,484884,Caroline-Lorraine Humbert,782704,815439,2022-04-26
CASH_OUT,196709,Caroline-Lorraine Humbert,815439,618730,Agence_mtn_Abomey,300000,103291,2022-04-27
CASH_IN,218169,Agence_mtn_Cotonou,300000,81831,Caroline-Lorraine Humbert,618730,836899,2022-04-27
CASH_OUT,147100,Pierre Reynaud,161540,14440,Agence_mtn_Cotonou,300000,152900,2022-04-02
CASH_OUT,8054,Pierre Reynaud,14440,6386,Agence_mtn_Ouidah,300000,291946,2022-04-03
TRANSFER,6064,Pierre Reynaud,6386,322,Alphonse Leclercq-Rousseau,227511,221447,2022-04-04
TRANSFER,306,Pierre Reynaud,322,16,Thibaut Coulon,341219,340913,2022-04-05
CASH_IN,97131,Agence_mtn_Ouidah,300000,202869,Pierre Reynaud,16,97147,2022-04-05
CASH_OUT,96408,Pierre Reynaud,97147,739,Agence_mtn_Abomey,300000,203592,2022-04-10
CASH_IN,258310,Agence_mtn_Ouidah,300000,41690,Pierre Reynaud,739,259049,2022-04-10
CASH_IN,241052,Agence_mtn_Ouidah,300000,58948,Pierre Reynaud,259049,500101,2022-04-13
CASH_OUT,254432,Pierre Reynaud,500101,245669,Agence_mtn_Ouidah,300000,45568,2022-04-14
CASH_OUT,18181,Pierre Reynaud,245669,227488,Agence_mtn_Cotonou,300000,281819,2022-04-15
TRANSFER,18844,Pierre Reynaud,227488,208644,Thibaut Coulon,340913,322069,2022-04-17
CASH_OUT,182486,Pierre Reynaud,208644,26158,Agence_mtn_Ouidah,300000,117514,2022-04-17
CASH_IN,109426,Agence_mtn_Ouidah,300000,190574,Pierre Reynaud,26158,135584,2022-04-18
CASH_OUT,16438,Pierre Reynaud,135584,119146,Agence_mtn_Abomey,300000,283562,2022-04-18
CASH_IN,8262,Agence_mtn_Ouidah,300000,291738,Pierre Reynaud,119146,127408,2022-04-20
CASH_IN,26556,Agence_mtn_Ouidah,300000,273444,Pierre Reynaud,127408,153964,2022-04-21
CASH_OUT,97372,Pierre Reynaud,153964,56592,Agence_mtn_Cotonou,300000,202628,2022-04-22
CASH_IN,12732,Agence_mtn_Ouidah,300000,287268,Pierre Reynaud,56592,69324,2022-04-23
TRANSFER,55562,Pierre Reynaud,69324,13762,Sébastien Lemaître,927367,871805,2022-04-24
CASH_OUT,3441,Pierre Reynaud,13762,10321,Agence_mtn_Ouidah,300000,296559,2022-04-25
CASH_IN,85939,Agence_mtn_Cotonou,300000,214061,Pierre Reynaud,10321,96260,2022-04-26
TRANSFER,885509,Emmanuelle Georges,905000,19491,Thibaut Coulon,322069,1207578,2022-04-02
CASH_IN,209366,Agence_mtn_Cotonou,300000,90634,Thibaut Coulon,1207578,1416944,2022-04-03
CASH_IN,224742,Agence_mtn_Ouidah,300000,75258,Thibaut Coulon,1416944,1641686,2022-04-03
TRANSFER,18047,Alfred du Lesage,38222,20175,Thibaut Coulon,1641686,1659733,2022-04-04
CASH_IN,76666,Agence_mtn_Ouidah,300000,223334,Thibaut Coulon,1659733,1736399,2022-04-04
TRANSFER,149903,Thibaut Coulon,1736399,1586496,Sébastien Lemaître,871805,721902,2022-04-05
CASH_OUT,1537184,Thibaut Coulon,1586496,49312,Agence_mtn_Ouidah,300000,-1237184,2022-04-05
CASH_IN,115538,Agence_mtn_Abomey,300000,184462,Thibaut Coulon,49312,164850,2022-04-09
CASH_IN,242230,Agence_mtn_Cotonou,300000,57770,Thibaut Coulon,164850,407080,2022-04-09
CASH_OUT,213283,Thibaut Coulon,407080,193797,Agence_mtn_Ouidah,300000,86717,2022-04-10
CASH_OUT,14939,Thibaut Coulon,193797,178858,Agence_mtn_Abomey,300000,285061,2022-04-12
CASH_IN,178862,Agence_mtn_Cotonou,300000,121138,Thibaut Coulon,178858,357720,2022-04-12
TRANSFER,23334,Renée David,24759,1425,Thibaut Coulon,357720,381054,2022-04-14
CASH_OUT,38416,Thibaut Coulon,381054,342638,Agence_mtn_Abomey,300000,261584,2022-04-15
CASH_OUT,307247,Thibaut Coulon,342638,35391,Agence_mtn_Ouidah,300000,-7247,2022-04-18
TRANSFER,680,Thierry Delattre-Simon,54000,53320,Thibaut Coulon,35391,36071,2022-04-21
CASH_IN,291392,Agence_mtn_Cotonou,300000,8608,Thibaut Coulon,36071,327463,2022-04-23
TRANSFER,248832,Thibaut Coulon,327463,78631,Adèle Labbé,562527,313695,2022-04-25
CASH_OUT,47515,Thibaut Coulon,78631,31116,Agence_mtn_Ouidah,300000,252485,2022-04-25
CASH_OUT,3370,Thibaut Coulon,31116,27746,Agence_mtn_Ouidah,300000,296630,2022-04-26
CASH_IN,269348,Agence_mtn_Cotonou,300000,30652,Thibaut Coulon,27746,297094,2022-04-26
TRANSFER,93259,Thibaut Coulon,297094,203835,Alphonse Leclercq-Rousseau,221447,128188,2022-04-27
CASH_IN,142871,Agence_mtn_Ouidah,300000,157129,Alix Maillet,-29013,113858,2022-04-01
CASH_IN,57342,Agence_mtn_Cotonou,300000,242658,Alix Maillet,113858,171200,2022-04-02
TRANSFER,79783,Alix Maillet,171200,91417,Alphonse Leclercq-Rousseau,128188,48405,2022-04-02
CASH_OUT,90698,Alix Maillet,91417,719,Agence_mtn_Cotonou,300000,209302,2022-04-03
TRANSFER,474,Alix Maillet,719,245,Sophie Gonzalez,1109500,1109026,2022-04-04
CASH_OUT,128,Alix Maillet,245,117,Agence_mtn_Cotonou,300000,299872,2022-04-04
CASH_OUT,113,Alix Maillet,117,4,Agence_mtn_Abomey,300000,299887,2022-04-05
CASH_IN,165110,Agence_mtn_Cotonou,300000,134890,Alix Maillet,4,165114,2022-04-06
CASH_IN,237418,Agence_mtn_Cotonou,300000,62582,Alix Maillet,165114,402532,2022-04-07
TRANSFER,222619,Alix Maillet,402532,179913,Roland Garcia,316943,94324,2022-04-08
CASH_OUT,112360,Alix Maillet,179913,67553,Agence_mtn_Cotonou,300000,187640,2022-04-08
TRANSFER,10612,Emmanuelle Georges,19491,8879,Alix Maillet,67553,78165,2022-04-10
CASH_OUT,21652,Alix Maillet,78165,56513,Agence_mtn_Abomey,300000,278348,2022-04-10
TRANSFER,913354,Thibault Moreno,1278416,365062,Alix Maillet,56513,969867,2022-04-12
CASH_OUT,747647,Alix Maillet,969867,222220,Agence_mtn_Cotonou,300000,-447647,2022-04-13
CASH_OUT,185372,Alix Maillet,222220,36848,Agence_mtn_Ouidah,300000,114628,2022-04-13
TRANSFER,193350,Louis Pichon,484884,291534,Alix Maillet,36848,230198,2022-04-14
TRANSFER,39784,Louise Girard,99140,59356,Alix Maillet,230198,269982,2022-04-15
TRANSFER,263778,Alix Maillet,269982,6204,Raymond Rossi,83287,-180491,2022-04-17
CASH_IN,24522,Agence_mtn_Cotonou,300000,275478,Alix Maillet,6204,30726,2022-04-19
TRANSFER,28686,Alix Maillet,30726,2040,Richard Le Descamps,837506,808820,2022-04-23
CASH_OUT,541,Alix Maillet,2040,1499,Agence_mtn_Ouidah,300000,299459,2022-04-24
CASH_OUT,1268,Alix Maillet,1499,231,Agence_mtn_Abomey,300000,298732,2022-04-26
CASH_IN,82920,Agence_mtn_Cotonou,300000,217080,Alix Maillet,231,83151,2022-04-26
TRANSFER,82977,Claude Foucher,143587,60610,Thierry Delattre-Simon,53320,-29657,2022-04-06
CASH_OUT,47613,Claude Foucher,60610,12997,Agence_mtn_Abomey,300000,252387,2022-04-06
CASH_IN,195432,Agence_mtn_Ouidah,300000,104568,Claude Foucher,12997,208429,2022-04-07
CASH_OUT,181672,Claude Foucher,208429,26757,Agence_mtn_Abomey,300000,118328,2022-04-09
TRANSFER,24036,Claude Foucher,26757,2721,Xavier de Lebreton,307,-23729,2022-04-11
CASH_IN,145353,Agence_mtn_Cotonou,300000,154647,Claude Foucher,2721,148074,2022-04-12
TRANSFER,98586,Claude Foucher,148074,49488,Alphonse Leclercq-Rousseau,48405,-50181,2022-04-13
CASH_IN,55149,Agence_mtn_Ouidah,300000,244851,Claude Foucher,49488,104637,2022-04-16
CASH_IN,293854,Agence_mtn_Ouidah,300000,6146,Claude Foucher,104637,398491,2022-04-17
TRANSFER,32665,Rémy Le Michaud,32835,170,Claude Foucher,398491,431156,2022-04-18
TRANSFER,332707,Claude Foucher,431156,98449,Emmanuelle Georges,8879,-323828,2022-04-23
TRANSFER,25334,Claude Foucher,98449,73115,Joséphine Gros,1123870,1098536,2022-04-25
TRANSFER,22181,Claude Foucher,73115,50934,Joséphine Gros,1098536,1076355,2022-04-26
CASH_OUT,50691,Claude Foucher,50934,243,Agence_mtn_Cotonou,300000,249309,2022-04-26
CASH_IN,56412,Agence_mtn_Ouidah,300000,243588,Claude Foucher,243,56655,2022-04-27
CASH_OUT,285343,François Michel-Legros,361066,75723,Agence_mtn_Cotonou,300000,14657,2022-04-01
TRANSFER,8610,François Michel-Legros,75723,67113,Étienne Roche,479286,470676,2022-04-09
CASH_IN,14236,Agence_mtn_Ouidah,300000,285764,François Michel-Legros,67113,81349,2022-04-11
TRANSFER,47942,François Michel-Legros,81349,33407,Louis Pichon,291534,243592,2022-04-14
TRANSFER,129691,Louis Pichon,243592,113901,François Michel-Legros,33407,163098,2022-04-17
CASH_IN,276882,Agence_mtn_Cotonou,300000,23118,François Michel-Legros,163098,439980,2022-04-19
TRANSFER,13937,Geneviève De Oliveira-Michel,132247,118310,François Michel-Legros,439980,453917,2022-04-23
TRANSFER,166576,François Michel-Legros,453917,287341,Gilbert-Charles Thibault,1252262,1085686,2022-04-24
TRANSFER,93422,François Michel-Legros,287341,193919,Renée David,1425,-91997,2022-04-26
TRANSFER,11583,Thibault Moreno,365062,353479,François Michel-Legros,193919,205502,2022-04-27
CASH_IN,66124,Agence_mtn_Abomey,300000,233876,Xavier Leblanc-Ferreira,-23999,42125,2022-04-04
CASH_OUT,4599,Xavier Leblanc-Ferreira,42125,37526,Agence_mtn_Ouidah,300000,295401,2022-04-08
TRANSFER,29798,Xavier Leblanc-Ferreira,37526,7728,Louis Pichon,113901,84103,2022-04-13
CASH_IN,76471,Agence_mtn_Abomey,300000,223529,Xavier Leblanc-Ferreira,7728,84199,2022-04-14
CASH_OUT,2614,Xavier Leblanc-Ferreira,84199,81585,Agence_mtn_Abomey,300000,297386,2022-04-14
CASH_IN,152352,Agence_mtn_Cotonou,300000,147648,Xavier Leblanc-Ferreira,81585,233937,2022-04-14
TRANSFER,536576,Jean Benard,969237,432661,Xavier Leblanc-Ferreira,233937,770513,2022-04-17
CASH_IN,275945,Agence_mtn_Ouidah,300000,24055,Xavier Leblanc-Ferreira,770513,1046458,2022-04-22
CASH_IN,228729,Agence_mtn_Ouidah,300000,71271,Xavier Leblanc-Ferreira,1046458,1275187,2022-04-23
CASH_IN,130609,Agence_mtn_Cotonou,300000,169391,Xavier Leblanc-Ferreira,1275187,1405796,2022-04-27
CASH_IN,133334,Agence_mtn_Ouidah,300000,166666,Benjamin Evrard-Marty,-186116,-52782,2022-04-02
CASH_IN,263761,Agence_mtn_Abomey,300000,36239,Benjamin Evrard-Marty,-52782,210979,2022-04-02
TRANSFER,971746,Valentine Martinez,1218955,247209,Benjamin Evrard-Marty,210979,1182725,2022-04-03
TRANSFER,967945,Benjamin Evrard-Marty,1182725,214780,Benjamin Evrard-Marty,1182725,2150670,2022-04-05
TRANSFER,32594,Jean Benard,432661,400067,Benjamin Evrard-Marty,214780,247374,2022-04-09
CASH_OUT,204171,Benjamin Evrard-Marty,247374,43203,Agence_mtn_Cotonou,300000,95829,2022-04-10
TRANSFER,1962,Benjamin Evrard-Marty,43203,41241,Sébastien Lemaître,721902,719940,2022-04-13
CASH_OUT,16084,Benjamin Evrard-Marty,41241,25157,Agence_mtn_Ouidah,300000,283916,2022-04-13
CASH_IN,125346,Agence_mtn_Abomey,300000,174654,Benjamin Evrard-Marty,25157,150503,2022-04-14
CASH_OUT,146377,Benjamin Evrard-Marty,150503,4126,Agence_mtn_Ouidah,300000,153623,2022-04-14
TRANSFER,71891,Margot Renaud,166664,94773,Benjamin Evrard-Marty,4126,76017,2022-04-19
TRANSFER,61766,Benjamin Evrard-Marty,76017,14251,Philippine Courtois,42625,-19141,2022-04-19
TRANSFER,14121,Benjamin Evrard-Marty,14251,130,Joséphine Gros,1076355,1062234,2022-04-22
CASH_OUT,110,Benjamin Evrard-Marty,130,20,Agence_mtn_Ouidah,300000,299890,2022-04-23
CASH_IN,174861,Agence_mtn_Abomey,300000,125139,Benjamin Evrard-Marty,20,174881,2022-04-24
CASH_OUT,141,Rémy Le Michaud,170,29,Agence_mtn_Ouidah,300000,299859,2022-04-02
CASH_IN,163185,Agence_mtn_Abomey,300000,136815,Rémy Le Michaud,29,163214,2022-04-03
CASH_OUT,91109,Rémy Le Michaud,163214,72105,Agence_mtn_Cotonou,300000,208891,2022-04-09
CASH_OUT,31682,Rémy Le Michaud,72105,40423,Agence_mtn_Abomey,300000,268318,2022-04-12
TRANSFER,36148,Rémy Le Michaud,40423,4275,Louise Girard,59356,23208,2022-04-14
CASH_OUT,560,Rémy Le Michaud,4275,3715,Agence_mtn_Cotonou,300000,299440,2022-04-15
CASH_IN,241304,Agence_mtn_Abomey,300000,58696,Rémy Le Michaud,3715,245019,2022-04-17
TRANSFER,69943,William Le Lucas,1837300,1767357,Rémy Le Michaud,245019,314962,2022-04-24
TRANSFER,185352,Nathalie Peron,219564,34212,Rémy Le Michaud,314962,500314,2022-04-25
CASH_IN,103056,Agence_mtn_Ouidah,300000,196944,Rémy Le Michaud,500314,603370,2022-04-26
CASH_IN,246169,Agence_mtn_Cotonou,300000,53831,Rémy Le Michaud,603370,849539,2022-04-26
CASH_IN,231219,Agence_mtn_Abomey,300000,68781,Céline Gomez,-59108,172111,2022-04-02
TRANSFER,64747,Céline Gomez,172111,107364,Nathalie Pages,112080,47333,2022-04-04
CASH_IN,273945,Agence_mtn_Cotonou,300000,26055,Céline Gomez,107364,381309,2022-04-04
CASH_OUT,121450,Céline Gomez,381309,259859,Agence_mtn_Abomey,300000,178550,2022-04-10
TRANSFER,21443,Louise Girard,23208,1765,Céline Gomez,259859,281302,2022-04-10
TRANSFER,923834,Sophie Gonzalez,1109026,185192,Céline Gomez,281302,1205136,2022-04-11
TRANSFER,2557,Alfred du Lesage,20175,17618,Céline Gomez,1205136,1207693,2022-04-12
CASH_IN,36080,Agence_mtn_Cotonou,300000,263920,Céline Gomez,1207693,1243773,2022-04-13
TRANSFER,1025280,Céline Gomez,1243773,218493,Geneviève De Oliveira-Michel,118310,-906970,2022-04-13
TRANSFER,350093,Gilbert-Charles Thibault,1085686,735593,Céline Gomez,218493,568586,2022-04-16
TRANSFER,5311,Nathalie Peron,34212,28901,Céline Gomez,568586,573897,2022-04-16
CASH_IN,196354,Agence_mtn_Cotonou,300000,103646,Céline Gomez,573897,770251,2022-04-17
CASH_OUT,185717,Céline Gomez,770251,584534,Agence_mtn_Abomey,300000,114283,2022-04-20
CASH_IN,214720,Agence_mtn_Ouidah,300000,85280,Céline Gomez,584534,799254,2022-04-23
CASH_OUT,310021,Céline Gomez,799254,489233,Agence_mtn_Cotonou,300000,-10021,2022-04-26
CASH_IN,285484,Agence_mtn_Ouidah,300000,14516,Cécile Delattre-Arnaud,-201457,84027,2022-04-01
CASH_OUT,24798,Cécile Delattre-Arnaud,84027,59229,Agence_mtn_Abomey,300000,275202,2022-04-05
CASH_OUT,31077,Cécile Delattre-Arnaud,59229,28152,Agence_mtn_Abomey,300000,268923,2022-04-06
CASH_IN,18973,Agence_mtn_Cotonou,300000,281027,Cécile Delattre-Arnaud,28152,47125,2022-04-11
CASH_IN,22128,Agence_mtn_Ouidah,300000,277872,Cécile Delattre-Arnaud,47125,69253,2022-04-11
TRANSFER,40047,Cécile Delattre-Arnaud,69253,29206,Louis Pichon,84103,44056,2022-04-12
TRANSFER,20817,Nathalie Peron,28901,8084,Cécile Delattre-Arnaud,29206,50023,2022-04-12
CASH_IN,141146,Agence_mtn_Abomey,300000,158854,Cécile Delattre-Arnaud,50023,191169,2022-04-13
TRANSFER,1678445,William Le Lucas,1767357,88912,Cécile Delattre-Arnaud,191169,1869614,2022-04-14
CASH_OUT,1484286,Cécile Delattre-Arnaud,1869614,385328,Agence_mtn_Ouidah,300000,-1184286,2022-04-16
TRANSFER,249685,Cécile Delattre-Arnaud,385328,135643,Richard Le Descamps,808820,559135,2022-04-16
TRANSFER,124405,Cécile Delattre-Arnaud,135643,11238,Cécile Delattre-Arnaud,135643,260048,2022-04-19
TRANSFER,10591,Cécile Delattre-Arnaud,11238,647,Valérie Dijoux,89235,78644,2022-04-20
TRANSFER,514,Cécile Delattre-Arnaud,647,133,Gilbert-Charles Thibault,735593,735079,2022-04-23
CASH_IN,235243,Agence_mtn_Cotonou,300000,64757,Cécile Delattre-Arnaud,133,235376,2022-04-23
CASH_IN,115068,Agence_mtn_Cotonou,300000,184932,Cécile Delattre-Arnaud,235376,350444,2022-04-24
CASH_OUT,114149,Cécile Delattre-Arnaud,350444,236295,Agence_mtn_Ouidah,300000,185851,2022-04-24
TRANSFER,900065,Joséphine Gros,1062234,162169,Valentine Martinez,247209,1147274,2022-04-02
CASH_IN,142026,Agence_mtn_Ouidah,300000,157974,Valentine Martinez,1147274,1289300,2022-04-03
TRANSFER,1154852,Valentine Martinez,1289300,134448,William Lebrun,348917,-805935,2022-04-07
CASH_IN,128250,Agence_mtn_Abomey,300000,171750,Valentine Martinez,134448,262698,2022-04-11
TRANSFER,70999,Valentine Martinez,262698,191699,Valérie Dijoux,78644,7645,2022-04-16
TRANSFER,433473,Gilbert-Charles Thibault,735079,301606,Valentine Martinez,191699,625172,2022-04-19
CASH_OUT,385683,Valentine Martinez,625172,239489,Agence_mtn_Cotonou,300000,-85683,2022-04-23
CASH_OUT,162325,Valentine Martinez,239489,77164,Agence_mtn_Cotonou,300000,137675,2022-04-23
CASH_IN,145095,Agence_mtn_Ouidah,300000,154905,Valentine Martinez,77164,222259,2022-04-27
CASH_IN,74707,Agence_mtn_Abomey,300000,225293,Simone Pineau,-157659,-82952,2022-04-02
CASH_IN,295327,Agence_mtn_Cotonou,300000,4673,Simone Pineau,-82952,212375,2022-04-06
CASH_IN,277392,Agence_mtn_Abomey,300000,22608,Simone Pineau,212375,489767,2022-04-09
TRANSFER,24887,Étienne Roche,470676,445789,Simone Pineau,489767,514654,2022-04-19
TRANSFER,438006,Étienne Roche,445789,7783,Simone Pineau,514654,952660,2022-04-19
TRANSFER,537929,Simone Pineau,952660,414731,Adèle Labbé,313695,-224234,2022-04-21
CASH_OUT,42210,Simone Pineau,414731,372521,Agence_mtn_Cotonou,300000,257790,2022-04-21
CASH_OUT,342996,Simone Pineau,372521,29525,Agence_mtn_Ouidah,300000,-42996,2022-04-22
CASH_IN,252691,Agence_mtn_Abomey,300000,47309,Simone Pineau,29525,282216,2022-04-22
TRANSFER,9973,Simone Pineau,282216,272243,Sophie Gonzalez,185192,175219,2022-04-23
CASH_IN,215299,Agence_mtn_Abomey,300000,84701,Simone Pineau,272243,487542,2022-04-26
CASH_IN,222823,Agence_mtn_Abomey,300000,77177,Geneviève De Oliveira-Michel,-906970,-684147,2022-04-01
CASH_IN,106255,Agence_mtn_Abomey,300000,193745,Geneviève De Oliveira-Michel,-684147,-577892,2022-04-02
CASH_IN,228416,Agence_mtn_Abomey,300000,71584,Geneviève De Oliveira-Michel,-577892,-349476,2022-04-04
CASH_IN,192358,Agence_mtn_Ouidah,300000,107642,Geneviève De Oliveira-Michel,-349476,-157118,2022-04-04
CASH_IN,199285,Agence_mtn_Abomey,300000,100715,Geneviève De Oliveira-Michel,-157118,42167,2022-04-10
CASH_OUT,30784,Geneviève De Oliveira-Michel,42167,11383,Agence_mtn_Ouidah,300000,269216,2022-04-10
TRANSFER,3685,Geneviève De Oliveira-Michel,11383,7698,Étienne Roche,7783,4098,2022-04-16
CASH_OUT,3221,Geneviève De Oliveira-Michel,7698,4477,Agence_mtn_Ouidah,300000,296779,2022-04-19
TRANSFER,1666,Geneviève De Oliveira-Michel,4477,2811,Valérie Dijoux,7645,5979,2022-04-21
CASH_OUT,740,Geneviève De Oliveira-Michel,2811,2071,Agence_mtn_Cotonou,300000,299260,2022-04-24
CASH_OUT,243,Geneviève De Oliveira-Michel,2071,1828,Agence_mtn_Abomey,300000,299757,2022-04-24
CASH_IN,197932,Agence_mtn_Ouidah,300000,102068,Geneviève De Oliveira-Michel,1828,199760,2022-04-27
CASH_IN,184291,Agence_mtn_Ouidah,300000,115709,Thérèse-Margaux Bruneau,-138031,46260,2022-04-05
CASH_OUT,25651,Thérèse-Margaux Bruneau,46260,20609,Agence_mtn_Cotonou,300000,274349,2022-04-07
TRANSFER,42455,Nathalie Pages,47333,4878,Thérèse-Margaux Bruneau,20609,63064,2022-04-08
CASH_IN,191697,Agence_mtn_Ouidah,300000,108303,Thérèse-Margaux Bruneau,63064,254761,2022-04-12
TRANSFER,59593,Thérèse-Margaux Bruneau,254761,195168,Thérèse-Margaux Bruneau,254761,314354,2022-04-12
CASH_IN,281400,Agence_mtn_Cotonou,300000,18600,Thérèse-Margaux Bruneau,195168,476568,2022-04-13
CASH_OUT,20432,Thérèse-Margaux Bruneau,476568,456136,Agence_mtn_Abomey,300000,279568,2022-04-13
CASH_OUT,435891,Thérèse-Margaux Bruneau,456136,20245,Agence_mtn_Cotonou,300000,-135891,2022-04-14
CASH_IN,67452,Agence_mtn_Ouidah,300000,232548,Thérèse-Margaux Bruneau,20245,87697,2022-04-19
CASH_OUT,82885,Thérèse-Margaux Bruneau,87697,4812,Agence_mtn_Abomey,300000,217115,2022-04-20
TRANSFER,3693,Thérèse-Margaux Bruneau,4812,1119,William Le Lucas,88912,85219,2022-04-27
CASH_IN,213065,Agence_mtn_Ouidah,300000,86935,Raymond Rossi,-180491,32574,2022-04-02
CASH_OUT,866,Raymond Rossi,32574,31708,Agence_mtn_Ouidah,300000,299134,2022-04-08
CASH_IN,101754,Agence_mtn_Abomey,300000,198246,Raymond Rossi,31708,133462,2022-04-11
TRANSFER,112895,Raymond Rossi,133462,20567,Raymond Rossi,133462,246357,2022-04-11
TRANSFER,6532,Nathalie Peron,8084,1552,Raymond Rossi,20567,27099,2022-04-14
CASH_OUT,15301,Raymond Rossi,27099,11798,Agence_mtn_Abomey,300000,284699,2022-04-14
TRANSFER,8863,Raymond Rossi,11798,2935,Valérie Dijoux,5979,-2884,2022-04-14
CASH_IN,199801,Agence_mtn_Abomey,300000,100199,Raymond Rossi,2935,202736,2022-04-17
TRANSFER,28391,Antoinette Bertrand,36024,7633,Raymond Rossi,202736,231127,2022-04-22
CASH_IN,149401,Agence_mtn_Ouidah,300000,150599,Raymond Rossi,231127,380528,2022-04-22
CASH_OUT,128304,Raymond Rossi,380528,252224,Agence_mtn_Ouidah,300000,171696,2022-04-24
CASH_IN,120411,Agence_mtn_Abomey,300000,179589,Bertrand Le Roux,-6316,114095,2022-04-03
TRANSFER,61300,Cécile Clerc,63048,1748,Bertrand Le Roux,114095,175395,2022-04-03
TRANSFER,147870,Bertrand Le Roux,175395,27525,Roland Garcia,94324,-53546,2022-04-04
CASH_OUT,21479,Bertrand Le Roux,27525,6046,Agence_mtn_Abomey,300000,278521,2022-04-09
CASH_OUT,636,Bertrand Le Roux,6046,5410,Agence_mtn_Cotonou,300000,299364,2022-04-11
CASH_OUT,740,Bertrand Le Roux,5410,4670,Agence_mtn_Cotonou,300000,299260,2022-04-27
TRANSFER,35713,Louis Pichon,44056,8343,Nathalie Peron,1552,37265,2022-04-01
TRANSFER,299158,Richard Le Descamps,559135,259977,Nathalie Peron,37265,336423,2022-04-03
CASH_IN,132852,Agence_mtn_Ouidah,300000,167148,Nathalie Peron,336423,469275,2022-04-03
TRANSFER,51177,Nathalie Peron,469275,418098,Cécile Clerc,1748,-49429,2022-04-03
CASH_OUT,133820,Nathalie Peron,418098,284278,Agence_mtn_Cotonou,300000,166180,2022-04-03
CASH_IN,53491,Agence_mtn_Cotonou,300000,246509,Nathalie Peron,284278,337769,2022-04-05
CASH_IN,121071,Agence_mtn_Cotonou,300000,178929,Nathalie Peron,337769,458840,2022-04-08
CASH_OUT,245051,Nathalie Peron,458840,213789,Agence_mtn_Ouidah,300000,54949,2022-04-08
CASH_OUT,69916,Nathalie Peron,213789,143873,Agence_mtn_Ouidah,300000,230084,2022-04-12
CASH_IN,84485,Agence_mtn_Cotonou,300000,215515,Nathalie Peron,143873,228358,2022-04-13
CASH_OUT,70741,Nathalie Peron,228358,157617,Agence_mtn_Abomey,300000,229259,2022-04-19
CASH_OUT,30172,Nathalie Peron,157617,127445,Agence_mtn_Ouidah,300000,269828,2022-04-20
TRANSFER,79869,Nathalie Peron,127445,47576,Antoinette Bertrand,7633,-72236,2022-04-21
CASH_OUT,4055,Nathalie Peron,47576,43521,Agence_mtn_Ouidah,300000,295945,2022-04-22
CASH_OUT,29131,Nathalie Peron,43521,14390,Agence_mtn_Ouidah,300000,270869,2022-04-22
CASH_IN,80745,Agence_mtn_Abomey,300000,219255,Nathalie Peron,14390,95135,2022-04-23
CASH_OUT,15419,Nathalie Peron,95135,79716,Agence_mtn_Abomey,300000,284581,2022-04-24
TRANSFER,11613,Gilbert-Charles Thibault,301606,289993,Nathalie Peron,79716,91329,2022-04-25
CASH_OUT,118705,Thibault Moreno,353479,234774,Agence_mtn_Cotonou,300000,181295,2022-04-03
CASH_IN,259011,Agence_mtn_Abomey,300000,40989,Thibault Moreno,234774,493785,2022-04-05
CASH_OUT,141535,Thibault Moreno,493785,352250,Agence_mtn_Abomey,300000,158465,2022-04-06
TRANSFER,337163,Thibault Moreno,352250,15087,Nathalie Pages,4878,-332285,2022-04-06
CASH_IN,156589,Agence_mtn_Ouidah,300000,143411,Thibault Moreno,15087,171676,2022-04-09
CASH_IN,171004,Agence_mtn_Cotonou,300000,128996,Thibault Moreno,171676,342680,2022-04-14
CASH_IN,46458,Agence_mtn_Ouidah,300000,253542,Philippine Courtois,-19141,27317,2022-04-01
CASH_OUT,18767,Philippine Courtois,27317,8550,Agence_mtn_Abomey,300000,281233,2022-04-01
TRANSFER,5248,Philippine Courtois,8550,3302,Sébastien Lemaître,719940,714692,2022-04-02
CASH_OUT,267,Philippine Courtois,3302,3035,Agence_mtn_Ouidah,300000,299733,2022-04-03
CASH_IN,231570,Agence_mtn_Abomey,300000,68430,Philippine Courtois,3035,234605,2022-04-04
CASH_IN,185579,Agence_mtn_Abomey,300000,114421,Philippine Courtois,234605,420184,2022-04-04
CASH_OUT,176546,Philippine Courtois,420184,243638,Agence_mtn_Cotonou,300000,123454,2022-04-05
TRANSFER,31771,William Le Lucas,85219,53448,Philippine Courtois,243638,275409,2022-04-06
CASH_OUT,212483,Philippine Courtois,275409,62926,Agence_mtn_Ouidah,300000,87517,2022-04-08
TRANSFER,26601,Sophie Gonzalez,175219,148618,Philippine Courtois,62926,89527,2022-04-11
CASH_OUT,82102,Philippine Courtois,89527,7425,Agence_mtn_Abomey,300000,217898,2022-04-11
TRANSFER,2106,Philippine Courtois,7425,5319,Richard Le Descamps,259977,257871,2022-04-11
TRANSFER,3164,Gilbert-Charles Thibault,289993,286829,Philippine Courtois,5319,8483,2022-04-17
CASH_IN,173403,Agence_mtn_Cotonou,300000,126597,Philippine Courtois,8483,181886,2022-04-18
CASH_IN,93046,Agence_mtn_Cotonou,300000,206954,Philippine Courtois,181886,274932,2022-04-18
CASH_IN,217152,Agence_mtn_Ouidah,300000,82848,Philippine Courtois,274932,492084,2022-04-19
TRANSFER,330111,Philippine Courtois,492084,161973,Gilbert-Charles Thibault,286829,-43282,2022-04-19
TRANSFER,153540,Philippine Courtois,161973,8433,Sébastien Lemaître,714692,561152,2022-04-21
CASH_IN,148141,Agence_mtn_Ouidah,300000,151859,Philippine Courtois,8433,156574,2022-04-21
CASH_OUT,125060,Philippine Courtois,156574,31514,Agence_mtn_Abomey,300000,174940,2022-04-25
CASH_IN,237245,Agence_mtn_Abomey,300000,62755,Antoinette Bertrand,-72236,165009,2022-04-02
TRANSFER,116033,Antoinette Bertrand,165009,48976,Antoinette Bertrand,165009,281042,2022-04-05
CASH_IN,208315,Agence_mtn_Ouidah,300000,91685,Antoinette Bertrand,48976,257291,2022-04-10
CASH_OUT,131497,Antoinette Bertrand,257291,125794,Agence_mtn_Cotonou,300000,168503,2022-04-10
TRANSFER,174,Louise Girard,1765,1591,Antoinette Bertrand,125794,125968,2022-04-20
TRANSFER,75043,Margot Renaud,94773,19730,Antoinette Bertrand,125968,201011,2022-04-25
CASH_IN,175627,Agence_mtn_Cotonou,300000,124373,Antoinette Bertrand,201011,376638,2022-04-25
TRANSFER,5558,Margot Renaud,19730,14172,Sophie Gonzalez,148618,154176,2022-04-01
CASH_IN,94947,Agence_mtn_Cotonou,300000,205053,Sophie Gonzalez,154176,249123,2022-04-03
CASH_OUT,176286,Sophie Gonzalez,249123,72837,Agence_mtn_Cotonou,300000,123714,2022-04-04
TRANSFER,8844,Sophie Gonzalez,72837,63993,Margot Renaud,14172,5328,2022-04-07
CASH_OUT,63162,Sophie Gonzalez,63993,831,Agence_mtn_Ouidah,300000,236838,2022-04-12
CASH_OUT,319,Sophie Gonzalez,831,512,Agence_mtn_Abomey,300000,299681,2022-04-12
TRANSFER,477,Sophie Gonzalez,512,35,Sophie Gonzalez,512,989,2022-04-17
CASH_IN,152852,Agence_mtn_Cotonou,300000,147148,Sophie Gonzalez,35,152887,2022-04-17
CASH_OUT,2726,Sophie Gonzalez,152887,150161,Agence_mtn_Ouidah,300000,297274,2022-04-18
CASH_IN,230120,Agence_mtn_Abomey,300000,69880,Sophie Gonzalez,150161,380281,2022-04-21
TRANSFER,31094,Joséphine Gros,162169,131075,Sophie Gonzalez,380281,411375,2022-04-21
TRANSFER,120606,Sophie Gonzalez,411375,290769,Sébastien Lemaître,561152,440546,2022-04-22
CASH_IN,105532,Agence_mtn_Abomey,300000,194468,Sophie Gonzalez,290769,396301,2022-04-25
CASH_IN,228662,Agence_mtn_Cotonou,300000,71338,Nathalie Pages,-332285,-103623,2022-04-02
CASH_IN,18567,Agence_mtn_Abomey,300000,281433,Nathalie Pages,-103623,-85056,2022-04-05
CASH_IN,100430,Agence_mtn_Cotonou,300000,199570,Nathalie Pages,-85056,15374,2022-04-06
CASH_IN,37660,Agence_mtn_Abomey,300000,262340,Nathalie Pages,15374,53034,2022-04-07
TRANSFER,155,Margot Renaud,5328,5173,Nathalie Pages,53034,53189,2022-04-10
CASH_OUT,12507,Nathalie Pages,53189,40682,Agence_mtn_Ouidah,300000,287493,2022-04-14
CASH_IN,203637,Agence_mtn_Abomey,300000,96363,Nathalie Pages,40682,244319,2022-04-14
CASH_IN,19159,Agence_mtn_Cotonou,300000,280841,Nathalie Pages,244319,263478,2022-04-17
CASH_OUT,257943,Nathalie Pages,263478,5535,Agence_mtn_Cotonou,300000,42057,2022-04-19
CASH_IN,48404,Agence_mtn_Cotonou,300000,251596,Nathalie Pages,5535,53939,2022-04-24
CASH_IN,215923,Agence_mtn_Cotonou,300000,84077,Nathalie Pages,53939,269862,2022-04-24
CASH_IN,100413,Agence_mtn_Cotonou,300000,199587,Gilbert Foucher,-279508,-179095,2022-04-03
CASH_IN,103216,Agence_mtn_Abomey,300000,196784,Gilbert Foucher,-179095,-75879,2022-04-06
CASH_IN,117833,Agence_mtn_Abomey,300000,182167,Gilbert Foucher,-75879,41954,2022-04-07
CASH_OUT,28006,Gilbert Foucher,41954,13948,Agence_mtn_Abomey,300000,271994,2022-04-08
TRANSFER,4223,Gilbert Foucher,13948,9725,Louise Girard,1591,-2632,2022-04-08
CASH_OUT,6837,Gilbert Foucher,9725,2888,Agence_mtn_Cotonou,300000,293163,2022-04-10
TRANSFER,118,Étienne Roche,4098,3980,Gilbert Foucher,2888,3006,2022-04-20
TRANSFER,2560,Margot Renaud,5173,2613,Gilbert Foucher,3006,5566,2022-04-21
CASH_OUT,3322,Gilbert Foucher,5566,2244,Agence_mtn_Ouidah,300000,296678,2022-04-22
CASH_OUT,617,Gilbert Foucher,2244,1627,Agence_mtn_Cotonou,300000,299383,2022-04-23
CASH_IN,289916,Agence_mtn_Abomey,300000,10084,Gilbert-Charles Thibault,-43282,246634,2022-04-03
CASH_OUT,218551,Gilbert-Charles Thibault,246634,28083,Agence_mtn_Abomey,300000,81449,2022-04-09
CASH_IN,204401,Agence_mtn_Cotonou,300000,95599,Gilbert-Charles Thibault,28083,232484,2022-04-10
TRANSFER,104124,Gilbert-Charles Thibault,232484,128360,Jean Benard,400067,295943,2022-04-13
CASH_IN,182056,Agence_mtn_Ouidah,300000,117944,Gilbert-Charles Thibault,128360,310416,2022-04-14
CASH_IN,47260,Agence_mtn_Abomey,300000,252740,Gilbert-Charles Thibault,310416,357676,2022-04-17
CASH_IN,288279,Agence_mtn_Cotonou,300000,11721,Gilbert-Charles Thibault,357676,645955,2022-04-20
CASH_OUT,102006,Gilbert-Charles Thibault,645955,543949,Agence_mtn_Abomey,300000,197994,2022-04-22
TRANSFER,176541,Gilbert-Charles Thibault,543949,367408,Étienne Roche,3980,-172561,2022-04-27
CASH_IN,124056,Agence_mtn_Ouidah,300000,175944,Emmanuelle Georges,-323828,-199772,2022-04-02
CASH_IN,257253,Agence_mtn_Ouidah,300000,42747,Emmanuelle Georges,-199772,57481,2022-04-03
TRANSFER,51027,Emmanuelle Georges,57481,6454,Sébastien Lemaître,440546,389519,2022-04-04
CASH_IN,263002,Agence_mtn_Abomey,300000,36998,Emmanuelle Georges,6454,269456,2022-04-05
CASH_IN,289202,Agence_mtn_Cotonou,300000,10798,Emmanuelle Georges,269456,558658,2022-04-08
CASH_IN,76406,Agence_mtn_Ouidah,300000,223594,Emmanuelle Georges,558658,635064,2022-04-09
TRANSFER,488182,Emmanuelle Georges,635064,146882,William Le Lucas,53448,-434734,2022-04-10
TRANSFER,67935,Emmanuelle Georges,146882,78947,Margot Renaud,2613,-65322,2022-04-12
CASH_OUT,61651,Emmanuelle Georges,78947,17296,Agence_mtn_Cotonou,300000,238349,2022-04-15
CASH_OUT,15067,Emmanuelle Georges,17296,2229,Agence_mtn_Ouidah,300000,284933,2022-04-17
TRANSFER,996,Emmanuelle Georges,2229,1233,Sébastien Lemaître,389519,388523,2022-04-17
TRANSFER,79999,Joséphine Gros,131075,51076,Emmanuelle Georges,1233,81232,2022-04-18
CASH_OUT,40293,Emmanuelle Georges,81232,40939,Agence_mtn_Ouidah,300000,259707,2022-04-19
CASH_OUT,32003,Emmanuelle Georges,40939,8936,Agence_mtn_Cotonou,300000,267997,2022-04-20
TRANSFER,38654,Jean Benard,295943,257289,Emmanuelle Georges,8936,47590,2022-04-21
CASH_IN,291992,Agence_mtn_Ouidah,300000,8008,Emmanuelle Georges,47590,339582,2022-04-22
CASH_IN,47999,Agence_mtn_Abomey,300000,252001,Emmanuelle Georges,339582,387581,2022-04-23
CASH_IN,214538,Agence_mtn_Ouidah,300000,85462,Emmanuelle Georges,387581,602119,2022-04-24
CASH_IN,273930,Agence_mtn_Abomey,300000,26070,Emmanuelle Georges,602119,876049,2022-04-25
TRANSFER,683581,Emmanuelle Georges,876049,192468,Richard Le Descamps,257871,-425710,2022-04-26
TRANSFER,10612,Sébastien Lemaître,388523,377911,Sébastien Lemaître,388523,377911,2022-04-04
CASH_OUT,3020,Sébastien Lemaître,377911,374891,Agence_mtn_Ouidah,300000,296980,2022-04-05
TRANSFER,20649,Joséphine Gros,51076,30427,Sébastien Lemaître,374891,395540,2022-04-05
TRANSFER,240060,Sébastien Lemaître,395540,155480,Joséphine Gros,30427,-209633,2022-04-05
CASH_OUT,89533,Sébastien Lemaître,155480,65947,Agence_mtn_Abomey,300000,210467,2022-04-08
CASH_OUT,32014,Sébastien Lemaître,65947,33933,Agence_mtn_Cotonou,300000,267986,2022-04-08
CASH_IN,294702,Agence_mtn_Ouidah,300000,5298,Sébastien Lemaître,33933,328635,2022-04-10
CASH_OUT,284506,Sébastien Lemaître,328635,44129,Agence_mtn_Abomey,300000,15494,2022-04-11
CASH_IN,101785,Agence_mtn_Cotonou,300000,198215,Sébastien Lemaître,44129,145914,2022-04-13
CASH_IN,85645,Agence_mtn_Ouidah,300000,214355,Sébastien Lemaître,145914,231559,2022-04-15
CASH_OUT,10325,Sébastien Lemaître,231559,221234,Agence_mtn_Abomey,300000,289675,2022-04-18
CASH_IN,205256,Agence_mtn_Abomey,300000,94744,Sébastien Lemaître,221234,426490,2022-04-20
CASH_OUT,73707,Sébastien Lemaître,426490,352783,Agence_mtn_Ouidah,300000,226293,2022-04-23
CASH_OUT,84950,Sébastien Lemaître,352783,267833,Agence_mtn_Cotonou,300000,215050,2022-04-26
CASH_IN,91373,Agence_mtn_Abomey,300000,208627,Louise Girard,-2632,88741,2022-04-01
CASH_OUT,83933,Louise Girard,88741,4808,Agence_mtn_Ouidah,300000,216067,2022-04-01
CASH_OUT,384,Louise Girard,4808,4424,Agence_mtn_Abomey,300000,299616,2022-04-03
CASH_OUT,3993,Louise Girard,4424,431,Agence_mtn_Abomey,300000,296007,2022-04-05
CASH_OUT,192,Louise Girard,431,239,Agence_mtn_Cotonou,300000,299808,2022-04-14
CASH_OUT,166,Louise Girard,239,73,Agence_mtn_Ouidah,300000,299834,2022-04-18
CASH_IN,232760,Agence_mtn_Abomey,300000,67240,Louise Girard,73,232833,2022-04-23
CASH_IN,206001,Agence_mtn_Abomey,300000,93999,Louise Girard,232833,438834,2022-04-24
CASH_OUT,14395,Louise Girard,438834,424439,Agence_mtn_Abomey,300000,285605,2022-04-25
CASH_OUT,202251,Louise Girard,424439,222188,Agence_mtn_Cotonou,300000,97749,2022-04-26
CASH_IN,167761,Agence_mtn_Cotonou,300000,132239,Alphonse Leclercq-Rousseau,-50181,117580,2022-04-01
CASH_IN,19545,Agence_mtn_Cotonou,300000,280455,Alphonse Leclercq-Rousseau,117580,137125,2022-04-04
TRANSFER,131710,Alphonse Leclercq-Rousseau,137125,5415,Alphonse Leclercq-Rousseau,137125,268835,2022-04-11
CASH_IN,63666,Agence_mtn_Ouidah,300000,236334,Alphonse Leclercq-Rousseau,5415,69081,2022-04-11
CASH_OUT,18400,Alphonse Leclercq-Rousseau,69081,50681,Agence_mtn_Abomey,300000,281600,2022-04-11
CASH_IN,17042,Agence_mtn_Ouidah,300000,282958,Alphonse Leclercq-Rousseau,50681,67723,2022-04-20
CASH_OUT,19298,Alphonse Leclercq-Rousseau,67723,48425,Agence_mtn_Abomey,300000,280702,2022-04-24
CASH_OUT,1750,Alphonse Leclercq-Rousseau,48425,46675,Agence_mtn_Abomey,300000,298250,2022-04-26
CASH_IN,270045,Agence_mtn_Abomey,300000,29955,Marine Chauvet-Potier,-872057,-602012,2022-04-01
CASH_IN,234783,Agence_mtn_Abomey,300000,65217,Marine Chauvet-Potier,-602012,-367229,2022-04-01
CASH_IN,14336,Agence_mtn_Abomey,300000,285664,Marine Chauvet-Potier,-367229,-352893,2022-04-04
CASH_IN,138892,Agence_mtn_Cotonou,300000,161108,Marine Chauvet-Potier,-352893,-214001,2022-04-05
CASH_IN,289603,Agence_mtn_Cotonou,300000,10397,Marine Chauvet-Potier,-214001,75602,2022-04-11
TRANSFER,28156,Marine Chauvet-Potier,75602,47446,Marine Chauvet-Potier,75602,103758,2022-04-15
TRANSFER,33603,Marine Chauvet-Potier,47446,13843,Marine Chauvet-Potier,47446,81049,2022-04-17
CASH_OUT,9113,Marine Chauvet-Potier,13843,4730,Agence_mtn_Ouidah,300000,290887,2022-04-17
CASH_IN,104194,Agence_mtn_Abomey,300000,195806,Marine Chauvet-Potier,4730,108924,2022-04-23
CASH_OUT,71061,Marine Chauvet-Potier,108924,37863,Agence_mtn_Abomey,300000,228939,2022-04-27
CASH_IN,235033,Agence_mtn_Ouidah,300000,64967,Cécile Clerc,-49429,185604,2022-04-02
CASH_OUT,48204,Cécile Clerc,185604,137400,Agence_mtn_Abomey,300000,251796,2022-04-03
TRANSFER,49490,Cécile Clerc,137400,87910,Cécile Clerc,137400,186890,2022-04-05
CASH_IN,64325,Agence_mtn_Cotonou,300000,235675,Cécile Clerc,87910,152235,2022-04-11
CASH_OUT,118724,Cécile Clerc,152235,33511,Agence_mtn_Abomey,300000,181276,2022-04-14
CASH_IN,83924,Agence_mtn_Cotonou,300000,216076,Cécile Clerc,33511,117435,2022-04-22
CASH_IN,167719,Agence_mtn_Cotonou,300000,132281,Cécile Clerc,117435,285154,2022-04-25
CASH_OUT,78549,Cécile Clerc,285154,206605,Agence_mtn_Ouidah,300000,221451,2022-04-26
CASH_IN,49068,Agence_mtn_Cotonou,300000,250932,Renée David,-91997,-42929,2022-04-02
CASH_IN,191239,Agence_mtn_Abomey,300000,108761,Renée David,-42929,148310,2022-04-04
CASH_OUT,1631,Renée David,148310,146679,Agence_mtn_Cotonou,300000,298369,2022-04-04
CASH_OUT,136140,Renée David,146679,10539,Agence_mtn_Cotonou,300000,163860,2022-04-07
CASH_IN,55060,Agence_mtn_Abomey,300000,244940,Renée David,10539,65599,2022-04-08
CASH_OUT,30850,Renée David,65599,34749,Agence_mtn_Ouidah,300000,269150,2022-04-09
CASH_OUT,2152,Renée David,34749,32597,Agence_mtn_Abomey,300000,297848,2022-04-11
TRANSFER,27345,Renée David,32597,5252,Renée David,32597,5252,2022-04-12
TRANSFER,2146,Renée David,5252,3106,Renée David,5252,7398,2022-04-13
CASH_OUT,2337,Renée David,3106,769,Agence_mtn_Cotonou,300000,297663,2022-04-16
CASH_IN,226821,Agence_mtn_Ouidah,300000,73179,Renée David,769,227590,2022-04-16
CASH_IN,271093,Agence_mtn_Cotonou,300000,28907,Renée David,227590,498683,2022-04-18
CASH_OUT,16816,Renée David,498683,481867,Agence_mtn_Abomey,300000,283184,2022-04-19
CASH_IN,211581,Agence_mtn_Cotonou,300000,88419,Renée David,481867,693448,2022-04-21
CASH_OUT,47880,Renée David,693448,645568,Agence_mtn_Abomey,300000,252120,2022-04-22
CASH_OUT,69286,Renée David,645568,576282,Agence_mtn_Ouidah,300000,230714,2022-04-24
CASH_IN,42618,Agence_mtn_Abomey,300000,257382,Sébastien Vallée,-785795,-743177,2022-04-04
CASH_IN,146513,Agence_mtn_Cotonou,300000,153487,Sébastien Vallée,-743177,-596664,2022-04-08
CASH_IN,54702,Agence_mtn_Cotonou,300000,245298,Sébastien Vallée,-596664,-541962,2022-04-11
CASH_IN,199229,Agence_mtn_Cotonou,300000,100771,Sébastien Vallée,-541962,-342733,2022-04-12
CASH_IN,69154,Agence_mtn_Cotonou,300000,230846,Sébastien Vallée,-342733,-273579,2022-04-13
CASH_IN,226857,Agence_mtn_Abomey,300000,73143,Sébastien Vallée,-273579,-46722,2022-04-14
CASH_IN,218021,Agence_mtn_Cotonou,300000,81979,Sébastien Vallée,-46722,171299,2022-04-16
CASH_IN,195262,Agence_mtn_Cotonou,300000,104738,Sébastien Vallée,171299,366561,2022-04-16
CASH_OUT,291734,Sébastien Vallée,366561,74827,Agence_mtn_Abomey,300000,8266,2022-04-18
CASH_IN,224349,Agence_mtn_Cotonou,300000,75651,Sébastien Vallée,74827,299176,2022-04-19
TRANSFER,3201,Sébastien Vallée,299176,295975,Sébastien Vallée,299176,302377,2022-04-20
TRANSFER,206347,Sébastien Vallée,295975,89628,Sébastien Vallée,295975,502322,2022-04-20
CASH_IN,90961,Agence_mtn_Cotonou,300000,209039,Sébastien Vallée,89628,180589,2022-04-22
CASH_IN,96374,Agence_mtn_Abomey,300000,203626,Sébastien Vallée,180589,276963,2022-04-22
CASH_OUT,165453,Sébastien Vallée,276963,111510,Agence_mtn_Cotonou,300000,134547,2022-04-23
CASH_IN,59535,Agence_mtn_Abomey,300000,240465,Vincent Fournier,-116426,-56891,2022-04-05
CASH_IN,129986,Agence_mtn_Ouidah,300000,170014,Vincent Fournier,-56891,73095,2022-04-09
CASH_OUT,5938,Vincent Fournier,73095,67157,Agence_mtn_Abomey,300000,294062,2022-04-13
CASH_IN,183277,Agence_mtn_Abomey,300000,116723,Vincent Fournier,67157,250434,2022-04-17
CASH_OUT,100267,Vincent Fournier,250434,150167,Agence_mtn_Abomey,300000,199733,2022-04-19
CASH_OUT,86892,Vincent Fournier,150167,63275,Agence_mtn_Cotonou,300000,213108,2022-04-23
CASH_IN,92049,Agence_mtn_Ouidah,300000,207951,William Le Lucas,-434734,-342685,2022-04-07
CASH_IN,198812,Agence_mtn_Cotonou,300000,101188,William Le Lucas,-342685,-143873,2022-04-11
CASH_IN,174772,Agence_mtn_Cotonou,300000,125228,William Le Lucas,-143873,30899,2022-04-11
CASH_OUT,29502,William Le Lucas,30899,1397,Agence_mtn_Abomey,300000,270498,2022-04-11
CASH_IN,87572,Agence_mtn_Ouidah,300000,212428,William Le Lucas,1397,88969,2022-04-12
CASH_OUT,24485,William Le Lucas,88969,64484,Agence_mtn_Ouidah,300000,275515,2022-04-14
CASH_IN,203592,Agence_mtn_Cotonou,300000,96408,William Le Lucas,64484,268076,2022-04-19
TRANSFER,231396,William Le Lucas,268076,36680,William Le Lucas,268076,36680,2022-04-20
CASH_IN,284881,Agence_mtn_Ouidah,300000,15119,William Le Lucas,36680,321561,2022-04-21
CASH_OUT,291011,William Le Lucas,321561,30550,Agence_mtn_Ouidah,300000,8989,2022-04-21
CASH_OUT,11580,William Le Lucas,30550,18970,Agence_mtn_Cotonou,300000,288420,2022-04-22
CASH_IN,191614,Agence_mtn_Ouidah,300000,108386,William Le Lucas,18970,210584,2022-04-27
CASH_IN,272189,Agence_mtn_Cotonou,300000,27811,Étienne Roche,-172561,99628,2022-04-05
CASH_IN,37918,Agence_mtn_Abomey,300000,262082,Étienne Roche,99628,137546,2022-04-05
CASH_OUT,77824,Étienne Roche,137546,59722,Agence_mtn_Ouidah,300000,222176,2022-04-12
CASH_OUT,7036,Étienne Roche,59722,52686,Agence_mtn_Cotonou,300000,292964,2022-04-12
TRANSFER,30532,Étienne Roche,52686,22154,Étienne Roche,52686,22154,2022-04-13
CASH_IN,70592,Agence_mtn_Cotonou,300000,229408,Étienne Roche,22154,92746,2022-04-14
CASH_OUT,30567,Étienne Roche,92746,62179,Agence_mtn_Abomey,300000,269433,2022-04-15
CASH_IN,44472,Agence_mtn_Abomey,300000,255528,Étienne Roche,62179,106651,2022-04-17
CASH_OUT,52799,Étienne Roche,106651,53852,Agence_mtn_Cotonou,300000,247201,2022-04-21
CASH_IN,12454,Agence_mtn_Cotonou,300000,287546,Adèle Labbé,-224234,-211780,2022-04-05
CASH_IN,177703,Agence_mtn_Abomey,300000,122297,Adèle Labbé,-211780,-34077,2022-04-10
CASH_IN,224979,Agence_mtn_Abomey,300000,75021,Adèle Labbé,-34077,190902,2022-04-11
CASH_OUT,100285,Adèle Labbé,190902,90617,Agence_mtn_Cotonou,300000,199715,2022-04-14
CASH_IN,171719,Agence_mtn_Abomey,300000,128281,Adèle Labbé,90617,262336,2022-04-14
CASH_OUT,98977,Adèle Labbé,262336,163359,Agence_mtn_Cotonou,300000,201023,2022-04-18
CASH_OUT,53508,Adèle Labbé,163359,109851,Agence_mtn_Ouidah,300000,246492,2022-04-25
CASH_IN,140386,Agence_mtn_Abomey,300000,159614,Xavier de Lebreton,-23729,116657,2022-04-01
CASH_OUT,108280,Xavier de Lebreton,116657,8377,Agence_mtn_Abomey,300000,191720,2022-04-02
CASH_OUT,1620,Xavier de Lebreton,8377,6757,Agence_mtn_Abomey,300000,298380,2022-04-02
TRANSFER,5167,Xavier de Lebreton,6757,1590,Xavier de Lebreton,6757,1590,2022-04-04
CASH_OUT,125,Xavier de Lebreton,1590,1465,Agence_mtn_Abomey,300000,299875,2022-04-05
TRANSFER,262,Xavier de Lebreton,1465,1203,Xavier de Lebreton,1465,1727,2022-04-07
CASH_OUT,530,Xavier de Lebreton,1203,673,Agence_mtn_Abomey,300000,299470,2022-04-07
CASH_IN,270227,Agence_mtn_Ouidah,300000,29773,Xavier de Lebreton,673,270900,2022-04-10
CASH_OUT,90290,Xavier de Lebreton,270900,180610,Agence_mtn_Cotonou,300000,209710,2022-04-13
CASH_OUT,126894,Xavier de Lebreton,180610,53716,Agence_mtn_Abomey,300000,173106,2022-04-15
CASH_IN,113871,Agence_mtn_Abomey,300000,186129,Xavier de Lebreton,53716,167587,2022-04-24
CASH_IN,58489,Agence_mtn_Abomey,300000,241511,Thierry Delattre-Simon,-29657,28832,2022-04-03
TRANSFER,9769,Thierry Delattre-Simon,28832,19063,Thierry Delattre-Simon,28832,38601,2022-04-03
CASH_OUT,7593,Thierry Delattre-Simon,19063,11470,Agence_mtn_Abomey,300000,292407,2022-04-04
CASH_IN,222142,Agence_mtn_Ouidah,300000,77858,Thierry Delattre-Simon,11470,233612,2022-04-04
CASH_IN,144805,Agence_mtn_Ouidah,300000,155195,Thierry Delattre-Simon,233612,378417,2022-04-04
CASH_IN,205289,Agence_mtn_Abomey,300000,94711,Thierry Delattre-Simon,378417,583706,2022-04-06
CASH_OUT,451208,Thierry Delattre-Simon,583706,132498,Agence_mtn_Cotonou,300000,-151208,2022-04-10
CASH_IN,239463,Agence_mtn_Ouidah,300000,60537,Thierry Delattre-Simon,132498,371961,2022-04-11
TRANSFER,115276,Thierry Delattre-Simon,371961,256685,Thierry Delattre-Simon,371961,256685,2022-04-11
TRANSFER,31555,Thierry Delattre-Simon,256685,225130,Thierry Delattre-Simon,256685,225130,2022-04-15
CASH_IN,224556,Agence_mtn_Ouidah,300000,75444,Thierry Delattre-Simon,225130,449686,2022-04-17
CASH_IN,13384,Agence_mtn_Ouidah,300000,286616,Thierry Delattre-Simon,449686,463070,2022-04-18
CASH_OUT,109455,Thierry Delattre-Simon,463070,353615,Agence_mtn_Cotonou,300000,190545,2022-04-19
CASH_IN,248900,Agence_mtn_Ouidah,300000,51100,Thierry Delattre-Simon,353615,602515,2022-04-20
CASH_OUT,128467,Thierry Delattre-Simon,602515,474048,Agence_mtn_Abomey,300000,171533,2022-04-24
CASH_OUT,246117,Thierry Delattre-Simon,474048,227931,Agence_mtn_Ouidah,300000,53883,2022-04-24
CASH_OUT,188691,Thierry Delattre-Simon,227931,39240,Agence_mtn_Ouidah,300000,111309,2022-04-27
CASH_IN,287117,Agence_mtn_Abomey,300000,12883,Astrid Gay de la Brunet,-64764,222353,2022-04-01
CASH_IN,194351,Agence_mtn_Abomey,300000,105649,Astrid Gay de la Brunet,222353,416704,2022-04-08
CASH_IN,201038,Agence_mtn_Cotonou,300000,98962,Astrid Gay de la Brunet,416704,617742,2022-04-09
CASH_IN,287185,Agence_mtn_Cotonou,300000,12815,Astrid Gay de la Brunet,617742,904927,2022-04-09
CASH_OUT,299734,Astrid Gay de la Brunet,904927,605193,Agence_mtn_Abomey,300000,266,2022-04-13
CASH_IN,271881,Agence_mtn_Cotonou,300000,28119,Astrid Gay de la Brunet,605193,877074,2022-04-15
CASH_OUT,546679,Astrid Gay de la Brunet,877074,330395,Agence_mtn_Abomey,300000,-246679,2022-04-16
CASH_IN,3404,Agence_mtn_Cotonou,300000,296596,Astrid Gay de la Brunet,330395,333799,2022-04-17
TRANSFER,302901,Astrid Gay de la Brunet,333799,30898,Astrid Gay de la Brunet,333799,30898,2022-04-21
CASH_OUT,30175,Astrid Gay de la Brunet,30898,723,Agence_mtn_Abomey,300000,269825,2022-04-22
CASH_IN,28840,Agence_mtn_Ouidah,300000,271160,Astrid Gay de la Brunet,723,29563,2022-04-24
CASH_IN,77421,Agence_mtn_Cotonou,300000,222579,Joséphine Gros,-209633,-132212,2022-04-04
CASH_IN,88569,Agence_mtn_Cotonou,300000,211431,Joséphine Gros,-132212,-43643,2022-04-05
CASH_IN,112191,Agence_mtn_Cotonou,300000,187809,Joséphine Gros,-43643,68548,2022-04-09
CASH_OUT,13044,Joséphine Gros,68548,55504,Agence_mtn_Cotonou,300000,286956,2022-04-12
CASH_IN,70029,Agence_mtn_Cotonou,300000,229971,Joséphine Gros,55504,125533,2022-04-21
CASH_IN,67757,Agence_mtn_Cotonou,300000,232243,Joséphine Gros,125533,193290,2022-04-21
CASH_IN,252256,Agence_mtn_Ouidah,300000,47744,Joséphine Gros,193290,445546,2022-04-23
CASH_OUT,207079,Joséphine Gros,445546,238467,Agence_mtn_Ouidah,300000,92921,2022-04-24
CASH_IN,123642,Agence_mtn_Ouidah,300000,176358,Émilie Moulin,-152142,-28500,2022-04-01
CASH_IN,22192,Agence_mtn_Ouidah,300000,277808,Émilie Moulin,-28500,-6308,2022-04-02
CASH_IN,163447,Agence_mtn_Ouidah,300000,136553,Émilie Moulin,-6308,157139,2022-04-14
CASH_IN,33892,Agence_mtn_Cotonou,300000,266108,Émilie Moulin,157139,191031,2022-04-15
CASH_OUT,130924,Émilie Moulin,191031,60107,Agence_mtn_Cotonou,300000,169076,2022-04-19
CASH_IN,211950,Agence_mtn_Cotonou,300000,88050,Émilie Moulin,60107,272057,2022-04-22
CASH_IN,204695,Agence_mtn_Cotonou,300000,95305,Émilie Moulin,272057,476752,2022-04-23
CASH_IN,55770,Agence_mtn_Ouidah,300000,244230,Bertrand Charles,-98758,-42988,2022-04-09
CASH_IN,13984,Agence_mtn_Ouidah,300000,286016,Bertrand Charles,-42988,-29004,2022-04-10
CASH_IN,46041,Agence_mtn_Cotonou,300000,253959,Bertrand Charles,-29004,17037,2022-04-10
CASH_OUT,16329,Bertrand Charles,17037,708,Agence_mtn_Ouidah,300000,283671,2022-04-13
CASH_OUT,222,Bertrand Charles,708,486,Agence_mtn_Ouidah,300000,299778,2022-04-13
CASH_IN,65813,Agence_mtn_Cotonou,300000,234187,Bertrand Charles,486,66299,2022-04-13
TRANSFER,50672,Bertrand Charles,66299,15627,Bertrand Charles,66299,116971,2022-04-13
TRANSFER,11928,Bertrand Charles,15627,3699,Bertrand Charles,15627,27555,2022-04-15
CASH_OUT,621,Bertrand Charles,3699,3078,Agence_mtn_Cotonou,300000,299379,2022-04-23
CASH_IN,229223,Agence_mtn_Abomey,300000,70777,Isabelle Rossi,-14685,214538,2022-04-04
CASH_IN,174102,Agence_mtn_Abomey,300000,125898,Isabelle Rossi,214538,388640,2022-04-05
TRANSFER,352221,Isabelle Rossi,388640,36419,Isabelle Rossi,388640,36419,2022-04-06
TRANSFER,16887,Isabelle Rossi,36419,19532,Isabelle Rossi,36419,19532,2022-04-06
CASH_IN,93297,Agence_mtn_Cotonou,300000,206703,Isabelle Rossi,19532,112829,2022-04-06
CASH_IN,42935,Agence_mtn_Ouidah,300000,257065,Isabelle Rossi,112829,155764,2022-04-07
TRANSFER,105956,Isabelle Rossi,155764,49808,Isabelle Rossi,155764,261720,2022-04-08
CASH_IN,46102,Agence_mtn_Cotonou,300000,253898,Isabelle Rossi,49808,95910,2022-04-08
CASH_IN,106972,Agence_mtn_Ouidah,300000,193028,Isabelle Rossi,95910,202882,2022-04-11
CASH_OUT,76222,Isabelle Rossi,202882,126660,Agence_mtn_Ouidah,300000,223778,2022-04-11
CASH_OUT,15026,Isabelle Rossi,126660,111634,Agence_mtn_Cotonou,300000,284974,2022-04-14
CASH_IN,28257,Agence_mtn_Abomey,300000,271743,Isabelle Rossi,111634,139891,2022-04-15
CASH_IN,137875,Agence_mtn_Ouidah,300000,162125,Isabelle Rossi,139891,277766,2022-04-21
CASH_OUT,94982,Isabelle Rossi,277766,182784,Agence_mtn_Ouidah,300000,205018,2022-04-22
CASH_IN,96249,Agence_mtn_Cotonou,300000,203751,Isabelle Rossi,182784,279033,2022-04-23
CASH_OUT,125965,Isabelle Rossi,279033,153068,Agence_mtn_Cotonou,300000,174035,2022-04-26
CASH_IN,74462,Agence_mtn_Abomey,300000,225538,Valérie Dijoux,-2884,71578,2022-04-01
CASH_IN,115058,Agence_mtn_Abomey,300000,184942,Valérie Dijoux,71578,186636,2022-04-01
CASH_IN,182201,Agence_mtn_Ouidah,300000,117799,Valérie Dijoux,186636,368837,2022-04-02
CASH_OUT,208824,Valérie Dijoux,368837,160013,Agence_mtn_Cotonou,300000,91176,2022-04-08
CASH_IN,178994,Agence_mtn_Cotonou,300000,121006,Valérie Dijoux,160013,339007,2022-04-12
CASH_IN,87728,Agence_mtn_Ouidah,300000,212272,Valérie Dijoux,339007,426735,2022-04-15
CASH_IN,142358,Agence_mtn_Cotonou,300000,157642,Valérie Dijoux,426735,569093,2022-04-18
CASH_IN,144492,Agence_mtn_Abomey,300000,155508,Valérie Dijoux,569093,713585,2022-04-18
CASH_OUT,43515,Valérie Dijoux,713585,670070,Agence_mtn_Abomey,300000,256485,2022-04-21
CASH_OUT,284280,Valérie Dijoux,670070,385790,Agence_mtn_Cotonou,300000,15720,2022-04-22
CASH_IN,260523,Agence_mtn_Abomey,300000,39477,Roland Garcia,-53546,206977,2022-04-02
TRANSFER,56104,Roland Garcia,206977,150873,Roland Garcia,206977,150873,2022-04-03
TRANSFER,80165,Roland Garcia,150873,70708,Roland Garcia,150873,70708,2022-04-04
CASH_IN,152713,Agence_mtn_Ouidah,300000,147287,Roland Garcia,70708,223421,2022-04-09
TRANSFER,71174,Roland Garcia,223421,152247,Roland Garcia,223421,294595,2022-04-11
TRANSFER,110578,Roland Garcia,152247,41669,Roland Garcia,152247,262825,2022-04-12
CASH_IN,270142,Agence_mtn_Cotonou,300000,29858,Roland Garcia,41669,311811,2022-04-17
CASH_IN,203937,Agence_mtn_Ouidah,300000,96063,Roland Garcia,311811,515748,2022-04-17
CASH_IN,220739,Agence_mtn_Cotonou,300000,79261,Roland Garcia,515748,736487,2022-04-17
CASH_OUT,115711,Roland Garcia,736487,620776,Agence_mtn_Abomey,300000,184289,2022-04-21
CASH_OUT,383921,Roland Garcia,620776,236855,Agence_mtn_Ouidah,300000,-83921,2022-04-22
CASH_OUT,107838,Roland Garcia,236855,129017,Agence_mtn_Cotonou,300000,192162,2022-04-23
CASH_OUT,19631,Roland Garcia,129017,109386,Agence_mtn_Abomey,300000,280369,2022-04-27
CASH_IN,15438,Agence_mtn_Cotonou,300000,284562,William Lebrun,-805935,-790497,2022-04-04
CASH_IN,229580,Agence_mtn_Cotonou,300000,70420,William Lebrun,-790497,-560917,2022-04-09
CASH_IN,290571,Agence_mtn_Ouidah,300000,9429,William Lebrun,-560917,-270346,2022-04-14
CASH_IN,97400,Agence_mtn_Cotonou,300000,202600,William Lebrun,-270346,-172946,2022-04-19
CASH_IN,59427,Agence_mtn_Ouidah,300000,240573,William Lebrun,-172946,-113519,2022-04-23
CASH_IN,240759,Agence_mtn_Abomey,300000,59241,William Lebrun,-113519,127240,2022-04-25
CASH_IN,211662,Agence_mtn_Ouidah,300000,88338,Margot Renaud,-65322,146340,2022-04-01
TRANSFER,98842,Margot Renaud,146340,47498,Margot Renaud,146340,47498,2022-04-02
CASH_OUT,36067,Margot Renaud,47498,11431,Agence_mtn_Abomey,300000,263933,2022-04-06
CASH_OUT,1199,Margot Renaud,11431,10232,Agence_mtn_Abomey,300000,298801,2022-04-09
CASH_OUT,5214,Margot Renaud,10232,5018,Agence_mtn_Cotonou,300000,294786,2022-04-10
CASH_IN,113942,Agence_mtn_Cotonou,300000,186058,Margot Renaud,5018,118960,2022-04-15
CASH_OUT,2143,Margot Renaud,118960,116817,Agence_mtn_Abomey,300000,297857,2022-04-15
CASH_OUT,86106,Margot Renaud,116817,30711,Agence_mtn_Abomey,300000,213894,2022-04-16
CASH_OUT,29686,Margot Renaud,30711,1025,Agence_mtn_Abomey,300000,270314,2022-04-22
CASH_IN,42345,Agence_mtn_Cotonou,300000,257655,Margot Renaud,1025,43370,2022-04-24
CASH_OUT,28941,Margot Renaud,43370,14429,Agence_mtn_Ouidah,300000,271059,2022-04-26
CASH_IN,31787,Agence_mtn_Abomey,300000,268213,Gabriel Humbert,-65543,-33756,2022-04-04
CASH_IN,286397,Agence_mtn_Ouidah,300000,13603,Gabriel Humbert,-33756,252641,2022-04-06
TRANSFER,66716,Gabriel Humbert,252641,185925,Gabriel Humbert,252641,185925,2022-04-08
CASH_OUT,181351,Gabriel Humbert,185925,4574,Agence_mtn_Abomey,300000,118649,2022-04-15
CASH_OUT,136,Gabriel Humbert,4574,4438,Agence_mtn_Abomey,300000,299864,2022-04-16
CASH_IN,61391,Agence_mtn_Abomey,300000,238609,Gabriel Humbert,4438,65829,2022-04-19
CASH_IN,33915,Agence_mtn_Ouidah,300000,266085,Gabriel Humbert,65829,99744,2022-04-25
CASH_OUT,4349,Gabriel Humbert,99744,95395,Agence_mtn_Ouidah,300000,295651,2022-04-27
CASH_OUT,290664,Thibaut Coulon,380500,89836,Agence_mtn_Cotonou,300000,9336,2022-05-06
TRANSFER,146022,Louise Girard,199800,53778,Eugène Poulain,1064100,1210122,2022-05-19
TRANSFER,437790,Gilbert-Charles Thibault,547500,109710,Michelle Lebon,371900,-65890,2022-05-02
TRANSFER,54071,Gilbert-Charles Thibault,109710,55639,Benjamin Evrard-Marty,512700,458629,2022-05-08
TRANSFER,53913,Gilbert-Charles Thibault,55639,1726,Isabelle Rossi,911600,857687,2022-05-18
CASH_OUT,1487,Gilbert-Charles Thibault,1726,239,Agence_mtn_Abomey,300000,298513,2022-05-24
CASH_OUT,141,Gilbert-Charles Thibault,239,98,Agence_mtn_Cotonou,300000,299859,2022-05-24
TRANSFER,135455,Sophie Gonzalez,179500,44045,Cécile Germain,1029400,893945,2022-05-01
CASH_OUT,10391,Sophie Gonzalez,44045,33654,Agence_mtn_Cotonou,300000,289609,2022-05-21
CASH_OUT,903918,Laurent-Bertrand Lefort,1219000,315082,Agence_mtn_Abomey,300000,-603918,2022-05-08
TRANSFER,526095,Victoire-Nicole Lopez,1706700,1180605,Nath Bruneau,711400,1237495,2022-05-19
CASH_OUT,97345,Nath Bruneau,1237495,1140150,Agence_mtn_Abomey,300000,202655,2022-05-23
CASH_IN,285403,Agence_mtn_Cotonou,300000,14597,Nath Bruneau,1140150,1425553,2022-05-26
CASH_OUT,195370,Théodore De Oliveira-Nicolas,1041000,845630,Agence_mtn_Abomey,300000,104630,2022-05-06
TRANSFER,233512,Cécile Clerc,263200,29688,Marcelle Charrier,352400,585912,2022-05-12
TRANSFER,310516,Marcelle Charrier,585912,275396,Rémy de la Roux,155900,-154616,2022-05-15
CASH_IN,172683,Agence_mtn_Ouidah,300000,127317,Marcelle Charrier,275396,448079,2022-05-15
TRANSFER,404168,Marcelle Charrier,448079,43911,Valentine Richard-Bourdon,1808400,1404232,2022-05-26
TRANSFER,470896,Marcelle Paris,528800,57904,Xavier de Lebreton,1263100,1733996,2022-05-05
TRANSFER,99165,Benjamin Evrard-Marty,458629,359464,Xavier de Lebreton,1733996,1833161,2022-05-11
CASH_OUT,1168675,Xavier de Lebreton,1833161,664486,Agence_mtn_Cotonou,300000,-868675,2022-05-17
CASH_IN,53849,Agence_mtn_Abomey,300000,246151,Xavier de Lebreton,664486,718335,2022-05-27
TRANSFER,350047,Virginie Le Gall,1175300,825253,Vincent Mathieu,1890300,2240347,2022-05-02
CASH_IN,201445,Agence_mtn_Ouidah,300000,98555,Vincent Mathieu,2240347,2441792,2022-05-16
CASH_IN,159860,Agence_mtn_Ouidah,300000,140140,Vincent Mathieu,2441792,2601652,2022-05-20
CASH_OUT,216107,Martine Wagner de la Bègue,629700,413593,Agence_mtn_Ouidah,300000,83893,2022-05-10
CASH_IN,143453,Agence_mtn_Abomey,300000,156547,Martine Wagner de la Bègue,413593,557046,2022-05-14
TRANSFER,513424,Martine Wagner de la Bègue,557046,43622,Léon Lecoq,180200,-333224,2022-05-20
CASH_IN,126547,Agence_mtn_Abomey,300000,173453,Martine Wagner de la Bègue,43622,170169,2022-05-23
TRANSFER,23811,Marcelle Paris,57904,34093,Raymond Rossi,834100,810289,2022-05-06
TRANSFER,218292,Geneviève Grondin,247200,28908,Marcelle Paris,34093,252385,2022-05-14
CASH_OUT,18083,Marcelle Paris,252385,234302,Agence_mtn_Cotonou,300000,281917,2022-05-17
CASH_IN,123244,Agence_mtn_Ouidah,300000,176756,Marcelle Paris,234302,357546,2022-05-27
CASH_IN,284065,Agence_mtn_Ouidah,300000,15935,Alexandre Rémy,1742700,2026765,2022-05-07
CASH_IN,10389,Agence_mtn_Cotonou,300000,289611,Alexandre Rémy,2026765,2037154,2022-05-27
CASH_OUT,1181820,Alexandre Rémy,2037154,855334,Agence_mtn_Abomey,300000,-881820,2022-05-27
CASH_IN,174174,Agence_mtn_Abomey,300000,125826,Michelle Lebon,-65890,108284,2022-05-10
TRANSFER,210787,Céline Gomez,412700,201913,Michelle Lebon,108284,319071,2022-05-15
CASH_IN,48477,Agence_mtn_Cotonou,300000,251523,Michelle Lebon,319071,367548,2022-05-27
CASH_IN,33374,Agence_mtn_Cotonou,300000,266626,William Lebrun,1441100,1474474,2022-05-02
CASH_IN,40575,Agence_mtn_Cotonou,300000,259425,William Lebrun,1474474,1515049,2022-05-04
TRANSFER,23704,William Lebrun,1515049,1491345,David du Blondel,565900,542196,2022-05-10
TRANSFER,1419860,François Michel-Legros,1571500,151640,William Lebrun,1491345,2911205,2022-05-16
TRANSFER,1490902,William Lebrun,2911205,1420303,Franck-Charles Texier,1594300,103398,2022-05-27
CASH_OUT,658533,Raymond Rossi,810289,151756,Agence_mtn_Ouidah,300000,-358533,2022-05-18
TRANSFER,8913,Raymond Rossi,151756,142843,Valentine Martinez,1323600,1314687,2022-05-26
TRANSFER,6192,Inès Hamon,28100,21908,William Le Lucas,1874500,1868308,2022-05-14
CASH_IN,41988,Agence_mtn_Cotonou,300000,258012,Gilbert Foucher,511100,553088,2022-05-01
TRANSFER,467126,Gilbert Foucher,553088,85962,Valentine Richard-Bourdon,1404232,937106,2022-05-11
TRANSFER,85345,Gilbert Foucher,85962,617,Antoine Leleu,405400,320055,2022-05-11
CASH_OUT,497,Gilbert Foucher,617,120,Agence_mtn_Ouidah,300000,299503,2022-05-20
CASH_OUT,647389,Aurore Guyon,660600,13211,Agence_mtn_Ouidah,300000,-347389,2022-05-02
TRANSFER,6793,Aurore Guyon,13211,6418,Simone Pineau,592200,585407,2022-05-21
CASH_IN,259597,Agence_mtn_Cotonou,300000,40403,Raymond Marchal de Nguyen,1479300,1738897,2022-05-11
CASH_OUT,1278892,Raymond Marchal de Nguyen,1738897,460005,Agence_mtn_Cotonou,300000,-978892,2022-05-25
CASH_IN,33551,Agence_mtn_Ouidah,300000,266449,Inès de Letellier,1033300,1066851,2022-05-06
CASH_IN,148181,Agence_mtn_Abomey,300000,151819,Inès de Letellier,1066851,1215032,2022-05-12
TRANSFER,40834,François Michel-Legros,151640,110806,Laure Philippe,585600,626434,2022-05-11
CASH_IN,154812,Agence_mtn_Ouidah,300000,145188,Alphonse Le Olivier,1068300,1223112,2022-05-04
CASH_OUT,1016230,Alphonse Le Olivier,1223112,206882,Agence_mtn_Abomey,300000,-716230,2022-05-14
CASH_IN,264436,Agence_mtn_Abomey,300000,35564,Alphonse Le Olivier,206882,471318,2022-05-16
CASH_OUT,458262,Alphonse Le Olivier,471318,13056,Agence_mtn_Cotonou,300000,-158262,2022-05-18
CASH_OUT,6451,Alphonse Le Olivier,13056,6605,Agence_mtn_Abomey,300000,293549,2022-05-23
CASH_IN,165541,Agence_mtn_Abomey,300000,134459,Thierry Delattre-Simon,15800,181341,2022-05-01
CASH_IN,240072,Agence_mtn_Ouidah,300000,59928,Thierry Delattre-Simon,181341,421413,2022-05-17
CASH_IN,262129,Agence_mtn_Cotonou,300000,37871,Thierry Delattre-Simon,421413,683542,2022-05-20
TRANSFER,610416,Cécile Germain,893945,283529,Catherine Faivre,1886400,2496816,2022-05-07
TRANSFER,889884,Édouard Nguyen,1390000,500116,Catherine Faivre,2496816,3386700,2022-05-11
CASH_OUT,3105447,Catherine Faivre,3386700,281253,Agence_mtn_Ouidah,300000,-2805447,2022-05-20
CASH_IN,278147,Agence_mtn_Cotonou,300000,21853,Catherine Faivre,281253,559400,2022-05-26
CASH_IN,98376,Agence_mtn_Abomey,300000,201624,Rémy de la Roux,-154616,-56240,2022-05-01
CASH_IN,15027,Agence_mtn_Ouidah,300000,284973,Rémy de la Roux,-56240,-41213,2022-05-02
CASH_IN,265188,Agence_mtn_Abomey,300000,34812,Rémy de la Roux,-41213,223975,2022-05-04
CASH_OUT,191282,Rémy de la Roux,223975,32693,Agence_mtn_Cotonou,300000,108718,2022-05-06
CASH_OUT,3042,Rémy de la Roux,32693,29651,Agence_mtn_Abomey,300000,296958,2022-05-07
TRANSFER,14281,Rémy de la Roux,29651,15370,Sophie Lévêque,784900,770619,2022-05-08
CASH_OUT,4306,Rémy de la Roux,15370,11064,Agence_mtn_Cotonou,300000,295694,2022-05-10
CASH_OUT,1508,Rémy de la Roux,11064,9556,Agence_mtn_Ouidah,300000,298492,2022-05-10
CASH_IN,237143,Agence_mtn_Abomey,300000,62857,Rémy de la Roux,9556,246699,2022-05-10
CASH_OUT,3584,Rémy de la Roux,246699,243115,Agence_mtn_Abomey,300000,296416,2022-05-11
CASH_IN,297434,Agence_mtn_Ouidah,300000,2566,Rémy de la Roux,243115,540549,2022-05-12
CASH_IN,262438,Agence_mtn_Ouidah,300000,37562,Rémy de la Roux,540549,802987,2022-05-12
CASH_OUT,748901,Rémy de la Roux,802987,54086,Agence_mtn_Ouidah,300000,-448901,2022-05-14
CASH_OUT,52119,Rémy de la Roux,54086,1967,Agence_mtn_Abomey,300000,247881,2022-05-14
CASH_OUT,1570,Rémy de la Roux,1967,397,Agence_mtn_Ouidah,300000,298430,2022-05-16
CASH_OUT,321,Rémy de la Roux,397,76,Agence_mtn_Abomey,300000,299679,2022-05-16
CASH_IN,43983,Agence_mtn_Ouidah,300000,256017,Rémy de la Roux,76,44059,2022-05-17
CASH_OUT,26258,Rémy de la Roux,44059,17801,Agence_mtn_Cotonou,300000,273742,2022-05-17
TRANSFER,834725,Joséphine Gros,1037400,202675,Rémy de la Roux,17801,852526,2022-05-18
TRANSFER,820786,Rémy de la Roux,852526,31740,Corinne-Louise Valentin,1403200,582414,2022-05-19
TRANSFER,1344782,Antoinette Bertrand,1391800,47018,Rémy de la Roux,31740,1376522,2022-05-20
CASH_OUT,110467,Rémy de la Roux,1376522,1266055,Agence_mtn_Abomey,300000,189533,2022-05-20
CASH_OUT,779048,Rémy de la Roux,1266055,487007,Agence_mtn_Cotonou,300000,-479048,2022-05-22
CASH_OUT,224817,Rémy de la Roux,487007,262190,Agence_mtn_Cotonou,300000,75183,2022-05-22
CASH_IN,49431,Agence_mtn_Abomey,300000,250569,Rémy de la Roux,262190,311621,2022-05-22
CASH_IN,206968,Agence_mtn_Abomey,300000,93032,Rémy de la Roux,311621,518589,2022-05-23
CASH_OUT,215359,Rémy de la Roux,518589,303230,Agence_mtn_Abomey,300000,84641,2022-05-23
CASH_OUT,108050,Rémy de la Roux,303230,195180,Agence_mtn_Ouidah,300000,191950,2022-05-27
TRANSFER,91088,Rémy de la Roux,195180,104092,Adèle Labbé,468900,377812,2022-05-27
TRANSFER,556886,Simone Pineau,585407,28521,David du Blondel,542196,-14690,2022-05-01
CASH_IN,206584,Agence_mtn_Abomey,300000,93416,Simone Pineau,28521,235105,2022-05-02
CASH_IN,114394,Agence_mtn_Ouidah,300000,185606,Simone Pineau,235105,349499,2022-05-02
CASH_OUT,288734,Simone Pineau,349499,60765,Agence_mtn_Ouidah,300000,11266,2022-05-03
TRANSFER,17708,Simone Pineau,60765,43057,Vincent Fournier,1208200,1190492,2022-05-04
TRANSFER,435207,Cécile Delattre-Arnaud,693100,257893,Simone Pineau,43057,478264,2022-05-04
CASH_IN,299819,Agence_mtn_Ouidah,300000,181,Simone Pineau,478264,778083,2022-05-05
CASH_IN,34796,Agence_mtn_Cotonou,300000,265204,Simone Pineau,778083,812879,2022-05-06
CASH_IN,23375,Agence_mtn_Abomey,300000,276625,Simone Pineau,812879,836254,2022-05-06
CASH_OUT,675631,Simone Pineau,836254,160623,Agence_mtn_Ouidah,300000,-375631,2022-05-06
CASH_OUT,125269,Simone Pineau,160623,35354,Agence_mtn_Cotonou,300000,174731,2022-05-07
CASH_IN,212454,Agence_mtn_Ouidah,300000,87546,Simone Pineau,35354,247808,2022-05-08
CASH_OUT,106619,Simone Pineau,247808,141189,Agence_mtn_Abomey,300000,193381,2022-05-12
TRANSFER,522268,Corinne-Louise Valentin,582414,60146,Simone Pineau,141189,663457,2022-05-13
CASH_OUT,455758,Simone Pineau,663457,207699,Agence_mtn_Cotonou,300000,-155758,2022-05-13
CASH_OUT,38182,Simone Pineau,207699,169517,Agence_mtn_Abomey,300000,261818,2022-05-14
CASH_OUT,32467,Simone Pineau,169517,137050,Agence_mtn_Abomey,300000,267533,2022-05-15
CASH_IN,12743,Agence_mtn_Cotonou,300000,287257,Simone Pineau,137050,149793,2022-05-19
CASH_OUT,51309,Simone Pineau,149793,98484,Agence_mtn_Cotonou,300000,248691,2022-05-19
CASH_OUT,9649,Simone Pineau,98484,88835,Agence_mtn_Ouidah,300000,290351,2022-05-21
CASH_IN,165862,Agence_mtn_Cotonou,300000,134138,Simone Pineau,88835,254697,2022-05-22
CASH_IN,92447,Agence_mtn_Abomey,300000,207553,Simone Pineau,254697,347144,2022-05-22
CASH_IN,104899,Agence_mtn_Cotonou,300000,195101,Simone Pineau,347144,452043,2022-05-23
CASH_IN,168690,Agence_mtn_Cotonou,300000,131310,Simone Pineau,452043,620733,2022-05-25
TRANSFER,411378,Claude Foucher,1139000,727622,Simone Pineau,620733,1032111,2022-05-25
CASH_OUT,843664,Simone Pineau,1032111,188447,Agence_mtn_Abomey,300000,-543664,2022-05-27
CASH_OUT,1509328,Adrien Chartier,1752500,243172,Agence_mtn_Ouidah,300000,-1209328,2022-05-02
TRANSFER,115357,Céline Gomez,201913,86556,Adrien Chartier,243172,358529,2022-05-02
CASH_OUT,251159,Adrien Chartier,358529,107370,Agence_mtn_Cotonou,300000,48841,2022-05-03
CASH_OUT,51399,Adrien Chartier,107370,55971,Agence_mtn_Abomey,300000,248601,2022-05-03
CASH_OUT,17096,Adrien Chartier,55971,38875,Agence_mtn_Ouidah,300000,282904,2022-05-03
CASH_IN,50654,Agence_mtn_Cotonou,300000,249346,Adrien Chartier,38875,89529,2022-05-05
CASH_IN,121828,Agence_mtn_Abomey,300000,178172,Adrien Chartier,89529,211357,2022-05-06
CASH_IN,128242,Agence_mtn_Abomey,300000,171758,Adrien Chartier,211357,339599,2022-05-06
CASH_IN,280747,Agence_mtn_Ouidah,300000,19253,Adrien Chartier,339599,620346,2022-05-07
CASH_IN,264139,Agence_mtn_Abomey,300000,35861,Adrien Chartier,620346,884485,2022-05-08
TRANSFER,134939,Claude Foucher,727622,592683,Adrien Chartier,884485,1019424,2022-05-12
CASH_IN,221238,Agence_mtn_Cotonou,300000,78762,Adrien Chartier,1019424,1240662,2022-05-13
CASH_OUT,23269,Adrien Chartier,1240662,1217393,Agence_mtn_Ouidah,300000,276731,2022-05-14
TRANSFER,50545,Franck-Charles Texier,103398,52853,Adrien Chartier,1217393,1267938,2022-05-15
CASH_IN,123654,Agence_mtn_Cotonou,300000,176346,Adrien Chartier,1267938,1391592,2022-05-15
CASH_OUT,1122579,Adrien Chartier,1391592,269013,Agence_mtn_Ouidah,300000,-822579,2022-05-15
CASH_IN,113276,Agence_mtn_Ouidah,300000,186724,Adrien Chartier,269013,382289,2022-05-18
CASH_OUT,182806,Adrien Chartier,382289,199483,Agence_mtn_Abomey,300000,117194,2022-05-18
CASH_IN,28226,Agence_mtn_Ouidah,300000,271774,Adrien Chartier,199483,227709,2022-05-19
CASH_OUT,148225,Adrien Chartier,227709,79484,Agence_mtn_Abomey,300000,151775,2022-05-19
CASH_IN,181584,Agence_mtn_Cotonou,300000,118416,Adrien Chartier,79484,261068,2022-05-19
TRANSFER,400350,Claude Foucher,592683,192333,Adrien Chartier,261068,661418,2022-05-21
CASH_IN,169372,Agence_mtn_Abomey,300000,130628,Adrien Chartier,661418,830790,2022-05-21
CASH_OUT,270209,Adrien Chartier,830790,560581,Agence_mtn_Cotonou,300000,29791,2022-05-22
TRANSFER,243441,Éléonore-Hélène Dubois,698600,455159,Adrien Chartier,560581,804022,2022-05-23
TRANSFER,821762,Richard Le Descamps,1239000,417238,Adrien Chartier,804022,1625784,2022-05-24
TRANSFER,719166,Margot Riou du Fernandes,1167700,448534,Adrien Chartier,1625784,2344950,2022-05-26
CASH_OUT,1220295,Adrien Chartier,2344950,1124655,Agence_mtn_Abomey,300000,-920295,2022-05-27
CASH_IN,141282,Agence_mtn_Ouidah,300000,158718,Alix Maillet,1323700,1464982,2022-05-02
CASH_OUT,1000308,Alix Maillet,1464982,464674,Agence_mtn_Abomey,300000,-700308,2022-05-03
CASH_IN,154541,Agence_mtn_Ouidah,300000,145459,Alix Maillet,464674,619215,2022-05-03
CASH_IN,59017,Agence_mtn_Abomey,300000,240983,Alix Maillet,619215,678232,2022-05-03
TRANSFER,77941,Valentine Richard-Bourdon,937106,859165,Alix Maillet,678232,756173,2022-05-03
CASH_OUT,199289,Alix Maillet,756173,556884,Agence_mtn_Abomey,300000,100711,2022-05-03
CASH_OUT,158105,Alix Maillet,556884,398779,Agence_mtn_Abomey,300000,141895,2022-05-04
TRANSFER,3549,Corinne-Louise Valentin,60146,56597,Alix Maillet,398779,402328,2022-05-06
TRANSFER,81094,Alix Maillet,402328,321234,Jeanne Garnier,1838500,1757406,2022-05-06
TRANSFER,754450,Étienne Roche,1374900,620450,Alix Maillet,321234,1075684,2022-05-07
CASH_OUT,684158,Alix Maillet,1075684,391526,Agence_mtn_Cotonou,300000,-384158,2022-05-07
TRANSFER,68084,Alix Maillet,391526,323442,Emmanuelle Georges,864200,796116,2022-05-07
CASH_IN,268866,Agence_mtn_Ouidah,300000,31134,Alix Maillet,323442,592308,2022-05-07
TRANSFER,201534,Emmanuelle Georges,796116,594582,Alix Maillet,592308,793842,2022-05-08
CASH_IN,89382,Agence_mtn_Abomey,300000,210618,Alix Maillet,793842,883224,2022-05-09
TRANSFER,608172,Alix Maillet,883224,275052,Antoinette Bertrand,47018,-561154,2022-05-10
CASH_IN,227357,Agence_mtn_Cotonou,300000,72643,Alix Maillet,275052,502409,2022-05-17
CASH_OUT,95744,Alix Maillet,502409,406665,Agence_mtn_Cotonou,300000,204256,2022-05-18
CASH_OUT,296769,Alix Maillet,406665,109896,Agence_mtn_Ouidah,300000,3231,2022-05-22
CASH_OUT,38006,Alix Maillet,109896,71890,Agence_mtn_Abomey,300000,261994,2022-05-23
TRANSFER,354612,Nathalie Peron,1094000,739388,Alix Maillet,71890,426502,2022-05-24
CASH_OUT,124708,Alix Maillet,426502,301794,Agence_mtn_Cotonou,300000,175292,2022-05-26
CASH_IN,292123,Agence_mtn_Cotonou,300000,7877,Alix Maillet,301794,593917,2022-05-27
CASH_IN,110939,Agence_mtn_Ouidah,300000,189061,Valérie Dijoux,1925300,2036239,2022-05-01
TRANSFER,426200,Louis Pichon,1396800,970600,Valérie Dijoux,2036239,2462439,2022-05-01
CASH_OUT,294060,Valérie Dijoux,2462439,2168379,Agence_mtn_Abomey,300000,5940,2022-05-02
CASH_OUT,137211,Valérie Dijoux,2168379,2031168,Agence_mtn_Cotonou,300000,162789,2022-05-04
TRANSFER,1883721,Valérie Dijoux,2031168,147447,Xavier Leblanc-Ferreira,1340400,-543321,2022-05-04
CASH_IN,9016,Agence_mtn_Cotonou,300000,290984,Valérie Dijoux,147447,156463,2022-05-05
CASH_OUT,119923,Valérie Dijoux,156463,36540,Agence_mtn_Abomey,300000,180077,2022-05-05
CASH_IN,182197,Agence_mtn_Cotonou,300000,117803,Valérie Dijoux,36540,218737,2022-05-05
CASH_OUT,195340,Valérie Dijoux,218737,23397,Agence_mtn_Cotonou,300000,104660,2022-05-05
TRANSFER,7232,Valérie Dijoux,23397,16165,Nathalie Peron,739388,732156,2022-05-07
TRANSFER,238541,Antoine Leleu,320055,81514,Valérie Dijoux,16165,254706,2022-05-08
TRANSFER,4627,Cécile Clerc,29688,25061,Valérie Dijoux,254706,259333,2022-05-10
CASH_IN,46481,Agence_mtn_Abomey,300000,253519,Valérie Dijoux,259333,305814,2022-05-11
CASH_IN,10951,Agence_mtn_Abomey,300000,289049,Valérie Dijoux,305814,316765,2022-05-13
CASH_IN,268598,Agence_mtn_Ouidah,300000,31402,Valérie Dijoux,316765,585363,2022-05-13
CASH_OUT,297030,Valérie Dijoux,585363,288333,Agence_mtn_Cotonou,300000,2970,2022-05-15
CASH_OUT,133507,Valérie Dijoux,288333,154826,Agence_mtn_Abomey,300000,166493,2022-05-15
CASH_IN,45500,Agence_mtn_Ouidah,300000,254500,Valérie Dijoux,154826,200326,2022-05-15
CASH_IN,222053,Agence_mtn_Cotonou,300000,77947,Valérie Dijoux,200326,422379,2022-05-16
CASH_OUT,136544,Valérie Dijoux,422379,285835,Agence_mtn_Ouidah,300000,163456,2022-05-18
TRANSFER,785802,Marie Picard,1567500,781698,Valérie Dijoux,285835,1071637,2022-05-19
CASH_IN,140908,Agence_mtn_Ouidah,300000,159092,Valérie Dijoux,1071637,1212545,2022-05-20
CASH_IN,223677,Agence_mtn_Ouidah,300000,76323,Valérie Dijoux,1212545,1436222,2022-05-24
TRANSFER,785323,Valérie Dijoux,1436222,650899,Tristan Thomas,812000,26677,2022-05-26
CASH_OUT,437050,Valérie Dijoux,650899,213849,Agence_mtn_Abomey,300000,-137050,2022-05-27
CASH_IN,159850,Agence_mtn_Cotonou,300000,140150,Valérie Dijoux,213849,373699,2022-05-27
CASH_IN,152035,Agence_mtn_Ouidah,300000,147965,Édouard Nguyen,500116,652151,2022-05-02
CASH_IN,83112,Agence_mtn_Cotonou,300000,216888,Édouard Nguyen,652151,735263,2022-05-02
CASH_IN,223303,Agence_mtn_Cotonou,300000,76697,Édouard Nguyen,735263,958566,2022-05-03
CASH_IN,299146,Agence_mtn_Abomey,300000,854,Édouard Nguyen,958566,1257712,2022-05-03
TRANSFER,673585,Valentine Richard-Bourdon,859165,185580,Édouard Nguyen,1257712,1931297,2022-05-05
CASH_IN,231295,Agence_mtn_Ouidah,300000,68705,Édouard Nguyen,1931297,2162592,2022-05-05
CASH_IN,11920,Agence_mtn_Abomey,300000,288080,Édouard Nguyen,2162592,2174512,2022-05-06
CASH_IN,178730,Agence_mtn_Cotonou,300000,121270,Édouard Nguyen,2174512,2353242,2022-05-06
CASH_OUT,108439,Édouard Nguyen,2353242,2244803,Agence_mtn_Abomey,300000,191561,2022-05-07
TRANSFER,117714,Édouard Nguyen,2244803,2127089,Geneviève Grondin,28908,-88806,2022-05-08
CASH_OUT,1602519,Édouard Nguyen,2127089,524570,Agence_mtn_Cotonou,300000,-1302519,2022-05-09
CASH_IN,76786,Agence_mtn_Ouidah,300000,223214,Édouard Nguyen,524570,601356,2022-05-10
TRANSFER,35713,Alphonse Leclercq-Rousseau,1943500,1907787,Édouard Nguyen,601356,637069,2022-05-11
TRANSFER,541040,Édouard Nguyen,637069,96029,Bertrand Charles,475000,-66040,2022-05-11
CASH_OUT,72090,Édouard Nguyen,96029,23939,Agence_mtn_Ouidah,300000,227910,2022-05-11
CASH_OUT,3257,Édouard Nguyen,23939,20682,Agence_mtn_Ouidah,300000,296743,2022-05-12
CASH_IN,279797,Agence_mtn_Abomey,300000,20203,Édouard Nguyen,20682,300479,2022-05-15
CASH_IN,272827,Agence_mtn_Abomey,300000,27173,Édouard Nguyen,300479,573306,2022-05-16
TRANSFER,172094,Joséphine Gros,202675,30581,Édouard Nguyen,573306,745400,2022-05-16
CASH_OUT,405309,Édouard Nguyen,745400,340091,Agence_mtn_Abomey,300000,-105309,2022-05-18
CASH_OUT,307346,Édouard Nguyen,340091,32745,Agence_mtn_Ouidah,300000,-7346,2022-05-19
CASH_IN,90871,Agence_mtn_Cotonou,300000,209129,Édouard Nguyen,32745,123616,2022-05-20
CASH_OUT,103387,Édouard Nguyen,123616,20229,Agence_mtn_Ouidah,300000,196613,2022-05-21
CASH_IN,18698,Agence_mtn_Ouidah,300000,281302,Édouard Nguyen,20229,38927,2022-05-21
TRANSFER,1092605,William Le Lucas,1868308,775703,Édouard Nguyen,38927,1131532,2022-05-22
CASH_IN,32450,Agence_mtn_Cotonou,300000,267550,Édouard Nguyen,1131532,1163982,2022-05-23
CASH_IN,87267,Agence_mtn_Abomey,300000,212733,Édouard Nguyen,1163982,1251249,2022-05-23
CASH_IN,114671,Agence_mtn_Ouidah,300000,185329,Édouard Nguyen,1251249,1365920,2022-05-25
CASH_IN,136006,Agence_mtn_Cotonou,300000,163994,Édouard Nguyen,1365920,1501926,2022-05-25
TRANSFER,1037266,Édouard Nguyen,1501926,464660,Alphonse Leclercq-Rousseau,1907787,870521,2022-05-27
CASH_OUT,152046,Sophie Lévêque,770619,618573,Agence_mtn_Ouidah,300000,147954,2022-05-01
CASH_OUT,342215,Sophie Lévêque,618573,276358,Agence_mtn_Cotonou,300000,-42215,2022-05-03
TRANSFER,52734,Sophie Lévêque,276358,223624,Thérèse-Margaux Bruneau,476400,423666,2022-05-06
CASH_OUT,131163,Sophie Lévêque,223624,92461,Agence_mtn_Ouidah,300000,168837,2022-05-07
CASH_IN,153268,Agence_mtn_Ouidah,300000,146732,Sophie Lévêque,92461,245729,2022-05-07
TRANSFER,1084575,Marine Chauvet-Potier,1454100,369525,Sophie Lévêque,245729,1330304,2022-05-08
TRANSFER,900005,Margot Renaud,1151800,251795,Sophie Lévêque,1330304,2230309,2022-05-09
TRANSFER,791684,Sophie Lévêque,2230309,1438625,Éléonore-Hélène Dubois,455159,-336525,2022-05-12
CASH_OUT,1271646,Sophie Lévêque,1438625,166979,Agence_mtn_Cotonou,300000,-971646,2022-05-12
TRANSFER,38115,Sophie Lévêque,166979,128864,Étienne Roche,620450,582335,2022-05-13
CASH_OUT,126150,Sophie Lévêque,128864,2714,Agence_mtn_Ouidah,300000,173850,2022-05-14
CASH_OUT,862,Sophie Lévêque,2714,1852,Agence_mtn_Cotonou,300000,299138,2022-05-15
TRANSFER,516409,Virginie Le Gall,825253,308844,Sophie Lévêque,1852,518261,2022-05-18
TRANSFER,163613,Claude Foucher,192333,28720,Sophie Lévêque,518261,681874,2022-05-20
TRANSFER,458646,Sophie Lévêque,681874,223228,Louis Pichon,970600,511954,2022-05-20
CASH_OUT,70359,Sophie Lévêque,223228,152869,Agence_mtn_Ouidah,300000,229641,2022-05-21
CASH_IN,162394,Agence_mtn_Cotonou,300000,137606,Sophie Lévêque,152869,315263,2022-05-21
CASH_IN,88967,Agence_mtn_Cotonou,300000,211033,Sophie Lévêque,315263,404230,2022-05-21
TRANSFER,318206,Sophie Lévêque,404230,86024,Renée David,1258100,939894,2022-05-22
TRANSFER,2521,Sophie Lévêque,86024,83503,Alphonse Leclercq-Rousseau,870521,868000,2022-05-23
CASH_OUT,49489,Sophie Lévêque,83503,34014,Agence_mtn_Ouidah,300000,250511,2022-05-24
CASH_IN,273497,Agence_mtn_Abomey,300000,26503,Sophie Lévêque,34014,307511,2022-05-25
CASH_IN,37904,Agence_mtn_Abomey,300000,262096,William Le Lucas,775703,813607,2022-05-02
TRANSFER,93372,Cécile Germain,283529,190157,William Le Lucas,813607,906979,2022-05-03
CASH_OUT,511199,William Le Lucas,906979,395780,Agence_mtn_Ouidah,300000,-211199,2022-05-03
CASH_IN,281396,Agence_mtn_Cotonou,300000,18604,William Le Lucas,395780,677176,2022-05-04
TRANSFER,510624,William Le Lucas,677176,166552,Vincent Fournier,1190492,679868,2022-05-04
CASH_IN,253797,Agence_mtn_Ouidah,300000,46203,William Le Lucas,166552,420349,2022-05-10
CASH_OUT,146986,William Le Lucas,420349,273363,Agence_mtn_Ouidah,300000,153014,2022-05-10
CASH_IN,125130,Agence_mtn_Abomey,300000,174870,William Le Lucas,273363,398493,2022-05-11
TRANSFER,84799,William Le Lucas,398493,313694,Louise Girard,53778,-31021,2022-05-12
TRANSFER,67674,Astrid Gay de la Brunet,80100,12426,William Le Lucas,313694,381368,2022-05-13
TRANSFER,828915,Isabelle Rossi,857687,28772,William Le Lucas,381368,1210283,2022-05-16
CASH_IN,184012,Agence_mtn_Cotonou,300000,115988,William Le Lucas,1210283,1394295,2022-05-16
CASH_OUT,1181986,William Le Lucas,1394295,212309,Agence_mtn_Ouidah,300000,-881986,2022-05-18
CASH_IN,147757,Agence_mtn_Ouidah,300000,152243,William Le Lucas,212309,360066,2022-05-18
CASH_IN,299908,Agence_mtn_Abomey,300000,92,William Le Lucas,360066,659974,2022-05-18
CASH_OUT,469482,William Le Lucas,659974,190492,Agence_mtn_Cotonou,300000,-169482,2022-05-20
TRANSFER,68087,William Le Lucas,190492,122405,Astrid Gay de la Brunet,12426,-55661,2022-05-21
CASH_IN,219,Agence_mtn_Ouidah,300000,299781,William Le Lucas,122405,122624,2022-05-23
TRANSFER,99343,William Le Lucas,122624,23281,Pierre Reynaud,1802100,1702757,2022-05-24
CASH_IN,166823,Agence_mtn_Cotonou,300000,133177,William Le Lucas,23281,190104,2022-05-24
CASH_OUT,53796,William Le Lucas,190104,136308,Agence_mtn_Ouidah,300000,246204,2022-05-26
CASH_OUT,121765,William Le Lucas,136308,14543,Agence_mtn_Ouidah,300000,178235,2022-05-26
TRANSFER,1153550,Geneviève De Oliveira-Michel,1264400,110850,William Le Lucas,14543,1168093,2022-05-27
CASH_OUT,21125,Franck-Charles Texier,52853,31728,Agence_mtn_Cotonou,300000,278875,2022-05-01
CASH_OUT,23348,Franck-Charles Texier,31728,8380,Agence_mtn_Cotonou,300000,276652,2022-05-02
TRANSFER,6727,Franck-Charles Texier,8380,1653,Claude Foucher,28720,21993,2022-05-05
CASH_IN,272811,Agence_mtn_Abomey,300000,27189,Franck-Charles Texier,1653,274464,2022-05-05
CASH_OUT,17281,Franck-Charles Texier,274464,257183,Agence_mtn_Ouidah,300000,282719,2022-05-06
TRANSFER,1496055,Émilie Moulin,1741300,245245,Franck-Charles Texier,257183,1753238,2022-05-07
CASH_IN,198417,Agence_mtn_Abomey,300000,101583,Franck-Charles Texier,1753238,1951655,2022-05-08
CASH_IN,46156,Agence_mtn_Cotonou,300000,253844,Franck-Charles Texier,1951655,1997811,2022-05-09
TRANSFER,1547833,Franck-Charles Texier,1997811,449978,Valentine Richard-Bourdon,185580,-1362253,2022-05-09
CASH_OUT,104302,Franck-Charles Texier,449978,345676,Agence_mtn_Cotonou,300000,195698,2022-05-12
TRANSFER,667123,Nathalie Peron,732156,65033,Franck-Charles Texier,345676,1012799,2022-05-13
TRANSFER,10857,Nathalie Peron,65033,54176,Franck-Charles Texier,1012799,1023656,2022-05-14
CASH_OUT,323934,Franck-Charles Texier,1023656,699722,Agence_mtn_Abomey,300000,-23934,2022-05-14
TRANSFER,568899,Franck-Charles Texier,699722,130823,François Michel-Legros,110806,-458093,2022-05-15
TRANSFER,111401,Franck-Charles Texier,130823,19422,Marie Picard,781698,670297,2022-05-15
CASH_OUT,11468,Franck-Charles Texier,19422,7954,Agence_mtn_Abomey,300000,288532,2022-05-19
CASH_OUT,6500,Franck-Charles Texier,7954,1454,Agence_mtn_Abomey,300000,293500,2022-05-19
CASH_OUT,732,Franck-Charles Texier,1454,722,Agence_mtn_Ouidah,300000,299268,2022-05-20
CASH_OUT,598,Franck-Charles Texier,722,124,Agence_mtn_Cotonou,300000,299402,2022-05-22
CASH_IN,138737,Agence_mtn_Abomey,300000,161263,Franck-Charles Texier,124,138861,2022-05-22
CASH_OUT,38786,Franck-Charles Texier,138861,100075,Agence_mtn_Cotonou,300000,261214,2022-05-22
CASH_IN,67294,Agence_mtn_Cotonou,300000,232706,Franck-Charles Texier,100075,167369,2022-05-25
TRANSFER,34941,Franck-Charles Texier,167369,132428,Joséphine Gros,30581,-4360,2022-05-26
CASH_OUT,24287,Franck-Charles Texier,132428,108141,Agence_mtn_Cotonou,300000,275713,2022-05-27
CASH_IN,243669,Agence_mtn_Ouidah,300000,56331,Marie Picard,670297,913966,2022-05-01
TRANSFER,65418,Geneviève De Oliveira-Michel,110850,45432,Marie Picard,913966,979384,2022-05-01
CASH_IN,26120,Agence_mtn_Ouidah,300000,273880,Marie Picard,979384,1005504,2022-05-02
CASH_OUT,198796,Marie Picard,1005504,806708,Agence_mtn_Cotonou,300000,101204,2022-05-02
TRANSFER,1014,Marie Picard,806708,805694,Marine Chauvet-Potier,369525,368511,2022-05-03
CASH_IN,21608,Agence_mtn_Ouidah,300000,278392,Marie Picard,805694,827302,2022-05-04
CASH_IN,46990,Agence_mtn_Ouidah,300000,253010,Marie Picard,827302,874292,2022-05-04
TRANSFER,50005,Margot Riou du Fernandes,448534,398529,Marie Picard,874292,924297,2022-05-04
TRANSFER,522050,Roland Garcia,695200,173150,Marie Picard,924297,1446347,2022-05-05
CASH_IN,78583,Agence_mtn_Abomey,300000,221417,Marie Picard,1446347,1524930,2022-05-05
TRANSFER,1091393,Marie Picard,1524930,433537,Marie Picard,1524930,433537,2022-05-06
CASH_IN,167527,Agence_mtn_Ouidah,300000,132473,Marie Picard,433537,601064,2022-05-07
CASH_IN,90240,Agence_mtn_Abomey,300000,209760,Marie Picard,601064,691304,2022-05-08
CASH_OUT,620394,Marie Picard,691304,70910,Agence_mtn_Abomey,300000,-320394,2022-05-11
CASH_IN,22230,Agence_mtn_Ouidah,300000,277770,Marie Picard,70910,93140,2022-05-11
CASH_IN,160491,Agence_mtn_Ouidah,300000,139509,Marie Picard,93140,253631,2022-05-12
TRANSFER,138948,Marie Picard,253631,114683,Marine Chauvet-Potier,368511,229563,2022-05-13
CASH_IN,269799,Agence_mtn_Abomey,300000,30201,Marie Picard,114683,384482,2022-05-13
CASH_IN,58859,Agence_mtn_Ouidah,300000,241141,Marie Picard,384482,443341,2022-05-15
CASH_IN,248905,Agence_mtn_Cotonou,300000,51095,Marie Picard,443341,692246,2022-05-16
CASH_OUT,594557,Marie Picard,692246,97689,Agence_mtn_Ouidah,300000,-294557,2022-05-17
TRANSFER,103,Marie Picard,97689,97586,Renée David,939894,939791,2022-05-17
CASH_OUT,9836,Marie Picard,97586,87750,Agence_mtn_Abomey,300000,290164,2022-05-21
CASH_IN,28578,Agence_mtn_Abomey,300000,271422,Marie Picard,87750,116328,2022-05-21
TRANSFER,70457,Marie Picard,116328,45871,Pierre Roger,1127900,1057443,2022-05-21
CASH_IN,105061,Agence_mtn_Cotonou,300000,194939,Marie Picard,45871,150932,2022-05-23
TRANSFER,114317,David Guérin,1882500,1768183,Marie Picard,150932,265249,2022-05-26
CASH_IN,67487,Agence_mtn_Cotonou,300000,232513,Marie Picard,265249,332736,2022-05-27
CASH_IN,200456,Agence_mtn_Abomey,300000,99544,Marie Picard,332736,533192,2022-05-27
CASH_OUT,18018,Thibault Moreno,1373900,1355882,Agence_mtn_Ouidah,300000,281982,2022-05-01
TRANSFER,1236232,Thibault Moreno,1355882,119650,Tristan Thomas,26677,-1209555,2022-05-01
CASH_OUT,107961,Thibault Moreno,119650,11689,Agence_mtn_Ouidah,300000,192039,2022-05-02
TRANSFER,29772,Antoine Leleu,81514,51742,Thibault Moreno,11689,41461,2022-05-02
CASH_OUT,14613,Thibault Moreno,41461,26848,Agence_mtn_Ouidah,300000,285387,2022-05-04
TRANSFER,18451,Thibault Moreno,26848,8397,Antoine Leleu,51742,33291,2022-05-04
CASH_OUT,3699,Thibault Moreno,8397,4698,Agence_mtn_Ouidah,300000,296301,2022-05-04
TRANSFER,1428619,Nathalie Pages,1634700,206081,Thibault Moreno,4698,1433317,2022-05-07
CASH_IN,288165,Agence_mtn_Cotonou,300000,11835,Thibault Moreno,1433317,1721482,2022-05-07
TRANSFER,55144,Virginie Le Gall,308844,253700,Thibault Moreno,1721482,1776626,2022-05-08
CASH_IN,278799,Agence_mtn_Abomey,300000,21201,Thibault Moreno,1776626,2055425,2022-05-09
CASH_OUT,255034,Thibault Moreno,2055425,1800391,Agence_mtn_Abomey,300000,44966,2022-05-10
CASH_IN,276013,Agence_mtn_Cotonou,300000,23987,Thibault Moreno,1800391,2076404,2022-05-10
TRANSFER,1050605,Thibault Moreno,2076404,1025799,Margot Renaud,251795,-798810,2022-05-10
TRANSFER,712747,Philippine Courtois,1825600,1112853,Thibault Moreno,1025799,1738546,2022-05-13
CASH_OUT,1305792,Thibault Moreno,1738546,432754,Agence_mtn_Cotonou,300000,-1005792,2022-05-14
CASH_OUT,67878,Thibault Moreno,432754,364876,Agence_mtn_Abomey,300000,232122,2022-05-15
CASH_OUT,292687,Thibault Moreno,364876,72189,Agence_mtn_Abomey,300000,7313,2022-05-17
CASH_IN,156124,Agence_mtn_Ouidah,300000,143876,Thibault Moreno,72189,228313,2022-05-17
TRANSFER,188258,Thibault Moreno,228313,40055,Geneviève De Oliveira-Michel,45432,-142826,2022-05-18
CASH_OUT,16650,Thibault Moreno,40055,23405,Agence_mtn_Abomey,300000,283350,2022-05-18
TRANSFER,13303,Thibault Moreno,23405,10102,Cécile Delattre-Arnaud,257893,244590,2022-05-20
CASH_IN,218205,Agence_mtn_Ouidah,300000,81795,Thibault Moreno,10102,228307,2022-05-21
TRANSFER,273544,Gabriel-Tristan Marty,319000,45456,Thibault Moreno,228307,501851,2022-05-21
CASH_IN,26771,Agence_mtn_Abomey,300000,273229,Thibault Moreno,501851,528622,2022-05-24
TRANSFER,284024,Thibault Moreno,528622,244598,Cécile Germain,190157,-93867,2022-05-24
TRANSFER,712653,Pierre Reynaud,1702757,990104,Thibault Moreno,244598,957251,2022-05-25
CASH_OUT,715115,Thibault Moreno,957251,242136,Agence_mtn_Ouidah,300000,-415115,2022-05-25
TRANSFER,206428,Sébastien Vallée,240300,33872,Thibault Moreno,242136,448564,2022-05-25
CASH_IN,57689,Agence_mtn_Ouidah,300000,242311,Thibault Moreno,448564,506253,2022-05-27
CASH_IN,213603,Agence_mtn_Ouidah,300000,86397,Gabriel-Tristan Marty,45456,259059,2022-05-01
CASH_IN,230964,Agence_mtn_Ouidah,300000,69036,Gabriel-Tristan Marty,259059,490023,2022-05-01
CASH_IN,241517,Agence_mtn_Ouidah,300000,58483,Gabriel-Tristan Marty,490023,731540,2022-05-02
CASH_IN,269530,Agence_mtn_Cotonou,300000,30470,Gabriel-Tristan Marty,731540,1001070,2022-05-04
CASH_OUT,146211,Gabriel-Tristan Marty,1001070,854859,Agence_mtn_Ouidah,300000,153789,2022-05-05
CASH_IN,28933,Agence_mtn_Cotonou,300000,271067,Gabriel-Tristan Marty,854859,883792,2022-05-07
TRANSFER,239718,Gabriel-Tristan Marty,883792,644074,Isabelle Rossi,28772,-210946,2022-05-08
CASH_OUT,31116,Gabriel-Tristan Marty,644074,612958,Agence_mtn_Abomey,300000,268884,2022-05-09
CASH_OUT,446273,Gabriel-Tristan Marty,612958,166685,Agence_mtn_Ouidah,300000,-146273,2022-05-09
TRANSFER,105217,Cécile Delattre-Arnaud,244590,139373,Gabriel-Tristan Marty,166685,271902,2022-05-11
CASH_IN,259015,Agence_mtn_Abomey,300000,40985,Gabriel-Tristan Marty,271902,530917,2022-05-11
TRANSFER,320900,Hortense Lemaire,724500,403600,Gabriel-Tristan Marty,530917,851817,2022-05-12
CASH_OUT,356328,Gabriel-Tristan Marty,851817,495489,Agence_mtn_Ouidah,300000,-56328,2022-05-13
TRANSFER,181798,Émilie Moulin,245245,63447,Gabriel-Tristan Marty,495489,677287,2022-05-14
CASH_OUT,268666,Gabriel-Tristan Marty,677287,408621,Agence_mtn_Abomey,300000,31334,2022-05-14
CASH_IN,181084,Agence_mtn_Ouidah,300000,118916,Gabriel-Tristan Marty,408621,589705,2022-05-15
TRANSFER,348531,Gabriel-Tristan Marty,589705,241174,Léon Martins-Briand,1338700,990169,2022-05-16
CASH_IN,82057,Agence_mtn_Abomey,300000,217943,Gabriel-Tristan Marty,241174,323231,2022-05-16
CASH_IN,63011,Agence_mtn_Ouidah,300000,236989,Gabriel-Tristan Marty,323231,386242,2022-05-17
TRANSFER,182147,Gabriel-Tristan Marty,386242,204095,Pierre Roger,1057443,875296,2022-05-17
CASH_OUT,167748,Gabriel-Tristan Marty,204095,36347,Agence_mtn_Cotonou,300000,132252,2022-05-18
CASH_OUT,22379,Gabriel-Tristan Marty,36347,13968,Agence_mtn_Cotonou,300000,277621,2022-05-19
CASH_IN,212266,Agence_mtn_Abomey,300000,87734,Gabriel-Tristan Marty,13968,226234,2022-05-20
TRANSFER,165754,Gabriel-Tristan Marty,226234,60480,Sébastien Lemaître,1041000,875246,2022-05-23
CASH_OUT,20164,Gabriel-Tristan Marty,60480,40316,Agence_mtn_Cotonou,300000,279836,2022-05-24
CASH_OUT,32714,Gabriel-Tristan Marty,40316,7602,Agence_mtn_Ouidah,300000,267286,2022-05-24
CASH_OUT,1908,Gabriel-Tristan Marty,7602,5694,Agence_mtn_Ouidah,300000,298092,2022-05-27
CASH_OUT,1062,Gabriel-Tristan Marty,5694,4632,Agence_mtn_Cotonou,300000,298938,2022-05-27
TRANSFER,2058,Gabriel-Tristan Marty,4632,2574,Cécile Clerc,25061,23003,2022-05-27
CASH_IN,42299,Agence_mtn_Cotonou,300000,257701,David Guérin,1768183,1810482,2022-05-01
CASH_OUT,296497,David Guérin,1810482,1513985,Agence_mtn_Ouidah,300000,3503,2022-05-09
CASH_IN,203516,Agence_mtn_Abomey,300000,96484,David Guérin,1513985,1717501,2022-05-09
TRANSFER,1253644,David Guérin,1717501,463857,Sébastien Lemaître,875246,-378398,2022-05-10
CASH_OUT,400408,David Guérin,463857,63449,Agence_mtn_Cotonou,300000,-100408,2022-05-12
TRANSFER,27332,David Guérin,63449,36117,Léon Martins-Briand,990169,962837,2022-05-13
TRANSFER,4362,David Guérin,36117,31755,Cécile Clerc,23003,18641,2022-05-14
CASH_IN,67286,Agence_mtn_Cotonou,300000,232714,David Guérin,31755,99041,2022-05-15
CASH_IN,148629,Agence_mtn_Abomey,300000,151371,David Guérin,99041,247670,2022-05-15
CASH_OUT,38360,David Guérin,247670,209310,Agence_mtn_Cotonou,300000,261640,2022-05-15
CASH_OUT,121514,David Guérin,209310,87796,Agence_mtn_Cotonou,300000,178486,2022-05-16
CASH_OUT,17731,David Guérin,87796,70065,Agence_mtn_Abomey,300000,282269,2022-05-16
CASH_OUT,62706,David Guérin,70065,7359,Agence_mtn_Cotonou,300000,237294,2022-05-19
CASH_IN,254767,Agence_mtn_Ouidah,300000,45233,David Guérin,7359,262126,2022-05-20
TRANSFER,98467,David Guérin,262126,163659,Cécile Delattre-Arnaud,139373,40906,2022-05-21
TRANSFER,118511,David Guérin,163659,45148,David Guérin,163659,45148,2022-05-21
TRANSFER,441137,Emmanuelle Georges,594582,153445,David Guérin,45148,486285,2022-05-22
CASH_OUT,40790,David Guérin,486285,445495,Agence_mtn_Cotonou,300000,259210,2022-05-23
CASH_OUT,345730,David Guérin,445495,99765,Agence_mtn_Cotonou,300000,-45730,2022-05-24
TRANSFER,1186616,Bertrand Le Roux,1898900,712284,David Guérin,99765,1286381,2022-05-25
CASH_IN,79994,Agence_mtn_Abomey,300000,220006,David Guérin,1286381,1366375,2022-05-25
CASH_IN,137477,Agence_mtn_Ouidah,300000,162523,David Guérin,1366375,1503852,2022-05-27
TRANSFER,119462,Alexandrie Delmas,1579400,1459938,David Guérin,1503852,1623314,2022-05-27
CASH_IN,169986,Agence_mtn_Ouidah,300000,130014,Bertrand Le Roux,712284,882270,2022-05-02
CASH_OUT,620483,Bertrand Le Roux,882270,261787,Agence_mtn_Ouidah,300000,-320483,2022-05-04
TRANSFER,44804,Bertrand Le Roux,261787,216983,Virginie Le Gall,253700,208896,2022-05-06
TRANSFER,59172,Hortense Lemaire,403600,344428,Bertrand Le Roux,216983,276155,2022-05-10
TRANSFER,170385,Bertrand Le Roux,276155,105770,Victoire-Nicole Lopez,1180605,1010220,2022-05-10
CASH_IN,129608,Agence_mtn_Abomey,300000,170392,Bertrand Le Roux,105770,235378,2022-05-12
CASH_IN,141268,Agence_mtn_Cotonou,300000,158732,Bertrand Le Roux,235378,376646,2022-05-12
TRANSFER,264838,Alphonse Leclercq-Rousseau,868000,603162,Bertrand Le Roux,376646,641484,2022-05-13
CASH_OUT,307313,Bertrand Le Roux,641484,334171,Agence_mtn_Abomey,300000,-7313,2022-05-15
CASH_OUT,249319,Bertrand Le Roux,334171,84852,Agence_mtn_Ouidah,300000,50681,2022-05-16
TRANSFER,18295,Virginie Le Gall,208896,190601,Bertrand Le Roux,84852,103147,2022-05-16
TRANSFER,236448,Richard Le Descamps,417238,180790,Bertrand Le Roux,103147,339595,2022-05-16
CASH_OUT,158096,Bertrand Le Roux,339595,181499,Agence_mtn_Ouidah,300000,141904,2022-05-17
CASH_OUT,168945,Bertrand Le Roux,181499,12554,Agence_mtn_Abomey,300000,131055,2022-05-18
TRANSFER,9447,Bertrand Le Roux,12554,3107,Rémy Le Michaud,1505400,1495953,2022-05-18
TRANSFER,1653,Céline Gomez,86556,84903,Bertrand Le Roux,3107,4760,2022-05-18
CASH_OUT,2771,Bertrand Le Roux,4760,1989,Agence_mtn_Cotonou,300000,297229,2022-05-18
CASH_OUT,396,Bertrand Le Roux,1989,1593,Agence_mtn_Cotonou,300000,299604,2022-05-19
CASH_IN,291825,Agence_mtn_Ouidah,300000,8175,Bertrand Le Roux,1593,293418,2022-05-20
CASH_IN,165301,Agence_mtn_Abomey,300000,134699,Bertrand Le Roux,293418,458719,2022-05-22
TRANSFER,165618,Bertrand Le Roux,458719,293101,Corinne-Louise Valentin,56597,-109021,2022-05-22
CASH_OUT,58161,Bertrand Le Roux,293101,234940,Agence_mtn_Cotonou,300000,241839,2022-05-23
CASH_OUT,134353,Bertrand Le Roux,234940,100587,Agence_mtn_Abomey,300000,165647,2022-05-24
TRANSFER,501782,Renée David,939791,438009,Bertrand Le Roux,100587,602369,2022-05-26
TRANSFER,528957,Bertrand Le Roux,602369,73412,Virginie Le Gall,190601,-338356,2022-05-26
CASH_IN,254589,Agence_mtn_Cotonou,300000,45411,Cécile Clerc,18641,273230,2022-05-01
TRANSFER,72948,Cécile Clerc,273230,200282,Adèle Labbé,377812,304864,2022-05-03
TRANSFER,235376,Renée David,438009,202633,Cécile Clerc,200282,435658,2022-05-03
TRANSFER,24432,Cécile Clerc,435658,411226,Cécile Delattre-Arnaud,40906,16474,2022-05-06
CASH_OUT,294069,Cécile Clerc,411226,117157,Agence_mtn_Ouidah,300000,5931,2022-05-07
TRANSFER,103047,Adèle Labbé,304864,201817,Cécile Clerc,117157,220204,2022-05-07
CASH_IN,270570,Agence_mtn_Abomey,300000,29430,Cécile Clerc,220204,490774,2022-05-07
CASH_OUT,376711,Cécile Clerc,490774,114063,Agence_mtn_Ouidah,300000,-76711,2022-05-07
TRANSFER,194361,Jean Benard,600900,406539,Cécile Clerc,114063,308424,2022-05-08
TRANSFER,74845,Richard Le Descamps,180790,105945,Cécile Clerc,308424,383269,2022-05-08
TRANSFER,272967,Étienne Roche,582335,309368,Cécile Clerc,383269,656236,2022-05-10
CASH_IN,74329,Agence_mtn_Ouidah,300000,225671,Cécile Clerc,656236,730565,2022-05-13
TRANSFER,112924,Cécile Clerc,730565,617641,Valentine Martinez,1314687,1201763,2022-05-14
CASH_OUT,248841,Cécile Clerc,617641,368800,Agence_mtn_Abomey,300000,51159,2022-05-15
CASH_IN,6871,Agence_mtn_Cotonou,300000,293129,Cécile Clerc,368800,375671,2022-05-18
CASH_OUT,232862,Cécile Clerc,375671,142809,Agence_mtn_Cotonou,300000,67138,2022-05-19
CASH_OUT,31747,Cécile Clerc,142809,111062,Agence_mtn_Ouidah,300000,268253,2022-05-19
CASH_IN,226349,Agence_mtn_Cotonou,300000,73651,Cécile Clerc,111062,337411,2022-05-21
TRANSFER,40863,Nathalie Peron,54176,13313,Cécile Clerc,337411,378274,2022-05-25
TRANSFER,305993,Hortense Lemaire,344428,38435,Cécile Clerc,378274,684267,2022-05-26
TRANSFER,104047,Pierre Roger,875296,771249,Cécile Clerc,684267,788314,2022-05-26
TRANSFER,165200,Roland Garcia,173150,7950,Cécile Clerc,788314,953514,2022-05-27
CASH_OUT,641267,Pénélope Ollivier,697500,56233,Agence_mtn_Ouidah,300000,-341267,2022-05-01
CASH_IN,163215,Agence_mtn_Cotonou,300000,136785,Pénélope Ollivier,56233,219448,2022-05-01
CASH_IN,63452,Agence_mtn_Abomey,300000,236548,Pénélope Ollivier,219448,282900,2022-05-02
CASH_IN,151414,Agence_mtn_Abomey,300000,148586,Pénélope Ollivier,282900,434314,2022-05-03
TRANSFER,50604,Pénélope Ollivier,434314,383710,Emmanuelle Georges,153445,102841,2022-05-05
TRANSFER,12656,Antoine Leleu,33291,20635,Pénélope Ollivier,383710,396366,2022-05-08
CASH_IN,19999,Agence_mtn_Cotonou,300000,280001,Pénélope Ollivier,396366,416365,2022-05-12
TRANSFER,336803,Pénélope Ollivier,416365,79562,Alexandrie Delmas,1459938,1123135,2022-05-12
CASH_IN,10114,Agence_mtn_Ouidah,300000,289886,Pénélope Ollivier,79562,89676,2022-05-14
TRANSFER,89142,Pénélope Ollivier,89676,534,Claude Foucher,21993,-67149,2022-05-14
CASH_IN,206541,Agence_mtn_Abomey,300000,93459,Pénélope Ollivier,534,207075,2022-05-14
CASH_OUT,24727,Pénélope Ollivier,207075,182348,Agence_mtn_Abomey,300000,275273,2022-05-15
CASH_OUT,152130,Pénélope Ollivier,182348,30218,Agence_mtn_Cotonou,300000,147870,2022-05-17
CASH_IN,17887,Agence_mtn_Ouidah,300000,282113,Pénélope Ollivier,30218,48105,2022-05-17
CASH_OUT,35063,Pénélope Ollivier,48105,13042,Agence_mtn_Abomey,300000,264937,2022-05-18
CASH_OUT,1735,Pénélope Ollivier,13042,11307,Agence_mtn_Ouidah,300000,298265,2022-05-18
CASH_OUT,368,Pénélope Ollivier,11307,10939,Agence_mtn_Abomey,300000,299632,2022-05-19
TRANSFER,82903,Emmanuelle Georges,102841,19938,Pénélope Ollivier,10939,93842,2022-05-19
CASH_IN,148833,Agence_mtn_Cotonou,300000,151167,Pénélope Ollivier,93842,242675,2022-05-19
CASH_OUT,190445,Pénélope Ollivier,242675,52230,Agence_mtn_Abomey,300000,109555,2022-05-21
CASH_OUT,48909,Pénélope Ollivier,52230,3321,Agence_mtn_Abomey,300000,251091,2022-05-21
CASH_IN,54246,Agence_mtn_Ouidah,300000,245754,Pénélope Ollivier,3321,57567,2022-05-21
CASH_OUT,21790,Pénélope Ollivier,57567,35777,Agence_mtn_Ouidah,300000,278210,2022-05-23
CASH_IN,41203,Agence_mtn_Ouidah,300000,258797,Pénélope Ollivier,35777,76980,2022-05-24
CASH_IN,154661,Agence_mtn_Cotonou,300000,145339,Pénélope Ollivier,76980,231641,2022-05-25
CASH_OUT,150163,Pénélope Ollivier,231641,81478,Agence_mtn_Cotonou,300000,149837,2022-05-26
CASH_IN,172722,Agence_mtn_Ouidah,300000,127278,Pénélope Ollivier,81478,254200,2022-05-27
TRANSFER,122634,Marine Chauvet-Potier,229563,106929,Pénélope Ollivier,254200,376834,2022-05-27
CASH_IN,14877,Agence_mtn_Cotonou,300000,285123,Pénélope Ollivier,376834,391711,2022-05-27
CASH_IN,222695,Agence_mtn_Cotonou,300000,77305,Sébastien Lemaître,-378398,-155703,2022-05-02
CASH_IN,169196,Agence_mtn_Abomey,300000,130804,Sébastien Lemaître,-155703,13493,2022-05-04
CASH_OUT,8119,Sébastien Lemaître,13493,5374,Agence_mtn_Ouidah,300000,291881,2022-05-06
CASH_OUT,2589,Sébastien Lemaître,5374,2785,Agence_mtn_Cotonou,300000,297411,2022-05-06
CASH_OUT,2544,Sébastien Lemaître,2785,241,Agence_mtn_Cotonou,300000,297456,2022-05-07
TRANSFER,486258,Caroline-Lorraine Humbert,1086700,600442,Sébastien Lemaître,241,486499,2022-05-09
CASH_OUT,384716,Sébastien Lemaître,486499,101783,Agence_mtn_Abomey,300000,-84716,2022-05-10
TRANSFER,581966,Gabriel Humbert,622700,40734,Sébastien Lemaître,101783,683749,2022-05-10
CASH_IN,198186,Agence_mtn_Abomey,300000,101814,Sébastien Lemaître,683749,881935,2022-05-11
CASH_OUT,760863,Sébastien Lemaître,881935,121072,Agence_mtn_Cotonou,300000,-460863,2022-05-11
CASH_IN,95247,Agence_mtn_Ouidah,300000,204753,Sébastien Lemaître,121072,216319,2022-05-12
CASH_IN,122318,Agence_mtn_Cotonou,300000,177682,Sébastien Lemaître,216319,338637,2022-05-12
CASH_IN,121276,Agence_mtn_Cotonou,300000,178724,Sébastien Lemaître,338637,459913,2022-05-14
TRANSFER,162978,Sébastien Lemaître,459913,296935,Sébastien Vallée,33872,-129106,2022-05-15
CASH_OUT,178950,Sébastien Lemaître,296935,117985,Agence_mtn_Abomey,300000,121050,2022-05-15
TRANSFER,80252,Sébastien Lemaître,117985,37733,Caroline-Lorraine Humbert,600442,520190,2022-05-16
CASH_IN,286115,Agence_mtn_Abomey,300000,13885,Sébastien Lemaître,37733,323848,2022-05-16
TRANSFER,108458,Nathalie Pages,206081,97623,Sébastien Lemaître,323848,432306,2022-05-18
CASH_OUT,311611,Sébastien Lemaître,432306,120695,Agence_mtn_Ouidah,300000,-11611,2022-05-18
CASH_IN,180567,Agence_mtn_Cotonou,300000,119433,Sébastien Lemaître,120695,301262,2022-05-19
TRANSFER,175190,Sébastien Lemaître,301262,126072,Marine Chauvet-Potier,106929,-68261,2022-05-19
TRANSFER,111742,Sébastien Lemaître,126072,14330,Thérèse-Margaux Bruneau,423666,311924,2022-05-20
CASH_OUT,2394,Sébastien Lemaître,14330,11936,Agence_mtn_Ouidah,300000,297606,2022-05-21
CASH_OUT,1043,Sébastien Lemaître,11936,10893,Agence_mtn_Ouidah,300000,298957,2022-05-22
TRANSFER,864,Sébastien Lemaître,10893,10029,Vincent Fournier,679868,679004,2022-05-22
CASH_IN,234885,Agence_mtn_Ouidah,300000,65115,Sébastien Lemaître,10029,244914,2022-05-24
TRANSFER,18271,Gabriel Humbert,40734,22463,Sébastien Lemaître,244914,263185,2022-05-24
CASH_IN,63295,Agence_mtn_Cotonou,300000,236705,Sébastien Lemaître,263185,326480,2022-05-26
CASH_IN,11037,Agence_mtn_Cotonou,300000,288963,Sébastien Lemaître,326480,337517,2022-05-27
TRANSFER,168641,Sébastien Lemaître,337517,168876,Alphonse Leclercq-Rousseau,603162,434521,2022-05-27
CASH_IN,222035,Agence_mtn_Abomey,300000,77965,Corinne-Louise Valentin,-109021,113014,2022-05-01
CASH_IN,90406,Agence_mtn_Cotonou,300000,209594,Corinne-Louise Valentin,113014,203420,2022-05-01
CASH_OUT,55545,Corinne-Louise Valentin,203420,147875,Agence_mtn_Ouidah,300000,244455,2022-05-04
CASH_OUT,63140,Corinne-Louise Valentin,147875,84735,Agence_mtn_Abomey,300000,236860,2022-05-06
CASH_OUT,20936,Corinne-Louise Valentin,84735,63799,Agence_mtn_Cotonou,300000,279064,2022-05-08
TRANSFER,46964,Corinne-Louise Valentin,63799,16835,Céline Gomez,84903,37939,2022-05-09
CASH_OUT,2062,Corinne-Louise Valentin,16835,14773,Agence_mtn_Ouidah,300000,297938,2022-05-09
TRANSFER,292788,Thérèse-Margaux Bruneau,311924,19136,Corinne-Louise Valentin,14773,307561,2022-05-10
CASH_IN,286237,Agence_mtn_Abomey,300000,13763,Corinne-Louise Valentin,307561,593798,2022-05-11
CASH_IN,73539,Agence_mtn_Cotonou,300000,226461,Corinne-Louise Valentin,593798,667337,2022-05-12
CASH_IN,144546,Agence_mtn_Ouidah,300000,155454,Corinne-Louise Valentin,667337,811883,2022-05-13
TRANSFER,8249,Emmanuelle Georges,19938,11689,Corinne-Louise Valentin,811883,820132,2022-05-14
TRANSFER,843411,Pierre Reynaud,990104,146693,Corinne-Louise Valentin,820132,1663543,2022-05-16
CASH_IN,217681,Agence_mtn_Cotonou,300000,82319,Corinne-Louise Valentin,1663543,1881224,2022-05-17
CASH_OUT,1712424,Corinne-Louise Valentin,1881224,168800,Agence_mtn_Cotonou,300000,-1412424,2022-05-18
CASH_IN,238512,Agence_mtn_Cotonou,300000,61488,Corinne-Louise Valentin,168800,407312,2022-05-18
TRANSFER,131162,Louis Pichon,511954,380792,Corinne-Louise Valentin,407312,538474,2022-05-20
CASH_IN,244588,Agence_mtn_Cotonou,300000,55412,Corinne-Louise Valentin,538474,783062,2022-05-22
CASH_IN,190134,Agence_mtn_Cotonou,300000,109866,Corinne-Louise Valentin,783062,973196,2022-05-23
CASH_IN,129934,Agence_mtn_Cotonou,300000,170066,Corinne-Louise Valentin,973196,1103130,2022-05-24
CASH_OUT,136309,Corinne-Louise Valentin,1103130,966821,Agence_mtn_Ouidah,300000,163691,2022-05-25
TRANSFER,179835,Valentine Martinez,1201763,1021928,Vincent Fournier,679004,499169,2022-05-03
CASH_IN,154556,Agence_mtn_Ouidah,300000,145444,Valentine Martinez,1021928,1176484,2022-05-04
TRANSFER,23988,Hortense Lemaire,38435,14447,Valentine Martinez,1176484,1200472,2022-05-04
TRANSFER,160238,Louis Pichon,380792,220554,Valentine Martinez,1200472,1360710,2022-05-05
CASH_OUT,472275,Valentine Martinez,1360710,888435,Agence_mtn_Cotonou,300000,-172275,2022-05-07
CASH_IN,242112,Agence_mtn_Cotonou,300000,57888,Valentine Martinez,888435,1130547,2022-05-12
CASH_OUT,763669,Valentine Martinez,1130547,366878,Agence_mtn_Ouidah,300000,-463669,2022-05-12
CASH_IN,262034,Agence_mtn_Ouidah,300000,37966,Valentine Martinez,366878,628912,2022-05-13
CASH_IN,201595,Agence_mtn_Cotonou,300000,98405,Valentine Martinez,628912,830507,2022-05-13
CASH_IN,101054,Agence_mtn_Abomey,300000,198946,Valentine Martinez,830507,931561,2022-05-15
TRANSFER,483891,Valentine Martinez,931561,447670,Emmanuelle Georges,11689,-472202,2022-05-16
CASH_IN,51076,Agence_mtn_Cotonou,300000,248924,Valentine Martinez,447670,498746,2022-05-16
CASH_IN,201777,Agence_mtn_Ouidah,300000,98223,Valentine Martinez,498746,700523,2022-05-16
CASH_IN,34633,Agence_mtn_Cotonou,300000,265367,Valentine Martinez,700523,735156,2022-05-17
CASH_IN,145001,Agence_mtn_Cotonou,300000,154999,Valentine Martinez,735156,880157,2022-05-18
CASH_IN,193508,Agence_mtn_Cotonou,300000,106492,Valentine Martinez,880157,1073665,2022-05-21
CASH_IN,146738,Agence_mtn_Ouidah,300000,153262,Valentine Martinez,1073665,1220403,2022-05-23
TRANSFER,182427,Renée David,202633,20206,Valentine Martinez,1220403,1402830,2022-05-24
CASH_OUT,1339546,Valentine Martinez,1402830,63284,Agence_mtn_Abomey,300000,-1039546,2022-05-24
CASH_OUT,19106,Valentine Martinez,63284,44178,Agence_mtn_Cotonou,300000,280894,2022-05-24
CASH_IN,126024,Agence_mtn_Cotonou,300000,173976,Valentine Martinez,44178,170202,2022-05-25
CASH_IN,138120,Agence_mtn_Ouidah,300000,161880,Valentine Martinez,170202,308322,2022-05-26
CASH_IN,28567,Agence_mtn_Abomey,300000,271433,Valentine Martinez,308322,336889,2022-05-26
TRANSFER,274649,Valentine Martinez,336889,62240,Alexandrie Delmas,1123135,848486,2022-05-27
TRANSFER,33058,Louis Pichon,220554,187496,Cécile Delattre-Arnaud,16474,-16584,2022-05-02
CASH_OUT,42990,Louis Pichon,187496,144506,Agence_mtn_Ouidah,300000,257010,2022-05-04
CASH_IN,150782,Agence_mtn_Ouidah,300000,149218,Louis Pichon,144506,295288,2022-05-06
CASH_OUT,111743,Louis Pichon,295288,183545,Agence_mtn_Abomey,300000,188257,2022-05-07
CASH_IN,151869,Agence_mtn_Cotonou,300000,148131,Louis Pichon,183545,335414,2022-05-09
CASH_IN,138029,Agence_mtn_Ouidah,300000,161971,Louis Pichon,335414,473443,2022-05-09
TRANSFER,11481,Céline Gomez,37939,26458,Louis Pichon,473443,484924,2022-05-09
CASH_IN,194638,Agence_mtn_Ouidah,300000,105362,Louis Pichon,484924,679562,2022-05-12
TRANSFER,78406,Louis Pichon,679562,601156,Pierre Reynaud,146693,68287,2022-05-14
CASH_OUT,556318,Louis Pichon,601156,44838,Agence_mtn_Ouidah,300000,-256318,2022-05-15
CASH_OUT,25114,Louis Pichon,44838,19724,Agence_mtn_Abomey,300000,274886,2022-05-17
CASH_IN,250667,Agence_mtn_Cotonou,300000,49333,Louis Pichon,19724,270391,2022-05-17
CASH_OUT,196214,Louis Pichon,270391,74177,Agence_mtn_Abomey,300000,103786,2022-05-18
CASH_OUT,73719,Louis Pichon,74177,458,Agence_mtn_Cotonou,300000,226281,2022-05-19
CASH_IN,251791,Agence_mtn_Ouidah,300000,48209,Louis Pichon,458,252249,2022-05-20
CASH_OUT,139920,Louis Pichon,252249,112329,Agence_mtn_Ouidah,300000,160080,2022-05-20
CASH_IN,264286,Agence_mtn_Cotonou,300000,35714,Louis Pichon,112329,376615,2022-05-22
CASH_IN,14585,Agence_mtn_Abomey,300000,285415,Louis Pichon,376615,391200,2022-05-23
CASH_IN,37963,Agence_mtn_Cotonou,300000,262037,Louis Pichon,391200,429163,2022-05-23
TRANSFER,104165,Louis Pichon,429163,324998,Jean Benard,406539,302374,2022-05-23
TRANSFER,312348,Louis Pichon,324998,12650,Étienne Roche,309368,-2980,2022-05-24
CASH_IN,251356,Agence_mtn_Cotonou,300000,48644,Louis Pichon,12650,264006,2022-05-26
CASH_OUT,6726,Louis Pichon,264006,257280,Agence_mtn_Ouidah,300000,293274,2022-05-27
CASH_IN,183722,Agence_mtn_Cotonou,300000,116278,Louise Girard,-31021,152701,2022-05-08
CASH_IN,166580,Agence_mtn_Cotonou,300000,133420,Louise Girard,152701,319281,2022-05-12
CASH_IN,217742,Agence_mtn_Abomey,300000,82258,Louise Girard,319281,537023,2022-05-13
CASH_IN,115026,Agence_mtn_Abomey,300000,184974,Louise Girard,537023,652049,2022-05-15
TRANSFER,14717,Céline Gomez,26458,11741,Louise Girard,652049,666766,2022-05-18
CASH_OUT,84804,Louise Girard,666766,581962,Agence_mtn_Abomey,300000,215196,2022-05-20
CASH_OUT,568691,Louise Girard,581962,13271,Agence_mtn_Abomey,300000,-268691,2022-05-21
TRANSFER,3221,Louise Girard,13271,10050,Philippine Courtois,1112853,1109632,2022-05-24
CASH_IN,241300,Agence_mtn_Abomey,300000,58700,Louise Girard,10050,251350,2022-05-26
CASH_IN,154431,Agence_mtn_Abomey,300000,145569,Geneviève Grondin,-88806,65625,2022-05-01
CASH_OUT,36719,Geneviève Grondin,65625,28906,Agence_mtn_Cotonou,300000,263281,2022-05-02
CASH_IN,144973,Agence_mtn_Cotonou,300000,155027,Geneviève Grondin,28906,173879,2022-05-02
CASH_OUT,130325,Geneviève Grondin,173879,43554,Agence_mtn_Ouidah,300000,169675,2022-05-03
CASH_IN,266062,Agence_mtn_Cotonou,300000,33938,Geneviève Grondin,43554,309616,2022-05-04
CASH_IN,150095,Agence_mtn_Abomey,300000,149905,Geneviève Grondin,309616,459711,2022-05-05
TRANSFER,91397,Geneviève Grondin,459711,368314,Margot Riou du Fernandes,398529,307132,2022-05-09
TRANSFER,489864,Philippine Courtois,1109632,619768,Geneviève Grondin,368314,858178,2022-05-10
CASH_IN,34774,Agence_mtn_Ouidah,300000,265226,Geneviève Grondin,858178,892952,2022-05-11
CASH_OUT,210121,Geneviève Grondin,892952,682831,Agence_mtn_Abomey,300000,89879,2022-05-14
TRANSFER,374111,Geneviève Grondin,682831,308720,Geneviève Grondin,682831,308720,2022-05-14
CASH_IN,147216,Agence_mtn_Ouidah,300000,152784,Geneviève Grondin,308720,455936,2022-05-17
CASH_IN,35578,Agence_mtn_Ouidah,300000,264422,Geneviève Grondin,455936,491514,2022-05-17
TRANSFER,116646,Geneviève Grondin,491514,374868,Jeanne Garnier,1757406,1640760,2022-05-20
TRANSFER,89185,Jean Benard,302374,213189,Geneviève Grondin,374868,464053,2022-05-25
TRANSFER,4634,Roland Garcia,7950,3316,Geneviève Grondin,464053,468687,2022-05-26
CASH_IN,203426,Agence_mtn_Cotonou,300000,96574,Geneviève Grondin,468687,672113,2022-05-26
CASH_IN,298856,Agence_mtn_Ouidah,300000,1144,Xavier Leblanc-Ferreira,-543321,-244465,2022-05-02
CASH_IN,105974,Agence_mtn_Cotonou,300000,194026,Xavier Leblanc-Ferreira,-244465,-138491,2022-05-10
CASH_IN,30547,Agence_mtn_Cotonou,300000,269453,Xavier Leblanc-Ferreira,-138491,-107944,2022-05-18
CASH_IN,128924,Agence_mtn_Abomey,300000,171076,Xavier Leblanc-Ferreira,-107944,20980,2022-05-18
CASH_OUT,17735,Xavier Leblanc-Ferreira,20980,3245,Agence_mtn_Abomey,300000,282265,2022-05-23
CASH_OUT,2767,Xavier Leblanc-Ferreira,3245,478,Agence_mtn_Abomey,300000,297233,2022-05-26
CASH_OUT,59607,Margot Riou du Fernandes,307132,247525,Agence_mtn_Ouidah,300000,240393,2022-05-04
CASH_OUT,13698,Margot Riou du Fernandes,247525,233827,Agence_mtn_Ouidah,300000,286302,2022-05-05
TRANSFER,3625,Thérèse-Margaux Bruneau,19136,15511,Margot Riou du Fernandes,233827,237452,2022-05-07
CASH_IN,110613,Agence_mtn_Ouidah,300000,189387,Margot Riou du Fernandes,237452,348065,2022-05-10
CASH_OUT,50250,Margot Riou du Fernandes,348065,297815,Agence_mtn_Cotonou,300000,249750,2022-05-10
CASH_IN,124884,Agence_mtn_Abomey,300000,175116,Margot Riou du Fernandes,297815,422699,2022-05-13
TRANSFER,154062,Margot Riou du Fernandes,422699,268637,Thérèse-Margaux Bruneau,15511,-138551,2022-05-13
TRANSFER,143888,Margot Riou du Fernandes,268637,124749,Nathalie Pages,97623,-46265,2022-05-14
CASH_IN,235470,Agence_mtn_Ouidah,300000,64530,Margot Riou du Fernandes,124749,360219,2022-05-14
CASH_OUT,145707,Margot Riou du Fernandes,360219,214512,Agence_mtn_Abomey,300000,154293,2022-05-15
TRANSFER,11161,Pierre Reynaud,68287,57126,Margot Riou du Fernandes,214512,225673,2022-05-18
TRANSFER,60378,Margot Riou du Fernandes,225673,165295,Émilie Moulin,63447,3069,2022-05-20
CASH_IN,213388,Agence_mtn_Abomey,300000,86612,Margot Riou du Fernandes,165295,378683,2022-05-21
TRANSFER,15795,Margot Riou du Fernandes,378683,362888,Honoré du Laurent,1603500,1587705,2022-05-21
TRANSFER,30878,Pierre Reynaud,57126,26248,Margot Riou du Fernandes,362888,393766,2022-05-25
CASH_IN,49493,Agence_mtn_Cotonou,300000,250507,Margot Riou du Fernandes,393766,443259,2022-05-26
CASH_IN,83957,Agence_mtn_Cotonou,300000,216043,Claude Foucher,-67149,16808,2022-05-01
CASH_OUT,14934,Claude Foucher,16808,1874,Agence_mtn_Ouidah,300000,285066,2022-05-04
CASH_IN,124206,Agence_mtn_Abomey,300000,175794,Claude Foucher,1874,126080,2022-05-04
CASH_IN,233384,Agence_mtn_Cotonou,300000,66616,Claude Foucher,126080,359464,2022-05-05
TRANSFER,70289,Jean Benard,213189,142900,Claude Foucher,359464,429753,2022-05-06
CASH_IN,43077,Agence_mtn_Cotonou,300000,256923,Claude Foucher,429753,472830,2022-05-07
CASH_OUT,257912,Claude Foucher,472830,214918,Agence_mtn_Abomey,300000,42088,2022-05-11
CASH_IN,45648,Agence_mtn_Ouidah,300000,254352,Claude Foucher,214918,260566,2022-05-12
TRANSFER,257489,Claude Foucher,260566,3077,Roland Garcia,3316,-254173,2022-05-12
CASH_IN,218581,Agence_mtn_Ouidah,300000,81419,Claude Foucher,3077,221658,2022-05-13
CASH_IN,124628,Agence_mtn_Cotonou,300000,175372,Claude Foucher,221658,346286,2022-05-14
CASH_IN,217068,Agence_mtn_Ouidah,300000,82932,Claude Foucher,346286,563354,2022-05-14
CASH_IN,205188,Agence_mtn_Cotonou,300000,94812,Claude Foucher,563354,768542,2022-05-21
CASH_IN,20415,Agence_mtn_Abomey,300000,279585,Claude Foucher,768542,788957,2022-05-22
TRANSFER,177894,Claude Foucher,788957,611063,Céline Gomez,11741,-166153,2022-05-23
CASH_IN,111023,Agence_mtn_Cotonou,300000,188977,Claude Foucher,611063,722086,2022-05-24
CASH_IN,223255,Agence_mtn_Abomey,300000,76745,Claude Foucher,722086,945341,2022-05-27
CASH_IN,296274,Agence_mtn_Cotonou,300000,3726,Claude Foucher,945341,1241615,2022-05-27
TRANSFER,176139,Alexandrie Delmas,848486,672347,Claude Foucher,1241615,1417754,2022-05-27
CASH_IN,190999,Agence_mtn_Cotonou,300000,109001,Thérèse-Margaux Bruneau,-138551,52448,2022-05-01
TRANSFER,207562,Vincent Fournier,499169,291607,Thérèse-Margaux Bruneau,52448,260010,2022-05-03
TRANSFER,7319,Nathalie Peron,13313,5994,Thérèse-Margaux Bruneau,260010,267329,2022-05-04
CASH_IN,201446,Agence_mtn_Cotonou,300000,98554,Thérèse-Margaux Bruneau,267329,468775,2022-05-04
CASH_OUT,238884,Thérèse-Margaux Bruneau,468775,229891,Agence_mtn_Ouidah,300000,61116,2022-05-07
CASH_IN,164586,Agence_mtn_Cotonou,300000,135414,Thérèse-Margaux Bruneau,229891,394477,2022-05-09
CASH_OUT,258364,Thérèse-Margaux Bruneau,394477,136113,Agence_mtn_Ouidah,300000,41636,2022-05-11
CASH_IN,150000,Agence_mtn_Abomey,300000,150000,Thérèse-Margaux Bruneau,136113,286113,2022-05-12
TRANSFER,458196,Caroline-Lorraine Humbert,520190,61994,Thérèse-Margaux Bruneau,286113,744309,2022-05-12
CASH_OUT,74112,Thérèse-Margaux Bruneau,744309,670197,Agence_mtn_Abomey,300000,225888,2022-05-19
CASH_IN,25243,Agence_mtn_Cotonou,300000,274757,Thérèse-Margaux Bruneau,670197,695440,2022-05-20
TRANSFER,344794,Thérèse-Margaux Bruneau,695440,350646,Thérèse-Margaux Bruneau,695440,350646,2022-05-21
CASH_IN,159083,Agence_mtn_Ouidah,300000,140917,Thérèse-Margaux Bruneau,350646,509729,2022-05-22
TRANSFER,206015,Thérèse-Margaux Bruneau,509729,303714,Adèle Labbé,201817,-4198,2022-05-23
CASH_OUT,243996,Thérèse-Margaux Bruneau,303714,59718,Agence_mtn_Abomey,300000,56004,2022-05-25
CASH_OUT,50916,Thérèse-Margaux Bruneau,59718,8802,Agence_mtn_Ouidah,300000,249084,2022-05-25
TRANSFER,7978,Thérèse-Margaux Bruneau,8802,824,Honoré du Laurent,1587705,1579727,2022-05-25
TRANSFER,668,Thérèse-Margaux Bruneau,824,156,Richard Le Descamps,105945,105277,2022-05-26
TRANSFER,98890,Jeanne Garnier,1640760,1541870,Thérèse-Margaux Bruneau,156,99046,2022-05-26
CASH_OUT,94539,Thérèse-Margaux Bruneau,99046,4507,Agence_mtn_Ouidah,300000,205461,2022-05-26
CASH_IN,186268,Agence_mtn_Ouidah,300000,113732,Adèle Labbé,-4198,182070,2022-05-05
CASH_OUT,81779,Adèle Labbé,182070,100291,Agence_mtn_Abomey,300000,218221,2022-05-05
TRANSFER,1096355,Jeanne Garnier,1541870,445515,Adèle Labbé,100291,1196646,2022-05-07
TRANSFER,6305,Renée David,20206,13901,Adèle Labbé,1196646,1202951,2022-05-07
CASH_IN,113159,Agence_mtn_Ouidah,300000,186841,Adèle Labbé,1202951,1316110,2022-05-08
CASH_OUT,824936,Adèle Labbé,1316110,491174,Agence_mtn_Cotonou,300000,-524936,2022-05-08
CASH_OUT,186156,Adèle Labbé,491174,305018,Agence_mtn_Abomey,300000,113844,2022-05-13
CASH_IN,39991,Agence_mtn_Ouidah,300000,260009,Adèle Labbé,305018,345009,2022-05-13
TRANSFER,55056,Adèle Labbé,345009,289953,Philippine Courtois,619768,564712,2022-05-14
CASH_OUT,99959,Adèle Labbé,289953,189994,Agence_mtn_Ouidah,300000,200041,2022-05-15
CASH_IN,4634,Agence_mtn_Ouidah,300000,295366,Adèle Labbé,189994,194628,2022-05-18
CASH_IN,210155,Agence_mtn_Abomey,300000,89845,Adèle Labbé,194628,404783,2022-05-20
CASH_OUT,302212,Adèle Labbé,404783,102571,Agence_mtn_Ouidah,300000,-2212,2022-05-22
CASH_OUT,100471,Adèle Labbé,102571,2100,Agence_mtn_Ouidah,300000,199529,2022-05-23
CASH_OUT,1158,Adèle Labbé,2100,942,Agence_mtn_Cotonou,300000,298842,2022-05-24
CASH_OUT,144,Adèle Labbé,942,798,Agence_mtn_Cotonou,300000,299856,2022-05-25
TRANSFER,635346,Pierre Roger,771249,135903,Adèle Labbé,798,636144,2022-05-27
TRANSFER,629841,Adèle Labbé,636144,6303,Rémy Le Michaud,1495953,866112,2022-05-27
CASH_IN,112535,Agence_mtn_Ouidah,300000,187465,Éléonore-Hélène Dubois,-336525,-223990,2022-05-06
CASH_IN,290209,Agence_mtn_Ouidah,300000,9791,Éléonore-Hélène Dubois,-223990,66219,2022-05-08
CASH_IN,212127,Agence_mtn_Ouidah,300000,87873,Éléonore-Hélène Dubois,66219,278346,2022-05-10
CASH_OUT,214695,Éléonore-Hélène Dubois,278346,63651,Agence_mtn_Ouidah,300000,85305,2022-05-11
TRANSFER,518470,Rémy Le Michaud,866112,347642,Éléonore-Hélène Dubois,63651,582121,2022-05-13
CASH_OUT,92619,Éléonore-Hélène Dubois,582121,489502,Agence_mtn_Ouidah,300000,207381,2022-05-15
TRANSFER,5144,Éléonore-Hélène Dubois,489502,484358,Hortense Lemaire,14447,9303,2022-05-18
CASH_IN,2033,Agence_mtn_Abomey,300000,297967,Margot Renaud,-798810,-796777,2022-05-03
CASH_IN,74919,Agence_mtn_Ouidah,300000,225081,Margot Renaud,-796777,-721858,2022-05-04
CASH_IN,61456,Agence_mtn_Cotonou,300000,238544,Margot Renaud,-721858,-660402,2022-05-10
CASH_IN,294091,Agence_mtn_Cotonou,300000,5909,Margot Renaud,-660402,-366311,2022-05-18
CASH_IN,74620,Agence_mtn_Abomey,300000,225380,Margot Renaud,-366311,-291691,2022-05-20
CASH_IN,153144,Agence_mtn_Abomey,300000,146856,Margot Renaud,-291691,-138547,2022-05-21
CASH_IN,235615,Agence_mtn_Cotonou,300000,64385,Cécile Germain,-93867,141748,2022-05-02
CASH_IN,286458,Agence_mtn_Cotonou,300000,13542,Cécile Germain,141748,428206,2022-05-02
TRANSFER,25958,Pierre Reynaud,26248,290,Cécile Germain,428206,454164,2022-05-07
CASH_IN,246151,Agence_mtn_Abomey,300000,53849,Cécile Germain,454164,700315,2022-05-10
CASH_IN,85792,Agence_mtn_Cotonou,300000,214208,Cécile Germain,700315,786107,2022-05-12
CASH_IN,155461,Agence_mtn_Cotonou,300000,144539,Cécile Germain,786107,941568,2022-05-17
TRANSFER,720772,Cécile Germain,941568,220796,Alphonse Leclercq-Rousseau,434521,-286251,2022-05-18
CASH_IN,19199,Agence_mtn_Cotonou,300000,280801,Cécile Germain,220796,239995,2022-05-18
CASH_IN,265737,Agence_mtn_Ouidah,300000,34263,Cécile Germain,239995,505732,2022-05-18
CASH_OUT,6935,Cécile Germain,505732,498797,Agence_mtn_Ouidah,300000,293065,2022-05-19
CASH_IN,145911,Agence_mtn_Ouidah,300000,154089,Cécile Germain,498797,644708,2022-05-25
CASH_IN,70027,Agence_mtn_Ouidah,300000,229973,Cécile Germain,644708,714735,2022-05-26
CASH_IN,16346,Agence_mtn_Cotonou,300000,283654,Cécile Germain,714735,731081,2022-05-26
CASH_IN,110924,Agence_mtn_Cotonou,300000,189076,Geneviève De Oliveira-Michel,-142826,-31902,2022-05-02
CASH_IN,289346,Agence_mtn_Cotonou,300000,10654,Geneviève De Oliveira-Michel,-31902,257444,2022-05-03
CASH_OUT,216889,Geneviève De Oliveira-Michel,257444,40555,Agence_mtn_Ouidah,300000,83111,2022-05-05
TRANSFER,32322,Geneviève De Oliveira-Michel,40555,8233,Rémy Le Michaud,347642,315320,2022-05-05
TRANSFER,212786,Vincent Fournier,291607,78821,Geneviève De Oliveira-Michel,8233,221019,2022-05-07
TRANSFER,8944,Hortense Lemaire,9303,359,Geneviève De Oliveira-Michel,221019,229963,2022-05-19
CASH_OUT,128893,Geneviève De Oliveira-Michel,229963,101070,Agence_mtn_Ouidah,300000,171107,2022-05-21
CASH_OUT,76523,Geneviève De Oliveira-Michel,101070,24547,Agence_mtn_Ouidah,300000,223477,2022-05-23
CASH_OUT,3228,Renée David,13901,10673,Agence_mtn_Ouidah,300000,296772,2022-05-01
TRANSFER,182041,Jeanne Garnier,445515,263474,Renée David,10673,192714,2022-05-12
CASH_IN,293292,Agence_mtn_Abomey,300000,6708,Renée David,192714,486006,2022-05-13
TRANSFER,119,Hortense Lemaire,359,240,Renée David,486006,486125,2022-05-14
CASH_OUT,255481,Renée David,486125,230644,Agence_mtn_Ouidah,300000,44519,2022-05-19
CASH_OUT,189741,Renée David,230644,40903,Agence_mtn_Ouidah,300000,110259,2022-05-19
CASH_OUT,33894,Renée David,40903,7009,Agence_mtn_Abomey,300000,266106,2022-05-20
TRANSFER,691326,Léon Martins-Briand,962837,271511,Renée David,7009,698335,2022-05-27
CASH_OUT,505854,Renée David,698335,192481,Agence_mtn_Ouidah,300000,-205854,2022-05-27
CASH_OUT,64550,Jeanne Garnier,263474,198924,Agence_mtn_Ouidah,300000,235450,2022-05-01
CASH_OUT,148679,Jeanne Garnier,198924,50245,Agence_mtn_Ouidah,300000,151321,2022-05-04
CASH_OUT,12884,Jeanne Garnier,50245,37361,Agence_mtn_Ouidah,300000,287116,2022-05-04
CASH_OUT,16066,Jeanne Garnier,37361,21295,Agence_mtn_Ouidah,300000,283934,2022-05-06
TRANSFER,769834,Honoré du Laurent,1579727,809893,Jeanne Garnier,21295,791129,2022-05-07
TRANSFER,112916,Jeanne Garnier,791129,678213,Hortense Lemaire,240,-112676,2022-05-08
CASH_IN,16323,Agence_mtn_Cotonou,300000,283677,Jeanne Garnier,678213,694536,2022-05-13
CASH_IN,255358,Agence_mtn_Cotonou,300000,44642,Jeanne Garnier,694536,949894,2022-05-23
CASH_IN,84283,Agence_mtn_Ouidah,300000,215717,Jeanne Garnier,949894,1034177,2022-05-23
CASH_IN,280831,Agence_mtn_Ouidah,300000,19169,Jeanne Garnier,1034177,1315008,2022-05-24
TRANSFER,1077159,Jeanne Garnier,1315008,237849,Gabriel Humbert,22463,-1054696,2022-05-27
CASH_IN,216765,Agence_mtn_Ouidah,300000,83235,Hortense Lemaire,-112676,104089,2022-05-06
CASH_OUT,37733,Hortense Lemaire,104089,66356,Agence_mtn_Cotonou,300000,262267,2022-05-07
CASH_OUT,43804,Hortense Lemaire,66356,22552,Agence_mtn_Cotonou,300000,256196,2022-05-07
CASH_IN,263838,Agence_mtn_Cotonou,300000,36162,Hortense Lemaire,22552,286390,2022-05-08
CASH_IN,256508,Agence_mtn_Cotonou,300000,43492,Hortense Lemaire,286390,542898,2022-05-10
CASH_IN,93420,Agence_mtn_Cotonou,300000,206580,Hortense Lemaire,542898,636318,2022-05-13
CASH_OUT,42860,Hortense Lemaire,636318,593458,Agence_mtn_Abomey,300000,257140,2022-05-17
CASH_OUT,371672,Hortense Lemaire,593458,221786,Agence_mtn_Cotonou,300000,-71672,2022-05-23
CASH_IN,142738,Agence_mtn_Cotonou,300000,157262,Hortense Lemaire,221786,364524,2022-05-25
TRANSFER,15120,Alexandrie Delmas,672347,657227,Hortense Lemaire,364524,379644,2022-05-25
TRANSFER,57390,Caroline-Lorraine Humbert,61994,4604,Hortense Lemaire,379644,437034,2022-05-25
CASH_IN,265632,Agence_mtn_Abomey,300000,34368,Antoine Leleu,20635,286267,2022-05-04
TRANSFER,103811,Antoine Leleu,286267,182456,Antoine Leleu,286267,390078,2022-05-06
TRANSFER,110699,Antoine Leleu,182456,71757,Caroline-Lorraine Humbert,4604,-106095,2022-05-07
TRANSFER,32262,Antoine Leleu,71757,39495,Alexandrie Delmas,657227,624965,2022-05-13
CASH_OUT,18589,Antoine Leleu,39495,20906,Agence_mtn_Cotonou,300000,281411,2022-05-14
TRANSFER,4098,Antoine Leleu,20906,16808,Vincent Fournier,78821,74723,2022-05-15
TRANSFER,7218,Antoine Leleu,16808,9590,Richard Le Descamps,105277,98059,2022-05-20
CASH_OUT,9120,Antoine Leleu,9590,470,Agence_mtn_Ouidah,300000,290880,2022-05-20
CASH_IN,299451,Agence_mtn_Abomey,300000,549,Antoine Leleu,470,299921,2022-05-21
CASH_IN,77059,Agence_mtn_Ouidah,300000,222941,David du Blondel,-14690,62369,2022-05-02
TRANSFER,58382,David du Blondel,62369,3987,Vincent Fournier,74723,16341,2022-05-03
TRANSFER,2423,David du Blondel,3987,1564,David du Blondel,3987,6410,2022-05-04
CASH_IN,165859,Agence_mtn_Abomey,300000,134141,David du Blondel,1564,167423,2022-05-15
CASH_OUT,151851,David du Blondel,167423,15572,Agence_mtn_Cotonou,300000,148149,2022-05-15
CASH_OUT,6192,David du Blondel,15572,9380,Agence_mtn_Cotonou,300000,293808,2022-05-15
TRANSFER,5215,David du Blondel,9380,4165,Philippine Courtois,564712,559497,2022-05-17
CASH_OUT,1610,David du Blondel,4165,2555,Agence_mtn_Ouidah,300000,298390,2022-05-20
CASH_IN,239704,Agence_mtn_Ouidah,300000,60296,David du Blondel,2555,242259,2022-05-22
CASH_OUT,146347,David du Blondel,242259,95912,Agence_mtn_Ouidah,300000,153653,2022-05-24
TRANSFER,13415,David du Blondel,95912,82497,Émilie Moulin,3069,-10346,2022-05-26
CASH_OUT,89695,Pierre Roger,135903,46208,Agence_mtn_Cotonou,300000,210305,2022-05-01
CASH_OUT,18985,Pierre Roger,46208,27223,Agence_mtn_Cotonou,300000,281015,2022-05-09
CASH_OUT,15861,Pierre Roger,27223,11362,Agence_mtn_Cotonou,300000,284139,2022-05-09
CASH_IN,245350,Agence_mtn_Ouidah,300000,54650,Pierre Roger,11362,256712,2022-05-09
TRANSFER,103028,Pierre Roger,256712,153684,Alexandrie Delmas,624965,521937,2022-05-09
CASH_IN,248084,Agence_mtn_Ouidah,300000,51916,Pierre Roger,153684,401768,2022-05-10
CASH_OUT,166366,Pierre Roger,401768,235402,Agence_mtn_Ouidah,300000,133634,2022-05-10
TRANSFER,49855,Richard Le Descamps,98059,48204,Pierre Roger,235402,285257,2022-05-11
TRANSFER,10286,Pierre Roger,285257,274971,Pierre Roger,285257,274971,2022-05-18
CASH_OUT,87522,Pierre Roger,274971,187449,Agence_mtn_Cotonou,300000,212478,2022-05-21
CASH_OUT,70814,Pierre Roger,187449,116635,Agence_mtn_Ouidah,300000,229186,2022-05-25
TRANSFER,78144,Jean Benard,142900,64756,Pierre Roger,116635,194779,2022-05-26
CASH_IN,232846,Agence_mtn_Ouidah,300000,67154,Pierre Roger,194779,427625,2022-05-26
CASH_IN,198048,Agence_mtn_Ouidah,300000,101952,Émilie Moulin,-10346,187702,2022-05-02
TRANSFER,187685,Philippine Courtois,559497,371812,Émilie Moulin,187702,375387,2022-05-04
CASH_OUT,53626,Émilie Moulin,375387,321761,Agence_mtn_Ouidah,300000,246374,2022-05-09
CASH_IN,91154,Agence_mtn_Cotonou,300000,208846,Émilie Moulin,321761,412915,2022-05-10
CASH_IN,136104,Agence_mtn_Ouidah,300000,163896,Émilie Moulin,412915,549019,2022-05-10
CASH_OUT,393411,Émilie Moulin,549019,155608,Agence_mtn_Cotonou,300000,-93411,2022-05-10
CASH_IN,232076,Agence_mtn_Ouidah,300000,67924,Émilie Moulin,155608,387684,2022-05-11
CASH_OUT,146494,Émilie Moulin,387684,241190,Agence_mtn_Ouidah,300000,153506,2022-05-12
CASH_IN,82361,Agence_mtn_Cotonou,300000,217639,Émilie Moulin,241190,323551,2022-05-14
CASH_IN,42182,Agence_mtn_Cotonou,300000,257818,Émilie Moulin,323551,365733,2022-05-17
CASH_IN,258353,Agence_mtn_Abomey,300000,41647,Émilie Moulin,365733,624086,2022-05-19
TRANSFER,283808,Rémy Le Michaud,315320,31512,Émilie Moulin,624086,907894,2022-05-21
CASH_IN,124952,Agence_mtn_Cotonou,300000,175048,Émilie Moulin,907894,1032846,2022-05-27
CASH_OUT,33717,Philippine Courtois,371812,338095,Agence_mtn_Ouidah,300000,266283,2022-05-01
CASH_OUT,299767,Philippine Courtois,338095,38328,Agence_mtn_Ouidah,300000,233,2022-05-11
CASH_OUT,36699,Philippine Courtois,38328,1629,Agence_mtn_Abomey,300000,263301,2022-05-16
TRANSFER,553,Philippine Courtois,1629,1076,Léon Martins-Briand,271511,270958,2022-05-18
TRANSFER,13735,Rémy Le Michaud,31512,17777,Philippine Courtois,1076,14811,2022-05-18
CASH_IN,64069,Agence_mtn_Cotonou,300000,235931,Philippine Courtois,14811,78880,2022-05-22
TRANSFER,184845,Alexandrie Delmas,521937,337092,Philippine Courtois,78880,263725,2022-05-23
CASH_OUT,189410,Philippine Courtois,263725,74315,Agence_mtn_Cotonou,300000,110590,2022-05-25
CASH_OUT,17846,Philippine Courtois,74315,56469,Agence_mtn_Ouidah,300000,282154,2022-05-26
CASH_IN,161594,Agence_mtn_Abomey,300000,138406,Roland Garcia,-254173,-92579,2022-05-03
CASH_IN,166436,Agence_mtn_Ouidah,300000,133564,Roland Garcia,-92579,73857,2022-05-05
CASH_IN,127684,Agence_mtn_Cotonou,300000,172316,Roland Garcia,73857,201541,2022-05-06
CASH_OUT,182503,Roland Garcia,201541,19038,Agence_mtn_Cotonou,300000,117497,2022-05-11
CASH_IN,138446,Agence_mtn_Ouidah,300000,161554,Roland Garcia,19038,157484,2022-05-18
TRANSFER,140359,Roland Garcia,157484,17125,Honoré du Laurent,809893,669534,2022-05-18
CASH_OUT,9439,Roland Garcia,17125,7686,Agence_mtn_Ouidah,300000,290561,2022-05-20
CASH_OUT,2694,Roland Garcia,7686,4992,Agence_mtn_Ouidah,300000,297306,2022-05-22
TRANSFER,1858,Roland Garcia,4992,3134,Nathalie Peron,5994,4136,2022-05-22
TRANSFER,2026,Roland Garcia,3134,1108,Honoré du Laurent,669534,667508,2022-05-25
TRANSFER,29666,Richard Le Descamps,48204,18538,Roland Garcia,1108,30774,2022-05-27
TRANSFER,28337,Roland Garcia,30774,2437,Alexandrie Delmas,337092,308755,2022-05-27
CASH_IN,297241,Agence_mtn_Cotonou,300000,2759,Isabelle Rossi,-210946,86295,2022-05-03
CASH_IN,71593,Agence_mtn_Abomey,300000,228407,Isabelle Rossi,86295,157888,2022-05-05
CASH_IN,282276,Agence_mtn_Cotonou,300000,17724,Isabelle Rossi,157888,440164,2022-05-08
TRANSFER,2889,Nathalie Peron,4136,1247,Isabelle Rossi,440164,443053,2022-05-10
CASH_IN,3636,Agence_mtn_Cotonou,300000,296364,Isabelle Rossi,443053,446689,2022-05-12
CASH_OUT,308146,Isabelle Rossi,446689,138543,Agence_mtn_Abomey,300000,-8146,2022-05-13
CASH_OUT,79527,Isabelle Rossi,138543,59016,Agence_mtn_Abomey,300000,220473,2022-05-15
CASH_IN,180486,Agence_mtn_Ouidah,300000,119514,Isabelle Rossi,59016,239502,2022-05-24
CASH_IN,165383,Agence_mtn_Abomey,300000,134617,Isabelle Rossi,239502,404885,2022-05-26
CASH_IN,200538,Agence_mtn_Cotonou,300000,99462,Gabriel Humbert,-1054696,-854158,2022-05-02
CASH_IN,114275,Agence_mtn_Cotonou,300000,185725,Gabriel Humbert,-854158,-739883,2022-05-06
CASH_IN,86858,Agence_mtn_Cotonou,300000,213142,Gabriel Humbert,-739883,-653025,2022-05-08
CASH_IN,251655,Agence_mtn_Ouidah,300000,48345,Gabriel Humbert,-653025,-401370,2022-05-08
CASH_IN,18067,Agence_mtn_Ouidah,300000,281933,Gabriel Humbert,-401370,-383303,2022-05-10
CASH_IN,109490,Agence_mtn_Abomey,300000,190510,Gabriel Humbert,-383303,-273813,2022-05-11
CASH_IN,297853,Agence_mtn_Cotonou,300000,2147,Gabriel Humbert,-273813,24040,2022-05-13
CASH_OUT,2538,Gabriel Humbert,24040,21502,Agence_mtn_Abomey,300000,297462,2022-05-14
CASH_OUT,13096,Gabriel Humbert,21502,8406,Agence_mtn_Cotonou,300000,286904,2022-05-14
CASH_IN,147473,Agence_mtn_Ouidah,300000,152527,Gabriel Humbert,8406,155879,2022-05-16
CASH_OUT,38821,Gabriel Humbert,155879,117058,Agence_mtn_Ouidah,300000,261179,2022-05-18
CASH_OUT,54498,Gabriel Humbert,117058,62560,Agence_mtn_Cotonou,300000,245502,2022-05-19
TRANSFER,39016,Gabriel Humbert,62560,23544,Léon Martins-Briand,270958,231942,2022-05-19
TRANSFER,540,Nathalie Peron,1247,707,Gabriel Humbert,23544,24084,2022-05-20
CASH_OUT,22645,Gabriel Humbert,24084,1439,Agence_mtn_Cotonou,300000,277355,2022-05-22
CASH_OUT,724,Gabriel Humbert,1439,715,Agence_mtn_Ouidah,300000,299276,2022-05-23
CASH_OUT,186,Nathalie Peron,707,521,Agence_mtn_Abomey,300000,299814,2022-05-05
TRANSFER,12543,Richard Le Descamps,18538,5995,Nathalie Peron,521,13064,2022-05-07
CASH_IN,238536,Agence_mtn_Abomey,300000,61464,Nathalie Peron,13064,251600,2022-05-08
CASH_IN,144880,Agence_mtn_Cotonou,300000,155120,Nathalie Peron,251600,396480,2022-05-09
CASH_IN,146716,Agence_mtn_Cotonou,300000,153284,Nathalie Peron,396480,543196,2022-05-09
CASH_OUT,517718,Nathalie Peron,543196,25478,Agence_mtn_Abomey,300000,-217718,2022-05-11
CASH_IN,82858,Agence_mtn_Ouidah,300000,217142,Nathalie Peron,25478,108336,2022-05-15
CASH_IN,76783,Agence_mtn_Cotonou,300000,223217,Nathalie Peron,108336,185119,2022-05-16
CASH_IN,5300,Agence_mtn_Abomey,300000,294700,Nathalie Peron,185119,190419,2022-05-18
CASH_OUT,178821,Nathalie Peron,190419,11598,Agence_mtn_Abomey,300000,121179,2022-05-21
CASH_OUT,4155,Nathalie Peron,11598,7443,Agence_mtn_Cotonou,300000,295845,2022-05-21
CASH_IN,81499,Agence_mtn_Abomey,300000,218501,Nathalie Peron,7443,88942,2022-05-24
CASH_OUT,78312,Nathalie Peron,88942,10630,Agence_mtn_Ouidah,300000,221688,2022-05-24
CASH_IN,59896,Agence_mtn_Ouidah,300000,240104,Nathalie Peron,10630,70526,2022-05-24
TRANSFER,3916,Nathalie Peron,70526,66610,Richard Le Descamps,5995,2079,2022-05-25
CASH_OUT,29485,Alexandrie Delmas,308755,279270,Agence_mtn_Ouidah,300000,270515,2022-05-01
TRANSFER,102995,Alexandrie Delmas,279270,176275,Pierre Reynaud,290,-102705,2022-05-03
CASH_OUT,138321,Alexandrie Delmas,176275,37954,Agence_mtn_Abomey,300000,161679,2022-05-04
CASH_OUT,15835,Alexandrie Delmas,37954,22119,Agence_mtn_Abomey,300000,284165,2022-05-04
CASH_OUT,8114,Alexandrie Delmas,22119,14005,Agence_mtn_Cotonou,300000,291886,2022-05-05
CASH_OUT,3466,Alexandrie Delmas,14005,10539,Agence_mtn_Abomey,300000,296534,2022-05-08
TRANSFER,97617,Victoire-Nicole Lopez,1010220,912603,Alexandrie Delmas,10539,108156,2022-05-10
CASH_IN,27759,Agence_mtn_Cotonou,300000,272241,Alexandrie Delmas,108156,135915,2022-05-11
CASH_IN,206948,Agence_mtn_Cotonou,300000,93052,Alexandrie Delmas,135915,342863,2022-05-11
TRANSFER,75948,Léon Martins-Briand,231942,155994,Alexandrie Delmas,342863,418811,2022-05-12
CASH_IN,2090,Agence_mtn_Cotonou,300000,297910,Alexandrie Delmas,418811,420901,2022-05-13
CASH_IN,79617,Agence_mtn_Cotonou,300000,220383,Alexandrie Delmas,420901,500518,2022-05-15
CASH_OUT,377824,Alexandrie Delmas,500518,122694,Agence_mtn_Abomey,300000,-77824,2022-05-15
CASH_IN,227079,Agence_mtn_Ouidah,300000,72921,Alexandrie Delmas,122694,349773,2022-05-16
CASH_OUT,342084,Alexandrie Delmas,349773,7689,Agence_mtn_Abomey,300000,-42084,2022-05-17
TRANSFER,62292,Jean Benard,64756,2464,Alexandrie Delmas,7689,69981,2022-05-18
CASH_IN,150594,Agence_mtn_Cotonou,300000,149406,Alexandrie Delmas,69981,220575,2022-05-20
CASH_IN,13726,Agence_mtn_Cotonou,300000,286274,Alexandrie Delmas,220575,234301,2022-05-22
TRANSFER,51785,Alexandrie Delmas,234301,182516,Jean Benard,2464,-49321,2022-05-25
CASH_IN,9545,Agence_mtn_Abomey,300000,290455,Jean Benard,-49321,-39776,2022-05-01
CASH_IN,109433,Agence_mtn_Cotonou,300000,190567,Jean Benard,-39776,69657,2022-05-04
TRANSFER,73803,Honoré du Laurent,667508,593705,Jean Benard,69657,143460,2022-05-05
CASH_OUT,122945,Jean Benard,143460,20515,Agence_mtn_Ouidah,300000,177055,2022-05-05
TRANSFER,6673,Jean Benard,20515,13842,Léon Martins-Briand,155994,149321,2022-05-08
TRANSFER,142553,Léon Martins-Briand,149321,6768,Jean Benard,13842,156395,2022-05-11
CASH_IN,3965,Agence_mtn_Cotonou,300000,296035,Jean Benard,156395,160360,2022-05-13
TRANSFER,62937,Jean Benard,160360,97423,Jean Benard,160360,97423,2022-05-13
CASH_IN,220828,Agence_mtn_Cotonou,300000,79172,Jean Benard,97423,318251,2022-05-14
CASH_IN,81988,Agence_mtn_Cotonou,300000,218012,Jean Benard,318251,400239,2022-05-16
CASH_IN,299605,Agence_mtn_Cotonou,300000,395,Jean Benard,400239,699844,2022-05-20
CASH_OUT,557066,Jean Benard,699844,142778,Agence_mtn_Ouidah,300000,-257066,2022-05-22
TRANSFER,1769,Léon Martins-Briand,6768,4999,Jean Benard,142778,144547,2022-05-22
CASH_IN,50475,Agence_mtn_Ouidah,300000,249525,Jean Benard,144547,195022,2022-05-22
CASH_IN,285045,Agence_mtn_Ouidah,300000,14955,Jean Benard,195022,480067,2022-05-22
TRANSFER,96920,Jean Benard,480067,383147,Léon Martins-Briand,4999,-91921,2022-05-25
TRANSFER,22473,Honoré du Laurent,593705,571232,Jean Benard,383147,405620,2022-05-26
CASH_IN,161836,Agence_mtn_Cotonou,300000,138164,Étienne Roche,-2980,158856,2022-05-02
CASH_OUT,100527,Étienne Roche,158856,58329,Agence_mtn_Abomey,300000,199473,2022-05-08
TRANSFER,45035,Étienne Roche,58329,13294,Étienne Roche,58329,13294,2022-05-11
TRANSFER,11490,Étienne Roche,13294,1804,Honoré du Laurent,571232,559742,2022-05-17
TRANSFER,841,Étienne Roche,1804,963,Étienne Roche,1804,963,2022-05-17
CASH_IN,249132,Agence_mtn_Abomey,300000,50868,Étienne Roche,963,250095,2022-05-17
TRANSFER,186714,Étienne Roche,250095,63381,Honoré du Laurent,559742,373028,2022-05-20
TRANSFER,63258,Étienne Roche,63381,123,Victoire-Nicole Lopez,912603,849345,2022-05-21
TRANSFER,798189,Victoire-Nicole Lopez,849345,51156,Étienne Roche,123,798312,2022-05-23
CASH_OUT,377943,Étienne Roche,798312,420369,Agence_mtn_Abomey,300000,-77943,2022-05-26
CASH_IN,36959,Agence_mtn_Cotonou,300000,263041,Étienne Roche,420369,457328,2022-05-26
CASH_IN,61056,Agence_mtn_Cotonou,300000,238944,Nathalie Pages,-46265,14791,2022-05-02
CASH_IN,284599,Agence_mtn_Abomey,300000,15401,Nathalie Pages,14791,299390,2022-05-04
TRANSFER,7568,Victoire-Nicole Lopez,51156,43588,Nathalie Pages,299390,306958,2022-05-07
TRANSFER,275856,Nathalie Pages,306958,31102,Nathalie Pages,306958,582814,2022-05-08
TRANSFER,3485,Victoire-Nicole Lopez,43588,40103,Nathalie Pages,31102,34587,2022-05-19
CASH_OUT,20176,Nathalie Pages,34587,14411,Agence_mtn_Abomey,300000,279824,2022-05-19
TRANSFER,15653,Victoire-Nicole Lopez,40103,24450,Nathalie Pages,14411,30064,2022-05-25
CASH_IN,162475,Agence_mtn_Abomey,300000,137525,Antoinette Bertrand,-561154,-398679,2022-05-03
CASH_IN,211135,Agence_mtn_Ouidah,300000,88865,Antoinette Bertrand,-398679,-187544,2022-05-05
CASH_IN,280142,Agence_mtn_Abomey,300000,19858,Antoinette Bertrand,-187544,92598,2022-05-06
CASH_IN,170884,Agence_mtn_Cotonou,300000,129116,Antoinette Bertrand,92598,263482,2022-05-08
TRANSFER,35070,Antoinette Bertrand,263482,228412,Antoinette Bertrand,263482,298552,2022-05-08
CASH_OUT,89367,Antoinette Bertrand,228412,139045,Agence_mtn_Ouidah,300000,210633,2022-05-10
TRANSFER,92950,Antoinette Bertrand,139045,46095,Victoire-Nicole Lopez,24450,-68500,2022-05-12
CASH_IN,45746,Agence_mtn_Abomey,300000,254254,Antoinette Bertrand,46095,91841,2022-05-12
CASH_OUT,78450,Antoinette Bertrand,91841,13391,Agence_mtn_Ouidah,300000,221550,2022-05-14
CASH_IN,126540,Agence_mtn_Abomey,300000,173460,Antoinette Bertrand,13391,139931,2022-05-17
CASH_IN,218025,Agence_mtn_Ouidah,300000,81975,Antoinette Bertrand,139931,357956,2022-05-18
CASH_IN,20810,Agence_mtn_Ouidah,300000,279190,Antoinette Bertrand,357956,378766,2022-05-24
TRANSFER,48095,Antoinette Bertrand,378766,330671,Antoinette Bertrand,378766,426861,2022-05-25
CASH_IN,74334,Agence_mtn_Cotonou,300000,225666,Antoinette Bertrand,330671,405005,2022-05-25
CASH_OUT,5853,Antoinette Bertrand,405005,399152,Agence_mtn_Cotonou,300000,294147,2022-05-25
CASH_IN,138740,Agence_mtn_Abomey,300000,161260,Antoinette Bertrand,399152,537892,2022-05-25
CASH_IN,179702,Agence_mtn_Cotonou,300000,120298,Cécile Delattre-Arnaud,-16584,163118,2022-05-01
TRANSFER,56682,Cécile Delattre-Arnaud,163118,106436,Cécile Delattre-Arnaud,163118,219800,2022-05-02
CASH_IN,129145,Agence_mtn_Abomey,300000,170855,Cécile Delattre-Arnaud,106436,235581,2022-05-05
CASH_OUT,148344,Cécile Delattre-Arnaud,235581,87237,Agence_mtn_Abomey,300000,151656,2022-05-07
TRANSFER,87232,Cécile Delattre-Arnaud,87237,5,Cécile Delattre-Arnaud,87237,5,2022-05-08
CASH_IN,197029,Agence_mtn_Abomey,300000,102971,Cécile Delattre-Arnaud,5,197034,2022-05-08
CASH_IN,256507,Agence_mtn_Cotonou,300000,43493,Cécile Delattre-Arnaud,197034,453541,2022-05-09
TRANSFER,181797,Cécile Delattre-Arnaud,453541,271744,Cécile Delattre-Arnaud,453541,271744,2022-05-09
CASH_OUT,229087,Cécile Delattre-Arnaud,271744,42657,Agence_mtn_Cotonou,300000,70913,2022-05-09
CASH_IN,229579,Agence_mtn_Abomey,300000,70421,Cécile Delattre-Arnaud,42657,272236,2022-05-11
CASH_OUT,64394,Cécile Delattre-Arnaud,272236,207842,Agence_mtn_Abomey,300000,235606,2022-05-11
CASH_IN,175440,Agence_mtn_Abomey,300000,124560,Cécile Delattre-Arnaud,207842,383282,2022-05-12
CASH_OUT,126084,Cécile Delattre-Arnaud,383282,257198,Agence_mtn_Ouidah,300000,173916,2022-05-20
CASH_IN,132027,Agence_mtn_Ouidah,300000,167973,Cécile Delattre-Arnaud,257198,389225,2022-05-21
CASH_OUT,124170,Cécile Delattre-Arnaud,389225,265055,Agence_mtn_Cotonou,300000,175830,2022-05-23
CASH_OUT,166445,Cécile Delattre-Arnaud,265055,98610,Agence_mtn_Abomey,300000,133555,2022-05-24
CASH_IN,292892,Agence_mtn_Cotonou,300000,7108,Cécile Delattre-Arnaud,98610,391502,2022-05-25
CASH_OUT,231395,Cécile Delattre-Arnaud,391502,160107,Agence_mtn_Cotonou,300000,68605,2022-05-26
CASH_IN,237020,Agence_mtn_Cotonou,300000,62980,Pierre Reynaud,-102705,134315,2022-05-01
CASH_OUT,86964,Pierre Reynaud,134315,47351,Agence_mtn_Abomey,300000,213036,2022-05-02
CASH_IN,172771,Agence_mtn_Ouidah,300000,127229,Pierre Reynaud,47351,220122,2022-05-06
TRANSFER,110362,Pierre Reynaud,220122,109760,Pierre Reynaud,220122,109760,2022-05-07
CASH_IN,119165,Agence_mtn_Ouidah,300000,180835,Pierre Reynaud,109760,228925,2022-05-09
CASH_IN,77999,Agence_mtn_Cotonou,300000,222001,Pierre Reynaud,228925,306924,2022-05-10
TRANSFER,296792,Pierre Reynaud,306924,10132,Pierre Reynaud,306924,10132,2022-05-11
CASH_OUT,3639,Pierre Reynaud,10132,6493,Agence_mtn_Cotonou,300000,296361,2022-05-18
CASH_OUT,2895,Pierre Reynaud,6493,3598,Agence_mtn_Ouidah,300000,297105,2022-05-19
CASH_OUT,770,Pierre Reynaud,3598,2828,Agence_mtn_Ouidah,300000,299230,2022-05-20
CASH_IN,33034,Agence_mtn_Cotonou,300000,266966,Pierre Reynaud,2828,35862,2022-05-23
CASH_OUT,31167,Pierre Reynaud,35862,4695,Agence_mtn_Abomey,300000,268833,2022-05-24
CASH_OUT,2107,Pierre Reynaud,4695,2588,Agence_mtn_Abomey,300000,297893,2022-05-27
CASH_IN,155275,Agence_mtn_Abomey,300000,144725,Virginie Le Gall,-338356,-183081,2022-05-01
CASH_IN,297071,Agence_mtn_Cotonou,300000,2929,Virginie Le Gall,-183081,113990,2022-05-01
TRANSFER,29360,Virginie Le Gall,113990,84630,Virginie Le Gall,113990,143350,2022-05-03
CASH_IN,77265,Agence_mtn_Ouidah,300000,222735,Virginie Le Gall,84630,161895,2022-05-04
CASH_OUT,122587,Virginie Le Gall,161895,39308,Agence_mtn_Abomey,300000,177413,2022-05-04
TRANSFER,37102,Virginie Le Gall,39308,2206,Virginie Le Gall,39308,2206,2022-05-09
CASH_OUT,2171,Virginie Le Gall,2206,35,Agence_mtn_Ouidah,300000,297829,2022-05-10
CASH_IN,295306,Agence_mtn_Cotonou,300000,4694,Virginie Le Gall,35,295341,2022-05-18
CASH_IN,34288,Agence_mtn_Cotonou,300000,265712,Virginie Le Gall,295341,329629,2022-05-19
CASH_OUT,154727,Virginie Le Gall,329629,174902,Agence_mtn_Ouidah,300000,145273,2022-05-21
CASH_IN,71685,Agence_mtn_Abomey,300000,228315,Virginie Le Gall,174902,246587,2022-05-26
CASH_IN,170093,Agence_mtn_Cotonou,300000,129907,Valentine Richard-Bourdon,-1362253,-1192160,2022-05-01
CASH_IN,109349,Agence_mtn_Ouidah,300000,190651,Valentine Richard-Bourdon,-1192160,-1082811,2022-05-01
CASH_IN,100904,Agence_mtn_Cotonou,300000,199096,Valentine Richard-Bourdon,-1082811,-981907,2022-05-01
CASH_IN,86551,Agence_mtn_Cotonou,300000,213449,Valentine Richard-Bourdon,-981907,-895356,2022-05-02
CASH_IN,103927,Agence_mtn_Ouidah,300000,196073,Valentine Richard-Bourdon,-895356,-791429,2022-05-05
CASH_IN,49459,Agence_mtn_Cotonou,300000,250541,Valentine Richard-Bourdon,-791429,-741970,2022-05-12
CASH_IN,87868,Agence_mtn_Abomey,300000,212132,Valentine Richard-Bourdon,-741970,-654102,2022-05-13
CASH_IN,12079,Agence_mtn_Cotonou,300000,287921,Valentine Richard-Bourdon,-654102,-642023,2022-05-15
CASH_IN,149490,Agence_mtn_Abomey,300000,150510,Valentine Richard-Bourdon,-642023,-492533,2022-05-16
CASH_IN,295612,Agence_mtn_Abomey,300000,4388,Valentine Richard-Bourdon,-492533,-196921,2022-05-16
CASH_IN,14524,Agence_mtn_Cotonou,300000,285476,Valentine Richard-Bourdon,-196921,-182397,2022-05-17
CASH_IN,212513,Agence_mtn_Ouidah,300000,87487,Valentine Richard-Bourdon,-182397,30116,2022-05-17
TRANSFER,8780,Valentine Richard-Bourdon,30116,21336,Valentine Richard-Bourdon,30116,21336,2022-05-18
CASH_OUT,8948,Valentine Richard-Bourdon,21336,12388,Agence_mtn_Abomey,300000,291052,2022-05-21
CASH_IN,274600,Agence_mtn_Cotonou,300000,25400,Valentine Richard-Bourdon,12388,286988,2022-05-26
CASH_IN,16056,Agence_mtn_Abomey,300000,283944,François Michel-Legros,-458093,-442037,2022-05-02
CASH_IN,162834,Agence_mtn_Abomey,300000,137166,François Michel-Legros,-442037,-279203,2022-05-02
CASH_IN,26838,Agence_mtn_Ouidah,300000,273162,François Michel-Legros,-279203,-252365,2022-05-03
CASH_IN,223764,Agence_mtn_Ouidah,300000,76236,François Michel-Legros,-252365,-28601,2022-05-04
CASH_IN,16752,Agence_mtn_Ouidah,300000,283248,François Michel-Legros,-28601,-11849,2022-05-04
CASH_IN,3112,Agence_mtn_Abomey,300000,296888,François Michel-Legros,-11849,-8737,2022-05-07
CASH_IN,26024,Agence_mtn_Ouidah,300000,273976,François Michel-Legros,-8737,17287,2022-05-11
CASH_OUT,2568,François Michel-Legros,17287,14719,Agence_mtn_Abomey,300000,297432,2022-05-11
CASH_OUT,11402,François Michel-Legros,14719,3317,Agence_mtn_Cotonou,300000,288598,2022-05-14
CASH_IN,64398,Agence_mtn_Ouidah,300000,235602,François Michel-Legros,3317,67715,2022-05-16
CASH_IN,213305,Agence_mtn_Abomey,300000,86695,François Michel-Legros,67715,281020,2022-05-18
TRANSFER,180637,François Michel-Legros,281020,100383,François Michel-Legros,281020,461657,2022-05-22
CASH_OUT,44473,François Michel-Legros,100383,55910,Agence_mtn_Cotonou,300000,255527,2022-05-23
CASH_IN,149953,Agence_mtn_Ouidah,300000,150047,François Michel-Legros,55910,205863,2022-05-23
CASH_OUT,193617,François Michel-Legros,205863,12246,Agence_mtn_Ouidah,300000,106383,2022-05-25
CASH_IN,265167,Agence_mtn_Abomey,300000,34833,Emmanuelle Georges,-472202,-207035,2022-05-02
CASH_IN,47020,Agence_mtn_Abomey,300000,252980,Emmanuelle Georges,-207035,-160015,2022-05-06
CASH_IN,140055,Agence_mtn_Abomey,300000,159945,Emmanuelle Georges,-160015,-19960,2022-05-06
CASH_IN,221530,Agence_mtn_Cotonou,300000,78470,Emmanuelle Georges,-19960,201570,2022-05-13
CASH_IN,261457,Agence_mtn_Cotonou,300000,38543,Emmanuelle Georges,201570,463027,2022-05-19
CASH_IN,279285,Agence_mtn_Cotonou,300000,20715,Emmanuelle Georges,463027,742312,2022-05-19
CASH_IN,190559,Agence_mtn_Ouidah,300000,109441,Emmanuelle Georges,742312,932871,2022-05-22
CASH_IN,180110,Agence_mtn_Ouidah,300000,119890,Emmanuelle Georges,932871,1112981,2022-05-24
CASH_OUT,260943,Emmanuelle Georges,1112981,852038,Agence_mtn_Abomey,300000,39057,2022-05-25
CASH_IN,96599,Agence_mtn_Cotonou,300000,203401,Emmanuelle Georges,852038,948637,2022-05-26
CASH_IN,190410,Agence_mtn_Abomey,300000,109590,Caroline-Lorraine Humbert,-106095,84315,2022-05-02
CASH_IN,60509,Agence_mtn_Ouidah,300000,239491,Caroline-Lorraine Humbert,84315,144824,2022-05-10
CASH_IN,239138,Agence_mtn_Cotonou,300000,60862,Caroline-Lorraine Humbert,144824,383962,2022-05-11
TRANSFER,9409,Caroline-Lorraine Humbert,383962,374553,Caroline-Lorraine Humbert,383962,374553,2022-05-11
CASH_IN,72189,Agence_mtn_Ouidah,300000,227811,Caroline-Lorraine Humbert,374553,446742,2022-05-11
CASH_IN,144954,Agence_mtn_Abomey,300000,155046,Caroline-Lorraine Humbert,446742,591696,2022-05-14
CASH_OUT,2882,Caroline-Lorraine Humbert,591696,588814,Agence_mtn_Abomey,300000,297118,2022-05-16
CASH_OUT,182725,Caroline-Lorraine Humbert,588814,406089,Agence_mtn_Abomey,300000,117275,2022-05-17
CASH_OUT,392032,Caroline-Lorraine Humbert,406089,14057,Agence_mtn_Ouidah,300000,-92032,2022-05-24
CASH_IN,182324,Agence_mtn_Ouidah,300000,117676,Tristan Thomas,-1209555,-1027231,2022-05-01
CASH_IN,238769,Agence_mtn_Cotonou,300000,61231,Tristan Thomas,-1027231,-788462,2022-05-04
CASH_IN,236067,Agence_mtn_Ouidah,300000,63933,Tristan Thomas,-788462,-552395,2022-05-07
CASH_IN,185299,Agence_mtn_Abomey,300000,114701,Tristan Thomas,-552395,-367096,2022-05-09
CASH_IN,129920,Agence_mtn_Ouidah,300000,170080,Tristan Thomas,-367096,-237176,2022-05-10
CASH_IN,157033,Agence_mtn_Cotonou,300000,142967,Tristan Thomas,-237176,-80143,2022-05-11
CASH_IN,126429,Agence_mtn_Cotonou,300000,173571,Tristan Thomas,-80143,46286,2022-05-12
CASH_OUT,9025,Tristan Thomas,46286,37261,Agence_mtn_Cotonou,300000,290975,2022-05-12
CASH_OUT,34578,Tristan Thomas,37261,2683,Agence_mtn_Ouidah,300000,265422,2022-05-20
TRANSFER,1944,Tristan Thomas,2683,739,Tristan Thomas,2683,739,2022-05-21
CASH_IN,194359,Agence_mtn_Cotonou,300000,105641,Tristan Thomas,739,195098,2022-05-23
CASH_IN,9073,Agence_mtn_Ouidah,300000,290927,Tristan Thomas,195098,204171,2022-05-23
CASH_OUT,102955,Tristan Thomas,204171,101216,Agence_mtn_Abomey,300000,197045,2022-05-25
CASH_IN,76629,Agence_mtn_Ouidah,300000,223371,Alphonse Leclercq-Rousseau,-286251,-209622,2022-05-01
CASH_IN,244994,Agence_mtn_Cotonou,300000,55006,Alphonse Leclercq-Rousseau,-209622,35372,2022-05-03
CASH_OUT,18092,Alphonse Leclercq-Rousseau,35372,17280,Agence_mtn_Ouidah,300000,281908,2022-05-03
CASH_OUT,2067,Alphonse Leclercq-Rousseau,17280,15213,Agence_mtn_Cotonou,300000,297933,2022-05-04
CASH_OUT,10802,Alphonse Leclercq-Rousseau,15213,4411,Agence_mtn_Cotonou,300000,289198,2022-05-04
CASH_IN,85285,Agence_mtn_Abomey,300000,214715,Alphonse Leclercq-Rousseau,4411,89696,2022-05-04
TRANSFER,56744,Alphonse Leclercq-Rousseau,89696,32952,Alphonse Leclercq-Rousseau,89696,32952,2022-05-05
TRANSFER,26688,Alphonse Leclercq-Rousseau,32952,6264,Alphonse Leclercq-Rousseau,32952,6264,2022-05-06
TRANSFER,840,Alphonse Leclercq-Rousseau,6264,5424,Alphonse Leclercq-Rousseau,6264,5424,2022-05-07
CASH_OUT,3174,Alphonse Leclercq-Rousseau,5424,2250,Agence_mtn_Abomey,300000,296826,2022-05-12
CASH_OUT,2185,Alphonse Leclercq-Rousseau,2250,65,Agence_mtn_Abomey,300000,297815,2022-05-16
CASH_IN,235254,Agence_mtn_Abomey,300000,64746,Alphonse Leclercq-Rousseau,65,235319,2022-05-18
CASH_OUT,181431,Alphonse Leclercq-Rousseau,235319,53888,Agence_mtn_Cotonou,300000,118569,2022-05-22
CASH_OUT,11882,Alphonse Leclercq-Rousseau,53888,42006,Agence_mtn_Abomey,300000,288118,2022-05-24
CASH_OUT,2350,Alphonse Leclercq-Rousseau,42006,39656,Agence_mtn_Abomey,300000,297650,2022-05-27
CASH_IN,174181,Agence_mtn_Abomey,300000,125819,Astrid Gay de la Brunet,-55661,118520,2022-05-02
TRANSFER,35458,Astrid Gay de la Brunet,118520,83062,Astrid Gay de la Brunet,118520,153978,2022-05-05
CASH_OUT,32610,Astrid Gay de la Brunet,83062,50452,Agence_mtn_Abomey,300000,267390,2022-05-09
CASH_IN,65024,Agence_mtn_Ouidah,300000,234976,Astrid Gay de la Brunet,50452,115476,2022-05-10
CASH_OUT,53964,Astrid Gay de la Brunet,115476,61512,Agence_mtn_Abomey,300000,246036,2022-05-14
TRANSFER,23663,Astrid Gay de la Brunet,61512,37849,Astrid Gay de la Brunet,61512,37849,2022-05-15
TRANSFER,30008,Astrid Gay de la Brunet,37849,7841,Astrid Gay de la Brunet,37849,7841,2022-05-17
CASH_IN,286858,Agence_mtn_Ouidah,300000,13142,Astrid Gay de la Brunet,7841,294699,2022-05-18
TRANSFER,65025,Astrid Gay de la Brunet,294699,229674,Astrid Gay de la Brunet,294699,359724,2022-05-19
CASH_IN,64769,Agence_mtn_Cotonou,300000,235231,Astrid Gay de la Brunet,229674,294443,2022-05-19
TRANSFER,70521,Astrid Gay de la Brunet,294443,223922,Astrid Gay de la Brunet,294443,364964,2022-05-20
CASH_IN,213364,Agence_mtn_Ouidah,300000,86636,Astrid Gay de la Brunet,223922,437286,2022-05-21
CASH_IN,211447,Agence_mtn_Cotonou,300000,88553,Astrid Gay de la Brunet,437286,648733,2022-05-22
CASH_IN,85234,Agence_mtn_Cotonou,300000,214766,Astrid Gay de la Brunet,648733,733967,2022-05-24
CASH_OUT,531942,Astrid Gay de la Brunet,733967,202025,Agence_mtn_Ouidah,300000,-231942,2022-05-24
CASH_IN,36745,Agence_mtn_Abomey,300000,263255,Bertrand Charles,-66040,-29295,2022-05-04
CASH_IN,171499,Agence_mtn_Cotonou,300000,128501,Bertrand Charles,-29295,142204,2022-05-06
TRANSFER,83137,Bertrand Charles,142204,59067,Bertrand Charles,142204,59067,2022-05-07
CASH_OUT,37512,Bertrand Charles,59067,21555,Agence_mtn_Cotonou,300000,262488,2022-05-12
TRANSFER,3332,Bertrand Charles,21555,18223,Bertrand Charles,21555,18223,2022-05-19
TRANSFER,12506,Bertrand Charles,18223,5717,Bertrand Charles,18223,5717,2022-05-20
TRANSFER,1034,Bertrand Charles,5717,4683,Bertrand Charles,5717,4683,2022-05-22
CASH_OUT,1503,Bertrand Charles,4683,3180,Agence_mtn_Abomey,300000,298497,2022-05-22
CASH_OUT,2958,Bertrand Charles,3180,222,Agence_mtn_Ouidah,300000,297042,2022-05-25
CASH_OUT,205,Bertrand Charles,222,17,Agence_mtn_Cotonou,300000,299795,2022-05-27
CASH_IN,120773,Agence_mtn_Cotonou,300000,179227,Sébastien Vallée,-129106,-8333,2022-05-01
CASH_IN,36900,Agence_mtn_Cotonou,300000,263100,Sébastien Vallée,-8333,28567,2022-05-01
CASH_IN,113461,Agence_mtn_Abomey,300000,186539,Sébastien Vallée,28567,142028,2022-05-02
CASH_OUT,103349,Sébastien Vallée,142028,38679,Agence_mtn_Cotonou,300000,196651,2022-05-03
CASH_OUT,29939,Sébastien Vallée,38679,8740,Agence_mtn_Abomey,300000,270061,2022-05-08
CASH_IN,213443,Agence_mtn_Cotonou,300000,86557,Sébastien Vallée,8740,222183,2022-05-09
TRANSFER,210203,Sébastien Vallée,222183,11980,Sébastien Vallée,222183,432386,2022-05-09
CASH_OUT,4205,Sébastien Vallée,11980,7775,Agence_mtn_Abomey,300000,295795,2022-05-10
CASH_IN,296681,Agence_mtn_Cotonou,300000,3319,Sébastien Vallée,7775,304456,2022-05-11
CASH_IN,9812,Agence_mtn_Abomey,300000,290188,Sébastien Vallée,304456,314268,2022-05-14
CASH_OUT,57378,Sébastien Vallée,314268,256890,Agence_mtn_Abomey,300000,242622,2022-05-14
CASH_OUT,34790,Sébastien Vallée,256890,222100,Agence_mtn_Abomey,300000,265210,2022-05-20
TRANSFER,140761,Sébastien Vallée,222100,81339,Sébastien Vallée,222100,81339,2022-05-21
TRANSFER,49477,Sébastien Vallée,81339,31862,Sébastien Vallée,81339,130816,2022-05-22
CASH_IN,44167,Agence_mtn_Cotonou,300000,255833,Sébastien Vallée,31862,76029,2022-05-22
CASH_OUT,71317,Sébastien Vallée,76029,4712,Agence_mtn_Abomey,300000,228683,2022-05-24
CASH_IN,227430,Agence_mtn_Ouidah,300000,72570,Sébastien Vallée,4712,232142,2022-05-27
CASH_IN,17215,Agence_mtn_Cotonou,300000,282785,Céline Gomez,-166153,-148938,2022-05-01
CASH_IN,19777,Agence_mtn_Ouidah,300000,280223,Céline Gomez,-148938,-129161,2022-05-02
CASH_IN,243208,Agence_mtn_Ouidah,300000,56792,Céline Gomez,-129161,114047,2022-05-06
CASH_OUT,60644,Céline Gomez,114047,53403,Agence_mtn_Cotonou,300000,239356,2022-05-08
CASH_OUT,14990,Céline Gomez,53403,38413,Agence_mtn_Ouidah,300000,285010,2022-05-08
CASH_OUT,14185,Céline Gomez,38413,24228,Agence_mtn_Abomey,300000,285815,2022-05-24
CASH_IN,150894,Agence_mtn_Cotonou,300000,149106,Léon Martins-Briand,-91921,58973,2022-05-04
CASH_IN,176607,Agence_mtn_Abomey,300000,123393,Léon Martins-Briand,58973,235580,2022-05-06
TRANSFER,83317,Léon Martins-Briand,235580,152263,Léon Martins-Briand,235580,152263,2022-05-07
CASH_OUT,19230,Léon Martins-Briand,152263,133033,Agence_mtn_Ouidah,300000,280770,2022-05-09
CASH_IN,270661,Agence_mtn_Abomey,300000,29339,Léon Martins-Briand,133033,403694,2022-05-11
CASH_IN,107672,Agence_mtn_Abomey,300000,192328,Léon Martins-Briand,403694,511366,2022-05-12
CASH_OUT,74801,Léon Martins-Briand,511366,436565,Agence_mtn_Ouidah,300000,225199,2022-05-20
CASH_IN,142566,Agence_mtn_Ouidah,300000,157434,Léon Martins-Briand,436565,579131,2022-05-21
CASH_OUT,93021,Léon Martins-Briand,579131,486110,Agence_mtn_Abomey,300000,206979,2022-05-22
CASH_IN,96330,Agence_mtn_Ouidah,300000,203670,Léon Martins-Briand,486110,582440,2022-05-23
CASH_IN,127872,Agence_mtn_Abomey,300000,172128,Léon Martins-Briand,582440,710312,2022-05-23
CASH_IN,161351,Agence_mtn_Abomey,300000,138649,Léon Martins-Briand,710312,871663,2022-05-25
CASH_OUT,624317,Léon Martins-Briand,871663,247346,Agence_mtn_Abomey,300000,-324317,2022-05-27
CASH_IN,227444,Agence_mtn_Ouidah,300000,72556,Léon Lecoq,-333224,-105780,2022-05-01
CASH_IN,226854,Agence_mtn_Ouidah,300000,73146,Léon Lecoq,-105780,121074,2022-05-01
TRANSFER,37422,Léon Lecoq,121074,83652,Léon Lecoq,121074,83652,2022-05-05
CASH_IN,296704,Agence_mtn_Abomey,300000,3296,Léon Lecoq,83652,380356,2022-05-06
TRANSFER,328815,Léon Lecoq,380356,51541,Léon Lecoq,380356,709171,2022-05-07
CASH_OUT,1864,Léon Lecoq,51541,49677,Agence_mtn_Abomey,300000,298136,2022-05-09
CASH_OUT,16441,Léon Lecoq,49677,33236,Agence_mtn_Abomey,300000,283559,2022-05-09
CASH_OUT,29119,Léon Lecoq,33236,4117,Agence_mtn_Cotonou,300000,270881,2022-05-09
CASH_IN,158633,Agence_mtn_Cotonou,300000,141367,Léon Lecoq,4117,162750,2022-05-12
TRANSFER,125589,Léon Lecoq,162750,37161,Léon Lecoq,162750,37161,2022-05-13
TRANSFER,1680,Léon Lecoq,37161,35481,Léon Lecoq,37161,35481,2022-05-14
CASH_IN,182635,Agence_mtn_Ouidah,300000,117365,Léon Lecoq,35481,218116,2022-05-16
CASH_OUT,5349,Léon Lecoq,218116,212767,Agence_mtn_Abomey,300000,294651,2022-05-18
CASH_OUT,158167,Léon Lecoq,212767,54600,Agence_mtn_Ouidah,300000,141833,2022-05-20
CASH_IN,295198,Agence_mtn_Abomey,300000,4802,Léon Lecoq,54600,349798,2022-05-20
CASH_IN,125661,Agence_mtn_Cotonou,300000,174339,Victoire-Nicole Lopez,-68500,57161,2022-05-02
CASH_OUT,43495,Victoire-Nicole Lopez,57161,13666,Agence_mtn_Ouidah,300000,256505,2022-05-05
CASH_OUT,3698,Victoire-Nicole Lopez,13666,9968,Agence_mtn_Ouidah,300000,296302,2022-05-08
CASH_IN,299857,Agence_mtn_Abomey,300000,143,Victoire-Nicole Lopez,9968,309825,2022-05-11
CASH_OUT,300083,Victoire-Nicole Lopez,309825,9742,Agence_mtn_Cotonou,300000,-83,2022-05-14
CASH_IN,155059,Agence_mtn_Cotonou,300000,144941,Victoire-Nicole Lopez,9742,164801,2022-05-15
CASH_IN,95128,Agence_mtn_Abomey,300000,204872,Victoire-Nicole Lopez,164801,259929,2022-05-15
TRANSFER,80442,Victoire-Nicole Lopez,259929,179487,Victoire-Nicole Lopez,259929,179487,2022-05-16
CASH_OUT,56186,Victoire-Nicole Lopez,179487,123301,Agence_mtn_Abomey,300000,243814,2022-05-16
CASH_OUT,38998,Victoire-Nicole Lopez,123301,84303,Agence_mtn_Cotonou,300000,261002,2022-05-18
CASH_IN,24129,Agence_mtn_Ouidah,300000,275871,Victoire-Nicole Lopez,84303,108432,2022-05-19
CASH_OUT,35795,Victoire-Nicole Lopez,108432,72637,Agence_mtn_Ouidah,300000,264205,2022-05-21
CASH_IN,56932,Agence_mtn_Ouidah,300000,243068,Victoire-Nicole Lopez,72637,129569,2022-05-22
CASH_OUT,225,Victoire-Nicole Lopez,129569,129344,Agence_mtn_Cotonou,300000,299775,2022-05-25
CASH_IN,270139,Agence_mtn_Ouidah,300000,29861,Joséphine Gros,-4360,265779,2022-05-06
CASH_OUT,252714,Joséphine Gros,265779,13065,Agence_mtn_Abomey,300000,47286,2022-05-07
TRANSFER,7780,Joséphine Gros,13065,5285,Joséphine Gros,13065,5285,2022-05-12
TRANSFER,3234,Joséphine Gros,5285,2051,Joséphine Gros,5285,8519,2022-05-12
CASH_IN,284655,Agence_mtn_Abomey,300000,15345,Joséphine Gros,2051,286706,2022-05-24
CASH_IN,238758,Agence_mtn_Cotonou,300000,61242,Joséphine Gros,286706,525464,2022-05-25
CASH_IN,175553,Agence_mtn_Abomey,300000,124447,Joséphine Gros,525464,701017,2022-05-25
CASH_OUT,19368,Joséphine Gros,701017,681649,Agence_mtn_Cotonou,300000,280632,2022-05-25
CASH_IN,211947,Agence_mtn_Ouidah,300000,88053,Joséphine Gros,681649,893596,2022-05-26
CASH_OUT,766097,Joséphine Gros,893596,127499,Agence_mtn_Ouidah,300000,-466097,2022-05-27
CASH_IN,233638,Agence_mtn_Cotonou,300000,66362,Marine Chauvet-Potier,-68261,165377,2022-05-01
CASH_IN,84668,Agence_mtn_Cotonou,300000,215332,Marine Chauvet-Potier,165377,250045,2022-05-02
CASH_IN,27791,Agence_mtn_Ouidah,300000,272209,Marine Chauvet-Potier,250045,277836,2022-05-03
CASH_OUT,171388,Marine Chauvet-Potier,277836,106448,Agence_mtn_Ouidah,300000,128612,2022-05-03
TRANSFER,2540,Marine Chauvet-Potier,106448,103908,Marine Chauvet-Potier,106448,103908,2022-05-04
TRANSFER,29374,Marine Chauvet-Potier,103908,74534,Marine Chauvet-Potier,103908,74534,2022-05-05
CASH_IN,78338,Agence_mtn_Abomey,300000,221662,Marine Chauvet-Potier,74534,152872,2022-05-05
TRANSFER,142078,Marine Chauvet-Potier,152872,10794,Marine Chauvet-Potier,152872,10794,2022-05-09
CASH_IN,175096,Agence_mtn_Cotonou,300000,124904,Marine Chauvet-Potier,10794,185890,2022-05-11
TRANSFER,154589,Marine Chauvet-Potier,185890,31301,Marine Chauvet-Potier,185890,340479,2022-05-11
TRANSFER,14329,Marine Chauvet-Potier,31301,16972,Marine Chauvet-Potier,31301,16972,2022-05-11
CASH_IN,141094,Agence_mtn_Ouidah,300000,158906,Marine Chauvet-Potier,16972,158066,2022-05-16
CASH_IN,65722,Agence_mtn_Ouidah,300000,234278,Marine Chauvet-Potier,158066,223788,2022-05-21
CASH_IN,197824,Agence_mtn_Cotonou,300000,102176,Marine Chauvet-Potier,223788,421612,2022-05-23
CASH_IN,264456,Agence_mtn_Ouidah,300000,35544,Marine Chauvet-Potier,421612,686068,2022-05-24
CASH_IN,53531,Agence_mtn_Abomey,300000,246469,Alexandrie Delmas,1929800,1983331,2022-06-10
CASH_OUT,410207,Alexandrie Delmas,1983331,1573124,Agence_mtn_Abomey,300000,-110207,2022-06-19
TRANSFER,1524490,Alexandrie Delmas,1573124,48634,Laure Philippe,1678800,154310,2022-06-24
CASH_OUT,404569,Céline Gomez,572600,168031,Agence_mtn_Ouidah,300000,-104569,2022-06-09
CASH_IN,299008,Agence_mtn_Abomey,300000,992,Céline Gomez,168031,467039,2022-06-16
CASH_OUT,350950,Céline Gomez,467039,116089,Agence_mtn_Abomey,300000,-50950,2022-06-19
CASH_OUT,113798,Jeanne Garnier,823500,709702,Agence_mtn_Abomey,300000,186202,2022-06-02
CASH_OUT,462792,Jeanne Garnier,709702,246910,Agence_mtn_Ouidah,300000,-162792,2022-06-16
CASH_OUT,62770,Jeanne Garnier,246910,184140,Agence_mtn_Ouidah,300000,237230,2022-06-22
CASH_IN,248090,Agence_mtn_Cotonou,300000,51910,Jeanne Garnier,184140,432230,2022-06-22
CASH_IN,63040,Agence_mtn_Abomey,300000,236960,Jeanne Garnier,432230,495270,2022-06-24
TRANSFER,1010316,Pénélope Dupuis,1657500,647184,Marine Chauvet-Potier,387000,1397316,2022-06-17
CASH_OUT,531419,Alphonse Le Olivier,1775800,1244381,Agence_mtn_Abomey,300000,-231419,2022-06-08
CASH_OUT,650905,Alphonse Le Olivier,1244381,593476,Agence_mtn_Ouidah,300000,-350905,2022-06-14
CASH_OUT,358896,David Guérin,1537200,1178304,Agence_mtn_Cotonou,300000,-58896,2022-06-20
TRANSFER,1157125,Alix Maillet,1529200,372075,Xavier de Lebreton,1959100,3116225,2022-06-25
CASH_OUT,302705,Honoré du Laurent,1149600,846895,Agence_mtn_Abomey,300000,-2705,2022-06-02
TRANSFER,606566,Honoré du Laurent,846895,240329,Rémy Le Michaud,138600,-467966,2022-06-08
CASH_OUT,111583,Honoré du Laurent,240329,128746,Agence_mtn_Cotonou,300000,188417,2022-06-08
CASH_OUT,107338,Honoré du Laurent,128746,21408,Agence_mtn_Abomey,300000,192662,2022-06-20
CASH_IN,197634,Agence_mtn_Abomey,300000,102366,Honoré du Laurent,21408,219042,2022-06-23
CASH_OUT,496802,Aurore Guyon,1106400,609598,Agence_mtn_Cotonou,300000,-196802,2022-06-18
CASH_OUT,1427148,Emmanuelle Georges,1802900,375752,Agence_mtn_Ouidah,300000,-1127148,2022-06-11
TRANSFER,76256,Gilbert-Charles Thibault,1268000,1191744,Emmanuelle Georges,375752,452008,2022-06-14
CASH_OUT,197958,Emmanuelle Georges,452008,254050,Agence_mtn_Abomey,300000,102042,2022-06-21
TRANSFER,178136,Emmanuelle Georges,254050,75914,Antoine Leleu,1008900,830764,2022-06-22
CASH_OUT,1079358,Gilbert-Charles Thibault,1191744,112386,Agence_mtn_Cotonou,300000,-779358,2022-06-03
TRANSFER,38424,Gilbert-Charles Thibault,112386,73962,Louise Girard,188700,150276,2022-06-04
CASH_OUT,52825,Gilbert-Charles Thibault,73962,21137,Agence_mtn_Cotonou,300000,247175,2022-06-09
CASH_OUT,288183,Sophie Gonzalez,1321000,1032817,Agence_mtn_Cotonou,300000,11817,2022-06-02
CASH_IN,213391,Agence_mtn_Cotonou,300000,86609,Sophie Gonzalez,1032817,1246208,2022-06-11
TRANSFER,1153644,Sophie Gonzalez,1246208,92564,Sophie Gonzalez,1246208,92564,2022-06-14
CASH_IN,151676,Agence_mtn_Ouidah,300000,148324,Sophie Gonzalez,92564,244240,2022-06-15
TRANSFER,158819,Alexandre Rémy,170200,11381,Sophie Gonzalez,244240,403059,2022-06-22
CASH_OUT,48783,Rémy de la Roux,706100,657317,Agence_mtn_Cotonou,300000,251217,2022-06-11
CASH_IN,9286,Agence_mtn_Cotonou,300000,290714,Rémy de la Roux,657317,666603,2022-06-20
CASH_IN,249751,Agence_mtn_Cotonou,300000,50249,Cécile Clerc,1789000,2038751,2022-06-14
CASH_OUT,1662073,Cécile Clerc,2038751,376678,Agence_mtn_Abomey,300000,-1362073,2022-06-26
CASH_OUT,403457,Marcelle Charrier,1270200,866743,Agence_mtn_Cotonou,300000,-103457,2022-06-18
CASH_OUT,99047,Raymond Marchal de Nguyen,546800,447753,Agence_mtn_Abomey,300000,200953,2022-06-20
CASH_IN,43318,Agence_mtn_Abomey,300000,256682,Raymond Marchal de Nguyen,447753,491071,2022-06-24
CASH_IN,157028,Agence_mtn_Ouidah,300000,142972,Raymond Marchal de Nguyen,491071,648099,2022-06-25
CASH_OUT,498112,Raymond Marchal de Nguyen,648099,149987,Agence_mtn_Cotonou,300000,-198112,2022-06-26
CASH_OUT,61639,Adrien Chartier,415600,353961,Agence_mtn_Abomey,300000,238361,2022-06-06
CASH_IN,62814,Agence_mtn_Abomey,300000,237186,Adrien Chartier,353961,416775,2022-06-18
CASH_IN,187459,Agence_mtn_Ouidah,300000,112541,David du Blondel,453200,640659,2022-06-16
CASH_IN,135835,Agence_mtn_Ouidah,300000,164165,Michelle Lebon,199700,335535,2022-06-01
TRANSFER,226591,Michelle Lebon,335535,108944,Richard Le Descamps,319300,92709,2022-06-20
CASH_OUT,8996,Michelle Lebon,108944,99948,Agence_mtn_Cotonou,300000,291004,2022-06-20
CASH_OUT,95696,Michelle Lebon,99948,4252,Agence_mtn_Abomey,300000,204304,2022-06-26
CASH_OUT,697659,Caroline-Lorraine Humbert,964400,266741,Agence_mtn_Abomey,300000,-397659,2022-06-01
TRANSFER,222639,Caroline-Lorraine Humbert,266741,44102,Vincent Fournier,1641500,1418861,2022-06-06
CASH_IN,220703,Agence_mtn_Ouidah,300000,79297,Caroline-Lorraine Humbert,44102,264805,2022-06-14
CASH_OUT,139852,Caroline-Lorraine Humbert,264805,124953,Agence_mtn_Cotonou,300000,160148,2022-06-18
TRANSFER,1107773,Frédéric Couturier,1859200,751427,Caroline-Lorraine Humbert,124953,1232726,2022-06-20
CASH_OUT,192804,Zoé Renaud de Boutin,319600,126796,Agence_mtn_Cotonou,300000,107196,2022-06-02
TRANSFER,109515,Zoé Renaud de Boutin,126796,17281,Gabriel-Tristan Marty,1132000,1022485,2022-06-13
CASH_OUT,13044,Zoé Renaud de Boutin,17281,4237,Agence_mtn_Ouidah,300000,286956,2022-06-15
TRANSFER,1932448,Benjamin Evrard-Marty,1965300,32852,Zoé Renaud de Boutin,4237,1936685,2022-06-19
CASH_IN,75508,Agence_mtn_Ouidah,300000,224492,Zoé Renaud de Boutin,1936685,2012193,2022-06-20
TRANSFER,306860,Théodore De Oliveira-Nicolas,689400,382540,William Lebrun,1295700,1602560,2022-06-03
CASH_IN,203884,Agence_mtn_Ouidah,300000,96116,William Lebrun,1602560,1806444,2022-06-04
CASH_OUT,176996,William Lebrun,1806444,1629448,Agence_mtn_Abomey,300000,123004,2022-06-06
CASH_IN,188006,Agence_mtn_Abomey,300000,111994,William Lebrun,1629448,1817454,2022-06-14
CASH_OUT,1672437,William Lebrun,1817454,145017,Agence_mtn_Cotonou,300000,-1372437,2022-06-23
TRANSFER,53396,Renée David,1491400,1438004,Martine Wagner de la Bègue,1623700,1677096,2022-06-10
CASH_OUT,154971,Martine Wagner de la Bègue,1677096,1522125,Agence_mtn_Abomey,300000,145029,2022-06-14
TRANSFER,195372,Pénélope Dupuis,647184,451812,Louise Girard,150276,345648,2022-06-03
TRANSFER,195843,Bertrand Charles,535700,339857,Louise Girard,345648,541491,2022-06-03
CASH_IN,67890,Agence_mtn_Cotonou,300000,232110,Louise Girard,541491,609381,2022-06-03
CASH_OUT,244941,Louise Girard,609381,364440,Agence_mtn_Cotonou,300000,55059,2022-06-03
CASH_IN,295439,Agence_mtn_Ouidah,300000,4561,Louise Girard,364440,659879,2022-06-05
TRANSFER,484080,Louise Girard,659879,175799,Margot Riou du Fernandes,932100,448020,2022-06-06
TRANSFER,22720,Richard Le Descamps,92709,69989,Louise Girard,175799,198519,2022-06-08
CASH_IN,117450,Agence_mtn_Cotonou,300000,182550,Louise Girard,198519,315969,2022-06-08
CASH_OUT,58959,Louise Girard,315969,257010,Agence_mtn_Cotonou,300000,241041,2022-06-08
CASH_OUT,104182,Louise Girard,257010,152828,Agence_mtn_Cotonou,300000,195818,2022-06-09
CASH_OUT,40606,Louise Girard,152828,112222,Agence_mtn_Cotonou,300000,259394,2022-06-10
TRANSFER,186656,Raymond Rossi,501200,314544,Louise Girard,112222,298878,2022-06-11
TRANSFER,341272,Joséphine Gros,512500,171228,Louise Girard,298878,640150,2022-06-12
TRANSFER,502031,Louise Girard,640150,138119,Astrid Gay de la Brunet,1263100,761069,2022-06-12
CASH_IN,138126,Agence_mtn_Cotonou,300000,161874,Louise Girard,138119,276245,2022-06-15
TRANSFER,445346,Gabriel-Tristan Marty,1022485,577139,Louise Girard,276245,721591,2022-06-16
TRANSFER,529093,Louise Girard,721591,192498,Thibault Moreno,1228600,699507,2022-06-17
TRANSFER,206052,Nathalie Peron,1494900,1288848,Louise Girard,192498,398550,2022-06-17
TRANSFER,586172,William Le Lucas,1531200,945028,Louise Girard,398550,984722,2022-06-17
CASH_OUT,501212,Louise Girard,984722,483510,Agence_mtn_Ouidah,300000,-201212,2022-06-18
CASH_IN,47133,Agence_mtn_Abomey,300000,252867,Louise Girard,483510,530643,2022-06-20
CASH_OUT,273202,Louise Girard,530643,257441,Agence_mtn_Ouidah,300000,26798,2022-06-20
CASH_IN,270244,Agence_mtn_Ouidah,300000,29756,Louise Girard,257441,527685,2022-06-21
CASH_OUT,466783,Louise Girard,527685,60902,Agence_mtn_Abomey,300000,-166783,2022-06-21
CASH_IN,227499,Agence_mtn_Cotonou,300000,72501,Louise Girard,60902,288401,2022-06-21
CASH_IN,70196,Agence_mtn_Cotonou,300000,229804,Louise Girard,288401,358597,2022-06-24
CASH_IN,223774,Agence_mtn_Abomey,300000,76226,Louise Girard,358597,582371,2022-06-24
TRANSFER,499207,Astrid Gay de la Brunet,761069,261862,Louise Girard,582371,1081578,2022-06-25
CASH_OUT,958854,Louise Girard,1081578,122724,Agence_mtn_Abomey,300000,-658854,2022-06-27
CASH_IN,187570,Agence_mtn_Ouidah,300000,112430,Virginie Le Gall,38400,225970,2022-06-01
TRANSFER,397634,Margot Renaud,1699800,1302166,Virginie Le Gall,225970,623604,2022-06-02
CASH_IN,206198,Agence_mtn_Abomey,300000,93802,Virginie Le Gall,623604,829802,2022-06-03
TRANSFER,735355,Eugène Poulain,1932700,1197345,Virginie Le Gall,829802,1565157,2022-06-03
CASH_IN,150531,Agence_mtn_Abomey,300000,149469,Virginie Le Gall,1565157,1715688,2022-06-04
CASH_IN,199543,Agence_mtn_Abomey,300000,100457,Virginie Le Gall,1715688,1915231,2022-06-05
TRANSFER,117381,Virginie Le Gall,1915231,1797850,Alix Maillet,372075,254694,2022-06-07
TRANSFER,813383,Vincent Fournier,1418861,605478,Virginie Le Gall,1797850,2611233,2022-06-09
CASH_OUT,621256,Virginie Le Gall,2611233,1989977,Agence_mtn_Abomey,300000,-321256,2022-06-12
CASH_OUT,1013581,Virginie Le Gall,1989977,976396,Agence_mtn_Abomey,300000,-713581,2022-06-12
CASH_OUT,117597,Virginie Le Gall,976396,858799,Agence_mtn_Cotonou,300000,182403,2022-06-12
TRANSFER,89940,Virginie Le Gall,858799,768859,Valentine Martinez,1291800,1201860,2022-06-13
CASH_IN,212065,Agence_mtn_Ouidah,300000,87935,Virginie Le Gall,768859,980924,2022-06-15
CASH_OUT,936392,Virginie Le Gall,980924,44532,Agence_mtn_Abomey,300000,-636392,2022-06-17
CASH_IN,278519,Agence_mtn_Cotonou,300000,21481,Virginie Le Gall,44532,323051,2022-06-17
TRANSFER,1353549,Bertrand Le Roux,1814000,460451,Virginie Le Gall,323051,1676600,2022-06-18
TRANSFER,74389,Nath Bruneau,137900,63511,Virginie Le Gall,1676600,1750989,2022-06-18
CASH_IN,226802,Agence_mtn_Cotonou,300000,73198,Virginie Le Gall,1750989,1977791,2022-06-18
CASH_OUT,1130515,Virginie Le Gall,1977791,847276,Agence_mtn_Abomey,300000,-830515,2022-06-19
TRANSFER,6075,Inès Hamon,90100,84025,Virginie Le Gall,847276,853351,2022-06-19
CASH_IN,95158,Agence_mtn_Ouidah,300000,204842,Virginie Le Gall,853351,948509,2022-06-22
TRANSFER,125927,Virginie Le Gall,948509,822582,Joséphine Gros,171228,45301,2022-06-22
CASH_OUT,782034,Virginie Le Gall,822582,40548,Agence_mtn_Abomey,300000,-482034,2022-06-23
CASH_IN,39866,Agence_mtn_Abomey,300000,260134,Virginie Le Gall,40548,80414,2022-06-24
TRANSFER,48234,Virginie Le Gall,80414,32180,Jean Benard,350000,301766,2022-06-25
TRANSFER,1729341,Marie Picard,1974000,244659,Virginie Le Gall,32180,1761521,2022-06-25
CASH_OUT,403375,Virginie Le Gall,1761521,1358146,Agence_mtn_Ouidah,300000,-103375,2022-06-26
CASH_OUT,1134485,Virginie Le Gall,1358146,223661,Agence_mtn_Ouidah,300000,-834485,2022-06-26
CASH_IN,206343,Agence_mtn_Ouidah,300000,93657,Virginie Le Gall,223661,430004,2022-06-27
CASH_OUT,12738,Inès Hamon,84025,71287,Agence_mtn_Cotonou,300000,287262,2022-06-02
TRANSFER,1395881,Victoire-Nicole Lopez,1547300,151419,Inès Hamon,71287,1467168,2022-06-02
CASH_IN,240978,Agence_mtn_Abomey,300000,59022,Inès Hamon,1467168,1708146,2022-06-05
TRANSFER,876919,Inès Hamon,1708146,831227,Sophie Lévêque,404100,-472819,2022-06-06
CASH_IN,193311,Agence_mtn_Cotonou,300000,106689,Inès Hamon,831227,1024538,2022-06-07
CASH_OUT,1007435,Inès Hamon,1024538,17103,Agence_mtn_Abomey,300000,-707435,2022-06-10
CASH_IN,27720,Agence_mtn_Abomey,300000,272280,Inès Hamon,17103,44823,2022-06-11
CASH_OUT,16412,Inès Hamon,44823,28411,Agence_mtn_Abomey,300000,283588,2022-06-12
CASH_IN,145928,Agence_mtn_Cotonou,300000,154072,Inès Hamon,28411,174339,2022-06-14
CASH_OUT,37505,Inès Hamon,174339,136834,Agence_mtn_Abomey,300000,262495,2022-06-15
CASH_OUT,60212,Inès Hamon,136834,76622,Agence_mtn_Cotonou,300000,239788,2022-06-15
CASH_OUT,20725,Inès Hamon,76622,55897,Agence_mtn_Cotonou,300000,279275,2022-06-15
CASH_OUT,49705,Inès Hamon,55897,6192,Agence_mtn_Abomey,300000,250295,2022-06-16
CASH_IN,90074,Agence_mtn_Abomey,300000,209926,Inès Hamon,6192,96266,2022-06-17
TRANSFER,33777,Inès Hamon,96266,62489,Louis Pichon,390200,356423,2022-06-17
CASH_IN,291946,Agence_mtn_Cotonou,300000,8054,Inès Hamon,62489,354435,2022-06-17
CASH_OUT,28045,Inès Hamon,354435,326390,Agence_mtn_Ouidah,300000,271955,2022-06-18
CASH_OUT,230857,Inès Hamon,326390,95533,Agence_mtn_Cotonou,300000,69143,2022-06-18
CASH_OUT,54651,Inès Hamon,95533,40882,Agence_mtn_Abomey,300000,245349,2022-06-20
TRANSFER,725,Pénélope Ollivier,457600,456875,Inès Hamon,40882,41607,2022-06-20
TRANSFER,68225,Antoinette Bertrand,301200,232975,Inès Hamon,41607,109832,2022-06-22
TRANSFER,242686,Alix Maillet,254694,12008,Inès Hamon,109832,352518,2022-06-24
TRANSFER,10989,Joséphine Gros,45301,34312,Inès Hamon,352518,363507,2022-06-24
CASH_OUT,73801,Inès Hamon,363507,289706,Agence_mtn_Cotonou,300000,226199,2022-06-24
TRANSFER,125112,Inès Hamon,289706,164594,Margot Riou du Fernandes,448020,322908,2022-06-26
CASH_IN,174214,Agence_mtn_Ouidah,300000,125786,Inès Hamon,164594,338808,2022-06-26
TRANSFER,252615,Inès Hamon,338808,86193,Geneviève De Oliveira-Michel,1249900,997285,2022-06-27
TRANSFER,1214181,Émilie Moulin,1875300,661119,Inès Hamon,86193,1300374,2022-06-27
CASH_OUT,475044,Xavier Leblanc-Ferreira,996700,521656,Agence_mtn_Cotonou,300000,-175044,2022-06-02
TRANSFER,98586,Xavier Leblanc-Ferreira,521656,423070,Eugène Poulain,1197345,1098759,2022-06-02
CASH_IN,138502,Agence_mtn_Ouidah,300000,161498,Xavier Leblanc-Ferreira,423070,561572,2022-06-04
TRANSFER,262934,Xavier Leblanc-Ferreira,561572,298638,Antoinette Bertrand,232975,-29959,2022-06-05
CASH_OUT,245035,Xavier Leblanc-Ferreira,298638,53603,Agence_mtn_Abomey,300000,54965,2022-06-05
CASH_OUT,53331,Xavier Leblanc-Ferreira,53603,272,Agence_mtn_Abomey,300000,246669,2022-06-07
TRANSFER,9315,Victoire-Nicole Lopez,151419,142104,Xavier Leblanc-Ferreira,272,9587,2022-06-10
CASH_IN,88624,Agence_mtn_Ouidah,300000,211376,Xavier Leblanc-Ferreira,9587,98211,2022-06-11
TRANSFER,32739,Xavier Leblanc-Ferreira,98211,65472,Édouard Nguyen,694100,661361,2022-06-12
CASH_IN,242264,Agence_mtn_Abomey,300000,57736,Xavier Leblanc-Ferreira,65472,307736,2022-06-14
TRANSFER,941311,Sébastien Lemaître,1131300,189989,Xavier Leblanc-Ferreira,307736,1249047,2022-06-14
CASH_OUT,902116,Xavier Leblanc-Ferreira,1249047,346931,Agence_mtn_Cotonou,300000,-602116,2022-06-16
CASH_IN,187767,Agence_mtn_Cotonou,300000,112233,Xavier Leblanc-Ferreira,346931,534698,2022-06-18
CASH_IN,269140,Agence_mtn_Ouidah,300000,30860,Xavier Leblanc-Ferreira,534698,803838,2022-06-20
CASH_IN,204397,Agence_mtn_Ouidah,300000,95603,Xavier Leblanc-Ferreira,803838,1008235,2022-06-21
CASH_IN,114891,Agence_mtn_Ouidah,300000,185109,Xavier Leblanc-Ferreira,1008235,1123126,2022-06-22
CASH_IN,176009,Agence_mtn_Cotonou,300000,123991,Xavier Leblanc-Ferreira,1123126,1299135,2022-06-24
TRANSFER,267011,Xavier Leblanc-Ferreira,1299135,1032124,Benjamin Evrard-Marty,32852,-234159,2022-06-25
CASH_IN,136739,Agence_mtn_Cotonou,300000,163261,Xavier Leblanc-Ferreira,1032124,1168863,2022-06-26
CASH_IN,126534,Agence_mtn_Abomey,300000,173466,Xavier Leblanc-Ferreira,1168863,1295397,2022-06-27
CASH_OUT,214206,Xavier Leblanc-Ferreira,1295397,1081191,Agence_mtn_Cotonou,300000,85794,2022-06-27
TRANSFER,261466,Marcelle Paris,515400,253934,Inès de Letellier,194800,-66666,2022-06-01
TRANSFER,797520,François Michel-Legros,1513400,715880,Marcelle Paris,253934,1051454,2022-06-01
CASH_IN,136681,Agence_mtn_Abomey,300000,163319,Marcelle Paris,1051454,1188135,2022-06-02
CASH_OUT,640787,Marcelle Paris,1188135,547348,Agence_mtn_Cotonou,300000,-340787,2022-06-02
CASH_IN,97407,Agence_mtn_Abomey,300000,202593,Marcelle Paris,547348,644755,2022-06-02
CASH_OUT,121814,Marcelle Paris,644755,522941,Agence_mtn_Cotonou,300000,178186,2022-06-03
CASH_IN,223929,Agence_mtn_Cotonou,300000,76071,Marcelle Paris,522941,746870,2022-06-03
TRANSFER,221960,Marcelle Paris,746870,524910,Isabelle Rossi,1106500,884540,2022-06-06
TRANSFER,30854,Margot Renaud,1302166,1271312,Marcelle Paris,524910,555764,2022-06-09
CASH_OUT,242774,Marcelle Paris,555764,312990,Agence_mtn_Cotonou,300000,57226,2022-06-10
TRANSFER,273914,Marcelle Paris,312990,39076,Gilbert Foucher,1702900,1428986,2022-06-11
CASH_IN,115722,Agence_mtn_Abomey,300000,184278,Marcelle Paris,39076,154798,2022-06-11
TRANSFER,117450,Marcelle Paris,154798,37348,Bertrand Le Roux,460451,343001,2022-06-15
CASH_IN,35374,Agence_mtn_Abomey,300000,264626,Marcelle Paris,37348,72722,2022-06-15
CASH_IN,295840,Agence_mtn_Ouidah,300000,4160,Marcelle Paris,72722,368562,2022-06-15
CASH_IN,276489,Agence_mtn_Cotonou,300000,23511,Marcelle Paris,368562,645051,2022-06-15
TRANSFER,724538,Claude Foucher,1862400,1137862,Marcelle Paris,645051,1369589,2022-06-16
CASH_OUT,885465,Marcelle Paris,1369589,484124,Agence_mtn_Ouidah,300000,-585465,2022-06-17
CASH_IN,142665,Agence_mtn_Abomey,300000,157335,Marcelle Paris,484124,626789,2022-06-19
TRANSFER,593214,Marcelle Paris,626789,33575,Thierry Delattre-Simon,230600,-362614,2022-06-20
CASH_IN,42198,Agence_mtn_Cotonou,300000,257802,Marcelle Paris,33575,75773,2022-06-20
CASH_OUT,1969,Marcelle Paris,75773,73804,Agence_mtn_Cotonou,300000,298031,2022-06-21
TRANSFER,235927,Astrid Gay de la Brunet,261862,25935,Marcelle Paris,73804,309731,2022-06-21
CASH_IN,247535,Agence_mtn_Cotonou,300000,52465,Marcelle Paris,309731,557266,2022-06-21
CASH_IN,270948,Agence_mtn_Ouidah,300000,29052,Marcelle Paris,557266,828214,2022-06-23
CASH_IN,72551,Agence_mtn_Abomey,300000,227449,Marcelle Paris,828214,900765,2022-06-24
CASH_IN,170571,Agence_mtn_Abomey,300000,129429,Marcelle Paris,900765,1071336,2022-06-27
CASH_OUT,39782,Marie Picard,244659,204877,Agence_mtn_Ouidah,300000,260218,2022-06-01
CASH_OUT,114609,Marie Picard,204877,90268,Agence_mtn_Ouidah,300000,185391,2022-06-04
TRANSFER,20205,Marie Picard,90268,70063,Marie Picard,90268,110473,2022-06-04
TRANSFER,124667,Laure Philippe,154310,29643,Marie Picard,70063,194730,2022-06-04
CASH_IN,133035,Agence_mtn_Ouidah,300000,166965,Marie Picard,194730,327765,2022-06-04
CASH_OUT,282995,Marie Picard,327765,44770,Agence_mtn_Cotonou,300000,17005,2022-06-07
CASH_IN,13973,Agence_mtn_Abomey,300000,286027,Marie Picard,44770,58743,2022-06-10
TRANSFER,28702,Marie Picard,58743,30041,Gilbert Foucher,1428986,1400284,2022-06-10
TRANSFER,17494,Marie Picard,30041,12547,Étienne Roche,1398500,1381006,2022-06-10
CASH_IN,88940,Agence_mtn_Cotonou,300000,211060,Marie Picard,12547,101487,2022-06-11
CASH_OUT,1727,Marie Picard,101487,99760,Agence_mtn_Cotonou,300000,298273,2022-06-11
CASH_IN,230070,Agence_mtn_Cotonou,300000,69930,Marie Picard,99760,329830,2022-06-14
CASH_OUT,276211,Marie Picard,329830,53619,Agence_mtn_Ouidah,300000,23789,2022-06-15
CASH_OUT,35241,Marie Picard,53619,18378,Agence_mtn_Ouidah,300000,264759,2022-06-15
TRANSFER,12473,Marie Picard,18378,5905,Astrid Gay de la Brunet,25935,13462,2022-06-16
TRANSFER,129047,Catherine Faivre,1995500,1866453,Marie Picard,5905,134952,2022-06-17
TRANSFER,121528,Léon Lecoq,1300100,1178572,Marie Picard,134952,256480,2022-06-19
CASH_IN,80736,Agence_mtn_Abomey,300000,219264,Marie Picard,256480,337216,2022-06-20
CASH_IN,1511,Agence_mtn_Abomey,300000,298489,Marie Picard,337216,338727,2022-06-23
TRANSFER,329730,Laurent-Bertrand Lefort,550500,220770,Marie Picard,338727,668457,2022-06-24
TRANSFER,26470,Marie Picard,668457,641987,Étienne Roche,1381006,1354536,2022-06-25
CASH_IN,278436,Agence_mtn_Abomey,300000,21564,Marie Picard,641987,920423,2022-06-26
CASH_IN,19400,Agence_mtn_Ouidah,300000,280600,Benjamin Evrard-Marty,-234159,-214759,2022-06-03
CASH_IN,60133,Agence_mtn_Cotonou,300000,239867,Benjamin Evrard-Marty,-214759,-154626,2022-06-05
CASH_IN,13468,Agence_mtn_Ouidah,300000,286532,Benjamin Evrard-Marty,-154626,-141158,2022-06-05
CASH_IN,58951,Agence_mtn_Ouidah,300000,241049,Benjamin Evrard-Marty,-141158,-82207,2022-06-06
CASH_IN,158493,Agence_mtn_Cotonou,300000,141507,Benjamin Evrard-Marty,-82207,76286,2022-06-06
CASH_OUT,41969,Benjamin Evrard-Marty,76286,34317,Agence_mtn_Cotonou,300000,258031,2022-06-07
TRANSFER,27109,Benjamin Evrard-Marty,34317,7208,Nath Bruneau,63511,36402,2022-06-11
CASH_OUT,4987,Benjamin Evrard-Marty,7208,2221,Agence_mtn_Abomey,300000,295013,2022-06-12
CASH_IN,271937,Agence_mtn_Cotonou,300000,28063,Benjamin Evrard-Marty,2221,274158,2022-06-12
CASH_IN,3082,Agence_mtn_Abomey,300000,296918,Benjamin Evrard-Marty,274158,277240,2022-06-13
CASH_OUT,230524,Benjamin Evrard-Marty,277240,46716,Agence_mtn_Abomey,300000,69476,2022-06-13
CASH_OUT,39298,Benjamin Evrard-Marty,46716,7418,Agence_mtn_Abomey,300000,260702,2022-06-13
CASH_OUT,5307,Benjamin Evrard-Marty,7418,2111,Agence_mtn_Cotonou,300000,294693,2022-06-14
CASH_IN,91389,Agence_mtn_Cotonou,300000,208611,Benjamin Evrard-Marty,2111,93500,2022-06-15
TRANSFER,70368,Benjamin Evrard-Marty,93500,23132,Claude Foucher,1137862,1067494,2022-06-17
CASH_OUT,3495,Benjamin Evrard-Marty,23132,19637,Agence_mtn_Ouidah,300000,296505,2022-06-20
CASH_IN,14814,Agence_mtn_Ouidah,300000,285186,Benjamin Evrard-Marty,19637,34451,2022-06-20
TRANSFER,358747,Frédéric Couturier,751427,392680,Benjamin Evrard-Marty,34451,393198,2022-06-21
CASH_IN,51203,Agence_mtn_Cotonou,300000,248797,Benjamin Evrard-Marty,393198,444401,2022-06-21
TRANSFER,370528,Benjamin Evrard-Marty,444401,73873,Léon Lecoq,1178572,808044,2022-06-22
CASH_IN,92715,Agence_mtn_Cotonou,300000,207285,Benjamin Evrard-Marty,73873,166588,2022-06-23
CASH_IN,1180,Agence_mtn_Ouidah,300000,298820,Benjamin Evrard-Marty,166588,167768,2022-06-24
CASH_OUT,68276,Benjamin Evrard-Marty,167768,99492,Agence_mtn_Abomey,300000,231724,2022-06-24
TRANSFER,19102,Benjamin Evrard-Marty,99492,80390,Bertrand Le Roux,343001,323899,2022-06-24
TRANSFER,1019260,Alphonse Leclercq-Rousseau,1693300,674040,Benjamin Evrard-Marty,80390,1099650,2022-06-27
CASH_OUT,20792,Joséphine Gros,34312,13520,Agence_mtn_Cotonou,300000,279208,2022-06-01
CASH_IN,122021,Agence_mtn_Abomey,300000,177979,Joséphine Gros,13520,135541,2022-06-01
CASH_IN,153375,Agence_mtn_Ouidah,300000,146625,Joséphine Gros,135541,288916,2022-06-03
CASH_IN,247622,Agence_mtn_Ouidah,300000,52378,Joséphine Gros,288916,536538,2022-06-03
CASH_OUT,430109,Joséphine Gros,536538,106429,Agence_mtn_Ouidah,300000,-130109,2022-06-04
TRANSFER,57469,Joséphine Gros,106429,48960,Nathalie Pages,341200,283731,2022-06-04
CASH_OUT,47707,Joséphine Gros,48960,1253,Agence_mtn_Ouidah,300000,252293,2022-06-04
CASH_OUT,503,Joséphine Gros,1253,750,Agence_mtn_Cotonou,300000,299497,2022-06-06
CASH_OUT,153,Joséphine Gros,750,597,Agence_mtn_Cotonou,300000,299847,2022-06-08
CASH_IN,164970,Agence_mtn_Ouidah,300000,135030,Joséphine Gros,597,165567,2022-06-09
CASH_OUT,153921,Joséphine Gros,165567,11646,Agence_mtn_Abomey,300000,146079,2022-06-09
CASH_IN,229945,Agence_mtn_Abomey,300000,70055,Joséphine Gros,11646,241591,2022-06-10
CASH_OUT,150021,Joséphine Gros,241591,91570,Agence_mtn_Cotonou,300000,149979,2022-06-10
TRANSFER,1656972,Thérèse-Margaux Bruneau,1736800,79828,Joséphine Gros,91570,1748542,2022-06-10
CASH_OUT,753414,Joséphine Gros,1748542,995128,Agence_mtn_Abomey,300000,-453414,2022-06-10
TRANSFER,941027,Joséphine Gros,995128,54101,Corinne-Louise Valentin,1275100,334073,2022-06-11
CASH_OUT,48700,Joséphine Gros,54101,5401,Agence_mtn_Ouidah,300000,251300,2022-06-12
CASH_OUT,2818,Joséphine Gros,5401,2583,Agence_mtn_Ouidah,300000,297182,2022-06-12
TRANSFER,1291,Joséphine Gros,2583,1292,Laure Philippe,29643,28352,2022-06-12
TRANSFER,489220,Margot Renaud,1271312,782092,Joséphine Gros,1292,490512,2022-06-15
TRANSFER,107842,Geneviève Grondin,119500,11658,Joséphine Gros,490512,598354,2022-06-16
CASH_OUT,296513,Joséphine Gros,598354,301841,Agence_mtn_Abomey,300000,3487,2022-06-17
TRANSFER,53856,Joséphine Gros,301841,247985,Nath Bruneau,36402,-17454,2022-06-17
CASH_IN,3228,Agence_mtn_Cotonou,300000,296772,Joséphine Gros,247985,251213,2022-06-19
TRANSFER,28953,Joséphine Gros,251213,222260,Adèle Labbé,606300,577347,2022-06-20
CASH_OUT,3487,Joséphine Gros,222260,218773,Agence_mtn_Cotonou,300000,296513,2022-06-21
CASH_IN,152498,Agence_mtn_Abomey,300000,147502,Joséphine Gros,218773,371271,2022-06-23
TRANSFER,303371,Margot Riou du Fernandes,322908,19537,Joséphine Gros,371271,674642,2022-06-24
TRANSFER,120511,Laurent-Bertrand Lefort,220770,100259,Joséphine Gros,674642,795153,2022-06-25
CASH_IN,159673,Agence_mtn_Ouidah,300000,140327,Joséphine Gros,795153,954826,2022-06-27
CASH_IN,45730,Agence_mtn_Cotonou,300000,254270,Gabriel Humbert,1548400,1594130,2022-06-01
CASH_OUT,585183,Gabriel Humbert,1594130,1008947,Agence_mtn_Cotonou,300000,-285183,2022-06-02
CASH_IN,276990,Agence_mtn_Cotonou,300000,23010,Gabriel Humbert,1008947,1285937,2022-06-02
CASH_OUT,156448,Gabriel Humbert,1285937,1129489,Agence_mtn_Ouidah,300000,143552,2022-06-03
CASH_OUT,627538,Gabriel Humbert,1129489,501951,Agence_mtn_Abomey,300000,-327538,2022-06-10
CASH_IN,241783,Agence_mtn_Cotonou,300000,58217,Gabriel Humbert,501951,743734,2022-06-10
TRANSFER,559230,Gabriel Humbert,743734,184504,Vincent Fournier,605478,46248,2022-06-10
CASH_OUT,103331,Gabriel Humbert,184504,81173,Agence_mtn_Cotonou,300000,196669,2022-06-10
TRANSFER,53289,Gabriel Humbert,81173,27884,Simone Pineau,1014400,961111,2022-06-12
TRANSFER,23305,Gabriel Humbert,27884,4579,Thérèse-Margaux Bruneau,79828,56523,2022-06-12
CASH_IN,297674,Agence_mtn_Abomey,300000,2326,Gabriel Humbert,4579,302253,2022-06-13
CASH_IN,220228,Agence_mtn_Cotonou,300000,79772,Gabriel Humbert,302253,522481,2022-06-14
TRANSFER,12768,Laure Philippe,28352,15584,Gabriel Humbert,522481,535249,2022-06-16
CASH_IN,226503,Agence_mtn_Ouidah,300000,73497,Gabriel Humbert,535249,761752,2022-06-17
CASH_OUT,419982,Gabriel Humbert,761752,341770,Agence_mtn_Abomey,300000,-119982,2022-06-17
CASH_IN,131651,Agence_mtn_Abomey,300000,168349,Gabriel Humbert,341770,473421,2022-06-18
CASH_OUT,435797,Gabriel Humbert,473421,37624,Agence_mtn_Abomey,300000,-135797,2022-06-18
TRANSFER,18649,Gabriel Humbert,37624,18975,Éléonore-Hélène Dubois,987500,968851,2022-06-20
CASH_IN,242903,Agence_mtn_Abomey,300000,57097,Gabriel Humbert,18975,261878,2022-06-20
CASH_OUT,90673,Gabriel Humbert,261878,171205,Agence_mtn_Cotonou,300000,209327,2022-06-21
TRANSFER,113920,Gabriel Humbert,171205,57285,Eugène Poulain,1098759,984839,2022-06-22
CASH_IN,59246,Agence_mtn_Cotonou,300000,240754,Gabriel Humbert,57285,116531,2022-06-22
CASH_OUT,72420,Gabriel Humbert,116531,44111,Agence_mtn_Ouidah,300000,227580,2022-06-23
CASH_IN,116994,Agence_mtn_Abomey,300000,183006,Gabriel Humbert,44111,161105,2022-06-24
CASH_IN,65727,Agence_mtn_Ouidah,300000,234273,Gabriel Humbert,161105,226832,2022-06-26
CASH_OUT,10212,Gabriel Humbert,226832,216620,Agence_mtn_Abomey,300000,289788,2022-06-27
CASH_OUT,105225,Gabriel Humbert,216620,111395,Agence_mtn_Cotonou,300000,194775,2022-06-27
CASH_OUT,1227202,Thibaut Coulon,1460800,233598,Agence_mtn_Abomey,300000,-927202,2022-06-01
CASH_OUT,68861,Thibaut Coulon,233598,164737,Agence_mtn_Ouidah,300000,231139,2022-06-02
TRANSFER,315853,Léon Lecoq,808044,492191,Thibaut Coulon,164737,480590,2022-06-02
CASH_IN,247698,Agence_mtn_Cotonou,300000,52302,Thibaut Coulon,480590,728288,2022-06-03
CASH_IN,275798,Agence_mtn_Ouidah,300000,24202,Thibaut Coulon,728288,1004086,2022-06-04
CASH_OUT,201354,Thibaut Coulon,1004086,802732,Agence_mtn_Abomey,300000,98646,2022-06-05
CASH_OUT,772622,Thibaut Coulon,802732,30110,Agence_mtn_Ouidah,300000,-472622,2022-06-06
CASH_OUT,7710,Thibaut Coulon,30110,22400,Agence_mtn_Abomey,300000,292290,2022-06-07
CASH_IN,62312,Agence_mtn_Ouidah,300000,237688,Thibaut Coulon,22400,84712,2022-06-07
TRANSFER,116382,Sébastien Lemaître,189989,73607,Thibaut Coulon,84712,201094,2022-06-07
CASH_OUT,56427,Thibaut Coulon,201094,144667,Agence_mtn_Ouidah,300000,243573,2022-06-09
TRANSFER,874218,Étienne Roche,1354536,480318,Thibaut Coulon,144667,1018885,2022-06-09
TRANSFER,11725,Raymond Rossi,314544,302819,Thibaut Coulon,1018885,1030610,2022-06-10
TRANSFER,254105,Théodore De Oliveira-Nicolas,382540,128435,Thibaut Coulon,1030610,1284715,2022-06-11
TRANSFER,932052,Eugène Poulain,984839,52787,Thibaut Coulon,1284715,2216767,2022-06-11
CASH_OUT,1958859,Thibaut Coulon,2216767,257908,Agence_mtn_Cotonou,300000,-1658859,2022-06-12
CASH_OUT,201969,Thibaut Coulon,257908,55939,Agence_mtn_Ouidah,300000,98031,2022-06-15
TRANSFER,6392,William Le Lucas,945028,938636,Thibaut Coulon,55939,62331,2022-06-16
CASH_IN,247248,Agence_mtn_Ouidah,300000,52752,Thibaut Coulon,62331,309579,2022-06-16
TRANSFER,42122,Thibaut Coulon,309579,267457,Valentine Martinez,1201860,1159738,2022-06-17
CASH_OUT,171354,Thibaut Coulon,267457,96103,Agence_mtn_Cotonou,300000,128646,2022-06-19
CASH_IN,140303,Agence_mtn_Ouidah,300000,159697,Thibaut Coulon,96103,236406,2022-06-20
CASH_OUT,188502,Thibaut Coulon,236406,47904,Agence_mtn_Cotonou,300000,111498,2022-06-21
CASH_IN,42728,Agence_mtn_Abomey,300000,257272,Thibaut Coulon,47904,90632,2022-06-21
TRANSFER,39818,Thibaut Coulon,90632,50814,Bertrand Le Roux,323899,284081,2022-06-22
CASH_IN,91797,Agence_mtn_Cotonou,300000,208203,Thibaut Coulon,50814,142611,2022-06-24
CASH_OUT,98891,Thibaut Coulon,142611,43720,Agence_mtn_Cotonou,300000,201109,2022-06-24
TRANSFER,49049,Thibault Moreno,699507,650458,Thibaut Coulon,43720,92769,2022-06-25
CASH_IN,224557,Agence_mtn_Cotonou,300000,75443,Thibaut Coulon,92769,317326,2022-06-26
TRANSFER,47871,Frédéric Couturier,392680,344809,Thibaut Coulon,317326,365197,2022-06-26
CASH_OUT,107353,Nathalie Pages,283731,176378,Agence_mtn_Abomey,300000,192647,2022-06-05
TRANSFER,40573,Richard Le Descamps,69989,29416,Nathalie Pages,176378,216951,2022-06-05
CASH_IN,113132,Agence_mtn_Cotonou,300000,186868,Nathalie Pages,216951,330083,2022-06-07
CASH_IN,233986,Agence_mtn_Cotonou,300000,66014,Nathalie Pages,330083,564069,2022-06-07
CASH_OUT,456135,Nathalie Pages,564069,107934,Agence_mtn_Abomey,300000,-156135,2022-06-08
CASH_IN,70954,Agence_mtn_Ouidah,300000,229046,Nathalie Pages,107934,178888,2022-06-09
CASH_IN,23300,Agence_mtn_Cotonou,300000,276700,Nathalie Pages,178888,202188,2022-06-09
CASH_OUT,21633,Nathalie Pages,202188,180555,Agence_mtn_Ouidah,300000,278367,2022-06-12
TRANSFER,151588,Nathalie Pages,180555,28967,Laurent-Bertrand Lefort,100259,-51329,2022-06-13
TRANSFER,22384,Nathalie Pages,28967,6583,Philippine Courtois,1182600,1160216,2022-06-14
TRANSFER,368080,Isabelle Rossi,884540,516460,Nathalie Pages,6583,374663,2022-06-14
CASH_OUT,97851,Nathalie Pages,374663,276812,Agence_mtn_Ouidah,300000,202149,2022-06-17
CASH_IN,108580,Agence_mtn_Ouidah,300000,191420,Nathalie Pages,276812,385392,2022-06-17
TRANSFER,245739,Nathalie Pages,385392,139653,Valérie Dijoux,1048900,803161,2022-06-19
CASH_OUT,50126,Nathalie Pages,139653,89527,Agence_mtn_Ouidah,300000,249874,2022-06-20
CASH_OUT,75122,Nathalie Pages,89527,14405,Agence_mtn_Cotonou,300000,224878,2022-06-20
CASH_OUT,6062,Nathalie Pages,14405,8343,Agence_mtn_Abomey,300000,293938,2022-06-22
CASH_OUT,4082,Nathalie Pages,8343,4261,Agence_mtn_Cotonou,300000,295918,2022-06-26
TRANSFER,199810,Louis Pichon,356423,156613,Nathalie Pages,4261,204071,2022-06-26
TRANSFER,53470,Thérèse-Margaux Bruneau,56523,3053,Nathalie Pages,204071,257541,2022-06-27
TRANSFER,104718,Nathalie Pages,257541,152823,Raymond Rossi,302819,198101,2022-06-27
TRANSFER,6074,Alexandre Rémy,11381,5307,François Michel-Legros,715880,721954,2022-06-03
TRANSFER,502252,Franck-Charles Texier,1377800,875548,François Michel-Legros,721954,1224206,2022-06-03
CASH_OUT,90893,François Michel-Legros,1224206,1133313,Agence_mtn_Abomey,300000,209107,2022-06-03
TRANSFER,62101,Étienne Roche,480318,418217,François Michel-Legros,1133313,1195414,2022-06-04
CASH_IN,178838,Agence_mtn_Ouidah,300000,121162,François Michel-Legros,1195414,1374252,2022-06-07
CASH_OUT,81284,François Michel-Legros,1374252,1292968,Agence_mtn_Abomey,300000,218716,2022-06-08
CASH_IN,215674,Agence_mtn_Ouidah,300000,84326,François Michel-Legros,1292968,1508642,2022-06-08
CASH_OUT,253396,François Michel-Legros,1508642,1255246,Agence_mtn_Cotonou,300000,46604,2022-06-09
CASH_OUT,320558,François Michel-Legros,1255246,934688,Agence_mtn_Ouidah,300000,-20558,2022-06-10
TRANSFER,271811,François Michel-Legros,934688,662877,Nathalie Peron,1288848,1017037,2022-06-11
CASH_IN,76349,Agence_mtn_Cotonou,300000,223651,François Michel-Legros,662877,739226,2022-06-12
CASH_OUT,627704,François Michel-Legros,739226,111522,Agence_mtn_Abomey,300000,-327704,2022-06-12
TRANSFER,64768,Sébastien Lemaître,73607,8839,François Michel-Legros,111522,176290,2022-06-15
CASH_OUT,155852,François Michel-Legros,176290,20438,Agence_mtn_Abomey,300000,144148,2022-06-18
CASH_OUT,13294,François Michel-Legros,20438,7144,Agence_mtn_Abomey,300000,286706,2022-06-18
TRANSFER,2807,François Michel-Legros,7144,4337,Laure Philippe,15584,12777,2022-06-18
TRANSFER,4293,François Michel-Legros,4337,44,Philippine Courtois,1160216,1155923,2022-06-19
CASH_IN,197807,Agence_mtn_Abomey,300000,102193,François Michel-Legros,44,197851,2022-06-20
CASH_IN,49732,Agence_mtn_Cotonou,300000,250268,François Michel-Legros,197851,247583,2022-06-20
CASH_OUT,160516,François Michel-Legros,247583,87067,Agence_mtn_Abomey,300000,139484,2022-06-21
CASH_IN,224199,Agence_mtn_Ouidah,300000,75801,François Michel-Legros,87067,311266,2022-06-24
TRANSFER,147831,François Michel-Legros,311266,163435,Laure Philippe,12777,-135054,2022-06-24
TRANSFER,822629,Claude Foucher,1067494,244865,François Michel-Legros,163435,986064,2022-06-24
TRANSFER,268240,Étienne Roche,418217,149977,François Michel-Legros,986064,1254304,2022-06-26
CASH_IN,148466,Agence_mtn_Ouidah,300000,151534,François Michel-Legros,1254304,1402770,2022-06-26
TRANSFER,451186,Gabriel-Tristan Marty,577139,125953,François Michel-Legros,1402770,1853956,2022-06-27
TRANSFER,1848294,François Michel-Legros,1853956,5662,Alfred du Lesage,1294600,-553694,2022-06-27
CASH_OUT,3277,François Michel-Legros,5662,2385,Agence_mtn_Ouidah,300000,296723,2022-06-27
CASH_OUT,542844,Valentine Martinez,1159738,616894,Agence_mtn_Cotonou,300000,-242844,2022-06-01
CASH_IN,274012,Agence_mtn_Ouidah,300000,25988,Valentine Martinez,616894,890906,2022-06-02
CASH_OUT,884351,Valentine Martinez,890906,6555,Agence_mtn_Cotonou,300000,-584351,2022-06-02
CASH_IN,14499,Agence_mtn_Abomey,300000,285501,Valentine Martinez,6555,21054,2022-06-02
CASH_IN,106713,Agence_mtn_Ouidah,300000,193287,Valentine Martinez,21054,127767,2022-06-04
CASH_IN,34265,Agence_mtn_Abomey,300000,265735,Valentine Martinez,127767,162032,2022-06-04
CASH_IN,195190,Agence_mtn_Cotonou,300000,104810,Valentine Martinez,162032,357222,2022-06-05
CASH_OUT,81485,Valentine Martinez,357222,275737,Agence_mtn_Ouidah,300000,218515,2022-06-06
TRANSFER,226956,Édouard Nguyen,661361,434405,Valentine Martinez,275737,502693,2022-06-07
TRANSFER,48954,Eugène Poulain,52787,3833,Valentine Martinez,502693,551647,2022-06-09
CASH_OUT,415157,Valentine Martinez,551647,136490,Agence_mtn_Cotonou,300000,-115157,2022-06-09
CASH_OUT,31655,Valentine Martinez,136490,104835,Agence_mtn_Abomey,300000,268345,2022-06-10
CASH_OUT,2043,Valentine Martinez,104835,102792,Agence_mtn_Abomey,300000,297957,2022-06-11
CASH_OUT,16490,Valentine Martinez,102792,86302,Agence_mtn_Cotonou,300000,283510,2022-06-12
CASH_IN,240756,Agence_mtn_Cotonou,300000,59244,Valentine Martinez,86302,327058,2022-06-13
CASH_IN,246538,Agence_mtn_Cotonou,300000,53462,Valentine Martinez,327058,573596,2022-06-14
CASH_OUT,469038,Valentine Martinez,573596,104558,Agence_mtn_Abomey,300000,-169038,2022-06-14
TRANSFER,902422,Éléonore-Hélène Dubois,968851,66429,Valentine Martinez,104558,1006980,2022-06-14
CASH_IN,10335,Agence_mtn_Ouidah,300000,289665,Valentine Martinez,1006980,1017315,2022-06-15
CASH_IN,180336,Agence_mtn_Abomey,300000,119664,Valentine Martinez,1017315,1197651,2022-06-16
TRANSFER,705430,Valentine Martinez,1197651,492221,Gilbert Foucher,1400284,694854,2022-06-18
CASH_IN,3172,Agence_mtn_Abomey,300000,296828,Valentine Martinez,492221,495393,2022-06-19
CASH_OUT,36016,Valentine Martinez,495393,459377,Agence_mtn_Abomey,300000,263984,2022-06-20
CASH_IN,42438,Agence_mtn_Ouidah,300000,257562,Valentine Martinez,459377,501815,2022-06-22
TRANSFER,2534,Eugène Poulain,3833,1299,Valentine Martinez,501815,504349,2022-06-26
TRANSFER,153184,Valentine Martinez,504349,351165,Eugène Poulain,1299,-151885,2022-06-26
CASH_IN,236338,Agence_mtn_Cotonou,300000,63662,Inès de Letellier,-66666,169672,2022-06-02
CASH_OUT,82335,Inès de Letellier,169672,87337,Agence_mtn_Ouidah,300000,217665,2022-06-02
CASH_IN,120018,Agence_mtn_Abomey,300000,179982,Inès de Letellier,87337,207355,2022-06-05
CASH_IN,74106,Agence_mtn_Ouidah,300000,225894,Inès de Letellier,207355,281461,2022-06-06
CASH_OUT,105836,Inès de Letellier,281461,175625,Agence_mtn_Cotonou,300000,194164,2022-06-08
CASH_IN,110154,Agence_mtn_Abomey,300000,189846,Inès de Letellier,175625,285779,2022-06-08
TRANSFER,168103,Inès de Letellier,285779,117676,Hortense Lemaire,810000,641897,2022-06-09
TRANSFER,6504,Inès de Letellier,117676,111172,Étienne Roche,149977,143473,2022-06-10
TRANSFER,59514,Inès de Letellier,111172,51658,Claude Foucher,244865,185351,2022-06-10
TRANSFER,14703,Richard Le Descamps,29416,14713,Inès de Letellier,51658,66361,2022-06-11
TRANSFER,20103,Inès de Letellier,66361,46258,Émilie Moulin,661119,641016,2022-06-13
CASH_OUT,33727,Inès de Letellier,46258,12531,Agence_mtn_Cotonou,300000,266273,2022-06-14
CASH_IN,90039,Agence_mtn_Cotonou,300000,209961,Inès de Letellier,12531,102570,2022-06-16
CASH_OUT,61897,Inès de Letellier,102570,40673,Agence_mtn_Abomey,300000,238103,2022-06-17
CASH_IN,61095,Agence_mtn_Cotonou,300000,238905,Inès de Letellier,40673,101768,2022-06-17
CASH_IN,162270,Agence_mtn_Abomey,300000,137730,Inès de Letellier,101768,264038,2022-06-17
CASH_OUT,28950,Inès de Letellier,264038,235088,Agence_mtn_Ouidah,300000,271050,2022-06-18
CASH_IN,231897,Agence_mtn_Cotonou,300000,68103,Inès de Letellier,235088,466985,2022-06-19
CASH_OUT,114018,Inès de Letellier,466985,352967,Agence_mtn_Ouidah,300000,185982,2022-06-20
CASH_IN,265686,Agence_mtn_Cotonou,300000,34314,Inès de Letellier,352967,618653,2022-06-20
TRANSFER,263424,Inès de Letellier,618653,355229,Léon Lecoq,492191,228767,2022-06-20
CASH_IN,107669,Agence_mtn_Ouidah,300000,192331,Inès de Letellier,355229,462898,2022-06-21
CASH_IN,215852,Agence_mtn_Ouidah,300000,84148,Inès de Letellier,462898,678750,2022-06-21
TRANSFER,336537,Frédéric Couturier,344809,8272,Inès de Letellier,678750,1015287,2022-06-21
CASH_IN,297003,Agence_mtn_Ouidah,300000,2997,Inès de Letellier,1015287,1312290,2022-06-22
TRANSFER,220290,Inès de Letellier,1312290,1092000,Bertrand Charles,339857,119567,2022-06-22
CASH_IN,260996,Agence_mtn_Ouidah,300000,39004,Inès de Letellier,1092000,1352996,2022-06-25
CASH_IN,79566,Agence_mtn_Cotonou,300000,220434,Inès de Letellier,1352996,1432562,2022-06-26
CASH_IN,66701,Agence_mtn_Ouidah,300000,233299,Inès de Letellier,1432562,1499263,2022-06-26
CASH_OUT,77457,Raymond Rossi,198101,120644,Agence_mtn_Cotonou,300000,222543,2022-06-01
TRANSFER,148806,Claude Foucher,185351,36545,Raymond Rossi,120644,269450,2022-06-02
TRANSFER,120636,Raymond Rossi,269450,148814,Étienne Roche,143473,22837,2022-06-04
TRANSFER,3960,Astrid Gay de la Brunet,13462,9502,Raymond Rossi,148814,152774,2022-06-07
CASH_OUT,124348,Raymond Rossi,152774,28426,Agence_mtn_Abomey,300000,175652,2022-06-11
TRANSFER,8848,Raymond Rossi,28426,19578,Éléonore-Hélène Dubois,66429,57581,2022-06-13
CASH_OUT,3435,Raymond Rossi,19578,16143,Agence_mtn_Ouidah,300000,296565,2022-06-14
CASH_IN,268774,Agence_mtn_Ouidah,300000,31226,Raymond Rossi,16143,284917,2022-06-14
CASH_OUT,100547,Raymond Rossi,284917,184370,Agence_mtn_Abomey,300000,199453,2022-06-15
CASH_OUT,150274,Raymond Rossi,184370,34096,Agence_mtn_Ouidah,300000,149726,2022-06-15
CASH_IN,210165,Agence_mtn_Cotonou,300000,89835,Raymond Rossi,34096,244261,2022-06-15
CASH_OUT,66475,Raymond Rossi,244261,177786,Agence_mtn_Ouidah,300000,233525,2022-06-16
CASH_IN,120973,Agence_mtn_Abomey,300000,179027,Raymond Rossi,177786,298759,2022-06-17
CASH_OUT,240131,Raymond Rossi,298759,58628,Agence_mtn_Abomey,300000,59869,2022-06-18
CASH_OUT,13608,Raymond Rossi,58628,45020,Agence_mtn_Abomey,300000,286392,2022-06-19
TRANSFER,12156,Raymond Rossi,45020,32864,Renée David,1438004,1425848,2022-06-22
CASH_OUT,20528,Raymond Rossi,32864,12336,Agence_mtn_Ouidah,300000,279472,2022-06-22
CASH_IN,39617,Agence_mtn_Ouidah,300000,260383,Raymond Rossi,12336,51953,2022-06-24
CASH_OUT,29625,Raymond Rossi,51953,22328,Agence_mtn_Cotonou,300000,270375,2022-06-24
CASH_OUT,588,Raymond Rossi,22328,21740,Agence_mtn_Ouidah,300000,299412,2022-06-25
CASH_OUT,1934,Raymond Rossi,21740,19806,Agence_mtn_Abomey,300000,298066,2022-06-25
CASH_OUT,13149,Raymond Rossi,19806,6657,Agence_mtn_Cotonou,300000,286851,2022-06-26
TRANSFER,982451,Nathalie Peron,1017037,34586,Cécile Germain,1508600,526149,2022-06-01
CASH_IN,38577,Agence_mtn_Abomey,300000,261423,Nathalie Peron,34586,73163,2022-06-04
CASH_IN,44933,Agence_mtn_Abomey,300000,255067,Nathalie Peron,73163,118096,2022-06-04
CASH_IN,161563,Agence_mtn_Abomey,300000,138437,Nathalie Peron,118096,279659,2022-06-06
CASH_OUT,13109,Nathalie Peron,279659,266550,Agence_mtn_Cotonou,300000,286891,2022-06-08
CASH_IN,240795,Agence_mtn_Abomey,300000,59205,Nathalie Peron,266550,507345,2022-06-09
TRANSFER,19925,Bertrand Charles,119567,99642,Nathalie Peron,507345,527270,2022-06-13
CASH_IN,156235,Agence_mtn_Cotonou,300000,143765,Nathalie Peron,527270,683505,2022-06-13
CASH_OUT,329412,Nathalie Peron,683505,354093,Agence_mtn_Ouidah,300000,-29412,2022-06-14
TRANSFER,56087,Nathalie Peron,354093,298006,Philippine Courtois,1155923,1099836,2022-06-14
CASH_IN,157156,Agence_mtn_Abomey,300000,142844,Nathalie Peron,298006,455162,2022-06-15
CASH_IN,281043,Agence_mtn_Abomey,300000,18957,Nathalie Peron,455162,736205,2022-06-15
TRANSFER,42580,Nathalie Peron,736205,693625,Geneviève Grondin,11658,-30922,2022-06-16
TRANSFER,29119,Éléonore-Hélène Dubois,57581,28462,Nathalie Peron,693625,722744,2022-06-17
CASH_OUT,303519,Nathalie Peron,722744,419225,Agence_mtn_Cotonou,300000,-3519,2022-06-18
CASH_IN,9906,Agence_mtn_Cotonou,300000,290094,Nathalie Peron,419225,429131,2022-06-21
TRANSFER,148342,Nathalie Peron,429131,280789,Vincent Fournier,46248,-102094,2022-06-22
CASH_OUT,105837,Nathalie Peron,280789,174952,Agence_mtn_Cotonou,300000,194163,2022-06-23
CASH_IN,278284,Agence_mtn_Abomey,300000,21716,Nathalie Peron,174952,453236,2022-06-23
TRANSFER,214990,Nathalie Peron,453236,238246,Éléonore-Hélène Dubois,28462,-186528,2022-06-24
CASH_OUT,212600,Nathalie Peron,238246,25646,Agence_mtn_Ouidah,300000,87400,2022-06-24
CASH_IN,189318,Agence_mtn_Abomey,300000,110682,Nathalie Peron,25646,214964,2022-06-25
TRANSFER,169044,Catherine Faivre,1866453,1697409,Simone Pineau,961111,792067,2022-06-01
CASH_IN,226962,Agence_mtn_Cotonou,300000,73038,Catherine Faivre,1697409,1924371,2022-06-02
CASH_OUT,289590,Catherine Faivre,1924371,1634781,Agence_mtn_Abomey,300000,10410,2022-06-02
CASH_IN,279101,Agence_mtn_Abomey,300000,20899,Catherine Faivre,1634781,1913882,2022-06-04
CASH_OUT,1461208,Catherine Faivre,1913882,452674,Agence_mtn_Ouidah,300000,-1161208,2022-06-05
CASH_OUT,242619,Catherine Faivre,452674,210055,Agence_mtn_Ouidah,300000,57381,2022-06-06
TRANSFER,76869,Catherine Faivre,210055,133186,Bertrand Charles,99642,22773,2022-06-06
TRANSFER,657445,Léon Martins-Briand,1209000,551555,Catherine Faivre,133186,790631,2022-06-06
CASH_OUT,159302,Catherine Faivre,790631,631329,Agence_mtn_Cotonou,300000,140698,2022-06-06
CASH_OUT,139924,Catherine Faivre,631329,491405,Agence_mtn_Cotonou,300000,160076,2022-06-07
CASH_IN,53330,Agence_mtn_Cotonou,300000,246670,Catherine Faivre,491405,544735,2022-06-08
CASH_OUT,219517,Catherine Faivre,544735,325218,Agence_mtn_Cotonou,300000,80483,2022-06-12
CASH_OUT,218447,Catherine Faivre,325218,106771,Agence_mtn_Ouidah,300000,81553,2022-06-18
TRANSFER,65624,Catherine Faivre,106771,41147,Alphonse Leclercq-Rousseau,674040,608416,2022-06-18
TRANSFER,8623,Sébastien Lemaître,8839,216,Catherine Faivre,41147,49770,2022-06-19
CASH_IN,153508,Agence_mtn_Ouidah,300000,146492,Catherine Faivre,49770,203278,2022-06-19
CASH_IN,66650,Agence_mtn_Abomey,300000,233350,Catherine Faivre,203278,269928,2022-06-22
CASH_IN,296370,Agence_mtn_Cotonou,300000,3630,Catherine Faivre,269928,566298,2022-06-23
CASH_IN,235574,Agence_mtn_Abomey,300000,64426,Catherine Faivre,566298,801872,2022-06-25
CASH_OUT,191775,Catherine Faivre,801872,610097,Agence_mtn_Abomey,300000,108225,2022-06-25
CASH_OUT,293695,Catherine Faivre,610097,316402,Agence_mtn_Ouidah,300000,6305,2022-06-25
CASH_OUT,291130,Catherine Faivre,316402,25272,Agence_mtn_Cotonou,300000,8870,2022-06-26
CASH_IN,273143,Agence_mtn_Ouidah,300000,26857,Sophie Lévêque,-472819,-199676,2022-06-01
CASH_IN,135758,Agence_mtn_Cotonou,300000,164242,Sophie Lévêque,-199676,-63918,2022-06-01
CASH_IN,298788,Agence_mtn_Ouidah,300000,1212,Sophie Lévêque,-63918,234870,2022-06-03
CASH_OUT,17238,Sophie Lévêque,234870,217632,Agence_mtn_Ouidah,300000,282762,2022-06-05
CASH_IN,8398,Agence_mtn_Cotonou,300000,291602,Sophie Lévêque,217632,226030,2022-06-06
CASH_OUT,96531,Sophie Lévêque,226030,129499,Agence_mtn_Cotonou,300000,203469,2022-06-09
CASH_IN,267411,Agence_mtn_Cotonou,300000,32589,Sophie Lévêque,129499,396910,2022-06-09
TRANSFER,120129,Sophie Lévêque,396910,276781,Léon Martins-Briand,551555,431426,2022-06-10
TRANSFER,74819,Sophie Lévêque,276781,201962,Théodore De Oliveira-Nicolas,128435,53616,2022-06-11
CASH_IN,59192,Agence_mtn_Cotonou,300000,240808,Sophie Lévêque,201962,261154,2022-06-11
CASH_IN,82863,Agence_mtn_Abomey,300000,217137,Sophie Lévêque,261154,344017,2022-06-13
CASH_OUT,233036,Sophie Lévêque,344017,110981,Agence_mtn_Abomey,300000,66964,2022-06-13
CASH_IN,193401,Agence_mtn_Cotonou,300000,106599,Sophie Lévêque,110981,304382,2022-06-18
TRANSFER,44760,Louis Pichon,156613,111853,Sophie Lévêque,304382,349142,2022-06-19
CASH_IN,17838,Agence_mtn_Cotonou,300000,282162,Sophie Lévêque,349142,366980,2022-06-20
TRANSFER,48506,Sophie Lévêque,366980,318474,Bertrand Le Roux,284081,235575,2022-06-20
TRANSFER,311392,Sophie Lévêque,318474,7082,Théodore De Oliveira-Nicolas,53616,-257776,2022-06-22
CASH_OUT,4719,Sophie Lévêque,7082,2363,Agence_mtn_Cotonou,300000,295281,2022-06-22
TRANSFER,551,Alexandre Rémy,5307,4756,Sophie Lévêque,2363,2914,2022-06-23
TRANSFER,2705,Sophie Lévêque,2914,209,Alphonse Leclercq-Rousseau,608416,605711,2022-06-23
CASH_OUT,149,Sophie Lévêque,209,60,Agence_mtn_Abomey,300000,299851,2022-06-24
CASH_IN,223769,Agence_mtn_Abomey,300000,76231,Sophie Lévêque,60,223829,2022-06-24
CASH_OUT,218790,Sophie Lévêque,223829,5039,Agence_mtn_Abomey,300000,81210,2022-06-25
CASH_OUT,563,Sophie Lévêque,5039,4476,Agence_mtn_Ouidah,300000,299437,2022-06-26
TRANSFER,482384,Geneviève De Oliveira-Michel,997285,514901,Sophie Lévêque,4476,486860,2022-06-27
CASH_OUT,466745,Sophie Lévêque,486860,20115,Agence_mtn_Cotonou,300000,-166745,2022-06-27
CASH_OUT,25069,Louis Pichon,111853,86784,Agence_mtn_Ouidah,300000,274931,2022-06-04
CASH_IN,245370,Agence_mtn_Cotonou,300000,54630,Louis Pichon,86784,332154,2022-06-05
TRANSFER,456018,Isabelle Rossi,516460,60442,Louis Pichon,332154,788172,2022-06-06
TRANSFER,618302,Thibault Moreno,650458,32156,Louis Pichon,788172,1406474,2022-06-09
CASH_OUT,750745,Louis Pichon,1406474,655729,Agence_mtn_Ouidah,300000,-450745,2022-06-09
TRANSFER,771652,Margot Renaud,782092,10440,Louis Pichon,655729,1427381,2022-06-10
CASH_OUT,601496,Louis Pichon,1427381,825885,Agence_mtn_Abomey,300000,-301496,2022-06-11
CASH_OUT,23953,Louis Pichon,825885,801932,Agence_mtn_Ouidah,300000,276047,2022-06-12
TRANSFER,142640,Louis Pichon,801932,659292,Alphonse Leclercq-Rousseau,605711,463071,2022-06-13
CASH_OUT,517292,Louis Pichon,659292,142000,Agence_mtn_Ouidah,300000,-217292,2022-06-13
CASH_OUT,93466,Louis Pichon,142000,48534,Agence_mtn_Abomey,300000,206534,2022-06-14
CASH_IN,215433,Agence_mtn_Cotonou,300000,84567,Louis Pichon,48534,263967,2022-06-14
CASH_IN,79073,Agence_mtn_Abomey,300000,220927,Louis Pichon,263967,343040,2022-06-15
CASH_IN,193195,Agence_mtn_Abomey,300000,106805,Louis Pichon,343040,536235,2022-06-15
TRANSFER,317980,Louis Pichon,536235,218255,Pénélope Ollivier,456875,138895,2022-06-15
TRANSFER,290119,William Le Lucas,938636,648517,Louis Pichon,218255,508374,2022-06-17
TRANSFER,748,Alexandre Rémy,4756,4008,Louis Pichon,508374,509122,2022-06-17
TRANSFER,47861,Pénélope Ollivier,138895,91034,Louis Pichon,509122,556983,2022-06-18
CASH_OUT,268519,Louis Pichon,556983,288464,Agence_mtn_Cotonou,300000,31481,2022-06-18
CASH_IN,159797,Agence_mtn_Ouidah,300000,140203,Louis Pichon,288464,448261,2022-06-18
CASH_OUT,191772,Louis Pichon,448261,256489,Agence_mtn_Cotonou,300000,108228,2022-06-18
CASH_OUT,236018,Louis Pichon,256489,20471,Agence_mtn_Ouidah,300000,63982,2022-06-19
CASH_IN,215464,Agence_mtn_Ouidah,300000,84536,Louis Pichon,20471,235935,2022-06-19
CASH_OUT,43478,Louis Pichon,235935,192457,Agence_mtn_Ouidah,300000,256522,2022-06-20
CASH_OUT,38301,Louis Pichon,192457,154156,Agence_mtn_Ouidah,300000,261699,2022-06-20
CASH_OUT,27318,Louis Pichon,154156,126838,Agence_mtn_Cotonou,300000,272682,2022-06-21
CASH_OUT,29867,Louis Pichon,126838,96971,Agence_mtn_Abomey,300000,270133,2022-06-22
CASH_IN,211340,Agence_mtn_Abomey,300000,88660,Louis Pichon,96971,308311,2022-06-23
CASH_OUT,285154,Louis Pichon,308311,23157,Agence_mtn_Cotonou,300000,14846,2022-06-27
CASH_IN,232902,Agence_mtn_Cotonou,300000,67098,Geneviève De Oliveira-Michel,514901,747803,2022-06-01
CASH_IN,253901,Agence_mtn_Abomey,300000,46099,Geneviève De Oliveira-Michel,747803,1001704,2022-06-01
CASH_OUT,633401,Geneviève De Oliveira-Michel,1001704,368303,Agence_mtn_Ouidah,300000,-333401,2022-06-02
TRANSFER,128,Sébastien Lemaître,216,88,Geneviève De Oliveira-Michel,368303,368431,2022-06-03
CASH_IN,35828,Agence_mtn_Abomey,300000,264172,Geneviève De Oliveira-Michel,368431,404259,2022-06-05
CASH_OUT,222858,Geneviève De Oliveira-Michel,404259,181401,Agence_mtn_Ouidah,300000,77142,2022-06-08
TRANSFER,46554,Simone Pineau,792067,745513,Geneviève De Oliveira-Michel,181401,227955,2022-06-08
CASH_OUT,195193,Geneviève De Oliveira-Michel,227955,32762,Agence_mtn_Cotonou,300000,104807,2022-06-08
CASH_OUT,17898,Geneviève De Oliveira-Michel,32762,14864,Agence_mtn_Abomey,300000,282102,2022-06-08
TRANSFER,8664,Geneviève De Oliveira-Michel,14864,6200,Édouard Nguyen,434405,425741,2022-06-14
TRANSFER,189907,Pierre Roger,208300,18393,Geneviève De Oliveira-Michel,6200,196107,2022-06-15
TRANSFER,53490,Gabriel-Tristan Marty,125953,72463,Geneviève De Oliveira-Michel,196107,249597,2022-06-15
CASH_IN,135176,Agence_mtn_Ouidah,300000,164824,Geneviève De Oliveira-Michel,249597,384773,2022-06-15
CASH_OUT,49317,Geneviève De Oliveira-Michel,384773,335456,Agence_mtn_Abomey,300000,250683,2022-06-15
CASH_OUT,311632,Geneviève De Oliveira-Michel,335456,23824,Agence_mtn_Ouidah,300000,-11632,2022-06-18
CASH_OUT,20323,Geneviève De Oliveira-Michel,23824,3501,Agence_mtn_Ouidah,300000,279677,2022-06-20
CASH_OUT,2051,Geneviève De Oliveira-Michel,3501,1450,Agence_mtn_Abomey,300000,297949,2022-06-22
CASH_OUT,867,Geneviève De Oliveira-Michel,1450,583,Agence_mtn_Cotonou,300000,299133,2022-06-23
CASH_IN,23741,Agence_mtn_Abomey,300000,276259,Geneviève De Oliveira-Michel,583,24324,2022-06-23
CASH_OUT,17162,Geneviève De Oliveira-Michel,24324,7162,Agence_mtn_Cotonou,300000,282838,2022-06-23
CASH_IN,156587,Agence_mtn_Ouidah,300000,143413,Geneviève De Oliveira-Michel,7162,163749,2022-06-24
TRANSFER,159595,Geneviève De Oliveira-Michel,163749,4154,Édouard Nguyen,425741,266146,2022-06-26
CASH_IN,170831,Agence_mtn_Cotonou,300000,129169,Geneviève De Oliveira-Michel,4154,174985,2022-06-26
TRANSFER,574035,Hortense Lemaire,641897,67862,Geneviève De Oliveira-Michel,174985,749020,2022-06-27
CASH_IN,203629,Agence_mtn_Cotonou,300000,96371,Antoinette Bertrand,-29959,173670,2022-06-04
TRANSFER,115276,Antoinette Bertrand,173670,58394,Thérèse-Margaux Bruneau,3053,-112223,2022-06-07
TRANSFER,27460,Antoinette Bertrand,58394,30934,Gilbert Foucher,694854,667394,2022-06-15
TRANSFER,57668,Victoire-Nicole Lopez,142104,84436,Antoinette Bertrand,30934,88602,2022-06-22
CASH_IN,5356,Agence_mtn_Ouidah,300000,294644,Antoinette Bertrand,88602,93958,2022-06-27
TRANSFER,7919,Antoinette Bertrand,93958,86039,Gilbert Foucher,667394,659475,2022-06-27
CASH_IN,193344,Agence_mtn_Ouidah,300000,106656,Franck-Charles Texier,875548,1068892,2022-06-01
CASH_IN,71777,Agence_mtn_Cotonou,300000,228223,Franck-Charles Texier,1068892,1140669,2022-06-01
CASH_IN,150065,Agence_mtn_Cotonou,300000,149935,Franck-Charles Texier,1140669,1290734,2022-06-03
TRANSFER,52616,Bertrand Le Roux,235575,182959,Franck-Charles Texier,1290734,1343350,2022-06-04
TRANSFER,278706,Pénélope Dupuis,451812,173106,Franck-Charles Texier,1343350,1622056,2022-06-07
CASH_IN,222219,Agence_mtn_Ouidah,300000,77781,Franck-Charles Texier,1622056,1844275,2022-06-09
CASH_IN,4271,Agence_mtn_Cotonou,300000,295729,Franck-Charles Texier,1844275,1848546,2022-06-14
CASH_OUT,500783,Franck-Charles Texier,1848546,1347763,Agence_mtn_Abomey,300000,-200783,2022-06-15
CASH_IN,148789,Agence_mtn_Abomey,300000,151211,Franck-Charles Texier,1347763,1496552,2022-06-15
CASH_OUT,360688,Franck-Charles Texier,1496552,1135864,Agence_mtn_Abomey,300000,-60688,2022-06-16
CASH_OUT,416749,Franck-Charles Texier,1135864,719115,Agence_mtn_Ouidah,300000,-116749,2022-06-18
TRANSFER,330849,Renée David,1425848,1094999,Franck-Charles Texier,719115,1049964,2022-06-19
CASH_IN,265754,Agence_mtn_Abomey,300000,34246,Franck-Charles Texier,1049964,1315718,2022-06-20
CASH_IN,535,Agence_mtn_Ouidah,300000,299465,Franck-Charles Texier,1315718,1316253,2022-06-21
CASH_IN,70828,Agence_mtn_Cotonou,300000,229172,Franck-Charles Texier,1316253,1387081,2022-06-22
TRANSFER,1128366,Franck-Charles Texier,1387081,258715,Claude Foucher,36545,-1091821,2022-06-23
CASH_IN,251270,Agence_mtn_Abomey,300000,48730,Franck-Charles Texier,258715,509985,2022-06-26
CASH_OUT,248259,Franck-Charles Texier,509985,261726,Agence_mtn_Cotonou,300000,51741,2022-06-26
CASH_OUT,84903,Pénélope Ollivier,91034,6131,Agence_mtn_Cotonou,300000,215097,2022-06-02
TRANSFER,5400,Pénélope Ollivier,6131,731,Pénélope Ollivier,6131,731,2022-06-06
TRANSFER,159043,Pénélope Dupuis,173106,14063,Pénélope Ollivier,731,159774,2022-06-09
TRANSFER,330605,Adèle Labbé,577347,246742,Pénélope Ollivier,159774,490379,2022-06-09
TRANSFER,284896,Pénélope Ollivier,490379,205483,Pénélope Dupuis,14063,-270833,2022-06-12
TRANSFER,674744,Philippine Courtois,1099836,425092,Pénélope Ollivier,205483,880227,2022-06-17
TRANSFER,625944,Pénélope Ollivier,880227,254283,Bertrand Charles,22773,-603171,2022-06-20
CASH_OUT,174912,Pénélope Ollivier,254283,79371,Agence_mtn_Ouidah,300000,125088,2022-06-22
CASH_OUT,5370,Pénélope Ollivier,79371,74001,Agence_mtn_Ouidah,300000,294630,2022-06-24
CASH_IN,282077,Agence_mtn_Abomey,300000,17923,Laurent-Bertrand Lefort,-51329,230748,2022-06-01
CASH_IN,186751,Agence_mtn_Cotonou,300000,113249,Laurent-Bertrand Lefort,230748,417499,2022-06-03
CASH_OUT,293484,Laurent-Bertrand Lefort,417499,124015,Agence_mtn_Cotonou,300000,6516,2022-06-10
TRANSFER,70611,Léon Lecoq,228767,158156,Laurent-Bertrand Lefort,124015,194626,2022-06-11
CASH_IN,1424,Agence_mtn_Ouidah,300000,298576,Laurent-Bertrand Lefort,194626,196050,2022-06-11
TRANSFER,12969,Édouard Nguyen,266146,253177,Laurent-Bertrand Lefort,196050,209019,2022-06-11
TRANSFER,137699,Laurent-Bertrand Lefort,209019,71320,Léon Lecoq,158156,20457,2022-06-15
CASH_IN,208705,Agence_mtn_Cotonou,300000,91295,Laurent-Bertrand Lefort,71320,280025,2022-06-17
TRANSFER,113637,Laurent-Bertrand Lefort,280025,166388,Émilie Moulin,641016,527379,2022-06-19
CASH_OUT,124995,Laurent-Bertrand Lefort,166388,41393,Agence_mtn_Cotonou,300000,175005,2022-06-20
CASH_OUT,25036,Laurent-Bertrand Lefort,41393,16357,Agence_mtn_Cotonou,300000,274964,2022-06-22
TRANSFER,221594,Jean Benard,301766,80172,Gabriel-Tristan Marty,72463,-149131,2022-06-01
TRANSFER,58459,Jean Benard,80172,21713,Adèle Labbé,246742,188283,2022-06-04
CASH_IN,265402,Agence_mtn_Ouidah,300000,34598,Jean Benard,21713,287115,2022-06-06
TRANSFER,30597,Jean Benard,287115,256518,Renée David,1094999,1064402,2022-06-07
CASH_OUT,251511,Jean Benard,256518,5007,Agence_mtn_Ouidah,300000,48489,2022-06-08
TRANSFER,21152,Isabelle Rossi,60442,39290,Jean Benard,5007,26159,2022-06-08
CASH_IN,14009,Agence_mtn_Cotonou,300000,285991,Jean Benard,26159,40168,2022-06-08
CASH_OUT,32942,Jean Benard,40168,7226,Agence_mtn_Abomey,300000,267058,2022-06-11
TRANSFER,233347,Cécile Germain,526149,292802,Jean Benard,7226,240573,2022-06-12
CASH_IN,90649,Agence_mtn_Ouidah,300000,209351,Jean Benard,240573,331222,2022-06-21
TRANSFER,255567,Jean Benard,331222,75655,Renée David,1064402,808835,2022-06-27
CASH_IN,11833,Agence_mtn_Cotonou,300000,288167,Thibault Moreno,32156,43989,2022-06-01
CASH_OUT,35149,Thibault Moreno,43989,8840,Agence_mtn_Cotonou,300000,264851,2022-06-02
CASH_OUT,1021,Thibault Moreno,8840,7819,Agence_mtn_Abomey,300000,298979,2022-06-09
CASH_IN,149429,Agence_mtn_Ouidah,300000,150571,Thibault Moreno,7819,157248,2022-06-11
CASH_OUT,71544,Thibault Moreno,157248,85704,Agence_mtn_Cotonou,300000,228456,2022-06-11
TRANSFER,13683,Richard Le Descamps,14713,1030,Thibault Moreno,85704,99387,2022-06-12
TRANSFER,13165,Vincent Mathieu,1647600,1634435,Thibault Moreno,99387,112552,2022-06-13
TRANSFER,1633,Astrid Gay de la Brunet,9502,7869,Thibault Moreno,112552,114185,2022-06-13
CASH_IN,54340,Agence_mtn_Cotonou,300000,245660,Thibault Moreno,114185,168525,2022-06-13
CASH_IN,266489,Agence_mtn_Ouidah,300000,33511,Thibault Moreno,168525,435014,2022-06-14
CASH_IN,298281,Agence_mtn_Ouidah,300000,1719,Thibault Moreno,435014,733295,2022-06-15
TRANSFER,248400,Cécile Germain,292802,44402,Thibault Moreno,733295,981695,2022-06-16
CASH_IN,110119,Agence_mtn_Abomey,300000,189881,Thibault Moreno,981695,1091814,2022-06-17
CASH_IN,16499,Agence_mtn_Cotonou,300000,283501,Thibault Moreno,1091814,1108313,2022-06-18
CASH_OUT,626407,Thibault Moreno,1108313,481906,Agence_mtn_Ouidah,300000,-326407,2022-06-20
CASH_IN,234782,Agence_mtn_Cotonou,300000,65218,Thibault Moreno,481906,716688,2022-06-22
CASH_IN,117533,Agence_mtn_Cotonou,300000,182467,Thibault Moreno,716688,834221,2022-06-23
CASH_IN,29283,Agence_mtn_Ouidah,300000,270717,Thibault Moreno,834221,863504,2022-06-24
TRANSFER,121596,Alphonse Leclercq-Rousseau,463071,341475,Thibault Moreno,863504,985100,2022-06-25
TRANSFER,220471,Thibault Moreno,985100,764629,Émilie Moulin,527379,306908,2022-06-25
CASH_IN,280684,Agence_mtn_Abomey,300000,19316,Laure Philippe,-135054,145630,2022-06-01
CASH_OUT,123308,Laure Philippe,145630,22322,Agence_mtn_Cotonou,300000,176692,2022-06-02
CASH_OUT,1833,Laure Philippe,22322,20489,Agence_mtn_Cotonou,300000,298167,2022-06-05
TRANSFER,8244,Laure Philippe,20489,12245,Victoire-Nicole Lopez,84436,76192,2022-06-05
CASH_IN,187718,Agence_mtn_Ouidah,300000,112282,Laure Philippe,12245,199963,2022-06-07
CASH_IN,257402,Agence_mtn_Ouidah,300000,42598,Laure Philippe,199963,457365,2022-06-07
TRANSFER,161531,Laure Philippe,457365,295834,Laure Philippe,457365,295834,2022-06-09
CASH_IN,90627,Agence_mtn_Cotonou,300000,209373,Laure Philippe,295834,386461,2022-06-12
TRANSFER,167669,Simone Pineau,745513,577844,Laure Philippe,386461,554130,2022-06-15
TRANSFER,42641,Laure Philippe,554130,511489,Alphonse Leclercq-Rousseau,341475,298834,2022-06-18
TRANSFER,30805,Victoire-Nicole Lopez,76192,45387,Laure Philippe,511489,542294,2022-06-19
TRANSFER,407136,Laure Philippe,542294,135158,Alexandre Rémy,4008,-403128,2022-06-19
CASH_IN,199827,Agence_mtn_Ouidah,300000,100173,Laure Philippe,135158,334985,2022-06-23
TRANSFER,323426,Laure Philippe,334985,11559,Renée David,808835,485409,2022-06-27
CASH_IN,214177,Agence_mtn_Ouidah,300000,85823,Margot Riou du Fernandes,19537,233714,2022-06-01
CASH_OUT,165064,Margot Riou du Fernandes,233714,68650,Agence_mtn_Ouidah,300000,134936,2022-06-06
CASH_OUT,27497,Margot Riou du Fernandes,68650,41153,Agence_mtn_Cotonou,300000,272503,2022-06-09
TRANSFER,244,Victoire-Nicole Lopez,45387,45143,Margot Riou du Fernandes,41153,41397,2022-06-11
CASH_IN,145632,Agence_mtn_Ouidah,300000,154368,Margot Riou du Fernandes,41397,187029,2022-06-12
TRANSFER,129534,Margot Riou du Fernandes,187029,57495,Margot Riou du Fernandes,187029,316563,2022-06-13
TRANSFER,47945,Margot Riou du Fernandes,57495,9550,Étienne Roche,22837,-25108,2022-06-14
CASH_IN,170836,Agence_mtn_Ouidah,300000,129164,Margot Riou du Fernandes,9550,180386,2022-06-15
TRANSFER,147986,Margot Riou du Fernandes,180386,32400,Richard Le Descamps,1030,-146956,2022-06-16
TRANSFER,312971,Valérie Dijoux,803161,490190,Margot Riou du Fernandes,32400,345371,2022-06-16
TRANSFER,35801,Hortense Lemaire,67862,32061,Margot Riou du Fernandes,345371,381172,2022-06-16
TRANSFER,129733,Margot Riou du Fernandes,381172,251439,Margot Riou du Fernandes,381172,251439,2022-06-18
TRANSFER,40267,Margot Riou du Fernandes,251439,211172,Margot Renaud,10440,-29827,2022-06-21
TRANSFER,199053,Margot Riou du Fernandes,211172,12119,Léon Martins-Briand,431426,232373,2022-06-22
TRANSFER,11539,Léon Lecoq,20457,8918,Margot Riou du Fernandes,12119,23658,2022-06-23
CASH_OUT,9848,Margot Riou du Fernandes,23658,13810,Agence_mtn_Abomey,300000,290152,2022-06-24
CASH_OUT,4210,Margot Riou du Fernandes,13810,9600,Agence_mtn_Abomey,300000,295790,2022-06-26
CASH_OUT,6340,Margot Riou du Fernandes,9600,3260,Agence_mtn_Abomey,300000,293660,2022-06-27
CASH_OUT,1261,Margot Riou du Fernandes,3260,1999,Agence_mtn_Cotonou,300000,298739,2022-06-27
CASH_IN,152875,Agence_mtn_Abomey,300000,147125,Éléonore-Hélène Dubois,-186528,-33653,2022-06-02
CASH_IN,276504,Agence_mtn_Ouidah,300000,23496,Éléonore-Hélène Dubois,-33653,242851,2022-06-04
TRANSFER,19396,Éléonore-Hélène Dubois,242851,223455,Alix Maillet,12008,-7388,2022-06-18
CASH_IN,123519,Agence_mtn_Cotonou,300000,176481,Éléonore-Hélène Dubois,223455,346974,2022-06-18
CASH_IN,29664,Agence_mtn_Ouidah,300000,270336,Éléonore-Hélène Dubois,346974,376638,2022-06-19
TRANSFER,38426,Éléonore-Hélène Dubois,376638,338212,Hortense Lemaire,32061,-6365,2022-06-20
CASH_OUT,92505,Éléonore-Hélène Dubois,338212,245707,Agence_mtn_Cotonou,300000,207495,2022-06-20
TRANSFER,178891,Éléonore-Hélène Dubois,245707,66816,Bertrand Le Roux,182959,4068,2022-06-26
CASH_OUT,32498,Éléonore-Hélène Dubois,66816,34318,Agence_mtn_Ouidah,300000,267502,2022-06-26
TRANSFER,93784,Gilbert Foucher,659475,565691,Vincent Mathieu,1634435,1540651,2022-06-03
TRANSFER,285336,Gilbert Foucher,565691,280355,Cécile Germain,44402,-240934,2022-06-04
CASH_IN,45679,Agence_mtn_Ouidah,300000,254321,Gilbert Foucher,280355,326034,2022-06-05
CASH_OUT,91463,Gilbert Foucher,326034,234571,Agence_mtn_Cotonou,300000,208537,2022-06-05
TRANSFER,112621,Gilbert Foucher,234571,121950,Alphonse Leclercq-Rousseau,298834,186213,2022-06-09
CASH_IN,227585,Agence_mtn_Cotonou,300000,72415,Gilbert Foucher,121950,349535,2022-06-11
CASH_OUT,175137,Gilbert Foucher,349535,174398,Agence_mtn_Cotonou,300000,124863,2022-06-11
CASH_IN,290769,Agence_mtn_Ouidah,300000,9231,Gilbert Foucher,174398,465167,2022-06-13
CASH_IN,106238,Agence_mtn_Abomey,300000,193762,Gilbert Foucher,465167,571405,2022-06-13
TRANSFER,134872,Gilbert Foucher,571405,436533,Corinne-Louise Valentin,334073,199201,2022-06-14
CASH_IN,14740,Agence_mtn_Ouidah,300000,285260,Gilbert Foucher,436533,451273,2022-06-15
CASH_OUT,137637,Gilbert Foucher,451273,313636,Agence_mtn_Cotonou,300000,162363,2022-06-16
CASH_IN,139309,Agence_mtn_Cotonou,300000,160691,Gilbert Foucher,313636,452945,2022-06-17
TRANSFER,1503386,Vincent Mathieu,1540651,37265,Gilbert Foucher,452945,1956331,2022-06-18
TRANSFER,1574781,Gilbert Foucher,1956331,381550,Frédéric Couturier,8272,-1566509,2022-06-19
TRANSFER,93238,Alphonse Leclercq-Rousseau,186213,92975,Gilbert Foucher,381550,474788,2022-06-22
CASH_IN,224565,Agence_mtn_Cotonou,300000,75435,Gilbert Foucher,474788,699353,2022-06-22
CASH_IN,147220,Agence_mtn_Abomey,300000,152780,Gilbert Foucher,699353,846573,2022-06-23
CASH_IN,5064,Agence_mtn_Abomey,300000,294936,Gilbert Foucher,846573,851637,2022-06-23
TRANSFER,13828,Pierre Roger,18393,4565,Gilbert Foucher,851637,865465,2022-06-26
TRANSFER,3569,Bertrand Le Roux,4068,499,Corinne-Louise Valentin,199201,195632,2022-06-02
CASH_OUT,258,Bertrand Le Roux,499,241,Agence_mtn_Abomey,300000,299742,2022-06-08
CASH_OUT,203,Bertrand Le Roux,241,38,Agence_mtn_Abomey,300000,299797,2022-06-10
CASH_IN,68521,Agence_mtn_Cotonou,300000,231479,Bertrand Le Roux,38,68559,2022-06-12
TRANSFER,62857,Bertrand Le Roux,68559,5702,Bertrand Le Roux,68559,5702,2022-06-13
TRANSFER,2188,Bertrand Le Roux,5702,3514,Bertrand Le Roux,5702,7890,2022-06-15
TRANSFER,278,Bertrand Le Roux,3514,3236,Vincent Mathieu,37265,36987,2022-06-16
TRANSFER,2224,Bertrand Le Roux,3236,1012,Pierre Roger,4565,2341,2022-06-18
CASH_IN,260104,Agence_mtn_Ouidah,300000,39896,Bertrand Le Roux,1012,261116,2022-06-21
CASH_OUT,147763,Bertrand Le Roux,261116,113353,Agence_mtn_Cotonou,300000,152237,2022-06-21
TRANSFER,55866,Bertrand Le Roux,113353,57487,Vincent Mathieu,36987,-18879,2022-06-22
TRANSFER,33267,Bertrand Le Roux,57487,24220,Philippine Courtois,425092,391825,2022-06-23
TRANSFER,7784,Bertrand Le Roux,24220,16436,Corinne-Louise Valentin,195632,187848,2022-06-25
TRANSFER,851,Bertrand Le Roux,16436,15585,Valérie Dijoux,490190,489339,2022-06-27
TRANSFER,842,Pierre Roger,2341,1499,Astrid Gay de la Brunet,7869,7027,2022-06-08
TRANSFER,14044,Alphonse Leclercq-Rousseau,92975,78931,Pierre Roger,1499,15543,2022-06-09
CASH_OUT,14942,Pierre Roger,15543,601,Agence_mtn_Ouidah,300000,285058,2022-06-10
CASH_OUT,274,Pierre Roger,601,327,Agence_mtn_Abomey,300000,299726,2022-06-11
CASH_IN,288691,Agence_mtn_Cotonou,300000,11309,Pierre Roger,327,289018,2022-06-11
TRANSFER,191656,Pierre Roger,289018,97362,Pierre Roger,289018,480674,2022-06-12
CASH_OUT,6930,Pierre Roger,97362,90432,Agence_mtn_Abomey,300000,293070,2022-06-13
TRANSFER,206833,Léon Martins-Briand,232373,25540,Pierre Roger,90432,297265,2022-06-13
CASH_IN,260710,Agence_mtn_Abomey,300000,39290,Pierre Roger,297265,557975,2022-06-14
CASH_IN,187264,Agence_mtn_Abomey,300000,112736,Pierre Roger,557975,745239,2022-06-15
CASH_IN,32141,Agence_mtn_Cotonou,300000,267859,Pierre Roger,745239,777380,2022-06-19
CASH_IN,245164,Agence_mtn_Ouidah,300000,54836,Pierre Roger,777380,1022544,2022-06-20
CASH_OUT,315754,Pierre Roger,1022544,706790,Agence_mtn_Cotonou,300000,-15754,2022-06-20
CASH_IN,62797,Agence_mtn_Abomey,300000,237203,Pierre Roger,706790,769587,2022-06-23
CASH_IN,247902,Agence_mtn_Cotonou,300000,52098,Pierre Roger,769587,1017489,2022-06-23
CASH_IN,148764,Agence_mtn_Ouidah,300000,151236,Pierre Roger,1017489,1166253,2022-06-24
CASH_IN,19088,Agence_mtn_Cotonou,300000,280912,Thierry Delattre-Simon,-362614,-343526,2022-06-03
CASH_IN,189518,Agence_mtn_Ouidah,300000,110482,Thierry Delattre-Simon,-343526,-154008,2022-06-03
CASH_IN,229478,Agence_mtn_Cotonou,300000,70522,Thierry Delattre-Simon,-154008,75470,2022-06-05
CASH_OUT,68792,Thierry Delattre-Simon,75470,6678,Agence_mtn_Abomey,300000,231208,2022-06-07
CASH_IN,246374,Agence_mtn_Ouidah,300000,53626,Thierry Delattre-Simon,6678,253052,2022-06-08
CASH_OUT,213979,Thierry Delattre-Simon,253052,39073,Agence_mtn_Ouidah,300000,86021,2022-06-09
TRANSFER,444329,Simone Pineau,577844,133515,Thierry Delattre-Simon,39073,483402,2022-06-09
TRANSFER,346592,Thierry Delattre-Simon,483402,136810,Victoire-Nicole Lopez,45143,-301449,2022-06-12
CASH_OUT,48547,Thierry Delattre-Simon,136810,88263,Agence_mtn_Abomey,300000,251453,2022-06-12
CASH_IN,244066,Agence_mtn_Cotonou,300000,55934,Thierry Delattre-Simon,88263,332329,2022-06-12
CASH_IN,224990,Agence_mtn_Ouidah,300000,75010,Thierry Delattre-Simon,332329,557319,2022-06-12
CASH_OUT,190519,Thierry Delattre-Simon,557319,366800,Agence_mtn_Abomey,300000,109481,2022-06-14
TRANSFER,191845,Thierry Delattre-Simon,366800,174955,Thierry Delattre-Simon,366800,174955,2022-06-14
TRANSFER,102515,Thierry Delattre-Simon,174955,72440,Thierry Delattre-Simon,174955,72440,2022-06-16
TRANSFER,53782,Thierry Delattre-Simon,72440,18658,Édouard Nguyen,253177,199395,2022-06-17
TRANSFER,79145,Corinne-Louise Valentin,187848,108703,Thierry Delattre-Simon,18658,97803,2022-06-17
TRANSFER,99003,Corinne-Louise Valentin,108703,9700,Thierry Delattre-Simon,97803,196806,2022-06-17
TRANSFER,6831,Léon Lecoq,8918,2087,Thierry Delattre-Simon,196806,203637,2022-06-23
CASH_IN,120348,Agence_mtn_Ouidah,300000,179652,Thierry Delattre-Simon,203637,323985,2022-06-27
CASH_IN,144925,Agence_mtn_Ouidah,300000,155075,Pénélope Dupuis,-270833,-125908,2022-06-05
CASH_IN,17336,Agence_mtn_Ouidah,300000,282664,Pénélope Dupuis,-125908,-108572,2022-06-11
CASH_IN,182982,Agence_mtn_Cotonou,300000,117018,Pénélope Dupuis,-108572,74410,2022-06-12
TRANSFER,1441,Léon Lecoq,2087,646,Pénélope Dupuis,74410,75851,2022-06-16
CASH_IN,61532,Agence_mtn_Cotonou,300000,238468,Pénélope Dupuis,75851,137383,2022-06-18
TRANSFER,18918,Pénélope Dupuis,137383,118465,Simone Pineau,133515,114597,2022-06-20
CASH_OUT,22432,Léon Martins-Briand,25540,3108,Agence_mtn_Ouidah,300000,277568,2022-06-02
TRANSFER,6123,Astrid Gay de la Brunet,7027,904,Léon Martins-Briand,3108,9231,2022-06-06
CASH_OUT,7906,Léon Martins-Briand,9231,1325,Agence_mtn_Abomey,300000,292094,2022-06-08
CASH_IN,295203,Agence_mtn_Abomey,300000,4797,Léon Martins-Briand,1325,296528,2022-06-12
CASH_IN,261221,Agence_mtn_Cotonou,300000,38779,Léon Martins-Briand,296528,557749,2022-06-12
CASH_OUT,528890,Léon Martins-Briand,557749,28859,Agence_mtn_Cotonou,300000,-228890,2022-06-12
CASH_OUT,19555,Léon Martins-Briand,28859,9304,Agence_mtn_Cotonou,300000,280445,2022-06-14
TRANSFER,3927,Léon Martins-Briand,9304,5377,Valérie Dijoux,489339,485412,2022-06-17
CASH_IN,151339,Agence_mtn_Cotonou,300000,148661,Léon Martins-Briand,5377,156716,2022-06-18
CASH_OUT,28949,Léon Martins-Briand,156716,127767,Agence_mtn_Cotonou,300000,271051,2022-06-20
CASH_IN,55061,Agence_mtn_Cotonou,300000,244939,Victoire-Nicole Lopez,-301449,-246388,2022-06-02
CASH_IN,289707,Agence_mtn_Abomey,300000,10293,Victoire-Nicole Lopez,-246388,43319,2022-06-03
CASH_IN,288797,Agence_mtn_Cotonou,300000,11203,Victoire-Nicole Lopez,43319,332116,2022-06-04
CASH_OUT,284304,Victoire-Nicole Lopez,332116,47812,Agence_mtn_Cotonou,300000,15696,2022-06-04
CASH_IN,286810,Agence_mtn_Abomey,300000,13190,Victoire-Nicole Lopez,47812,334622,2022-06-06
CASH_IN,94860,Agence_mtn_Cotonou,300000,205140,Victoire-Nicole Lopez,334622,429482,2022-06-09
CASH_OUT,84333,Victoire-Nicole Lopez,429482,345149,Agence_mtn_Ouidah,300000,215667,2022-06-12
TRANSFER,225562,Victoire-Nicole Lopez,345149,119587,Alphonse Leclercq-Rousseau,78931,-146631,2022-06-14
CASH_IN,144257,Agence_mtn_Ouidah,300000,155743,Victoire-Nicole Lopez,119587,263844,2022-06-15
TRANSFER,40479,Victoire-Nicole Lopez,263844,223365,Valérie Dijoux,485412,444933,2022-06-15
CASH_OUT,165434,Victoire-Nicole Lopez,223365,57931,Agence_mtn_Cotonou,300000,134566,2022-06-17
CASH_IN,281958,Agence_mtn_Abomey,300000,18042,Victoire-Nicole Lopez,57931,339889,2022-06-18
TRANSFER,401972,William Le Lucas,648517,246545,Victoire-Nicole Lopez,339889,741861,2022-06-21
TRANSFER,731605,Victoire-Nicole Lopez,741861,10256,Corinne-Louise Valentin,9700,-721905,2022-06-24
CASH_OUT,574,Victoire-Nicole Lopez,10256,9682,Agence_mtn_Cotonou,300000,299426,2022-06-26
CASH_IN,214265,Agence_mtn_Ouidah,300000,85735,Bertrand Charles,-603171,-388906,2022-06-06
CASH_IN,177527,Agence_mtn_Ouidah,300000,122473,Bertrand Charles,-388906,-211379,2022-06-10
CASH_IN,168127,Agence_mtn_Abomey,300000,131873,Bertrand Charles,-211379,-43252,2022-06-11
CASH_IN,240878,Agence_mtn_Abomey,300000,59122,Bertrand Charles,-43252,197626,2022-06-11
CASH_OUT,144390,Bertrand Charles,197626,53236,Agence_mtn_Ouidah,300000,155610,2022-06-12
TRANSFER,34983,Simone Pineau,114597,79614,Bertrand Charles,53236,88219,2022-06-12
CASH_OUT,33683,Bertrand Charles,88219,54536,Agence_mtn_Abomey,300000,266317,2022-06-14
TRANSFER,16600,Isabelle Rossi,39290,22690,Bertrand Charles,54536,71136,2022-06-24
CASH_OUT,46621,Bertrand Charles,71136,24515,Agence_mtn_Cotonou,300000,253379,2022-06-27
CASH_IN,142210,Agence_mtn_Ouidah,300000,157790,Alix Maillet,-7388,134822,2022-06-04
CASH_OUT,86211,Alix Maillet,134822,48611,Agence_mtn_Cotonou,300000,213789,2022-06-07
CASH_IN,110784,Agence_mtn_Abomey,300000,189216,Alix Maillet,48611,159395,2022-06-12
TRANSFER,18297,Isabelle Rossi,22690,4393,Alix Maillet,159395,177692,2022-06-13
CASH_IN,99684,Agence_mtn_Cotonou,300000,200316,Alix Maillet,177692,277376,2022-06-14
CASH_IN,70618,Agence_mtn_Abomey,300000,229382,Alix Maillet,277376,347994,2022-06-15
CASH_OUT,151436,Alix Maillet,347994,196558,Agence_mtn_Abomey,300000,148564,2022-06-19
TRANSFER,184575,Alix Maillet,196558,11983,Émilie Moulin,306908,122333,2022-06-25
CASH_IN,7818,Agence_mtn_Abomey,300000,292182,Eugène Poulain,-151885,-144067,2022-06-01
CASH_IN,173715,Agence_mtn_Abomey,300000,126285,Eugène Poulain,-144067,29648,2022-06-02
CASH_OUT,5850,Eugène Poulain,29648,23798,Agence_mtn_Abomey,300000,294150,2022-06-06
CASH_OUT,12410,Eugène Poulain,23798,11388,Agence_mtn_Abomey,300000,287590,2022-06-06
TRANSFER,10429,Eugène Poulain,11388,959,William Le Lucas,246545,236116,2022-06-08
CASH_OUT,849,Eugène Poulain,959,110,Agence_mtn_Abomey,300000,299151,2022-06-12
CASH_IN,161484,Agence_mtn_Abomey,300000,138516,Eugène Poulain,110,161594,2022-06-13
CASH_IN,163356,Agence_mtn_Cotonou,300000,136644,Eugène Poulain,161594,324950,2022-06-13
CASH_IN,127765,Agence_mtn_Abomey,300000,172235,Eugène Poulain,324950,452715,2022-06-18
CASH_IN,228542,Agence_mtn_Ouidah,300000,71458,Eugène Poulain,452715,681257,2022-06-18
CASH_OUT,637235,Eugène Poulain,681257,44022,Agence_mtn_Abomey,300000,-337235,2022-06-21
TRANSFER,39923,Eugène Poulain,44022,4099,Édouard Nguyen,199395,159472,2022-06-26
CASH_OUT,760,Eugène Poulain,4099,3339,Agence_mtn_Cotonou,300000,299240,2022-06-26
TRANSFER,1939,Eugène Poulain,3339,1400,William Le Lucas,236116,234177,2022-06-27
CASH_IN,296670,Agence_mtn_Abomey,300000,3330,Rémy Le Michaud,-467966,-171296,2022-06-04
CASH_IN,126317,Agence_mtn_Abomey,300000,173683,Rémy Le Michaud,-171296,-44979,2022-06-06
CASH_IN,35973,Agence_mtn_Cotonou,300000,264027,Rémy Le Michaud,-44979,-9006,2022-06-06
CASH_IN,249049,Agence_mtn_Ouidah,300000,50951,Rémy Le Michaud,-9006,240043,2022-06-07
CASH_OUT,102751,Rémy Le Michaud,240043,137292,Agence_mtn_Abomey,300000,197249,2022-06-07
CASH_IN,152301,Agence_mtn_Ouidah,300000,147699,Rémy Le Michaud,137292,289593,2022-06-11
TRANSFER,191989,Rémy Le Michaud,289593,97604,Isabelle Rossi,4393,-187596,2022-06-12
CASH_IN,180180,Agence_mtn_Ouidah,300000,119820,Rémy Le Michaud,97604,277784,2022-06-12
CASH_IN,52749,Agence_mtn_Ouidah,300000,247251,Rémy Le Michaud,277784,330533,2022-06-14
TRANSFER,35324,Édouard Nguyen,159472,124148,Rémy Le Michaud,330533,365857,2022-06-16
CASH_OUT,186669,Rémy Le Michaud,365857,179188,Agence_mtn_Abomey,300000,113331,2022-06-16
TRANSFER,39960,Simone Pineau,79614,39654,Rémy Le Michaud,179188,219148,2022-06-17
CASH_IN,149881,Agence_mtn_Cotonou,300000,150119,Rémy Le Michaud,219148,369029,2022-06-20
TRANSFER,221327,Rémy Le Michaud,369029,147702,Adèle Labbé,188283,-33044,2022-06-21
CASH_OUT,29136,Rémy Le Michaud,147702,118566,Agence_mtn_Cotonou,300000,270864,2022-06-21
TRANSFER,100910,Rémy Le Michaud,118566,17656,Astrid Gay de la Brunet,904,-100006,2022-06-23
CASH_IN,264741,Agence_mtn_Cotonou,300000,35259,Rémy Le Michaud,17656,282397,2022-06-24
CASH_OUT,254168,Rémy Le Michaud,282397,28229,Agence_mtn_Ouidah,300000,45832,2022-06-26
CASH_OUT,4305,Rémy Le Michaud,28229,23924,Agence_mtn_Cotonou,300000,295695,2022-06-26
CASH_IN,170280,Agence_mtn_Ouidah,300000,129720,Rémy Le Michaud,23924,194204,2022-06-27
CASH_IN,16487,Agence_mtn_Ouidah,300000,283513,Théodore De Oliveira-Nicolas,-257776,-241289,2022-06-01
CASH_IN,295780,Agence_mtn_Cotonou,300000,4220,Théodore De Oliveira-Nicolas,-241289,54491,2022-06-02
CASH_OUT,13382,Théodore De Oliveira-Nicolas,54491,41109,Agence_mtn_Ouidah,300000,286618,2022-06-05
CASH_IN,57042,Agence_mtn_Ouidah,300000,242958,Théodore De Oliveira-Nicolas,41109,98151,2022-06-09
CASH_IN,68407,Agence_mtn_Ouidah,300000,231593,Théodore De Oliveira-Nicolas,98151,166558,2022-06-16
CASH_IN,256209,Agence_mtn_Ouidah,300000,43791,Théodore De Oliveira-Nicolas,166558,422767,2022-06-16
CASH_OUT,61703,Théodore De Oliveira-Nicolas,422767,361064,Agence_mtn_Cotonou,300000,238297,2022-06-18
CASH_OUT,238773,Théodore De Oliveira-Nicolas,361064,122291,Agence_mtn_Ouidah,300000,61227,2022-06-21
CASH_IN,287833,Agence_mtn_Ouidah,300000,12167,Théodore De Oliveira-Nicolas,122291,410124,2022-06-22
CASH_OUT,79735,Théodore De Oliveira-Nicolas,410124,330389,Agence_mtn_Cotonou,300000,220265,2022-06-24
TRANSFER,218751,Valérie Dijoux,444933,226182,Théodore De Oliveira-Nicolas,330389,549140,2022-06-27
CASH_OUT,134635,Théodore De Oliveira-Nicolas,549140,414505,Agence_mtn_Ouidah,300000,165365,2022-06-27
CASH_IN,270863,Agence_mtn_Ouidah,300000,29137,Richard Le Descamps,-146956,123907,2022-06-01
CASH_IN,20316,Agence_mtn_Cotonou,300000,279684,Richard Le Descamps,123907,144223,2022-06-02
CASH_OUT,10320,Richard Le Descamps,144223,133903,Agence_mtn_Abomey,300000,289680,2022-06-08
TRANSFER,60661,Édouard Nguyen,124148,63487,Richard Le Descamps,133903,194564,2022-06-13
TRANSFER,107586,Richard Le Descamps,194564,86978,Édouard Nguyen,63487,-44099,2022-06-13
TRANSFER,125408,Valérie Dijoux,226182,100774,Richard Le Descamps,86978,212386,2022-06-18
CASH_IN,107524,Agence_mtn_Ouidah,300000,192476,Richard Le Descamps,212386,319910,2022-06-18
CASH_OUT,139007,Richard Le Descamps,319910,180903,Agence_mtn_Ouidah,300000,160993,2022-06-20
CASH_OUT,121746,Richard Le Descamps,180903,59157,Agence_mtn_Abomey,300000,178254,2022-06-21
CASH_OUT,31470,Richard Le Descamps,59157,27687,Agence_mtn_Ouidah,300000,268530,2022-06-26
CASH_OUT,3376,Richard Le Descamps,27687,24311,Agence_mtn_Abomey,300000,296624,2022-06-26
CASH_IN,88305,Agence_mtn_Cotonou,300000,211695,Cécile Germain,-240934,-152629,2022-06-01
CASH_IN,58602,Agence_mtn_Ouidah,300000,241398,Cécile Germain,-152629,-94027,2022-06-02
CASH_IN,164539,Agence_mtn_Abomey,300000,135461,Cécile Germain,-94027,70512,2022-06-07
TRANSFER,86918,Émilie Moulin,122333,35415,Cécile Germain,70512,157430,2022-06-12
CASH_IN,237096,Agence_mtn_Abomey,300000,62904,Cécile Germain,157430,394526,2022-06-13
CASH_IN,291810,Agence_mtn_Abomey,300000,8190,Cécile Germain,394526,686336,2022-06-14
CASH_OUT,592680,Cécile Germain,686336,93656,Agence_mtn_Abomey,300000,-292680,2022-06-14
CASH_IN,256077,Agence_mtn_Ouidah,300000,43923,Cécile Germain,93656,349733,2022-06-14
CASH_OUT,325488,Cécile Germain,349733,24245,Agence_mtn_Abomey,300000,-25488,2022-06-16
CASH_OUT,9927,Cécile Germain,24245,14318,Agence_mtn_Abomey,300000,290073,2022-06-23
CASH_IN,39576,Agence_mtn_Abomey,300000,260424,Édouard Nguyen,-44099,-4523,2022-06-01
CASH_IN,232274,Agence_mtn_Abomey,300000,67726,Édouard Nguyen,-4523,227751,2022-06-02
TRANSFER,79867,Édouard Nguyen,227751,147884,Philippine Courtois,391825,311958,2022-06-02
CASH_IN,278086,Agence_mtn_Cotonou,300000,21914,Édouard Nguyen,147884,425970,2022-06-02
CASH_IN,4062,Agence_mtn_Cotonou,300000,295938,Édouard Nguyen,425970,430032,2022-06-03
CASH_IN,95525,Agence_mtn_Abomey,300000,204475,Édouard Nguyen,430032,525557,2022-06-03
CASH_OUT,502972,Édouard Nguyen,525557,22585,Agence_mtn_Cotonou,300000,-202972,2022-06-04
TRANSFER,20201,Édouard Nguyen,22585,2384,Valérie Dijoux,100774,80573,2022-06-06
CASH_OUT,1373,Édouard Nguyen,2384,1011,Agence_mtn_Cotonou,300000,298627,2022-06-10
CASH_OUT,748,Édouard Nguyen,1011,263,Agence_mtn_Abomey,300000,299252,2022-06-12
TRANSFER,57850,Valérie Dijoux,80573,22723,Édouard Nguyen,263,58113,2022-06-12
CASH_OUT,22341,Édouard Nguyen,58113,35772,Agence_mtn_Ouidah,300000,277659,2022-06-12
CASH_IN,188751,Agence_mtn_Cotonou,300000,111249,Édouard Nguyen,35772,224523,2022-06-15
CASH_IN,39966,Agence_mtn_Cotonou,300000,260034,Édouard Nguyen,224523,264489,2022-06-17
TRANSFER,14866,Valérie Dijoux,22723,7857,Édouard Nguyen,264489,279355,2022-06-17
CASH_IN,23319,Agence_mtn_Abomey,300000,276681,Édouard Nguyen,279355,302674,2022-06-19
CASH_OUT,188384,Édouard Nguyen,302674,114290,Agence_mtn_Cotonou,300000,111616,2022-06-24
CASH_OUT,48957,Édouard Nguyen,114290,65333,Agence_mtn_Cotonou,300000,251043,2022-06-27
CASH_IN,294694,Agence_mtn_Ouidah,300000,5306,Frédéric Couturier,-1566509,-1271815,2022-06-04
CASH_IN,165500,Agence_mtn_Abomey,300000,134500,Frédéric Couturier,-1271815,-1106315,2022-06-09
CASH_IN,231733,Agence_mtn_Cotonou,300000,68267,Frédéric Couturier,-1106315,-874582,2022-06-10
CASH_IN,36633,Agence_mtn_Ouidah,300000,263367,Frédéric Couturier,-874582,-837949,2022-06-12
CASH_IN,200984,Agence_mtn_Abomey,300000,99016,Frédéric Couturier,-837949,-636965,2022-06-15
CASH_IN,11248,Agence_mtn_Ouidah,300000,288752,Frédéric Couturier,-636965,-625717,2022-06-17
CASH_IN,260629,Agence_mtn_Cotonou,300000,39371,Frédéric Couturier,-625717,-365088,2022-06-22
CASH_IN,108305,Agence_mtn_Ouidah,300000,191695,Frédéric Couturier,-365088,-256783,2022-06-24
CASH_IN,210595,Agence_mtn_Cotonou,300000,89405,Frédéric Couturier,-256783,-46188,2022-06-27
CASH_IN,62529,Agence_mtn_Ouidah,300000,237471,Margot Renaud,-29827,32702,2022-06-07
TRANSFER,12977,Margot Renaud,32702,19725,Valérie Dijoux,7857,-5120,2022-06-08
TRANSFER,17578,Margot Renaud,19725,2147,Margot Renaud,19725,2147,2022-06-08
CASH_OUT,804,Margot Renaud,2147,1343,Agence_mtn_Cotonou,300000,299196,2022-06-09
TRANSFER,1077,Margot Renaud,1343,266,Simone Pineau,39654,38577,2022-06-12
CASH_OUT,143,Margot Renaud,266,123,Agence_mtn_Abomey,300000,299857,2022-06-13
TRANSFER,63301,Philippine Courtois,311958,248657,Margot Renaud,123,63424,2022-06-16
CASH_OUT,20450,Margot Renaud,63424,42974,Agence_mtn_Abomey,300000,279550,2022-06-16
CASH_IN,81757,Agence_mtn_Ouidah,300000,218243,Margot Renaud,42974,124731,2022-06-17
CASH_OUT,86023,Margot Renaud,124731,38708,Agence_mtn_Ouidah,300000,213977,2022-06-17
CASH_OUT,15009,Margot Renaud,38708,23699,Agence_mtn_Abomey,300000,284991,2022-06-18
CASH_IN,292600,Agence_mtn_Abomey,300000,7400,Margot Renaud,23699,316299,2022-06-21
CASH_OUT,237878,Margot Renaud,316299,78421,Agence_mtn_Ouidah,300000,62122,2022-06-25
CASH_IN,245111,Agence_mtn_Abomey,300000,54889,Margot Renaud,78421,323532,2022-06-27
CASH_IN,238486,Agence_mtn_Ouidah,300000,61514,Hortense Lemaire,-6365,232121,2022-06-03
CASH_OUT,63445,Hortense Lemaire,232121,168676,Agence_mtn_Ouidah,300000,236555,2022-06-03
CASH_OUT,99265,Hortense Lemaire,168676,69411,Agence_mtn_Abomey,300000,200735,2022-06-05
CASH_IN,106558,Agence_mtn_Ouidah,300000,193442,Hortense Lemaire,69411,175969,2022-06-06
TRANSFER,1947,Hortense Lemaire,175969,174022,Simone Pineau,38577,36630,2022-06-06
CASH_IN,43632,Agence_mtn_Abomey,300000,256368,Hortense Lemaire,174022,217654,2022-06-08
CASH_IN,170397,Agence_mtn_Abomey,300000,129603,Hortense Lemaire,217654,388051,2022-06-08
TRANSFER,36605,Simone Pineau,36630,25,Hortense Lemaire,388051,424656,2022-06-11
CASH_IN,59035,Agence_mtn_Abomey,300000,240965,Hortense Lemaire,424656,483691,2022-06-12
CASH_OUT,166705,Hortense Lemaire,483691,316986,Agence_mtn_Cotonou,300000,133295,2022-06-13
CASH_IN,296323,Agence_mtn_Ouidah,300000,3677,Hortense Lemaire,316986,613309,2022-06-17
CASH_OUT,198317,Hortense Lemaire,613309,414992,Agence_mtn_Cotonou,300000,101683,2022-06-19
CASH_IN,269540,Agence_mtn_Abomey,300000,30460,Hortense Lemaire,414992,684532,2022-06-20
TRANSFER,123302,Philippine Courtois,248657,125355,Hortense Lemaire,684532,807834,2022-06-21
CASH_OUT,704660,Hortense Lemaire,807834,103174,Agence_mtn_Ouidah,300000,-404660,2022-06-22
TRANSFER,76602,Philippine Courtois,125355,48753,Hortense Lemaire,103174,179776,2022-06-23
TRANSFER,91255,Hortense Lemaire,179776,88521,Philippine Courtois,48753,-42502,2022-06-24
CASH_OUT,50978,Hortense Lemaire,88521,37543,Agence_mtn_Abomey,300000,249022,2022-06-24
CASH_OUT,28814,Hortense Lemaire,37543,8729,Agence_mtn_Abomey,300000,271186,2022-06-27
CASH_IN,62965,Agence_mtn_Ouidah,300000,237035,Geneviève Grondin,-30922,32043,2022-06-01
CASH_IN,161802,Agence_mtn_Abomey,300000,138198,Geneviève Grondin,32043,193845,2022-06-01
CASH_IN,252637,Agence_mtn_Abomey,300000,47363,Geneviève Grondin,193845,446482,2022-06-08
CASH_OUT,11683,Geneviève Grondin,446482,434799,Agence_mtn_Abomey,300000,288317,2022-06-12
CASH_IN,35518,Agence_mtn_Abomey,300000,264482,Geneviève Grondin,434799,470317,2022-06-15
TRANSFER,363102,Geneviève Grondin,470317,107215,Geneviève Grondin,470317,833419,2022-06-17
CASH_IN,55736,Agence_mtn_Cotonou,300000,244264,Geneviève Grondin,107215,162951,2022-06-20
CASH_OUT,147674,Geneviève Grondin,162951,15277,Agence_mtn_Ouidah,300000,152326,2022-06-23
TRANSFER,8408,Geneviève Grondin,15277,6869,Émilie Moulin,35415,27007,2022-06-23
CASH_IN,241205,Agence_mtn_Abomey,300000,58795,Alphonse Leclercq-Rousseau,-146631,94574,2022-06-01
CASH_OUT,48452,Alphonse Leclercq-Rousseau,94574,46122,Agence_mtn_Cotonou,300000,251548,2022-06-02
CASH_OUT,16353,Alphonse Leclercq-Rousseau,46122,29769,Agence_mtn_Cotonou,300000,283647,2022-06-03
TRANSFER,15813,Alphonse Leclercq-Rousseau,29769,13956,Alphonse Leclercq-Rousseau,29769,45582,2022-06-05
TRANSFER,10606,Alphonse Leclercq-Rousseau,13956,3350,Alphonse Leclercq-Rousseau,13956,24562,2022-06-06
CASH_OUT,2497,Alphonse Leclercq-Rousseau,3350,853,Agence_mtn_Cotonou,300000,297503,2022-06-06
TRANSFER,781,Alphonse Leclercq-Rousseau,853,72,Alphonse Leclercq-Rousseau,853,1634,2022-06-08
CASH_IN,260476,Agence_mtn_Cotonou,300000,39524,Alphonse Leclercq-Rousseau,72,260548,2022-06-10
CASH_IN,239161,Agence_mtn_Cotonou,300000,60839,Alphonse Leclercq-Rousseau,260548,499709,2022-06-11
CASH_OUT,173563,Alphonse Leclercq-Rousseau,499709,326146,Agence_mtn_Abomey,300000,126437,2022-06-14
CASH_IN,56814,Agence_mtn_Cotonou,300000,243186,Alphonse Leclercq-Rousseau,326146,382960,2022-06-15
CASH_OUT,360506,Alphonse Leclercq-Rousseau,382960,22454,Agence_mtn_Ouidah,300000,-60506,2022-06-15
CASH_OUT,6851,Alphonse Leclercq-Rousseau,22454,15603,Agence_mtn_Ouidah,300000,293149,2022-06-18
CASH_IN,172723,Agence_mtn_Abomey,300000,127277,Alphonse Leclercq-Rousseau,15603,188326,2022-06-18
CASH_OUT,80001,Alphonse Leclercq-Rousseau,188326,108325,Agence_mtn_Ouidah,300000,219999,2022-06-23
CASH_IN,83584,Agence_mtn_Ouidah,300000,216416,Alphonse Leclercq-Rousseau,108325,191909,2022-06-23
CASH_IN,181356,Agence_mtn_Cotonou,300000,118644,Alphonse Leclercq-Rousseau,191909,373265,2022-06-25
CASH_IN,198495,Agence_mtn_Ouidah,300000,101505,Sébastien Lemaître,88,198583,2022-06-02
CASH_IN,296202,Agence_mtn_Cotonou,300000,3798,Sébastien Lemaître,198583,494785,2022-06-04
TRANSFER,173189,Sébastien Lemaître,494785,321596,Sébastien Lemaître,494785,667974,2022-06-06
TRANSFER,300703,Sébastien Lemaître,321596,20893,Sébastien Lemaître,321596,20893,2022-06-09
CASH_OUT,6053,Sébastien Lemaître,20893,14840,Agence_mtn_Cotonou,300000,293947,2022-06-09
CASH_OUT,2685,Sébastien Lemaître,14840,12155,Agence_mtn_Abomey,300000,297315,2022-06-11
CASH_IN,120768,Agence_mtn_Abomey,300000,179232,Sébastien Lemaître,12155,132923,2022-06-11
CASH_OUT,111373,Sébastien Lemaître,132923,21550,Agence_mtn_Cotonou,300000,188627,2022-06-19
CASH_OUT,3127,Sébastien Lemaître,21550,18423,Agence_mtn_Ouidah,300000,296873,2022-06-22
CASH_IN,155236,Agence_mtn_Abomey,300000,144764,Sébastien Lemaître,18423,173659,2022-06-23
CASH_IN,296315,Agence_mtn_Cotonou,300000,3685,Claude Foucher,-1091821,-795506,2022-06-02
CASH_IN,158283,Agence_mtn_Cotonou,300000,141717,Claude Foucher,-795506,-637223,2022-06-06
CASH_IN,61482,Agence_mtn_Cotonou,300000,238518,Claude Foucher,-637223,-575741,2022-06-12
CASH_IN,6530,Agence_mtn_Cotonou,300000,293470,Claude Foucher,-575741,-569211,2022-06-12
CASH_IN,48112,Agence_mtn_Ouidah,300000,251888,Claude Foucher,-569211,-521099,2022-06-15
CASH_IN,266299,Agence_mtn_Abomey,300000,33701,Claude Foucher,-521099,-254800,2022-06-25
CASH_IN,297879,Agence_mtn_Abomey,300000,2121,Claude Foucher,-254800,43079,2022-06-27
CASH_IN,104719,Agence_mtn_Abomey,300000,195281,Corinne-Louise Valentin,-721905,-617186,2022-06-02
CASH_IN,230737,Agence_mtn_Abomey,300000,69263,Corinne-Louise Valentin,-617186,-386449,2022-06-03
CASH_IN,90799,Agence_mtn_Ouidah,300000,209201,Corinne-Louise Valentin,-386449,-295650,2022-06-04
CASH_IN,55410,Agence_mtn_Cotonou,300000,244590,Corinne-Louise Valentin,-295650,-240240,2022-06-05
CASH_IN,241767,Agence_mtn_Abomey,300000,58233,Corinne-Louise Valentin,-240240,1527,2022-06-07
CASH_IN,292401,Agence_mtn_Abomey,300000,7599,Corinne-Louise Valentin,1527,293928,2022-06-07
CASH_OUT,247736,Corinne-Louise Valentin,293928,46192,Agence_mtn_Abomey,300000,52264,2022-06-10
CASH_OUT,26570,Corinne-Louise Valentin,46192,19622,Agence_mtn_Abomey,300000,273430,2022-06-10
CASH_IN,81823,Agence_mtn_Cotonou,300000,218177,Corinne-Louise Valentin,19622,101445,2022-06-12
CASH_OUT,85260,Corinne-Louise Valentin,101445,16185,Agence_mtn_Abomey,300000,214740,2022-06-12
CASH_IN,234733,Agence_mtn_Ouidah,300000,65267,Corinne-Louise Valentin,16185,250918,2022-06-13
CASH_IN,76952,Agence_mtn_Abomey,300000,223048,Corinne-Louise Valentin,250918,327870,2022-06-17
CASH_OUT,305467,Corinne-Louise Valentin,327870,22403,Agence_mtn_Cotonou,300000,-5467,2022-06-27
CASH_IN,75177,Agence_mtn_Ouidah,300000,224823,Simone Pineau,25,75202,2022-06-02
TRANSFER,35150,Simone Pineau,75202,40052,Simone Pineau,75202,40052,2022-06-10
CASH_OUT,27481,Simone Pineau,40052,12571,Agence_mtn_Cotonou,300000,272519,2022-06-17
CASH_OUT,7781,Simone Pineau,12571,4790,Agence_mtn_Cotonou,300000,292219,2022-06-17
CASH_IN,243165,Agence_mtn_Ouidah,300000,56835,Simone Pineau,4790,247955,2022-06-20
CASH_IN,184323,Agence_mtn_Cotonou,300000,115677,Simone Pineau,247955,432278,2022-06-21
CASH_IN,26653,Agence_mtn_Cotonou,300000,273347,Simone Pineau,432278,458931,2022-06-27
CASH_IN,173679,Agence_mtn_Abomey,300000,126321,Alfred du Lesage,-553694,-380015,2022-06-02
CASH_IN,177049,Agence_mtn_Cotonou,300000,122951,Alfred du Lesage,-380015,-202966,2022-06-03
CASH_IN,247859,Agence_mtn_Ouidah,300000,52141,Alfred du Lesage,-202966,44893,2022-06-04
CASH_OUT,9125,Alfred du Lesage,44893,35768,Agence_mtn_Ouidah,300000,290875,2022-06-05
CASH_OUT,20348,Alfred du Lesage,35768,15420,Agence_mtn_Ouidah,300000,279652,2022-06-05
TRANSFER,11489,Alfred du Lesage,15420,3931,Alfred du Lesage,15420,3931,2022-06-06
CASH_OUT,3249,Alfred du Lesage,3931,682,Agence_mtn_Cotonou,300000,296751,2022-06-07
CASH_OUT,115,Alfred du Lesage,682,567,Agence_mtn_Abomey,300000,299885,2022-06-08
TRANSFER,242,Alfred du Lesage,567,325,Alfred du Lesage,567,325,2022-06-09
CASH_IN,116240,Agence_mtn_Abomey,300000,183760,Alfred du Lesage,325,116565,2022-06-12
TRANSFER,89364,Alfred du Lesage,116565,27201,Alfred du Lesage,116565,27201,2022-06-14
CASH_IN,157802,Agence_mtn_Abomey,300000,142198,Alfred du Lesage,27201,185003,2022-06-18
CASH_IN,182287,Agence_mtn_Ouidah,300000,117713,Vincent Fournier,-102094,80193,2022-06-05
CASH_IN,95116,Agence_mtn_Cotonou,300000,204884,Vincent Fournier,80193,175309,2022-06-06
TRANSFER,127355,Vincent Fournier,175309,47954,Vincent Fournier,175309,47954,2022-06-09
CASH_OUT,36366,Vincent Fournier,47954,11588,Agence_mtn_Ouidah,300000,263634,2022-06-11
CASH_OUT,3976,Vincent Fournier,11588,7612,Agence_mtn_Cotonou,300000,296024,2022-06-19
CASH_IN,209806,Agence_mtn_Abomey,300000,90194,Nath Bruneau,-17454,192352,2022-06-01
CASH_OUT,49019,Nath Bruneau,192352,143333,Agence_mtn_Ouidah,300000,250981,2022-06-08
TRANSFER,80942,Nath Bruneau,143333,62391,Nath Bruneau,143333,62391,2022-06-12
CASH_OUT,50490,Nath Bruneau,62391,11901,Agence_mtn_Cotonou,300000,249510,2022-06-17
TRANSFER,7606,Nath Bruneau,11901,4295,Nath Bruneau,11901,19507,2022-06-18
TRANSFER,4286,Nath Bruneau,4295,9,Nath Bruneau,4295,8581,2022-06-20
CASH_IN,124450,Agence_mtn_Ouidah,300000,175550,Nath Bruneau,9,124459,2022-06-20
CASH_IN,69646,Agence_mtn_Cotonou,300000,230354,Nath Bruneau,124459,194105,2022-06-20
CASH_OUT,146459,Nath Bruneau,194105,47646,Agence_mtn_Ouidah,300000,153541,2022-06-22
CASH_IN,146564,Agence_mtn_Abomey,300000,153436,Nath Bruneau,47646,194210,2022-06-22
CASH_IN,53139,Agence_mtn_Ouidah,300000,246861,Nath Bruneau,194210,247349,2022-06-24
CASH_IN,245513,Agence_mtn_Cotonou,300000,54487,Nath Bruneau,247349,492862,2022-06-25
CASH_IN,240349,Agence_mtn_Ouidah,300000,59651,Nath Bruneau,492862,733211,2022-06-26
CASH_IN,3183,Agence_mtn_Abomey,300000,296817,Philippine Courtois,-42502,-39319,2022-06-03
CASH_IN,91981,Agence_mtn_Abomey,300000,208019,Philippine Courtois,-39319,52662,2022-06-03
CASH_IN,108183,Agence_mtn_Ouidah,300000,191817,Philippine Courtois,52662,160845,2022-06-11
CASH_OUT,57028,Philippine Courtois,160845,103817,Agence_mtn_Ouidah,300000,242972,2022-06-11
TRANSFER,27666,Philippine Courtois,103817,76151,Philippine Courtois,103817,76151,2022-06-12
CASH_IN,7051,Agence_mtn_Cotonou,300000,292949,Philippine Courtois,76151,83202,2022-06-13
CASH_OUT,32667,Philippine Courtois,83202,50535,Agence_mtn_Ouidah,300000,267333,2022-06-16
CASH_IN,228142,Agence_mtn_Abomey,300000,71858,Philippine Courtois,50535,278677,2022-06-16
CASH_IN,139634,Agence_mtn_Cotonou,300000,160366,Philippine Courtois,278677,418311,2022-06-16
CASH_IN,95061,Agence_mtn_Abomey,300000,204939,Philippine Courtois,418311,513372,2022-06-17
CASH_IN,209625,Agence_mtn_Abomey,300000,90375,Philippine Courtois,513372,722997,2022-06-23
CASH_OUT,493897,Philippine Courtois,722997,229100,Agence_mtn_Abomey,300000,-193897,2022-06-27
CASH_IN,299021,Agence_mtn_Abomey,300000,979,Alexandre Rémy,-403128,-104107,2022-06-01
CASH_IN,224080,Agence_mtn_Cotonou,300000,75920,Alexandre Rémy,-104107,119973,2022-06-03
CASH_IN,243425,Agence_mtn_Cotonou,300000,56575,Alexandre Rémy,119973,363398,2022-06-04
CASH_IN,264810,Agence_mtn_Ouidah,300000,35190,Alexandre Rémy,363398,628208,2022-06-04
CASH_IN,153762,Agence_mtn_Abomey,300000,146238,Alexandre Rémy,628208,781970,2022-06-07
CASH_OUT,128976,Alexandre Rémy,781970,652994,Agence_mtn_Ouidah,300000,171024,2022-06-09
CASH_OUT,163852,Alexandre Rémy,652994,489142,Agence_mtn_Cotonou,300000,136148,2022-06-10
CASH_IN,98909,Agence_mtn_Cotonou,300000,201091,Alexandre Rémy,489142,588051,2022-06-11
CASH_IN,280701,Agence_mtn_Ouidah,300000,19299,Alexandre Rémy,588051,868752,2022-06-14
CASH_IN,139865,Agence_mtn_Ouidah,300000,160135,Alexandre Rémy,868752,1008617,2022-06-15
TRANSFER,872176,Alexandre Rémy,1008617,136441,Alexandre Rémy,1008617,1880793,2022-06-15
CASH_OUT,33281,Alexandre Rémy,136441,103160,Agence_mtn_Abomey,300000,266719,2022-06-15
TRANSFER,50236,Alexandre Rémy,103160,52924,Alexandre Rémy,103160,153396,2022-06-16
CASH_IN,26643,Agence_mtn_Cotonou,300000,273357,Alexandre Rémy,52924,79567,2022-06-22
CASH_OUT,59905,Alexandre Rémy,79567,19662,Agence_mtn_Abomey,300000,240095,2022-06-23
CASH_IN,171323,Agence_mtn_Ouidah,300000,128677,Alexandre Rémy,19662,190985,2022-06-26
CASH_OUT,53439,Alexandre Rémy,190985,137546,Agence_mtn_Abomey,300000,246561,2022-06-26
CASH_OUT,38692,Alexandre Rémy,137546,98854,Agence_mtn_Cotonou,300000,261308,2022-06-26
CASH_OUT,52145,Alexandre Rémy,98854,46709,Agence_mtn_Abomey,300000,247855,2022-06-26
CASH_IN,276714,Agence_mtn_Cotonou,300000,23286,Gabriel-Tristan Marty,-149131,127583,2022-06-01
CASH_OUT,16113,Gabriel-Tristan Marty,127583,111470,Agence_mtn_Abomey,300000,283887,2022-06-08
TRANSFER,108060,Gabriel-Tristan Marty,111470,3410,Gabriel-Tristan Marty,111470,219530,2022-06-09
CASH_IN,119877,Agence_mtn_Ouidah,300000,180123,Gabriel-Tristan Marty,3410,123287,2022-06-11
TRANSFER,123212,Gabriel-Tristan Marty,123287,75,Gabriel-Tristan Marty,123287,246499,2022-06-12
CASH_IN,250810,Agence_mtn_Abomey,300000,49190,Gabriel-Tristan Marty,75,250885,2022-06-12
CASH_IN,63219,Agence_mtn_Ouidah,300000,236781,Gabriel-Tristan Marty,250885,314104,2022-06-15
CASH_OUT,570,Gabriel-Tristan Marty,314104,313534,Agence_mtn_Cotonou,300000,299430,2022-06-15
CASH_OUT,38658,Gabriel-Tristan Marty,313534,274876,Agence_mtn_Ouidah,300000,261342,2022-06-15
CASH_IN,269568,Agence_mtn_Cotonou,300000,30432,Gabriel-Tristan Marty,274876,544444,2022-06-18
CASH_IN,180439,Agence_mtn_Ouidah,300000,119561,Gabriel-Tristan Marty,544444,724883,2022-06-20
CASH_OUT,634304,Gabriel-Tristan Marty,724883,90579,Agence_mtn_Cotonou,300000,-334304,2022-06-21
CASH_OUT,78597,Gabriel-Tristan Marty,90579,11982,Agence_mtn_Cotonou,300000,221403,2022-06-25
CASH_IN,276177,Agence_mtn_Abomey,300000,23823,Isabelle Rossi,-187596,88581,2022-06-02
CASH_OUT,28613,Isabelle Rossi,88581,59968,Agence_mtn_Cotonou,300000,271387,2022-06-05
CASH_OUT,42103,Isabelle Rossi,59968,17865,Agence_mtn_Ouidah,300000,257897,2022-06-07
CASH_OUT,10523,Isabelle Rossi,17865,7342,Agence_mtn_Ouidah,300000,289477,2022-06-09
CASH_IN,51566,Agence_mtn_Cotonou,300000,248434,Isabelle Rossi,7342,58908,2022-06-11
CASH_OUT,44531,Isabelle Rossi,58908,14377,Agence_mtn_Cotonou,300000,255469,2022-06-11
CASH_OUT,5156,Isabelle Rossi,14377,9221,Agence_mtn_Abomey,300000,294844,2022-06-12
TRANSFER,2174,Isabelle Rossi,9221,7047,Isabelle Rossi,9221,11395,2022-06-14
CASH_OUT,5444,Isabelle Rossi,7047,1603,Agence_mtn_Abomey,300000,294556,2022-06-15
CASH_OUT,1379,Isabelle Rossi,1603,224,Agence_mtn_Abomey,300000,298621,2022-06-16
TRANSFER,130,Isabelle Rossi,224,94,Isabelle Rossi,224,354,2022-06-18
CASH_IN,286555,Agence_mtn_Ouidah,300000,13445,Isabelle Rossi,94,286649,2022-06-18
CASH_OUT,170664,Isabelle Rossi,286649,115985,Agence_mtn_Abomey,300000,129336,2022-06-19
CASH_IN,75412,Agence_mtn_Cotonou,300000,224588,Isabelle Rossi,115985,191397,2022-06-19
CASH_IN,54399,Agence_mtn_Abomey,300000,245601,Isabelle Rossi,191397,245796,2022-06-20
CASH_IN,34609,Agence_mtn_Abomey,300000,265391,Isabelle Rossi,245796,280405,2022-06-21
CASH_IN,65690,Agence_mtn_Abomey,300000,234310,Isabelle Rossi,280405,346095,2022-06-22
CASH_OUT,232476,Isabelle Rossi,346095,113619,Agence_mtn_Ouidah,300000,67524,2022-06-22
CASH_OUT,29217,Isabelle Rossi,113619,84402,Agence_mtn_Ouidah,300000,270783,2022-06-25
CASH_IN,140503,Agence_mtn_Abomey,300000,159497,Adèle Labbé,-33044,107459,2022-06-02
TRANSFER,105362,Adèle Labbé,107459,2097,Adèle Labbé,107459,2097,2022-06-13
CASH_IN,31173,Agence_mtn_Abomey,300000,268827,Adèle Labbé,2097,33270,2022-06-13
CASH_IN,269489,Agence_mtn_Cotonou,300000,30511,Adèle Labbé,33270,302759,2022-06-13
CASH_IN,146234,Agence_mtn_Cotonou,300000,153766,Adèle Labbé,302759,448993,2022-06-18
CASH_OUT,235424,Adèle Labbé,448993,213569,Agence_mtn_Ouidah,300000,64576,2022-06-24
CASH_OUT,23108,Adèle Labbé,213569,190461,Agence_mtn_Cotonou,300000,276892,2022-06-26
CASH_IN,210228,Agence_mtn_Cotonou,300000,89772,Astrid Gay de la Brunet,-100006,110222,2022-06-06
CASH_IN,51932,Agence_mtn_Cotonou,300000,248068,Astrid Gay de la Brunet,110222,162154,2022-06-07
CASH_OUT,140783,Astrid Gay de la Brunet,162154,21371,Agence_mtn_Cotonou,300000,159217,2022-06-10
CASH_IN,233870,Agence_mtn_Cotonou,300000,66130,Astrid Gay de la Brunet,21371,255241,2022-06-15
CASH_IN,88955,Agence_mtn_Ouidah,300000,211045,Astrid Gay de la Brunet,255241,344196,2022-06-19
CASH_OUT,4967,Astrid Gay de la Brunet,344196,339229,Agence_mtn_Abomey,300000,295033,2022-06-19
CASH_IN,31021,Agence_mtn_Ouidah,300000,268979,Astrid Gay de la Brunet,339229,370250,2022-06-20
CASH_IN,97986,Agence_mtn_Abomey,300000,202014,Astrid Gay de la Brunet,370250,468236,2022-06-24
CASH_OUT,48480,Astrid Gay de la Brunet,468236,419756,Agence_mtn_Cotonou,300000,251520,2022-06-26
CASH_IN,141595,Agence_mtn_Ouidah,300000,158405,Astrid Gay de la Brunet,419756,561351,2022-06-26
CASH_IN,248639,Agence_mtn_Abomey,300000,51361,Valérie Dijoux,-5120,243519,2022-06-02
CASH_OUT,213386,Valérie Dijoux,243519,30133,Agence_mtn_Ouidah,300000,86614,2022-06-05
CASH_IN,36120,Agence_mtn_Abomey,300000,263880,Valérie Dijoux,30133,66253,2022-06-05
TRANSFER,41406,Valérie Dijoux,66253,24847,Valérie Dijoux,66253,107659,2022-06-07
CASH_OUT,11813,Valérie Dijoux,24847,13034,Agence_mtn_Ouidah,300000,288187,2022-06-08
CASH_OUT,2775,Valérie Dijoux,13034,10259,Agence_mtn_Abomey,300000,297225,2022-06-08
TRANSFER,6499,Valérie Dijoux,10259,3760,Valérie Dijoux,10259,3760,2022-06-08
CASH_IN,23848,Agence_mtn_Cotonou,300000,276152,Valérie Dijoux,3760,27608,2022-06-08
CASH_OUT,9395,Valérie Dijoux,27608,18213,Agence_mtn_Cotonou,300000,290605,2022-06-14
CASH_IN,185691,Agence_mtn_Cotonou,300000,114309,Valérie Dijoux,18213,203904,2022-06-17
CASH_OUT,66139,Valérie Dijoux,203904,137765,Agence_mtn_Abomey,300000,233861,2022-06-18
CASH_OUT,100744,Valérie Dijoux,137765,37021,Agence_mtn_Abomey,300000,199256,2022-06-21
CASH_OUT,17060,Valérie Dijoux,37021,19961,Agence_mtn_Cotonou,300000,282940,2022-06-23
CASH_OUT,11133,Valérie Dijoux,19961,8828,Agence_mtn_Cotonou,300000,288867,2022-06-24
CASH_IN,165104,Agence_mtn_Ouidah,300000,134896,Vincent Mathieu,-18879,146225,2022-06-01
CASH_OUT,46771,Vincent Mathieu,146225,99454,Agence_mtn_Abomey,300000,253229,2022-06-01
CASH_IN,239362,Agence_mtn_Cotonou,300000,60638,Vincent Mathieu,99454,338816,2022-06-06
CASH_OUT,286684,Vincent Mathieu,338816,52132,Agence_mtn_Cotonou,300000,13316,2022-06-06
TRANSFER,44434,Vincent Mathieu,52132,7698,Vincent Mathieu,52132,96566,2022-06-07
CASH_OUT,407,Vincent Mathieu,7698,7291,Agence_mtn_Ouidah,300000,299593,2022-06-20
CASH_OUT,2416,Vincent Mathieu,7291,4875,Agence_mtn_Cotonou,300000,297584,2022-06-26
CASH_IN,255375,Agence_mtn_Cotonou,300000,44625,Vincent Mathieu,4875,260250,2022-06-26
CASH_OUT,15423,Vincent Mathieu,260250,244827,Agence_mtn_Abomey,300000,284577,2022-06-26
CASH_OUT,208309,Vincent Mathieu,244827,36518,Agence_mtn_Ouidah,300000,91691,2022-06-27
CASH_IN,85654,Agence_mtn_Cotonou,300000,214346,Thérèse-Margaux Bruneau,-112223,-26569,2022-06-01
CASH_IN,289028,Agence_mtn_Abomey,300000,10972,Thérèse-Margaux Bruneau,-26569,262459,2022-06-01
TRANSFER,82845,Thérèse-Margaux Bruneau,262459,179614,Thérèse-Margaux Bruneau,262459,179614,2022-06-01
CASH_OUT,72759,Thérèse-Margaux Bruneau,179614,106855,Agence_mtn_Cotonou,300000,227241,2022-06-02
CASH_OUT,100837,Thérèse-Margaux Bruneau,106855,6018,Agence_mtn_Abomey,300000,199163,2022-06-04
CASH_IN,71960,Agence_mtn_Ouidah,300000,228040,Thérèse-Margaux Bruneau,6018,77978,2022-06-05
CASH_OUT,34414,Thérèse-Margaux Bruneau,77978,43564,Agence_mtn_Ouidah,300000,265586,2022-06-05
CASH_OUT,14238,Thérèse-Margaux Bruneau,43564,29326,Agence_mtn_Cotonou,300000,285762,2022-06-05
CASH_OUT,19095,Thérèse-Margaux Bruneau,29326,10231,Agence_mtn_Abomey,300000,280905,2022-06-08
CASH_OUT,9920,Thérèse-Margaux Bruneau,10231,311,Agence_mtn_Cotonou,300000,290080,2022-06-08
TRANSFER,245,Thérèse-Margaux Bruneau,311,66,Thérèse-Margaux Bruneau,311,556,2022-06-09
CASH_IN,229592,Agence_mtn_Abomey,300000,70408,Thérèse-Margaux Bruneau,66,229658,2022-06-12
CASH_OUT,149890,Thérèse-Margaux Bruneau,229658,79768,Agence_mtn_Cotonou,300000,150110,2022-06-13
CASH_OUT,63547,Thérèse-Margaux Bruneau,79768,16221,Agence_mtn_Ouidah,300000,236453,2022-06-18
CASH_OUT,15170,Thérèse-Margaux Bruneau,16221,1051,Agence_mtn_Ouidah,300000,284830,2022-06-21
CASH_IN,241550,Agence_mtn_Ouidah,300000,58450,Thérèse-Margaux Bruneau,1051,242601,2022-06-21
CASH_OUT,5930,Franck-Charles Texier,549600,543670,Agence_mtn_Ouidah,300000,294070,2022-07-09
CASH_OUT,340001,Franck-Charles Texier,543670,203669,Agence_mtn_Cotonou,300000,-40001,2022-07-11
CASH_IN,113969,Agence_mtn_Cotonou,300000,186031,Franck-Charles Texier,203669,317638,2022-07-16
TRANSFER,181529,Franck-Charles Texier,317638,136109,Vincent Fournier,1804400,1622871,2022-07-17
CASH_OUT,67089,Franck-Charles Texier,136109,69020,Agence_mtn_Abomey,300000,232911,2022-07-27
TRANSFER,1091560,Gabriel Humbert,1640200,548640,Émilie Moulin,765300,-326260,2022-07-24
TRANSFER,247613,Gabriel Humbert,548640,301027,Philippine Courtois,1222500,974887,2022-07-24
TRANSFER,903626,Michelle Lebon,1067200,163574,Marcelle Charrier,1845900,2749526,2022-07-01
CASH_IN,251764,Agence_mtn_Cotonou,300000,48236,Marcelle Charrier,2749526,3001290,2022-07-02
CASH_IN,137159,Agence_mtn_Abomey,300000,162841,Marcelle Charrier,3001290,3138449,2022-07-02
CASH_IN,263299,Agence_mtn_Abomey,300000,36701,Marcelle Charrier,3138449,3401748,2022-07-08
CASH_IN,84395,Agence_mtn_Ouidah,300000,215605,Marcelle Charrier,3401748,3486143,2022-07-08
TRANSFER,214494,David Guérin,1104200,889706,Louis Pichon,766000,551506,2022-07-08
CASH_IN,129923,Agence_mtn_Cotonou,300000,170077,Émilie Moulin,-326260,-196337,2022-07-01
CASH_IN,186496,Agence_mtn_Cotonou,300000,113504,Émilie Moulin,-196337,-9841,2022-07-13
CASH_IN,149378,Agence_mtn_Ouidah,300000,150622,Émilie Moulin,-9841,139537,2022-07-17
CASH_OUT,118042,Émilie Moulin,139537,21495,Agence_mtn_Cotonou,300000,181958,2022-07-20
CASH_IN,136947,Agence_mtn_Cotonou,300000,163053,Émilie Moulin,21495,158442,2022-07-27
TRANSFER,26069,Cécile Clerc,83300,57231,Louis Pichon,551506,525437,2022-07-01
CASH_IN,70865,Agence_mtn_Ouidah,300000,229135,Cécile Clerc,57231,128096,2022-07-08
CASH_IN,222685,Agence_mtn_Abomey,300000,77315,Cécile Clerc,128096,350781,2022-07-12
CASH_OUT,82315,Cécile Clerc,350781,268466,Agence_mtn_Abomey,300000,217685,2022-07-12
CASH_IN,219326,Agence_mtn_Ouidah,300000,80674,Cécile Clerc,268466,487792,2022-07-19
TRANSFER,488492,Cécile Delattre-Arnaud,1828000,1339508,Raymond Marchal de Nguyen,1425000,936508,2022-07-11
TRANSFER,174535,Cécile Delattre-Arnaud,1339508,1164973,Pénélope Ollivier,1768800,1594265,2022-07-13
TRANSFER,419265,Sophie Lévêque,731100,311835,Cécile Delattre-Arnaud,1164973,1584238,2022-07-15
CASH_IN,251540,Agence_mtn_Ouidah,300000,48460,Cécile Delattre-Arnaud,1584238,1835778,2022-07-21
CASH_OUT,1782696,Cécile Delattre-Arnaud,1835778,53082,Agence_mtn_Ouidah,300000,-1482696,2022-07-24
CASH_OUT,210677,Sébastien Vallée,1203500,992823,Agence_mtn_Cotonou,300000,89323,2022-07-13
CASH_IN,17236,Agence_mtn_Ouidah,300000,282764,Sébastien Vallée,992823,1010059,2022-07-14
CASH_OUT,679472,Sébastien Vallée,1010059,330587,Agence_mtn_Abomey,300000,-379472,2022-07-19
CASH_OUT,318146,Sébastien Vallée,330587,12441,Agence_mtn_Abomey,300000,-18146,2022-07-24
TRANSFER,744831,William Le Lucas,1823800,1078969,Benjamin Evrard-Marty,1817400,1072569,2022-07-17
CASH_OUT,218298,Sophie Lévêque,311835,93537,Agence_mtn_Cotonou,300000,81702,2022-07-06
CASH_OUT,35336,Sophie Lévêque,93537,58201,Agence_mtn_Abomey,300000,264664,2022-07-11
CASH_IN,265107,Agence_mtn_Abomey,300000,34893,Sophie Lévêque,58201,323308,2022-07-20
TRANSFER,23373,Sophie Lévêque,323308,299935,Isabelle Rossi,1575000,1551627,2022-07-25
CASH_OUT,231180,Margot Riou du Fernandes,933800,702620,Agence_mtn_Abomey,300000,68820,2022-07-01
CASH_IN,59493,Agence_mtn_Cotonou,300000,240507,Margot Riou du Fernandes,702620,762113,2022-07-11
TRANSFER,1115652,Frédéric Couturier,1705900,590248,Margot Riou du Fernandes,762113,1877765,2022-07-22
CASH_IN,49271,Agence_mtn_Ouidah,300000,250729,Virginie Le Gall,701300,750571,2022-07-06
CASH_OUT,324413,Virginie Le Gall,750571,426158,Agence_mtn_Cotonou,300000,-24413,2022-07-16
CASH_IN,262686,Agence_mtn_Cotonou,300000,37314,Virginie Le Gall,426158,688844,2022-07-16
CASH_OUT,475743,Virginie Le Gall,688844,213101,Agence_mtn_Ouidah,300000,-175743,2022-07-25
TRANSFER,151386,Alphonse Leclercq-Rousseau,379300,227914,Virginie Le Gall,213101,364487,2022-07-26
TRANSFER,100374,Marcelle Paris,661900,561526,Simone Pineau,1927200,1826826,2022-07-16
CASH_OUT,372548,Marcelle Paris,561526,188978,Agence_mtn_Abomey,300000,-72548,2022-07-18
CASH_IN,218267,Agence_mtn_Abomey,300000,81733,Marcelle Paris,188978,407245,2022-07-26
CASH_IN,40813,Agence_mtn_Cotonou,300000,259187,Marcelle Paris,407245,448058,2022-07-27
TRANSFER,225603,Rémy Le Michaud,1771300,1545697,Nathalie Peron,804800,1030403,2022-07-05
TRANSFER,805987,Nathalie Peron,1030403,224416,Pénélope Ollivier,1594265,788278,2022-07-07
CASH_OUT,181218,Nathalie Peron,224416,43198,Agence_mtn_Cotonou,300000,118782,2022-07-15
CASH_OUT,9344,Nathalie Peron,43198,33854,Agence_mtn_Cotonou,300000,290656,2022-07-19
CASH_OUT,746966,Bertrand Le Roux,777800,30834,Agence_mtn_Abomey,300000,-446966,2022-07-19
TRANSFER,5098,Bertrand Le Roux,30834,25736,Alix Maillet,287700,282602,2022-07-21
CASH_OUT,867491,Jean Benard,1504400,636909,Agence_mtn_Cotonou,300000,-567491,2022-07-01
TRANSFER,417265,Jean Benard,636909,219644,Marine Chauvet-Potier,84500,-332765,2022-07-14
CASH_IN,67607,Agence_mtn_Abomey,300000,232393,Jean Benard,219644,287251,2022-07-15
TRANSFER,37982,Gabriel-Tristan Marty,130000,92018,Jean Benard,287251,325233,2022-07-20
CASH_IN,159718,Agence_mtn_Abomey,300000,140282,Alphonse Leclercq-Rousseau,227914,387632,2022-07-02
CASH_OUT,7900,Alphonse Leclercq-Rousseau,387632,379732,Agence_mtn_Abomey,300000,292100,2022-07-04
CASH_IN,287628,Agence_mtn_Ouidah,300000,12372,Alphonse Leclercq-Rousseau,379732,667360,2022-07-06
CASH_OUT,132494,Aurore Guyon,397400,264906,Agence_mtn_Cotonou,300000,167506,2022-07-02
CASH_IN,273168,Agence_mtn_Abomey,300000,26832,Aurore Guyon,264906,538074,2022-07-15
TRANSFER,1007909,Margot Renaud,1090900,82991,Aurore Guyon,538074,1545983,2022-07-16
CASH_IN,46050,Agence_mtn_Ouidah,300000,253950,Aurore Guyon,1545983,1592033,2022-07-17
CASH_IN,132055,Agence_mtn_Abomey,300000,167945,Aurore Guyon,1592033,1724088,2022-07-21
CASH_OUT,481032,Thérèse-Margaux Bruneau,795500,314468,Agence_mtn_Abomey,300000,-181032,2022-07-14
CASH_OUT,10080,Thibault Moreno,1357700,1347620,Agence_mtn_Abomey,300000,289920,2022-07-03
CASH_OUT,318588,Thibault Moreno,1347620,1029032,Agence_mtn_Cotonou,300000,-18588,2022-07-10
CASH_OUT,532441,Thibault Moreno,1029032,496591,Agence_mtn_Cotonou,300000,-232441,2022-07-16
TRANSFER,45833,Laurent-Bertrand Lefort,145700,99867,David du Blondel,681100,726933,2022-07-11
TRANSFER,630699,Rémy de la Roux,1296500,665801,David du Blondel,726933,1357632,2022-07-13
TRANSFER,457638,Jeanne Garnier,711300,253662,David du Blondel,1357632,1815270,2022-07-15
TRANSFER,107864,Pierre Reynaud,1472700,1364836,Adrien Chartier,1588100,1695964,2022-07-01
CASH_OUT,245330,Adrien Chartier,1695964,1450634,Agence_mtn_Abomey,300000,54670,2022-07-02
TRANSFER,101379,Jeanne Garnier,253662,152283,Adrien Chartier,1450634,1552013,2022-07-10
TRANSFER,973149,Adrien Chartier,1552013,578864,Alphonse Le Olivier,889500,-83649,2022-07-14
CASH_OUT,121955,Thibaut Coulon,1037100,915145,Agence_mtn_Ouidah,300000,178045,2022-07-06
CASH_OUT,860810,Thibaut Coulon,915145,54335,Agence_mtn_Ouidah,300000,-560810,2022-07-14
CASH_IN,100516,Agence_mtn_Ouidah,300000,199484,Thibaut Coulon,54335,154851,2022-07-16
CASH_OUT,47712,Thibaut Coulon,154851,107139,Agence_mtn_Cotonou,300000,252288,2022-07-18
CASH_IN,142147,Agence_mtn_Abomey,300000,157853,Thibaut Coulon,107139,249286,2022-07-19
CASH_OUT,208978,Alfred du Lesage,318700,109722,Agence_mtn_Ouidah,300000,91022,2022-07-27
CASH_OUT,42736,Antoinette Bertrand,79800,37064,Agence_mtn_Cotonou,300000,257264,2022-07-03
TRANSFER,629462,Claude Foucher,1670500,1041038,Antoinette Bertrand,37064,666526,2022-07-11
CASH_IN,60073,Agence_mtn_Abomey,300000,239927,Antoinette Bertrand,666526,726599,2022-07-18
TRANSFER,383236,Tristan Thomas,560700,177464,Antoinette Bertrand,726599,1109835,2022-07-21
TRANSFER,27380,Cécile Germain,517600,490220,Laure Philippe,549700,577080,2022-07-01
TRANSFER,77932,Laure Philippe,577080,499148,François Michel-Legros,1649600,1571668,2022-07-03
CASH_OUT,90974,Laure Philippe,499148,408174,Agence_mtn_Cotonou,300000,209026,2022-07-03
CASH_IN,98417,Agence_mtn_Ouidah,300000,201583,Laure Philippe,408174,506591,2022-07-06
CASH_OUT,392810,Laure Philippe,506591,113781,Agence_mtn_Abomey,300000,-92810,2022-07-07
TRANSFER,1018415,Antoine Leleu,1535600,517185,Laure Philippe,113781,1132196,2022-07-08
CASH_OUT,711225,Laure Philippe,1132196,420971,Agence_mtn_Cotonou,300000,-411225,2022-07-08
CASH_IN,37654,Agence_mtn_Ouidah,300000,262346,Laure Philippe,420971,458625,2022-07-10
CASH_OUT,455624,Laure Philippe,458625,3001,Agence_mtn_Ouidah,300000,-155624,2022-07-11
CASH_IN,106196,Agence_mtn_Cotonou,300000,193804,Laure Philippe,3001,109197,2022-07-11
CASH_IN,167855,Agence_mtn_Abomey,300000,132145,Laure Philippe,109197,277052,2022-07-13
CASH_IN,47715,Agence_mtn_Cotonou,300000,252285,Laure Philippe,277052,324767,2022-07-15
CASH_OUT,99236,Laure Philippe,324767,225531,Agence_mtn_Cotonou,300000,200764,2022-07-16
TRANSFER,1377236,Gilbert Foucher,1568600,191364,Laure Philippe,225531,1602767,2022-07-18
TRANSFER,793739,Laure Philippe,1602767,809028,Pierre Roger,1329600,535861,2022-07-19
CASH_IN,76536,Agence_mtn_Cotonou,300000,223464,Laure Philippe,809028,885564,2022-07-20
CASH_IN,78491,Agence_mtn_Ouidah,300000,221509,Laure Philippe,885564,964055,2022-07-21
TRANSFER,225306,Laure Philippe,964055,738749,Valérie Dijoux,191100,-34206,2022-07-21
TRANSFER,248660,Antoine Leleu,517185,268525,Laure Philippe,738749,987409,2022-07-22
CASH_IN,133105,Agence_mtn_Cotonou,300000,166895,Laure Philippe,987409,1120514,2022-07-24
CASH_OUT,187919,Laure Philippe,1120514,932595,Agence_mtn_Cotonou,300000,112081,2022-07-24
TRANSFER,86208,Inès de Letellier,1240300,1154092,Laure Philippe,932595,1018803,2022-07-24
CASH_IN,226323,Agence_mtn_Cotonou,300000,73677,Laure Philippe,1018803,1245126,2022-07-25
TRANSFER,134019,Laure Philippe,1245126,1111107,Xavier Leblanc-Ferreira,1317200,1183181,2022-07-26
CASH_IN,85798,Agence_mtn_Abomey,300000,214202,Laure Philippe,1111107,1196905,2022-07-26
TRANSFER,539936,Laure Philippe,1196905,656969,Victoire-Nicole Lopez,1498800,958864,2022-07-27
CASH_IN,217831,Agence_mtn_Cotonou,300000,82169,Laure Philippe,656969,874800,2022-07-27
CASH_OUT,537094,Pénélope Ollivier,788278,251184,Agence_mtn_Abomey,300000,-237094,2022-07-01
CASH_OUT,95922,Pénélope Ollivier,251184,155262,Agence_mtn_Cotonou,300000,204078,2022-07-01
CASH_IN,185925,Agence_mtn_Abomey,300000,114075,Pénélope Ollivier,155262,341187,2022-07-02
TRANSFER,82541,Pénélope Ollivier,341187,258646,Sébastien Lemaître,193500,110959,2022-07-02
CASH_IN,83864,Agence_mtn_Ouidah,300000,216136,Pénélope Ollivier,258646,342510,2022-07-03
CASH_IN,57413,Agence_mtn_Abomey,300000,242587,Pénélope Ollivier,342510,399923,2022-07-03
CASH_IN,206247,Agence_mtn_Ouidah,300000,93753,Pénélope Ollivier,399923,606170,2022-07-04
CASH_OUT,580395,Pénélope Ollivier,606170,25775,Agence_mtn_Cotonou,300000,-280395,2022-07-05
CASH_OUT,981,Pénélope Ollivier,25775,24794,Agence_mtn_Ouidah,300000,299019,2022-07-12
CASH_IN,32485,Agence_mtn_Abomey,300000,267515,Pénélope Ollivier,24794,57279,2022-07-13
TRANSFER,3368,Pénélope Ollivier,57279,53911,Victoire-Nicole Lopez,958864,955496,2022-07-14
TRANSFER,33370,Pénélope Ollivier,53911,20541,Édouard Nguyen,1987700,1954330,2022-07-14
TRANSFER,456785,Honoré du Laurent,688700,231915,Pénélope Ollivier,20541,477326,2022-07-14
CASH_OUT,166664,Pénélope Ollivier,477326,310662,Agence_mtn_Cotonou,300000,133336,2022-07-18
CASH_OUT,186355,Pénélope Ollivier,310662,124307,Agence_mtn_Cotonou,300000,113645,2022-07-19
CASH_OUT,13086,Pénélope Ollivier,124307,111221,Agence_mtn_Cotonou,300000,286914,2022-07-19
TRANSFER,255626,Claude Foucher,1041038,785412,Pénélope Ollivier,111221,366847,2022-07-19
CASH_IN,82530,Agence_mtn_Cotonou,300000,217470,Pénélope Ollivier,366847,449377,2022-07-21
TRANSFER,301192,Pénélope Ollivier,449377,148185,Alexandre Rémy,442400,141208,2022-07-21
CASH_IN,204389,Agence_mtn_Abomey,300000,95611,Pénélope Ollivier,148185,352574,2022-07-22
CASH_OUT,179144,Pénélope Ollivier,352574,173430,Agence_mtn_Abomey,300000,120856,2022-07-24
TRANSFER,75689,Honoré du Laurent,231915,156226,Pénélope Ollivier,173430,249119,2022-07-24
CASH_OUT,75355,Pénélope Ollivier,249119,173764,Agence_mtn_Cotonou,300000,224645,2022-07-26
CASH_OUT,33448,Pénélope Ollivier,173764,140316,Agence_mtn_Cotonou,300000,266552,2022-07-27
CASH_OUT,96456,Pénélope Ollivier,140316,43860,Agence_mtn_Ouidah,300000,203544,2022-07-27
CASH_OUT,114291,Vincent Mathieu,404000,289709,Agence_mtn_Cotonou,300000,185709,2022-07-01
TRANSFER,77030,Eugène Poulain,689600,612570,Vincent Mathieu,289709,366739,2022-07-01
CASH_IN,125729,Agence_mtn_Ouidah,300000,174271,Vincent Mathieu,366739,492468,2022-07-01
CASH_OUT,124148,Vincent Mathieu,492468,368320,Agence_mtn_Cotonou,300000,175852,2022-07-01
CASH_OUT,324898,Vincent Mathieu,368320,43422,Agence_mtn_Ouidah,300000,-24898,2022-07-03
TRANSFER,591993,Édouard Nguyen,1954330,1362337,Vincent Mathieu,43422,635415,2022-07-05
TRANSFER,78592,Vincent Mathieu,635415,556823,Raymond Rossi,26000,-52592,2022-07-06
CASH_IN,103806,Agence_mtn_Ouidah,300000,196194,Vincent Mathieu,556823,660629,2022-07-07
CASH_IN,92807,Agence_mtn_Ouidah,300000,207193,Vincent Mathieu,660629,753436,2022-07-09
CASH_IN,105943,Agence_mtn_Ouidah,300000,194057,Vincent Mathieu,753436,859379,2022-07-09
CASH_OUT,521934,Vincent Mathieu,859379,337445,Agence_mtn_Cotonou,300000,-221934,2022-07-11
CASH_OUT,118526,Vincent Mathieu,337445,218919,Agence_mtn_Cotonou,300000,181474,2022-07-13
CASH_IN,233806,Agence_mtn_Abomey,300000,66194,Vincent Mathieu,218919,452725,2022-07-15
CASH_OUT,290887,Vincent Mathieu,452725,161838,Agence_mtn_Cotonou,300000,9113,2022-07-15
CASH_IN,234038,Agence_mtn_Cotonou,300000,65962,Vincent Mathieu,161838,395876,2022-07-16
CASH_OUT,46045,Vincent Mathieu,395876,349831,Agence_mtn_Abomey,300000,253955,2022-07-18
CASH_IN,42004,Agence_mtn_Abomey,300000,257996,Vincent Mathieu,349831,391835,2022-07-18
TRANSFER,46945,Laurent-Bertrand Lefort,99867,52922,Vincent Mathieu,391835,438780,2022-07-18
TRANSFER,24796,Vincent Mathieu,438780,413984,Philippine Courtois,974887,950091,2022-07-19
CASH_IN,4843,Agence_mtn_Ouidah,300000,295157,Vincent Mathieu,413984,418827,2022-07-20
CASH_IN,118683,Agence_mtn_Ouidah,300000,181317,Vincent Mathieu,418827,537510,2022-07-21
CASH_OUT,9443,Vincent Mathieu,537510,528067,Agence_mtn_Cotonou,300000,290557,2022-07-25
TRANSFER,369225,Vincent Mathieu,528067,158842,Corinne-Louise Valentin,1800300,1431075,2022-07-25
TRANSFER,26623,Vincent Mathieu,158842,132219,Richard Le Descamps,1254000,1227377,2022-07-27
CASH_IN,263598,Agence_mtn_Cotonou,300000,36402,Alphonse Le Olivier,-83649,179949,2022-07-01
TRANSFER,13189,Alphonse Le Olivier,179949,166760,Michelle Lebon,163574,150385,2022-07-02
CASH_IN,82093,Agence_mtn_Cotonou,300000,217907,Alphonse Le Olivier,166760,248853,2022-07-04
CASH_OUT,189275,Alphonse Le Olivier,248853,59578,Agence_mtn_Ouidah,300000,110725,2022-07-05
CASH_IN,241135,Agence_mtn_Abomey,300000,58865,Alphonse Le Olivier,59578,300713,2022-07-06
CASH_OUT,259306,Alphonse Le Olivier,300713,41407,Agence_mtn_Cotonou,300000,40694,2022-07-06
CASH_OUT,7708,Alphonse Le Olivier,41407,33699,Agence_mtn_Abomey,300000,292292,2022-07-07
CASH_OUT,22907,Alphonse Le Olivier,33699,10792,Agence_mtn_Ouidah,300000,277093,2022-07-08
CASH_OUT,4124,Alphonse Le Olivier,10792,6668,Agence_mtn_Ouidah,300000,295876,2022-07-09
TRANSFER,858510,Léon Lecoq,988900,130390,Alphonse Le Olivier,6668,865178,2022-07-09
TRANSFER,100089,Alphonse Le Olivier,865178,765089,Alphonse Le Olivier,865178,965267,2022-07-12
CASH_OUT,402727,Alphonse Le Olivier,765089,362362,Agence_mtn_Abomey,300000,-102727,2022-07-12
CASH_OUT,130446,Alphonse Le Olivier,362362,231916,Agence_mtn_Ouidah,300000,169554,2022-07-12
TRANSFER,50691,Alphonse Le Olivier,231916,181225,Laurent-Bertrand Lefort,52922,2231,2022-07-15
CASH_IN,219528,Agence_mtn_Ouidah,300000,80472,Alphonse Le Olivier,181225,400753,2022-07-18
TRANSFER,42498,Alphonse Le Olivier,400753,358255,Geneviève De Oliveira-Michel,946600,904102,2022-07-18
TRANSFER,100563,Alphonse Le Olivier,358255,257692,Éléonore-Hélène Dubois,1622600,1522037,2022-07-19
CASH_IN,128278,Agence_mtn_Ouidah,300000,171722,Alphonse Le Olivier,257692,385970,2022-07-20
CASH_OUT,1372,Alphonse Le Olivier,385970,384598,Agence_mtn_Abomey,300000,298628,2022-07-21
CASH_IN,32925,Agence_mtn_Abomey,300000,267075,Alphonse Le Olivier,384598,417523,2022-07-23
CASH_OUT,388173,Alphonse Le Olivier,417523,29350,Agence_mtn_Cotonou,300000,-88173,2022-07-23
TRANSFER,695031,Claude Foucher,785412,90381,Alphonse Le Olivier,29350,724381,2022-07-24
CASH_OUT,31084,Alphonse Le Olivier,724381,693297,Agence_mtn_Cotonou,300000,268916,2022-07-25
CASH_IN,200554,Agence_mtn_Cotonou,300000,99446,Alphonse Le Olivier,693297,893851,2022-07-25
CASH_OUT,14734,Alphonse Le Olivier,893851,879117,Agence_mtn_Ouidah,300000,285266,2022-07-26
CASH_OUT,606468,Alphonse Le Olivier,879117,272649,Agence_mtn_Ouidah,300000,-306468,2022-07-26
TRANSFER,70365,Alphonse Le Olivier,272649,202284,Valentine Martinez,1315300,1244935,2022-07-27
TRANSFER,1349824,Gilbert-Charles Thibault,1613800,263976,Alphonse Le Olivier,202284,1552108,2022-07-27
CASH_IN,130442,Agence_mtn_Ouidah,300000,169558,Frédéric Couturier,590248,720690,2022-07-01
CASH_IN,138212,Agence_mtn_Abomey,300000,161788,Frédéric Couturier,720690,858902,2022-07-02
TRANSFER,158264,Frédéric Couturier,858902,700638,François Michel-Legros,1571668,1413404,2022-07-03
CASH_OUT,659170,Frédéric Couturier,700638,41468,Agence_mtn_Cotonou,300000,-359170,2022-07-04
CASH_OUT,887,Frédéric Couturier,41468,40581,Agence_mtn_Cotonou,300000,299113,2022-07-05
CASH_IN,190009,Agence_mtn_Ouidah,300000,109991,Frédéric Couturier,40581,230590,2022-07-07
CASH_IN,260068,Agence_mtn_Ouidah,300000,39932,Frédéric Couturier,230590,490658,2022-07-08
CASH_IN,186335,Agence_mtn_Cotonou,300000,113665,Frédéric Couturier,490658,676993,2022-07-09
CASH_OUT,278108,Frédéric Couturier,676993,398885,Agence_mtn_Ouidah,300000,21892,2022-07-09
TRANSFER,1000911,Xavier Leblanc-Ferreira,1183181,182270,Frédéric Couturier,398885,1399796,2022-07-12
CASH_IN,252673,Agence_mtn_Ouidah,300000,47327,Frédéric Couturier,1399796,1652469,2022-07-13
CASH_IN,294657,Agence_mtn_Ouidah,300000,5343,Frédéric Couturier,1652469,1947126,2022-07-13
CASH_OUT,466496,Frédéric Couturier,1947126,1480630,Agence_mtn_Abomey,300000,-166496,2022-07-14
CASH_OUT,759271,Frédéric Couturier,1480630,721359,Agence_mtn_Abomey,300000,-459271,2022-07-14
TRANSFER,167865,Gilbert Foucher,191364,23499,Frédéric Couturier,721359,889224,2022-07-19
TRANSFER,1069593,Richard Le Descamps,1227377,157784,Frédéric Couturier,889224,1958817,2022-07-20
CASH_IN,268862,Agence_mtn_Ouidah,300000,31138,Frédéric Couturier,1958817,2227679,2022-07-21
CASH_IN,286742,Agence_mtn_Abomey,300000,13258,Frédéric Couturier,2227679,2514421,2022-07-21
CASH_IN,296262,Agence_mtn_Ouidah,300000,3738,Frédéric Couturier,2514421,2810683,2022-07-22
CASH_IN,84311,Agence_mtn_Cotonou,300000,215689,Frédéric Couturier,2810683,2894994,2022-07-22
CASH_OUT,979225,Frédéric Couturier,2894994,1915769,Agence_mtn_Cotonou,300000,-679225,2022-07-24
TRANSFER,89092,Valentine Martinez,1244935,1155843,Frédéric Couturier,1915769,2004861,2022-07-25
CASH_OUT,1495532,Frédéric Couturier,2004861,509329,Agence_mtn_Abomey,300000,-1195532,2022-07-26
CASH_OUT,219386,Frédéric Couturier,509329,289943,Agence_mtn_Ouidah,300000,80614,2022-07-26
CASH_OUT,117054,Frédéric Couturier,289943,172889,Agence_mtn_Ouidah,300000,182946,2022-07-27
CASH_IN,143352,Agence_mtn_Cotonou,300000,156648,Céline Gomez,224800,368152,2022-07-01
CASH_IN,24573,Agence_mtn_Abomey,300000,275427,Céline Gomez,368152,392725,2022-07-01
CASH_IN,133246,Agence_mtn_Cotonou,300000,166754,Céline Gomez,392725,525971,2022-07-02
TRANSFER,139986,Richard Le Descamps,157784,17798,Céline Gomez,525971,665957,2022-07-03
TRANSFER,129639,Céline Gomez,665957,536318,Nathalie Pages,64300,-65339,2022-07-05
TRANSFER,288828,Céline Gomez,536318,247490,Antoine Leleu,268525,-20303,2022-07-06
CASH_IN,48426,Agence_mtn_Abomey,300000,251574,Céline Gomez,247490,295916,2022-07-06
TRANSFER,251770,Céline Gomez,295916,44146,Victoire-Nicole Lopez,955496,703726,2022-07-06
CASH_OUT,16247,Céline Gomez,44146,27899,Agence_mtn_Ouidah,300000,283753,2022-07-08
TRANSFER,1072928,Corinne-Louise Valentin,1431075,358147,Céline Gomez,27899,1100827,2022-07-08
TRANSFER,196874,Céline Gomez,1100827,903953,Gilbert-Charles Thibault,263976,67102,2022-07-09
CASH_IN,90001,Agence_mtn_Abomey,300000,209999,Céline Gomez,903953,993954,2022-07-09
CASH_OUT,503906,Céline Gomez,993954,490048,Agence_mtn_Ouidah,300000,-203906,2022-07-10
CASH_OUT,385743,Céline Gomez,490048,104305,Agence_mtn_Abomey,300000,-85743,2022-07-10
CASH_OUT,100890,Céline Gomez,104305,3415,Agence_mtn_Abomey,300000,199110,2022-07-13
CASH_IN,275412,Agence_mtn_Ouidah,300000,24588,Céline Gomez,3415,278827,2022-07-17
TRANSFER,256369,Victoire-Nicole Lopez,703726,447357,Céline Gomez,278827,535196,2022-07-19
CASH_IN,260449,Agence_mtn_Cotonou,300000,39551,Céline Gomez,535196,795645,2022-07-20
CASH_OUT,265176,Céline Gomez,795645,530469,Agence_mtn_Ouidah,300000,34824,2022-07-22
CASH_IN,760,Agence_mtn_Cotonou,300000,299240,Céline Gomez,530469,531229,2022-07-24
CASH_IN,210181,Agence_mtn_Ouidah,300000,89819,Céline Gomez,531229,741410,2022-07-26
TRANSFER,453453,Céline Gomez,741410,287957,Zoé Renaud de Boutin,193700,-259753,2022-07-27
CASH_IN,112303,Agence_mtn_Abomey,300000,187697,Céline Gomez,287957,400260,2022-07-27
CASH_OUT,507885,Rémy de la Roux,665801,157916,Agence_mtn_Ouidah,300000,-207885,2022-07-01
TRANSFER,147442,Rémy de la Roux,157916,10474,Tristan Thomas,177464,30022,2022-07-01
TRANSFER,1899,Rémy de la Roux,10474,8575,Honoré du Laurent,156226,154327,2022-07-01
CASH_OUT,7693,Rémy de la Roux,8575,882,Agence_mtn_Ouidah,300000,292307,2022-07-02
CASH_IN,249633,Agence_mtn_Cotonou,300000,50367,Rémy de la Roux,882,250515,2022-07-04
TRANSFER,313845,Pénélope Dupuis,667200,353355,Rémy de la Roux,250515,564360,2022-07-04
TRANSFER,254133,Martine Wagner de la Bègue,1260500,1006367,Rémy de la Roux,564360,818493,2022-07-05
TRANSFER,567505,Rémy de la Roux,818493,250988,Eugène Poulain,612570,45065,2022-07-07
CASH_OUT,246160,Rémy de la Roux,250988,4828,Agence_mtn_Ouidah,300000,53840,2022-07-07
CASH_OUT,2029,Rémy de la Roux,4828,2799,Agence_mtn_Cotonou,300000,297971,2022-07-08
CASH_IN,109897,Agence_mtn_Abomey,300000,190103,Rémy de la Roux,2799,112696,2022-07-14
CASH_IN,52904,Agence_mtn_Ouidah,300000,247096,Rémy de la Roux,112696,165600,2022-07-14
CASH_IN,240078,Agence_mtn_Cotonou,300000,59922,Rémy de la Roux,165600,405678,2022-07-16
CASH_IN,107168,Agence_mtn_Abomey,300000,192832,Rémy de la Roux,405678,512846,2022-07-17
CASH_IN,297153,Agence_mtn_Abomey,300000,2847,Rémy de la Roux,512846,809999,2022-07-19
CASH_IN,226848,Agence_mtn_Ouidah,300000,73152,Rémy de la Roux,809999,1036847,2022-07-20
TRANSFER,200685,Alix Maillet,282602,81917,Rémy de la Roux,1036847,1237532,2022-07-22
CASH_OUT,62077,Rémy de la Roux,1237532,1175455,Agence_mtn_Ouidah,300000,237923,2022-07-22
TRANSFER,43571,Emmanuelle Georges,1429600,1386029,Rémy de la Roux,1175455,1219026,2022-07-24
CASH_IN,275632,Agence_mtn_Ouidah,300000,24368,Rémy de la Roux,1219026,1494658,2022-07-24
TRANSFER,1247338,Vincent Fournier,1622871,375533,Rémy de la Roux,1494658,2741996,2022-07-25
CASH_OUT,505762,Caroline-Lorraine Humbert,1432100,926338,Agence_mtn_Cotonou,300000,-205762,2022-07-01
TRANSFER,283016,Isabelle Rossi,1551627,1268611,Caroline-Lorraine Humbert,926338,1209354,2022-07-01
CASH_OUT,835874,Caroline-Lorraine Humbert,1209354,373480,Agence_mtn_Ouidah,300000,-535874,2022-07-02
CASH_OUT,363178,Caroline-Lorraine Humbert,373480,10302,Agence_mtn_Ouidah,300000,-63178,2022-07-03
CASH_IN,147646,Agence_mtn_Cotonou,300000,152354,Caroline-Lorraine Humbert,10302,157948,2022-07-04
TRANSFER,74028,Xavier de Lebreton,158500,84472,Caroline-Lorraine Humbert,157948,231976,2022-07-05
CASH_OUT,97683,Caroline-Lorraine Humbert,231976,134293,Agence_mtn_Cotonou,300000,202317,2022-07-06
TRANSFER,380563,Geneviève De Oliveira-Michel,904102,523539,Caroline-Lorraine Humbert,134293,514856,2022-07-08
CASH_IN,79054,Agence_mtn_Cotonou,300000,220946,Caroline-Lorraine Humbert,514856,593910,2022-07-08
CASH_OUT,66113,Caroline-Lorraine Humbert,593910,527797,Agence_mtn_Cotonou,300000,233887,2022-07-09
CASH_IN,31261,Agence_mtn_Cotonou,300000,268739,Caroline-Lorraine Humbert,527797,559058,2022-07-09
CASH_IN,32681,Agence_mtn_Abomey,300000,267319,Caroline-Lorraine Humbert,559058,591739,2022-07-10
CASH_OUT,563128,Caroline-Lorraine Humbert,591739,28611,Agence_mtn_Ouidah,300000,-263128,2022-07-13
CASH_IN,57777,Agence_mtn_Abomey,300000,242223,Caroline-Lorraine Humbert,28611,86388,2022-07-13
CASH_IN,13981,Agence_mtn_Cotonou,300000,286019,Caroline-Lorraine Humbert,86388,100369,2022-07-15
TRANSFER,48822,Alix Maillet,81917,33095,Caroline-Lorraine Humbert,100369,149191,2022-07-16
CASH_IN,266202,Agence_mtn_Ouidah,300000,33798,Caroline-Lorraine Humbert,149191,415393,2022-07-17
TRANSFER,116723,Caroline-Lorraine Humbert,415393,298670,Isabelle Rossi,1268611,1151888,2022-07-17
CASH_IN,158278,Agence_mtn_Cotonou,300000,141722,Caroline-Lorraine Humbert,298670,456948,2022-07-17
CASH_OUT,213600,Caroline-Lorraine Humbert,456948,243348,Agence_mtn_Ouidah,300000,86400,2022-07-18
CASH_IN,79838,Agence_mtn_Ouidah,300000,220162,Caroline-Lorraine Humbert,243348,323186,2022-07-20
TRANSFER,316326,Caroline-Lorraine Humbert,323186,6860,Alexandre Rémy,141208,-175118,2022-07-23
TRANSFER,34437,Sébastien Lemaître,110959,76522,Caroline-Lorraine Humbert,6860,41297,2022-07-27
CASH_IN,62677,Agence_mtn_Ouidah,300000,237323,Caroline-Lorraine Humbert,41297,103974,2022-07-27
CASH_IN,261615,Agence_mtn_Cotonou,300000,38385,Antoine Leleu,-20303,241312,2022-07-02
TRANSFER,15100,Richard Le Descamps,17798,2698,Antoine Leleu,241312,256412,2022-07-03
CASH_OUT,40153,Antoine Leleu,256412,216259,Agence_mtn_Ouidah,300000,259847,2022-07-03
TRANSFER,204723,Antoine Leleu,216259,11536,Honoré du Laurent,154327,-50396,2022-07-04
TRANSFER,3575,Antoine Leleu,11536,7961,Pierre Reynaud,1364836,1361261,2022-07-05
TRANSFER,10588,Geneviève De Oliveira-Michel,523539,512951,Antoine Leleu,7961,18549,2022-07-06
CASH_OUT,12666,Antoine Leleu,18549,5883,Agence_mtn_Cotonou,300000,287334,2022-07-09
TRANSFER,5295,Antoine Leleu,5883,588,Étienne Roche,1854600,1849305,2022-07-09
TRANSFER,899513,Valentine Martinez,1155843,256330,Antoine Leleu,588,900101,2022-07-10
TRANSFER,1797,Richard Le Descamps,2698,901,Antoine Leleu,900101,901898,2022-07-13
CASH_OUT,50587,Antoine Leleu,901898,851311,Agence_mtn_Ouidah,300000,249413,2022-07-13
TRANSFER,30831,Pierre Roger,535861,505030,Antoine Leleu,851311,882142,2022-07-18
TRANSFER,542779,Antoine Leleu,882142,339363,Martine Wagner de la Bègue,1006367,463588,2022-07-18
TRANSFER,214320,Roland Garcia,1956100,1741780,Antoine Leleu,339363,553683,2022-07-19
CASH_IN,75234,Agence_mtn_Cotonou,300000,224766,Antoine Leleu,553683,628917,2022-07-19
CASH_OUT,324495,Antoine Leleu,628917,304422,Agence_mtn_Abomey,300000,-24495,2022-07-21
TRANSFER,237979,Antoine Leleu,304422,66443,Victoire-Nicole Lopez,447357,209378,2022-07-21
TRANSFER,43870,Antoine Leleu,66443,22573,Théodore De Oliveira-Nicolas,164500,120630,2022-07-21
CASH_IN,274036,Agence_mtn_Abomey,300000,25964,Antoine Leleu,22573,296609,2022-07-22
CASH_IN,291155,Agence_mtn_Abomey,300000,8845,Antoine Leleu,296609,587764,2022-07-22
CASH_OUT,370087,Antoine Leleu,587764,217677,Agence_mtn_Ouidah,300000,-70087,2022-07-23
CASH_OUT,159352,Antoine Leleu,217677,58325,Agence_mtn_Ouidah,300000,140648,2022-07-26
TRANSFER,26736,Antoine Leleu,58325,31589,Alexandrie Delmas,1169900,1143164,2022-07-27
CASH_IN,265440,Agence_mtn_Ouidah,300000,34560,Antoine Leleu,31589,297029,2022-07-27
CASH_IN,49119,Agence_mtn_Abomey,300000,250881,Antoine Leleu,297029,346148,2022-07-27
CASH_OUT,104058,Valentine Martinez,256330,152272,Agence_mtn_Ouidah,300000,195942,2022-07-01
CASH_OUT,31644,Valentine Martinez,152272,120628,Agence_mtn_Cotonou,300000,268356,2022-07-02
TRANSFER,115805,Valentine Martinez,120628,4823,Raymond Marchal de Nguyen,936508,820703,2022-07-02
CASH_OUT,4517,Valentine Martinez,4823,306,Agence_mtn_Abomey,300000,295483,2022-07-05
CASH_IN,178799,Agence_mtn_Cotonou,300000,121201,Valentine Martinez,306,179105,2022-07-05
TRANSFER,96244,Valentine Martinez,179105,82861,William Lebrun,222000,125756,2022-07-06
CASH_IN,269414,Agence_mtn_Cotonou,300000,30586,Valentine Martinez,82861,352275,2022-07-06
CASH_OUT,287200,Valentine Martinez,352275,65075,Agence_mtn_Ouidah,300000,12800,2022-07-07
TRANSFER,39979,Valentine Martinez,65075,25096,Tristan Thomas,30022,-9957,2022-07-07
TRANSFER,13908,Valentine Martinez,25096,11188,Roland Garcia,1741780,1727872,2022-07-07
CASH_OUT,7737,Valentine Martinez,11188,3451,Agence_mtn_Ouidah,300000,292263,2022-07-08
TRANSFER,1255,Valentine Martinez,3451,2196,Margot Renaud,82991,81736,2022-07-11
TRANSFER,400575,Adèle Labbé,639600,239025,Valentine Martinez,2196,402771,2022-07-11
CASH_OUT,121383,Valentine Martinez,402771,281388,Agence_mtn_Cotonou,300000,178617,2022-07-12
CASH_OUT,119343,Valentine Martinez,281388,162045,Agence_mtn_Abomey,300000,180657,2022-07-13
CASH_IN,263641,Agence_mtn_Cotonou,300000,36359,Valentine Martinez,162045,425686,2022-07-14
TRANSFER,24612,Valentine Martinez,425686,401074,Xavier Leblanc-Ferreira,182270,157658,2022-07-15
CASH_OUT,391327,Valentine Martinez,401074,9747,Agence_mtn_Cotonou,300000,-91327,2022-07-17
CASH_OUT,180,Valentine Martinez,9747,9567,Agence_mtn_Cotonou,300000,299820,2022-07-18
CASH_IN,269114,Agence_mtn_Ouidah,300000,30886,Valentine Martinez,9567,278681,2022-07-21
CASH_OUT,133810,Valentine Martinez,278681,144871,Agence_mtn_Cotonou,300000,166190,2022-07-23
CASH_IN,156572,Agence_mtn_Abomey,300000,143428,Valentine Martinez,144871,301443,2022-07-24
CASH_IN,223904,Agence_mtn_Ouidah,300000,76096,Valentine Martinez,301443,525347,2022-07-27
CASH_IN,183202,Agence_mtn_Cotonou,300000,116798,François Michel-Legros,1413404,1596606,2022-07-01
CASH_IN,247806,Agence_mtn_Ouidah,300000,52194,François Michel-Legros,1596606,1844412,2022-07-02
CASH_IN,120609,Agence_mtn_Ouidah,300000,179391,François Michel-Legros,1844412,1965021,2022-07-03
TRANSFER,392433,François Michel-Legros,1965021,1572588,Valentine Richard-Bourdon,542900,150467,2022-07-04
CASH_IN,108672,Agence_mtn_Abomey,300000,191328,François Michel-Legros,1572588,1681260,2022-07-05
TRANSFER,218333,Louis Pichon,525437,307104,François Michel-Legros,1681260,1899593,2022-07-06
TRANSFER,1714440,François Michel-Legros,1899593,185153,Louis Pichon,307104,-1407336,2022-07-06
CASH_IN,252068,Agence_mtn_Cotonou,300000,47932,François Michel-Legros,185153,437221,2022-07-06
CASH_OUT,54801,François Michel-Legros,437221,382420,Agence_mtn_Cotonou,300000,245199,2022-07-07
CASH_OUT,256880,François Michel-Legros,382420,125540,Agence_mtn_Abomey,300000,43120,2022-07-07
CASH_OUT,6869,François Michel-Legros,125540,118671,Agence_mtn_Ouidah,300000,293131,2022-07-09
TRANSFER,951798,Inès Hamon,1048400,96602,François Michel-Legros,118671,1070469,2022-07-10
TRANSFER,107898,François Michel-Legros,1070469,962571,Xavier de Lebreton,84472,-23426,2022-07-10
CASH_IN,82279,Agence_mtn_Cotonou,300000,217721,François Michel-Legros,962571,1044850,2022-07-11
CASH_OUT,617628,François Michel-Legros,1044850,427222,Agence_mtn_Ouidah,300000,-317628,2022-07-14
CASH_IN,165227,Agence_mtn_Cotonou,300000,134773,François Michel-Legros,427222,592449,2022-07-15
TRANSFER,71269,Inès Hamon,96602,25333,François Michel-Legros,592449,663718,2022-07-15
CASH_OUT,339372,François Michel-Legros,663718,324346,Agence_mtn_Abomey,300000,-39372,2022-07-15
TRANSFER,65056,Inès de Letellier,1154092,1089036,François Michel-Legros,324346,389402,2022-07-15
TRANSFER,13998,Corinne-Louise Valentin,358147,344149,François Michel-Legros,389402,403400,2022-07-16
TRANSFER,390244,François Michel-Legros,403400,13156,Léon Lecoq,130390,-259854,2022-07-16
CASH_IN,171355,Agence_mtn_Cotonou,300000,128645,François Michel-Legros,13156,184511,2022-07-17
CASH_OUT,67012,François Michel-Legros,184511,117499,Agence_mtn_Ouidah,300000,232988,2022-07-17
CASH_OUT,23108,François Michel-Legros,117499,94391,Agence_mtn_Abomey,300000,276892,2022-07-18
TRANSFER,842961,Étienne Roche,1849305,1006344,François Michel-Legros,94391,937352,2022-07-21
CASH_OUT,880265,François Michel-Legros,937352,57087,Agence_mtn_Cotonou,300000,-580265,2022-07-22
TRANSFER,46597,François Michel-Legros,57087,10490,Théodore De Oliveira-Nicolas,120630,74033,2022-07-23
TRANSFER,864465,Pierre Reynaud,1361261,496796,François Michel-Legros,10490,874955,2022-07-25
CASH_IN,292848,Agence_mtn_Cotonou,300000,7152,François Michel-Legros,874955,1167803,2022-07-25
CASH_OUT,397735,François Michel-Legros,1167803,770068,Agence_mtn_Cotonou,300000,-97735,2022-07-27
CASH_IN,196405,Agence_mtn_Cotonou,300000,103595,Victoire-Nicole Lopez,209378,405783,2022-07-01
CASH_OUT,405736,Victoire-Nicole Lopez,405783,47,Agence_mtn_Abomey,300000,-105736,2022-07-02
CASH_IN,71445,Agence_mtn_Abomey,300000,228555,Victoire-Nicole Lopez,47,71492,2022-07-03
CASH_OUT,30916,Victoire-Nicole Lopez,71492,40576,Agence_mtn_Ouidah,300000,269084,2022-07-04
CASH_OUT,36921,Victoire-Nicole Lopez,40576,3655,Agence_mtn_Abomey,300000,263079,2022-07-06
TRANSFER,136508,Sophie Gonzalez,1203300,1066792,Victoire-Nicole Lopez,3655,140163,2022-07-07
CASH_IN,197541,Agence_mtn_Cotonou,300000,102459,Victoire-Nicole Lopez,140163,337704,2022-07-07
TRANSFER,175211,Victoire-Nicole Lopez,337704,162493,Thierry Delattre-Simon,1373300,1198089,2022-07-07
TRANSFER,82697,Gabriel-Tristan Marty,92018,9321,Victoire-Nicole Lopez,162493,245190,2022-07-08
CASH_IN,121585,Agence_mtn_Abomey,300000,178415,Victoire-Nicole Lopez,245190,366775,2022-07-08
CASH_IN,229274,Agence_mtn_Cotonou,300000,70726,Victoire-Nicole Lopez,366775,596049,2022-07-09
CASH_IN,183261,Agence_mtn_Ouidah,300000,116739,Victoire-Nicole Lopez,596049,779310,2022-07-12
CASH_OUT,489613,Victoire-Nicole Lopez,779310,289697,Agence_mtn_Cotonou,300000,-189613,2022-07-15
TRANSFER,800584,Alexandrie Delmas,1143164,342580,Victoire-Nicole Lopez,289697,1090281,2022-07-17
CASH_IN,20787,Agence_mtn_Cotonou,300000,279213,Victoire-Nicole Lopez,1090281,1111068,2022-07-18
CASH_IN,245676,Agence_mtn_Ouidah,300000,54324,Victoire-Nicole Lopez,1111068,1356744,2022-07-19
TRANSFER,335325,Victoire-Nicole Lopez,1356744,1021419,Gilbert-Charles Thibault,67102,-268223,2022-07-20
TRANSFER,337656,Sophie Gonzalez,1066792,729136,Victoire-Nicole Lopez,1021419,1359075,2022-07-22
CASH_IN,58470,Agence_mtn_Ouidah,300000,241530,Victoire-Nicole Lopez,1359075,1417545,2022-07-22
CASH_IN,9619,Agence_mtn_Ouidah,300000,290381,Victoire-Nicole Lopez,1417545,1427164,2022-07-23
TRANSFER,651674,Victoire-Nicole Lopez,1427164,775490,Thierry Delattre-Simon,1198089,546415,2022-07-25
TRANSFER,36028,Roland Garcia,1727872,1691844,Victoire-Nicole Lopez,775490,811518,2022-07-27
TRANSFER,190794,Victoire-Nicole Lopez,811518,620724,Roland Garcia,1691844,1501050,2022-07-27
CASH_IN,166978,Agence_mtn_Cotonou,300000,133022,Victoire-Nicole Lopez,620724,787702,2022-07-27
TRANSFER,1074915,Éléonore-Hélène Dubois,1522037,447122,Victoire-Nicole Lopez,787702,1862617,2022-07-27
TRANSFER,871104,Nath Bruneau,1255600,384496,Joséphine Gros,1921700,2792804,2022-07-04
CASH_OUT,223274,Joséphine Gros,2792804,2569530,Agence_mtn_Cotonou,300000,76726,2022-07-05
TRANSFER,25147,Corinne-Louise Valentin,344149,319002,Joséphine Gros,2569530,2594677,2022-07-11
CASH_OUT,2437459,Joséphine Gros,2594677,157218,Agence_mtn_Cotonou,300000,-2137459,2022-07-13
CASH_OUT,147903,Joséphine Gros,157218,9315,Agence_mtn_Abomey,300000,152097,2022-07-13
CASH_IN,90588,Agence_mtn_Cotonou,300000,209412,Joséphine Gros,9315,99903,2022-07-15
CASH_OUT,25310,Joséphine Gros,99903,74593,Agence_mtn_Cotonou,300000,274690,2022-07-16
CASH_IN,9353,Agence_mtn_Cotonou,300000,290647,Joséphine Gros,74593,83946,2022-07-17
CASH_IN,278394,Agence_mtn_Cotonou,300000,21606,Joséphine Gros,83946,362340,2022-07-17
CASH_OUT,208738,Joséphine Gros,362340,153602,Agence_mtn_Cotonou,300000,91262,2022-07-17
CASH_OUT,86864,Joséphine Gros,153602,66738,Agence_mtn_Ouidah,300000,213136,2022-07-17
TRANSFER,39383,Joséphine Gros,66738,27355,Jeanne Garnier,152283,112900,2022-07-19
CASH_IN,217006,Agence_mtn_Cotonou,300000,82994,Joséphine Gros,27355,244361,2022-07-19
CASH_OUT,71114,Joséphine Gros,244361,173247,Agence_mtn_Abomey,300000,228886,2022-07-22
CASH_IN,41607,Agence_mtn_Abomey,300000,258393,Joséphine Gros,173247,214854,2022-07-22
CASH_IN,255116,Agence_mtn_Abomey,300000,44884,Joséphine Gros,214854,469970,2022-07-23
CASH_IN,286278,Agence_mtn_Abomey,300000,13722,Joséphine Gros,469970,756248,2022-07-24
TRANSFER,308675,Nath Bruneau,384496,75821,Joséphine Gros,756248,1064923,2022-07-26
CASH_OUT,346405,Joséphine Gros,1064923,718518,Agence_mtn_Ouidah,300000,-46405,2022-07-26
CASH_IN,33878,Agence_mtn_Abomey,300000,266122,Joséphine Gros,718518,752396,2022-07-26
CASH_OUT,706246,Joséphine Gros,752396,46150,Agence_mtn_Ouidah,300000,-406246,2022-07-27
TRANSFER,34601,Xavier Leblanc-Ferreira,157658,123057,Laurent-Bertrand Lefort,2231,36832,2022-07-01
CASH_IN,100445,Agence_mtn_Ouidah,300000,199555,Laurent-Bertrand Lefort,36832,137277,2022-07-01
CASH_OUT,122516,Laurent-Bertrand Lefort,137277,14761,Agence_mtn_Abomey,300000,177484,2022-07-02
CASH_IN,290606,Agence_mtn_Cotonou,300000,9394,Laurent-Bertrand Lefort,14761,305367,2022-07-02
TRANSFER,59061,Laurent-Bertrand Lefort,305367,246306,Inès Hamon,25333,-33728,2022-07-03
CASH_OUT,38585,Laurent-Bertrand Lefort,246306,207721,Agence_mtn_Cotonou,300000,261415,2022-07-03
CASH_IN,60014,Agence_mtn_Ouidah,300000,239986,Laurent-Bertrand Lefort,207721,267735,2022-07-05
TRANSFER,204508,Laurent-Bertrand Lefort,267735,63227,Rémy Le Michaud,1545697,1341189,2022-07-05
CASH_IN,58061,Agence_mtn_Cotonou,300000,241939,Laurent-Bertrand Lefort,63227,121288,2022-07-06
TRANSFER,32412,Claude Foucher,90381,57969,Laurent-Bertrand Lefort,121288,153700,2022-07-07
TRANSFER,815,Richard Le Descamps,901,86,Laurent-Bertrand Lefort,153700,154515,2022-07-08
TRANSFER,33520,Vincent Fournier,375533,342013,Laurent-Bertrand Lefort,154515,188035,2022-07-09
CASH_IN,211025,Agence_mtn_Abomey,300000,88975,Laurent-Bertrand Lefort,188035,399060,2022-07-09
CASH_OUT,176371,Laurent-Bertrand Lefort,399060,222689,Agence_mtn_Abomey,300000,123629,2022-07-10
CASH_IN,282787,Agence_mtn_Cotonou,300000,17213,Laurent-Bertrand Lefort,222689,505476,2022-07-11
CASH_IN,2728,Agence_mtn_Ouidah,300000,297272,Laurent-Bertrand Lefort,505476,508204,2022-07-12
CASH_OUT,98503,Laurent-Bertrand Lefort,508204,409701,Agence_mtn_Cotonou,300000,201497,2022-07-15
CASH_IN,256534,Agence_mtn_Abomey,300000,43466,Laurent-Bertrand Lefort,409701,666235,2022-07-16
CASH_IN,18120,Agence_mtn_Cotonou,300000,281880,Laurent-Bertrand Lefort,666235,684355,2022-07-17
CASH_OUT,303784,Laurent-Bertrand Lefort,684355,380571,Agence_mtn_Cotonou,300000,-3784,2022-07-19
CASH_OUT,322259,Laurent-Bertrand Lefort,380571,58312,Agence_mtn_Cotonou,300000,-22259,2022-07-20
CASH_IN,85567,Agence_mtn_Abomey,300000,214433,Laurent-Bertrand Lefort,58312,143879,2022-07-22
TRANSFER,143064,Laurent-Bertrand Lefort,143879,815,Cécile Germain,490220,347156,2022-07-27
CASH_OUT,335,Laurent-Bertrand Lefort,815,480,Agence_mtn_Ouidah,300000,299665,2022-07-27
CASH_OUT,652968,Geneviève Grondin,1382900,729932,Agence_mtn_Cotonou,300000,-352968,2022-07-02
CASH_OUT,189676,Geneviève Grondin,729932,540256,Agence_mtn_Cotonou,300000,110324,2022-07-02
CASH_OUT,276524,Geneviève Grondin,540256,263732,Agence_mtn_Ouidah,300000,23476,2022-07-03
CASH_IN,207666,Agence_mtn_Ouidah,300000,92334,Geneviève Grondin,263732,471398,2022-07-03
TRANSFER,54324,Geneviève Grondin,471398,417074,Roland Garcia,1501050,1446726,2022-07-03
CASH_OUT,239635,Geneviève Grondin,417074,177439,Agence_mtn_Ouidah,300000,60365,2022-07-03
CASH_IN,158026,Agence_mtn_Ouidah,300000,141974,Geneviève Grondin,177439,335465,2022-07-05
CASH_OUT,51459,Geneviève Grondin,335465,284006,Agence_mtn_Cotonou,300000,248541,2022-07-07
CASH_IN,149521,Agence_mtn_Ouidah,300000,150479,Geneviève Grondin,284006,433527,2022-07-07
CASH_IN,206068,Agence_mtn_Ouidah,300000,93932,Geneviève Grondin,433527,639595,2022-07-08
CASH_IN,103660,Agence_mtn_Abomey,300000,196340,Geneviève Grondin,639595,743255,2022-07-08
TRANSFER,234000,Inès de Letellier,1089036,855036,Geneviève Grondin,743255,977255,2022-07-08
CASH_IN,22342,Agence_mtn_Cotonou,300000,277658,Geneviève Grondin,977255,999597,2022-07-12
CASH_OUT,149872,Geneviève Grondin,999597,849725,Agence_mtn_Cotonou,300000,150128,2022-07-13
TRANSFER,269882,Geneviève Grondin,849725,579843,Rémy Le Michaud,1341189,1071307,2022-07-15
TRANSFER,63978,Geneviève Grondin,579843,515865,Geneviève Grondin,579843,643821,2022-07-19
TRANSFER,82821,Geneviève Grondin,515865,433044,Pierre Roger,505030,422209,2022-07-20
TRANSFER,110794,Geneviève Grondin,433044,322250,Sophie Gonzalez,729136,618342,2022-07-20
CASH_IN,4956,Agence_mtn_Cotonou,300000,295044,Geneviève Grondin,322250,327206,2022-07-21
TRANSFER,739109,Benjamin Evrard-Marty,1072569,333460,Geneviève Grondin,327206,1066315,2022-07-22
CASH_IN,21510,Agence_mtn_Ouidah,300000,278490,Geneviève Grondin,1066315,1087825,2022-07-22
TRANSFER,812424,Astrid Gay de la Brunet,871900,59476,Geneviève Grondin,1087825,1900249,2022-07-23
CASH_OUT,293517,Geneviève Grondin,1900249,1606732,Agence_mtn_Abomey,300000,6483,2022-07-23
CASH_OUT,704542,Geneviève Grondin,1606732,902190,Agence_mtn_Cotonou,300000,-404542,2022-07-24
CASH_OUT,34747,Geneviève Grondin,902190,867443,Agence_mtn_Cotonou,300000,265253,2022-07-25
TRANSFER,538014,Geneviève Grondin,867443,329429,Roland Garcia,1446726,908712,2022-07-25
TRANSFER,3905,Alix Maillet,33095,29190,Inès de Letellier,855036,858941,2022-07-02
CASH_OUT,754090,Inès de Letellier,858941,104851,Agence_mtn_Abomey,300000,-454090,2022-07-02
CASH_OUT,12210,Inès de Letellier,104851,92641,Agence_mtn_Cotonou,300000,287790,2022-07-02
CASH_IN,175019,Agence_mtn_Cotonou,300000,124981,Inès de Letellier,92641,267660,2022-07-05
CASH_IN,225355,Agence_mtn_Abomey,300000,74645,Inès de Letellier,267660,493015,2022-07-05
CASH_OUT,136729,Inès de Letellier,493015,356286,Agence_mtn_Abomey,300000,163271,2022-07-08
TRANSFER,65319,Michelle Lebon,150385,85066,Inès de Letellier,356286,421605,2022-07-09
CASH_IN,49972,Agence_mtn_Cotonou,300000,250028,Inès de Letellier,421605,471577,2022-07-09
CASH_OUT,94327,Inès de Letellier,471577,377250,Agence_mtn_Cotonou,300000,205673,2022-07-10
CASH_IN,171336,Agence_mtn_Cotonou,300000,128664,Inès de Letellier,377250,548586,2022-07-11
CASH_IN,265752,Agence_mtn_Abomey,300000,34248,Inès de Letellier,548586,814338,2022-07-11
TRANSFER,297276,Inès de Letellier,814338,517062,Sébastien Lemaître,76522,-220754,2022-07-11
CASH_OUT,200653,Inès de Letellier,517062,316409,Agence_mtn_Cotonou,300000,99347,2022-07-11
CASH_OUT,298846,Inès de Letellier,316409,17563,Agence_mtn_Abomey,300000,1154,2022-07-12
CASH_OUT,326,Inès de Letellier,17563,17237,Agence_mtn_Abomey,300000,299674,2022-07-13
TRANSFER,13514,Inès de Letellier,17237,3723,Sophie Gonzalez,618342,604828,2022-07-14
CASH_OUT,422,Inès de Letellier,3723,3301,Agence_mtn_Ouidah,300000,299578,2022-07-15
CASH_IN,279312,Agence_mtn_Abomey,300000,20688,Inès de Letellier,3301,282613,2022-07-17
CASH_IN,131950,Agence_mtn_Cotonou,300000,168050,Inès de Letellier,282613,414563,2022-07-17
CASH_OUT,56246,Inès de Letellier,414563,358317,Agence_mtn_Cotonou,300000,243754,2022-07-18
TRANSFER,238792,Inès de Letellier,358317,119525,William Lebrun,125756,-113036,2022-07-18
CASH_IN,117120,Agence_mtn_Cotonou,300000,182880,Inès de Letellier,119525,236645,2022-07-19
CASH_IN,41622,Agence_mtn_Cotonou,300000,258378,Inès de Letellier,236645,278267,2022-07-19
CASH_OUT,151924,Inès de Letellier,278267,126343,Agence_mtn_Abomey,300000,148076,2022-07-20
TRANSFER,125702,Alexandrie Delmas,342580,216878,Inès de Letellier,126343,252045,2022-07-23
CASH_OUT,197575,Inès de Letellier,252045,54470,Agence_mtn_Cotonou,300000,102425,2022-07-24
CASH_OUT,29172,Inès de Letellier,54470,25298,Agence_mtn_Abomey,300000,270828,2022-07-25
TRANSFER,22581,Inès de Letellier,25298,2717,Jeanne Garnier,112900,90319,2022-07-26
CASH_IN,211456,Agence_mtn_Ouidah,300000,88544,Inès de Letellier,2717,214173,2022-07-26
CASH_IN,212121,Agence_mtn_Ouidah,300000,87879,Sébastien Lemaître,-220754,-8633,2022-07-02
CASH_IN,30306,Agence_mtn_Cotonou,300000,269694,Sébastien Lemaître,-8633,21673,2022-07-04
CASH_OUT,17578,Sébastien Lemaître,21673,4095,Agence_mtn_Cotonou,300000,282422,2022-07-06
TRANSFER,913,Sébastien Lemaître,4095,3182,Isabelle Rossi,1151888,1150975,2022-07-07
TRANSFER,2014,Sébastien Lemaître,3182,1168,Renée David,93800,91786,2022-07-08
CASH_IN,9614,Agence_mtn_Abomey,300000,290386,Sébastien Lemaître,1168,10782,2022-07-09
CASH_OUT,5439,Sébastien Lemaître,10782,5343,Agence_mtn_Ouidah,300000,294561,2022-07-10
CASH_OUT,4135,Sébastien Lemaître,5343,1208,Agence_mtn_Ouidah,300000,295865,2022-07-12
CASH_IN,258893,Agence_mtn_Abomey,300000,41107,Sébastien Lemaître,1208,260101,2022-07-12
CASH_OUT,177676,Sébastien Lemaître,260101,82425,Agence_mtn_Abomey,300000,122324,2022-07-15
CASH_OUT,33347,Sébastien Lemaître,82425,49078,Agence_mtn_Abomey,300000,266653,2022-07-16
CASH_IN,25663,Agence_mtn_Cotonou,300000,274337,Sébastien Lemaître,49078,74741,2022-07-16
TRANSFER,187033,Pierre Reynaud,496796,309763,Sébastien Lemaître,74741,261774,2022-07-19
TRANSFER,1086820,Édouard Nguyen,1362337,275517,Sébastien Lemaître,261774,1348594,2022-07-19
CASH_IN,15633,Agence_mtn_Cotonou,300000,284367,Sébastien Lemaître,1348594,1364227,2022-07-20
CASH_OUT,84737,Sébastien Lemaître,1364227,1279490,Agence_mtn_Cotonou,300000,215263,2022-07-22
TRANSFER,925072,Isabelle Rossi,1150975,225903,Sébastien Lemaître,1279490,2204562,2022-07-23
CASH_IN,155941,Agence_mtn_Abomey,300000,144059,Sébastien Lemaître,2204562,2360503,2022-07-23
CASH_OUT,2127850,Sébastien Lemaître,2360503,232653,Agence_mtn_Cotonou,300000,-1827850,2022-07-25
CASH_OUT,147067,Sébastien Lemaître,232653,85586,Agence_mtn_Abomey,300000,152933,2022-07-26
TRANSFER,445005,Emmanuelle Georges,1386029,941024,Sébastien Lemaître,85586,530591,2022-07-26
TRANSFER,152448,Sébastien Lemaître,530591,378143,Pierre Reynaud,309763,157315,2022-07-27
TRANSFER,510261,Thierry Delattre-Simon,546415,36154,Vincent Fournier,342013,-168248,2022-07-01
CASH_OUT,31242,Thierry Delattre-Simon,36154,4912,Agence_mtn_Abomey,300000,268758,2022-07-02
TRANSFER,3110,Thierry Delattre-Simon,4912,1802,Raymond Marchal de Nguyen,820703,817593,2022-07-03
CASH_IN,11911,Agence_mtn_Cotonou,300000,288089,Thierry Delattre-Simon,1802,13713,2022-07-03
TRANSFER,8298,Thierry Delattre-Simon,13713,5415,Emmanuelle Georges,941024,932726,2022-07-04
CASH_IN,47097,Agence_mtn_Cotonou,300000,252903,Thierry Delattre-Simon,5415,52512,2022-07-07
CASH_OUT,40055,Thierry Delattre-Simon,52512,12457,Agence_mtn_Ouidah,300000,259945,2022-07-08
CASH_IN,60433,Agence_mtn_Ouidah,300000,239567,Thierry Delattre-Simon,12457,72890,2022-07-08
CASH_IN,291085,Agence_mtn_Abomey,300000,8915,Thierry Delattre-Simon,72890,363975,2022-07-09
CASH_IN,216790,Agence_mtn_Abomey,300000,83210,Thierry Delattre-Simon,363975,580765,2022-07-11
TRANSFER,911790,Hortense Lemaire,1146400,234610,Thierry Delattre-Simon,580765,1492555,2022-07-11
CASH_OUT,345974,Thierry Delattre-Simon,1492555,1146581,Agence_mtn_Cotonou,300000,-45974,2022-07-11
CASH_IN,20155,Agence_mtn_Ouidah,300000,279845,Thierry Delattre-Simon,1146581,1166736,2022-07-11
TRANSFER,788700,Thierry Delattre-Simon,1166736,378036,Michelle Lebon,85066,-703634,2022-07-12
TRANSFER,44465,Margot Renaud,81736,37271,Thierry Delattre-Simon,378036,422501,2022-07-14
CASH_OUT,210569,Thierry Delattre-Simon,422501,211932,Agence_mtn_Ouidah,300000,89431,2022-07-15
CASH_IN,159440,Agence_mtn_Cotonou,300000,140560,Thierry Delattre-Simon,211932,371372,2022-07-16
CASH_OUT,330262,Thierry Delattre-Simon,371372,41110,Agence_mtn_Abomey,300000,-30262,2022-07-19
CASH_IN,160789,Agence_mtn_Ouidah,300000,139211,Thierry Delattre-Simon,41110,201899,2022-07-19
CASH_IN,50888,Agence_mtn_Ouidah,300000,249112,Thierry Delattre-Simon,201899,252787,2022-07-20
CASH_OUT,99841,Thierry Delattre-Simon,252787,152946,Agence_mtn_Cotonou,300000,200159,2022-07-20
CASH_IN,190743,Agence_mtn_Abomey,300000,109257,Thierry Delattre-Simon,152946,343689,2022-07-21
CASH_IN,188880,Agence_mtn_Cotonou,300000,111120,Thierry Delattre-Simon,343689,532569,2022-07-21
CASH_IN,215641,Agence_mtn_Cotonou,300000,84359,Thierry Delattre-Simon,532569,748210,2022-07-22
CASH_OUT,76255,Thierry Delattre-Simon,748210,671955,Agence_mtn_Abomey,300000,223745,2022-07-23
CASH_IN,46013,Agence_mtn_Abomey,300000,253987,Thierry Delattre-Simon,671955,717968,2022-07-23
CASH_OUT,703668,Thierry Delattre-Simon,717968,14300,Agence_mtn_Cotonou,300000,-403668,2022-07-24
CASH_OUT,5038,Thierry Delattre-Simon,14300,9262,Agence_mtn_Cotonou,300000,294962,2022-07-24
CASH_IN,94882,Agence_mtn_Cotonou,300000,205118,Thierry Delattre-Simon,9262,104144,2022-07-25
CASH_IN,230332,Agence_mtn_Ouidah,300000,69668,Thierry Delattre-Simon,104144,334476,2022-07-27
TRANSFER,154676,Cécile Germain,347156,192480,Martine Wagner de la Bègue,463588,618264,2022-07-01
CASH_IN,125267,Agence_mtn_Cotonou,300000,174733,Martine Wagner de la Bègue,618264,743531,2022-07-02
TRANSFER,98374,Xavier Leblanc-Ferreira,123057,24683,Martine Wagner de la Bègue,743531,841905,2022-07-04
TRANSFER,61306,Nath Bruneau,75821,14515,Martine Wagner de la Bègue,841905,903211,2022-07-05
TRANSFER,784906,Martine Wagner de la Bègue,903211,118305,Sophie Gonzalez,604828,-180078,2022-07-06
TRANSFER,45088,Astrid Gay de la Brunet,59476,14388,Martine Wagner de la Bègue,118305,163393,2022-07-06
CASH_OUT,37351,Martine Wagner de la Bègue,163393,126042,Agence_mtn_Ouidah,300000,262649,2022-07-06
TRANSFER,87480,Pénélope Dupuis,353355,265875,Martine Wagner de la Bègue,126042,213522,2022-07-06
TRANSFER,106290,Pierre Reynaud,157315,51025,Martine Wagner de la Bègue,213522,319812,2022-07-08
TRANSFER,188444,Alexandrie Delmas,216878,28434,Martine Wagner de la Bègue,319812,508256,2022-07-09
CASH_IN,223590,Agence_mtn_Cotonou,300000,76410,Martine Wagner de la Bègue,508256,731846,2022-07-09
CASH_OUT,711410,Martine Wagner de la Bègue,731846,20436,Agence_mtn_Ouidah,300000,-411410,2022-07-09
CASH_OUT,11637,Martine Wagner de la Bègue,20436,8799,Agence_mtn_Ouidah,300000,288363,2022-07-10
TRANSFER,7142,Martine Wagner de la Bègue,8799,1657,Claude Foucher,57969,50827,2022-07-10
TRANSFER,1397,Martine Wagner de la Bègue,1657,260,Pénélope Dupuis,265875,264478,2022-07-11
TRANSFER,258547,Benjamin Evrard-Marty,333460,74913,Martine Wagner de la Bègue,260,258807,2022-07-13
CASH_OUT,158684,Martine Wagner de la Bègue,258807,100123,Agence_mtn_Abomey,300000,141316,2022-07-14
CASH_IN,61214,Agence_mtn_Abomey,300000,238786,Martine Wagner de la Bègue,100123,161337,2022-07-14
CASH_IN,237484,Agence_mtn_Abomey,300000,62516,Martine Wagner de la Bègue,161337,398821,2022-07-20
CASH_OUT,8497,Martine Wagner de la Bègue,398821,390324,Agence_mtn_Cotonou,300000,291503,2022-07-21
CASH_OUT,105218,Martine Wagner de la Bègue,390324,285106,Agence_mtn_Cotonou,300000,194782,2022-07-22
CASH_IN,174118,Agence_mtn_Cotonou,300000,125882,Martine Wagner de la Bègue,285106,459224,2022-07-22
CASH_IN,116911,Agence_mtn_Ouidah,300000,183089,Martine Wagner de la Bègue,459224,576135,2022-07-22
CASH_OUT,324038,Martine Wagner de la Bègue,576135,252097,Agence_mtn_Ouidah,300000,-24038,2022-07-22
CASH_OUT,207055,Martine Wagner de la Bègue,252097,45042,Agence_mtn_Cotonou,300000,92945,2022-07-23
CASH_IN,105132,Agence_mtn_Cotonou,300000,194868,Martine Wagner de la Bègue,45042,150174,2022-07-23
CASH_IN,205694,Agence_mtn_Ouidah,300000,94306,Martine Wagner de la Bègue,150174,355868,2022-07-23
CASH_OUT,350976,Martine Wagner de la Bègue,355868,4892,Agence_mtn_Ouidah,300000,-50976,2022-07-25
CASH_IN,45916,Agence_mtn_Cotonou,300000,254084,Martine Wagner de la Bègue,4892,50808,2022-07-25
CASH_OUT,18660,Corinne-Louise Valentin,319002,300342,Agence_mtn_Cotonou,300000,281340,2022-07-01
CASH_IN,263867,Agence_mtn_Abomey,300000,36133,Corinne-Louise Valentin,300342,564209,2022-07-01
CASH_IN,57754,Agence_mtn_Ouidah,300000,242246,Corinne-Louise Valentin,564209,621963,2022-07-01
CASH_OUT,292213,Corinne-Louise Valentin,621963,329750,Agence_mtn_Ouidah,300000,7787,2022-07-01
CASH_IN,238840,Agence_mtn_Ouidah,300000,61160,Corinne-Louise Valentin,329750,568590,2022-07-01
TRANSFER,21018,Alexandrie Delmas,28434,7416,Corinne-Louise Valentin,568590,589608,2022-07-02
TRANSFER,456725,Corinne-Louise Valentin,589608,132883,Geneviève De Oliveira-Michel,512951,56226,2022-07-05
CASH_OUT,79135,Corinne-Louise Valentin,132883,53748,Agence_mtn_Abomey,300000,220865,2022-07-07
CASH_OUT,46140,Corinne-Louise Valentin,53748,7608,Agence_mtn_Cotonou,300000,253860,2022-07-10
CASH_OUT,255,Corinne-Louise Valentin,7608,7353,Agence_mtn_Ouidah,300000,299745,2022-07-10
CASH_OUT,707,Corinne-Louise Valentin,7353,6646,Agence_mtn_Cotonou,300000,299293,2022-07-10
CASH_IN,54190,Agence_mtn_Ouidah,300000,245810,Corinne-Louise Valentin,6646,60836,2022-07-12
CASH_OUT,9195,Corinne-Louise Valentin,60836,51641,Agence_mtn_Cotonou,300000,290805,2022-07-13
CASH_OUT,40404,Corinne-Louise Valentin,51641,11237,Agence_mtn_Ouidah,300000,259596,2022-07-13
TRANSFER,48232,Claude Foucher,50827,2595,Corinne-Louise Valentin,11237,59469,2022-07-14
CASH_OUT,14633,Corinne-Louise Valentin,59469,44836,Agence_mtn_Ouidah,300000,285367,2022-07-16
TRANSFER,41276,Corinne-Louise Valentin,44836,3560,Roland Garcia,908712,867436,2022-07-16
CASH_IN,130662,Agence_mtn_Ouidah,300000,169338,Corinne-Louise Valentin,3560,134222,2022-07-17
CASH_OUT,117113,Corinne-Louise Valentin,134222,17109,Agence_mtn_Abomey,300000,182887,2022-07-19
CASH_IN,15141,Agence_mtn_Abomey,300000,284859,Corinne-Louise Valentin,17109,32250,2022-07-21
CASH_OUT,31612,Corinne-Louise Valentin,32250,638,Agence_mtn_Cotonou,300000,268388,2022-07-22
TRANSFER,380,Corinne-Louise Valentin,638,258,Hortense Lemaire,234610,234230,2022-07-24
TRANSFER,86925,Philippine Courtois,950091,863166,Corinne-Louise Valentin,258,87183,2022-07-24
CASH_IN,256319,Agence_mtn_Ouidah,300000,43681,Corinne-Louise Valentin,87183,343502,2022-07-25
CASH_OUT,255406,Corinne-Louise Valentin,343502,88096,Agence_mtn_Abomey,300000,44594,2022-07-27
CASH_IN,158990,Agence_mtn_Ouidah,300000,141010,Richard Le Descamps,86,159076,2022-07-06
TRANSFER,909914,Étienne Roche,1006344,96430,Richard Le Descamps,159076,1068990,2022-07-07
TRANSFER,652174,Richard Le Descamps,1068990,416816,Nath Bruneau,14515,-637659,2022-07-08
TRANSFER,48189,Jeanne Garnier,90319,42130,Richard Le Descamps,416816,465005,2022-07-10
CASH_IN,210330,Agence_mtn_Cotonou,300000,89670,Richard Le Descamps,465005,675335,2022-07-11
TRANSFER,39823,Renée David,91786,51963,Richard Le Descamps,675335,715158,2022-07-15
CASH_IN,25755,Agence_mtn_Cotonou,300000,274245,Richard Le Descamps,715158,740913,2022-07-17
TRANSFER,43457,Richard Le Descamps,740913,697456,Hortense Lemaire,234230,190773,2022-07-17
CASH_OUT,236723,Richard Le Descamps,697456,460733,Agence_mtn_Cotonou,300000,63277,2022-07-18
CASH_OUT,48634,Richard Le Descamps,460733,412099,Agence_mtn_Ouidah,300000,251366,2022-07-27
CASH_IN,147076,Agence_mtn_Abomey,300000,152924,Hortense Lemaire,190773,337849,2022-07-02
TRANSFER,937620,Rémy Le Michaud,1071307,133687,Hortense Lemaire,337849,1275469,2022-07-03
CASH_IN,81304,Agence_mtn_Ouidah,300000,218696,Hortense Lemaire,1275469,1356773,2022-07-03
CASH_OUT,12853,Hortense Lemaire,1356773,1343920,Agence_mtn_Abomey,300000,287147,2022-07-04
TRANSFER,219061,Roland Garcia,867436,648375,Hortense Lemaire,1343920,1562981,2022-07-07
CASH_OUT,1064485,Hortense Lemaire,1562981,498496,Agence_mtn_Ouidah,300000,-764485,2022-07-07
CASH_IN,215643,Agence_mtn_Ouidah,300000,84357,Hortense Lemaire,498496,714139,2022-07-08
TRANSFER,33233,Eugène Poulain,45065,11832,Hortense Lemaire,714139,747372,2022-07-10
CASH_IN,266369,Agence_mtn_Cotonou,300000,33631,Hortense Lemaire,747372,1013741,2022-07-19
CASH_OUT,166638,Hortense Lemaire,1013741,847103,Agence_mtn_Abomey,300000,133362,2022-07-19
CASH_IN,135374,Agence_mtn_Abomey,300000,164626,Hortense Lemaire,847103,982477,2022-07-22
CASH_OUT,543489,Hortense Lemaire,982477,438988,Agence_mtn_Cotonou,300000,-243489,2022-07-23
TRANSFER,13616,Astrid Gay de la Brunet,14388,772,Isabelle Rossi,225903,239519,2022-07-01
CASH_IN,277692,Agence_mtn_Cotonou,300000,22308,Isabelle Rossi,239519,517211,2022-07-01
TRANSFER,2265,Claude Foucher,2595,330,Isabelle Rossi,517211,519476,2022-07-02
TRANSFER,342677,Isabelle Rossi,519476,176799,Emmanuelle Georges,932726,590049,2022-07-03
CASH_OUT,110366,Isabelle Rossi,176799,66433,Agence_mtn_Abomey,300000,189634,2022-07-05
CASH_IN,58085,Agence_mtn_Ouidah,300000,241915,Isabelle Rossi,66433,124518,2022-07-05
CASH_IN,128705,Agence_mtn_Ouidah,300000,171295,Isabelle Rossi,124518,253223,2022-07-07
CASH_OUT,22143,Isabelle Rossi,253223,231080,Agence_mtn_Abomey,300000,277857,2022-07-08
CASH_IN,65028,Agence_mtn_Abomey,300000,234972,Isabelle Rossi,231080,296108,2022-07-08
CASH_OUT,170173,Isabelle Rossi,296108,125935,Agence_mtn_Cotonou,300000,129827,2022-07-10
TRANSFER,191373,Adèle Labbé,239025,47652,Isabelle Rossi,125935,317308,2022-07-12
TRANSFER,280531,Isabelle Rossi,317308,36777,Philippine Courtois,863166,582635,2022-07-12
CASH_OUT,7328,Isabelle Rossi,36777,29449,Agence_mtn_Cotonou,300000,292672,2022-07-18
TRANSFER,6120,Xavier Leblanc-Ferreira,24683,18563,Isabelle Rossi,29449,35569,2022-07-21
CASH_OUT,9018,Isabelle Rossi,35569,26551,Agence_mtn_Cotonou,300000,290982,2022-07-22
CASH_OUT,20147,Isabelle Rossi,26551,6404,Agence_mtn_Ouidah,300000,279853,2022-07-25
CASH_IN,25805,Agence_mtn_Abomey,300000,274195,Isabelle Rossi,6404,32209,2022-07-26
CASH_IN,128641,Agence_mtn_Ouidah,300000,171359,Isabelle Rossi,32209,160850,2022-07-27
CASH_IN,269318,Agence_mtn_Cotonou,300000,30682,Léon Lecoq,-259854,9464,2022-07-01
CASH_IN,143889,Agence_mtn_Abomey,300000,156111,Léon Lecoq,9464,153353,2022-07-04
CASH_OUT,87790,Léon Lecoq,153353,65563,Agence_mtn_Abomey,300000,212210,2022-07-04
CASH_OUT,39467,Léon Lecoq,65563,26096,Agence_mtn_Cotonou,300000,260533,2022-07-05
TRANSFER,17321,Léon Lecoq,26096,8775,Raymond Marchal de Nguyen,817593,800272,2022-07-09
TRANSFER,3237,Léon Lecoq,8775,5538,Alexandrie Delmas,7416,4179,2022-07-11
TRANSFER,32371,Étienne Roche,96430,64059,Léon Lecoq,5538,37909,2022-07-11
CASH_IN,112546,Agence_mtn_Ouidah,300000,187454,Léon Lecoq,37909,150455,2022-07-11
CASH_IN,279305,Agence_mtn_Cotonou,300000,20695,Léon Lecoq,150455,429760,2022-07-13
TRANSFER,95363,Roland Garcia,648375,553012,Léon Lecoq,429760,525123,2022-07-14
CASH_IN,212368,Agence_mtn_Cotonou,300000,87632,Léon Lecoq,525123,737491,2022-07-14
CASH_OUT,603131,Léon Lecoq,737491,134360,Agence_mtn_Ouidah,300000,-303131,2022-07-15
CASH_IN,113127,Agence_mtn_Ouidah,300000,186873,Léon Lecoq,134360,247487,2022-07-19
CASH_OUT,178568,Léon Lecoq,247487,68919,Agence_mtn_Abomey,300000,121432,2022-07-21
CASH_IN,351,Agence_mtn_Ouidah,300000,299649,Léon Lecoq,68919,69270,2022-07-23
CASH_OUT,13799,Léon Lecoq,69270,55471,Agence_mtn_Abomey,300000,286201,2022-07-23
CASH_OUT,35338,Léon Lecoq,55471,20133,Agence_mtn_Ouidah,300000,264662,2022-07-25
CASH_IN,120040,Agence_mtn_Abomey,300000,179960,Léon Lecoq,20133,140173,2022-07-26
CASH_IN,67663,Agence_mtn_Cotonou,300000,232337,Léon Lecoq,140173,207836,2022-07-27
CASH_OUT,78827,Rémy Le Michaud,133687,54860,Agence_mtn_Abomey,300000,221173,2022-07-01
TRANSFER,21047,Alix Maillet,29190,8143,Rémy Le Michaud,54860,75907,2022-07-02
CASH_OUT,52364,Rémy Le Michaud,75907,23543,Agence_mtn_Abomey,300000,247636,2022-07-04
CASH_OUT,22365,Rémy Le Michaud,23543,1178,Agence_mtn_Cotonou,300000,277635,2022-07-04
TRANSFER,4195,Alix Maillet,8143,3948,Rémy Le Michaud,1178,5373,2022-07-04
TRANSFER,4407,Rémy Le Michaud,5373,966,Xavier Leblanc-Ferreira,18563,14156,2022-07-05
CASH_IN,152212,Agence_mtn_Ouidah,300000,147788,Rémy Le Michaud,966,153178,2022-07-08
CASH_IN,51747,Agence_mtn_Abomey,300000,248253,Rémy Le Michaud,153178,204925,2022-07-12
CASH_IN,164822,Agence_mtn_Ouidah,300000,135178,Rémy Le Michaud,204925,369747,2022-07-15
CASH_OUT,330740,Rémy Le Michaud,369747,39007,Agence_mtn_Ouidah,300000,-30740,2022-07-17
CASH_OUT,30758,Rémy Le Michaud,39007,8249,Agence_mtn_Cotonou,300000,269242,2022-07-18
CASH_OUT,3913,Rémy Le Michaud,8249,4336,Agence_mtn_Abomey,300000,296087,2022-07-19
TRANSFER,42374,Théodore De Oliveira-Nicolas,74033,31659,Rémy Le Michaud,4336,46710,2022-07-20
CASH_IN,117934,Agence_mtn_Cotonou,300000,182066,Rémy Le Michaud,46710,164644,2022-07-21
TRANSFER,9448,Margot Renaud,37271,27823,Rémy Le Michaud,164644,174092,2022-07-25
CASH_IN,263416,Agence_mtn_Cotonou,300000,36584,Rémy Le Michaud,174092,437508,2022-07-26
TRANSFER,6912,Gabriel-Tristan Marty,9321,2409,Pierre Reynaud,51025,44113,2022-07-01
TRANSFER,12163,Théodore De Oliveira-Nicolas,31659,19496,Gabriel-Tristan Marty,2409,14572,2022-07-06
CASH_IN,262903,Agence_mtn_Cotonou,300000,37097,Gabriel-Tristan Marty,14572,277475,2022-07-06
CASH_OUT,166246,Gabriel-Tristan Marty,277475,111229,Agence_mtn_Ouidah,300000,133754,2022-07-11
CASH_OUT,68614,Gabriel-Tristan Marty,111229,42615,Agence_mtn_Ouidah,300000,231386,2022-07-17
TRANSFER,4793,Gabriel-Tristan Marty,42615,37822,Claude Foucher,330,-4463,2022-07-21
CASH_OUT,17873,Gabriel-Tristan Marty,37822,19949,Agence_mtn_Ouidah,300000,282127,2022-07-23
TRANSFER,727,Astrid Gay de la Brunet,772,45,Gabriel-Tristan Marty,19949,20676,2022-07-25
TRANSFER,1609,Gabriel-Tristan Marty,20676,19067,Geneviève De Oliveira-Michel,56226,54617,2022-07-26
CASH_IN,199221,Agence_mtn_Ouidah,300000,100779,Michelle Lebon,-703634,-504413,2022-07-04
CASH_IN,147972,Agence_mtn_Cotonou,300000,152028,Michelle Lebon,-504413,-356441,2022-07-10
CASH_IN,94756,Agence_mtn_Abomey,300000,205244,Michelle Lebon,-356441,-261685,2022-07-15
CASH_IN,41266,Agence_mtn_Ouidah,300000,258734,Michelle Lebon,-261685,-220419,2022-07-19
CASH_IN,81390,Agence_mtn_Cotonou,300000,218610,Michelle Lebon,-220419,-139029,2022-07-19
CASH_IN,135140,Agence_mtn_Abomey,300000,164860,Michelle Lebon,-139029,-3889,2022-07-21
CASH_IN,299120,Agence_mtn_Cotonou,300000,880,Michelle Lebon,-3889,295231,2022-07-21
CASH_IN,86041,Agence_mtn_Cotonou,300000,213959,Michelle Lebon,295231,381272,2022-07-23
CASH_IN,86537,Agence_mtn_Abomey,300000,213463,Michelle Lebon,381272,467809,2022-07-27
CASH_IN,73381,Agence_mtn_Ouidah,300000,226619,Nathalie Pages,-65339,8042,2022-07-02
CASH_OUT,2489,Nathalie Pages,8042,5553,Agence_mtn_Abomey,300000,297511,2022-07-02
TRANSFER,19978,Jeanne Garnier,42130,22152,Nathalie Pages,5553,25531,2022-07-03
CASH_IN,205454,Agence_mtn_Ouidah,300000,94546,Nathalie Pages,25531,230985,2022-07-04
CASH_OUT,46197,Nathalie Pages,230985,184788,Agence_mtn_Abomey,300000,253803,2022-07-04
TRANSFER,20145,Nathalie Pages,184788,164643,Eugène Poulain,11832,-8313,2022-07-05
CASH_OUT,105640,Nathalie Pages,164643,59003,Agence_mtn_Cotonou,300000,194360,2022-07-08
CASH_OUT,40766,Nathalie Pages,59003,18237,Agence_mtn_Abomey,300000,259234,2022-07-09
TRANSFER,16561,Nathalie Pages,18237,1676,Philippine Courtois,582635,566074,2022-07-10
TRANSFER,30093,Renée David,51963,21870,Nathalie Pages,1676,31769,2022-07-12
TRANSFER,11215,Nathalie Pages,31769,20554,Pierre Roger,422209,410994,2022-07-13
CASH_OUT,11254,Nathalie Pages,20554,9300,Agence_mtn_Abomey,300000,288746,2022-07-13
CASH_OUT,4457,Nathalie Pages,9300,4843,Agence_mtn_Abomey,300000,295543,2022-07-14
CASH_OUT,3791,Nathalie Pages,4843,1052,Agence_mtn_Ouidah,300000,296209,2022-07-16
CASH_OUT,624,Nathalie Pages,1052,428,Agence_mtn_Cotonou,300000,299376,2022-07-16
CASH_IN,204375,Agence_mtn_Abomey,300000,95625,Nathalie Pages,428,204803,2022-07-19
CASH_IN,161356,Agence_mtn_Ouidah,300000,138644,Nathalie Pages,204803,366159,2022-07-23
TRANSFER,5506,Benjamin Evrard-Marty,74913,69407,Nathalie Pages,366159,371665,2022-07-24
CASH_OUT,72687,Nathalie Pages,371665,298978,Agence_mtn_Abomey,300000,227313,2022-07-27
CASH_IN,274986,Agence_mtn_Cotonou,300000,25014,Emmanuelle Georges,590049,865035,2022-07-01
TRANSFER,55118,Étienne Roche,64059,8941,Emmanuelle Georges,865035,920153,2022-07-03
CASH_IN,182546,Agence_mtn_Abomey,300000,117454,Emmanuelle Georges,920153,1102699,2022-07-06
TRANSFER,1321,Bertrand Charles,39500,38179,Emmanuelle Georges,1102699,1104020,2022-07-08
CASH_OUT,846401,Emmanuelle Georges,1104020,257619,Agence_mtn_Ouidah,300000,-546401,2022-07-10
CASH_OUT,161090,Emmanuelle Georges,257619,96529,Agence_mtn_Cotonou,300000,138910,2022-07-11
CASH_OUT,75635,Emmanuelle Georges,96529,20894,Agence_mtn_Abomey,300000,224365,2022-07-15
CASH_IN,152474,Agence_mtn_Abomey,300000,147526,Emmanuelle Georges,20894,173368,2022-07-21
CASH_IN,98192,Agence_mtn_Abomey,300000,201808,Emmanuelle Georges,173368,271560,2022-07-22
TRANSFER,60939,Emmanuelle Georges,271560,210621,Philippine Courtois,566074,505135,2022-07-22
CASH_IN,221980,Agence_mtn_Cotonou,300000,78020,Emmanuelle Georges,210621,432601,2022-07-25
TRANSFER,31093,Geneviève De Oliveira-Michel,54617,23524,Jeanne Garnier,22152,53245,2022-07-03
CASH_OUT,35295,Jeanne Garnier,53245,17950,Agence_mtn_Abomey,300000,264705,2022-07-05
CASH_IN,285234,Agence_mtn_Abomey,300000,14766,Jeanne Garnier,17950,303184,2022-07-07
CASH_OUT,262364,Jeanne Garnier,303184,40820,Agence_mtn_Abomey,300000,37636,2022-07-10
TRANSFER,302672,Philippine Courtois,505135,202463,Jeanne Garnier,40820,343492,2022-07-11
TRANSFER,33163,Adèle Labbé,47652,14489,Jeanne Garnier,343492,376655,2022-07-13
CASH_OUT,53114,Jeanne Garnier,376655,323541,Agence_mtn_Cotonou,300000,246886,2022-07-14
CASH_OUT,323004,Jeanne Garnier,323541,537,Agence_mtn_Cotonou,300000,-23004,2022-07-18
CASH_IN,208170,Agence_mtn_Cotonou,300000,91830,Jeanne Garnier,537,208707,2022-07-19
TRANSFER,96693,Jeanne Garnier,208707,112014,Étienne Roche,8941,-87752,2022-07-20
TRANSFER,43821,Jeanne Garnier,112014,68193,Roland Garcia,553012,509191,2022-07-22
TRANSFER,190853,Cécile Germain,192480,1627,Jeanne Garnier,68193,259046,2022-07-22
CASH_IN,131038,Agence_mtn_Abomey,300000,168962,Jeanne Garnier,259046,390084,2022-07-22
CASH_IN,221039,Agence_mtn_Cotonou,300000,78961,Jeanne Garnier,390084,611123,2022-07-23
CASH_OUT,396655,Jeanne Garnier,611123,214468,Agence_mtn_Ouidah,300000,-96655,2022-07-24
CASH_IN,232635,Agence_mtn_Ouidah,300000,67365,Édouard Nguyen,275517,508152,2022-07-01
CASH_OUT,388640,Édouard Nguyen,508152,119512,Agence_mtn_Abomey,300000,-88640,2022-07-02
TRANSFER,92825,Édouard Nguyen,119512,26687,Alexandrie Delmas,4179,-88646,2022-07-04
TRANSFER,26199,Pierre Reynaud,44113,17914,Édouard Nguyen,26687,52886,2022-07-05
TRANSFER,32620,Édouard Nguyen,52886,20266,Pénélope Dupuis,264478,231858,2022-07-06
TRANSFER,3634,Édouard Nguyen,20266,16632,Cécile Germain,1627,-2007,2022-07-07
CASH_IN,198234,Agence_mtn_Ouidah,300000,101766,Édouard Nguyen,16632,214866,2022-07-07
CASH_OUT,130317,Édouard Nguyen,214866,84549,Agence_mtn_Abomey,300000,169683,2022-07-07
TRANSFER,13317,Gilbert Foucher,23499,10182,Édouard Nguyen,84549,97866,2022-07-14
CASH_IN,50768,Agence_mtn_Ouidah,300000,249232,Édouard Nguyen,97866,148634,2022-07-14
TRANSFER,35821,Édouard Nguyen,148634,112813,Pierre Reynaud,17914,-17907,2022-07-16
CASH_OUT,59997,Édouard Nguyen,112813,52816,Agence_mtn_Cotonou,300000,240003,2022-07-17
TRANSFER,46683,Édouard Nguyen,52816,6133,Margot Renaud,27823,-18860,2022-07-17
CASH_IN,103446,Agence_mtn_Ouidah,300000,196554,Édouard Nguyen,6133,109579,2022-07-18
CASH_OUT,27192,Édouard Nguyen,109579,82387,Agence_mtn_Ouidah,300000,272808,2022-07-21
TRANSFER,53394,Édouard Nguyen,82387,28993,Bertrand Charles,38179,-15215,2022-07-21
CASH_IN,118537,Agence_mtn_Ouidah,300000,181463,Édouard Nguyen,28993,147530,2022-07-23
CASH_IN,8605,Agence_mtn_Cotonou,300000,291395,Édouard Nguyen,147530,156135,2022-07-27
TRANSFER,139716,Valentine Richard-Bourdon,150467,10751,Geneviève De Oliveira-Michel,23524,163240,2022-07-03
CASH_OUT,90166,Geneviève De Oliveira-Michel,163240,73074,Agence_mtn_Cotonou,300000,209834,2022-07-05
CASH_IN,69092,Agence_mtn_Ouidah,300000,230908,Geneviève De Oliveira-Michel,73074,142166,2022-07-08
CASH_OUT,33240,Geneviève De Oliveira-Michel,142166,108926,Agence_mtn_Cotonou,300000,266760,2022-07-16
CASH_IN,57969,Agence_mtn_Cotonou,300000,242031,Geneviève De Oliveira-Michel,108926,166895,2022-07-22
CASH_OUT,98433,Geneviève De Oliveira-Michel,166895,68462,Agence_mtn_Abomey,300000,201567,2022-07-24
TRANSFER,2357,Geneviève De Oliveira-Michel,68462,66105,Pénélope Dupuis,231858,229501,2022-07-25
CASH_OUT,19613,Geneviève De Oliveira-Michel,66105,46492,Agence_mtn_Ouidah,300000,280387,2022-07-25
TRANSFER,315069,Pierre Roger,410994,95925,Geneviève De Oliveira-Michel,46492,361561,2022-07-25
CASH_IN,15939,Agence_mtn_Ouidah,300000,284061,Valérie Dijoux,-34206,-18267,2022-07-01
CASH_IN,261724,Agence_mtn_Abomey,300000,38276,Valérie Dijoux,-18267,243457,2022-07-02
TRANSFER,78212,Pierre Roger,95925,17713,Valérie Dijoux,243457,321669,2022-07-04
CASH_OUT,23226,Valérie Dijoux,321669,298443,Agence_mtn_Abomey,300000,276774,2022-07-04
CASH_OUT,283430,Valérie Dijoux,298443,15013,Agence_mtn_Cotonou,300000,16570,2022-07-10
CASH_OUT,6120,Valérie Dijoux,15013,8893,Agence_mtn_Abomey,300000,293880,2022-07-10
CASH_IN,119577,Agence_mtn_Cotonou,300000,180423,Valérie Dijoux,8893,128470,2022-07-11
CASH_OUT,99588,Valérie Dijoux,128470,28882,Agence_mtn_Abomey,300000,200412,2022-07-12
CASH_IN,254877,Agence_mtn_Ouidah,300000,45123,Valérie Dijoux,28882,283759,2022-07-16
TRANSFER,243,Adèle Labbé,14489,14246,Valérie Dijoux,283759,284002,2022-07-21
CASH_OUT,108549,Valérie Dijoux,284002,175453,Agence_mtn_Abomey,300000,191451,2022-07-22
CASH_IN,120095,Agence_mtn_Cotonou,300000,179905,Valérie Dijoux,175453,295548,2022-07-23
TRANSFER,17817,Théodore De Oliveira-Nicolas,19496,1679,Valérie Dijoux,295548,313365,2022-07-23
CASH_IN,34369,Agence_mtn_Cotonou,300000,265631,Valérie Dijoux,313365,347734,2022-07-24
TRANSFER,143911,Philippine Courtois,202463,58552,Valérie Dijoux,347734,491645,2022-07-25
CASH_IN,76736,Agence_mtn_Ouidah,300000,223264,Bertrand Charles,-15215,61521,2022-07-01
CASH_OUT,33090,Bertrand Charles,61521,28431,Agence_mtn_Abomey,300000,266910,2022-07-06
CASH_OUT,8682,Bertrand Charles,28431,19749,Agence_mtn_Abomey,300000,291318,2022-07-06
TRANSFER,43963,Benjamin Evrard-Marty,69407,25444,Bertrand Charles,19749,63712,2022-07-09
TRANSFER,15706,Pierre Roger,17713,2007,Bertrand Charles,63712,79418,2022-07-10
TRANSFER,79166,Bertrand Charles,79418,252,Roland Garcia,509191,430025,2022-07-10
CASH_OUT,153,Bertrand Charles,252,99,Agence_mtn_Cotonou,300000,299847,2022-07-11
CASH_IN,140294,Agence_mtn_Ouidah,300000,159706,Bertrand Charles,99,140393,2022-07-12
CASH_OUT,21296,Bertrand Charles,140393,119097,Agence_mtn_Cotonou,300000,278704,2022-07-12
CASH_OUT,31292,Bertrand Charles,119097,87805,Agence_mtn_Cotonou,300000,268708,2022-07-22
CASH_OUT,5816,Bertrand Charles,87805,81989,Agence_mtn_Cotonou,300000,294184,2022-07-22
CASH_IN,265606,Agence_mtn_Ouidah,300000,34394,Bertrand Charles,81989,347595,2022-07-23
CASH_IN,472,Agence_mtn_Cotonou,300000,299528,Bertrand Charles,347595,348067,2022-07-25
CASH_OUT,151413,Bertrand Charles,348067,196654,Agence_mtn_Abomey,300000,148587,2022-07-26
CASH_IN,258771,Agence_mtn_Cotonou,300000,41229,Eugène Poulain,-8313,250458,2022-07-01
CASH_IN,10212,Agence_mtn_Cotonou,300000,289788,Eugène Poulain,250458,260670,2022-07-04
CASH_IN,111341,Agence_mtn_Ouidah,300000,188659,Eugène Poulain,260670,372011,2022-07-06
CASH_OUT,72654,Eugène Poulain,372011,299357,Agence_mtn_Abomey,300000,227346,2022-07-07
CASH_IN,122503,Agence_mtn_Ouidah,300000,177497,Eugène Poulain,299357,421860,2022-07-07
CASH_OUT,165056,Eugène Poulain,421860,256804,Agence_mtn_Abomey,300000,134944,2022-07-07
CASH_IN,293317,Agence_mtn_Cotonou,300000,6683,Eugène Poulain,256804,550121,2022-07-10
CASH_IN,69883,Agence_mtn_Abomey,300000,230117,Eugène Poulain,550121,620004,2022-07-11
TRANSFER,151668,Éléonore-Hélène Dubois,447122,295454,Eugène Poulain,620004,771672,2022-07-13
CASH_IN,50576,Agence_mtn_Ouidah,300000,249424,Eugène Poulain,771672,822248,2022-07-13
CASH_IN,205290,Agence_mtn_Cotonou,300000,94710,Eugène Poulain,822248,1027538,2022-07-15
TRANSFER,404778,Eugène Poulain,1027538,622760,Gilbert Foucher,10182,-394596,2022-07-17
TRANSFER,147049,Eugène Poulain,622760,475711,Pénélope Dupuis,229501,82452,2022-07-19
CASH_IN,109757,Agence_mtn_Abomey,300000,190243,Eugène Poulain,475711,585468,2022-07-20
CASH_OUT,108057,Eugène Poulain,585468,477411,Agence_mtn_Abomey,300000,191943,2022-07-23
CASH_IN,279839,Agence_mtn_Cotonou,300000,20161,Eugène Poulain,477411,757250,2022-07-24
CASH_OUT,189759,Eugène Poulain,757250,567491,Agence_mtn_Cotonou,300000,110241,2022-07-24
CASH_IN,174938,Agence_mtn_Ouidah,300000,125062,Eugène Poulain,567491,742429,2022-07-25
CASH_IN,141561,Agence_mtn_Ouidah,300000,158439,Sophie Gonzalez,-180078,-38517,2022-07-03
CASH_IN,178378,Agence_mtn_Abomey,300000,121622,Sophie Gonzalez,-38517,139861,2022-07-04
TRANSFER,253050,Éléonore-Hélène Dubois,295454,42404,Sophie Gonzalez,139861,392911,2022-07-04
CASH_OUT,635,Sophie Gonzalez,392911,392276,Agence_mtn_Ouidah,300000,299365,2022-07-04
TRANSFER,81228,Pénélope Dupuis,82452,1224,Sophie Gonzalez,392276,473504,2022-07-05
CASH_OUT,213599,Sophie Gonzalez,473504,259905,Agence_mtn_Ouidah,300000,86401,2022-07-06
CASH_OUT,38777,Sophie Gonzalez,259905,221128,Agence_mtn_Abomey,300000,261223,2022-07-08
CASH_IN,166977,Agence_mtn_Ouidah,300000,133023,Sophie Gonzalez,221128,388105,2022-07-08
CASH_OUT,284670,Sophie Gonzalez,388105,103435,Agence_mtn_Abomey,300000,15330,2022-07-10
CASH_OUT,9362,Sophie Gonzalez,103435,94073,Agence_mtn_Abomey,300000,290638,2022-07-12
TRANSFER,57492,Sophie Gonzalez,94073,36581,Éléonore-Hélène Dubois,42404,-15088,2022-07-16
TRANSFER,225022,Roland Garcia,430025,205003,Sophie Gonzalez,36581,261603,2022-07-18
CASH_IN,13479,Agence_mtn_Ouidah,300000,286521,Sophie Gonzalez,261603,275082,2022-07-19
CASH_IN,141476,Agence_mtn_Abomey,300000,158524,Sophie Gonzalez,275082,416558,2022-07-19
CASH_OUT,369426,Sophie Gonzalez,416558,47132,Agence_mtn_Ouidah,300000,-69426,2022-07-22
TRANSFER,10076,Philippine Courtois,58552,48476,Sophie Gonzalez,47132,57208,2022-07-22
TRANSFER,203559,Roland Garcia,205003,1444,Sophie Gonzalez,57208,260767,2022-07-24
TRANSFER,375879,Raymond Marchal de Nguyen,800272,424393,Sophie Gonzalez,260767,636646,2022-07-25
CASH_IN,189898,Agence_mtn_Abomey,300000,110102,Marine Chauvet-Potier,-332765,-142867,2022-07-01
CASH_IN,220766,Agence_mtn_Cotonou,300000,79234,Marine Chauvet-Potier,-142867,77899,2022-07-01
CASH_OUT,23887,Marine Chauvet-Potier,77899,54012,Agence_mtn_Ouidah,300000,276113,2022-07-02
CASH_IN,182202,Agence_mtn_Ouidah,300000,117798,Marine Chauvet-Potier,54012,236214,2022-07-05
CASH_OUT,199312,Marine Chauvet-Potier,236214,36902,Agence_mtn_Ouidah,300000,100688,2022-07-07
CASH_OUT,15625,Marine Chauvet-Potier,36902,21277,Agence_mtn_Abomey,300000,284375,2022-07-07
CASH_IN,150905,Agence_mtn_Abomey,300000,149095,Marine Chauvet-Potier,21277,172182,2022-07-08
TRANSFER,31327,Philippine Courtois,48476,17149,Marine Chauvet-Potier,172182,203509,2022-07-10
TRANSFER,104545,Marine Chauvet-Potier,203509,98964,Marine Chauvet-Potier,203509,98964,2022-07-10
TRANSFER,96443,Marine Chauvet-Potier,98964,2521,Benjamin Evrard-Marty,25444,-70999,2022-07-10
CASH_OUT,1804,Marine Chauvet-Potier,2521,717,Agence_mtn_Abomey,300000,298196,2022-07-13
TRANSFER,220,Marine Chauvet-Potier,717,497,Pénélope Dupuis,1224,1004,2022-07-15
TRANSFER,463,Marine Chauvet-Potier,497,34,Philippine Courtois,17149,16686,2022-07-18
CASH_IN,81248,Agence_mtn_Cotonou,300000,218752,Marine Chauvet-Potier,34,81282,2022-07-18
TRANSFER,77209,Marine Chauvet-Potier,81282,4073,Pénélope Dupuis,1004,-76205,2022-07-21
TRANSFER,204,Marine Chauvet-Potier,4073,3869,Théodore De Oliveira-Nicolas,1679,1475,2022-07-23
TRANSFER,688,Marine Chauvet-Potier,3869,3181,Alix Maillet,3948,3260,2022-07-25
CASH_IN,101009,Agence_mtn_Cotonou,300000,198991,Marine Chauvet-Potier,3181,104190,2022-07-26
CASH_OUT,55061,Marine Chauvet-Potier,104190,49129,Agence_mtn_Cotonou,300000,244939,2022-07-26
TRANSFER,2718,Alix Maillet,3260,542,Marine Chauvet-Potier,49129,51847,2022-07-27
CASH_IN,136425,Agence_mtn_Abomey,300000,163575,Cécile Germain,-2007,134418,2022-07-01
TRANSFER,3727,Cécile Germain,134418,130691,Cécile Germain,134418,130691,2022-07-03
CASH_IN,299737,Agence_mtn_Abomey,300000,263,Cécile Germain,130691,430428,2022-07-04
TRANSFER,207879,Cécile Germain,430428,222549,Valentine Richard-Bourdon,10751,-197128,2022-07-06
CASH_IN,5932,Agence_mtn_Abomey,300000,294068,Cécile Germain,222549,228481,2022-07-08
TRANSFER,133333,Cécile Germain,228481,95148,Renée David,21870,-111463,2022-07-13
CASH_IN,196051,Agence_mtn_Abomey,300000,103949,Cécile Germain,95148,291199,2022-07-20
CASH_OUT,8374,Cécile Germain,291199,282825,Agence_mtn_Abomey,300000,291626,2022-07-24
CASH_IN,237782,Agence_mtn_Ouidah,300000,62218,Cécile Germain,282825,520607,2022-07-26
CASH_OUT,442018,Cécile Germain,520607,78589,Agence_mtn_Cotonou,300000,-142018,2022-07-26
TRANSFER,1294,Théodore De Oliveira-Nicolas,1475,181,Cécile Germain,78589,79883,2022-07-26
CASH_IN,49730,Agence_mtn_Ouidah,300000,250270,Astrid Gay de la Brunet,45,49775,2022-07-01
CASH_OUT,16847,Astrid Gay de la Brunet,49775,32928,Agence_mtn_Abomey,300000,283153,2022-07-03
TRANSFER,1323,Astrid Gay de la Brunet,32928,31605,Adèle Labbé,14246,12923,2022-07-03
CASH_OUT,27103,Astrid Gay de la Brunet,31605,4502,Agence_mtn_Cotonou,300000,272897,2022-07-04
CASH_OUT,1166,Astrid Gay de la Brunet,4502,3336,Agence_mtn_Abomey,300000,298834,2022-07-05
CASH_OUT,2393,Astrid Gay de la Brunet,3336,943,Agence_mtn_Ouidah,300000,297607,2022-07-06
TRANSFER,274496,Raymond Marchal de Nguyen,424393,149897,Astrid Gay de la Brunet,943,275439,2022-07-08
CASH_OUT,247306,Astrid Gay de la Brunet,275439,28133,Agence_mtn_Abomey,300000,52694,2022-07-12
TRANSFER,20889,Astrid Gay de la Brunet,28133,7244,Adèle Labbé,12923,-7966,2022-07-12
CASH_OUT,800,Astrid Gay de la Brunet,7244,6444,Agence_mtn_Ouidah,300000,299200,2022-07-14
CASH_IN,183557,Agence_mtn_Cotonou,300000,116443,Astrid Gay de la Brunet,6444,190001,2022-07-19
CASH_IN,38610,Agence_mtn_Abomey,300000,261390,Astrid Gay de la Brunet,190001,228611,2022-07-19
CASH_IN,39293,Agence_mtn_Abomey,300000,260707,Astrid Gay de la Brunet,228611,267904,2022-07-22
CASH_OUT,25071,Astrid Gay de la Brunet,267904,242833,Agence_mtn_Cotonou,300000,274929,2022-07-22
CASH_OUT,229711,Astrid Gay de la Brunet,242833,13122,Agence_mtn_Abomey,300000,70289,2022-07-22
CASH_IN,185976,Agence_mtn_Abomey,300000,114024,Astrid Gay de la Brunet,13122,199098,2022-07-23
TRANSFER,82718,Astrid Gay de la Brunet,199098,116380,Philippine Courtois,16686,-66032,2022-07-27
CASH_IN,190497,Agence_mtn_Ouidah,300000,109503,Alix Maillet,542,191039,2022-07-01
CASH_IN,237785,Agence_mtn_Abomey,300000,62215,Alix Maillet,191039,428824,2022-07-06
CASH_IN,91293,Agence_mtn_Cotonou,300000,208707,Alix Maillet,428824,520117,2022-07-08
TRANSFER,34719,Raymond Marchal de Nguyen,149897,115178,Alix Maillet,520117,554836,2022-07-08
CASH_IN,13838,Agence_mtn_Abomey,300000,286162,Alix Maillet,554836,568674,2022-07-09
CASH_IN,90361,Agence_mtn_Ouidah,300000,209639,Alix Maillet,568674,659035,2022-07-10
CASH_OUT,140183,Alix Maillet,659035,518852,Agence_mtn_Ouidah,300000,159817,2022-07-15
CASH_OUT,29028,Alix Maillet,518852,489824,Agence_mtn_Ouidah,300000,270972,2022-07-15
CASH_IN,106264,Agence_mtn_Cotonou,300000,193736,Alix Maillet,489824,596088,2022-07-20
TRANSFER,111,Théodore De Oliveira-Nicolas,181,70,Alix Maillet,596088,596199,2022-07-26
TRANSFER,202874,Alix Maillet,596199,393325,Raymond Marchal de Nguyen,115178,-87696,2022-07-26
CASH_IN,3892,Agence_mtn_Cotonou,300000,296108,Adèle Labbé,-7966,-4074,2022-07-02
CASH_IN,92472,Agence_mtn_Abomey,300000,207528,Adèle Labbé,-4074,88398,2022-07-03
TRANSFER,23715,Adèle Labbé,88398,64683,Adèle Labbé,88398,64683,2022-07-04
TRANSFER,32970,Adèle Labbé,64683,31713,Adèle Labbé,64683,97653,2022-07-05
CASH_OUT,14131,Adèle Labbé,31713,17582,Agence_mtn_Cotonou,300000,285869,2022-07-07
TRANSFER,10780,Adèle Labbé,17582,6802,Adèle Labbé,17582,28362,2022-07-08
CASH_IN,85679,Agence_mtn_Cotonou,300000,214321,Adèle Labbé,6802,92481,2022-07-08
CASH_IN,62004,Agence_mtn_Ouidah,300000,237996,Adèle Labbé,92481,154485,2022-07-09
TRANSFER,46235,Adèle Labbé,154485,108250,Adèle Labbé,154485,200720,2022-07-10
CASH_IN,84500,Agence_mtn_Cotonou,300000,215500,Adèle Labbé,108250,192750,2022-07-12
CASH_IN,232676,Agence_mtn_Abomey,300000,67324,Adèle Labbé,192750,425426,2022-07-14
CASH_OUT,246199,Adèle Labbé,425426,179227,Agence_mtn_Abomey,300000,53801,2022-07-19
CASH_IN,275525,Agence_mtn_Cotonou,300000,24475,Adèle Labbé,179227,454752,2022-07-21
CASH_OUT,400516,Adèle Labbé,454752,54236,Agence_mtn_Ouidah,300000,-100516,2022-07-23
CASH_OUT,46617,Adèle Labbé,54236,7619,Agence_mtn_Cotonou,300000,253383,2022-07-26
CASH_IN,163479,Agence_mtn_Ouidah,300000,136521,Benjamin Evrard-Marty,-70999,92480,2022-07-01
CASH_OUT,22263,Benjamin Evrard-Marty,92480,70217,Agence_mtn_Cotonou,300000,277737,2022-07-01
CASH_OUT,65618,Benjamin Evrard-Marty,70217,4599,Agence_mtn_Ouidah,300000,234382,2022-07-02
CASH_IN,155085,Agence_mtn_Cotonou,300000,144915,Benjamin Evrard-Marty,4599,159684,2022-07-05
CASH_OUT,29397,Benjamin Evrard-Marty,159684,130287,Agence_mtn_Ouidah,300000,270603,2022-07-11
TRANSFER,129852,Benjamin Evrard-Marty,130287,435,Benjamin Evrard-Marty,130287,435,2022-07-13
CASH_OUT,295,Benjamin Evrard-Marty,435,140,Agence_mtn_Cotonou,300000,299705,2022-07-14
CASH_IN,265304,Agence_mtn_Ouidah,300000,34696,Benjamin Evrard-Marty,140,265444,2022-07-17
CASH_OUT,136743,Benjamin Evrard-Marty,265444,128701,Agence_mtn_Abomey,300000,163257,2022-07-17
CASH_IN,20076,Agence_mtn_Ouidah,300000,279924,Benjamin Evrard-Marty,128701,148777,2022-07-18
CASH_OUT,103965,Benjamin Evrard-Marty,148777,44812,Agence_mtn_Ouidah,300000,196035,2022-07-20
CASH_OUT,37609,Benjamin Evrard-Marty,44812,7203,Agence_mtn_Ouidah,300000,262391,2022-07-22
CASH_IN,147235,Agence_mtn_Abomey,300000,152765,Raymond Marchal de Nguyen,-87696,59539,2022-07-01
TRANSFER,30293,Raymond Marchal de Nguyen,59539,29246,Raymond Marchal de Nguyen,59539,89832,2022-07-02
CASH_IN,42477,Agence_mtn_Abomey,300000,257523,Raymond Marchal de Nguyen,29246,71723,2022-07-04
CASH_OUT,54439,Raymond Marchal de Nguyen,71723,17284,Agence_mtn_Abomey,300000,245561,2022-07-08
CASH_IN,48452,Agence_mtn_Cotonou,300000,251548,Raymond Marchal de Nguyen,17284,65736,2022-07-17
CASH_IN,286095,Agence_mtn_Ouidah,300000,13905,Raymond Marchal de Nguyen,65736,351831,2022-07-18
CASH_IN,263368,Agence_mtn_Ouidah,300000,36632,Raymond Marchal de Nguyen,351831,615199,2022-07-22
CASH_OUT,253690,Raymond Marchal de Nguyen,615199,361509,Agence_mtn_Ouidah,300000,46310,2022-07-24
CASH_IN,282740,Agence_mtn_Abomey,300000,17260,Théodore De Oliveira-Nicolas,70,282810,2022-07-02
CASH_IN,131098,Agence_mtn_Abomey,300000,168902,Théodore De Oliveira-Nicolas,282810,413908,2022-07-06
CASH_IN,289242,Agence_mtn_Cotonou,300000,10758,Théodore De Oliveira-Nicolas,413908,703150,2022-07-06
CASH_IN,163355,Agence_mtn_Ouidah,300000,136645,Théodore De Oliveira-Nicolas,703150,866505,2022-07-07
CASH_IN,208017,Agence_mtn_Ouidah,300000,91983,Théodore De Oliveira-Nicolas,866505,1074522,2022-07-07
CASH_IN,71967,Agence_mtn_Abomey,300000,228033,Théodore De Oliveira-Nicolas,1074522,1146489,2022-07-10
CASH_OUT,827936,Théodore De Oliveira-Nicolas,1146489,318553,Agence_mtn_Ouidah,300000,-527936,2022-07-11
CASH_IN,154190,Agence_mtn_Cotonou,300000,145810,Théodore De Oliveira-Nicolas,318553,472743,2022-07-15
CASH_OUT,199129,Théodore De Oliveira-Nicolas,472743,273614,Agence_mtn_Abomey,300000,100871,2022-07-19
CASH_OUT,179819,Théodore De Oliveira-Nicolas,273614,93795,Agence_mtn_Ouidah,300000,120181,2022-07-22
CASH_OUT,76734,Théodore De Oliveira-Nicolas,93795,17061,Agence_mtn_Abomey,300000,223266,2022-07-24
CASH_OUT,16753,Théodore De Oliveira-Nicolas,17061,308,Agence_mtn_Ouidah,300000,283247,2022-07-27
CASH_IN,100904,Agence_mtn_Abomey,300000,199096,Louis Pichon,-1407336,-1306432,2022-07-01
CASH_IN,79209,Agence_mtn_Cotonou,300000,220791,Louis Pichon,-1306432,-1227223,2022-07-01
CASH_IN,247091,Agence_mtn_Cotonou,300000,52909,Louis Pichon,-1227223,-980132,2022-07-06
CASH_IN,205181,Agence_mtn_Cotonou,300000,94819,Louis Pichon,-980132,-774951,2022-07-07
CASH_IN,1096,Agence_mtn_Cotonou,300000,298904,Louis Pichon,-774951,-773855,2022-07-08
CASH_IN,221475,Agence_mtn_Cotonou,300000,78525,Louis Pichon,-773855,-552380,2022-07-08
CASH_IN,240715,Agence_mtn_Ouidah,300000,59285,Louis Pichon,-552380,-311665,2022-07-08
CASH_IN,12956,Agence_mtn_Abomey,300000,287044,Louis Pichon,-311665,-298709,2022-07-11
CASH_IN,285716,Agence_mtn_Cotonou,300000,14284,Louis Pichon,-298709,-12993,2022-07-11
CASH_IN,4219,Agence_mtn_Abomey,300000,295781,Louis Pichon,-12993,-8774,2022-07-17
CASH_IN,199110,Agence_mtn_Abomey,300000,100890,Louis Pichon,-8774,190336,2022-07-18
CASH_IN,4692,Agence_mtn_Abomey,300000,295308,Louis Pichon,190336,195028,2022-07-20
CASH_OUT,80290,Louis Pichon,195028,114738,Agence_mtn_Ouidah,300000,219710,2022-07-21
CASH_IN,279139,Agence_mtn_Ouidah,300000,20861,Louis Pichon,114738,393877,2022-07-22
CASH_OUT,69095,Louis Pichon,393877,324782,Agence_mtn_Ouidah,300000,230905,2022-07-22
CASH_IN,160403,Agence_mtn_Ouidah,300000,139597,Louis Pichon,324782,485185,2022-07-25
CASH_IN,272348,Agence_mtn_Cotonou,300000,27652,Louis Pichon,485185,757533,2022-07-27
CASH_IN,239988,Agence_mtn_Abomey,300000,60012,Alexandre Rémy,-175118,64870,2022-07-01
CASH_OUT,26010,Alexandre Rémy,64870,38860,Agence_mtn_Abomey,300000,273990,2022-07-01
CASH_OUT,18281,Alexandre Rémy,38860,20579,Agence_mtn_Ouidah,300000,281719,2022-07-02
CASH_IN,124443,Agence_mtn_Cotonou,300000,175557,Alexandre Rémy,20579,145022,2022-07-03
TRANSFER,52173,Alexandre Rémy,145022,92849,Alexandre Rémy,145022,197195,2022-07-05
CASH_IN,97905,Agence_mtn_Abomey,300000,202095,Alexandre Rémy,92849,190754,2022-07-06
CASH_OUT,51568,Alexandre Rémy,190754,139186,Agence_mtn_Abomey,300000,248432,2022-07-07
CASH_IN,215756,Agence_mtn_Abomey,300000,84244,Alexandre Rémy,139186,354942,2022-07-07
CASH_IN,288514,Agence_mtn_Ouidah,300000,11486,Alexandre Rémy,354942,643456,2022-07-10
TRANSFER,131113,Alexandre Rémy,643456,512343,Alexandre Rémy,643456,512343,2022-07-13
CASH_OUT,266034,Alexandre Rémy,512343,246309,Agence_mtn_Ouidah,300000,33966,2022-07-19
CASH_IN,115646,Agence_mtn_Ouidah,300000,184354,Alexandre Rémy,246309,361955,2022-07-22
CASH_IN,131135,Agence_mtn_Abomey,300000,168865,Alexandre Rémy,361955,493090,2022-07-25
CASH_OUT,366507,Alexandre Rémy,493090,126583,Agence_mtn_Abomey,300000,-66507,2022-07-27
CASH_IN,238467,Agence_mtn_Cotonou,300000,61533,Gilbert-Charles Thibault,-268223,-29756,2022-07-01
CASH_IN,269522,Agence_mtn_Cotonou,300000,30478,Gilbert-Charles Thibault,-29756,239766,2022-07-03
CASH_OUT,137515,Gilbert-Charles Thibault,239766,102251,Agence_mtn_Abomey,300000,162485,2022-07-04
CASH_IN,141134,Agence_mtn_Cotonou,300000,158866,Gilbert-Charles Thibault,102251,243385,2022-07-04
CASH_OUT,10053,Gilbert-Charles Thibault,243385,233332,Agence_mtn_Ouidah,300000,289947,2022-07-09
TRANSFER,54001,Gilbert-Charles Thibault,233332,179331,Gilbert-Charles Thibault,233332,179331,2022-07-10
TRANSFER,1838,Gilbert-Charles Thibault,179331,177493,Gilbert-Charles Thibault,179331,181169,2022-07-12
CASH_IN,271231,Agence_mtn_Abomey,300000,28769,Gilbert-Charles Thibault,177493,448724,2022-07-12
CASH_IN,6377,Agence_mtn_Cotonou,300000,293623,Gilbert-Charles Thibault,448724,455101,2022-07-13
CASH_OUT,292835,Gilbert-Charles Thibault,455101,162266,Agence_mtn_Abomey,300000,7165,2022-07-15
TRANSFER,121597,Gilbert-Charles Thibault,162266,40669,Gilbert-Charles Thibault,162266,40669,2022-07-15
CASH_OUT,34793,Gilbert-Charles Thibault,40669,5876,Agence_mtn_Cotonou,300000,265207,2022-07-18
CASH_IN,288011,Agence_mtn_Abomey,300000,11989,Gilbert-Charles Thibault,5876,293887,2022-07-20
CASH_IN,56866,Agence_mtn_Cotonou,300000,243134,Gilbert-Charles Thibault,293887,350753,2022-07-21
CASH_IN,160145,Agence_mtn_Cotonou,300000,139855,Gilbert-Charles Thibault,350753,510898,2022-07-23
CASH_IN,41389,Agence_mtn_Ouidah,300000,258611,Gilbert-Charles Thibault,510898,552287,2022-07-24
CASH_OUT,318182,Gilbert-Charles Thibault,552287,234105,Agence_mtn_Ouidah,300000,-18182,2022-07-25
CASH_OUT,166429,Gilbert-Charles Thibault,234105,67676,Agence_mtn_Cotonou,300000,133571,2022-07-25
CASH_OUT,61355,Gilbert-Charles Thibault,67676,6321,Agence_mtn_Abomey,300000,238645,2022-07-25
CASH_IN,69782,Agence_mtn_Ouidah,300000,230218,Gilbert-Charles Thibault,6321,76103,2022-07-27
CASH_IN,160168,Agence_mtn_Cotonou,300000,139832,Vincent Fournier,-168248,-8080,2022-07-01
CASH_IN,7343,Agence_mtn_Abomey,300000,292657,Vincent Fournier,-8080,-737,2022-07-03
CASH_IN,209752,Agence_mtn_Cotonou,300000,90248,Vincent Fournier,-737,209015,2022-07-05
CASH_IN,223999,Agence_mtn_Cotonou,300000,76001,Vincent Fournier,209015,433014,2022-07-06
TRANSFER,356406,Vincent Fournier,433014,76608,Vincent Fournier,433014,76608,2022-07-06
TRANSFER,35358,Vincent Fournier,76608,41250,Vincent Fournier,76608,111966,2022-07-09
CASH_IN,258350,Agence_mtn_Cotonou,300000,41650,Vincent Fournier,41250,299600,2022-07-12
CASH_OUT,183404,Vincent Fournier,299600,116196,Agence_mtn_Cotonou,300000,116596,2022-07-15
TRANSFER,27521,Vincent Fournier,116196,88675,Vincent Fournier,116196,88675,2022-07-16
CASH_IN,145326,Agence_mtn_Ouidah,300000,154674,Vincent Fournier,88675,234001,2022-07-20
CASH_OUT,162974,Vincent Fournier,234001,71027,Agence_mtn_Abomey,300000,137026,2022-07-25
CASH_IN,40006,Agence_mtn_Ouidah,300000,259994,Nath Bruneau,-637659,-597653,2022-07-03
CASH_IN,66899,Agence_mtn_Ouidah,300000,233101,Nath Bruneau,-597653,-530754,2022-07-06
CASH_IN,166395,Agence_mtn_Abomey,300000,133605,Nath Bruneau,-530754,-364359,2022-07-07
CASH_IN,142007,Agence_mtn_Ouidah,300000,157993,Nath Bruneau,-364359,-222352,2022-07-09
CASH_IN,83751,Agence_mtn_Ouidah,300000,216249,Nath Bruneau,-222352,-138601,2022-07-09
CASH_IN,12722,Agence_mtn_Cotonou,300000,287278,Nath Bruneau,-138601,-125879,2022-07-09
CASH_IN,244231,Agence_mtn_Ouidah,300000,55769,Nath Bruneau,-125879,118352,2022-07-13
TRANSFER,108094,Nath Bruneau,118352,10258,Nath Bruneau,118352,10258,2022-07-16
CASH_OUT,6991,Nath Bruneau,10258,3267,Agence_mtn_Cotonou,300000,293009,2022-07-18
CASH_IN,248159,Agence_mtn_Cotonou,300000,51841,Nath Bruneau,3267,251426,2022-07-20
CASH_OUT,67084,Nath Bruneau,251426,184342,Agence_mtn_Ouidah,300000,232916,2022-07-21
CASH_OUT,29593,Nath Bruneau,184342,154749,Agence_mtn_Abomey,300000,270407,2022-07-21
CASH_IN,279709,Agence_mtn_Abomey,300000,20291,Nath Bruneau,154749,434458,2022-07-22
CASH_OUT,419283,Nath Bruneau,434458,15175,Agence_mtn_Abomey,300000,-119283,2022-07-22
CASH_IN,114451,Agence_mtn_Ouidah,300000,185549,Nath Bruneau,15175,129626,2022-07-23
CASH_OUT,968,Nath Bruneau,129626,128658,Agence_mtn_Abomey,300000,299032,2022-07-24
CASH_OUT,29639,Nath Bruneau,128658,99019,Agence_mtn_Cotonou,300000,270361,2022-07-26
CASH_IN,92819,Agence_mtn_Ouidah,300000,207181,Éléonore-Hélène Dubois,-15088,77731,2022-07-01
CASH_IN,286693,Agence_mtn_Cotonou,300000,13307,Éléonore-Hélène Dubois,77731,364424,2022-07-01
TRANSFER,228282,Éléonore-Hélène Dubois,364424,136142,Éléonore-Hélène Dubois,364424,592706,2022-07-03
CASH_OUT,8775,Éléonore-Hélène Dubois,136142,127367,Agence_mtn_Ouidah,300000,291225,2022-07-07
CASH_IN,196588,Agence_mtn_Cotonou,300000,103412,Éléonore-Hélène Dubois,127367,323955,2022-07-09
CASH_OUT,96601,Éléonore-Hélène Dubois,323955,227354,Agence_mtn_Cotonou,300000,203399,2022-07-17
CASH_OUT,121899,Éléonore-Hélène Dubois,227354,105455,Agence_mtn_Cotonou,300000,178101,2022-07-21
CASH_IN,12550,Agence_mtn_Ouidah,300000,287450,Éléonore-Hélène Dubois,105455,118005,2022-07-23
CASH_IN,54776,Agence_mtn_Ouidah,300000,245224,Éléonore-Hélène Dubois,118005,172781,2022-07-23
CASH_IN,241894,Agence_mtn_Cotonou,300000,58106,Valentine Richard-Bourdon,-197128,44766,2022-07-03
CASH_IN,177619,Agence_mtn_Abomey,300000,122381,Valentine Richard-Bourdon,44766,222385,2022-07-03
TRANSFER,145850,Valentine Richard-Bourdon,222385,76535,Valentine Richard-Bourdon,222385,368235,2022-07-03
CASH_OUT,12758,Valentine Richard-Bourdon,76535,63777,Agence_mtn_Abomey,300000,287242,2022-07-06
TRANSFER,15565,Valentine Richard-Bourdon,63777,48212,Valentine Richard-Bourdon,63777,79342,2022-07-07
TRANSFER,10851,Valentine Richard-Bourdon,48212,37361,Valentine Richard-Bourdon,48212,37361,2022-07-08
CASH_OUT,30422,Valentine Richard-Bourdon,37361,6939,Agence_mtn_Abomey,300000,269578,2022-07-09
CASH_IN,119481,Agence_mtn_Ouidah,300000,180519,Valentine Richard-Bourdon,6939,126420,2022-07-11
CASH_IN,215648,Agence_mtn_Abomey,300000,84352,Valentine Richard-Bourdon,126420,342068,2022-07-11
TRANSFER,118414,Valentine Richard-Bourdon,342068,223654,Valentine Richard-Bourdon,342068,223654,2022-07-13
CASH_IN,254276,Agence_mtn_Cotonou,300000,45724,Valentine Richard-Bourdon,223654,477930,2022-07-14
CASH_IN,43110,Agence_mtn_Ouidah,300000,256890,Valentine Richard-Bourdon,477930,521040,2022-07-14
CASH_IN,33979,Agence_mtn_Ouidah,300000,266021,Valentine Richard-Bourdon,521040,555019,2022-07-21
CASH_OUT,155697,Valentine Richard-Bourdon,555019,399322,Agence_mtn_Abomey,300000,144303,2022-07-22
CASH_OUT,42842,Valentine Richard-Bourdon,399322,356480,Agence_mtn_Abomey,300000,257158,2022-07-27
CASH_IN,93354,Agence_mtn_Abomey,300000,206646,William Lebrun,-113036,-19682,2022-07-03
CASH_IN,296587,Agence_mtn_Abomey,300000,3413,William Lebrun,-19682,276905,2022-07-03
CASH_OUT,92506,William Lebrun,276905,184399,Agence_mtn_Cotonou,300000,207494,2022-07-07
CASH_IN,272660,Agence_mtn_Ouidah,300000,27340,William Lebrun,184399,457059,2022-07-18
CASH_IN,4565,Agence_mtn_Ouidah,300000,295435,William Lebrun,457059,461624,2022-07-20
CASH_IN,65155,Agence_mtn_Ouidah,300000,234845,William Lebrun,461624,526779,2022-07-21
TRANSFER,35439,William Lebrun,526779,491340,William Lebrun,526779,491340,2022-07-23
TRANSFER,479773,William Lebrun,491340,11567,William Lebrun,491340,11567,2022-07-24
CASH_OUT,3777,William Lebrun,11567,7790,Agence_mtn_Cotonou,300000,296223,2022-07-25
CASH_IN,13838,Agence_mtn_Cotonou,300000,286162,William Lebrun,7790,21628,2022-07-26
CASH_OUT,8408,William Lebrun,21628,13220,Agence_mtn_Ouidah,300000,291592,2022-07-27
CASH_IN,33695,Agence_mtn_Cotonou,300000,266305,Honoré du Laurent,-50396,-16701,2022-07-07
CASH_IN,217829,Agence_mtn_Cotonou,300000,82171,Honoré du Laurent,-16701,201128,2022-07-11
CASH_OUT,112921,Honoré du Laurent,201128,88207,Agence_mtn_Ouidah,300000,187079,2022-07-12
CASH_IN,231290,Agence_mtn_Ouidah,300000,68710,Honoré du Laurent,88207,319497,2022-07-13
TRANSFER,241317,Honoré du Laurent,319497,78180,Honoré du Laurent,319497,78180,2022-07-13
TRANSFER,10757,Honoré du Laurent,78180,67423,Honoré du Laurent,78180,88937,2022-07-15
TRANSFER,22655,Honoré du Laurent,67423,44768,Honoré du Laurent,67423,90078,2022-07-15
CASH_IN,56010,Agence_mtn_Cotonou,300000,243990,Honoré du Laurent,44768,100778,2022-07-20
CASH_OUT,62212,Honoré du Laurent,100778,38566,Agence_mtn_Cotonou,300000,237788,2022-07-23
CASH_IN,54074,Agence_mtn_Abomey,300000,245926,Honoré du Laurent,38566,92640,2022-07-26
CASH_IN,146920,Agence_mtn_Abomey,300000,153080,Gilbert Foucher,-394596,-247676,2022-07-06
CASH_IN,113464,Agence_mtn_Ouidah,300000,186536,Gilbert Foucher,-247676,-134212,2022-07-06
CASH_IN,43747,Agence_mtn_Abomey,300000,256253,Gilbert Foucher,-134212,-90465,2022-07-06
CASH_IN,120353,Agence_mtn_Ouidah,300000,179647,Gilbert Foucher,-90465,29888,2022-07-06
CASH_OUT,21567,Gilbert Foucher,29888,8321,Agence_mtn_Abomey,300000,278433,2022-07-07
CASH_IN,226645,Agence_mtn_Ouidah,300000,73355,Gilbert Foucher,8321,234966,2022-07-10
TRANSFER,21864,Gilbert Foucher,234966,213102,Gilbert Foucher,234966,213102,2022-07-11
CASH_OUT,160444,Gilbert Foucher,213102,52658,Agence_mtn_Abomey,300000,139556,2022-07-12
CASH_IN,12058,Agence_mtn_Cotonou,300000,287942,Gilbert Foucher,52658,64716,2022-07-13
TRANSFER,26880,Gilbert Foucher,64716,37836,Gilbert Foucher,64716,91596,2022-07-16
CASH_IN,129433,Agence_mtn_Ouidah,300000,170567,Gilbert Foucher,37836,167269,2022-07-17
CASH_OUT,101300,Gilbert Foucher,167269,65969,Agence_mtn_Ouidah,300000,198700,2022-07-18
CASH_IN,98603,Agence_mtn_Abomey,300000,201397,Gilbert Foucher,65969,164572,2022-07-21
CASH_IN,202046,Agence_mtn_Ouidah,300000,97954,Gilbert Foucher,164572,366618,2022-07-24
CASH_IN,197420,Agence_mtn_Abomey,300000,102580,Gilbert Foucher,366618,564038,2022-07-24
CASH_IN,23925,Agence_mtn_Abomey,300000,276075,Gilbert Foucher,564038,587963,2022-07-24
CASH_IN,143539,Agence_mtn_Cotonou,300000,156461,Étienne Roche,-87752,55787,2022-07-01
TRANSFER,34406,Étienne Roche,55787,21381,Étienne Roche,55787,90193,2022-07-02
TRANSFER,289,Étienne Roche,21381,21092,Étienne Roche,21381,21092,2022-07-04
CASH_OUT,6859,Étienne Roche,21092,14233,Agence_mtn_Abomey,300000,293141,2022-07-05
CASH_IN,161036,Agence_mtn_Abomey,300000,138964,Étienne Roche,14233,175269,2022-07-05
CASH_OUT,98987,Étienne Roche,175269,76282,Agence_mtn_Abomey,300000,201013,2022-07-06
TRANSFER,67129,Étienne Roche,76282,9153,Étienne Roche,76282,9153,2022-07-08
CASH_IN,84348,Agence_mtn_Ouidah,300000,215652,Étienne Roche,9153,93501,2022-07-09
TRANSFER,48951,Étienne Roche,93501,44550,Étienne Roche,93501,142452,2022-07-12
TRANSFER,30601,Étienne Roche,44550,13949,Étienne Roche,44550,13949,2022-07-12
CASH_IN,207843,Agence_mtn_Ouidah,300000,92157,Étienne Roche,13949,221792,2022-07-13
CASH_IN,173187,Agence_mtn_Cotonou,300000,126813,Étienne Roche,221792,394979,2022-07-13
CASH_IN,179602,Agence_mtn_Ouidah,300000,120398,Étienne Roche,394979,574581,2022-07-15
CASH_OUT,34479,Étienne Roche,574581,540102,Agence_mtn_Abomey,300000,265521,2022-07-15
CASH_IN,132409,Agence_mtn_Cotonou,300000,167591,Étienne Roche,540102,672511,2022-07-22
CASH_OUT,573351,Étienne Roche,672511,99160,Agence_mtn_Cotonou,300000,-273351,2022-07-22
CASH_IN,178612,Agence_mtn_Abomey,300000,121388,Étienne Roche,99160,277772,2022-07-24
CASH_IN,294007,Agence_mtn_Ouidah,300000,5993,Étienne Roche,277772,571779,2022-07-27
CASH_IN,12859,Agence_mtn_Ouidah,300000,287141,Raymond Rossi,-52592,-39733,2022-07-08
CASH_IN,38350,Agence_mtn_Abomey,300000,261650,Raymond Rossi,-39733,-1383,2022-07-11
CASH_IN,151424,Agence_mtn_Ouidah,300000,148576,Raymond Rossi,-1383,150041,2022-07-11
CASH_IN,90759,Agence_mtn_Cotonou,300000,209241,Raymond Rossi,150041,240800,2022-07-12
TRANSFER,157545,Raymond Rossi,240800,83255,Raymond Rossi,240800,83255,2022-07-12
CASH_IN,167883,Agence_mtn_Abomey,300000,132117,Raymond Rossi,83255,251138,2022-07-26
CASH_IN,286478,Agence_mtn_Cotonou,300000,13522,Alexandrie Delmas,-88646,197832,2022-07-02
TRANSFER,58536,Alexandrie Delmas,197832,139296,Alexandrie Delmas,197832,139296,2022-07-06
TRANSFER,92699,Alexandrie Delmas,139296,46597,Alexandrie Delmas,139296,46597,2022-07-06
CASH_OUT,20268,Alexandrie Delmas,46597,26329,Agence_mtn_Cotonou,300000,279732,2022-07-12
CASH_IN,260912,Agence_mtn_Abomey,300000,39088,Alexandrie Delmas,26329,287241,2022-07-15
CASH_OUT,71404,Alexandrie Delmas,287241,215837,Agence_mtn_Ouidah,300000,228596,2022-07-15
CASH_IN,26448,Agence_mtn_Ouidah,300000,273552,Alexandrie Delmas,215837,242285,2022-07-19
CASH_OUT,163195,Alexandrie Delmas,242285,79090,Agence_mtn_Ouidah,300000,136805,2022-07-19
CASH_OUT,1116,Alexandrie Delmas,79090,77974,Agence_mtn_Ouidah,300000,298884,2022-07-20
CASH_IN,160359,Agence_mtn_Ouidah,300000,139641,Alexandrie Delmas,77974,238333,2022-07-21
CASH_IN,265412,Agence_mtn_Ouidah,300000,34588,Philippine Courtois,-66032,199380,2022-07-03
CASH_OUT,183962,Philippine Courtois,199380,15418,Agence_mtn_Cotonou,300000,116038,2022-07-04
CASH_IN,136571,Agence_mtn_Abomey,300000,163429,Philippine Courtois,15418,151989,2022-07-04
CASH_OUT,128393,Philippine Courtois,151989,23596,Agence_mtn_Ouidah,300000,171607,2022-07-05
CASH_IN,240985,Agence_mtn_Ouidah,300000,59015,Philippine Courtois,23596,264581,2022-07-08
CASH_IN,5794,Agence_mtn_Ouidah,300000,294206,Philippine Courtois,264581,270375,2022-07-08
CASH_IN,53537,Agence_mtn_Abomey,300000,246463,Philippine Courtois,270375,323912,2022-07-12
CASH_OUT,19609,Philippine Courtois,323912,304303,Agence_mtn_Abomey,300000,280391,2022-07-15
CASH_IN,99184,Agence_mtn_Abomey,300000,200816,Philippine Courtois,304303,403487,2022-07-15
CASH_OUT,400784,Philippine Courtois,403487,2703,Agence_mtn_Ouidah,300000,-100784,2022-07-16
CASH_IN,17042,Agence_mtn_Abomey,300000,282958,Philippine Courtois,2703,19745,2022-07-16
CASH_OUT,277,Philippine Courtois,19745,19468,Agence_mtn_Ouidah,300000,299723,2022-07-19
CASH_IN,14341,Agence_mtn_Ouidah,300000,285659,Philippine Courtois,19468,33809,2022-07-27
CASH_OUT,9532,Philippine Courtois,33809,24277,Agence_mtn_Abomey,300000,290468,2022-07-27
CASH_IN,245719,Agence_mtn_Abomey,300000,54281,Tristan Thomas,-9957,235762,2022-07-03
TRANSFER,35144,Tristan Thomas,235762,200618,Tristan Thomas,235762,270906,2022-07-12
CASH_IN,17509,Agence_mtn_Ouidah,300000,282491,Tristan Thomas,200618,218127,2022-07-15
CASH_OUT,204168,Tristan Thomas,218127,13959,Agence_mtn_Ouidah,300000,95832,2022-07-17
CASH_IN,112938,Agence_mtn_Ouidah,300000,187062,Tristan Thomas,13959,126897,2022-07-23
CASH_IN,83824,Agence_mtn_Abomey,300000,216176,Tristan Thomas,126897,210721,2022-07-27
CASH_IN,103340,Agence_mtn_Abomey,300000,196660,Zoé Renaud de Boutin,-259753,-156413,2022-07-03
CASH_IN,263137,Agence_mtn_Ouidah,300000,36863,Zoé Renaud de Boutin,-156413,106724,2022-07-04
CASH_IN,23419,Agence_mtn_Abomey,300000,276581,Zoé Renaud de Boutin,106724,130143,2022-07-06
TRANSFER,1594,Zoé Renaud de Boutin,130143,128549,Zoé Renaud de Boutin,130143,128549,2022-07-09
TRANSFER,51753,Zoé Renaud de Boutin,128549,76796,Zoé Renaud de Boutin,128549,180302,2022-07-12
TRANSFER,46947,Zoé Renaud de Boutin,76796,29849,Zoé Renaud de Boutin,76796,123743,2022-07-16
TRANSFER,15690,Zoé Renaud de Boutin,29849,14159,Zoé Renaud de Boutin,29849,45539,2022-07-17
CASH_OUT,4855,Zoé Renaud de Boutin,14159,9304,Agence_mtn_Abomey,300000,295145,2022-07-19
TRANSFER,1057,Zoé Renaud de Boutin,9304,8247,Zoé Renaud de Boutin,9304,8247,2022-07-19
CASH_OUT,4935,Zoé Renaud de Boutin,8247,3312,Agence_mtn_Ouidah,300000,295065,2022-07-20
CASH_OUT,1931,Zoé Renaud de Boutin,3312,1381,Agence_mtn_Cotonou,300000,298069,2022-07-21
TRANSFER,1042,Zoé Renaud de Boutin,1381,339,Zoé Renaud de Boutin,1381,339,2022-07-21
CASH_OUT,260,Zoé Renaud de Boutin,339,79,Agence_mtn_Abomey,300000,299740,2022-07-23
CASH_IN,245588,Agence_mtn_Abomey,300000,54412,Zoé Renaud de Boutin,79,245667,2022-07-24
CASH_IN,40093,Agence_mtn_Ouidah,300000,259907,Zoé Renaud de Boutin,245667,285760,2022-07-25
CASH_IN,155311,Agence_mtn_Ouidah,300000,144689,Zoé Renaud de Boutin,285760,441071,2022-07-25
CASH_IN,169598,Agence_mtn_Ouidah,300000,130402,Zoé Renaud de Boutin,441071,610669,2022-07-26
CASH_IN,278222,Agence_mtn_Abomey,300000,21778,Renée David,-111463,166759,2022-07-06
CASH_OUT,35208,Renée David,166759,131551,Agence_mtn_Abomey,300000,264792,2022-07-12
CASH_IN,128988,Agence_mtn_Abomey,300000,171012,Renée David,131551,260539,2022-07-16
CASH_OUT,79524,Renée David,260539,181015,Agence_mtn_Abomey,300000,220476,2022-07-16
CASH_IN,210615,Agence_mtn_Ouidah,300000,89385,Renée David,181015,391630,2022-07-17
CASH_OUT,24574,Renée David,391630,367056,Agence_mtn_Ouidah,300000,275426,2022-07-20
CASH_IN,14285,Agence_mtn_Ouidah,300000,285715,Renée David,367056,381341,2022-07-21
CASH_OUT,358862,Renée David,381341,22479,Agence_mtn_Ouidah,300000,-58862,2022-07-25
CASH_IN,207576,Agence_mtn_Ouidah,300000,92424,Xavier de Lebreton,-23426,184150,2022-07-01
CASH_OUT,66040,Xavier de Lebreton,184150,118110,Agence_mtn_Cotonou,300000,233960,2022-07-02
TRANSFER,41954,Xavier de Lebreton,118110,76156,Xavier de Lebreton,118110,160064,2022-07-05
TRANSFER,39240,Xavier de Lebreton,76156,36916,Xavier de Lebreton,76156,36916,2022-07-06
TRANSFER,26555,Xavier de Lebreton,36916,10361,Xavier de Lebreton,36916,63471,2022-07-06
CASH_OUT,826,Xavier de Lebreton,10361,9535,Agence_mtn_Cotonou,300000,299174,2022-07-09
CASH_OUT,3217,Xavier de Lebreton,9535,6318,Agence_mtn_Cotonou,300000,296783,2022-07-10
TRANSFER,2415,Xavier de Lebreton,6318,3903,Xavier de Lebreton,6318,3903,2022-07-11
CASH_OUT,3318,Xavier de Lebreton,3903,585,Agence_mtn_Cotonou,300000,296682,2022-07-12
CASH_IN,151169,Agence_mtn_Abomey,300000,148831,Xavier de Lebreton,585,151754,2022-07-12
CASH_OUT,56680,Xavier de Lebreton,151754,95074,Agence_mtn_Cotonou,300000,243320,2022-07-13
CASH_IN,218229,Agence_mtn_Cotonou,300000,81771,Xavier de Lebreton,95074,313303,2022-07-24
CASH_IN,149218,Agence_mtn_Ouidah,300000,150782,Xavier de Lebreton,313303,462521,2022-07-26
CASH_IN,170257,Agence_mtn_Abomey,300000,129743,Xavier de Lebreton,462521,632778,2022-07-27
CASH_IN,13448,Agence_mtn_Ouidah,300000,286552,Pénélope Dupuis,-76205,-62757,2022-07-01
CASH_IN,195020,Agence_mtn_Ouidah,300000,104980,Pénélope Dupuis,-62757,132263,2022-07-02
TRANSFER,82827,Pénélope Dupuis,132263,49436,Pénélope Dupuis,132263,49436,2022-07-04
TRANSFER,8063,Pénélope Dupuis,49436,41373,Pénélope Dupuis,49436,57499,2022-07-07
CASH_OUT,39828,Pénélope Dupuis,41373,1545,Agence_mtn_Cotonou,300000,260172,2022-07-10
CASH_IN,46347,Agence_mtn_Cotonou,300000,253653,Pénélope Dupuis,1545,47892,2022-07-19
CASH_IN,32054,Agence_mtn_Ouidah,300000,267946,Pénélope Dupuis,47892,79946,2022-07-21
CASH_IN,179874,Agence_mtn_Ouidah,300000,120126,Pénélope Dupuis,79946,259820,2022-07-26
CASH_IN,210314,Agence_mtn_Ouidah,300000,89686,Pénélope Dupuis,259820,470134,2022-07-27
CASH_IN,73897,Agence_mtn_Abomey,300000,226103,Inès Hamon,-33728,40169,2022-07-02
CASH_OUT,31076,Inès Hamon,40169,9093,Agence_mtn_Cotonou,300000,268924,2022-07-02
CASH_IN,176492,Agence_mtn_Cotonou,300000,123508,Inès Hamon,9093,185585,2022-07-06
TRANSFER,20986,Inès Hamon,185585,164599,Inès Hamon,185585,164599,2022-07-06
TRANSFER,117439,Inès Hamon,164599,47160,Inès Hamon,164599,282038,2022-07-09
CASH_OUT,34869,Inès Hamon,47160,12291,Agence_mtn_Ouidah,300000,265131,2022-07-09
TRANSFER,10290,Inès Hamon,12291,2001,Inès Hamon,12291,2001,2022-07-12
TRANSFER,433,Inès Hamon,2001,1568,Inès Hamon,2001,1568,2022-07-13
CASH_IN,16134,Agence_mtn_Cotonou,300000,283866,Inès Hamon,1568,17702,2022-07-15
TRANSFER,5587,Inès Hamon,17702,12115,Inès Hamon,17702,12115,2022-07-17
CASH_IN,220967,Agence_mtn_Cotonou,300000,79033,Inès Hamon,12115,233082,2022-07-19
CASH_IN,82462,Agence_mtn_Abomey,300000,217538,Inès Hamon,233082,315544,2022-07-23
CASH_IN,142800,Agence_mtn_Cotonou,300000,157200,Inès Hamon,315544,458344,2022-07-24
CASH_IN,145508,Agence_mtn_Ouidah,300000,154492,Inès Hamon,458344,603852,2022-07-25
CASH_IN,252684,Agence_mtn_Abomey,300000,47316,Margot Renaud,-18860,233824,2022-07-03
CASH_IN,109820,Agence_mtn_Ouidah,300000,190180,Margot Renaud,233824,343644,2022-07-03
CASH_OUT,155881,Margot Renaud,343644,187763,Agence_mtn_Cotonou,300000,144119,2022-07-12
TRANSFER,130785,Margot Renaud,187763,56978,Margot Renaud,187763,318548,2022-07-12
TRANSFER,24815,Margot Renaud,56978,32163,Margot Renaud,56978,81793,2022-07-12
CASH_OUT,22663,Margot Renaud,32163,9500,Agence_mtn_Abomey,300000,277337,2022-07-18
CASH_IN,199864,Agence_mtn_Ouidah,300000,100136,Margot Renaud,9500,209364,2022-07-18
CASH_OUT,136299,Margot Renaud,209364,73065,Agence_mtn_Abomey,300000,163701,2022-07-19
CASH_IN,233150,Agence_mtn_Abomey,300000,66850,Margot Renaud,73065,306215,2022-07-19
CASH_OUT,10042,Margot Renaud,306215,296173,Agence_mtn_Abomey,300000,289958,2022-07-20
CASH_OUT,180523,Margot Renaud,296173,115650,Agence_mtn_Abomey,300000,119477,2022-07-23
CASH_OUT,107205,Margot Renaud,115650,8445,Agence_mtn_Ouidah,300000,192795,2022-07-27
CASH_IN,120069,Agence_mtn_Abomey,300000,179931,Margot Renaud,8445,128514,2022-07-27
CASH_OUT,61449,Honoré du Laurent,1392900,1331451,Agence_mtn_Cotonou,300000,238551,2022-08-01
CASH_OUT,1325417,Honoré du Laurent,1331451,6034,Agence_mtn_Abomey,300000,-1025417,2022-08-02
CASH_OUT,4934,Honoré du Laurent,6034,1100,Agence_mtn_Cotonou,300000,295066,2022-08-03
CASH_IN,96318,Agence_mtn_Abomey,300000,203682,Honoré du Laurent,1100,97418,2022-08-03
CASH_IN,52396,Agence_mtn_Ouidah,300000,247604,Honoré du Laurent,97418,149814,2022-08-08
TRANSFER,235097,Gilbert-Charles Thibault,1209700,974603,Valentine Martinez,211900,446997,2022-08-21
CASH_OUT,197224,Valentine Martinez,446997,249773,Agence_mtn_Cotonou,300000,102776,2022-08-21
CASH_OUT,228023,Thierry Delattre-Simon,1035300,807277,Agence_mtn_Cotonou,300000,71977,2022-08-05
TRANSFER,710615,Pénélope Dupuis,1405500,694885,Thierry Delattre-Simon,807277,1517892,2022-08-13
TRANSFER,386552,Thierry Delattre-Simon,1517892,1131340,Étienne Roche,741800,355248,2022-08-18
CASH_OUT,803315,Thierry Delattre-Simon,1131340,328025,Agence_mtn_Abomey,300000,-503315,2022-08-20
TRANSFER,58525,Thierry Delattre-Simon,328025,269500,Jean Benard,222600,164075,2022-08-22
CASH_IN,38497,Agence_mtn_Ouidah,300000,261503,Valérie Dijoux,1563100,1601597,2022-08-06
CASH_IN,268059,Agence_mtn_Cotonou,300000,31941,Valérie Dijoux,1601597,1869656,2022-08-11
TRANSFER,1257650,Claude Foucher,1931500,673850,Valérie Dijoux,1869656,3127306,2022-08-12
TRANSFER,32733,Pénélope Dupuis,694885,662152,Valérie Dijoux,3127306,3160039,2022-08-19
TRANSFER,29045,Vincent Fournier,208600,179555,Virginie Le Gall,1196700,1167655,2022-08-02
CASH_IN,187408,Agence_mtn_Abomey,300000,112592,Vincent Fournier,179555,366963,2022-08-06
CASH_IN,72683,Agence_mtn_Abomey,300000,227317,Vincent Fournier,366963,439646,2022-08-07
TRANSFER,424467,Vincent Fournier,439646,15179,Marie Picard,146300,-278167,2022-08-16
CASH_IN,147584,Agence_mtn_Ouidah,300000,152416,Vincent Fournier,15179,162763,2022-08-25
CASH_OUT,846359,Alphonse Leclercq-Rousseau,901300,54941,Agence_mtn_Cotonou,300000,-546359,2022-08-13
TRANSFER,20979,Michelle Lebon,961800,940821,Louise Girard,1225900,1246879,2022-08-03
CASH_IN,192858,Agence_mtn_Ouidah,300000,107142,Louise Girard,1246879,1439737,2022-08-20
CASH_IN,13720,Agence_mtn_Ouidah,300000,286280,Louise Girard,1439737,1453457,2022-08-21
CASH_OUT,840601,Louise Girard,1453457,612856,Agence_mtn_Cotonou,300000,-540601,2022-08-25
CASH_IN,147365,Agence_mtn_Abomey,300000,152635,Valentine Richard-Bourdon,1620700,1768065,2022-08-04
CASH_IN,289028,Agence_mtn_Cotonou,300000,10972,Valentine Richard-Bourdon,1768065,2057093,2022-08-19
CASH_IN,235791,Agence_mtn_Abomey,300000,64209,Caroline-Lorraine Humbert,1706900,1942691,2022-08-14
TRANSFER,4522,Thibaut Coulon,676100,671578,Thibault Moreno,187100,191622,2022-08-01
CASH_OUT,50326,Thibault Moreno,191622,141296,Agence_mtn_Ouidah,300000,249674,2022-08-11
TRANSFER,32688,Thibault Moreno,141296,108608,Gabriel Humbert,1717100,1684412,2022-08-16
CASH_IN,14064,Agence_mtn_Ouidah,300000,285936,Thibault Moreno,108608,122672,2022-08-18
CASH_IN,242641,Agence_mtn_Abomey,300000,57359,Antoinette Bertrand,830800,1073441,2022-08-05
TRANSFER,936401,Antoinette Bertrand,1073441,137040,Isabelle Rossi,786200,-150201,2022-08-07
CASH_IN,206189,Agence_mtn_Cotonou,300000,93811,Antoinette Bertrand,137040,343229,2022-08-24
CASH_IN,137413,Agence_mtn_Abomey,300000,162587,Antoinette Bertrand,343229,480642,2022-08-27
CASH_OUT,375889,Marcelle Charrier,521100,145211,Agence_mtn_Ouidah,300000,-75889,2022-08-22
CASH_IN,225468,Agence_mtn_Cotonou,300000,74532,Raymond Marchal de Nguyen,1262100,1487568,2022-08-07
CASH_IN,67370,Agence_mtn_Abomey,300000,232630,Tristan Thomas,353600,420970,2022-08-02
CASH_IN,168018,Agence_mtn_Ouidah,300000,131982,Tristan Thomas,420970,588988,2022-08-10
TRANSFER,679119,Cécile Germain,1047700,368581,Philippine Courtois,651600,-27519,2022-08-01
TRANSFER,306921,Cécile Germain,368581,61660,Nathalie Pages,1484500,1177579,2022-08-08
CASH_OUT,46658,Cécile Germain,61660,15002,Agence_mtn_Abomey,300000,253342,2022-08-19
CASH_OUT,5207,Cécile Germain,15002,9795,Agence_mtn_Ouidah,300000,294793,2022-08-24
CASH_OUT,1688,Cécile Germain,9795,8107,Agence_mtn_Ouidah,300000,298312,2022-08-27
CASH_IN,244453,Agence_mtn_Abomey,300000,55547,Vincent Mathieu,873800,1118253,2022-08-03
TRANSFER,210917,Vincent Mathieu,1118253,907336,Sophie Gonzalez,1320700,1109783,2022-08-04
CASH_OUT,194460,Vincent Mathieu,907336,712876,Agence_mtn_Cotonou,300000,105540,2022-08-09
TRANSFER,52626,Vincent Mathieu,712876,660250,Cécile Delattre-Arnaud,1325100,1272474,2022-08-18
CASH_IN,176783,Agence_mtn_Cotonou,300000,123217,Vincent Mathieu,660250,837033,2022-08-21
CASH_OUT,254406,David du Blondel,449700,195294,Agence_mtn_Abomey,300000,45594,2022-08-19
CASH_IN,102284,Agence_mtn_Ouidah,300000,197716,Simone Pineau,1999600,2101884,2022-08-03
CASH_IN,63045,Agence_mtn_Cotonou,300000,236955,Simone Pineau,2101884,2164929,2022-08-09
CASH_OUT,1223823,Simone Pineau,2164929,941106,Agence_mtn_Ouidah,300000,-923823,2022-08-11
CASH_IN,192320,Agence_mtn_Ouidah,300000,107680,Simone Pineau,941106,1133426,2022-08-26
CASH_OUT,161955,Simone Pineau,1133426,971471,Agence_mtn_Cotonou,300000,138045,2022-08-27
CASH_OUT,142064,Léon Lecoq,776000,633936,Agence_mtn_Abomey,300000,157936,2022-08-09
TRANSFER,339871,Théodore De Oliveira-Nicolas,779000,439129,Léon Lecoq,633936,973807,2022-08-22
CASH_IN,89123,Agence_mtn_Cotonou,300000,210877,Léon Lecoq,973807,1062930,2022-08-27
CASH_OUT,183218,William Le Lucas,1002800,819582,Agence_mtn_Abomey,300000,116782,2022-08-17
TRANSFER,140582,Adèle Labbé,295800,155218,Emmanuelle Georges,143600,284182,2022-08-24
CASH_OUT,1204202,Cécile Delattre-Arnaud,1272474,68272,Agence_mtn_Abomey,300000,-904202,2022-08-03
CASH_OUT,1759,Cécile Delattre-Arnaud,68272,66513,Agence_mtn_Abomey,300000,298241,2022-08-05
TRANSFER,434515,Sébastien Vallée,652400,217885,Cécile Delattre-Arnaud,66513,501028,2022-08-10
CASH_IN,80921,Agence_mtn_Cotonou,300000,219079,Cécile Delattre-Arnaud,501028,581949,2022-08-10
CASH_IN,70376,Agence_mtn_Abomey,300000,229624,Cécile Delattre-Arnaud,581949,652325,2022-08-26
CASH_OUT,149664,Geneviève Grondin,888000,738336,Agence_mtn_Abomey,300000,150336,2022-08-13
CASH_OUT,531564,Geneviève Grondin,738336,206772,Agence_mtn_Ouidah,300000,-231564,2022-08-15
CASH_IN,68255,Agence_mtn_Abomey,300000,231745,Claude Foucher,673850,742105,2022-08-05
CASH_OUT,292514,Claude Foucher,742105,449591,Agence_mtn_Abomey,300000,7486,2022-08-17
TRANSFER,211852,Astrid Gay de la Brunet,1860400,1648548,Claude Foucher,449591,661443,2022-08-21
CASH_OUT,416222,Claude Foucher,661443,245221,Agence_mtn_Abomey,300000,-116222,2022-08-27
TRANSFER,299240,Franck-Charles Texier,464500,165260,Victoire-Nicole Lopez,994700,1293940,2022-08-04
TRANSFER,317041,Victoire-Nicole Lopez,1293940,976899,Victoire-Nicole Lopez,1293940,1610981,2022-08-09
TRANSFER,94218,François Michel-Legros,427500,333282,Zoé Renaud de Boutin,1585500,1679718,2022-08-02
TRANSFER,1494003,Zoé Renaud de Boutin,1679718,185715,Michelle Lebon,940821,-553182,2022-08-03
CASH_OUT,134166,Zoé Renaud de Boutin,185715,51549,Agence_mtn_Abomey,300000,165834,2022-08-04
CASH_IN,267781,Agence_mtn_Abomey,300000,32219,Zoé Renaud de Boutin,51549,319330,2022-08-05
CASH_IN,292780,Agence_mtn_Ouidah,300000,7220,Zoé Renaud de Boutin,319330,612110,2022-08-06
CASH_IN,29857,Agence_mtn_Cotonou,300000,270143,Zoé Renaud de Boutin,612110,641967,2022-08-07
TRANSFER,36687,Adrien Chartier,556200,519513,Zoé Renaud de Boutin,641967,678654,2022-08-08
TRANSFER,558788,Zoé Renaud de Boutin,678654,119866,Zoé Renaud de Boutin,678654,119866,2022-08-09
TRANSFER,39124,Alix Maillet,135600,96476,Zoé Renaud de Boutin,119866,158990,2022-08-10
TRANSFER,97149,Zoé Renaud de Boutin,158990,61841,Pénélope Dupuis,662152,565003,2022-08-11
CASH_IN,99691,Agence_mtn_Ouidah,300000,200309,Zoé Renaud de Boutin,61841,161532,2022-08-11
CASH_OUT,145888,Zoé Renaud de Boutin,161532,15644,Agence_mtn_Cotonou,300000,154112,2022-08-12
TRANSFER,9594,Zoé Renaud de Boutin,15644,6050,Gabriel-Tristan Marty,808000,798406,2022-08-13
TRANSFER,138873,Adrien Chartier,519513,380640,Zoé Renaud de Boutin,6050,144923,2022-08-14
TRANSFER,52354,Zoé Renaud de Boutin,144923,92569,Hortense Lemaire,6500,-45854,2022-08-14
CASH_IN,204745,Agence_mtn_Cotonou,300000,95255,Zoé Renaud de Boutin,92569,297314,2022-08-14
CASH_OUT,62573,Zoé Renaud de Boutin,297314,234741,Agence_mtn_Ouidah,300000,237427,2022-08-17
TRANSFER,107116,Zoé Renaud de Boutin,234741,127625,Étienne Roche,355248,248132,2022-08-17
TRANSFER,31908,Zoé Renaud de Boutin,127625,95717,Jean Benard,164075,132167,2022-08-18
TRANSFER,85953,François Michel-Legros,333282,247329,Zoé Renaud de Boutin,95717,181670,2022-08-19
CASH_IN,200164,Agence_mtn_Cotonou,300000,99836,Zoé Renaud de Boutin,181670,381834,2022-08-19
CASH_OUT,269939,Zoé Renaud de Boutin,381834,111895,Agence_mtn_Ouidah,300000,30061,2022-08-19
TRANSFER,27129,Zoé Renaud de Boutin,111895,84766,Thérèse-Margaux Bruneau,1413000,1385871,2022-08-20
CASH_OUT,7846,Zoé Renaud de Boutin,84766,76920,Agence_mtn_Abomey,300000,292154,2022-08-20
CASH_OUT,35682,Zoé Renaud de Boutin,76920,41238,Agence_mtn_Ouidah,300000,264318,2022-08-20
CASH_OUT,38806,Zoé Renaud de Boutin,41238,2432,Agence_mtn_Abomey,300000,261194,2022-08-24
TRANSFER,544574,Martine Wagner de la Bègue,588500,43926,Pierre Roger,1644500,1099926,2022-08-01
CASH_IN,159811,Agence_mtn_Cotonou,300000,140189,Martine Wagner de la Bègue,43926,203737,2022-08-03
TRANSFER,119332,Martine Wagner de la Bègue,203737,84405,Alix Maillet,96476,-22856,2022-08-03
CASH_IN,235932,Agence_mtn_Ouidah,300000,64068,Martine Wagner de la Bègue,84405,320337,2022-08-03
TRANSFER,86130,Martine Wagner de la Bègue,320337,234207,Sophie Gonzalez,1109783,1023653,2022-08-05
CASH_OUT,205653,Martine Wagner de la Bègue,234207,28554,Agence_mtn_Abomey,300000,94347,2022-08-06
TRANSFER,17083,Martine Wagner de la Bègue,28554,11471,Théodore De Oliveira-Nicolas,439129,422046,2022-08-07
TRANSFER,216070,Laurent-Bertrand Lefort,1537000,1320930,Martine Wagner de la Bègue,11471,227541,2022-08-07
CASH_OUT,1782,Martine Wagner de la Bègue,227541,225759,Agence_mtn_Ouidah,300000,298218,2022-08-09
CASH_OUT,25749,Martine Wagner de la Bègue,225759,200010,Agence_mtn_Ouidah,300000,274251,2022-08-09
CASH_IN,256921,Agence_mtn_Ouidah,300000,43079,Martine Wagner de la Bègue,200010,456931,2022-08-10
CASH_IN,277964,Agence_mtn_Abomey,300000,22036,Martine Wagner de la Bègue,456931,734895,2022-08-12
CASH_IN,65590,Agence_mtn_Cotonou,300000,234410,Martine Wagner de la Bègue,734895,800485,2022-08-13
CASH_IN,155560,Agence_mtn_Cotonou,300000,144440,Martine Wagner de la Bègue,800485,956045,2022-08-13
CASH_IN,131958,Agence_mtn_Cotonou,300000,168042,Martine Wagner de la Bègue,956045,1088003,2022-08-14
CASH_IN,134920,Agence_mtn_Ouidah,300000,165080,Martine Wagner de la Bègue,1088003,1222923,2022-08-14
CASH_OUT,480335,Martine Wagner de la Bègue,1222923,742588,Agence_mtn_Ouidah,300000,-180335,2022-08-16
TRANSFER,239145,Martine Wagner de la Bègue,742588,503443,Laure Philippe,1423300,1184155,2022-08-16
CASH_IN,151070,Agence_mtn_Cotonou,300000,148930,Martine Wagner de la Bègue,503443,654513,2022-08-17
TRANSFER,20946,Alphonse Le Olivier,725100,704154,Martine Wagner de la Bègue,654513,675459,2022-08-19
TRANSFER,1239499,Geneviève De Oliveira-Michel,1921900,682401,Martine Wagner de la Bègue,675459,1914958,2022-08-21
TRANSFER,1138461,Martine Wagner de la Bègue,1914958,776497,Astrid Gay de la Brunet,1648548,510087,2022-08-21
CASH_IN,180749,Agence_mtn_Abomey,300000,119251,Martine Wagner de la Bègue,776497,957246,2022-08-22
CASH_OUT,288004,Martine Wagner de la Bègue,957246,669242,Agence_mtn_Cotonou,300000,11996,2022-08-24
CASH_IN,99991,Agence_mtn_Abomey,300000,200009,Martine Wagner de la Bègue,669242,769233,2022-08-25
CASH_OUT,556091,Martine Wagner de la Bègue,769233,213142,Agence_mtn_Abomey,300000,-256091,2022-08-25
CASH_IN,204715,Agence_mtn_Abomey,300000,95285,Martine Wagner de la Bègue,213142,417857,2022-08-25
TRANSFER,27508,Xavier de Lebreton,90200,62692,Martine Wagner de la Bègue,417857,445365,2022-08-27
CASH_IN,171010,Agence_mtn_Ouidah,300000,128990,Martine Wagner de la Bègue,445365,616375,2022-08-27
CASH_IN,38611,Agence_mtn_Cotonou,300000,261389,Rémy de la Roux,1745200,1783811,2022-08-01
TRANSFER,315325,Xavier Leblanc-Ferreira,521300,205975,Rémy de la Roux,1783811,2099136,2022-08-01
CASH_IN,55102,Agence_mtn_Ouidah,300000,244898,Rémy de la Roux,2099136,2154238,2022-08-02
CASH_IN,265283,Agence_mtn_Ouidah,300000,34717,Rémy de la Roux,2154238,2419521,2022-08-03
CASH_IN,134880,Agence_mtn_Ouidah,300000,165120,Rémy de la Roux,2419521,2554401,2022-08-05
TRANSFER,2195013,Rémy de la Roux,2554401,359388,Renée David,1769000,-426013,2022-08-06
TRANSFER,147380,Rémy de la Roux,359388,212008,Marcelle Paris,1084300,936920,2022-08-06
CASH_IN,256719,Agence_mtn_Abomey,300000,43281,Rémy de la Roux,212008,468727,2022-08-09
CASH_OUT,5143,Rémy de la Roux,468727,463584,Agence_mtn_Ouidah,300000,294857,2022-08-11
CASH_IN,127676,Agence_mtn_Ouidah,300000,172324,Rémy de la Roux,463584,591260,2022-08-12
CASH_OUT,432496,Rémy de la Roux,591260,158764,Agence_mtn_Cotonou,300000,-132496,2022-08-13
CASH_IN,156449,Agence_mtn_Cotonou,300000,143551,Rémy de la Roux,158764,315213,2022-08-14
TRANSFER,687312,Marcelle Paris,936920,249608,Rémy de la Roux,315213,1002525,2022-08-14
CASH_IN,62064,Agence_mtn_Abomey,300000,237936,Rémy de la Roux,1002525,1064589,2022-08-16
CASH_OUT,893488,Rémy de la Roux,1064589,171101,Agence_mtn_Cotonou,300000,-593488,2022-08-16
CASH_IN,71566,Agence_mtn_Abomey,300000,228434,Rémy de la Roux,171101,242667,2022-08-17
CASH_IN,239391,Agence_mtn_Cotonou,300000,60609,Rémy de la Roux,242667,482058,2022-08-17
CASH_IN,197291,Agence_mtn_Ouidah,300000,102709,Rémy de la Roux,482058,679349,2022-08-19
CASH_OUT,562190,Rémy de la Roux,679349,117159,Agence_mtn_Abomey,300000,-262190,2022-08-20
TRANSFER,1095,Rémy de la Roux,117159,116064,Raymond Rossi,196300,195205,2022-08-24
TRANSFER,353543,Richard Le Descamps,606000,252457,Rémy de la Roux,116064,469607,2022-08-24
CASH_IN,66288,Agence_mtn_Abomey,300000,233712,Rémy de la Roux,469607,535895,2022-08-25
CASH_IN,93979,Agence_mtn_Abomey,300000,206021,Rémy de la Roux,535895,629874,2022-08-26
CASH_IN,54189,Agence_mtn_Cotonou,300000,245811,Rémy de la Roux,629874,684063,2022-08-27
CASH_OUT,148523,Rémy de la Roux,684063,535540,Agence_mtn_Abomey,300000,151477,2022-08-27
CASH_IN,111712,Agence_mtn_Ouidah,300000,188288,Étienne Roche,248132,359844,2022-08-01
CASH_IN,150231,Agence_mtn_Abomey,300000,149769,Étienne Roche,359844,510075,2022-08-03
CASH_IN,7157,Agence_mtn_Ouidah,300000,292843,Étienne Roche,510075,517232,2022-08-04
TRANSFER,38818,Étienne Roche,517232,478414,Alfred du Lesage,692400,653582,2022-08-06
CASH_OUT,58966,Étienne Roche,478414,419448,Agence_mtn_Ouidah,300000,241034,2022-08-06
TRANSFER,414215,Céline Gomez,1069000,654785,Étienne Roche,419448,833663,2022-08-06
CASH_IN,88421,Agence_mtn_Ouidah,300000,211579,Étienne Roche,833663,922084,2022-08-08
CASH_OUT,106945,Étienne Roche,922084,815139,Agence_mtn_Abomey,300000,193055,2022-08-08
CASH_IN,229825,Agence_mtn_Cotonou,300000,70175,Étienne Roche,815139,1044964,2022-08-09
CASH_IN,51741,Agence_mtn_Cotonou,300000,248259,Étienne Roche,1044964,1096705,2022-08-09
CASH_IN,237712,Agence_mtn_Abomey,300000,62288,Étienne Roche,1096705,1334417,2022-08-10
CASH_IN,90357,Agence_mtn_Abomey,300000,209643,Étienne Roche,1334417,1424774,2022-08-11
TRANSFER,695711,Émilie Moulin,1429100,733389,Étienne Roche,1424774,2120485,2022-08-11
CASH_OUT,76826,Étienne Roche,2120485,2043659,Agence_mtn_Ouidah,300000,223174,2022-08-12
CASH_IN,186027,Agence_mtn_Cotonou,300000,113973,Étienne Roche,2043659,2229686,2022-08-14
CASH_IN,273412,Agence_mtn_Ouidah,300000,26588,Étienne Roche,2229686,2503098,2022-08-14
CASH_OUT,702945,Étienne Roche,2503098,1800153,Agence_mtn_Abomey,300000,-402945,2022-08-16
TRANSFER,180638,Étienne Roche,1800153,1619515,Sophie Lévêque,874300,693662,2022-08-19
TRANSFER,655413,Cécile Clerc,844300,188887,Étienne Roche,1619515,2274928,2022-08-20
TRANSFER,669705,Nathalie Peron,1096200,426495,Étienne Roche,2274928,2944633,2022-08-20
TRANSFER,2030549,Étienne Roche,2944633,914084,Eugène Poulain,614100,-1416449,2022-08-21
TRANSFER,1063867,Virginie Le Gall,1167655,103788,Étienne Roche,914084,1977951,2022-08-22
CASH_OUT,1442703,Étienne Roche,1977951,535248,Agence_mtn_Abomey,300000,-1142703,2022-08-22
CASH_IN,131440,Agence_mtn_Cotonou,300000,168560,Étienne Roche,535248,666688,2022-08-23
CASH_OUT,81033,Étienne Roche,666688,585655,Agence_mtn_Abomey,300000,218967,2022-08-25
CASH_OUT,448027,Étienne Roche,585655,137628,Agence_mtn_Abomey,300000,-148027,2022-08-25
TRANSFER,124786,Édouard Nguyen,444000,319214,Étienne Roche,137628,262414,2022-08-27
CASH_OUT,65945,Étienne Roche,262414,196469,Agence_mtn_Abomey,300000,234055,2022-08-27
TRANSFER,334613,Astrid Gay de la Brunet,510087,175474,Étienne Roche,196469,531082,2022-08-27
TRANSFER,500079,Gabriel-Tristan Marty,798406,298327,Étienne Roche,531082,1031161,2022-08-27
CASH_OUT,535166,Margot Riou du Fernandes,1895000,1359834,Agence_mtn_Ouidah,300000,-235166,2022-08-02
CASH_OUT,159611,Margot Riou du Fernandes,1359834,1200223,Agence_mtn_Ouidah,300000,140389,2022-08-03
CASH_IN,69769,Agence_mtn_Cotonou,300000,230231,Margot Riou du Fernandes,1200223,1269992,2022-08-04
TRANSFER,522179,Margot Riou du Fernandes,1269992,747813,Marcelle Paris,249608,-272571,2022-08-05
TRANSFER,594167,Inès de Letellier,1633200,1039033,Margot Riou du Fernandes,747813,1341980,2022-08-05
TRANSFER,274586,Alexandre Rémy,1804100,1529514,Margot Riou du Fernandes,1341980,1616566,2022-08-07
CASH_OUT,219565,Margot Riou du Fernandes,1616566,1397001,Agence_mtn_Cotonou,300000,80435,2022-08-09
TRANSFER,91380,Louis Pichon,474800,383420,Margot Riou du Fernandes,1397001,1488381,2022-08-12
TRANSFER,346163,Margot Riou du Fernandes,1488381,1142218,Théodore De Oliveira-Nicolas,422046,75883,2022-08-13
TRANSFER,10758,Margot Riou du Fernandes,1142218,1131460,Sophie Lévêque,693662,682904,2022-08-13
CASH_IN,126529,Agence_mtn_Abomey,300000,173471,Margot Riou du Fernandes,1131460,1257989,2022-08-13
CASH_IN,207932,Agence_mtn_Ouidah,300000,92068,Margot Riou du Fernandes,1257989,1465921,2022-08-13
CASH_IN,216153,Agence_mtn_Abomey,300000,83847,Margot Riou du Fernandes,1465921,1682074,2022-08-15
CASH_OUT,15040,Margot Riou du Fernandes,1682074,1667034,Agence_mtn_Cotonou,300000,284960,2022-08-16
CASH_OUT,1369056,Margot Riou du Fernandes,1667034,297978,Agence_mtn_Cotonou,300000,-1069056,2022-08-16
CASH_OUT,128995,Margot Riou du Fernandes,297978,168983,Agence_mtn_Ouidah,300000,171005,2022-08-17
CASH_IN,232395,Agence_mtn_Ouidah,300000,67605,Margot Riou du Fernandes,168983,401378,2022-08-18
TRANSFER,102164,Virginie Le Gall,103788,1624,Margot Riou du Fernandes,401378,503542,2022-08-22
CASH_OUT,290000,Margot Riou du Fernandes,503542,213542,Agence_mtn_Cotonou,300000,10000,2022-08-23
TRANSFER,490808,Pénélope Dupuis,565003,74195,Margot Riou du Fernandes,213542,704350,2022-08-23
CASH_OUT,270254,Margot Riou du Fernandes,704350,434096,Agence_mtn_Abomey,300000,29746,2022-08-23
CASH_IN,69793,Agence_mtn_Abomey,300000,230207,Margot Riou du Fernandes,434096,503889,2022-08-25
TRANSFER,384117,Margot Riou du Fernandes,503889,119772,Antoine Leleu,839800,455683,2022-08-26
CASH_OUT,44452,Margot Riou du Fernandes,119772,75320,Agence_mtn_Ouidah,300000,255548,2022-08-26
TRANSFER,186236,François Michel-Legros,247329,61093,Marine Chauvet-Potier,1479800,1293564,2022-08-02
TRANSFER,49226,François Michel-Legros,61093,11867,Gabriel Humbert,1684412,1635186,2022-08-03
CASH_IN,202580,Agence_mtn_Cotonou,300000,97420,François Michel-Legros,11867,214447,2022-08-03
CASH_OUT,80575,François Michel-Legros,214447,133872,Agence_mtn_Ouidah,300000,219425,2022-08-04
TRANSFER,423177,Thérèse-Margaux Bruneau,1385871,962694,François Michel-Legros,133872,557049,2022-08-09
TRANSFER,119968,Astrid Gay de la Brunet,175474,55506,François Michel-Legros,557049,677017,2022-08-09
CASH_IN,180819,Agence_mtn_Ouidah,300000,119181,François Michel-Legros,677017,857836,2022-08-10
CASH_IN,194444,Agence_mtn_Abomey,300000,105556,François Michel-Legros,857836,1052280,2022-08-10
TRANSFER,761857,Gilbert-Charles Thibault,974603,212746,François Michel-Legros,1052280,1814137,2022-08-11
TRANSFER,817493,François Michel-Legros,1814137,996644,Cécile Clerc,188887,-628606,2022-08-12
CASH_OUT,845496,François Michel-Legros,996644,151148,Agence_mtn_Ouidah,300000,-545496,2022-08-12
CASH_IN,8252,Agence_mtn_Abomey,300000,291748,François Michel-Legros,151148,159400,2022-08-14
TRANSFER,136133,François Michel-Legros,159400,23267,Édouard Nguyen,319214,183081,2022-08-15
CASH_IN,40653,Agence_mtn_Ouidah,300000,259347,François Michel-Legros,23267,63920,2022-08-19
CASH_OUT,24687,François Michel-Legros,63920,39233,Agence_mtn_Abomey,300000,275313,2022-08-22
CASH_IN,12391,Agence_mtn_Ouidah,300000,287609,François Michel-Legros,39233,51624,2022-08-23
CASH_IN,263775,Agence_mtn_Abomey,300000,36225,François Michel-Legros,51624,315399,2022-08-23
CASH_OUT,158969,François Michel-Legros,315399,156430,Agence_mtn_Cotonou,300000,141031,2022-08-23
CASH_OUT,56869,François Michel-Legros,156430,99561,Agence_mtn_Abomey,300000,243131,2022-08-25
CASH_IN,116600,Agence_mtn_Abomey,300000,183400,François Michel-Legros,99561,216161,2022-08-25
TRANSFER,247997,Marine Chauvet-Potier,1293564,1045567,François Michel-Legros,216161,464158,2022-08-26
CASH_IN,67336,Agence_mtn_Ouidah,300000,232664,Renée David,-426013,-358677,2022-08-01
CASH_IN,56079,Agence_mtn_Abomey,300000,243921,Renée David,-358677,-302598,2022-08-02
CASH_IN,77894,Agence_mtn_Cotonou,300000,222106,Renée David,-302598,-224704,2022-08-03
CASH_IN,213982,Agence_mtn_Ouidah,300000,86018,Renée David,-224704,-10722,2022-08-06
CASH_IN,67013,Agence_mtn_Ouidah,300000,232987,Renée David,-10722,56291,2022-08-08
TRANSFER,38353,Renée David,56291,17938,Pierre Reynaud,17700,-20653,2022-08-08
CASH_OUT,12449,Renée David,17938,5489,Agence_mtn_Ouidah,300000,287551,2022-08-08
CASH_IN,89414,Agence_mtn_Cotonou,300000,210586,Renée David,5489,94903,2022-08-10
CASH_IN,8657,Agence_mtn_Cotonou,300000,291343,Renée David,94903,103560,2022-08-11
CASH_IN,48653,Agence_mtn_Abomey,300000,251347,Renée David,103560,152213,2022-08-12
CASH_OUT,20768,Renée David,152213,131445,Agence_mtn_Ouidah,300000,279232,2022-08-13
CASH_OUT,130799,Renée David,131445,646,Agence_mtn_Ouidah,300000,169201,2022-08-14
TRANSFER,265,Renée David,646,381,Sébastien Lemaître,275900,275635,2022-08-15
TRANSFER,186541,Aurore Guyon,1484000,1297459,Renée David,381,186922,2022-08-15
CASH_IN,147130,Agence_mtn_Abomey,300000,152870,Renée David,186922,334052,2022-08-17
CASH_IN,224421,Agence_mtn_Abomey,300000,75579,Renée David,334052,558473,2022-08-17
CASH_OUT,51705,Renée David,558473,506768,Agence_mtn_Abomey,300000,248295,2022-08-18
TRANSFER,392,Virginie Le Gall,1624,1232,Renée David,506768,507160,2022-08-20
TRANSFER,27383,Nathalie Peron,426495,399112,Renée David,507160,534543,2022-08-21
CASH_OUT,59994,Renée David,534543,474549,Agence_mtn_Abomey,300000,240006,2022-08-22
TRANSFER,331350,Renée David,474549,143199,Rémy Le Michaud,498300,166950,2022-08-23
CASH_IN,290858,Agence_mtn_Ouidah,300000,9142,Renée David,143199,434057,2022-08-24
CASH_OUT,121282,Renée David,434057,312775,Agence_mtn_Abomey,300000,178718,2022-08-26
TRANSFER,198490,Renée David,312775,114285,Alexandrie Delmas,1344100,1145610,2022-08-26
CASH_OUT,110832,Renée David,114285,3453,Agence_mtn_Abomey,300000,189168,2022-08-27
TRANSFER,3161,Renée David,3453,292,Aurore Guyon,1297459,1294298,2022-08-27
TRANSFER,448725,Bertrand Charles,623100,174375,Renée David,292,449017,2022-08-27
CASH_OUT,44039,Raymond Rossi,195205,151166,Agence_mtn_Abomey,300000,255961,2022-08-03
CASH_IN,7768,Agence_mtn_Ouidah,300000,292232,Raymond Rossi,151166,158934,2022-08-04
CASH_IN,181823,Agence_mtn_Abomey,300000,118177,Raymond Rossi,158934,340757,2022-08-04
TRANSFER,156267,Raymond Rossi,340757,184490,Pénélope Dupuis,74195,-82072,2022-08-05
CASH_OUT,131976,Raymond Rossi,184490,52514,Agence_mtn_Ouidah,300000,168024,2022-08-06
TRANSFER,949386,Léon Martins-Briand,1519100,569714,Raymond Rossi,52514,1001900,2022-08-06
CASH_OUT,83547,Raymond Rossi,1001900,918353,Agence_mtn_Abomey,300000,216453,2022-08-08
CASH_IN,162398,Agence_mtn_Abomey,300000,137602,Raymond Rossi,918353,1080751,2022-08-09
TRANSFER,152419,Sébastien Vallée,217885,65466,Raymond Rossi,1080751,1233170,2022-08-11
TRANSFER,100536,Inès de Letellier,1039033,938497,Raymond Rossi,1233170,1333706,2022-08-11
CASH_OUT,479126,Raymond Rossi,1333706,854580,Agence_mtn_Cotonou,300000,-179126,2022-08-13
CASH_OUT,294214,Raymond Rossi,854580,560366,Agence_mtn_Cotonou,300000,5786,2022-08-14
TRANSFER,601609,Marine Chauvet-Potier,1045567,443958,Raymond Rossi,560366,1161975,2022-08-17
CASH_IN,63428,Agence_mtn_Abomey,300000,236572,Raymond Rossi,1161975,1225403,2022-08-17
CASH_IN,219437,Agence_mtn_Cotonou,300000,80563,Raymond Rossi,1225403,1444840,2022-08-19
TRANSFER,1033520,Catherine Faivre,1597700,564180,Raymond Rossi,1444840,2478360,2022-08-20
CASH_OUT,444155,Raymond Rossi,2478360,2034205,Agence_mtn_Abomey,300000,-144155,2022-08-20
CASH_IN,119896,Agence_mtn_Cotonou,300000,180104,Raymond Rossi,2034205,2154101,2022-08-21
CASH_IN,174538,Agence_mtn_Ouidah,300000,125462,Raymond Rossi,2154101,2328639,2022-08-22
CASH_OUT,1821499,Raymond Rossi,2328639,507140,Agence_mtn_Cotonou,300000,-1521499,2022-08-22
TRANSFER,25517,Gabriel-Tristan Marty,298327,272810,Raymond Rossi,507140,532657,2022-08-23
TRANSFER,438337,Raymond Rossi,532657,94320,Antoine Leleu,455683,17346,2022-08-24
CASH_IN,104763,Agence_mtn_Cotonou,300000,195237,Raymond Rossi,94320,199083,2022-08-26
CASH_OUT,175182,Raymond Rossi,199083,23901,Agence_mtn_Abomey,300000,124818,2022-08-26
CASH_IN,299003,Agence_mtn_Ouidah,300000,997,Marcelle Paris,-272571,26432,2022-08-04
CASH_OUT,18874,Marcelle Paris,26432,7558,Agence_mtn_Ouidah,300000,281126,2022-08-04
TRANSFER,386943,Sophie Lévêque,682904,295961,Marcelle Paris,7558,394501,2022-08-06
CASH_IN,226236,Agence_mtn_Cotonou,300000,73764,Marcelle Paris,394501,620737,2022-08-07
CASH_OUT,79891,Marcelle Paris,620737,540846,Agence_mtn_Ouidah,300000,220109,2022-08-07
TRANSFER,395523,Marcelle Paris,540846,145323,David Guérin,1009200,613677,2022-08-08
CASH_IN,255,Agence_mtn_Cotonou,300000,299745,Marcelle Paris,145323,145578,2022-08-10
CASH_IN,6456,Agence_mtn_Cotonou,300000,293544,Marcelle Paris,145578,152034,2022-08-10
TRANSFER,347539,Adrien Chartier,380640,33101,Marcelle Paris,152034,499573,2022-08-10
CASH_OUT,309649,Marcelle Paris,499573,189924,Agence_mtn_Abomey,300000,-9649,2022-08-11
CASH_OUT,138240,Marcelle Paris,189924,51684,Agence_mtn_Abomey,300000,161760,2022-08-11
TRANSFER,4608,Marcelle Paris,51684,47076,Adèle Labbé,155218,150610,2022-08-11
CASH_IN,240553,Agence_mtn_Ouidah,300000,59447,Marcelle Paris,47076,287629,2022-08-12
CASH_OUT,190452,Marcelle Paris,287629,97177,Agence_mtn_Cotonou,300000,109548,2022-08-14
CASH_IN,201667,Agence_mtn_Ouidah,300000,98333,Marcelle Paris,97177,298844,2022-08-16
CASH_OUT,67353,Marcelle Paris,298844,231491,Agence_mtn_Cotonou,300000,232647,2022-08-18
CASH_IN,19960,Agence_mtn_Abomey,300000,280040,Marcelle Paris,231491,251451,2022-08-19
CASH_OUT,109925,Marcelle Paris,251451,141526,Agence_mtn_Cotonou,300000,190075,2022-08-19
CASH_OUT,74420,Marcelle Paris,141526,67106,Agence_mtn_Ouidah,300000,225580,2022-08-22
TRANSFER,2431,Marcelle Paris,67106,64675,Thérèse-Margaux Bruneau,962694,960263,2022-08-23
TRANSFER,58609,Marcelle Paris,64675,6066,Nathalie Pages,1177579,1118970,2022-08-27
CASH_IN,148834,Agence_mtn_Abomey,300000,151166,Eugène Poulain,-1416449,-1267615,2022-08-01
CASH_IN,227498,Agence_mtn_Ouidah,300000,72502,Eugène Poulain,-1267615,-1040117,2022-08-02
CASH_IN,28786,Agence_mtn_Ouidah,300000,271214,Eugène Poulain,-1040117,-1011331,2022-08-04
CASH_IN,2509,Agence_mtn_Abomey,300000,297491,Eugène Poulain,-1011331,-1008822,2022-08-06
CASH_IN,184924,Agence_mtn_Ouidah,300000,115076,Eugène Poulain,-1008822,-823898,2022-08-07
CASH_IN,99670,Agence_mtn_Cotonou,300000,200330,Eugène Poulain,-823898,-724228,2022-08-07
CASH_IN,54025,Agence_mtn_Abomey,300000,245975,Eugène Poulain,-724228,-670203,2022-08-07
CASH_IN,285195,Agence_mtn_Ouidah,300000,14805,Eugène Poulain,-670203,-385008,2022-08-07
CASH_IN,14728,Agence_mtn_Ouidah,300000,285272,Eugène Poulain,-385008,-370280,2022-08-07
CASH_IN,256639,Agence_mtn_Ouidah,300000,43361,Eugène Poulain,-370280,-113641,2022-08-07
CASH_IN,16950,Agence_mtn_Ouidah,300000,283050,Eugène Poulain,-113641,-96691,2022-08-08
CASH_IN,168088,Agence_mtn_Ouidah,300000,131912,Eugène Poulain,-96691,71397,2022-08-08
CASH_OUT,66346,Eugène Poulain,71397,5051,Agence_mtn_Ouidah,300000,233654,2022-08-09
CASH_IN,85229,Agence_mtn_Abomey,300000,214771,Eugène Poulain,5051,90280,2022-08-09
TRANSFER,38467,Eugène Poulain,90280,51813,Roland Garcia,1491800,1453333,2022-08-10
CASH_OUT,37423,Eugène Poulain,51813,14390,Agence_mtn_Ouidah,300000,262577,2022-08-10
CASH_IN,198575,Agence_mtn_Abomey,300000,101425,Eugène Poulain,14390,212965,2022-08-12
TRANSFER,46827,Eugène Poulain,212965,166138,Nathalie Peron,399112,352285,2022-08-14
CASH_IN,158470,Agence_mtn_Ouidah,300000,141530,Eugène Poulain,166138,324608,2022-08-14
CASH_IN,74472,Agence_mtn_Cotonou,300000,225528,Eugène Poulain,324608,399080,2022-08-16
TRANSFER,133708,Eugène Poulain,399080,265372,Éléonore-Hélène Dubois,1610700,1476992,2022-08-17
CASH_IN,47176,Agence_mtn_Cotonou,300000,252824,Eugène Poulain,265372,312548,2022-08-20
CASH_OUT,248912,Eugène Poulain,312548,63636,Agence_mtn_Abomey,300000,51088,2022-08-20
CASH_OUT,39095,Eugène Poulain,63636,24541,Agence_mtn_Cotonou,300000,260905,2022-08-22
CASH_OUT,3931,Eugène Poulain,24541,20610,Agence_mtn_Ouidah,300000,296069,2022-08-22
CASH_OUT,10418,Eugène Poulain,20610,10192,Agence_mtn_Abomey,300000,289582,2022-08-26
TRANSFER,123991,Adèle Labbé,150610,26619,Eugène Poulain,10192,134183,2022-08-27
CASH_OUT,19946,Eugène Poulain,134183,114237,Agence_mtn_Cotonou,300000,280054,2022-08-27
CASH_OUT,1289326,Laurent-Bertrand Lefort,1320930,31604,Agence_mtn_Abomey,300000,-989326,2022-08-02
CASH_OUT,27562,Laurent-Bertrand Lefort,31604,4042,Agence_mtn_Abomey,300000,272438,2022-08-03
TRANSFER,88908,Inès de Letellier,938497,849589,Laurent-Bertrand Lefort,4042,92950,2022-08-03
CASH_IN,269935,Agence_mtn_Abomey,300000,30065,Laurent-Bertrand Lefort,92950,362885,2022-08-06
CASH_IN,266126,Agence_mtn_Cotonou,300000,33874,Laurent-Bertrand Lefort,362885,629011,2022-08-06
CASH_OUT,582483,Laurent-Bertrand Lefort,629011,46528,Agence_mtn_Ouidah,300000,-282483,2022-08-08
CASH_IN,277642,Agence_mtn_Cotonou,300000,22358,Laurent-Bertrand Lefort,46528,324170,2022-08-11
CASH_OUT,134306,Laurent-Bertrand Lefort,324170,189864,Agence_mtn_Abomey,300000,165694,2022-08-11
CASH_OUT,180336,Laurent-Bertrand Lefort,189864,9528,Agence_mtn_Abomey,300000,119664,2022-08-12
CASH_IN,53942,Agence_mtn_Cotonou,300000,246058,Laurent-Bertrand Lefort,9528,63470,2022-08-12
TRANSFER,489020,Thérèse-Margaux Bruneau,960263,471243,Laurent-Bertrand Lefort,63470,552490,2022-08-12
TRANSFER,594333,Geneviève De Oliveira-Michel,682401,88068,Laurent-Bertrand Lefort,552490,1146823,2022-08-15
CASH_OUT,891427,Laurent-Bertrand Lefort,1146823,255396,Agence_mtn_Ouidah,300000,-591427,2022-08-15
CASH_OUT,187931,Laurent-Bertrand Lefort,255396,67465,Agence_mtn_Ouidah,300000,112069,2022-08-15
CASH_OUT,6470,Laurent-Bertrand Lefort,67465,60995,Agence_mtn_Abomey,300000,293530,2022-08-16
TRANSFER,47692,Astrid Gay de la Brunet,55506,7814,Laurent-Bertrand Lefort,60995,108687,2022-08-16
CASH_OUT,14665,Laurent-Bertrand Lefort,108687,94022,Agence_mtn_Ouidah,300000,285335,2022-08-17
CASH_OUT,73955,Laurent-Bertrand Lefort,94022,20067,Agence_mtn_Cotonou,300000,226045,2022-08-17
CASH_IN,99078,Agence_mtn_Cotonou,300000,200922,Laurent-Bertrand Lefort,20067,119145,2022-08-19
TRANSFER,377061,Thibaut Coulon,671578,294517,Laurent-Bertrand Lefort,119145,496206,2022-08-20
CASH_OUT,452052,Laurent-Bertrand Lefort,496206,44154,Agence_mtn_Cotonou,300000,-152052,2022-08-21
CASH_IN,233660,Agence_mtn_Ouidah,300000,66340,Laurent-Bertrand Lefort,44154,277814,2022-08-22
CASH_OUT,209409,Laurent-Bertrand Lefort,277814,68405,Agence_mtn_Ouidah,300000,90591,2022-08-24
CASH_IN,266300,Agence_mtn_Cotonou,300000,33700,Laurent-Bertrand Lefort,68405,334705,2022-08-25
CASH_OUT,81908,Laurent-Bertrand Lefort,334705,252797,Agence_mtn_Cotonou,300000,218092,2022-08-25
TRANSFER,51192,Marine Chauvet-Potier,443958,392766,Laurent-Bertrand Lefort,252797,303989,2022-08-27
TRANSFER,58016,Laurent-Bertrand Lefort,303989,245973,Sophie Lévêque,295961,237945,2022-08-27
CASH_IN,115558,Agence_mtn_Cotonou,300000,184442,Sophie Lévêque,237945,353503,2022-08-02
CASH_IN,270692,Agence_mtn_Ouidah,300000,29308,Sophie Lévêque,353503,624195,2022-08-02
TRANSFER,345798,Marine Chauvet-Potier,392766,46968,Sophie Lévêque,624195,969993,2022-08-04
TRANSFER,515138,Léon Martins-Briand,569714,54576,Sophie Lévêque,969993,1485131,2022-08-05
CASH_IN,15693,Agence_mtn_Cotonou,300000,284307,Sophie Lévêque,1485131,1500824,2022-08-06
TRANSFER,797244,Inès de Letellier,849589,52345,Sophie Lévêque,1500824,2298068,2022-08-08
TRANSFER,1810571,Sophie Lévêque,2298068,487497,Franck-Charles Texier,165260,-1645311,2022-08-08
CASH_OUT,163100,Sophie Lévêque,487497,324397,Agence_mtn_Ouidah,300000,136900,2022-08-11
CASH_IN,281712,Agence_mtn_Abomey,300000,18288,Sophie Lévêque,324397,606109,2022-08-11
CASH_OUT,263257,Sophie Lévêque,606109,342852,Agence_mtn_Abomey,300000,36743,2022-08-13
CASH_IN,248343,Agence_mtn_Ouidah,300000,51657,Sophie Lévêque,342852,591195,2022-08-13
CASH_OUT,439546,Sophie Lévêque,591195,151649,Agence_mtn_Abomey,300000,-139546,2022-08-13
CASH_IN,136360,Agence_mtn_Abomey,300000,163640,Sophie Lévêque,151649,288009,2022-08-13
TRANSFER,123775,Céline Gomez,654785,531010,Sophie Lévêque,288009,411784,2022-08-13
TRANSFER,975882,Éléonore-Hélène Dubois,1476992,501110,Sophie Lévêque,411784,1387666,2022-08-15
TRANSFER,227701,Sophie Lévêque,1387666,1159965,Alfred du Lesage,653582,425881,2022-08-20
CASH_IN,179334,Agence_mtn_Ouidah,300000,120666,Sophie Lévêque,1159965,1339299,2022-08-21
CASH_OUT,407115,Sophie Lévêque,1339299,932184,Agence_mtn_Cotonou,300000,-107115,2022-08-22
TRANSFER,124020,Sophie Lévêque,932184,808164,Alexandrie Delmas,1145610,1021590,2022-08-24
CASH_OUT,391982,Sophie Lévêque,808164,416182,Agence_mtn_Ouidah,300000,-91982,2022-08-25
CASH_IN,188617,Agence_mtn_Ouidah,300000,111383,Sophie Lévêque,416182,604799,2022-08-26
TRANSFER,580024,Sophie Lévêque,604799,24775,Adèle Labbé,26619,-553405,2022-08-26
TRANSFER,12163,Antoine Leleu,17346,5183,Alexandre Rémy,1529514,1517351,2022-08-01
CASH_OUT,2325,Antoine Leleu,5183,2858,Agence_mtn_Abomey,300000,297675,2022-08-02
CASH_OUT,1875,Antoine Leleu,2858,983,Agence_mtn_Cotonou,300000,298125,2022-08-03
CASH_IN,88371,Agence_mtn_Ouidah,300000,211629,Antoine Leleu,983,89354,2022-08-05
CASH_OUT,86896,Antoine Leleu,89354,2458,Agence_mtn_Abomey,300000,213104,2022-08-07
CASH_OUT,1872,Antoine Leleu,2458,586,Agence_mtn_Abomey,300000,298128,2022-08-07
TRANSFER,598903,Alphonse Le Olivier,704154,105251,Antoine Leleu,586,599489,2022-08-07
CASH_OUT,225101,Antoine Leleu,599489,374388,Agence_mtn_Ouidah,300000,74899,2022-08-07
CASH_OUT,85488,Antoine Leleu,374388,288900,Agence_mtn_Abomey,300000,214512,2022-08-09
CASH_OUT,74941,Antoine Leleu,288900,213959,Agence_mtn_Abomey,300000,225059,2022-08-09
CASH_OUT,40061,Antoine Leleu,213959,173898,Agence_mtn_Abomey,300000,259939,2022-08-10
TRANSFER,38777,Antoine Leleu,173898,135121,Alexandre Rémy,1517351,1478574,2022-08-11
CASH_OUT,19068,Antoine Leleu,135121,116053,Agence_mtn_Cotonou,300000,280932,2022-08-12
CASH_OUT,53048,Antoine Leleu,116053,63005,Agence_mtn_Cotonou,300000,246952,2022-08-12
CASH_IN,291111,Agence_mtn_Ouidah,300000,8889,Antoine Leleu,63005,354116,2022-08-13
TRANSFER,311130,Nathalie Peron,352285,41155,Antoine Leleu,354116,665246,2022-08-14
TRANSFER,332971,Antoine Leleu,665246,332275,Alfred du Lesage,425881,92910,2022-08-15
CASH_IN,39853,Agence_mtn_Ouidah,300000,260147,Antoine Leleu,332275,372128,2022-08-15
CASH_IN,32213,Agence_mtn_Cotonou,300000,267787,Antoine Leleu,372128,404341,2022-08-15
CASH_IN,285635,Agence_mtn_Cotonou,300000,14365,Antoine Leleu,404341,689976,2022-08-15
CASH_OUT,607474,Antoine Leleu,689976,82502,Agence_mtn_Abomey,300000,-307474,2022-08-16
CASH_IN,55141,Agence_mtn_Abomey,300000,244859,Antoine Leleu,82502,137643,2022-08-19
CASH_OUT,116107,Antoine Leleu,137643,21536,Agence_mtn_Abomey,300000,183893,2022-08-19
CASH_IN,198653,Agence_mtn_Cotonou,300000,101347,Antoine Leleu,21536,220189,2022-08-21
TRANSFER,111372,Rémy Le Michaud,166950,55578,Antoine Leleu,220189,331561,2022-08-24
TRANSFER,145453,Antoine Leleu,331561,186108,Laure Philippe,1184155,1038702,2022-08-25
CASH_IN,279863,Agence_mtn_Ouidah,300000,20137,Antoine Leleu,186108,465971,2022-08-26
TRANSFER,277912,Catherine Faivre,564180,286268,Antoine Leleu,465971,743883,2022-08-26
CASH_OUT,347706,Antoine Leleu,743883,396177,Agence_mtn_Abomey,300000,-47706,2022-08-27
CASH_IN,173188,Agence_mtn_Cotonou,300000,126812,Adèle Labbé,-553405,-380217,2022-08-01
CASH_IN,295787,Agence_mtn_Abomey,300000,4213,Adèle Labbé,-380217,-84430,2022-08-01
CASH_IN,184813,Agence_mtn_Cotonou,300000,115187,Adèle Labbé,-84430,100383,2022-08-02
CASH_IN,289701,Agence_mtn_Ouidah,300000,10299,Adèle Labbé,100383,390084,2022-08-03
TRANSFER,123023,Jeanne Garnier,1096000,972977,Adèle Labbé,390084,513107,2022-08-06
TRANSFER,27566,Léon Martins-Briand,54576,27010,Adèle Labbé,513107,540673,2022-08-06
CASH_OUT,352919,Adèle Labbé,540673,187754,Agence_mtn_Ouidah,300000,-52919,2022-08-08
TRANSFER,114422,Adèle Labbé,187754,73332,Léon Martins-Briand,27010,-87412,2022-08-10
TRANSFER,4455,Sébastien Vallée,65466,61011,Adèle Labbé,73332,77787,2022-08-11
CASH_OUT,21969,Adèle Labbé,77787,55818,Agence_mtn_Cotonou,300000,278031,2022-08-12
TRANSFER,143672,Nathalie Pages,1118970,975298,Adèle Labbé,55818,199490,2022-08-13
CASH_OUT,113368,Adèle Labbé,199490,86122,Agence_mtn_Abomey,300000,186632,2022-08-13
TRANSFER,942878,Nathalie Pages,975298,32420,Adèle Labbé,86122,1029000,2022-08-13
TRANSFER,125263,David Guérin,613677,488414,Adèle Labbé,1029000,1154263,2022-08-14
TRANSFER,244222,Richard Le Descamps,252457,8235,Adèle Labbé,1154263,1398485,2022-08-14
TRANSFER,284200,Adèle Labbé,1398485,1114285,Nathalie Peron,41155,-243045,2022-08-15
TRANSFER,1109746,Adèle Labbé,1114285,4539,Louis Pichon,383420,-726326,2022-08-15
CASH_OUT,1116,Adèle Labbé,4539,3423,Agence_mtn_Abomey,300000,298884,2022-08-16
CASH_OUT,2033,Adèle Labbé,3423,1390,Agence_mtn_Cotonou,300000,297967,2022-08-18
CASH_OUT,782,Adèle Labbé,1390,608,Agence_mtn_Abomey,300000,299218,2022-08-20
TRANSFER,448,Adèle Labbé,608,160,Rémy Le Michaud,55578,55130,2022-08-20
CASH_OUT,105,Adèle Labbé,160,55,Agence_mtn_Abomey,300000,299895,2022-08-21
CASH_IN,232094,Agence_mtn_Cotonou,300000,67906,Adèle Labbé,55,232149,2022-08-21
TRANSFER,675745,Jeanne Garnier,972977,297232,Adèle Labbé,232149,907894,2022-08-22
CASH_IN,149001,Agence_mtn_Abomey,300000,150999,Adèle Labbé,907894,1056895,2022-08-24
CASH_IN,200458,Agence_mtn_Abomey,300000,99542,Adèle Labbé,1056895,1257353,2022-08-26
CASH_IN,15380,Agence_mtn_Cotonou,300000,284620,Adèle Labbé,1257353,1272733,2022-08-26
CASH_IN,29067,Agence_mtn_Cotonou,300000,270933,Adèle Labbé,1272733,1301800,2022-08-26
CASH_OUT,1200193,Adèle Labbé,1301800,101607,Agence_mtn_Cotonou,300000,-900193,2022-08-27
CASH_IN,83015,Agence_mtn_Ouidah,300000,216985,Adèle Labbé,101607,184622,2022-08-27
TRANSFER,22995,Inès de Letellier,52345,29350,Alexandrie Delmas,1021590,1044585,2022-08-02
TRANSFER,132246,Jeanne Garnier,297232,164986,Alexandrie Delmas,1044585,1176831,2022-08-03
CASH_IN,81914,Agence_mtn_Cotonou,300000,218086,Alexandrie Delmas,1176831,1258745,2022-08-03
CASH_OUT,961737,Alexandrie Delmas,1258745,297008,Agence_mtn_Abomey,300000,-661737,2022-08-06
CASH_IN,13207,Agence_mtn_Abomey,300000,286793,Alexandrie Delmas,297008,310215,2022-08-08
TRANSFER,96011,Alexandrie Delmas,310215,214204,Xavier de Lebreton,62692,-33319,2022-08-08
CASH_IN,73584,Agence_mtn_Cotonou,300000,226416,Alexandrie Delmas,214204,287788,2022-08-08
TRANSFER,42193,Alexandrie Delmas,287788,245595,Adrien Chartier,33101,-9092,2022-08-08
CASH_OUT,27574,Alexandrie Delmas,245595,218021,Agence_mtn_Ouidah,300000,272426,2022-08-09
CASH_OUT,16784,Alexandrie Delmas,218021,201237,Agence_mtn_Abomey,300000,283216,2022-08-10
TRANSFER,171389,Alexandrie Delmas,201237,29848,Marine Chauvet-Potier,46968,-124421,2022-08-11
CASH_OUT,8496,Alexandrie Delmas,29848,21352,Agence_mtn_Ouidah,300000,291504,2022-08-11
TRANSFER,13186,Alexandrie Delmas,21352,8166,Thérèse-Margaux Bruneau,471243,458057,2022-08-14
CASH_IN,216819,Agence_mtn_Cotonou,300000,83181,Alexandrie Delmas,8166,224985,2022-08-14
TRANSFER,795708,Sophie Gonzalez,1023653,227945,Alexandrie Delmas,224985,1020693,2022-08-19
TRANSFER,18235,Inès de Letellier,29350,11115,Alexandrie Delmas,1020693,1038928,2022-08-19
CASH_IN,262736,Agence_mtn_Cotonou,300000,37264,Alexandrie Delmas,1038928,1301664,2022-08-20
CASH_OUT,414882,Alexandrie Delmas,1301664,886782,Agence_mtn_Abomey,300000,-114882,2022-08-20
CASH_IN,175270,Agence_mtn_Ouidah,300000,124730,Alexandrie Delmas,886782,1062052,2022-08-22
CASH_IN,272884,Agence_mtn_Ouidah,300000,27116,Alexandrie Delmas,1062052,1334936,2022-08-22
TRANSFER,220657,Thérèse-Margaux Bruneau,458057,237400,Alexandrie Delmas,1334936,1555593,2022-08-25
CASH_IN,91453,Agence_mtn_Cotonou,300000,208547,Pierre Reynaud,-20653,70800,2022-08-01
CASH_OUT,57321,Pierre Reynaud,70800,13479,Agence_mtn_Cotonou,300000,242679,2022-08-02
CASH_IN,137717,Agence_mtn_Cotonou,300000,162283,Pierre Reynaud,13479,151196,2022-08-03
CASH_OUT,63439,Pierre Reynaud,151196,87757,Agence_mtn_Abomey,300000,236561,2022-08-05
CASH_IN,46306,Agence_mtn_Ouidah,300000,253694,Pierre Reynaud,87757,134063,2022-08-07
CASH_OUT,87139,Pierre Reynaud,134063,46924,Agence_mtn_Ouidah,300000,212861,2022-08-07
TRANSFER,15974,Nathalie Pages,32420,16446,Pierre Reynaud,46924,62898,2022-08-09
CASH_IN,10447,Agence_mtn_Cotonou,300000,289553,Pierre Reynaud,62898,73345,2022-08-10
CASH_IN,122842,Agence_mtn_Cotonou,300000,177158,Pierre Reynaud,73345,196187,2022-08-12
CASH_OUT,164143,Pierre Reynaud,196187,32044,Agence_mtn_Ouidah,300000,135857,2022-08-13
CASH_OUT,6595,Pierre Reynaud,32044,25449,Agence_mtn_Abomey,300000,293405,2022-08-13
CASH_IN,75938,Agence_mtn_Abomey,300000,224062,Pierre Reynaud,25449,101387,2022-08-13
CASH_OUT,79341,Pierre Reynaud,101387,22046,Agence_mtn_Abomey,300000,220659,2022-08-14
TRANSFER,4354,Inès de Letellier,11115,6761,Pierre Reynaud,22046,26400,2022-08-14
TRANSFER,885527,Aurore Guyon,1294298,408771,Pierre Reynaud,26400,911927,2022-08-14
CASH_OUT,185436,Pierre Reynaud,911927,726491,Agence_mtn_Abomey,300000,114564,2022-08-17
CASH_OUT,107543,Pierre Reynaud,726491,618948,Agence_mtn_Abomey,300000,192457,2022-08-18
TRANSFER,977594,Corinne-Louise Valentin,1920500,942906,Pierre Reynaud,618948,1596542,2022-08-19
CASH_OUT,466845,Pierre Reynaud,1596542,1129697,Agence_mtn_Cotonou,300000,-166845,2022-08-21
CASH_OUT,1008459,Pierre Reynaud,1129697,121238,Agence_mtn_Abomey,300000,-708459,2022-08-24
TRANSFER,384418,Bertrand Le Roux,676800,292382,Pierre Reynaud,121238,505656,2022-08-25
TRANSFER,205504,Sophie Gonzalez,227945,22441,Pierre Reynaud,505656,711160,2022-08-25
CASH_IN,293993,Agence_mtn_Cotonou,300000,6007,Isabelle Rossi,-150201,143792,2022-08-02
CASH_OUT,103414,Isabelle Rossi,143792,40378,Agence_mtn_Abomey,300000,196586,2022-08-03
TRANSFER,70175,Édouard Nguyen,183081,112906,Isabelle Rossi,40378,110553,2022-08-03
CASH_OUT,65623,Isabelle Rossi,110553,44930,Agence_mtn_Cotonou,300000,234377,2022-08-03
CASH_IN,100005,Agence_mtn_Abomey,300000,199995,Isabelle Rossi,44930,144935,2022-08-04
CASH_OUT,120790,Isabelle Rossi,144935,24145,Agence_mtn_Ouidah,300000,179210,2022-08-07
TRANSFER,382970,Corinne-Louise Valentin,942906,559936,Isabelle Rossi,24145,407115,2022-08-07
CASH_OUT,227719,Isabelle Rossi,407115,179396,Agence_mtn_Ouidah,300000,72281,2022-08-10
CASH_OUT,170012,Isabelle Rossi,179396,9384,Agence_mtn_Ouidah,300000,129988,2022-08-10
CASH_IN,186247,Agence_mtn_Cotonou,300000,113753,Isabelle Rossi,9384,195631,2022-08-11
CASH_IN,60925,Agence_mtn_Cotonou,300000,239075,Isabelle Rossi,195631,256556,2022-08-13
TRANSFER,251985,Isabelle Rossi,256556,4571,Astrid Gay de la Brunet,7814,-244171,2022-08-13
TRANSFER,2561,Isabelle Rossi,4571,2010,Édouard Nguyen,112906,110345,2022-08-14
CASH_OUT,386,Isabelle Rossi,2010,1624,Agence_mtn_Abomey,300000,299614,2022-08-15
TRANSFER,90025,Gilbert-Charles Thibault,212746,122721,Isabelle Rossi,1624,91649,2022-08-16
CASH_IN,277603,Agence_mtn_Abomey,300000,22397,Isabelle Rossi,91649,369252,2022-08-17
CASH_OUT,304519,Isabelle Rossi,369252,64733,Agence_mtn_Ouidah,300000,-4519,2022-08-18
TRANSFER,3177,Inès de Letellier,6761,3584,Isabelle Rossi,64733,67910,2022-08-19
TRANSFER,13550,Isabelle Rossi,67910,54360,Thérèse-Margaux Bruneau,237400,223850,2022-08-21
TRANSFER,132999,Frédéric Couturier,1384400,1251401,Isabelle Rossi,54360,187359,2022-08-21
CASH_OUT,7648,Isabelle Rossi,187359,179711,Agence_mtn_Ouidah,300000,292352,2022-08-21
CASH_IN,99363,Agence_mtn_Cotonou,300000,200637,Isabelle Rossi,179711,279074,2022-08-25
CASH_OUT,91245,Édouard Nguyen,110345,19100,Agence_mtn_Abomey,300000,208755,2022-08-01
TRANSFER,240584,Sébastien Lemaître,275635,35051,Édouard Nguyen,19100,259684,2022-08-02
TRANSFER,1444663,Nath Bruneau,1455600,10937,Édouard Nguyen,259684,1704347,2022-08-02
CASH_IN,75830,Agence_mtn_Ouidah,300000,224170,Édouard Nguyen,1704347,1780177,2022-08-02
CASH_OUT,883334,Édouard Nguyen,1780177,896843,Agence_mtn_Cotonou,300000,-583334,2022-08-04
CASH_IN,280413,Agence_mtn_Cotonou,300000,19587,Édouard Nguyen,896843,1177256,2022-08-06
CASH_IN,237558,Agence_mtn_Abomey,300000,62442,Édouard Nguyen,1177256,1414814,2022-08-07
CASH_OUT,816198,Édouard Nguyen,1414814,598616,Agence_mtn_Cotonou,300000,-516198,2022-08-07
TRANSFER,205818,Thérèse-Margaux Bruneau,223850,18032,Édouard Nguyen,598616,804434,2022-08-09
CASH_OUT,17951,Édouard Nguyen,804434,786483,Agence_mtn_Abomey,300000,282049,2022-08-09
CASH_OUT,580948,Édouard Nguyen,786483,205535,Agence_mtn_Cotonou,300000,-280948,2022-08-10
CASH_OUT,193156,Édouard Nguyen,205535,12379,Agence_mtn_Cotonou,300000,106844,2022-08-12
CASH_IN,123749,Agence_mtn_Cotonou,300000,176251,Édouard Nguyen,12379,136128,2022-08-12
CASH_OUT,32403,Édouard Nguyen,136128,103725,Agence_mtn_Ouidah,300000,267597,2022-08-14
CASH_OUT,81460,Édouard Nguyen,103725,22265,Agence_mtn_Abomey,300000,218540,2022-08-14
CASH_OUT,6425,Édouard Nguyen,22265,15840,Agence_mtn_Abomey,300000,293575,2022-08-15
TRANSFER,6466,Édouard Nguyen,15840,9374,Roland Garcia,1453333,1446867,2022-08-15
TRANSFER,107651,Roland Garcia,1446867,1339216,Édouard Nguyen,9374,117025,2022-08-17
TRANSFER,91771,Édouard Nguyen,117025,25254,Aurore Guyon,408771,317000,2022-08-18
TRANSFER,12650,Édouard Nguyen,25254,12604,Jean Benard,132167,119517,2022-08-19
TRANSFER,38572,Rémy Le Michaud,55130,16558,Édouard Nguyen,12604,51176,2022-08-19
TRANSFER,288300,Roland Garcia,1339216,1050916,Édouard Nguyen,51176,339476,2022-08-23
TRANSFER,40843,Sébastien Vallée,61011,20168,Édouard Nguyen,339476,380319,2022-08-25
TRANSFER,161707,Édouard Nguyen,380319,218612,Inès de Letellier,3584,-158123,2022-08-27
TRANSFER,662411,Laure Philippe,1038702,376291,Sébastien Vallée,20168,682579,2022-08-03
TRANSFER,134202,Bertrand Charles,174375,40173,Sébastien Vallée,682579,816781,2022-08-03
TRANSFER,8549,Thérèse-Margaux Bruneau,18032,9483,Sébastien Vallée,816781,825330,2022-08-03
CASH_OUT,96767,Sébastien Vallée,825330,728563,Agence_mtn_Cotonou,300000,203233,2022-08-04
CASH_OUT,105354,Sébastien Vallée,728563,623209,Agence_mtn_Abomey,300000,194646,2022-08-04
CASH_OUT,357197,Sébastien Vallée,623209,266012,Agence_mtn_Ouidah,300000,-57197,2022-08-06
TRANSFER,39557,Sébastien Vallée,266012,226455,Sébastien Vallée,266012,305569,2022-08-06
TRANSFER,1230,Virginie Le Gall,1232,2,Sébastien Vallée,226455,227685,2022-08-09
CASH_IN,175151,Agence_mtn_Abomey,300000,124849,Sébastien Vallée,227685,402836,2022-08-09
CASH_OUT,122424,Sébastien Vallée,402836,280412,Agence_mtn_Abomey,300000,177576,2022-08-09
CASH_OUT,28017,Sébastien Vallée,280412,252395,Agence_mtn_Cotonou,300000,271983,2022-08-11
CASH_IN,5422,Agence_mtn_Ouidah,300000,294578,Sébastien Vallée,252395,257817,2022-08-12
CASH_OUT,120266,Sébastien Vallée,257817,137551,Agence_mtn_Ouidah,300000,179734,2022-08-13
CASH_IN,219449,Agence_mtn_Cotonou,300000,80551,Sébastien Vallée,137551,357000,2022-08-13
TRANSFER,75451,Sébastien Vallée,357000,281549,Aurore Guyon,317000,241549,2022-08-15
CASH_OUT,149075,Sébastien Vallée,281549,132474,Agence_mtn_Ouidah,300000,150925,2022-08-15
TRANSFER,8313,Théodore De Oliveira-Nicolas,75883,67570,Sébastien Vallée,132474,140787,2022-08-18
CASH_IN,120300,Agence_mtn_Ouidah,300000,179700,Sébastien Vallée,140787,261087,2022-08-18
CASH_OUT,239907,Sébastien Vallée,261087,21180,Agence_mtn_Abomey,300000,60093,2022-08-18
CASH_OUT,5107,Sébastien Vallée,21180,16073,Agence_mtn_Ouidah,300000,294893,2022-08-19
TRANSFER,474777,Éléonore-Hélène Dubois,501110,26333,Sébastien Vallée,16073,490850,2022-08-22
CASH_IN,136114,Agence_mtn_Abomey,300000,163886,Sébastien Vallée,490850,626964,2022-08-23
CASH_IN,251977,Agence_mtn_Ouidah,300000,48023,Sébastien Vallée,626964,878941,2022-08-24
TRANSFER,557633,Sébastien Vallée,878941,321308,Sophie Gonzalez,22441,-535192,2022-08-26
CASH_OUT,237778,Sébastien Vallée,321308,83530,Agence_mtn_Abomey,300000,62222,2022-08-26
CASH_IN,34736,Agence_mtn_Ouidah,300000,265264,Sébastien Vallée,83530,118266,2022-08-26
CASH_OUT,2818,Sébastien Vallée,118266,115448,Agence_mtn_Ouidah,300000,297182,2022-08-27
CASH_IN,265198,Agence_mtn_Cotonou,300000,34802,Nathalie Pages,16446,281644,2022-08-03
CASH_IN,86115,Agence_mtn_Cotonou,300000,213885,Nathalie Pages,281644,367759,2022-08-03
CASH_OUT,39633,Nathalie Pages,367759,328126,Agence_mtn_Abomey,300000,260367,2022-08-05
CASH_IN,50516,Agence_mtn_Cotonou,300000,249484,Nathalie Pages,328126,378642,2022-08-06
CASH_IN,31010,Agence_mtn_Ouidah,300000,268990,Nathalie Pages,378642,409652,2022-08-07
TRANSFER,35880,Nathalie Pages,409652,373772,Thibaut Coulon,294517,258637,2022-08-07
CASH_IN,253918,Agence_mtn_Ouidah,300000,46082,Nathalie Pages,373772,627690,2022-08-09
CASH_OUT,418954,Nathalie Pages,627690,208736,Agence_mtn_Ouidah,300000,-118954,2022-08-09
CASH_IN,175662,Agence_mtn_Cotonou,300000,124338,Nathalie Pages,208736,384398,2022-08-09
CASH_IN,198567,Agence_mtn_Cotonou,300000,101433,Nathalie Pages,384398,582965,2022-08-11
TRANSFER,9911,Gilbert-Charles Thibault,122721,112810,Nathalie Pages,582965,592876,2022-08-12
CASH_OUT,360644,Nathalie Pages,592876,232232,Agence_mtn_Cotonou,300000,-60644,2022-08-14
CASH_OUT,14228,Nathalie Pages,232232,218004,Agence_mtn_Abomey,300000,285772,2022-08-14
TRANSFER,81043,Nathalie Pages,218004,136961,Alfred du Lesage,92910,11867,2022-08-15
CASH_OUT,94173,Nathalie Pages,136961,42788,Agence_mtn_Cotonou,300000,205827,2022-08-15
TRANSFER,35932,Nathalie Pages,42788,6856,Nath Bruneau,10937,-24995,2022-08-19
TRANSFER,3444,Éléonore-Hélène Dubois,26333,22889,Nathalie Pages,6856,10300,2022-08-19
CASH_OUT,3403,Nathalie Pages,10300,6897,Agence_mtn_Ouidah,300000,296597,2022-08-20
CASH_OUT,3081,Nathalie Pages,6897,3816,Agence_mtn_Ouidah,300000,296919,2022-08-22
CASH_IN,191546,Agence_mtn_Ouidah,300000,108454,Nathalie Pages,3816,195362,2022-08-24
CASH_OUT,176583,Nathalie Pages,195362,18779,Agence_mtn_Abomey,300000,123417,2022-08-25
TRANSFER,6101,Nathalie Pages,18779,12678,Richard Le Descamps,8235,2134,2022-08-26
CASH_OUT,3589,Nathalie Pages,12678,9089,Agence_mtn_Ouidah,300000,296411,2022-08-26
CASH_IN,92126,Agence_mtn_Ouidah,300000,207874,Nathalie Pages,9089,101215,2022-08-27
TRANSFER,2402,Alfred du Lesage,11867,9465,Théodore De Oliveira-Nicolas,67570,69972,2022-08-01
TRANSFER,57868,Théodore De Oliveira-Nicolas,69972,12104,Aurore Guyon,241549,183681,2022-08-03
CASH_IN,155726,Agence_mtn_Cotonou,300000,144274,Théodore De Oliveira-Nicolas,12104,167830,2022-08-05
TRANSFER,122953,Théodore De Oliveira-Nicolas,167830,44877,Catherine Faivre,286268,163315,2022-08-08
CASH_IN,299689,Agence_mtn_Abomey,300000,311,Théodore De Oliveira-Nicolas,44877,344566,2022-08-10
TRANSFER,25410,Catherine Faivre,163315,137905,Théodore De Oliveira-Nicolas,344566,369976,2022-08-11
CASH_IN,246581,Agence_mtn_Abomey,300000,53419,Théodore De Oliveira-Nicolas,369976,616557,2022-08-18
TRANSFER,93237,Théodore De Oliveira-Nicolas,616557,523320,Thibaut Coulon,258637,165400,2022-08-23
TRANSFER,210632,Corinne-Louise Valentin,559936,349304,Théodore De Oliveira-Nicolas,523320,733952,2022-08-25
TRANSFER,262683,Théodore De Oliveira-Nicolas,733952,471269,Bertrand Charles,40173,-222510,2022-08-26
CASH_IN,46841,Agence_mtn_Ouidah,300000,253159,Louis Pichon,-726326,-679485,2022-08-03
CASH_IN,167582,Agence_mtn_Ouidah,300000,132418,Louis Pichon,-679485,-511903,2022-08-03
CASH_IN,118697,Agence_mtn_Ouidah,300000,181303,Louis Pichon,-511903,-393206,2022-08-09
CASH_IN,135462,Agence_mtn_Ouidah,300000,164538,Louis Pichon,-393206,-257744,2022-08-15
CASH_IN,164206,Agence_mtn_Abomey,300000,135794,Louis Pichon,-257744,-93538,2022-08-16
CASH_IN,183393,Agence_mtn_Cotonou,300000,116607,Louis Pichon,-93538,89855,2022-08-17
CASH_IN,196676,Agence_mtn_Ouidah,300000,103324,Louis Pichon,89855,286531,2022-08-18
CASH_OUT,285858,Louis Pichon,286531,673,Agence_mtn_Cotonou,300000,14142,2022-08-21
CASH_OUT,291,Louis Pichon,673,382,Agence_mtn_Cotonou,300000,299709,2022-08-22
CASH_OUT,203,Louis Pichon,382,179,Agence_mtn_Abomey,300000,299797,2022-08-22
CASH_OUT,157,Louis Pichon,179,22,Agence_mtn_Cotonou,300000,299843,2022-08-23
CASH_IN,21743,Agence_mtn_Cotonou,300000,278257,Louis Pichon,22,21765,2022-08-24
CASH_IN,118254,Agence_mtn_Cotonou,300000,181746,Louis Pichon,21765,140019,2022-08-25
CASH_IN,153248,Agence_mtn_Ouidah,300000,146752,Louis Pichon,140019,293267,2022-08-25
CASH_IN,112448,Agence_mtn_Cotonou,300000,187552,Louis Pichon,293267,405715,2022-08-26
CASH_IN,163729,Agence_mtn_Cotonou,300000,136271,Inès de Letellier,-158123,5606,2022-08-01
TRANSFER,5341,Inès de Letellier,5606,265,Richard Le Descamps,2134,-3207,2022-08-02
TRANSFER,96939,Jean Benard,119517,22578,Inès de Letellier,265,97204,2022-08-06
TRANSFER,93509,Inès de Letellier,97204,3695,Pierre Roger,1099926,1006417,2022-08-08
CASH_OUT,3245,Inès de Letellier,3695,450,Agence_mtn_Ouidah,300000,296755,2022-08-09
CASH_OUT,363,Inès de Letellier,450,87,Agence_mtn_Ouidah,300000,299637,2022-08-09
CASH_IN,83010,Agence_mtn_Cotonou,300000,216990,Inès de Letellier,87,83097,2022-08-11
CASH_IN,15560,Agence_mtn_Cotonou,300000,284440,Inès de Letellier,83097,98657,2022-08-12
TRANSFER,91967,Inès de Letellier,98657,6690,Céline Gomez,531010,439043,2022-08-15
CASH_OUT,6179,Inès de Letellier,6690,511,Agence_mtn_Cotonou,300000,293821,2022-08-16
TRANSFER,287,Inès de Letellier,511,224,Laure Philippe,376291,376004,2022-08-21
TRANSFER,100,Inès de Letellier,224,124,Éléonore-Hélène Dubois,22889,22789,2022-08-22
CASH_IN,116069,Agence_mtn_Abomey,300000,183931,Inès de Letellier,124,116193,2022-08-22
TRANSFER,9547,Éléonore-Hélène Dubois,22789,13242,Inès de Letellier,116193,125740,2022-08-22
CASH_OUT,45621,Inès de Letellier,125740,80119,Agence_mtn_Abomey,300000,254379,2022-08-23
TRANSFER,782699,Frédéric Couturier,1251401,468702,Inès de Letellier,80119,862818,2022-08-23
TRANSFER,537554,Benjamin Evrard-Marty,1010200,472646,Inès de Letellier,862818,1400372,2022-08-24
TRANSFER,170396,Céline Gomez,439043,268647,Inès de Letellier,1400372,1570768,2022-08-24
CASH_IN,84282,Agence_mtn_Ouidah,300000,215718,Inès de Letellier,1570768,1655050,2022-08-24
CASH_OUT,1584408,Inès de Letellier,1655050,70642,Agence_mtn_Ouidah,300000,-1284408,2022-08-27
CASH_IN,287548,Agence_mtn_Ouidah,300000,12452,Michelle Lebon,-553182,-265634,2022-08-02
CASH_IN,64307,Agence_mtn_Abomey,300000,235693,Michelle Lebon,-265634,-201327,2022-08-04
CASH_IN,194626,Agence_mtn_Ouidah,300000,105374,Michelle Lebon,-201327,-6701,2022-08-12
CASH_IN,208743,Agence_mtn_Abomey,300000,91257,Michelle Lebon,-6701,202042,2022-08-16
CASH_IN,274299,Agence_mtn_Cotonou,300000,25701,Michelle Lebon,202042,476341,2022-08-17
CASH_IN,143067,Agence_mtn_Ouidah,300000,156933,Michelle Lebon,476341,619408,2022-08-21
CASH_OUT,590412,Michelle Lebon,619408,28996,Agence_mtn_Ouidah,300000,-290412,2022-08-27
CASH_IN,177034,Agence_mtn_Cotonou,300000,122966,Xavier Leblanc-Ferreira,205975,383009,2022-08-03
TRANSFER,5896,Margot Renaud,11200,5304,Xavier Leblanc-Ferreira,383009,388905,2022-08-04
TRANSFER,8680,Rémy Le Michaud,16558,7878,Xavier Leblanc-Ferreira,388905,397585,2022-08-04
CASH_IN,47146,Agence_mtn_Abomey,300000,252854,Xavier Leblanc-Ferreira,397585,444731,2022-08-04
CASH_IN,160197,Agence_mtn_Abomey,300000,139803,Xavier Leblanc-Ferreira,444731,604928,2022-08-05
TRANSFER,229479,Gabriel-Tristan Marty,272810,43331,Xavier Leblanc-Ferreira,604928,834407,2022-08-07
TRANSFER,199,Margot Renaud,5304,5105,Xavier Leblanc-Ferreira,834407,834606,2022-08-08
CASH_IN,270629,Agence_mtn_Abomey,300000,29371,Xavier Leblanc-Ferreira,834606,1105235,2022-08-10
CASH_OUT,359584,Xavier Leblanc-Ferreira,1105235,745651,Agence_mtn_Abomey,300000,-59584,2022-08-16
TRANSFER,518960,Xavier Leblanc-Ferreira,745651,226691,Alexandre Rémy,1478574,959614,2022-08-18
CASH_OUT,136075,Xavier Leblanc-Ferreira,226691,90616,Agence_mtn_Abomey,300000,163925,2022-08-19
CASH_IN,191393,Agence_mtn_Cotonou,300000,108607,Xavier Leblanc-Ferreira,90616,282009,2022-08-21
CASH_IN,185856,Agence_mtn_Abomey,300000,114144,Xavier Leblanc-Ferreira,282009,467865,2022-08-21
CASH_OUT,19690,Xavier Leblanc-Ferreira,467865,448175,Agence_mtn_Abomey,300000,280310,2022-08-22
CASH_IN,209220,Agence_mtn_Ouidah,300000,90780,Alix Maillet,-22856,186364,2022-08-01
TRANSFER,205129,Frédéric Couturier,468702,263573,Alix Maillet,186364,391493,2022-08-08
CASH_OUT,268584,Alix Maillet,391493,122909,Agence_mtn_Cotonou,300000,31416,2022-08-08
CASH_IN,293896,Agence_mtn_Ouidah,300000,6104,Alix Maillet,122909,416805,2022-08-15
TRANSFER,817510,Pierre Roger,1006417,188907,Alix Maillet,416805,1234315,2022-08-15
TRANSFER,2221,Rémy Le Michaud,7878,5657,Alix Maillet,1234315,1236536,2022-08-17
TRANSFER,505178,Émilie Moulin,733389,228211,Alix Maillet,1236536,1741714,2022-08-17
CASH_IN,230725,Agence_mtn_Ouidah,300000,69275,Alix Maillet,1741714,1972439,2022-08-25
TRANSFER,1307338,Gabriel Humbert,1635186,327848,Alix Maillet,1972439,3279777,2022-08-27
CASH_IN,251514,Agence_mtn_Abomey,300000,48486,Alix Maillet,3279777,3531291,2022-08-27
CASH_OUT,8601,Éléonore-Hélène Dubois,13242,4641,Agence_mtn_Ouidah,300000,291399,2022-08-02
TRANSFER,29847,Frédéric Couturier,263573,233726,Éléonore-Hélène Dubois,4641,34488,2022-08-06
CASH_IN,255638,Agence_mtn_Abomey,300000,44362,Éléonore-Hélène Dubois,34488,290126,2022-08-06
TRANSFER,134131,Catherine Faivre,137905,3774,Éléonore-Hélène Dubois,290126,424257,2022-08-11
TRANSFER,374710,Éléonore-Hélène Dubois,424257,49547,Gabriel-Tristan Marty,43331,-331379,2022-08-14
TRANSFER,169713,Émilie Moulin,228211,58498,Éléonore-Hélène Dubois,49547,219260,2022-08-15
CASH_IN,107467,Agence_mtn_Cotonou,300000,192533,Éléonore-Hélène Dubois,219260,326727,2022-08-22
TRANSFER,22670,Éléonore-Hélène Dubois,326727,304057,Geneviève De Oliveira-Michel,88068,65398,2022-08-27
CASH_IN,60503,Agence_mtn_Ouidah,300000,239497,Éléonore-Hélène Dubois,304057,364560,2022-08-27
CASH_IN,74934,Agence_mtn_Abomey,300000,225066,Marie Picard,-278167,-203233,2022-08-05
CASH_IN,144935,Agence_mtn_Cotonou,300000,155065,Marie Picard,-203233,-58298,2022-08-10
CASH_IN,241208,Agence_mtn_Cotonou,300000,58792,Marie Picard,-58298,182910,2022-08-12
CASH_IN,218818,Agence_mtn_Abomey,300000,81182,Marie Picard,182910,401728,2022-08-15
CASH_OUT,138317,Marie Picard,401728,263411,Agence_mtn_Abomey,300000,161683,2022-08-16
TRANSFER,66347,Marie Picard,263411,197064,Pierre Roger,188907,122560,2022-08-23
TRANSFER,119886,Jeanne Garnier,164986,45100,Marie Picard,197064,316950,2022-08-25
CASH_IN,145469,Agence_mtn_Ouidah,300000,154531,Marie Picard,316950,462419,2022-08-26
CASH_IN,63277,Agence_mtn_Abomey,300000,236723,Marie Picard,462419,525696,2022-08-27
CASH_IN,93289,Agence_mtn_Abomey,300000,206711,Marie Picard,525696,618985,2022-08-27
CASH_IN,129668,Agence_mtn_Abomey,300000,170332,Nathalie Peron,-243045,-113377,2022-08-01
CASH_IN,96930,Agence_mtn_Abomey,300000,203070,Nathalie Peron,-113377,-16447,2022-08-05
CASH_IN,234090,Agence_mtn_Ouidah,300000,65910,Nathalie Peron,-16447,217643,2022-08-06
CASH_OUT,148947,Nathalie Peron,217643,68696,Agence_mtn_Cotonou,300000,151053,2022-08-08
TRANSFER,4381,Nathalie Peron,68696,64315,Geneviève De Oliveira-Michel,65398,61017,2022-08-09
CASH_IN,165420,Agence_mtn_Ouidah,300000,134580,Nathalie Peron,64315,229735,2022-08-10
TRANSFER,157975,David Guérin,488414,330439,Nathalie Peron,229735,387710,2022-08-10
TRANSFER,7254,Geneviève De Oliveira-Michel,61017,53763,Nathalie Peron,387710,394964,2022-08-12
CASH_IN,211721,Agence_mtn_Ouidah,300000,88279,Nathalie Peron,394964,606685,2022-08-12
CASH_IN,197489,Agence_mtn_Cotonou,300000,102511,Nathalie Peron,606685,804174,2022-08-13
CASH_OUT,159373,Nathalie Peron,804174,644801,Agence_mtn_Abomey,300000,140627,2022-08-13
CASH_IN,232053,Agence_mtn_Ouidah,300000,67947,Nathalie Peron,644801,876854,2022-08-14
TRANSFER,3564,Margot Renaud,5105,1541,Nathalie Peron,876854,880418,2022-08-15
TRANSFER,519025,Nathalie Peron,880418,361393,Bertrand Le Roux,292382,-226643,2022-08-17
TRANSFER,291223,Alexandre Rémy,959614,668391,Nathalie Peron,361393,652616,2022-08-17
CASH_OUT,368710,Nathalie Peron,652616,283906,Agence_mtn_Ouidah,300000,-68710,2022-08-24
CASH_IN,203563,Agence_mtn_Cotonou,300000,96437,Gabriel-Tristan Marty,-331379,-127816,2022-08-01
CASH_IN,122677,Agence_mtn_Ouidah,300000,177323,Gabriel-Tristan Marty,-127816,-5139,2022-08-01
CASH_IN,31234,Agence_mtn_Ouidah,300000,268766,Gabriel-Tristan Marty,-5139,26095,2022-08-02
CASH_IN,47221,Agence_mtn_Ouidah,300000,252779,Gabriel-Tristan Marty,26095,73316,2022-08-02
TRANSFER,25273,Gabriel-Tristan Marty,73316,48043,Alexandre Rémy,668391,643118,2022-08-03
TRANSFER,24442,Geneviève De Oliveira-Michel,53763,29321,Gabriel-Tristan Marty,48043,72485,2022-08-05
CASH_IN,38377,Agence_mtn_Abomey,300000,261623,Gabriel-Tristan Marty,72485,110862,2022-08-05
CASH_IN,32309,Agence_mtn_Abomey,300000,267691,Gabriel-Tristan Marty,110862,143171,2022-08-09
CASH_IN,231343,Agence_mtn_Abomey,300000,68657,Gabriel-Tristan Marty,143171,374514,2022-08-11
TRANSFER,32735,Émilie Moulin,58498,25763,Gabriel-Tristan Marty,374514,407249,2022-08-12
CASH_IN,169953,Agence_mtn_Ouidah,300000,130047,Gabriel-Tristan Marty,407249,577202,2022-08-12
CASH_IN,37614,Agence_mtn_Abomey,300000,262386,Gabriel-Tristan Marty,577202,614816,2022-08-13
CASH_IN,57642,Agence_mtn_Cotonou,300000,242358,Gabriel-Tristan Marty,614816,672458,2022-08-18
CASH_OUT,201865,Gabriel-Tristan Marty,672458,470593,Agence_mtn_Ouidah,300000,98135,2022-08-22
CASH_IN,196069,Agence_mtn_Cotonou,300000,103931,Gabriel-Tristan Marty,470593,666662,2022-08-24
TRANSFER,656093,Gabriel-Tristan Marty,666662,10569,Laure Philippe,376004,-280089,2022-08-24
TRANSFER,12111,Sébastien Lemaître,35051,22940,Gabriel-Tristan Marty,10569,22680,2022-08-24
CASH_IN,227199,Agence_mtn_Abomey,300000,72801,Gabriel-Tristan Marty,22680,249879,2022-08-25
TRANSFER,157538,Gabriel-Tristan Marty,249879,92341,Alexandre Rémy,643118,485580,2022-08-27
CASH_OUT,227548,Benjamin Evrard-Marty,472646,245098,Agence_mtn_Cotonou,300000,72452,2022-08-01
CASH_OUT,169947,Benjamin Evrard-Marty,245098,75151,Agence_mtn_Cotonou,300000,130053,2022-08-03
TRANSFER,21284,Benjamin Evrard-Marty,75151,53867,Gabriel Humbert,327848,306564,2022-08-05
CASH_IN,7113,Agence_mtn_Ouidah,300000,292887,Benjamin Evrard-Marty,53867,60980,2022-08-08
CASH_IN,45939,Agence_mtn_Ouidah,300000,254061,Benjamin Evrard-Marty,60980,106919,2022-08-09
CASH_OUT,96764,Benjamin Evrard-Marty,106919,10155,Agence_mtn_Abomey,300000,203236,2022-08-11
TRANSFER,9204,Benjamin Evrard-Marty,10155,951,David Guérin,330439,321235,2022-08-12
TRANSFER,172,Benjamin Evrard-Marty,951,779,Benjamin Evrard-Marty,951,779,2022-08-16
CASH_IN,226793,Agence_mtn_Ouidah,300000,73207,Benjamin Evrard-Marty,779,227572,2022-08-16
TRANSFER,2169,Catherine Faivre,3774,1605,Benjamin Evrard-Marty,227572,229741,2022-08-17
CASH_IN,190211,Agence_mtn_Cotonou,300000,109789,Benjamin Evrard-Marty,229741,419952,2022-08-17
CASH_IN,1088,Agence_mtn_Cotonou,300000,298912,Benjamin Evrard-Marty,419952,421040,2022-08-18
TRANSFER,1195,Catherine Faivre,1605,410,Benjamin Evrard-Marty,421040,422235,2022-08-18
CASH_IN,67470,Agence_mtn_Abomey,300000,232530,Benjamin Evrard-Marty,422235,489705,2022-08-18
CASH_OUT,388622,Benjamin Evrard-Marty,489705,101083,Agence_mtn_Abomey,300000,-88622,2022-08-19
CASH_IN,71425,Agence_mtn_Abomey,300000,228575,Nath Bruneau,-24995,46430,2022-08-05
CASH_OUT,40438,Nath Bruneau,46430,5992,Agence_mtn_Abomey,300000,259562,2022-08-05
CASH_IN,68954,Agence_mtn_Cotonou,300000,231046,Nath Bruneau,5992,74946,2022-08-05
CASH_IN,183333,Agence_mtn_Ouidah,300000,116667,Nath Bruneau,74946,258279,2022-08-08
CASH_OUT,131201,Nath Bruneau,258279,127078,Agence_mtn_Abomey,300000,168799,2022-08-09
CASH_IN,256438,Agence_mtn_Ouidah,300000,43562,Nath Bruneau,127078,383516,2022-08-12
CASH_IN,175407,Agence_mtn_Cotonou,300000,124593,Nath Bruneau,383516,558923,2022-08-14
CASH_IN,119226,Agence_mtn_Cotonou,300000,180774,Nath Bruneau,558923,678149,2022-08-16
CASH_OUT,546495,Nath Bruneau,678149,131654,Agence_mtn_Abomey,300000,-246495,2022-08-18
CASH_OUT,107563,Nath Bruneau,131654,24091,Agence_mtn_Cotonou,300000,192437,2022-08-23
CASH_IN,136619,Agence_mtn_Abomey,300000,163381,Nath Bruneau,24091,160710,2022-08-24
TRANSFER,130694,Corinne-Louise Valentin,349304,218610,Roland Garcia,1050916,1181610,2022-08-03
CASH_IN,252596,Agence_mtn_Abomey,300000,47404,Roland Garcia,1181610,1434206,2022-08-05
CASH_OUT,92410,Roland Garcia,1434206,1341796,Agence_mtn_Ouidah,300000,207590,2022-08-06
CASH_OUT,831690,Roland Garcia,1341796,510106,Agence_mtn_Ouidah,300000,-531690,2022-08-07
CASH_OUT,245807,Roland Garcia,510106,264299,Agence_mtn_Ouidah,300000,54193,2022-08-11
CASH_OUT,10614,Roland Garcia,264299,253685,Agence_mtn_Abomey,300000,289386,2022-08-16
CASH_OUT,141062,Roland Garcia,253685,112623,Agence_mtn_Abomey,300000,158938,2022-08-18
CASH_OUT,65536,Roland Garcia,112623,47087,Agence_mtn_Abomey,300000,234464,2022-08-22
TRANSFER,89616,Céline Gomez,268647,179031,Roland Garcia,47087,136703,2022-08-22
CASH_IN,110516,Agence_mtn_Abomey,300000,189484,Bertrand Charles,-222510,-111994,2022-08-06
CASH_IN,128721,Agence_mtn_Ouidah,300000,171279,Bertrand Charles,-111994,16727,2022-08-08
CASH_OUT,11189,Bertrand Charles,16727,5538,Agence_mtn_Abomey,300000,288811,2022-08-12
TRANSFER,23707,Émilie Moulin,25763,2056,Bertrand Charles,5538,29245,2022-08-15
TRANSFER,270,Alfred du Lesage,9465,9195,Bertrand Charles,29245,29515,2022-08-16
TRANSFER,133583,Thibaut Coulon,165400,31817,Bertrand Charles,29515,163098,2022-08-19
CASH_OUT,139456,Bertrand Charles,163098,23642,Agence_mtn_Cotonou,300000,160544,2022-08-20
TRANSFER,9932,Bertrand Charles,23642,13710,Gabriel Humbert,306564,296632,2022-08-20
CASH_OUT,8892,Bertrand Charles,13710,4818,Agence_mtn_Ouidah,300000,291108,2022-08-21
CASH_OUT,1973,Bertrand Charles,4818,2845,Agence_mtn_Abomey,300000,298027,2022-08-22
CASH_IN,7752,Agence_mtn_Cotonou,300000,292248,Bertrand Charles,2845,10597,2022-08-24
TRANSFER,408311,Alexandre Rémy,485580,77269,Frédéric Couturier,233726,-174585,2022-08-15
TRANSFER,20337,Jean Benard,22578,2241,Alexandre Rémy,77269,97606,2022-08-15
CASH_IN,147139,Agence_mtn_Ouidah,300000,152861,Alexandre Rémy,97606,244745,2022-08-15
CASH_OUT,31092,Alexandre Rémy,244745,213653,Agence_mtn_Abomey,300000,268908,2022-08-16
TRANSFER,143268,Alexandre Rémy,213653,70385,Alphonse Le Olivier,105251,-38017,2022-08-17
TRANSFER,7599,Alexandre Rémy,70385,62786,Geneviève De Oliveira-Michel,29321,21722,2022-08-18
TRANSFER,39759,Alexandre Rémy,62786,23027,Thérèse-Margaux Bruneau,9483,-30276,2022-08-20
CASH_OUT,4095,Alexandre Rémy,23027,18932,Agence_mtn_Cotonou,300000,295905,2022-08-23
TRANSFER,13841,Alexandre Rémy,18932,5091,Catherine Faivre,410,-13431,2022-08-25
TRANSFER,205548,David Guérin,321235,115687,Geneviève De Oliveira-Michel,21722,-183826,2022-08-01
TRANSFER,36672,David Guérin,115687,79015,Émilie Moulin,2056,-34616,2022-08-03
TRANSFER,137111,Céline Gomez,179031,41920,David Guérin,79015,216126,2022-08-05
TRANSFER,71083,David Guérin,216126,145043,Thibaut Coulon,31817,-39266,2022-08-06
TRANSFER,18719,Jeanne Garnier,45100,26381,David Guérin,145043,163762,2022-08-06
TRANSFER,10434,Jeanne Garnier,26381,15947,David Guérin,163762,174196,2022-08-07
CASH_IN,240063,Agence_mtn_Ouidah,300000,59937,David Guérin,174196,414259,2022-08-08
CASH_IN,70060,Agence_mtn_Abomey,300000,229940,David Guérin,414259,484319,2022-08-08
TRANSFER,326806,David Guérin,484319,157513,Jean Benard,2241,-324565,2022-08-12
CASH_OUT,41574,David Guérin,157513,115939,Agence_mtn_Ouidah,300000,258426,2022-08-14
CASH_OUT,107591,David Guérin,115939,8348,Agence_mtn_Cotonou,300000,192409,2022-08-15
CASH_OUT,5811,David Guérin,8348,2537,Agence_mtn_Ouidah,300000,294189,2022-08-17
TRANSFER,18451,Sébastien Lemaître,22940,4489,David Guérin,2537,20988,2022-08-18
CASH_IN,191022,Agence_mtn_Abomey,300000,108978,David Guérin,20988,212010,2022-08-18
CASH_OUT,16131,David Guérin,212010,195879,Agence_mtn_Cotonou,300000,283869,2022-08-20
CASH_OUT,59790,David Guérin,195879,136089,Agence_mtn_Ouidah,300000,240210,2022-08-22
CASH_OUT,131361,David Guérin,136089,4728,Agence_mtn_Ouidah,300000,168639,2022-08-23
CASH_IN,267431,Agence_mtn_Cotonou,300000,32569,David Guérin,4728,272159,2022-08-25
TRANSFER,33827,Céline Gomez,41920,8093,David Guérin,272159,305986,2022-08-27
CASH_OUT,806,Margot Renaud,1541,735,Agence_mtn_Cotonou,300000,299194,2022-08-02
CASH_IN,140005,Agence_mtn_Abomey,300000,159995,Margot Renaud,735,140740,2022-08-02
TRANSFER,65426,Margot Renaud,140740,75314,Gilbert-Charles Thibault,112810,47384,2022-08-02
TRANSFER,25142,Gilbert-Charles Thibault,47384,22242,Margot Renaud,75314,100456,2022-08-08
CASH_IN,35216,Agence_mtn_Cotonou,300000,264784,Margot Renaud,100456,135672,2022-08-09
TRANSFER,1295,Gabriel Humbert,296632,295337,Margot Renaud,135672,136967,2022-08-15
CASH_OUT,38664,Margot Renaud,136967,98303,Agence_mtn_Cotonou,300000,261336,2022-08-16
CASH_OUT,66246,Margot Renaud,98303,32057,Agence_mtn_Abomey,300000,233754,2022-08-17
CASH_IN,247237,Agence_mtn_Abomey,300000,52763,Margot Renaud,32057,279294,2022-08-17
TRANSFER,5724,Gilbert-Charles Thibault,22242,16518,Margot Renaud,279294,285018,2022-08-17
CASH_OUT,267172,Margot Renaud,285018,17846,Agence_mtn_Ouidah,300000,32828,2022-08-18
CASH_OUT,15687,Margot Renaud,17846,2159,Agence_mtn_Ouidah,300000,284313,2022-08-19
TRANSFER,9873,Gilbert-Charles Thibault,16518,6645,Margot Renaud,2159,12032,2022-08-20
TRANSFER,5613,Gilbert-Charles Thibault,6645,1032,Margot Renaud,12032,17645,2022-08-23
CASH_IN,246278,Agence_mtn_Abomey,300000,53722,Laure Philippe,-280089,-33811,2022-08-02
CASH_IN,125558,Agence_mtn_Abomey,300000,174442,Laure Philippe,-33811,91747,2022-08-03
CASH_IN,92144,Agence_mtn_Ouidah,300000,207856,Laure Philippe,91747,183891,2022-08-05
TRANSFER,170141,Laure Philippe,183891,13750,Pierre Roger,122560,-47581,2022-08-18
CASH_IN,248005,Agence_mtn_Cotonou,300000,51995,Laure Philippe,13750,261755,2022-08-24
CASH_IN,95706,Agence_mtn_Cotonou,300000,204294,Laure Philippe,261755,357461,2022-08-24
CASH_OUT,233938,Laure Philippe,357461,123523,Agence_mtn_Ouidah,300000,66062,2022-08-25
CASH_OUT,115020,Laure Philippe,123523,8503,Agence_mtn_Abomey,300000,184980,2022-08-27
CASH_IN,274266,Agence_mtn_Abomey,300000,25734,Franck-Charles Texier,-1645311,-1371045,2022-08-02
CASH_IN,139637,Agence_mtn_Cotonou,300000,160363,Franck-Charles Texier,-1371045,-1231408,2022-08-02
CASH_IN,58632,Agence_mtn_Cotonou,300000,241368,Franck-Charles Texier,-1231408,-1172776,2022-08-03
CASH_IN,294884,Agence_mtn_Cotonou,300000,5116,Franck-Charles Texier,-1172776,-877892,2022-08-05
CASH_IN,288377,Agence_mtn_Cotonou,300000,11623,Franck-Charles Texier,-877892,-589515,2022-08-05
CASH_IN,235972,Agence_mtn_Cotonou,300000,64028,Franck-Charles Texier,-589515,-353543,2022-08-07
CASH_IN,3989,Agence_mtn_Abomey,300000,296011,Franck-Charles Texier,-353543,-349554,2022-08-08
CASH_IN,231137,Agence_mtn_Ouidah,300000,68863,Franck-Charles Texier,-349554,-118417,2022-08-09
CASH_IN,39682,Agence_mtn_Ouidah,300000,260318,Franck-Charles Texier,-118417,-78735,2022-08-09
CASH_IN,12925,Agence_mtn_Cotonou,300000,287075,Franck-Charles Texier,-78735,-65810,2022-08-09
CASH_IN,56571,Agence_mtn_Abomey,300000,243429,Franck-Charles Texier,-65810,-9239,2022-08-10
CASH_IN,160786,Agence_mtn_Cotonou,300000,139214,Franck-Charles Texier,-9239,151547,2022-08-13
CASH_IN,252290,Agence_mtn_Ouidah,300000,47710,Franck-Charles Texier,151547,403837,2022-08-14
TRANSFER,505,Céline Gomez,8093,7588,Franck-Charles Texier,403837,404342,2022-08-17
TRANSFER,88794,Franck-Charles Texier,404342,315548,Sébastien Lemaître,4489,-84305,2022-08-17
CASH_IN,246467,Agence_mtn_Ouidah,300000,53533,Franck-Charles Texier,315548,562015,2022-08-19
CASH_OUT,527353,Franck-Charles Texier,562015,34662,Agence_mtn_Cotonou,300000,-227353,2022-08-19
CASH_OUT,8722,Franck-Charles Texier,34662,25940,Agence_mtn_Cotonou,300000,291278,2022-08-19
CASH_IN,141400,Agence_mtn_Cotonou,300000,158600,Franck-Charles Texier,25940,167340,2022-08-20
CASH_IN,296032,Agence_mtn_Ouidah,300000,3968,Franck-Charles Texier,167340,463372,2022-08-20
CASH_IN,45985,Agence_mtn_Cotonou,300000,254015,Geneviève De Oliveira-Michel,-183826,-137841,2022-08-02
CASH_IN,110189,Agence_mtn_Cotonou,300000,189811,Geneviève De Oliveira-Michel,-137841,-27652,2022-08-02
CASH_IN,144764,Agence_mtn_Cotonou,300000,155236,Geneviève De Oliveira-Michel,-27652,117112,2022-08-05
TRANSFER,571,Rémy Le Michaud,5657,5086,Geneviève De Oliveira-Michel,117112,117683,2022-08-06
CASH_IN,279142,Agence_mtn_Ouidah,300000,20858,Geneviève De Oliveira-Michel,117683,396825,2022-08-08
CASH_IN,235712,Agence_mtn_Ouidah,300000,64288,Geneviève De Oliveira-Michel,396825,632537,2022-08-08
CASH_OUT,339724,Geneviève De Oliveira-Michel,632537,292813,Agence_mtn_Ouidah,300000,-39724,2022-08-09
TRANSFER,6955,Céline Gomez,7588,633,Geneviève De Oliveira-Michel,292813,299768,2022-08-10
CASH_OUT,261110,Geneviève De Oliveira-Michel,299768,38658,Agence_mtn_Cotonou,300000,38890,2022-08-11
TRANSFER,3778,Geneviève De Oliveira-Michel,38658,34880,Gilbert-Charles Thibault,1032,-2746,2022-08-12
TRANSFER,135,Céline Gomez,633,498,Geneviève De Oliveira-Michel,34880,35015,2022-08-13
CASH_OUT,9041,Geneviève De Oliveira-Michel,35015,25974,Agence_mtn_Ouidah,300000,290959,2022-08-14
TRANSFER,7538,Jeanne Garnier,15947,8409,Geneviève De Oliveira-Michel,25974,33512,2022-08-18
CASH_OUT,18026,Geneviève De Oliveira-Michel,33512,15486,Agence_mtn_Abomey,300000,281974,2022-08-20
TRANSFER,114392,Gabriel Humbert,295337,180945,Geneviève De Oliveira-Michel,15486,129878,2022-08-23
CASH_IN,163731,Agence_mtn_Cotonou,300000,136269,Geneviève De Oliveira-Michel,129878,293609,2022-08-25
CASH_IN,52783,Agence_mtn_Ouidah,300000,247217,Geneviève De Oliveira-Michel,293609,346392,2022-08-25
TRANSFER,307534,Geneviève De Oliveira-Michel,346392,38858,Jeanne Garnier,8409,-299125,2022-08-26
CASH_OUT,25727,Geneviève De Oliveira-Michel,38858,13131,Agence_mtn_Ouidah,300000,274273,2022-08-26
CASH_IN,202807,Agence_mtn_Cotonou,300000,97193,Jean Benard,-324565,-121758,2022-08-05
CASH_IN,37610,Agence_mtn_Cotonou,300000,262390,Jean Benard,-121758,-84148,2022-08-08
CASH_IN,90024,Agence_mtn_Abomey,300000,209976,Jean Benard,-84148,5876,2022-08-08
CASH_IN,220189,Agence_mtn_Cotonou,300000,79811,Jean Benard,5876,226065,2022-08-10
CASH_IN,242275,Agence_mtn_Abomey,300000,57725,Jean Benard,226065,468340,2022-08-11
CASH_IN,144856,Agence_mtn_Ouidah,300000,155144,Jean Benard,468340,613196,2022-08-12
CASH_OUT,304977,Jean Benard,613196,308219,Agence_mtn_Cotonou,300000,-4977,2022-08-13
CASH_IN,40364,Agence_mtn_Ouidah,300000,259636,Jean Benard,308219,348583,2022-08-15
CASH_OUT,243100,Jean Benard,348583,105483,Agence_mtn_Cotonou,300000,56900,2022-08-15
TRANSFER,48743,Jean Benard,105483,56740,Gabriel Humbert,180945,132202,2022-08-20
CASH_IN,252277,Agence_mtn_Cotonou,300000,47723,Jean Benard,56740,309017,2022-08-25
TRANSFER,143013,Jean Benard,309017,166004,Rémy Le Michaud,5086,-137927,2022-08-26
CASH_IN,33034,Agence_mtn_Ouidah,300000,266966,Jean Benard,166004,199038,2022-08-27
CASH_OUT,58242,Jean Benard,199038,140796,Agence_mtn_Cotonou,300000,241758,2022-08-27
CASH_IN,165578,Agence_mtn_Abomey,300000,134422,Jean Benard,140796,306374,2022-08-27
CASH_IN,258328,Agence_mtn_Cotonou,300000,41672,Hortense Lemaire,-45854,212474,2022-08-01
TRANSFER,134689,Hortense Lemaire,212474,77785,Hortense Lemaire,212474,347163,2022-08-04
CASH_IN,80927,Agence_mtn_Ouidah,300000,219073,Hortense Lemaire,77785,158712,2022-08-13
CASH_OUT,100767,Hortense Lemaire,158712,57945,Agence_mtn_Abomey,300000,199233,2022-08-16
CASH_IN,51433,Agence_mtn_Abomey,300000,248567,Hortense Lemaire,57945,109378,2022-08-17
TRANSFER,90105,Corinne-Louise Valentin,218610,128505,Hortense Lemaire,109378,199483,2022-08-18
TRANSFER,119381,Hortense Lemaire,199483,80102,Gabriel Humbert,132202,12821,2022-08-23
CASH_IN,292031,Agence_mtn_Abomey,300000,7969,Bertrand Le Roux,-226643,65388,2022-08-01
TRANSFER,61864,Bertrand Le Roux,65388,3524,Gabriel Humbert,12821,-49043,2022-08-03
CASH_IN,203611,Agence_mtn_Abomey,300000,96389,Bertrand Le Roux,3524,207135,2022-08-04
CASH_IN,298108,Agence_mtn_Abomey,300000,1892,Bertrand Le Roux,207135,505243,2022-08-05
CASH_IN,102813,Agence_mtn_Abomey,300000,197187,Bertrand Le Roux,505243,608056,2022-08-05
CASH_OUT,177470,Bertrand Le Roux,608056,430586,Agence_mtn_Abomey,300000,122530,2022-08-05
CASH_IN,137282,Agence_mtn_Cotonou,300000,162718,Bertrand Le Roux,430586,567868,2022-08-09
CASH_IN,16966,Agence_mtn_Cotonou,300000,283034,Bertrand Le Roux,567868,584834,2022-08-09
CASH_IN,206145,Agence_mtn_Ouidah,300000,93855,Bertrand Le Roux,584834,790979,2022-08-09
CASH_OUT,191094,Bertrand Le Roux,790979,599885,Agence_mtn_Ouidah,300000,108906,2022-08-16
CASH_OUT,85971,Bertrand Le Roux,599885,513914,Agence_mtn_Abomey,300000,214029,2022-08-17
CASH_OUT,264795,Bertrand Le Roux,513914,249119,Agence_mtn_Abomey,300000,35205,2022-08-17
CASH_OUT,67239,Bertrand Le Roux,249119,181880,Agence_mtn_Ouidah,300000,232761,2022-08-21
CASH_OUT,80227,Bertrand Le Roux,181880,101653,Agence_mtn_Abomey,300000,219773,2022-08-24
CASH_OUT,8594,Bertrand Le Roux,101653,93059,Agence_mtn_Cotonou,300000,291406,2022-08-24
CASH_IN,146332,Agence_mtn_Abomey,300000,153668,Bertrand Le Roux,93059,239391,2022-08-25
TRANSFER,227443,Bertrand Le Roux,239391,11948,Corinne-Louise Valentin,128505,-98938,2022-08-26
CASH_IN,214476,Agence_mtn_Cotonou,300000,85524,Gilbert-Charles Thibault,-2746,211730,2022-08-07
CASH_OUT,29432,Gilbert-Charles Thibault,211730,182298,Agence_mtn_Cotonou,300000,270568,2022-08-09
CASH_IN,211175,Agence_mtn_Abomey,300000,88825,Gilbert-Charles Thibault,182298,393473,2022-08-09
CASH_OUT,183588,Gilbert-Charles Thibault,393473,209885,Agence_mtn_Abomey,300000,116412,2022-08-15
CASH_OUT,155004,Gilbert-Charles Thibault,209885,54881,Agence_mtn_Ouidah,300000,144996,2022-08-16
CASH_IN,169668,Agence_mtn_Cotonou,300000,130332,Gilbert-Charles Thibault,54881,224549,2022-08-24
CASH_IN,32244,Agence_mtn_Ouidah,300000,267756,Gilbert-Charles Thibault,224549,256793,2022-08-25
CASH_OUT,14743,Gilbert-Charles Thibault,256793,242050,Agence_mtn_Cotonou,300000,285257,2022-08-27
CASH_IN,36545,Agence_mtn_Ouidah,300000,263455,Thérèse-Margaux Bruneau,-30276,6269,2022-08-02
CASH_IN,149020,Agence_mtn_Abomey,300000,150980,Thérèse-Margaux Bruneau,6269,155289,2022-08-03
TRANSFER,151005,Thérèse-Margaux Bruneau,155289,4284,Thérèse-Margaux Bruneau,155289,306294,2022-08-06
CASH_IN,84853,Agence_mtn_Abomey,300000,215147,Thérèse-Margaux Bruneau,4284,89137,2022-08-08
CASH_OUT,43042,Thérèse-Margaux Bruneau,89137,46095,Agence_mtn_Cotonou,300000,256958,2022-08-11
CASH_OUT,13528,Thérèse-Margaux Bruneau,46095,32567,Agence_mtn_Cotonou,300000,286472,2022-08-19
CASH_IN,205030,Agence_mtn_Abomey,300000,94970,Thérèse-Margaux Bruneau,32567,237597,2022-08-22
CASH_IN,100426,Agence_mtn_Ouidah,300000,199574,Thérèse-Margaux Bruneau,237597,338023,2022-08-23
CASH_OUT,44428,Thérèse-Margaux Bruneau,338023,293595,Agence_mtn_Cotonou,300000,255572,2022-08-24
CASH_IN,228376,Agence_mtn_Ouidah,300000,71624,Rémy Le Michaud,-137927,90449,2022-08-03
CASH_IN,136522,Agence_mtn_Ouidah,300000,163478,Rémy Le Michaud,90449,226971,2022-08-04
CASH_IN,51264,Agence_mtn_Cotonou,300000,248736,Rémy Le Michaud,226971,278235,2022-08-05
CASH_OUT,179845,Rémy Le Michaud,278235,98390,Agence_mtn_Ouidah,300000,120155,2022-08-05
CASH_IN,202066,Agence_mtn_Ouidah,300000,97934,Rémy Le Michaud,98390,300456,2022-08-06
CASH_OUT,145450,Rémy Le Michaud,300456,155006,Agence_mtn_Ouidah,300000,154550,2022-08-08
CASH_IN,93259,Agence_mtn_Cotonou,300000,206741,Rémy Le Michaud,155006,248265,2022-08-09
TRANSFER,110393,Rémy Le Michaud,248265,137872,Rémy Le Michaud,248265,137872,2022-08-12
CASH_OUT,121191,Rémy Le Michaud,137872,16681,Agence_mtn_Cotonou,300000,178809,2022-08-14
TRANSFER,7306,Rémy Le Michaud,16681,9375,Rémy Le Michaud,16681,23987,2022-08-14
CASH_IN,44097,Agence_mtn_Ouidah,300000,255903,Rémy Le Michaud,9375,53472,2022-08-16
CASH_OUT,28657,Rémy Le Michaud,53472,24815,Agence_mtn_Ouidah,300000,271343,2022-08-17
CASH_OUT,20831,Rémy Le Michaud,24815,3984,Agence_mtn_Cotonou,300000,279169,2022-08-17
CASH_OUT,452,Rémy Le Michaud,3984,3532,Agence_mtn_Ouidah,300000,299548,2022-08-18
CASH_IN,286498,Agence_mtn_Abomey,300000,13502,Rémy Le Michaud,3532,290030,2022-08-18
CASH_IN,245700,Agence_mtn_Ouidah,300000,54300,Rémy Le Michaud,290030,535730,2022-08-23
CASH_OUT,279581,Rémy Le Michaud,535730,256149,Agence_mtn_Abomey,300000,20419,2022-08-25
CASH_OUT,119204,Rémy Le Michaud,256149,136945,Agence_mtn_Cotonou,300000,180796,2022-08-27
CASH_IN,565,Agence_mtn_Ouidah,300000,299435,Pierre Roger,-47581,-47016,2022-08-07
CASH_IN,212894,Agence_mtn_Cotonou,300000,87106,Pierre Roger,-47016,165878,2022-08-07
CASH_IN,226230,Agence_mtn_Cotonou,300000,73770,Pierre Roger,165878,392108,2022-08-07
CASH_OUT,225001,Pierre Roger,392108,167107,Agence_mtn_Ouidah,300000,74999,2022-08-11
TRANSFER,42192,Pierre Roger,167107,124915,Pierre Roger,167107,124915,2022-08-12
CASH_OUT,96013,Pierre Roger,124915,28902,Agence_mtn_Abomey,300000,203987,2022-08-13
CASH_OUT,3193,Pierre Roger,28902,25709,Agence_mtn_Abomey,300000,296807,2022-08-13
CASH_IN,36019,Agence_mtn_Ouidah,300000,263981,Pierre Roger,25709,61728,2022-08-14
TRANSFER,41829,Pierre Roger,61728,19899,Pierre Roger,61728,19899,2022-08-14
CASH_OUT,4137,Pierre Roger,19899,15762,Agence_mtn_Ouidah,300000,295863,2022-08-15
CASH_IN,95209,Agence_mtn_Ouidah,300000,204791,Pierre Roger,15762,110971,2022-08-15
CASH_OUT,50317,Pierre Roger,110971,60654,Agence_mtn_Cotonou,300000,249683,2022-08-20
CASH_OUT,44450,Pierre Roger,60654,16204,Agence_mtn_Abomey,300000,255550,2022-08-20
CASH_IN,103095,Agence_mtn_Ouidah,300000,196905,Pierre Roger,16204,119299,2022-08-23
CASH_IN,277808,Agence_mtn_Cotonou,300000,22192,Pierre Roger,119299,397107,2022-08-25
CASH_IN,93431,Agence_mtn_Abomey,300000,206569,Pierre Roger,397107,490538,2022-08-27
CASH_IN,154315,Agence_mtn_Ouidah,300000,145685,Jeanne Garnier,-299125,-144810,2022-08-03
CASH_IN,52862,Agence_mtn_Abomey,300000,247138,Jeanne Garnier,-144810,-91948,2022-08-10
CASH_IN,151344,Agence_mtn_Ouidah,300000,148656,Jeanne Garnier,-91948,59396,2022-08-11
CASH_OUT,36427,Jeanne Garnier,59396,22969,Agence_mtn_Cotonou,300000,263573,2022-08-11
CASH_IN,43696,Agence_mtn_Ouidah,300000,256304,Jeanne Garnier,22969,66665,2022-08-11
CASH_IN,238299,Agence_mtn_Abomey,300000,61701,Jeanne Garnier,66665,304964,2022-08-24
CASH_IN,272164,Agence_mtn_Abomey,300000,27836,Jeanne Garnier,304964,577128,2022-08-25
CASH_OUT,245638,Jeanne Garnier,577128,331490,Agence_mtn_Ouidah,300000,54362,2022-08-27
CASH_IN,265204,Agence_mtn_Ouidah,300000,34796,Cécile Clerc,-628606,-363402,2022-08-01
CASH_IN,255926,Agence_mtn_Cotonou,300000,44074,Cécile Clerc,-363402,-107476,2022-08-02
CASH_IN,259886,Agence_mtn_Cotonou,300000,40114,Cécile Clerc,-107476,152410,2022-08-04
TRANSFER,108453,Cécile Clerc,152410,43957,Cécile Clerc,152410,43957,2022-08-07
CASH_OUT,37096,Cécile Clerc,43957,6861,Agence_mtn_Ouidah,300000,262904,2022-08-07
TRANSFER,764,Cécile Clerc,6861,6097,Cécile Clerc,6861,7625,2022-08-08
CASH_IN,89189,Agence_mtn_Ouidah,300000,210811,Cécile Clerc,6097,95286,2022-08-15
CASH_IN,278065,Agence_mtn_Cotonou,300000,21935,Cécile Clerc,95286,373351,2022-08-17
TRANSFER,91930,Cécile Clerc,373351,281421,Cécile Clerc,373351,465281,2022-08-21
CASH_IN,186086,Agence_mtn_Cotonou,300000,113914,Cécile Clerc,281421,467507,2022-08-22
CASH_OUT,313499,Cécile Clerc,467507,154008,Agence_mtn_Cotonou,300000,-13499,2022-08-23
CASH_OUT,1642,Cécile Clerc,154008,152366,Agence_mtn_Cotonou,300000,298358,2022-08-27
CASH_IN,23647,Agence_mtn_Cotonou,300000,276353,Corinne-Louise Valentin,-98938,-75291,2022-08-06
CASH_IN,154057,Agence_mtn_Abomey,300000,145943,Corinne-Louise Valentin,-75291,78766,2022-08-09
CASH_OUT,31690,Corinne-Louise Valentin,78766,47076,Agence_mtn_Cotonou,300000,268310,2022-08-14
CASH_OUT,17331,Corinne-Louise Valentin,47076,29745,Agence_mtn_Cotonou,300000,282669,2022-08-17
CASH_OUT,28367,Corinne-Louise Valentin,29745,1378,Agence_mtn_Ouidah,300000,271633,2022-08-18
CASH_IN,194269,Agence_mtn_Abomey,300000,105731,Corinne-Louise Valentin,1378,195647,2022-08-22
CASH_IN,59953,Agence_mtn_Abomey,300000,240047,Corinne-Louise Valentin,195647,255600,2022-08-22
CASH_OUT,161464,Corinne-Louise Valentin,255600,94136,Agence_mtn_Cotonou,300000,138536,2022-08-22
CASH_IN,235594,Agence_mtn_Abomey,300000,64406,Corinne-Louise Valentin,94136,329730,2022-08-27
CASH_IN,248491,Agence_mtn_Ouidah,300000,51509,Frédéric Couturier,-174585,73906,2022-08-02
TRANSFER,51152,Frédéric Couturier,73906,22754,Frédéric Couturier,73906,22754,2022-08-04
CASH_IN,218907,Agence_mtn_Cotonou,300000,81093,Frédéric Couturier,22754,241661,2022-08-04
CASH_OUT,120509,Frédéric Couturier,241661,121152,Agence_mtn_Cotonou,300000,179491,2022-08-05
CASH_OUT,105518,Frédéric Couturier,121152,15634,Agence_mtn_Cotonou,300000,194482,2022-08-06
CASH_OUT,11913,Frédéric Couturier,15634,3721,Agence_mtn_Cotonou,300000,288087,2022-08-07
CASH_IN,227811,Agence_mtn_Cotonou,300000,72189,Frédéric Couturier,3721,231532,2022-08-09
CASH_OUT,51290,Frédéric Couturier,231532,180242,Agence_mtn_Abomey,300000,248710,2022-08-10
CASH_OUT,179308,Frédéric Couturier,180242,934,Agence_mtn_Cotonou,300000,120692,2022-08-11
CASH_OUT,594,Frédéric Couturier,934,340,Agence_mtn_Ouidah,300000,299406,2022-08-11
CASH_OUT,323,Frédéric Couturier,340,17,Agence_mtn_Cotonou,300000,299677,2022-08-17
CASH_IN,115002,Agence_mtn_Ouidah,300000,184998,Frédéric Couturier,17,115019,2022-08-18
TRANSFER,18891,Frédéric Couturier,115019,96128,Frédéric Couturier,115019,96128,2022-08-19
CASH_OUT,94443,Frédéric Couturier,96128,1685,Agence_mtn_Cotonou,300000,205557,2022-08-19
CASH_IN,193671,Agence_mtn_Abomey,300000,106329,Frédéric Couturier,1685,195356,2022-08-25
CASH_IN,28971,Agence_mtn_Abomey,300000,271029,Frédéric Couturier,195356,224327,2022-08-27
CASH_OUT,218890,Frédéric Couturier,224327,5437,Agence_mtn_Cotonou,300000,81110,2022-08-27
CASH_IN,351,Agence_mtn_Ouidah,300000,299649,Sophie Gonzalez,-535192,-534841,2022-08-01
CASH_IN,222293,Agence_mtn_Cotonou,300000,77707,Sophie Gonzalez,-534841,-312548,2022-08-02
CASH_IN,251262,Agence_mtn_Ouidah,300000,48738,Sophie Gonzalez,-312548,-61286,2022-08-07
CASH_IN,271626,Agence_mtn_Abomey,300000,28374,Sophie Gonzalez,-61286,210340,2022-08-11
TRANSFER,40199,Sophie Gonzalez,210340,170141,Sophie Gonzalez,210340,170141,2022-08-17
CASH_IN,78199,Agence_mtn_Cotonou,300000,221801,Sophie Gonzalez,170141,248340,2022-08-21
CASH_IN,109099,Agence_mtn_Ouidah,300000,190901,Sophie Gonzalez,248340,357439,2022-08-22
CASH_OUT,72892,Sophie Gonzalez,357439,284547,Agence_mtn_Ouidah,300000,227108,2022-08-23
CASH_OUT,215927,Sophie Gonzalez,284547,68620,Agence_mtn_Cotonou,300000,84073,2022-08-24
CASH_IN,283378,Agence_mtn_Cotonou,300000,16622,Astrid Gay de la Brunet,-244171,39207,2022-08-01
CASH_OUT,15760,Astrid Gay de la Brunet,39207,23447,Agence_mtn_Ouidah,300000,284240,2022-08-04
CASH_OUT,11908,Astrid Gay de la Brunet,23447,11539,Agence_mtn_Cotonou,300000,288092,2022-08-06
CASH_OUT,1983,Astrid Gay de la Brunet,11539,9556,Agence_mtn_Cotonou,300000,298017,2022-08-07
CASH_OUT,8039,Astrid Gay de la Brunet,9556,1517,Agence_mtn_Abomey,300000,291961,2022-08-10
CASH_OUT,1106,Astrid Gay de la Brunet,1517,411,Agence_mtn_Abomey,300000,298894,2022-08-12
CASH_IN,94814,Agence_mtn_Abomey,300000,205186,Astrid Gay de la Brunet,411,95225,2022-08-19
CASH_OUT,52967,Astrid Gay de la Brunet,95225,42258,Agence_mtn_Ouidah,300000,247033,2022-08-20
CASH_OUT,34116,Astrid Gay de la Brunet,42258,8142,Agence_mtn_Cotonou,300000,265884,2022-08-27
CASH_IN,36072,Agence_mtn_Cotonou,300000,263928,Xavier de Lebreton,-33319,2753,2022-08-01
CASH_OUT,2294,Xavier de Lebreton,2753,459,Agence_mtn_Abomey,300000,297706,2022-08-02
CASH_IN,43825,Agence_mtn_Cotonou,300000,256175,Xavier de Lebreton,459,44284,2022-08-03
CASH_IN,288328,Agence_mtn_Ouidah,300000,11672,Xavier de Lebreton,44284,332612,2022-08-04
CASH_OUT,23364,Xavier de Lebreton,332612,309248,Agence_mtn_Abomey,300000,276636,2022-08-04
CASH_IN,182785,Agence_mtn_Abomey,300000,117215,Xavier de Lebreton,309248,492033,2022-08-04
TRANSFER,335495,Xavier de Lebreton,492033,156538,Xavier de Lebreton,492033,156538,2022-08-04
CASH_IN,166681,Agence_mtn_Abomey,300000,133319,Xavier de Lebreton,156538,323219,2022-08-06
CASH_IN,159436,Agence_mtn_Ouidah,300000,140564,Xavier de Lebreton,323219,482655,2022-08-06
CASH_IN,234814,Agence_mtn_Cotonou,300000,65186,Xavier de Lebreton,482655,717469,2022-08-07
TRANSFER,14908,Xavier de Lebreton,717469,702561,Xavier de Lebreton,717469,732377,2022-08-10
TRANSFER,463775,Xavier de Lebreton,702561,238786,Xavier de Lebreton,702561,1166336,2022-08-12
CASH_IN,279195,Agence_mtn_Ouidah,300000,20805,Xavier de Lebreton,238786,517981,2022-08-17
TRANSFER,119063,Xavier de Lebreton,517981,398918,Xavier de Lebreton,517981,637044,2022-08-18
CASH_IN,226189,Agence_mtn_Cotonou,300000,73811,Xavier de Lebreton,398918,625107,2022-08-19
CASH_IN,188758,Agence_mtn_Cotonou,300000,111242,Xavier de Lebreton,625107,813865,2022-08-20
CASH_IN,230685,Agence_mtn_Abomey,300000,69315,Xavier de Lebreton,813865,1044550,2022-08-22
CASH_OUT,301702,Xavier de Lebreton,1044550,742848,Agence_mtn_Cotonou,300000,-1702,2022-08-22
CASH_IN,284291,Agence_mtn_Cotonou,300000,15709,Xavier de Lebreton,742848,1027139,2022-08-27
CASH_IN,254126,Agence_mtn_Abomey,300000,45874,Philippine Courtois,-27519,226607,2022-08-01
TRANSFER,44975,Philippine Courtois,226607,181632,Philippine Courtois,226607,181632,2022-08-03
CASH_OUT,15440,Philippine Courtois,181632,166192,Agence_mtn_Abomey,300000,284560,2022-08-03
CASH_IN,100891,Agence_mtn_Cotonou,300000,199109,Philippine Courtois,166192,267083,2022-08-04
TRANSFER,77237,Philippine Courtois,267083,189846,Philippine Courtois,267083,344320,2022-08-04
TRANSFER,79623,Philippine Courtois,189846,110223,Philippine Courtois,189846,110223,2022-08-08
CASH_OUT,58070,Philippine Courtois,110223,52153,Agence_mtn_Cotonou,300000,241930,2022-08-08
CASH_OUT,35643,Philippine Courtois,52153,16510,Agence_mtn_Ouidah,300000,264357,2022-08-16
CASH_OUT,8563,Philippine Courtois,16510,7947,Agence_mtn_Abomey,300000,291437,2022-08-16
CASH_OUT,2224,Philippine Courtois,7947,5723,Agence_mtn_Ouidah,300000,297776,2022-08-17
CASH_OUT,5302,Philippine Courtois,5723,421,Agence_mtn_Abomey,300000,294698,2022-08-18
CASH_OUT,232,Philippine Courtois,421,189,Agence_mtn_Ouidah,300000,299768,2022-08-18
TRANSFER,183,Philippine Courtois,189,6,Philippine Courtois,189,6,2022-08-20
CASH_IN,251015,Agence_mtn_Ouidah,300000,48985,Philippine Courtois,6,251021,2022-08-22
CASH_OUT,148874,Philippine Courtois,251021,102147,Agence_mtn_Cotonou,300000,151126,2022-08-23
CASH_IN,148635,Agence_mtn_Ouidah,300000,151365,Virginie Le Gall,2,148637,2022-08-02
CASH_IN,56619,Agence_mtn_Ouidah,300000,243381,Virginie Le Gall,148637,205256,2022-08-03
CASH_IN,117344,Agence_mtn_Cotonou,300000,182656,Virginie Le Gall,205256,322600,2022-08-04
CASH_OUT,299695,Virginie Le Gall,322600,22905,Agence_mtn_Ouidah,300000,305,2022-08-04
CASH_OUT,18398,Virginie Le Gall,22905,4507,Agence_mtn_Abomey,300000,281602,2022-08-06
CASH_OUT,1700,Virginie Le Gall,4507,2807,Agence_mtn_Cotonou,300000,298300,2022-08-08
TRANSFER,1285,Virginie Le Gall,2807,1522,Virginie Le Gall,2807,4092,2022-08-08
CASH_IN,124299,Agence_mtn_Cotonou,300000,175701,Virginie Le Gall,1522,125821,2022-08-12
CASH_IN,48112,Agence_mtn_Ouidah,300000,251888,Virginie Le Gall,125821,173933,2022-08-12
CASH_OUT,16488,Virginie Le Gall,173933,157445,Agence_mtn_Abomey,300000,283512,2022-08-15
CASH_OUT,63530,Virginie Le Gall,157445,93915,Agence_mtn_Abomey,300000,236470,2022-08-17
CASH_OUT,32652,Virginie Le Gall,93915,61263,Agence_mtn_Cotonou,300000,267348,2022-08-18
CASH_OUT,2478,Virginie Le Gall,61263,58785,Agence_mtn_Cotonou,300000,297522,2022-08-18
CASH_OUT,48897,Virginie Le Gall,58785,9888,Agence_mtn_Cotonou,300000,251103,2022-08-26
CASH_IN,55273,Agence_mtn_Ouidah,300000,244727,Virginie Le Gall,9888,65161,2022-08-26
CASH_IN,129401,Agence_mtn_Ouidah,300000,170599,Virginie Le Gall,65161,194562,2022-08-27
CASH_IN,206352,Agence_mtn_Cotonou,300000,93648,Catherine Faivre,-13431,192921,2022-08-01
TRANSFER,43308,Catherine Faivre,192921,149613,Catherine Faivre,192921,149613,2022-08-05
CASH_OUT,35643,Catherine Faivre,149613,113970,Agence_mtn_Cotonou,300000,264357,2022-08-06
CASH_IN,47083,Agence_mtn_Cotonou,300000,252917,Catherine Faivre,113970,161053,2022-08-07
CASH_OUT,144115,Catherine Faivre,161053,16938,Agence_mtn_Cotonou,300000,155885,2022-08-10
CASH_IN,66714,Agence_mtn_Cotonou,300000,233286,Catherine Faivre,16938,83652,2022-08-14
CASH_IN,84684,Agence_mtn_Ouidah,300000,215316,Catherine Faivre,83652,168336,2022-08-17
CASH_OUT,112517,Catherine Faivre,168336,55819,Agence_mtn_Cotonou,300000,187483,2022-08-18
CASH_OUT,15677,Catherine Faivre,55819,40142,Agence_mtn_Ouidah,300000,284323,2022-08-26
CASH_IN,36626,Agence_mtn_Cotonou,300000,263374,Alphonse Le Olivier,-38017,-1391,2022-08-02
CASH_IN,67280,Agence_mtn_Abomey,300000,232720,Alphonse Le Olivier,-1391,65889,2022-08-04
CASH_OUT,32522,Alphonse Le Olivier,65889,33367,Agence_mtn_Ouidah,300000,267478,2022-08-06
CASH_IN,151477,Agence_mtn_Abomey,300000,148523,Alphonse Le Olivier,33367,184844,2022-08-06
CASH_IN,46625,Agence_mtn_Abomey,300000,253375,Alphonse Le Olivier,184844,231469,2022-08-08
CASH_IN,47478,Agence_mtn_Ouidah,300000,252522,Alphonse Le Olivier,231469,278947,2022-08-14
CASH_OUT,4649,Alphonse Le Olivier,278947,274298,Agence_mtn_Ouidah,300000,295351,2022-08-16
CASH_OUT,185760,Alphonse Le Olivier,274298,88538,Agence_mtn_Ouidah,300000,114240,2022-08-17
CASH_IN,167196,Agence_mtn_Ouidah,300000,132804,Alphonse Le Olivier,88538,255734,2022-08-18
CASH_IN,209868,Agence_mtn_Ouidah,300000,90132,Alphonse Le Olivier,255734,465602,2022-08-18
CASH_OUT,461466,Alphonse Le Olivier,465602,4136,Agence_mtn_Abomey,300000,-161466,2022-08-20
CASH_IN,87773,Agence_mtn_Cotonou,300000,212227,Alphonse Le Olivier,4136,91909,2022-08-26
CASH_IN,214572,Agence_mtn_Ouidah,300000,85428,Richard Le Descamps,-3207,211365,2022-08-07
CASH_IN,168632,Agence_mtn_Cotonou,300000,131368,Richard Le Descamps,211365,379997,2022-08-07
CASH_IN,130080,Agence_mtn_Abomey,300000,169920,Richard Le Descamps,379997,510077,2022-08-23
CASH_IN,207476,Agence_mtn_Cotonou,300000,92524,Sébastien Lemaître,-84305,123171,2022-08-01
CASH_OUT,115433,Sébastien Lemaître,123171,7738,Agence_mtn_Ouidah,300000,184567,2022-08-01
CASH_OUT,6445,Sébastien Lemaître,7738,1293,Agence_mtn_Abomey,300000,293555,2022-08-02
TRANSFER,289,Sébastien Lemaître,1293,1004,Sébastien Lemaître,1293,1004,2022-08-02
CASH_OUT,202,Sébastien Lemaître,1004,802,Agence_mtn_Cotonou,300000,299798,2022-08-07
CASH_OUT,412,Sébastien Lemaître,802,390,Agence_mtn_Cotonou,300000,299588,2022-08-15
CASH_IN,237382,Agence_mtn_Abomey,300000,62618,Sébastien Lemaître,390,237772,2022-08-25
CASH_IN,52946,Agence_mtn_Cotonou,300000,247054,Léon Martins-Briand,-87412,-34466,2022-08-03
CASH_IN,204299,Agence_mtn_Cotonou,300000,95701,Léon Martins-Briand,-34466,169833,2022-08-04
CASH_OUT,15439,Léon Martins-Briand,169833,154394,Agence_mtn_Ouidah,300000,284561,2022-08-04
CASH_OUT,77903,Léon Martins-Briand,154394,76491,Agence_mtn_Abomey,300000,222097,2022-08-08
CASH_IN,139213,Agence_mtn_Ouidah,300000,160787,Léon Martins-Briand,76491,215704,2022-08-09
CASH_OUT,183160,Léon Martins-Briand,215704,32544,Agence_mtn_Ouidah,300000,116840,2022-08-10
TRANSFER,1010,Léon Martins-Briand,32544,31534,Léon Martins-Briand,32544,33554,2022-08-11
TRANSFER,5799,Léon Martins-Briand,31534,25735,Léon Martins-Briand,31534,37333,2022-08-12
CASH_OUT,18996,Léon Martins-Briand,25735,6739,Agence_mtn_Ouidah,300000,281004,2022-08-13
CASH_IN,211044,Agence_mtn_Abomey,300000,88956,Léon Martins-Briand,6739,217783,2022-08-16
CASH_OUT,161834,Léon Martins-Briand,217783,55949,Agence_mtn_Cotonou,300000,138166,2022-08-19
CASH_OUT,41832,Léon Martins-Briand,55949,14117,Agence_mtn_Abomey,300000,258168,2022-08-20
CASH_IN,144792,Agence_mtn_Abomey,300000,155208,Marine Chauvet-Potier,-124421,20371,2022-08-09
CASH_OUT,1362,Marine Chauvet-Potier,20371,19009,Agence_mtn_Cotonou,300000,298638,2022-08-12
CASH_IN,281071,Agence_mtn_Abomey,300000,18929,Thibaut Coulon,-39266,241805,2022-08-03
TRANSFER,36257,Thibaut Coulon,241805,205548,Thibaut Coulon,241805,205548,2022-08-04
TRANSFER,145669,Thibaut Coulon,205548,59879,Thibaut Coulon,205548,351217,2022-08-08
CASH_OUT,43511,Thibaut Coulon,59879,16368,Agence_mtn_Ouidah,300000,256489,2022-08-16
CASH_OUT,15423,Thibaut Coulon,16368,945,Agence_mtn_Abomey,300000,284577,2022-08-17
CASH_IN,6977,Agence_mtn_Ouidah,300000,293023,Thibaut Coulon,945,7922,2022-08-18
CASH_IN,192636,Agence_mtn_Ouidah,300000,107364,Thibaut Coulon,7922,200558,2022-08-23
CASH_IN,89666,Agence_mtn_Abomey,300000,210334,Adrien Chartier,-9092,80574,2022-08-05
CASH_OUT,6299,Adrien Chartier,80574,74275,Agence_mtn_Abomey,300000,293701,2022-08-05
CASH_OUT,57871,Adrien Chartier,74275,16404,Agence_mtn_Ouidah,300000,242129,2022-08-14
TRANSFER,6415,Adrien Chartier,16404,9989,Adrien Chartier,16404,9989,2022-08-16
CASH_IN,174132,Agence_mtn_Ouidah,300000,125868,Adrien Chartier,9989,184121,2022-08-18
CASH_OUT,56600,Adrien Chartier,184121,127521,Agence_mtn_Ouidah,300000,243400,2022-08-19
CASH_IN,235101,Agence_mtn_Abomey,300000,64899,Adrien Chartier,127521,362622,2022-08-20
CASH_OUT,169037,Adrien Chartier,362622,193585,Agence_mtn_Abomey,300000,130963,2022-08-27
CASH_IN,166155,Agence_mtn_Abomey,300000,133845,Pénélope Dupuis,-82072,84083,2022-08-04
CASH_OUT,76364,Pénélope Dupuis,84083,7719,Agence_mtn_Abomey,300000,223636,2022-08-06
CASH_OUT,456,Pénélope Dupuis,7719,7263,Agence_mtn_Abomey,300000,299544,2022-08-09
CASH_IN,86400,Agence_mtn_Abomey,300000,213600,Pénélope Dupuis,7263,93663,2022-08-10
TRANSFER,41868,Pénélope Dupuis,93663,51795,Pénélope Dupuis,93663,51795,2022-08-11
CASH_IN,250937,Agence_mtn_Ouidah,300000,49063,Pénélope Dupuis,51795,302732,2022-08-18
TRANSFER,270920,Pénélope Dupuis,302732,31812,Pénélope Dupuis,302732,573652,2022-08-19
CASH_IN,278960,Agence_mtn_Ouidah,300000,21040,Pénélope Dupuis,31812,310772,2022-08-20
CASH_OUT,52156,Pénélope Dupuis,310772,258616,Agence_mtn_Abomey,300000,247844,2022-08-21
CASH_OUT,212813,Pénélope Dupuis,258616,45803,Agence_mtn_Cotonou,300000,87187,2022-08-22
CASH_IN,278908,Agence_mtn_Ouidah,300000,21092,Pénélope Dupuis,45803,324711,2022-08-24
CASH_OUT,285127,Pénélope Dupuis,324711,39584,Agence_mtn_Cotonou,300000,14873,2022-08-25
CASH_OUT,13724,Pénélope Dupuis,39584,25860,Agence_mtn_Ouidah,300000,286276,2022-08-27
CASH_OUT,354446,Étienne Roche,1857200,1502754,Agence_mtn_Abomey,300000,-54446,2022-09-24
TRANSFER,1411618,Étienne Roche,1502754,91136,Cécile Clerc,1882600,470982,2022-09-25
CASH_IN,152700,Agence_mtn_Cotonou,300000,147300,Vincent Mathieu,721800,874500,2022-09-09
CASH_IN,227868,Agence_mtn_Cotonou,300000,72132,Vincent Mathieu,874500,1102368,2022-09-11
CASH_OUT,4786,Vincent Mathieu,1102368,1097582,Agence_mtn_Ouidah,300000,295214,2022-09-12
CASH_OUT,918956,Vincent Mathieu,1097582,178626,Agence_mtn_Cotonou,300000,-618956,2022-09-13
CASH_IN,13832,Agence_mtn_Cotonou,300000,286168,Émilie Moulin,488700,502532,2022-09-19
CASH_OUT,102153,Émilie Moulin,502532,400379,Agence_mtn_Ouidah,300000,197847,2022-09-21
TRANSFER,360005,Richard Le Descamps,747900,387895,Émilie Moulin,400379,760384,2022-09-26
TRANSFER,711684,Renée David,847100,135416,Cécile Delattre-Arnaud,36300,747984,2022-09-13
TRANSFER,70091,Pierre Reynaud,775700,705609,Cécile Delattre-Arnaud,747984,818075,2022-09-21
CASH_OUT,235749,Cécile Delattre-Arnaud,818075,582326,Agence_mtn_Abomey,300000,64251,2022-09-25
CASH_IN,140871,Agence_mtn_Cotonou,300000,159129,Cécile Delattre-Arnaud,582326,723197,2022-09-27
TRANSFER,1106117,Valentine Martinez,1132500,26383,François Michel-Legros,803300,1909417,2022-09-08
CASH_IN,260546,Agence_mtn_Abomey,300000,39454,François Michel-Legros,1909417,2169963,2022-09-20
TRANSFER,566409,Michelle Lebon,1165400,598991,Marie Picard,169800,736209,2022-09-02
CASH_OUT,345034,Marie Picard,736209,391175,Agence_mtn_Ouidah,300000,-45034,2022-09-20
CASH_OUT,19111,Marie Picard,391175,372064,Agence_mtn_Ouidah,300000,280889,2022-09-21
TRANSFER,72358,Sébastien Lemaître,170000,97642,Isabelle Rossi,1369900,1442258,2022-09-20
TRANSFER,904288,Claude Foucher,1879400,975112,Isabelle Rossi,1442258,2346546,2022-09-26
CASH_OUT,398249,Vincent Fournier,928700,530451,Agence_mtn_Ouidah,300000,-98249,2022-09-13
TRANSFER,123793,Geneviève De Oliveira-Michel,283000,159207,Vincent Fournier,530451,654244,2022-09-16
CASH_OUT,301464,Vincent Fournier,654244,352780,Agence_mtn_Abomey,300000,-1464,2022-09-22
CASH_IN,10970,Agence_mtn_Abomey,300000,289030,Sébastien Vallée,113800,124770,2022-09-04
CASH_IN,74893,Agence_mtn_Abomey,300000,225107,Sébastien Vallée,124770,199663,2022-09-13
CASH_IN,10594,Agence_mtn_Ouidah,300000,289406,Sébastien Vallée,199663,210257,2022-09-16
TRANSFER,262688,Pénélope Ollivier,868900,606212,Éléonore-Hélène Dubois,1434100,1171412,2022-09-06
CASH_IN,17242,Agence_mtn_Abomey,300000,282758,Pénélope Ollivier,606212,623454,2022-09-09
CASH_IN,281277,Agence_mtn_Abomey,300000,18723,Pénélope Ollivier,623454,904731,2022-09-12
CASH_IN,64692,Agence_mtn_Abomey,300000,235308,Pénélope Ollivier,904731,969423,2022-09-19
CASH_IN,149304,Agence_mtn_Ouidah,300000,150696,Pénélope Ollivier,969423,1118727,2022-09-21
CASH_IN,83329,Agence_mtn_Ouidah,300000,216671,Richard Le Descamps,387895,471224,2022-09-11
TRANSFER,310853,Richard Le Descamps,471224,160371,Alix Maillet,1957300,1646447,2022-09-12
CASH_IN,183246,Agence_mtn_Abomey,300000,116754,Richard Le Descamps,160371,343617,2022-09-12
CASH_IN,176172,Agence_mtn_Abomey,300000,123828,Richard Le Descamps,343617,519789,2022-09-15
CASH_OUT,171848,Richard Le Descamps,519789,347941,Agence_mtn_Ouidah,300000,128152,2022-09-21
CASH_IN,84366,Agence_mtn_Ouidah,300000,215634,Martine Wagner de la Bègue,950300,1034666,2022-09-03
CASH_IN,135771,Agence_mtn_Cotonou,300000,164229,Martine Wagner de la Bègue,1034666,1170437,2022-09-22
CASH_IN,149554,Agence_mtn_Ouidah,300000,150446,Martine Wagner de la Bègue,1170437,1319991,2022-09-27
CASH_OUT,894085,Pénélope Dupuis,1030600,136515,Agence_mtn_Abomey,300000,-594085,2022-09-04
CASH_IN,173965,Agence_mtn_Cotonou,300000,126035,Geneviève Grondin,270400,444365,2022-09-03
TRANSFER,420612,Benjamin Evrard-Marty,650100,229488,Geneviève Grondin,444365,864977,2022-09-11
TRANSFER,360076,Geneviève Grondin,864977,504901,Roland Garcia,1367800,1007724,2022-09-15
CASH_OUT,157583,Geneviève Grondin,504901,347318,Agence_mtn_Ouidah,300000,142417,2022-09-19
TRANSFER,120220,Geneviève Grondin,347318,227098,Roland Garcia,1007724,887504,2022-09-25
TRANSFER,12631,Corinne-Louise Valentin,43500,30869,Simone Pineau,428000,415369,2022-09-08
CASH_IN,39573,Agence_mtn_Abomey,300000,260427,Corinne-Louise Valentin,30869,70442,2022-09-12
CASH_IN,180814,Agence_mtn_Cotonou,300000,119186,Adrien Chartier,252900,433714,2022-09-07
CASH_IN,113744,Agence_mtn_Abomey,300000,186256,Adrien Chartier,433714,547458,2022-09-15
CASH_OUT,161594,Adrien Chartier,547458,385864,Agence_mtn_Ouidah,300000,138406,2022-09-20
CASH_IN,227739,Agence_mtn_Cotonou,300000,72261,Adrien Chartier,385864,613603,2022-09-22
CASH_IN,68611,Agence_mtn_Cotonou,300000,231389,David Guérin,871300,939911,2022-09-05
CASH_OUT,305261,Margot Renaud,901000,595739,Agence_mtn_Abomey,300000,-5261,2022-09-07
CASH_OUT,550014,Margot Renaud,595739,45725,Agence_mtn_Cotonou,300000,-250014,2022-09-07
CASH_IN,112439,Agence_mtn_Cotonou,300000,187561,Margot Renaud,45725,158164,2022-09-08
TRANSFER,488840,Adèle Labbé,490000,1160,Margot Renaud,158164,647004,2022-09-11
CASH_OUT,243373,William Le Lucas,741300,497927,Agence_mtn_Abomey,300000,56627,2022-09-12
CASH_IN,77431,Agence_mtn_Abomey,300000,222569,William Le Lucas,497927,575358,2022-09-14
CASH_IN,106506,Agence_mtn_Cotonou,300000,193494,William Le Lucas,575358,681864,2022-09-15
CASH_IN,262842,Agence_mtn_Cotonou,300000,37158,William Le Lucas,681864,944706,2022-09-24
CASH_IN,30985,Agence_mtn_Abomey,300000,269015,William Le Lucas,944706,975691,2022-09-26
CASH_IN,29318,Agence_mtn_Abomey,300000,270682,Sophie Gonzalez,46800,76118,2022-09-10
TRANSFER,1139049,Raymond Rossi,1221500,82451,Thérèse-Margaux Bruneau,489100,-649949,2022-09-15
CASH_OUT,11018,Raymond Rossi,82451,71433,Agence_mtn_Abomey,300000,288982,2022-09-19
CASH_IN,138551,Agence_mtn_Abomey,300000,161449,Raymond Rossi,71433,209984,2022-09-26
CASH_OUT,302483,Rémy de la Roux,801700,499217,Agence_mtn_Abomey,300000,-2483,2022-09-04
CASH_OUT,204725,Hortense Lemaire,775600,570875,Agence_mtn_Ouidah,300000,95275,2022-09-07
CASH_OUT,32085,Hortense Lemaire,570875,538790,Agence_mtn_Cotonou,300000,267915,2022-09-11
CASH_OUT,46480,Hortense Lemaire,538790,492310,Agence_mtn_Ouidah,300000,253520,2022-09-20
TRANSFER,67232,Hortense Lemaire,492310,425078,Eugène Poulain,746400,679168,2022-09-23
CASH_IN,160147,Agence_mtn_Cotonou,300000,139853,Alexandre Rémy,1690000,1850147,2022-09-03
TRANSFER,244087,Bertrand Charles,696700,452613,Alexandre Rémy,1850147,2094234,2022-09-05
CASH_IN,269464,Agence_mtn_Ouidah,300000,30536,Alexandre Rémy,2094234,2363698,2022-09-05
CASH_OUT,1831192,Alexandre Rémy,2363698,532506,Agence_mtn_Abomey,300000,-1531192,2022-09-25
TRANSFER,127918,Gilbert-Charles Thibault,171800,43882,Inès de Letellier,1656500,1784418,2022-09-18
CASH_IN,117820,Agence_mtn_Cotonou,300000,182180,Franck-Charles Texier,1232000,1349820,2022-09-06
CASH_IN,39352,Agence_mtn_Abomey,300000,260648,Franck-Charles Texier,1349820,1389172,2022-09-20
TRANSFER,446582,Franck-Charles Texier,1389172,942590,Raymond Marchal de Nguyen,578400,131818,2022-09-23
TRANSFER,704747,Thibault Moreno,1711400,1006653,Alix Maillet,1646447,2351194,2022-09-01
TRANSFER,86995,Sébastien Lemaître,97642,10647,Alix Maillet,2351194,2438189,2022-09-04
CASH_IN,53340,Agence_mtn_Ouidah,300000,246660,Alix Maillet,2438189,2491529,2022-09-08
TRANSFER,76809,Xavier de Lebreton,157000,80191,Alix Maillet,2491529,2568338,2022-09-08
TRANSFER,2062978,Alix Maillet,2568338,505360,Adèle Labbé,1160,-2061818,2022-09-08
CASH_OUT,328429,Alix Maillet,505360,176931,Agence_mtn_Cotonou,300000,-28429,2022-09-09
CASH_IN,244319,Agence_mtn_Cotonou,300000,55681,Alix Maillet,176931,421250,2022-09-09
CASH_OUT,405273,Alix Maillet,421250,15977,Agence_mtn_Cotonou,300000,-105273,2022-09-10
TRANSFER,1709374,Léon Martins-Briand,1966800,257426,Alix Maillet,15977,1725351,2022-09-11
CASH_IN,214942,Agence_mtn_Cotonou,300000,85058,Alix Maillet,1725351,1940293,2022-09-11
TRANSFER,1209474,Nath Bruneau,1891900,682426,Alix Maillet,1940293,3149767,2022-09-11
CASH_OUT,1699223,Alix Maillet,3149767,1450544,Agence_mtn_Ouidah,300000,-1399223,2022-09-13
CASH_OUT,10294,Alix Maillet,1450544,1440250,Agence_mtn_Abomey,300000,289706,2022-09-13
CASH_OUT,1255166,Alix Maillet,1440250,185084,Agence_mtn_Abomey,300000,-955166,2022-09-14
CASH_IN,191603,Agence_mtn_Abomey,300000,108397,Alix Maillet,185084,376687,2022-09-14
CASH_OUT,160580,Alix Maillet,376687,216107,Agence_mtn_Ouidah,300000,139420,2022-09-16
CASH_IN,130048,Agence_mtn_Cotonou,300000,169952,Alix Maillet,216107,346155,2022-09-17
CASH_OUT,157478,Alix Maillet,346155,188677,Agence_mtn_Cotonou,300000,142522,2022-09-17
CASH_OUT,134631,Alix Maillet,188677,54046,Agence_mtn_Abomey,300000,165369,2022-09-18
CASH_IN,90998,Agence_mtn_Abomey,300000,209002,Alix Maillet,54046,145044,2022-09-19
CASH_IN,288099,Agence_mtn_Cotonou,300000,11901,Alix Maillet,145044,433143,2022-09-19
TRANSFER,56275,Pierre Reynaud,705609,649334,Alix Maillet,433143,489418,2022-09-20
CASH_OUT,181913,Alix Maillet,489418,307505,Agence_mtn_Ouidah,300000,118087,2022-09-26
CASH_OUT,244981,Alix Maillet,307505,62524,Agence_mtn_Abomey,300000,55019,2022-09-26
CASH_OUT,94278,Frédéric Couturier,288800,194522,Agence_mtn_Ouidah,300000,205722,2022-09-01
CASH_IN,238381,Agence_mtn_Ouidah,300000,61619,Frédéric Couturier,194522,432903,2022-09-02
CASH_IN,234546,Agence_mtn_Abomey,300000,65454,Frédéric Couturier,432903,667449,2022-09-02
TRANSFER,114308,Frédéric Couturier,667449,553141,Bertrand Charles,452613,338305,2022-09-03
CASH_OUT,458164,Frédéric Couturier,553141,94977,Agence_mtn_Cotonou,300000,-158164,2022-09-03
CASH_IN,217787,Agence_mtn_Ouidah,300000,82213,Frédéric Couturier,94977,312764,2022-09-03
CASH_OUT,220166,Frédéric Couturier,312764,92598,Agence_mtn_Ouidah,300000,79834,2022-09-05
CASH_IN,140696,Agence_mtn_Cotonou,300000,159304,Frédéric Couturier,92598,233294,2022-09-07
CASH_IN,269943,Agence_mtn_Abomey,300000,30057,Frédéric Couturier,233294,503237,2022-09-07
CASH_OUT,59574,Frédéric Couturier,503237,443663,Agence_mtn_Abomey,300000,240426,2022-09-10
TRANSFER,146488,Frédéric Couturier,443663,297175,Victoire-Nicole Lopez,1893800,1747312,2022-09-10
TRANSFER,1285373,Antoine Leleu,1661200,375827,Frédéric Couturier,297175,1582548,2022-09-10
TRANSFER,694987,Frédéric Couturier,1582548,887561,Valentine Martinez,26383,-668604,2022-09-13
TRANSFER,106210,Nath Bruneau,682426,576216,Frédéric Couturier,887561,993771,2022-09-13
TRANSFER,1365278,Marine Chauvet-Potier,1413800,48522,Frédéric Couturier,993771,2359049,2022-09-16
TRANSFER,605254,Aurore Guyon,750100,144846,Frédéric Couturier,2359049,2964303,2022-09-19
CASH_OUT,803678,Frédéric Couturier,2964303,2160625,Agence_mtn_Abomey,300000,-503678,2022-09-19
CASH_OUT,1103059,Frédéric Couturier,2160625,1057566,Agence_mtn_Abomey,300000,-803059,2022-09-22
CASH_OUT,897585,Frédéric Couturier,1057566,159981,Agence_mtn_Ouidah,300000,-597585,2022-09-23
CASH_OUT,130594,Frédéric Couturier,159981,29387,Agence_mtn_Ouidah,300000,169406,2022-09-23
TRANSFER,207642,Pierre Reynaud,649334,441692,Frédéric Couturier,29387,237029,2022-09-23
CASH_OUT,200568,Frédéric Couturier,237029,36461,Agence_mtn_Abomey,300000,99432,2022-09-25
CASH_IN,254576,Agence_mtn_Cotonou,300000,45424,Frédéric Couturier,36461,291037,2022-09-26
CASH_OUT,7325,Xavier de Lebreton,80191,72866,Agence_mtn_Cotonou,300000,292675,2022-09-01
CASH_IN,53229,Agence_mtn_Cotonou,300000,246771,Xavier de Lebreton,72866,126095,2022-09-04
CASH_IN,286941,Agence_mtn_Abomey,300000,13059,Xavier de Lebreton,126095,413036,2022-09-05
CASH_OUT,390640,Xavier de Lebreton,413036,22396,Agence_mtn_Cotonou,300000,-90640,2022-09-05
CASH_OUT,20258,Xavier de Lebreton,22396,2138,Agence_mtn_Ouidah,300000,279742,2022-09-05
CASH_OUT,1397,Xavier de Lebreton,2138,741,Agence_mtn_Ouidah,300000,298603,2022-09-06
TRANSFER,1780,Sébastien Lemaître,10647,8867,Xavier de Lebreton,741,2521,2022-09-08
CASH_OUT,1888,Xavier de Lebreton,2521,633,Agence_mtn_Abomey,300000,298112,2022-09-09
TRANSFER,484,Xavier de Lebreton,633,149,Alphonse Le Olivier,89000,88516,2022-09-10
TRANSFER,111,Xavier de Lebreton,149,38,Catherine Faivre,1330400,1330289,2022-09-13
CASH_IN,218602,Agence_mtn_Abomey,300000,81398,Xavier de Lebreton,38,218640,2022-09-14
CASH_IN,98839,Agence_mtn_Cotonou,300000,201161,Xavier de Lebreton,218640,317479,2022-09-16
CASH_IN,24587,Agence_mtn_Abomey,300000,275413,Xavier de Lebreton,317479,342066,2022-09-17
CASH_IN,88955,Agence_mtn_Ouidah,300000,211045,Xavier de Lebreton,342066,431021,2022-09-17
TRANSFER,14516,Antoinette Bertrand,17600,3084,Xavier de Lebreton,431021,445537,2022-09-18
CASH_IN,214508,Agence_mtn_Abomey,300000,85492,Xavier de Lebreton,445537,660045,2022-09-18
CASH_IN,55124,Agence_mtn_Cotonou,300000,244876,Xavier de Lebreton,660045,715169,2022-09-19
CASH_IN,79995,Agence_mtn_Ouidah,300000,220005,Xavier de Lebreton,715169,795164,2022-09-19
CASH_OUT,406082,Xavier de Lebreton,795164,389082,Agence_mtn_Cotonou,300000,-106082,2022-09-20
TRANSFER,223134,Xavier de Lebreton,389082,165948,Raymond Marchal de Nguyen,131818,-91316,2022-09-20
TRANSFER,105484,Virginie Le Gall,710100,604616,Xavier de Lebreton,165948,271432,2022-09-24
TRANSFER,215634,Xavier de Lebreton,271432,55798,Céline Gomez,1976800,1761166,2022-09-25
CASH_OUT,1162755,Zoé Renaud de Boutin,1612000,449245,Agence_mtn_Abomey,300000,-862755,2022-09-01
CASH_OUT,179519,Zoé Renaud de Boutin,449245,269726,Agence_mtn_Cotonou,300000,120481,2022-09-02
CASH_IN,221565,Agence_mtn_Ouidah,300000,78435,Zoé Renaud de Boutin,269726,491291,2022-09-05
TRANSFER,30244,Aurore Guyon,144846,114602,Zoé Renaud de Boutin,491291,521535,2022-09-08
CASH_IN,90578,Agence_mtn_Abomey,300000,209422,Zoé Renaud de Boutin,521535,612113,2022-09-11
CASH_OUT,552373,Zoé Renaud de Boutin,612113,59740,Agence_mtn_Abomey,300000,-252373,2022-09-13
CASH_OUT,4723,Zoé Renaud de Boutin,59740,55017,Agence_mtn_Cotonou,300000,295277,2022-09-13
CASH_OUT,28641,Zoé Renaud de Boutin,55017,26376,Agence_mtn_Abomey,300000,271359,2022-09-14
CASH_OUT,10044,Zoé Renaud de Boutin,26376,16332,Agence_mtn_Cotonou,300000,289956,2022-09-15
CASH_IN,117657,Agence_mtn_Abomey,300000,182343,Zoé Renaud de Boutin,16332,133989,2022-09-15
TRANSFER,188460,Pierre Reynaud,441692,253232,Zoé Renaud de Boutin,133989,322449,2022-09-16
CASH_OUT,79332,Zoé Renaud de Boutin,322449,243117,Agence_mtn_Abomey,300000,220668,2022-09-16
TRANSFER,78560,Aurore Guyon,114602,36042,Zoé Renaud de Boutin,243117,321677,2022-09-17
TRANSFER,18172,Édouard Nguyen,144300,126128,Zoé Renaud de Boutin,321677,339849,2022-09-17
CASH_IN,54062,Agence_mtn_Ouidah,300000,245938,Zoé Renaud de Boutin,339849,393911,2022-09-18
TRANSFER,129584,Zoé Renaud de Boutin,393911,264327,Sébastien Lemaître,8867,-120717,2022-09-19
CASH_IN,213786,Agence_mtn_Cotonou,300000,86214,Zoé Renaud de Boutin,264327,478113,2022-09-20
CASH_IN,291900,Agence_mtn_Abomey,300000,8100,Zoé Renaud de Boutin,478113,770013,2022-09-21
CASH_IN,33660,Agence_mtn_Ouidah,300000,266340,Zoé Renaud de Boutin,770013,803673,2022-09-24
TRANSFER,225756,Zoé Renaud de Boutin,803673,577917,Louis Pichon,978200,752444,2022-09-25
CASH_IN,35804,Agence_mtn_Abomey,300000,264196,Zoé Renaud de Boutin,577917,613721,2022-09-27
TRANSFER,945579,Thibaut Coulon,957200,11621,Théodore De Oliveira-Nicolas,1332400,2277979,2022-09-01
TRANSFER,1067523,Marcelle Charrier,1364800,297277,Théodore De Oliveira-Nicolas,2277979,3345502,2022-09-02
CASH_OUT,1434436,Théodore De Oliveira-Nicolas,3345502,1911066,Agence_mtn_Ouidah,300000,-1134436,2022-09-03
CASH_IN,138886,Agence_mtn_Abomey,300000,161114,Théodore De Oliveira-Nicolas,1911066,2049952,2022-09-03
CASH_IN,110778,Agence_mtn_Abomey,300000,189222,Théodore De Oliveira-Nicolas,2049952,2160730,2022-09-04
CASH_OUT,1189042,Théodore De Oliveira-Nicolas,2160730,971688,Agence_mtn_Abomey,300000,-889042,2022-09-07
CASH_OUT,525210,Théodore De Oliveira-Nicolas,971688,446478,Agence_mtn_Ouidah,300000,-225210,2022-09-08
CASH_IN,123423,Agence_mtn_Cotonou,300000,176577,Théodore De Oliveira-Nicolas,446478,569901,2022-09-13
CASH_IN,235734,Agence_mtn_Ouidah,300000,64266,Théodore De Oliveira-Nicolas,569901,805635,2022-09-13
CASH_IN,208926,Agence_mtn_Cotonou,300000,91074,Théodore De Oliveira-Nicolas,805635,1014561,2022-09-14
TRANSFER,989,Gilbert-Charles Thibault,43882,42893,Théodore De Oliveira-Nicolas,1014561,1015550,2022-09-14
TRANSFER,454854,Cécile Germain,669500,214646,Théodore De Oliveira-Nicolas,1015550,1470404,2022-09-15
CASH_OUT,284087,Théodore De Oliveira-Nicolas,1470404,1186317,Agence_mtn_Abomey,300000,15913,2022-09-15
CASH_OUT,226140,Théodore De Oliveira-Nicolas,1186317,960177,Agence_mtn_Cotonou,300000,73860,2022-09-17
TRANSFER,469171,Théodore De Oliveira-Nicolas,960177,491006,Aurore Guyon,36042,-433129,2022-09-19
TRANSFER,178467,Théodore De Oliveira-Nicolas,491006,312539,Margot Riou du Fernandes,1233500,1055033,2022-09-20
CASH_OUT,155754,Théodore De Oliveira-Nicolas,312539,156785,Agence_mtn_Abomey,300000,144246,2022-09-23
CASH_OUT,130969,Théodore De Oliveira-Nicolas,156785,25816,Agence_mtn_Abomey,300000,169031,2022-09-24
CASH_IN,246735,Agence_mtn_Cotonou,300000,53265,Théodore De Oliveira-Nicolas,25816,272551,2022-09-24
TRANSFER,83141,Théodore De Oliveira-Nicolas,272551,189410,Pierre Reynaud,253232,170091,2022-09-24
TRANSFER,200654,Victoire-Nicole Lopez,1747312,1546658,Théodore De Oliveira-Nicolas,189410,390064,2022-09-25
TRANSFER,146976,Geneviève De Oliveira-Michel,159207,12231,Théodore De Oliveira-Nicolas,390064,537040,2022-09-26
CASH_IN,170522,Agence_mtn_Cotonou,300000,129478,Théodore De Oliveira-Nicolas,537040,707562,2022-09-26
CASH_IN,124790,Agence_mtn_Ouidah,300000,175210,Théodore De Oliveira-Nicolas,707562,832352,2022-09-27
CASH_IN,3543,Agence_mtn_Cotonou,300000,296457,Théodore De Oliveira-Nicolas,832352,835895,2022-09-27
CASH_OUT,1127455,Astrid Gay de la Brunet,1480200,352745,Agence_mtn_Cotonou,300000,-827455,2022-09-01
CASH_OUT,309747,Astrid Gay de la Brunet,352745,42998,Agence_mtn_Cotonou,300000,-9747,2022-09-03
CASH_IN,134952,Agence_mtn_Cotonou,300000,165048,Astrid Gay de la Brunet,42998,177950,2022-09-04
CASH_IN,139450,Agence_mtn_Abomey,300000,160550,Astrid Gay de la Brunet,177950,317400,2022-09-05
TRANSFER,1669534,Rémy Le Michaud,1850100,180566,Astrid Gay de la Brunet,317400,1986934,2022-09-06
CASH_OUT,481229,Astrid Gay de la Brunet,1986934,1505705,Agence_mtn_Cotonou,300000,-181229,2022-09-09
CASH_OUT,154431,Astrid Gay de la Brunet,1505705,1351274,Agence_mtn_Abomey,300000,145569,2022-09-10
TRANSFER,78046,Catherine Faivre,1330289,1252243,Astrid Gay de la Brunet,1351274,1429320,2022-09-11
TRANSFER,114270,Gabriel-Tristan Marty,207500,93230,Astrid Gay de la Brunet,1429320,1543590,2022-09-11
TRANSFER,1144006,Pierre Roger,1292000,147994,Astrid Gay de la Brunet,1543590,2687596,2022-09-12
CASH_OUT,1989763,Astrid Gay de la Brunet,2687596,697833,Agence_mtn_Ouidah,300000,-1689763,2022-09-12
TRANSFER,150341,Virginie Le Gall,604616,454275,Astrid Gay de la Brunet,697833,848174,2022-09-12
TRANSFER,606629,Astrid Gay de la Brunet,848174,241545,Valérie Dijoux,1345900,739271,2022-09-12
CASH_OUT,89391,Astrid Gay de la Brunet,241545,152154,Agence_mtn_Ouidah,300000,210609,2022-09-14
CASH_OUT,18378,Astrid Gay de la Brunet,152154,133776,Agence_mtn_Ouidah,300000,281622,2022-09-15
TRANSFER,122400,Astrid Gay de la Brunet,133776,11376,Benjamin Evrard-Marty,229488,107088,2022-09-15
TRANSFER,2836,Thierry Delattre-Simon,345900,343064,Astrid Gay de la Brunet,11376,14212,2022-09-16
CASH_OUT,1761,Astrid Gay de la Brunet,14212,12451,Agence_mtn_Abomey,300000,298239,2022-09-16
CASH_IN,245911,Agence_mtn_Ouidah,300000,54089,Astrid Gay de la Brunet,12451,258362,2022-09-17
CASH_IN,15171,Agence_mtn_Ouidah,300000,284829,Astrid Gay de la Brunet,258362,273533,2022-09-17
CASH_IN,160482,Agence_mtn_Abomey,300000,139518,Astrid Gay de la Brunet,273533,434015,2022-09-18
TRANSFER,146458,Astrid Gay de la Brunet,434015,287557,Inès Hamon,1140900,994442,2022-09-18
CASH_IN,103868,Agence_mtn_Cotonou,300000,196132,Astrid Gay de la Brunet,287557,391425,2022-09-18
TRANSFER,287934,Astrid Gay de la Brunet,391425,103491,Pierre Roger,147994,-139940,2022-09-23
CASH_OUT,55337,Astrid Gay de la Brunet,103491,48154,Agence_mtn_Abomey,300000,244663,2022-09-24
TRANSFER,42494,Astrid Gay de la Brunet,48154,5660,Jean Benard,295700,253206,2022-09-26
TRANSFER,9193,Geneviève De Oliveira-Michel,12231,3038,Astrid Gay de la Brunet,5660,14853,2022-09-26
CASH_OUT,3193,Astrid Gay de la Brunet,14853,11660,Agence_mtn_Abomey,300000,296807,2022-09-26
CASH_OUT,3985,Astrid Gay de la Brunet,11660,7675,Agence_mtn_Cotonou,300000,296015,2022-09-27
CASH_IN,136742,Agence_mtn_Cotonou,300000,163258,Raymond Marchal de Nguyen,-91316,45426,2022-09-01
TRANSFER,38062,Raymond Marchal de Nguyen,45426,7364,Laurent-Bertrand Lefort,1165600,1127538,2022-09-02
CASH_OUT,4745,Raymond Marchal de Nguyen,7364,2619,Agence_mtn_Abomey,300000,295255,2022-09-03
TRANSFER,166916,Marcelle Charrier,297277,130361,Raymond Marchal de Nguyen,2619,169535,2022-09-04
CASH_OUT,128450,Raymond Marchal de Nguyen,169535,41085,Agence_mtn_Ouidah,300000,171550,2022-09-04
CASH_OUT,30323,Raymond Marchal de Nguyen,41085,10762,Agence_mtn_Ouidah,300000,269677,2022-09-05
TRANSFER,6071,Raymond Marchal de Nguyen,10762,4691,Claude Foucher,975112,969041,2022-09-06
CASH_OUT,4348,Raymond Marchal de Nguyen,4691,343,Agence_mtn_Abomey,300000,295652,2022-09-07
TRANSFER,214,Raymond Marchal de Nguyen,343,129,Alphonse Le Olivier,88516,88302,2022-09-08
CASH_IN,154684,Agence_mtn_Cotonou,300000,145316,Raymond Marchal de Nguyen,129,154813,2022-09-08
CASH_IN,24474,Agence_mtn_Cotonou,300000,275526,Raymond Marchal de Nguyen,154813,179287,2022-09-09
CASH_OUT,179175,Raymond Marchal de Nguyen,179287,112,Agence_mtn_Ouidah,300000,120825,2022-09-10
CASH_OUT,103,Raymond Marchal de Nguyen,112,9,Agence_mtn_Cotonou,300000,299897,2022-09-10
CASH_IN,33752,Agence_mtn_Cotonou,300000,266248,Raymond Marchal de Nguyen,9,33761,2022-09-11
CASH_OUT,25744,Raymond Marchal de Nguyen,33761,8017,Agence_mtn_Cotonou,300000,274256,2022-09-12
CASH_OUT,2906,Raymond Marchal de Nguyen,8017,5111,Agence_mtn_Abomey,300000,297094,2022-09-12
TRANSFER,171042,Léon Martins-Briand,257426,86384,Raymond Marchal de Nguyen,5111,176153,2022-09-12
CASH_OUT,29526,Raymond Marchal de Nguyen,176153,146627,Agence_mtn_Abomey,300000,270474,2022-09-12
TRANSFER,40308,Raymond Marchal de Nguyen,146627,106319,Marcelle Paris,359700,319392,2022-09-13
TRANSFER,420778,Cécile Clerc,470982,50204,Raymond Marchal de Nguyen,106319,527097,2022-09-18
TRANSFER,192371,Gilbert Foucher,601200,408829,Raymond Marchal de Nguyen,527097,719468,2022-09-23
TRANSFER,596318,Raymond Marchal de Nguyen,719468,123150,Marcelle Charrier,130361,-465957,2022-09-25
CASH_IN,12353,Agence_mtn_Abomey,300000,287647,Raymond Marchal de Nguyen,123150,135503,2022-09-25
TRANSFER,96402,Raymond Marchal de Nguyen,135503,39101,Alexandrie Delmas,595200,498798,2022-09-27
TRANSFER,83608,Pierre Reynaud,170091,86483,William Lebrun,16000,99608,2022-09-02
CASH_OUT,19133,William Lebrun,99608,80475,Agence_mtn_Ouidah,300000,280867,2022-09-03
CASH_OUT,78316,William Lebrun,80475,2159,Agence_mtn_Ouidah,300000,221684,2022-09-03
CASH_OUT,1902,William Lebrun,2159,257,Agence_mtn_Ouidah,300000,298098,2022-09-03
CASH_IN,171981,Agence_mtn_Cotonou,300000,128019,William Lebrun,257,172238,2022-09-04
CASH_IN,116430,Agence_mtn_Ouidah,300000,183570,William Lebrun,172238,288668,2022-09-05
TRANSFER,246252,William Lebrun,288668,42416,Victoire-Nicole Lopez,1546658,1300406,2022-09-06
CASH_OUT,17650,William Lebrun,42416,24766,Agence_mtn_Cotonou,300000,282350,2022-09-08
CASH_OUT,22906,William Lebrun,24766,1860,Agence_mtn_Cotonou,300000,277094,2022-09-08
CASH_OUT,1557,William Lebrun,1860,303,Agence_mtn_Cotonou,300000,298443,2022-09-08
TRANSFER,266,William Lebrun,303,37,Céline Gomez,1761166,1760900,2022-09-10
CASH_IN,36265,Agence_mtn_Cotonou,300000,263735,William Lebrun,37,36302,2022-09-10
TRANSFER,26057,William Lebrun,36302,10245,Rémy Le Michaud,180566,154509,2022-09-11
CASH_IN,34508,Agence_mtn_Ouidah,300000,265492,William Lebrun,10245,44753,2022-09-13
CASH_IN,144597,Agence_mtn_Abomey,300000,155403,William Lebrun,44753,189350,2022-09-14
CASH_IN,56996,Agence_mtn_Ouidah,300000,243004,William Lebrun,189350,246346,2022-09-16
CASH_OUT,206171,William Lebrun,246346,40175,Agence_mtn_Cotonou,300000,93829,2022-09-20
CASH_OUT,11432,William Lebrun,40175,28743,Agence_mtn_Cotonou,300000,288568,2022-09-22
CASH_OUT,5145,William Lebrun,28743,23598,Agence_mtn_Ouidah,300000,294855,2022-09-22
CASH_IN,7078,Agence_mtn_Ouidah,300000,292922,William Lebrun,23598,30676,2022-09-24
CASH_OUT,5691,William Lebrun,30676,24985,Agence_mtn_Ouidah,300000,294309,2022-09-25
TRANSFER,65029,Léon Martins-Briand,86384,21355,William Lebrun,24985,90014,2022-09-25
CASH_OUT,109023,Virginie Le Gall,454275,345252,Agence_mtn_Ouidah,300000,190977,2022-09-01
CASH_OUT,80343,Virginie Le Gall,345252,264909,Agence_mtn_Abomey,300000,219657,2022-09-01
CASH_OUT,168824,Virginie Le Gall,264909,96085,Agence_mtn_Abomey,300000,131176,2022-09-02
TRANSFER,76385,Inès Hamon,994442,918057,Virginie Le Gall,96085,172470,2022-09-04
CASH_IN,126394,Agence_mtn_Ouidah,300000,173606,Virginie Le Gall,172470,298864,2022-09-04
TRANSFER,1181174,Céline Gomez,1760900,579726,Virginie Le Gall,298864,1480038,2022-09-06
CASH_OUT,1238625,Virginie Le Gall,1480038,241413,Agence_mtn_Ouidah,300000,-938625,2022-09-07
CASH_IN,161683,Agence_mtn_Cotonou,300000,138317,Virginie Le Gall,241413,403096,2022-09-07
CASH_OUT,123384,Virginie Le Gall,403096,279712,Agence_mtn_Ouidah,300000,176616,2022-09-08
TRANSFER,52063,Virginie Le Gall,279712,227649,Simone Pineau,415369,363306,2022-09-11
CASH_IN,71462,Agence_mtn_Abomey,300000,228538,Virginie Le Gall,227649,299111,2022-09-13
CASH_IN,126846,Agence_mtn_Ouidah,300000,173154,Virginie Le Gall,299111,425957,2022-09-14
TRANSFER,22594,Virginie Le Gall,425957,403363,Pierre Reynaud,86483,63889,2022-09-14
CASH_OUT,52001,Virginie Le Gall,403363,351362,Agence_mtn_Ouidah,300000,247999,2022-09-14
CASH_IN,111915,Agence_mtn_Cotonou,300000,188085,Virginie Le Gall,351362,463277,2022-09-14
CASH_OUT,404586,Virginie Le Gall,463277,58691,Agence_mtn_Abomey,300000,-104586,2022-09-17
CASH_IN,294706,Agence_mtn_Abomey,300000,5294,Virginie Le Gall,58691,353397,2022-09-18
CASH_IN,157017,Agence_mtn_Abomey,300000,142983,Virginie Le Gall,353397,510414,2022-09-19
CASH_OUT,318650,Virginie Le Gall,510414,191764,Agence_mtn_Ouidah,300000,-18650,2022-09-19
TRANSFER,68938,Rémy Le Michaud,154509,85571,Virginie Le Gall,191764,260702,2022-09-19
CASH_OUT,82911,Virginie Le Gall,260702,177791,Agence_mtn_Ouidah,300000,217089,2022-09-21
CASH_IN,213100,Agence_mtn_Ouidah,300000,86900,Virginie Le Gall,177791,390891,2022-09-23
CASH_IN,256224,Agence_mtn_Ouidah,300000,43776,Virginie Le Gall,390891,647115,2022-09-23
CASH_OUT,268065,Virginie Le Gall,647115,379050,Agence_mtn_Abomey,300000,31935,2022-09-25
CASH_OUT,375333,Virginie Le Gall,379050,3717,Agence_mtn_Abomey,300000,-75333,2022-09-25
CASH_IN,150522,Agence_mtn_Ouidah,300000,149478,Virginie Le Gall,3717,154239,2022-09-26
TRANSFER,303518,Claude Foucher,969041,665523,Alphonse Le Olivier,88302,391820,2022-09-02
TRANSFER,18744,Alphonse Le Olivier,391820,373076,Honoré du Laurent,1510100,1491356,2022-09-05
CASH_OUT,112815,Alphonse Le Olivier,373076,260261,Agence_mtn_Cotonou,300000,187185,2022-09-05
CASH_OUT,72329,Alphonse Le Olivier,260261,187932,Agence_mtn_Abomey,300000,227671,2022-09-06
CASH_OUT,122997,Alphonse Le Olivier,187932,64935,Agence_mtn_Cotonou,300000,177003,2022-09-06
CASH_OUT,26810,Alphonse Le Olivier,64935,38125,Agence_mtn_Cotonou,300000,273190,2022-09-06
CASH_OUT,31301,Alphonse Le Olivier,38125,6824,Agence_mtn_Cotonou,300000,268699,2022-09-07
TRANSFER,2119,Alphonse Le Olivier,6824,4705,Honoré du Laurent,1491356,1489237,2022-09-09
CASH_OUT,2276,Alphonse Le Olivier,4705,2429,Agence_mtn_Ouidah,300000,297724,2022-09-09
CASH_IN,17489,Agence_mtn_Ouidah,300000,282511,Alphonse Le Olivier,2429,19918,2022-09-10
TRANSFER,18001,Alphonse Le Olivier,19918,1917,Jean Benard,253206,235205,2022-09-11
TRANSFER,736478,Joséphine Gros,1210900,474422,Alphonse Le Olivier,1917,738395,2022-09-12
CASH_IN,119105,Agence_mtn_Ouidah,300000,180895,Alphonse Le Olivier,738395,857500,2022-09-13
CASH_OUT,193688,Alphonse Le Olivier,857500,663812,Agence_mtn_Cotonou,300000,106312,2022-09-15
CASH_IN,204761,Agence_mtn_Abomey,300000,95239,Alphonse Le Olivier,663812,868573,2022-09-16
CASH_OUT,803473,Alphonse Le Olivier,868573,65100,Agence_mtn_Ouidah,300000,-503473,2022-09-17
CASH_OUT,19014,Alphonse Le Olivier,65100,46086,Agence_mtn_Cotonou,300000,280986,2022-09-17
CASH_OUT,9829,Alphonse Le Olivier,46086,36257,Agence_mtn_Ouidah,300000,290171,2022-09-20
CASH_IN,201962,Agence_mtn_Ouidah,300000,98038,Alphonse Le Olivier,36257,238219,2022-09-20
CASH_IN,128213,Agence_mtn_Cotonou,300000,171787,Alphonse Le Olivier,238219,366432,2022-09-21
CASH_OUT,184986,Alphonse Le Olivier,366432,181446,Agence_mtn_Cotonou,300000,115014,2022-09-21
CASH_IN,118853,Agence_mtn_Ouidah,300000,181147,Alphonse Le Olivier,181446,300299,2022-09-21
CASH_OUT,158120,Alphonse Le Olivier,300299,142179,Agence_mtn_Abomey,300000,141880,2022-09-21
TRANSFER,302337,Gilbert Foucher,408829,106492,Alphonse Le Olivier,142179,444516,2022-09-22
CASH_IN,264741,Agence_mtn_Abomey,300000,35259,Alphonse Le Olivier,444516,709257,2022-09-22
CASH_IN,263297,Agence_mtn_Ouidah,300000,36703,Alphonse Le Olivier,709257,972554,2022-09-23
CASH_OUT,485546,Alphonse Le Olivier,972554,487008,Agence_mtn_Ouidah,300000,-185546,2022-09-24
CASH_IN,42230,Agence_mtn_Abomey,300000,257770,Alphonse Le Olivier,487008,529238,2022-09-25
CASH_OUT,527253,Alphonse Le Olivier,529238,1985,Agence_mtn_Abomey,300000,-227253,2022-09-25
CASH_IN,30949,Agence_mtn_Abomey,300000,269051,Thérèse-Margaux Bruneau,-649949,-619000,2022-09-01
CASH_IN,203903,Agence_mtn_Cotonou,300000,96097,Thérèse-Margaux Bruneau,-619000,-415097,2022-09-02
CASH_IN,221011,Agence_mtn_Cotonou,300000,78989,Thérèse-Margaux Bruneau,-415097,-194086,2022-09-02
CASH_IN,94628,Agence_mtn_Cotonou,300000,205372,Thérèse-Margaux Bruneau,-194086,-99458,2022-09-03
CASH_IN,53601,Agence_mtn_Abomey,300000,246399,Thérèse-Margaux Bruneau,-99458,-45857,2022-09-04
CASH_IN,268391,Agence_mtn_Cotonou,300000,31609,Thérèse-Margaux Bruneau,-45857,222534,2022-09-04
TRANSFER,207975,Antoine Leleu,375827,167852,Thérèse-Margaux Bruneau,222534,430509,2022-09-05
TRANSFER,122255,Thérèse-Margaux Bruneau,430509,308254,Gabriel-Tristan Marty,93230,-29025,2022-09-06
CASH_IN,281930,Agence_mtn_Cotonou,300000,18070,Thérèse-Margaux Bruneau,308254,590184,2022-09-06
TRANSFER,287524,Thérèse-Margaux Bruneau,590184,302660,Gilbert Foucher,106492,-181032,2022-09-07
TRANSFER,10934,Léon Martins-Briand,21355,10421,Thérèse-Margaux Bruneau,302660,313594,2022-09-09
CASH_OUT,152381,Thérèse-Margaux Bruneau,313594,161213,Agence_mtn_Cotonou,300000,147619,2022-09-11
CASH_OUT,49420,Thérèse-Margaux Bruneau,161213,111793,Agence_mtn_Cotonou,300000,250580,2022-09-12
CASH_OUT,27449,Thérèse-Margaux Bruneau,111793,84344,Agence_mtn_Cotonou,300000,272551,2022-09-12
CASH_OUT,50232,Thérèse-Margaux Bruneau,84344,34112,Agence_mtn_Abomey,300000,249768,2022-09-13
CASH_OUT,7709,Thérèse-Margaux Bruneau,34112,26403,Agence_mtn_Cotonou,300000,292291,2022-09-15
CASH_IN,22217,Agence_mtn_Abomey,300000,277783,Thérèse-Margaux Bruneau,26403,48620,2022-09-16
CASH_OUT,19495,Thérèse-Margaux Bruneau,48620,29125,Agence_mtn_Abomey,300000,280505,2022-09-17
CASH_IN,8767,Agence_mtn_Abomey,300000,291233,Thérèse-Margaux Bruneau,29125,37892,2022-09-17
CASH_OUT,2485,Thérèse-Margaux Bruneau,37892,35407,Agence_mtn_Cotonou,300000,297515,2022-09-18
TRANSFER,13537,Thérèse-Margaux Bruneau,35407,21870,Nathalie Peron,714900,701363,2022-09-18
TRANSFER,6923,Thérèse-Margaux Bruneau,21870,14947,Marcelle Paris,319392,312469,2022-09-22
TRANSFER,906472,Laurent-Bertrand Lefort,1127538,221066,Thérèse-Margaux Bruneau,14947,921419,2022-09-22
CASH_OUT,771122,Thérèse-Margaux Bruneau,921419,150297,Agence_mtn_Cotonou,300000,-471122,2022-09-23
TRANSFER,248087,Céline Gomez,579726,331639,Thérèse-Margaux Bruneau,150297,398384,2022-09-24
CASH_OUT,182788,Thérèse-Margaux Bruneau,398384,215596,Agence_mtn_Cotonou,300000,117212,2022-09-24
CASH_IN,297545,Agence_mtn_Cotonou,300000,2455,Thérèse-Margaux Bruneau,215596,513141,2022-09-25
CASH_OUT,293319,Thérèse-Margaux Bruneau,513141,219822,Agence_mtn_Cotonou,300000,6681,2022-09-26
TRANSFER,203236,Thérèse-Margaux Bruneau,219822,16586,Philippine Courtois,349800,146564,2022-09-27
CASH_IN,201279,Agence_mtn_Abomey,300000,98721,Nathalie Pages,810100,1011379,2022-09-01
TRANSFER,498759,Nathalie Peron,701363,202604,Nathalie Pages,1011379,1510138,2022-09-02
CASH_OUT,497574,Nathalie Pages,1510138,1012564,Agence_mtn_Abomey,300000,-197574,2022-09-03
CASH_OUT,789752,Nathalie Pages,1012564,222812,Agence_mtn_Cotonou,300000,-489752,2022-09-05
CASH_OUT,171091,Nathalie Pages,222812,51721,Agence_mtn_Abomey,300000,128909,2022-09-07
TRANSFER,460434,Valentine Richard-Bourdon,1259100,798666,Nathalie Pages,51721,512155,2022-09-08
CASH_IN,213521,Agence_mtn_Abomey,300000,86479,Nathalie Pages,512155,725676,2022-09-09
CASH_IN,247777,Agence_mtn_Ouidah,300000,52223,Nathalie Pages,725676,973453,2022-09-09
CASH_OUT,40567,Nathalie Pages,973453,932886,Agence_mtn_Cotonou,300000,259433,2022-09-10
TRANSFER,844809,Nathalie Pages,932886,88077,Bertrand Le Roux,1538900,694091,2022-09-10
TRANSFER,23650,Nathalie Pages,88077,64427,Léon Lecoq,728500,704850,2022-09-12
CASH_OUT,22598,Nathalie Pages,64427,41829,Agence_mtn_Ouidah,300000,277402,2022-09-13
CASH_OUT,25131,Nathalie Pages,41829,16698,Agence_mtn_Abomey,300000,274869,2022-09-15
CASH_OUT,6205,Nathalie Pages,16698,10493,Agence_mtn_Cotonou,300000,293795,2022-09-15
CASH_IN,103654,Agence_mtn_Ouidah,300000,196346,Nathalie Pages,10493,114147,2022-09-16
CASH_IN,274255,Agence_mtn_Ouidah,300000,25745,Nathalie Pages,114147,388402,2022-09-16
TRANSFER,307948,Nathalie Pages,388402,80454,Claude Foucher,665523,357575,2022-09-17
TRANSFER,6748,Nathalie Pages,80454,73706,Céline Gomez,331639,324891,2022-09-17
CASH_OUT,15588,Nathalie Pages,73706,58118,Agence_mtn_Cotonou,300000,284412,2022-09-18
CASH_IN,47975,Agence_mtn_Ouidah,300000,252025,Nathalie Pages,58118,106093,2022-09-19
TRANSFER,957662,Honoré du Laurent,1489237,531575,Nathalie Pages,106093,1063755,2022-09-20
CASH_IN,109062,Agence_mtn_Cotonou,300000,190938,Nathalie Pages,1063755,1172817,2022-09-22
CASH_OUT,168658,Nathalie Pages,1172817,1004159,Agence_mtn_Abomey,300000,131342,2022-09-22
CASH_IN,124247,Agence_mtn_Abomey,300000,175753,Nathalie Pages,1004159,1128406,2022-09-23
TRANSFER,41070,Renée David,135416,94346,Nathalie Pages,1128406,1169476,2022-09-24
TRANSFER,67234,Simone Pineau,363306,296072,Nathalie Pages,1169476,1236710,2022-09-24
CASH_IN,122548,Agence_mtn_Abomey,300000,177452,Nathalie Pages,1236710,1359258,2022-09-26
TRANSFER,152383,Nathalie Pages,1359258,1206875,Bertrand Le Roux,694091,541708,2022-09-27
TRANSFER,572974,Nathalie Pages,1206875,633901,Nathalie Pages,1206875,633901,2022-09-27
TRANSFER,47044,Rémy Le Michaud,85571,38527,Michelle Lebon,598991,551947,2022-09-01
CASH_OUT,14756,Rémy Le Michaud,38527,23771,Agence_mtn_Cotonou,300000,285244,2022-09-01
TRANSFER,309382,Michelle Lebon,551947,242565,Rémy Le Michaud,23771,333153,2022-09-01
CASH_IN,90949,Agence_mtn_Ouidah,300000,209051,Rémy Le Michaud,333153,424102,2022-09-02
CASH_OUT,392629,Rémy Le Michaud,424102,31473,Agence_mtn_Cotonou,300000,-92629,2022-09-05
CASH_OUT,16461,Rémy Le Michaud,31473,15012,Agence_mtn_Cotonou,300000,283539,2022-09-07
TRANSFER,222989,Simone Pineau,296072,73083,Rémy Le Michaud,15012,238001,2022-09-07
TRANSFER,178064,Jeanne Garnier,561800,383736,Rémy Le Michaud,238001,416065,2022-09-07
TRANSFER,5155,Antoine Leleu,167852,162697,Rémy Le Michaud,416065,421220,2022-09-08
TRANSFER,410974,Thibault Moreno,1006653,595679,Rémy Le Michaud,421220,832194,2022-09-11
TRANSFER,783498,Rémy Le Michaud,832194,48696,Simone Pineau,73083,-710415,2022-09-11
TRANSFER,43015,Rémy Le Michaud,48696,5681,Sophie Lévêque,1437400,1394385,2022-09-12
CASH_IN,79156,Agence_mtn_Abomey,300000,220844,Rémy Le Michaud,5681,84837,2022-09-13
TRANSFER,22570,Rémy Le Michaud,84837,62267,Léon Martins-Briand,10421,-12149,2022-09-13
TRANSFER,61508,Rémy Le Michaud,62267,759,Louis Pichon,752444,690936,2022-09-14
CASH_IN,103729,Agence_mtn_Abomey,300000,196271,Rémy Le Michaud,759,104488,2022-09-15
TRANSFER,852607,Tristan Thomas,1915500,1062893,Rémy Le Michaud,104488,957095,2022-09-17
CASH_IN,171575,Agence_mtn_Cotonou,300000,128425,Rémy Le Michaud,957095,1128670,2022-09-21
TRANSFER,613767,Roland Garcia,887504,273737,Rémy Le Michaud,1128670,1742437,2022-09-22
CASH_OUT,1082147,Rémy Le Michaud,1742437,660290,Agence_mtn_Abomey,300000,-782147,2022-09-23
CASH_IN,186930,Agence_mtn_Cotonou,300000,113070,Rémy Le Michaud,660290,847220,2022-09-23
CASH_IN,150476,Agence_mtn_Abomey,300000,149524,Rémy Le Michaud,847220,997696,2022-09-24
CASH_OUT,289562,Rémy Le Michaud,997696,708134,Agence_mtn_Ouidah,300000,10438,2022-09-25
TRANSFER,568264,Léon Lecoq,704850,136586,Rémy Le Michaud,708134,1276398,2022-09-25
TRANSFER,332086,Rémy Le Michaud,1276398,944312,Thibaut Coulon,11621,-320465,2022-09-26
CASH_IN,151053,Agence_mtn_Abomey,300000,148947,Rémy Le Michaud,944312,1095365,2022-09-27
CASH_OUT,516174,Rémy Le Michaud,1095365,579191,Agence_mtn_Cotonou,300000,-216174,2022-09-27
CASH_IN,251107,Agence_mtn_Cotonou,300000,48893,Aurore Guyon,-433129,-182022,2022-09-01
CASH_IN,20335,Agence_mtn_Abomey,300000,279665,Aurore Guyon,-182022,-161687,2022-09-02
CASH_IN,228414,Agence_mtn_Ouidah,300000,71586,Aurore Guyon,-161687,66727,2022-09-03
CASH_IN,122023,Agence_mtn_Cotonou,300000,177977,Aurore Guyon,66727,188750,2022-09-06
CASH_IN,227356,Agence_mtn_Ouidah,300000,72644,Aurore Guyon,188750,416106,2022-09-09
TRANSFER,23530,Aurore Guyon,416106,392576,Valérie Dijoux,739271,715741,2022-09-09
CASH_IN,180099,Agence_mtn_Ouidah,300000,119901,Aurore Guyon,392576,572675,2022-09-10
TRANSFER,296290,Aurore Guyon,572675,276385,Céline Gomez,324891,28601,2022-09-11
CASH_OUT,241062,Aurore Guyon,276385,35323,Agence_mtn_Abomey,300000,58938,2022-09-12
CASH_IN,14053,Agence_mtn_Abomey,300000,285947,Aurore Guyon,35323,49376,2022-09-15
CASH_IN,187894,Agence_mtn_Abomey,300000,112106,Aurore Guyon,49376,237270,2022-09-15
TRANSFER,721,Antoinette Bertrand,3084,2363,Aurore Guyon,237270,237991,2022-09-15
CASH_IN,85559,Agence_mtn_Ouidah,300000,214441,Aurore Guyon,237991,323550,2022-09-17
CASH_IN,145185,Agence_mtn_Cotonou,300000,154815,Aurore Guyon,323550,468735,2022-09-18
CASH_OUT,164635,Aurore Guyon,468735,304100,Agence_mtn_Cotonou,300000,135365,2022-09-18
TRANSFER,131970,Aurore Guyon,304100,172130,Tristan Thomas,1062893,930923,2022-09-18
CASH_OUT,59247,Aurore Guyon,172130,112883,Agence_mtn_Cotonou,300000,240753,2022-09-18
CASH_IN,246147,Agence_mtn_Cotonou,300000,53853,Aurore Guyon,112883,359030,2022-09-21
TRANSFER,198934,Aurore Guyon,359030,160096,Eugène Poulain,679168,480234,2022-09-22
CASH_IN,22207,Agence_mtn_Ouidah,300000,277793,Aurore Guyon,160096,182303,2022-09-23
TRANSFER,1159329,Victoire-Nicole Lopez,1300406,141077,Aurore Guyon,182303,1341632,2022-09-25
TRANSFER,307098,David du Blondel,1894800,1587702,Aurore Guyon,1341632,1648730,2022-09-26
CASH_IN,71713,Agence_mtn_Cotonou,300000,228287,Aurore Guyon,1648730,1720443,2022-09-27
CASH_IN,62639,Agence_mtn_Abomey,300000,237361,Aurore Guyon,1720443,1783082,2022-09-27
TRANSFER,163587,Roland Garcia,273737,110150,Édouard Nguyen,126128,289715,2022-09-02
CASH_IN,44887,Agence_mtn_Abomey,300000,255113,Édouard Nguyen,289715,334602,2022-09-04
CASH_OUT,162171,Édouard Nguyen,334602,172431,Agence_mtn_Ouidah,300000,137829,2022-09-05
TRANSFER,454225,Bertrand Le Roux,541708,87483,Édouard Nguyen,172431,626656,2022-09-05
CASH_OUT,353767,Édouard Nguyen,626656,272889,Agence_mtn_Cotonou,300000,-53767,2022-09-06
CASH_OUT,64680,Édouard Nguyen,272889,208209,Agence_mtn_Abomey,300000,235320,2022-09-10
TRANSFER,144393,Édouard Nguyen,208209,63816,Céline Gomez,28601,-115792,2022-09-10
TRANSFER,222447,Valentine Richard-Bourdon,798666,576219,Édouard Nguyen,63816,286263,2022-09-12
TRANSFER,90430,Édouard Nguyen,286263,195833,Michelle Lebon,242565,152135,2022-09-13
CASH_IN,8656,Agence_mtn_Abomey,300000,291344,Édouard Nguyen,195833,204489,2022-09-13
TRANSFER,24956,Inès Hamon,918057,893101,Édouard Nguyen,204489,229445,2022-09-14
CASH_OUT,138653,Édouard Nguyen,229445,90792,Agence_mtn_Cotonou,300000,161347,2022-09-14
TRANSFER,33430,Thierry Delattre-Simon,343064,309634,Édouard Nguyen,90792,124222,2022-09-15
TRANSFER,57772,Édouard Nguyen,124222,66450,Louis Pichon,690936,633164,2022-09-15
CASH_OUT,46179,Édouard Nguyen,66450,20271,Agence_mtn_Abomey,300000,253821,2022-09-15
CASH_IN,255394,Agence_mtn_Ouidah,300000,44606,Édouard Nguyen,20271,275665,2022-09-16
CASH_OUT,243650,Édouard Nguyen,275665,32015,Agence_mtn_Ouidah,300000,56350,2022-09-16
CASH_OUT,1497,Édouard Nguyen,32015,30518,Agence_mtn_Ouidah,300000,298503,2022-09-17
CASH_IN,14617,Agence_mtn_Ouidah,300000,285383,Édouard Nguyen,30518,45135,2022-09-17
CASH_IN,218018,Agence_mtn_Ouidah,300000,81982,Édouard Nguyen,45135,263153,2022-09-18
CASH_OUT,253932,Édouard Nguyen,263153,9221,Agence_mtn_Cotonou,300000,46068,2022-09-18
CASH_IN,260271,Agence_mtn_Cotonou,300000,39729,Édouard Nguyen,9221,269492,2022-09-21
CASH_OUT,259600,Édouard Nguyen,269492,9892,Agence_mtn_Abomey,300000,40400,2022-09-21
CASH_IN,295406,Agence_mtn_Abomey,300000,4594,Édouard Nguyen,9892,305298,2022-09-23
CASH_OUT,116108,Édouard Nguyen,305298,189190,Agence_mtn_Cotonou,300000,183892,2022-09-23
CASH_OUT,28173,Édouard Nguyen,189190,161017,Agence_mtn_Abomey,300000,271827,2022-09-23
CASH_OUT,154502,Édouard Nguyen,161017,6515,Agence_mtn_Ouidah,300000,145498,2022-09-24
TRANSFER,407665,Emmanuelle Georges,1310200,902535,Édouard Nguyen,6515,414180,2022-09-25
CASH_OUT,196338,Édouard Nguyen,414180,217842,Agence_mtn_Cotonou,300000,103662,2022-09-27
CASH_IN,145399,Agence_mtn_Abomey,300000,154601,Édouard Nguyen,217842,363241,2022-09-27
TRANSFER,379727,Joséphine Gros,474422,94695,Bertrand Le Roux,87483,-292244,2022-09-01
TRANSFER,51206,Joséphine Gros,94695,43489,Laurent-Bertrand Lefort,221066,169860,2022-09-01
TRANSFER,7634,Joséphine Gros,43489,35855,Cécile Germain,214646,207012,2022-09-03
TRANSFER,598919,Tristan Thomas,930923,332004,Joséphine Gros,35855,634774,2022-09-03
CASH_OUT,276572,Joséphine Gros,634774,358202,Agence_mtn_Abomey,300000,23428,2022-09-04
TRANSFER,98155,Cécile Germain,207012,108857,Joséphine Gros,358202,456357,2022-09-05
TRANSFER,107841,Caroline-Lorraine Humbert,614600,506759,Joséphine Gros,456357,564198,2022-09-06
CASH_OUT,440361,Joséphine Gros,564198,123837,Agence_mtn_Cotonou,300000,-140361,2022-09-06
TRANSFER,38647,Léon Lecoq,136586,97939,Joséphine Gros,123837,162484,2022-09-08
CASH_OUT,50007,Joséphine Gros,162484,112477,Agence_mtn_Cotonou,300000,249993,2022-09-11
CASH_IN,202560,Agence_mtn_Abomey,300000,97440,Joséphine Gros,112477,315037,2022-09-14
CASH_OUT,222383,Joséphine Gros,315037,92654,Agence_mtn_Ouidah,300000,77617,2022-09-14
CASH_OUT,5254,Joséphine Gros,92654,87400,Agence_mtn_Cotonou,300000,294746,2022-09-17
CASH_OUT,7657,Joséphine Gros,87400,79743,Agence_mtn_Ouidah,300000,292343,2022-09-20
CASH_IN,96455,Agence_mtn_Cotonou,300000,203545,Joséphine Gros,79743,176198,2022-09-20
CASH_IN,259667,Agence_mtn_Abomey,300000,40333,Joséphine Gros,176198,435865,2022-09-21
TRANSFER,428610,Joséphine Gros,435865,7255,Laurent-Bertrand Lefort,169860,-258750,2022-09-21
CASH_OUT,4518,Joséphine Gros,7255,2737,Agence_mtn_Cotonou,300000,295482,2022-09-21
CASH_IN,121409,Agence_mtn_Abomey,300000,178591,Joséphine Gros,2737,124146,2022-09-23
CASH_OUT,30736,Joséphine Gros,124146,93410,Agence_mtn_Abomey,300000,269264,2022-09-24
CASH_IN,22440,Agence_mtn_Abomey,300000,277560,Joséphine Gros,93410,115850,2022-09-24
CASH_OUT,793,Joséphine Gros,115850,115057,Agence_mtn_Cotonou,300000,299207,2022-09-25
TRANSFER,48070,Marine Chauvet-Potier,48522,452,Joséphine Gros,115057,163127,2022-09-26
CASH_IN,74984,Agence_mtn_Ouidah,300000,225016,Jean Benard,235205,310189,2022-09-01
CASH_IN,125287,Agence_mtn_Abomey,300000,174713,Jean Benard,310189,435476,2022-09-03
CASH_OUT,238423,Jean Benard,435476,197053,Agence_mtn_Ouidah,300000,61577,2022-09-03
CASH_OUT,107531,Jean Benard,197053,89522,Agence_mtn_Ouidah,300000,192469,2022-09-05
CASH_OUT,77183,Jean Benard,89522,12339,Agence_mtn_Abomey,300000,222817,2022-09-05
CASH_OUT,10278,Jean Benard,12339,2061,Agence_mtn_Abomey,300000,289722,2022-09-06
CASH_IN,107563,Agence_mtn_Cotonou,300000,192437,Jean Benard,2061,109624,2022-09-06
CASH_OUT,53222,Jean Benard,109624,56402,Agence_mtn_Ouidah,300000,246778,2022-09-07
TRANSFER,39032,Jean Benard,56402,17370,Inès Hamon,893101,854069,2022-09-08
TRANSFER,5607,Jean Benard,17370,11763,Alfred du Lesage,497100,491493,2022-09-09
CASH_OUT,9293,Jean Benard,11763,2470,Agence_mtn_Cotonou,300000,290707,2022-09-09
CASH_OUT,1002,Jean Benard,2470,1468,Agence_mtn_Abomey,300000,298998,2022-09-11
CASH_IN,167309,Agence_mtn_Ouidah,300000,132691,Jean Benard,1468,168777,2022-09-11
TRANSFER,374405,Alfred du Lesage,491493,117088,Jean Benard,168777,543182,2022-09-12
TRANSFER,43059,Jean Benard,543182,500123,Jeanne Garnier,383736,340677,2022-09-14
CASH_OUT,398922,Jean Benard,500123,101201,Agence_mtn_Abomey,300000,-98922,2022-09-14
TRANSFER,36894,Jean Benard,101201,64307,Pierre Reynaud,63889,26995,2022-09-16
CASH_IN,1196,Agence_mtn_Ouidah,300000,298804,Jean Benard,64307,65503,2022-09-17
CASH_IN,29834,Agence_mtn_Abomey,300000,270166,Jean Benard,65503,95337,2022-09-17
TRANSFER,294662,Marcelle Paris,312469,17807,Jean Benard,95337,389999,2022-09-18
TRANSFER,221785,Jean Benard,389999,168214,Jean Benard,389999,168214,2022-09-20
CASH_IN,165056,Agence_mtn_Abomey,300000,134944,Jean Benard,168214,333270,2022-09-22
CASH_OUT,228097,Jean Benard,333270,105173,Agence_mtn_Abomey,300000,71903,2022-09-22
CASH_IN,155082,Agence_mtn_Cotonou,300000,144918,Jean Benard,105173,260255,2022-09-23
CASH_IN,163877,Agence_mtn_Ouidah,300000,136123,Jean Benard,260255,424132,2022-09-23
CASH_IN,62642,Agence_mtn_Ouidah,300000,237358,Jean Benard,424132,486774,2022-09-24
CASH_OUT,30378,Jean Benard,486774,456396,Agence_mtn_Abomey,300000,269622,2022-09-24
CASH_IN,113686,Agence_mtn_Ouidah,300000,186314,Jean Benard,456396,570082,2022-09-24
CASH_IN,137720,Agence_mtn_Abomey,300000,162280,Jean Benard,570082,707802,2022-09-27
TRANSFER,6723,Cécile Germain,108857,102134,Léon Lecoq,97939,104662,2022-09-03
CASH_OUT,3855,Léon Lecoq,104662,100807,Agence_mtn_Abomey,300000,296145,2022-09-03
CASH_IN,106711,Agence_mtn_Ouidah,300000,193289,Léon Lecoq,100807,207518,2022-09-03
CASH_IN,299985,Agence_mtn_Cotonou,300000,15,Léon Lecoq,207518,507503,2022-09-04
TRANSFER,425927,Léon Lecoq,507503,81576,Alfred du Lesage,117088,-308839,2022-09-06
TRANSFER,61783,Nathalie Peron,202604,140821,Léon Lecoq,81576,143359,2022-09-06
CASH_IN,46646,Agence_mtn_Ouidah,300000,253354,Léon Lecoq,143359,190005,2022-09-10
TRANSFER,477913,Honoré du Laurent,531575,53662,Léon Lecoq,190005,667918,2022-09-11
CASH_IN,230566,Agence_mtn_Abomey,300000,69434,Léon Lecoq,667918,898484,2022-09-13
TRANSFER,225162,Jeanne Garnier,340677,115515,Léon Lecoq,898484,1123646,2022-09-14
CASH_OUT,777737,Léon Lecoq,1123646,345909,Agence_mtn_Ouidah,300000,-477737,2022-09-15
CASH_IN,210276,Agence_mtn_Abomey,300000,89724,Léon Lecoq,345909,556185,2022-09-16
CASH_IN,113081,Agence_mtn_Cotonou,300000,186919,Léon Lecoq,556185,669266,2022-09-17
CASH_OUT,228125,Léon Lecoq,669266,441141,Agence_mtn_Abomey,300000,71875,2022-09-17
TRANSFER,163463,Léon Lecoq,441141,277678,Pierre Reynaud,26995,-136468,2022-09-17
CASH_OUT,143359,Léon Lecoq,277678,134319,Agence_mtn_Ouidah,300000,156641,2022-09-18
CASH_OUT,77375,Léon Lecoq,134319,56944,Agence_mtn_Abomey,300000,222625,2022-09-20
CASH_IN,49637,Agence_mtn_Cotonou,300000,250363,Léon Lecoq,56944,106581,2022-09-21
TRANSFER,504468,Caroline-Lorraine Humbert,506759,2291,Léon Lecoq,106581,611049,2022-09-24
CASH_OUT,377771,Léon Lecoq,611049,233278,Agence_mtn_Abomey,300000,-77771,2022-09-24
CASH_IN,273973,Agence_mtn_Abomey,300000,26027,Léon Lecoq,233278,507251,2022-09-25
TRANSFER,332026,Sophie Lévêque,1394385,1062359,Léon Lecoq,507251,839277,2022-09-25
CASH_OUT,673668,Léon Lecoq,839277,165609,Agence_mtn_Ouidah,300000,-373668,2022-09-26
CASH_IN,168501,Agence_mtn_Abomey,300000,131499,Léon Lecoq,165609,334110,2022-09-27
CASH_IN,17208,Agence_mtn_Ouidah,300000,282792,Gilbert Foucher,-181032,-163824,2022-09-02
CASH_IN,44112,Agence_mtn_Ouidah,300000,255888,Gilbert Foucher,-163824,-119712,2022-09-03
CASH_IN,60378,Agence_mtn_Ouidah,300000,239622,Gilbert Foucher,-119712,-59334,2022-09-04
CASH_IN,174499,Agence_mtn_Ouidah,300000,125501,Gilbert Foucher,-59334,115165,2022-09-05
TRANSFER,58246,Gilbert Foucher,115165,56919,Nath Bruneau,576216,517970,2022-09-05
CASH_OUT,16901,Gilbert Foucher,56919,40018,Agence_mtn_Abomey,300000,283099,2022-09-05
CASH_OUT,20924,Gilbert Foucher,40018,19094,Agence_mtn_Abomey,300000,279076,2022-09-06
CASH_OUT,5472,Gilbert Foucher,19094,13622,Agence_mtn_Cotonou,300000,294528,2022-09-06
CASH_OUT,10744,Gilbert Foucher,13622,2878,Agence_mtn_Ouidah,300000,289256,2022-09-07
TRANSFER,6647,Bertrand Charles,338305,331658,Gilbert Foucher,2878,9525,2022-09-07
CASH_OUT,3351,Gilbert Foucher,9525,6174,Agence_mtn_Abomey,300000,296649,2022-09-09
CASH_IN,269865,Agence_mtn_Cotonou,300000,30135,Gilbert Foucher,6174,276039,2022-09-12
TRANSFER,12347,Gilbert Foucher,276039,263692,Gilbert Foucher,276039,263692,2022-09-13
TRANSFER,179034,Gilbert Foucher,263692,84658,David du Blondel,1587702,1408668,2022-09-13
CASH_OUT,81353,Gilbert Foucher,84658,3305,Agence_mtn_Abomey,300000,218647,2022-09-13
TRANSFER,830595,Emmanuelle Georges,902535,71940,Gilbert Foucher,3305,833900,2022-09-15
TRANSFER,458797,Gilbert Foucher,833900,375103,Roland Garcia,110150,-348647,2022-09-15
TRANSFER,295207,Gilbert Foucher,375103,79896,Alphonse Leclercq-Rousseau,229400,-65807,2022-09-18
CASH_IN,138265,Agence_mtn_Ouidah,300000,161735,Gilbert Foucher,79896,218161,2022-09-18
CASH_IN,272722,Agence_mtn_Ouidah,300000,27278,Gilbert Foucher,218161,490883,2022-09-19
CASH_IN,259443,Agence_mtn_Cotonou,300000,40557,Gilbert Foucher,490883,750326,2022-09-19
TRANSFER,603998,Gilbert Foucher,750326,146328,Antoinette Bertrand,2363,-601635,2022-09-19
TRANSFER,125285,Tristan Thomas,332004,206719,Gilbert Foucher,146328,271613,2022-09-19
CASH_IN,139961,Agence_mtn_Ouidah,300000,160039,Alphonse Leclercq-Rousseau,-65807,74154,2022-09-01
CASH_IN,263221,Agence_mtn_Abomey,300000,36779,Alphonse Leclercq-Rousseau,74154,337375,2022-09-05
CASH_OUT,31219,Alphonse Leclercq-Rousseau,337375,306156,Agence_mtn_Ouidah,300000,268781,2022-09-08
CASH_IN,200757,Agence_mtn_Abomey,300000,99243,Alphonse Leclercq-Rousseau,306156,506913,2022-09-08
TRANSFER,4371,Gilbert-Charles Thibault,42893,38522,Alphonse Leclercq-Rousseau,506913,511284,2022-09-09
CASH_OUT,10047,Alphonse Leclercq-Rousseau,511284,501237,Agence_mtn_Abomey,300000,289953,2022-09-10
TRANSFER,240249,Nath Bruneau,517970,277721,Alphonse Leclercq-Rousseau,501237,741486,2022-09-11
TRANSFER,715047,Alphonse Leclercq-Rousseau,741486,26439,Tristan Thomas,206719,-508328,2022-09-13
TRANSFER,10936,Alphonse Leclercq-Rousseau,26439,15503,Inès Hamon,854069,843133,2022-09-14
CASH_OUT,4576,Alphonse Leclercq-Rousseau,15503,10927,Agence_mtn_Ouidah,300000,295424,2022-09-15
TRANSFER,1801,Alphonse Leclercq-Rousseau,10927,9126,Cécile Germain,102134,100333,2022-09-17
TRANSFER,6652,Alphonse Leclercq-Rousseau,9126,2474,Xavier Leblanc-Ferreira,1282500,1275848,2022-09-17
CASH_OUT,2250,Alphonse Leclercq-Rousseau,2474,224,Agence_mtn_Cotonou,300000,297750,2022-09-18
TRANSFER,18925,Cécile Clerc,50204,31279,Alphonse Leclercq-Rousseau,224,19149,2022-09-20
CASH_IN,215570,Agence_mtn_Abomey,300000,84430,Alphonse Leclercq-Rousseau,19149,234719,2022-09-20
CASH_IN,173867,Agence_mtn_Abomey,300000,126133,Alphonse Leclercq-Rousseau,234719,408586,2022-09-21
CASH_IN,290903,Agence_mtn_Abomey,300000,9097,Alphonse Leclercq-Rousseau,408586,699489,2022-09-22
CASH_OUT,615415,Alphonse Leclercq-Rousseau,699489,84074,Agence_mtn_Abomey,300000,-315415,2022-09-22
TRANSFER,550860,Valérie Dijoux,715741,164881,Alphonse Leclercq-Rousseau,84074,634934,2022-09-23
CASH_IN,254939,Agence_mtn_Cotonou,300000,45061,Alphonse Leclercq-Rousseau,634934,889873,2022-09-24
CASH_IN,5305,Agence_mtn_Cotonou,300000,294695,Alphonse Leclercq-Rousseau,889873,895178,2022-09-26
CASH_IN,286957,Agence_mtn_Ouidah,300000,13043,Alphonse Leclercq-Rousseau,895178,1182135,2022-09-27
CASH_OUT,1029683,Xavier Leblanc-Ferreira,1275848,246165,Agence_mtn_Abomey,300000,-729683,2022-09-04
TRANSFER,135552,Xavier Leblanc-Ferreira,246165,110613,Valentine Richard-Bourdon,576219,440667,2022-09-04
CASH_IN,73394,Agence_mtn_Ouidah,300000,226606,Xavier Leblanc-Ferreira,110613,184007,2022-09-04
TRANSFER,140364,Antoine Leleu,162697,22333,Xavier Leblanc-Ferreira,184007,324371,2022-09-09
CASH_IN,214620,Agence_mtn_Cotonou,300000,85380,Xavier Leblanc-Ferreira,324371,538991,2022-09-10
CASH_OUT,210210,Xavier Leblanc-Ferreira,538991,328781,Agence_mtn_Abomey,300000,89790,2022-09-10
CASH_IN,238280,Agence_mtn_Ouidah,300000,61720,Xavier Leblanc-Ferreira,328781,567061,2022-09-11
CASH_OUT,458260,Xavier Leblanc-Ferreira,567061,108801,Agence_mtn_Cotonou,300000,-158260,2022-09-13
CASH_IN,133672,Agence_mtn_Ouidah,300000,166328,Xavier Leblanc-Ferreira,108801,242473,2022-09-13
CASH_IN,84101,Agence_mtn_Ouidah,300000,215899,Xavier Leblanc-Ferreira,242473,326574,2022-09-15
CASH_IN,235650,Agence_mtn_Ouidah,300000,64350,Xavier Leblanc-Ferreira,326574,562224,2022-09-17
CASH_OUT,413665,Xavier Leblanc-Ferreira,562224,148559,Agence_mtn_Cotonou,300000,-113665,2022-09-17
CASH_IN,173735,Agence_mtn_Abomey,300000,126265,Xavier Leblanc-Ferreira,148559,322294,2022-09-20
TRANSFER,29315,Jeanne Garnier,115515,86200,Xavier Leblanc-Ferreira,322294,351609,2022-09-20
TRANSFER,172782,Thibault Moreno,595679,422897,Xavier Leblanc-Ferreira,351609,524391,2022-09-21
CASH_IN,55104,Agence_mtn_Ouidah,300000,244896,Xavier Leblanc-Ferreira,524391,579495,2022-09-24
CASH_IN,50168,Agence_mtn_Cotonou,300000,249832,Xavier Leblanc-Ferreira,579495,629663,2022-09-27
CASH_OUT,19577,Honoré du Laurent,53662,34085,Agence_mtn_Ouidah,300000,280423,2022-09-01
CASH_OUT,25005,Honoré du Laurent,34085,9080,Agence_mtn_Ouidah,300000,274995,2022-09-02
CASH_OUT,7859,Honoré du Laurent,9080,1221,Agence_mtn_Ouidah,300000,292141,2022-09-05
TRANSFER,1059,Honoré du Laurent,1221,162,Marine Chauvet-Potier,452,-607,2022-09-06
CASH_OUT,102,Honoré du Laurent,162,60,Agence_mtn_Abomey,300000,299898,2022-09-06
CASH_IN,198761,Agence_mtn_Cotonou,300000,101239,Honoré du Laurent,60,198821,2022-09-06
CASH_OUT,59034,Honoré du Laurent,198821,139787,Agence_mtn_Cotonou,300000,240966,2022-09-08
TRANSFER,68438,Cécile Germain,100333,31895,Honoré du Laurent,139787,208225,2022-09-11
CASH_OUT,95897,Honoré du Laurent,208225,112328,Agence_mtn_Ouidah,300000,204103,2022-09-14
CASH_OUT,56403,Honoré du Laurent,112328,55925,Agence_mtn_Cotonou,300000,243597,2022-09-15
CASH_IN,251329,Agence_mtn_Abomey,300000,48671,Honoré du Laurent,55925,307254,2022-09-15
CASH_OUT,91538,Honoré du Laurent,307254,215716,Agence_mtn_Abomey,300000,208462,2022-09-16
CASH_OUT,111511,Honoré du Laurent,215716,104205,Agence_mtn_Abomey,300000,188489,2022-09-16
CASH_IN,50360,Agence_mtn_Ouidah,300000,249640,Honoré du Laurent,104205,154565,2022-09-17
TRANSFER,20921,Antoine Leleu,22333,1412,Honoré du Laurent,154565,175486,2022-09-20
CASH_OUT,122863,Honoré du Laurent,175486,52623,Agence_mtn_Abomey,300000,177137,2022-09-21
CASH_OUT,3660,Honoré du Laurent,52623,48963,Agence_mtn_Cotonou,300000,296340,2022-09-24
CASH_IN,239678,Agence_mtn_Cotonou,300000,60322,Honoré du Laurent,48963,288641,2022-09-27
TRANSFER,131560,Honoré du Laurent,288641,157081,Marcelle Paris,17807,-113753,2022-09-27
CASH_IN,199427,Agence_mtn_Cotonou,300000,100573,Gabriel-Tristan Marty,-29025,170402,2022-09-02
CASH_OUT,163921,Gabriel-Tristan Marty,170402,6481,Agence_mtn_Cotonou,300000,136079,2022-09-02
CASH_OUT,1021,Gabriel-Tristan Marty,6481,5460,Agence_mtn_Abomey,300000,298979,2022-09-03
TRANSFER,1837,Gabriel-Tristan Marty,5460,3623,Louis Pichon,633164,631327,2022-09-03
CASH_IN,230376,Agence_mtn_Cotonou,300000,69624,Gabriel-Tristan Marty,3623,233999,2022-09-04
CASH_IN,220219,Agence_mtn_Cotonou,300000,79781,Gabriel-Tristan Marty,233999,454218,2022-09-05
TRANSFER,6359,Claude Foucher,357575,351216,Gabriel-Tristan Marty,454218,460577,2022-09-06
CASH_OUT,384768,Gabriel-Tristan Marty,460577,75809,Agence_mtn_Abomey,300000,-84768,2022-09-08
CASH_OUT,42427,Gabriel-Tristan Marty,75809,33382,Agence_mtn_Abomey,300000,257573,2022-09-10
CASH_OUT,26390,Gabriel-Tristan Marty,33382,6992,Agence_mtn_Abomey,300000,273610,2022-09-14
TRANSFER,896840,Catherine Faivre,1252243,355403,Gabriel-Tristan Marty,6992,903832,2022-09-15
CASH_OUT,265828,Gabriel-Tristan Marty,903832,638004,Agence_mtn_Abomey,300000,34172,2022-09-15
CASH_OUT,15331,Gabriel-Tristan Marty,638004,622673,Agence_mtn_Ouidah,300000,284669,2022-09-18
TRANSFER,223208,Gabriel-Tristan Marty,622673,399465,Michelle Lebon,152135,-71073,2022-09-18
TRANSFER,123748,Gabriel-Tristan Marty,399465,275717,Jeanne Garnier,86200,-37548,2022-09-21
CASH_IN,182105,Agence_mtn_Cotonou,300000,117895,Gabriel-Tristan Marty,275717,457822,2022-09-22
CASH_OUT,434970,Gabriel-Tristan Marty,457822,22852,Agence_mtn_Abomey,300000,-134970,2022-09-23
TRANSFER,2312,Geneviève De Oliveira-Michel,3038,726,Bertrand Charles,331658,329346,2022-09-01
CASH_IN,71281,Agence_mtn_Abomey,300000,228719,Geneviève De Oliveira-Michel,726,72007,2022-09-01
CASH_IN,41199,Agence_mtn_Ouidah,300000,258801,Geneviève De Oliveira-Michel,72007,113206,2022-09-02
CASH_OUT,53546,Geneviève De Oliveira-Michel,113206,59660,Agence_mtn_Ouidah,300000,246454,2022-09-03
TRANSFER,15849,Geneviève De Oliveira-Michel,59660,43811,Louis Pichon,631327,615478,2022-09-06
CASH_IN,81628,Agence_mtn_Abomey,300000,218372,Geneviève De Oliveira-Michel,43811,125439,2022-09-07
TRANSFER,135782,Bertrand Charles,329346,193564,Geneviève De Oliveira-Michel,125439,261221,2022-09-11
TRANSFER,156427,Geneviève De Oliveira-Michel,261221,104794,David du Blondel,1408668,1252241,2022-09-12
CASH_OUT,64460,Geneviève De Oliveira-Michel,104794,40334,Agence_mtn_Abomey,300000,235540,2022-09-15
CASH_OUT,35622,Geneviève De Oliveira-Michel,40334,4712,Agence_mtn_Cotonou,300000,264378,2022-09-19
CASH_IN,135249,Agence_mtn_Cotonou,300000,164751,Geneviève De Oliveira-Michel,4712,139961,2022-09-19
CASH_OUT,90490,Geneviève De Oliveira-Michel,139961,49471,Agence_mtn_Cotonou,300000,209510,2022-09-20
CASH_OUT,34200,Geneviève De Oliveira-Michel,49471,15271,Agence_mtn_Abomey,300000,265800,2022-09-21
CASH_OUT,3520,Geneviève De Oliveira-Michel,15271,11751,Agence_mtn_Ouidah,300000,296480,2022-09-24
TRANSFER,41889,Claude Foucher,351216,309327,Geneviève De Oliveira-Michel,11751,53640,2022-09-24
TRANSFER,100107,Victoire-Nicole Lopez,141077,40970,Geneviève De Oliveira-Michel,53640,153747,2022-09-24
CASH_IN,78730,Agence_mtn_Cotonou,300000,221270,Simone Pineau,-710415,-631685,2022-09-03
CASH_IN,221183,Agence_mtn_Abomey,300000,78817,Simone Pineau,-631685,-410502,2022-09-03
CASH_IN,63725,Agence_mtn_Abomey,300000,236275,Simone Pineau,-410502,-346777,2022-09-03
CASH_IN,100008,Agence_mtn_Cotonou,300000,199992,Simone Pineau,-346777,-246769,2022-09-06
CASH_IN,185251,Agence_mtn_Abomey,300000,114749,Simone Pineau,-246769,-61518,2022-09-08
CASH_IN,263069,Agence_mtn_Ouidah,300000,36931,Simone Pineau,-61518,201551,2022-09-11
CASH_IN,176570,Agence_mtn_Ouidah,300000,123430,Simone Pineau,201551,378121,2022-09-13
TRANSFER,1697,Simone Pineau,378121,376424,Nath Bruneau,277721,276024,2022-09-14
CASH_OUT,222939,Simone Pineau,376424,153485,Agence_mtn_Ouidah,300000,77061,2022-09-15
CASH_IN,275076,Agence_mtn_Cotonou,300000,24924,Simone Pineau,153485,428561,2022-09-15
TRANSFER,158025,Simone Pineau,428561,270536,Simone Pineau,428561,586586,2022-09-22
TRANSFER,12562,Benjamin Evrard-Marty,107088,94526,Simone Pineau,270536,283098,2022-09-24
TRANSFER,145310,Simone Pineau,283098,137788,Alexandrie Delmas,498798,353488,2022-09-24
CASH_OUT,92369,Simone Pineau,137788,45419,Agence_mtn_Ouidah,300000,207631,2022-09-24
CASH_OUT,29248,Simone Pineau,45419,16171,Agence_mtn_Abomey,300000,270752,2022-09-25
CASH_OUT,5902,Simone Pineau,16171,10269,Agence_mtn_Abomey,300000,294098,2022-09-27
CASH_OUT,8786,Simone Pineau,10269,1483,Agence_mtn_Cotonou,300000,291214,2022-09-27
CASH_OUT,491497,Sophie Lévêque,1062359,570862,Agence_mtn_Ouidah,300000,-191497,2022-09-01
CASH_IN,168403,Agence_mtn_Ouidah,300000,131597,Sophie Lévêque,570862,739265,2022-09-02
TRANSFER,127592,Nathalie Peron,140821,13229,Sophie Lévêque,739265,866857,2022-09-03
CASH_OUT,149108,Sophie Lévêque,866857,717749,Agence_mtn_Cotonou,300000,150892,2022-09-04
CASH_OUT,610083,Sophie Lévêque,717749,107666,Agence_mtn_Ouidah,300000,-310083,2022-09-09
TRANSFER,411650,David du Blondel,1252241,840591,Sophie Lévêque,107666,519316,2022-09-10
TRANSFER,500044,Sophie Lévêque,519316,19272,Caroline-Lorraine Humbert,2291,-497753,2022-09-14
TRANSFER,3037,Sophie Lévêque,19272,16235,Antoine Leleu,1412,-1625,2022-09-17
TRANSFER,13758,Sophie Lévêque,16235,2477,Sophie Lévêque,16235,29993,2022-09-19
CASH_IN,178011,Agence_mtn_Ouidah,300000,121989,Sophie Lévêque,2477,180488,2022-09-19
CASH_IN,12853,Agence_mtn_Cotonou,300000,287147,Sophie Lévêque,180488,193341,2022-09-22
CASH_IN,258728,Agence_mtn_Ouidah,300000,41272,Sophie Lévêque,193341,452069,2022-09-25
CASH_OUT,55577,Emmanuelle Georges,71940,16363,Agence_mtn_Cotonou,300000,244423,2022-09-02
TRANSFER,195533,Claude Foucher,309327,113794,Emmanuelle Georges,16363,211896,2022-09-02
CASH_IN,175383,Agence_mtn_Ouidah,300000,124617,Emmanuelle Georges,211896,387279,2022-09-03
TRANSFER,143594,Nath Bruneau,276024,132430,Emmanuelle Georges,387279,530873,2022-09-04
CASH_IN,74387,Agence_mtn_Ouidah,300000,225613,Emmanuelle Georges,530873,605260,2022-09-04
CASH_OUT,144376,Emmanuelle Georges,605260,460884,Agence_mtn_Cotonou,300000,155624,2022-09-06
TRANSFER,311618,Emmanuelle Georges,460884,149266,Emmanuelle Georges,460884,149266,2022-09-09
CASH_OUT,60174,Emmanuelle Georges,149266,89092,Agence_mtn_Ouidah,300000,239826,2022-09-11
CASH_IN,246016,Agence_mtn_Abomey,300000,53984,Emmanuelle Georges,89092,335108,2022-09-17
CASH_IN,280369,Agence_mtn_Abomey,300000,19631,Emmanuelle Georges,335108,615477,2022-09-17
TRANSFER,153605,Valérie Dijoux,164881,11276,Emmanuelle Georges,615477,769082,2022-09-21
CASH_OUT,522890,Emmanuelle Georges,769082,246192,Agence_mtn_Cotonou,300000,-222890,2022-09-22
CASH_OUT,175351,Emmanuelle Georges,246192,70841,Agence_mtn_Cotonou,300000,124649,2022-09-23
CASH_IN,226001,Agence_mtn_Ouidah,300000,73999,Emmanuelle Georges,70841,296842,2022-09-24
TRANSFER,4498,Emmanuelle Georges,296842,292344,Philippine Courtois,146564,142066,2022-09-24
TRANSFER,75909,Emmanuelle Georges,292344,216435,Emmanuelle Georges,292344,216435,2022-09-25
CASH_IN,47432,Agence_mtn_Abomey,300000,252568,Emmanuelle Georges,216435,263867,2022-09-25
TRANSFER,134145,Emmanuelle Georges,263867,129722,Thibault Moreno,422897,288752,2022-09-26
TRANSFER,377880,David du Blondel,840591,462711,Emmanuelle Georges,129722,507602,2022-09-26
TRANSFER,432519,Emmanuelle Georges,507602,75083,Thibault Moreno,288752,-143767,2022-09-26
CASH_OUT,21181,Cécile Clerc,31279,10098,Agence_mtn_Ouidah,300000,278819,2022-09-01
TRANSFER,93245,Bertrand Charles,193564,100319,Cécile Clerc,10098,103343,2022-09-03
TRANSFER,84084,Cécile Clerc,103343,19259,Valentine Richard-Bourdon,440667,356583,2022-09-10
CASH_OUT,7683,Cécile Clerc,19259,11576,Agence_mtn_Abomey,300000,292317,2022-09-10
TRANSFER,5954,Cécile Clerc,11576,5622,Thierry Delattre-Simon,309634,303680,2022-09-11
TRANSFER,85493,Benjamin Evrard-Marty,94526,9033,Cécile Clerc,5622,91115,2022-09-12
TRANSFER,53146,David du Blondel,462711,409565,Cécile Clerc,91115,144261,2022-09-19
TRANSFER,37068,Cécile Clerc,144261,107193,Nath Bruneau,132430,95362,2022-09-21
TRANSFER,51867,Cécile Clerc,107193,55326,David du Blondel,409565,357698,2022-09-22
TRANSFER,158911,Valentine Richard-Bourdon,356583,197672,Cécile Clerc,55326,214237,2022-09-23
CASH_IN,259565,Agence_mtn_Abomey,300000,40435,Michelle Lebon,-71073,188492,2022-09-01
CASH_OUT,26000,Michelle Lebon,188492,162492,Agence_mtn_Abomey,300000,274000,2022-09-04
CASH_OUT,45534,Michelle Lebon,162492,116958,Agence_mtn_Abomey,300000,254466,2022-09-06
CASH_OUT,4393,Michelle Lebon,116958,112565,Agence_mtn_Abomey,300000,295607,2022-09-06
CASH_IN,159768,Agence_mtn_Cotonou,300000,140232,Michelle Lebon,112565,272333,2022-09-10
TRANSFER,95198,Michelle Lebon,272333,177135,Inès Hamon,843133,747935,2022-09-13
TRANSFER,154137,Michelle Lebon,177135,22998,Cécile Germain,31895,-122242,2022-09-17
TRANSFER,101041,Claude Foucher,113794,12753,Michelle Lebon,22998,124039,2022-09-20
CASH_OUT,69044,Michelle Lebon,124039,54995,Agence_mtn_Cotonou,300000,230956,2022-09-23
CASH_OUT,51871,Michelle Lebon,54995,3124,Agence_mtn_Ouidah,300000,248129,2022-09-24
CASH_OUT,1412,Michelle Lebon,3124,1712,Agence_mtn_Abomey,300000,298588,2022-09-27
CASH_OUT,122,Michelle Lebon,1712,1590,Agence_mtn_Abomey,300000,299878,2022-09-27
TRANSFER,1335,Benjamin Evrard-Marty,9033,7698,Michelle Lebon,1590,2925,2022-09-27
CASH_IN,252111,Agence_mtn_Ouidah,300000,47889,Laurent-Bertrand Lefort,-258750,-6639,2022-09-04
CASH_IN,254427,Agence_mtn_Ouidah,300000,45573,Laurent-Bertrand Lefort,-6639,247788,2022-09-05
CASH_IN,108896,Agence_mtn_Ouidah,300000,191104,Laurent-Bertrand Lefort,247788,356684,2022-09-06
CASH_OUT,173357,Laurent-Bertrand Lefort,356684,183327,Agence_mtn_Ouidah,300000,126643,2022-09-08
TRANSFER,109261,Laurent-Bertrand Lefort,183327,74066,Catherine Faivre,355403,246142,2022-09-10
TRANSFER,324471,Inès Hamon,747935,423464,Laurent-Bertrand Lefort,74066,398537,2022-09-11
CASH_IN,33922,Agence_mtn_Ouidah,300000,266078,Laurent-Bertrand Lefort,398537,432459,2022-09-15
TRANSFER,361477,Laurent-Bertrand Lefort,432459,70982,Margot Riou du Fernandes,1055033,693556,2022-09-15
CASH_OUT,37390,Laurent-Bertrand Lefort,70982,33592,Agence_mtn_Abomey,300000,262610,2022-09-17
CASH_OUT,31369,Laurent-Bertrand Lefort,33592,2223,Agence_mtn_Cotonou,300000,268631,2022-09-18
CASH_IN,212829,Agence_mtn_Abomey,300000,87171,Laurent-Bertrand Lefort,2223,215052,2022-09-22
CASH_OUT,138892,Laurent-Bertrand Lefort,215052,76160,Agence_mtn_Ouidah,300000,161108,2022-09-22
CASH_IN,13006,Agence_mtn_Cotonou,300000,286994,Laurent-Bertrand Lefort,76160,89166,2022-09-24
CASH_OUT,4930,Laurent-Bertrand Lefort,89166,84236,Agence_mtn_Ouidah,300000,295070,2022-09-27
CASH_IN,217017,Agence_mtn_Abomey,300000,82983,Cécile Germain,-122242,94775,2022-09-03
CASH_OUT,27465,Cécile Germain,94775,67310,Agence_mtn_Cotonou,300000,272535,2022-09-04
CASH_OUT,26344,Cécile Germain,67310,40966,Agence_mtn_Cotonou,300000,273656,2022-09-04
CASH_IN,89007,Agence_mtn_Cotonou,300000,210993,Cécile Germain,40966,129973,2022-09-06
CASH_IN,204485,Agence_mtn_Cotonou,300000,95515,Cécile Germain,129973,334458,2022-09-07
CASH_IN,241280,Agence_mtn_Cotonou,300000,58720,Cécile Germain,334458,575738,2022-09-16
CASH_IN,182060,Agence_mtn_Cotonou,300000,117940,Cécile Germain,575738,757798,2022-09-17
TRANSFER,303139,Cécile Germain,757798,454659,Gilbert-Charles Thibault,38522,-264617,2022-09-19
TRANSFER,11939,Eugène Poulain,480234,468295,Cécile Germain,454659,466598,2022-09-23
CASH_OUT,118362,Cécile Germain,466598,348236,Agence_mtn_Abomey,300000,181638,2022-09-26
CASH_IN,239170,Agence_mtn_Cotonou,300000,60830,Cécile Germain,348236,587406,2022-09-26
CASH_IN,141862,Agence_mtn_Ouidah,300000,158138,Cécile Germain,587406,729268,2022-09-27
TRANSFER,215350,Thierry Delattre-Simon,303680,88330,Louis Pichon,615478,830828,2022-09-01
CASH_OUT,245975,Louis Pichon,830828,584853,Agence_mtn_Cotonou,300000,54025,2022-09-03
CASH_OUT,236773,Louis Pichon,584853,348080,Agence_mtn_Ouidah,300000,63227,2022-09-06
CASH_IN,269875,Agence_mtn_Abomey,300000,30125,Louis Pichon,348080,617955,2022-09-12
TRANSFER,387540,Louis Pichon,617955,230415,Alexandrie Delmas,353488,-34052,2022-09-13
CASH_OUT,130401,Louis Pichon,230415,100014,Agence_mtn_Cotonou,300000,169599,2022-09-15
CASH_OUT,28914,Louis Pichon,100014,71100,Agence_mtn_Cotonou,300000,271086,2022-09-15
CASH_IN,104494,Agence_mtn_Ouidah,300000,195506,Louis Pichon,71100,175594,2022-09-17
TRANSFER,4423,Benjamin Evrard-Marty,7698,3275,Louis Pichon,175594,180017,2022-09-18
CASH_IN,185822,Agence_mtn_Ouidah,300000,114178,Louis Pichon,180017,365839,2022-09-19
CASH_OUT,26792,Louis Pichon,365839,339047,Agence_mtn_Abomey,300000,273208,2022-09-23
CASH_OUT,232635,Louis Pichon,339047,106412,Agence_mtn_Ouidah,300000,67365,2022-09-25
TRANSFER,72150,Louis Pichon,106412,34262,Benjamin Evrard-Marty,3275,-68875,2022-09-26
CASH_OUT,24580,Louis Pichon,34262,9682,Agence_mtn_Ouidah,300000,275420,2022-09-26
CASH_OUT,4106,Louis Pichon,9682,5576,Agence_mtn_Ouidah,300000,295894,2022-09-27
CASH_OUT,313304,Inès Hamon,423464,110160,Agence_mtn_Abomey,300000,-13304,2022-09-04
CASH_OUT,97576,Inès Hamon,110160,12584,Agence_mtn_Cotonou,300000,202424,2022-09-05
CASH_OUT,170,Inès Hamon,12584,12414,Agence_mtn_Ouidah,300000,299830,2022-09-09
TRANSFER,9503,Inès Hamon,12414,2911,Inès Hamon,12414,2911,2022-09-12
TRANSFER,1049,Inès Hamon,2911,1862,Catherine Faivre,246142,245093,2022-09-17
CASH_IN,296241,Agence_mtn_Cotonou,300000,3759,Inès Hamon,1862,298103,2022-09-22
CASH_IN,283649,Agence_mtn_Cotonou,300000,16351,Inès Hamon,298103,581752,2022-09-24
TRANSFER,169714,Inès Hamon,581752,412038,Catherine Faivre,245093,75379,2022-09-25
CASH_OUT,196930,Inès Hamon,412038,215108,Agence_mtn_Abomey,300000,103070,2022-09-25
CASH_IN,233333,Agence_mtn_Abomey,300000,66667,Inès Hamon,215108,448441,2022-09-26
CASH_OUT,300186,Inès Hamon,448441,148255,Agence_mtn_Cotonou,300000,-186,2022-09-27
CASH_OUT,2139,Thierry Delattre-Simon,88330,86191,Agence_mtn_Cotonou,300000,297861,2022-09-02
CASH_IN,143254,Agence_mtn_Abomey,300000,156746,Thierry Delattre-Simon,86191,229445,2022-09-02
CASH_IN,193983,Agence_mtn_Abomey,300000,106017,Thierry Delattre-Simon,229445,423428,2022-09-02
CASH_OUT,73145,Thierry Delattre-Simon,423428,350283,Agence_mtn_Ouidah,300000,226855,2022-09-05
TRANSFER,30825,Nath Bruneau,95362,64537,Thierry Delattre-Simon,350283,381108,2022-09-05
TRANSFER,227712,Thierry Delattre-Simon,381108,153396,Nathalie Peron,13229,-214483,2022-09-10
CASH_OUT,7256,Thierry Delattre-Simon,153396,146140,Agence_mtn_Abomey,300000,292744,2022-09-11
CASH_OUT,80822,Thierry Delattre-Simon,146140,65318,Agence_mtn_Ouidah,300000,219178,2022-09-15
CASH_IN,193078,Agence_mtn_Abomey,300000,106922,Thierry Delattre-Simon,65318,258396,2022-09-20
TRANSFER,212068,Thierry Delattre-Simon,258396,46328,Valérie Dijoux,11276,-200792,2022-09-20
TRANSFER,54319,Bertrand Charles,100319,46000,Thierry Delattre-Simon,46328,100647,2022-09-20
CASH_IN,287789,Agence_mtn_Ouidah,300000,12211,Thierry Delattre-Simon,100647,388436,2022-09-20
TRANSFER,91946,Thierry Delattre-Simon,388436,296490,Bertrand Charles,46000,-45946,2022-09-22
CASH_OUT,22521,Thierry Delattre-Simon,296490,273969,Agence_mtn_Ouidah,300000,277479,2022-09-26
CASH_OUT,192363,Thierry Delattre-Simon,273969,81606,Agence_mtn_Cotonou,300000,107637,2022-09-26
CASH_IN,241857,Agence_mtn_Abomey,300000,58143,Valentine Martinez,-668604,-426747,2022-09-01
CASH_IN,139774,Agence_mtn_Ouidah,300000,160226,Valentine Martinez,-426747,-286973,2022-09-04
CASH_IN,201809,Agence_mtn_Abomey,300000,98191,Valentine Martinez,-286973,-85164,2022-09-17
CASH_IN,190831,Agence_mtn_Abomey,300000,109169,Valentine Martinez,-85164,105667,2022-09-20
CASH_OUT,4217,Valentine Martinez,105667,101450,Agence_mtn_Cotonou,300000,295783,2022-09-21
CASH_OUT,14075,Valentine Martinez,101450,87375,Agence_mtn_Cotonou,300000,285925,2022-09-23
TRANSFER,2777,Catherine Faivre,75379,72602,Valentine Martinez,87375,90152,2022-09-23
CASH_IN,175527,Agence_mtn_Ouidah,300000,124473,Valentine Martinez,90152,265679,2022-09-25
TRANSFER,309420,Eugène Poulain,468295,158875,Valentine Martinez,265679,575099,2022-09-26
CASH_IN,245393,Agence_mtn_Cotonou,300000,54607,Céline Gomez,-115792,129601,2022-09-02
CASH_IN,221419,Agence_mtn_Cotonou,300000,78581,Céline Gomez,129601,351020,2022-09-03
TRANSFER,40694,Philippine Courtois,142066,101372,Céline Gomez,351020,391714,2022-09-05
CASH_IN,44429,Agence_mtn_Cotonou,300000,255571,Céline Gomez,391714,436143,2022-09-06
TRANSFER,47952,Renée David,94346,46394,Céline Gomez,436143,484095,2022-09-07
CASH_OUT,282125,Céline Gomez,484095,201970,Agence_mtn_Abomey,300000,17875,2022-09-09
CASH_OUT,126133,Céline Gomez,201970,75837,Agence_mtn_Cotonou,300000,173867,2022-09-10
TRANSFER,61491,Céline Gomez,75837,14346,Philippine Courtois,101372,39881,2022-09-12
TRANSFER,8823,Renée David,46394,37571,Céline Gomez,14346,23169,2022-09-13
TRANSFER,172367,Valentine Richard-Bourdon,197672,25305,Céline Gomez,23169,195536,2022-09-13
TRANSFER,25189,Victoire-Nicole Lopez,40970,15781,Céline Gomez,195536,220725,2022-09-15
CASH_IN,241721,Agence_mtn_Abomey,300000,58279,Céline Gomez,220725,462446,2022-09-25
CASH_OUT,211035,Céline Gomez,462446,251411,Agence_mtn_Ouidah,300000,88965,2022-09-26
TRANSFER,158921,Céline Gomez,251411,92490,Renée David,37571,-121350,2022-09-27
CASH_IN,79036,Agence_mtn_Abomey,300000,220964,Benjamin Evrard-Marty,-68875,10161,2022-09-01
TRANSFER,5155,Benjamin Evrard-Marty,10161,5006,Catherine Faivre,72602,67447,2022-09-02
CASH_OUT,203,Benjamin Evrard-Marty,5006,4803,Agence_mtn_Abomey,300000,299797,2022-09-02
CASH_OUT,1468,Benjamin Evrard-Marty,4803,3335,Agence_mtn_Abomey,300000,298532,2022-09-03
CASH_OUT,1974,Benjamin Evrard-Marty,3335,1361,Agence_mtn_Ouidah,300000,298026,2022-09-05
CASH_IN,201933,Agence_mtn_Ouidah,300000,98067,Benjamin Evrard-Marty,1361,203294,2022-09-10
TRANSFER,23014,Valentine Richard-Bourdon,25305,2291,Benjamin Evrard-Marty,203294,226308,2022-09-14
CASH_OUT,54105,Benjamin Evrard-Marty,226308,172203,Agence_mtn_Ouidah,300000,245895,2022-09-16
TRANSFER,6673,Victoire-Nicole Lopez,15781,9108,Benjamin Evrard-Marty,172203,178876,2022-09-20
CASH_OUT,80560,Benjamin Evrard-Marty,178876,98316,Agence_mtn_Cotonou,300000,219440,2022-09-23
TRANSFER,67543,Benjamin Evrard-Marty,98316,30773,Margot Riou du Fernandes,693556,626013,2022-09-23
CASH_OUT,11896,Benjamin Evrard-Marty,30773,18877,Agence_mtn_Ouidah,300000,288104,2022-09-26
CASH_OUT,6810,Benjamin Evrard-Marty,18877,12067,Agence_mtn_Ouidah,300000,293190,2022-09-27
TRANSFER,733,Nath Bruneau,64537,63804,Benjamin Evrard-Marty,12067,12800,2022-09-27
CASH_IN,161482,Agence_mtn_Cotonou,300000,138518,Benjamin Evrard-Marty,12800,174282,2022-09-27
CASH_IN,35619,Agence_mtn_Cotonou,300000,264381,David du Blondel,357698,393317,2022-09-06
CASH_OUT,339848,David du Blondel,393317,53469,Agence_mtn_Abomey,300000,-39848,2022-09-12
CASH_IN,185118,Agence_mtn_Abomey,300000,114882,David du Blondel,53469,238587,2022-09-13
CASH_OUT,219452,David du Blondel,238587,19135,Agence_mtn_Ouidah,300000,80548,2022-09-14
TRANSFER,59731,Nath Bruneau,63804,4073,David du Blondel,19135,78866,2022-09-15
CASH_OUT,50834,David du Blondel,78866,28032,Agence_mtn_Cotonou,300000,249166,2022-09-16
CASH_IN,293869,Agence_mtn_Ouidah,300000,6131,David du Blondel,28032,321901,2022-09-17
CASH_OUT,1859,David du Blondel,321901,320042,Agence_mtn_Abomey,300000,298141,2022-09-18
CASH_OUT,179747,David du Blondel,320042,140295,Agence_mtn_Ouidah,300000,120253,2022-09-22
TRANSFER,71349,David du Blondel,140295,68946,Victoire-Nicole Lopez,9108,-62241,2022-09-23
CASH_IN,157537,Agence_mtn_Abomey,300000,142463,David du Blondel,68946,226483,2022-09-24
CASH_IN,99603,Agence_mtn_Cotonou,300000,200397,Alexandrie Delmas,-34052,65551,2022-09-01
CASH_IN,222526,Agence_mtn_Ouidah,300000,77474,Alexandrie Delmas,65551,288077,2022-09-02
TRANSFER,24158,Philippine Courtois,39881,15723,Alexandrie Delmas,288077,312235,2022-09-03
CASH_IN,275798,Agence_mtn_Cotonou,300000,24202,Alexandrie Delmas,312235,588033,2022-09-05
CASH_IN,265913,Agence_mtn_Cotonou,300000,34087,Alexandrie Delmas,588033,853946,2022-09-07
CASH_IN,12332,Agence_mtn_Abomey,300000,287668,Alexandrie Delmas,853946,866278,2022-09-08
TRANSFER,6728,Catherine Faivre,67447,60719,Alexandrie Delmas,866278,873006,2022-09-10
CASH_IN,275707,Agence_mtn_Cotonou,300000,24293,Alexandrie Delmas,873006,1148713,2022-09-10
CASH_IN,224536,Agence_mtn_Abomey,300000,75464,Alexandrie Delmas,1148713,1373249,2022-09-11
CASH_OUT,747533,Alexandrie Delmas,1373249,625716,Agence_mtn_Ouidah,300000,-447533,2022-09-12
TRANSFER,91372,Alexandrie Delmas,625716,534344,Valentine Richard-Bourdon,2291,-89081,2022-09-14
CASH_IN,68698,Agence_mtn_Abomey,300000,231302,Alexandrie Delmas,534344,603042,2022-09-20
CASH_IN,103373,Agence_mtn_Abomey,300000,196627,Alexandrie Delmas,603042,706415,2022-09-20
CASH_IN,156962,Agence_mtn_Cotonou,300000,143038,Alexandrie Delmas,706415,863377,2022-09-21
TRANSFER,57937,Catherine Faivre,60719,2782,Alexandrie Delmas,863377,921314,2022-09-23
CASH_OUT,403452,Alexandrie Delmas,921314,517862,Agence_mtn_Abomey,300000,-103452,2022-09-24
CASH_IN,233144,Agence_mtn_Abomey,300000,66856,Alexandrie Delmas,517862,751006,2022-09-25
CASH_IN,99686,Agence_mtn_Ouidah,300000,200314,Alexandrie Delmas,751006,850692,2022-09-27
CASH_IN,92393,Agence_mtn_Ouidah,300000,207607,Alexandrie Delmas,850692,943085,2022-09-27
CASH_IN,82247,Agence_mtn_Ouidah,300000,217753,Alexandrie Delmas,943085,1025332,2022-09-27
CASH_IN,16815,Agence_mtn_Abomey,300000,283185,Pierre Reynaud,-136468,-119653,2022-09-06
CASH_IN,96928,Agence_mtn_Abomey,300000,203072,Pierre Reynaud,-119653,-22725,2022-09-08
CASH_IN,225528,Agence_mtn_Ouidah,300000,74472,Pierre Reynaud,-22725,202803,2022-09-10
TRANSFER,564218,Margot Riou du Fernandes,626013,61795,Pierre Reynaud,202803,767021,2022-09-12
CASH_OUT,518798,Pierre Reynaud,767021,248223,Agence_mtn_Cotonou,300000,-218798,2022-09-13
CASH_OUT,101088,Pierre Reynaud,248223,147135,Agence_mtn_Ouidah,300000,198912,2022-09-18
CASH_OUT,124221,Pierre Reynaud,147135,22914,Agence_mtn_Cotonou,300000,175779,2022-09-19
CASH_OUT,5980,Pierre Reynaud,22914,16934,Agence_mtn_Abomey,300000,294020,2022-09-21
CASH_OUT,14141,Pierre Reynaud,16934,2793,Agence_mtn_Cotonou,300000,285859,2022-09-21
TRANSFER,1201,Pierre Reynaud,2793,1592,Catherine Faivre,2782,1581,2022-09-26
CASH_IN,109227,Agence_mtn_Abomey,300000,190773,Philippine Courtois,15723,124950,2022-09-09
CASH_IN,244939,Agence_mtn_Ouidah,300000,55061,Philippine Courtois,124950,369889,2022-09-12
CASH_IN,180815,Agence_mtn_Ouidah,300000,119185,Philippine Courtois,369889,550704,2022-09-13
TRANSFER,52235,Philippine Courtois,550704,498469,Eugène Poulain,158875,106640,2022-09-13
CASH_IN,247361,Agence_mtn_Abomey,300000,52639,Philippine Courtois,498469,745830,2022-09-16
CASH_IN,89720,Agence_mtn_Cotonou,300000,210280,Philippine Courtois,745830,835550,2022-09-16
TRANSFER,32505,Eugène Poulain,106640,74135,Philippine Courtois,835550,868055,2022-09-23
CASH_IN,297499,Agence_mtn_Cotonou,300000,2501,Antoinette Bertrand,-601635,-304136,2022-09-02
CASH_IN,129747,Agence_mtn_Ouidah,300000,170253,Antoinette Bertrand,-304136,-174389,2022-09-03
CASH_IN,199441,Agence_mtn_Cotonou,300000,100559,Antoinette Bertrand,-174389,25052,2022-09-03
CASH_IN,246098,Agence_mtn_Ouidah,300000,53902,Antoinette Bertrand,25052,271150,2022-09-05
CASH_IN,75430,Agence_mtn_Cotonou,300000,224570,Antoinette Bertrand,271150,346580,2022-09-09
CASH_OUT,194385,Antoinette Bertrand,346580,152195,Agence_mtn_Abomey,300000,105615,2022-09-10
CASH_IN,104396,Agence_mtn_Abomey,300000,195604,Antoinette Bertrand,152195,256591,2022-09-10
CASH_OUT,192337,Antoinette Bertrand,256591,64254,Agence_mtn_Abomey,300000,107663,2022-09-11
TRANSFER,47637,Antoinette Bertrand,64254,16617,Margot Riou du Fernandes,61795,14158,2022-09-13
CASH_OUT,4408,Antoinette Bertrand,16617,12209,Agence_mtn_Ouidah,300000,295592,2022-09-14
CASH_IN,230314,Agence_mtn_Ouidah,300000,69686,Antoinette Bertrand,12209,242523,2022-09-15
CASH_IN,194070,Agence_mtn_Abomey,300000,105930,Antoinette Bertrand,242523,436593,2022-09-17
CASH_IN,5839,Agence_mtn_Ouidah,300000,294161,Antoinette Bertrand,436593,442432,2022-09-18
CASH_IN,25516,Agence_mtn_Abomey,300000,274484,Antoinette Bertrand,442432,467948,2022-09-20
CASH_OUT,347140,Antoinette Bertrand,467948,120808,Agence_mtn_Abomey,300000,-47140,2022-09-20
CASH_OUT,1224,Antoinette Bertrand,120808,119584,Agence_mtn_Cotonou,300000,298776,2022-09-21
CASH_OUT,90998,Antoinette Bertrand,119584,28586,Agence_mtn_Cotonou,300000,209002,2022-09-22
CASH_OUT,7227,Antoinette Bertrand,28586,21359,Agence_mtn_Ouidah,300000,292773,2022-09-26
CASH_IN,281637,Agence_mtn_Abomey,300000,18363,Antoinette Bertrand,21359,302996,2022-09-26
TRANSFER,218301,Antoinette Bertrand,302996,84695,Eugène Poulain,74135,-144166,2022-09-26
CASH_IN,171250,Agence_mtn_Abomey,300000,128750,Victoire-Nicole Lopez,-62241,109009,2022-09-03
TRANSFER,40140,Victoire-Nicole Lopez,109009,68869,Margot Riou du Fernandes,14158,-25982,2022-09-05
TRANSFER,30371,Victoire-Nicole Lopez,68869,38498,Victoire-Nicole Lopez,68869,99240,2022-09-06
CASH_OUT,24085,Victoire-Nicole Lopez,38498,14413,Agence_mtn_Abomey,300000,275915,2022-09-08
CASH_IN,137219,Agence_mtn_Ouidah,300000,162781,Victoire-Nicole Lopez,14413,151632,2022-09-08
CASH_IN,89944,Agence_mtn_Cotonou,300000,210056,Victoire-Nicole Lopez,151632,241576,2022-09-08
CASH_IN,113040,Agence_mtn_Abomey,300000,186960,Victoire-Nicole Lopez,241576,354616,2022-09-08
CASH_OUT,318592,Victoire-Nicole Lopez,354616,36024,Agence_mtn_Ouidah,300000,-18592,2022-09-15
CASH_IN,243979,Agence_mtn_Cotonou,300000,56021,Victoire-Nicole Lopez,36024,280003,2022-09-16
CASH_OUT,242931,Victoire-Nicole Lopez,280003,37072,Agence_mtn_Abomey,300000,57069,2022-09-18
CASH_OUT,5906,Victoire-Nicole Lopez,37072,31166,Agence_mtn_Cotonou,300000,294094,2022-09-20
TRANSFER,299,Catherine Faivre,1581,1282,Victoire-Nicole Lopez,31166,31465,2022-09-22
CASH_OUT,7484,Victoire-Nicole Lopez,31465,23981,Agence_mtn_Cotonou,300000,292516,2022-09-23
TRANSFER,16199,Victoire-Nicole Lopez,23981,7782,Catherine Faivre,1282,-14917,2022-09-25
CASH_IN,95761,Agence_mtn_Abomey,300000,204239,Marine Chauvet-Potier,-607,95154,2022-09-01
CASH_OUT,52913,Marine Chauvet-Potier,95154,42241,Agence_mtn_Abomey,300000,247087,2022-09-02
CASH_IN,283801,Agence_mtn_Abomey,300000,16199,Marine Chauvet-Potier,42241,326042,2022-09-03
CASH_OUT,26620,Marine Chauvet-Potier,326042,299422,Agence_mtn_Cotonou,300000,273380,2022-09-05
CASH_OUT,196555,Marine Chauvet-Potier,299422,102867,Agence_mtn_Ouidah,300000,103445,2022-09-14
CASH_OUT,32585,Marine Chauvet-Potier,102867,70282,Agence_mtn_Abomey,300000,267415,2022-09-16
CASH_OUT,49959,Marine Chauvet-Potier,70282,20323,Agence_mtn_Cotonou,300000,250041,2022-09-19
TRANSFER,8039,Marine Chauvet-Potier,20323,12284,Marine Chauvet-Potier,20323,12284,2022-09-21
CASH_OUT,7587,Marine Chauvet-Potier,12284,4697,Agence_mtn_Cotonou,300000,292413,2022-09-23
CASH_IN,233842,Agence_mtn_Cotonou,300000,66158,Marine Chauvet-Potier,4697,238539,2022-09-23
CASH_OUT,148990,Marine Chauvet-Potier,238539,89549,Agence_mtn_Cotonou,300000,151010,2022-09-27
CASH_IN,30838,Agence_mtn_Ouidah,300000,269162,Pierre Roger,-139940,-109102,2022-09-11
CASH_IN,260306,Agence_mtn_Abomey,300000,39694,Pierre Roger,-109102,151204,2022-09-13
TRANSFER,146623,Pierre Roger,151204,4581,Pierre Roger,151204,297827,2022-09-15
CASH_IN,113326,Agence_mtn_Abomey,300000,186674,Pierre Roger,4581,117907,2022-09-19
CASH_IN,251082,Agence_mtn_Cotonou,300000,48918,Pierre Roger,117907,368989,2022-09-22
CASH_IN,195715,Agence_mtn_Cotonou,300000,104285,Pierre Roger,368989,564704,2022-09-23
CASH_IN,293270,Agence_mtn_Abomey,300000,6730,Pierre Roger,564704,857974,2022-09-27
CASH_IN,212443,Agence_mtn_Cotonou,300000,87557,Jeanne Garnier,-37548,174895,2022-09-01
TRANSFER,124686,Jeanne Garnier,174895,50209,Jeanne Garnier,174895,299581,2022-09-01
CASH_OUT,31637,Jeanne Garnier,50209,18572,Agence_mtn_Abomey,300000,268363,2022-09-02
CASH_IN,54900,Agence_mtn_Cotonou,300000,245100,Jeanne Garnier,18572,73472,2022-09-03
CASH_OUT,17021,Jeanne Garnier,73472,56451,Agence_mtn_Abomey,300000,282979,2022-09-03
CASH_IN,153518,Agence_mtn_Ouidah,300000,146482,Jeanne Garnier,56451,209969,2022-09-04
CASH_IN,25313,Agence_mtn_Ouidah,300000,274687,Jeanne Garnier,209969,235282,2022-09-04
CASH_OUT,40427,Jeanne Garnier,235282,194855,Agence_mtn_Ouidah,300000,259573,2022-09-05
TRANSFER,107847,Jeanne Garnier,194855,87008,Jeanne Garnier,194855,87008,2022-09-05
CASH_IN,110864,Agence_mtn_Abomey,300000,189136,Jeanne Garnier,87008,197872,2022-09-08
CASH_IN,129476,Agence_mtn_Cotonou,300000,170524,Jeanne Garnier,197872,327348,2022-09-08
CASH_IN,248256,Agence_mtn_Ouidah,300000,51744,Jeanne Garnier,327348,575604,2022-09-10
CASH_IN,48446,Agence_mtn_Cotonou,300000,251554,Jeanne Garnier,575604,624050,2022-09-14
CASH_IN,106646,Agence_mtn_Abomey,300000,193354,Jeanne Garnier,624050,730696,2022-09-15
CASH_IN,10806,Agence_mtn_Abomey,300000,289194,Jeanne Garnier,730696,741502,2022-09-16
CASH_OUT,337396,Jeanne Garnier,741502,404106,Agence_mtn_Cotonou,300000,-37396,2022-09-18
CASH_OUT,385563,Jeanne Garnier,404106,18543,Agence_mtn_Cotonou,300000,-85563,2022-09-24
CASH_IN,196924,Agence_mtn_Cotonou,300000,103076,Jeanne Garnier,18543,215467,2022-09-25
CASH_IN,281110,Agence_mtn_Abomey,300000,18890,Thibaut Coulon,-320465,-39355,2022-09-01
CASH_IN,261779,Agence_mtn_Ouidah,300000,38221,Thibaut Coulon,-39355,222424,2022-09-07
CASH_IN,108983,Agence_mtn_Ouidah,300000,191017,Thibaut Coulon,222424,331407,2022-09-09
TRANSFER,109213,Thibaut Coulon,331407,222194,Thibaut Coulon,331407,222194,2022-09-12
CASH_OUT,146004,Thibaut Coulon,222194,76190,Agence_mtn_Ouidah,300000,153996,2022-09-13
CASH_OUT,66739,Thibaut Coulon,76190,9451,Agence_mtn_Ouidah,300000,233261,2022-09-14
TRANSFER,7509,Thibaut Coulon,9451,1942,Thibaut Coulon,9451,16960,2022-09-15
CASH_OUT,1850,Thibaut Coulon,1942,92,Agence_mtn_Ouidah,300000,298150,2022-09-18
CASH_IN,14924,Agence_mtn_Cotonou,300000,285076,Thibaut Coulon,92,15016,2022-09-21
CASH_IN,65211,Agence_mtn_Abomey,300000,234789,Thibaut Coulon,15016,80227,2022-09-22
CASH_OUT,12862,Thibaut Coulon,80227,67365,Agence_mtn_Abomey,300000,287138,2022-09-23
CASH_IN,152595,Agence_mtn_Cotonou,300000,147405,Sébastien Lemaître,-120717,31878,2022-09-01
TRANSFER,13354,Sébastien Lemaître,31878,18524,Sébastien Lemaître,31878,45232,2022-09-03
CASH_OUT,5065,Sébastien Lemaître,18524,13459,Agence_mtn_Cotonou,300000,294935,2022-09-03
CASH_IN,253387,Agence_mtn_Abomey,300000,46613,Sébastien Lemaître,13459,266846,2022-09-08
CASH_IN,70665,Agence_mtn_Cotonou,300000,229335,Sébastien Lemaître,266846,337511,2022-09-10
CASH_IN,142667,Agence_mtn_Cotonou,300000,157333,Sébastien Lemaître,337511,480178,2022-09-13
CASH_OUT,34722,Sébastien Lemaître,480178,445456,Agence_mtn_Cotonou,300000,265278,2022-09-16
CASH_OUT,406522,Sébastien Lemaître,445456,38934,Agence_mtn_Cotonou,300000,-106522,2022-09-21
CASH_IN,24229,Agence_mtn_Abomey,300000,275771,Marcelle Charrier,-465957,-441728,2022-09-01
CASH_IN,110315,Agence_mtn_Cotonou,300000,189685,Marcelle Charrier,-441728,-331413,2022-09-05
CASH_IN,252571,Agence_mtn_Ouidah,300000,47429,Marcelle Charrier,-331413,-78842,2022-09-05
CASH_IN,70072,Agence_mtn_Ouidah,300000,229928,Marcelle Charrier,-78842,-8770,2022-09-07
CASH_IN,4049,Agence_mtn_Abomey,300000,295951,Marcelle Charrier,-8770,-4721,2022-09-08
CASH_IN,239347,Agence_mtn_Cotonou,300000,60653,Marcelle Charrier,-4721,234626,2022-09-09
TRANSFER,93037,Marcelle Charrier,234626,141589,Marcelle Charrier,234626,327663,2022-09-15
CASH_IN,293297,Agence_mtn_Abomey,300000,6703,Marcelle Charrier,141589,434886,2022-09-19
CASH_IN,199497,Agence_mtn_Cotonou,300000,100503,Marcelle Charrier,434886,634383,2022-09-20
CASH_OUT,30130,Marcelle Charrier,634383,604253,Agence_mtn_Cotonou,300000,269870,2022-09-23
CASH_IN,192051,Agence_mtn_Ouidah,300000,107949,Marcelle Charrier,604253,796304,2022-09-23
CASH_IN,5980,Agence_mtn_Cotonou,300000,294020,Valérie Dijoux,-200792,-194812,2022-09-03
CASH_IN,53599,Agence_mtn_Ouidah,300000,246401,Valérie Dijoux,-194812,-141213,2022-09-06
CASH_IN,157436,Agence_mtn_Abomey,300000,142564,Valérie Dijoux,-141213,16223,2022-09-07
CASH_IN,286229,Agence_mtn_Abomey,300000,13771,Valérie Dijoux,16223,302452,2022-09-08
CASH_OUT,299119,Valérie Dijoux,302452,3333,Agence_mtn_Abomey,300000,881,2022-09-14
TRANSFER,985,Valérie Dijoux,3333,2348,Valérie Dijoux,3333,2348,2022-09-16
CASH_OUT,806,Valérie Dijoux,2348,1542,Agence_mtn_Abomey,300000,299194,2022-09-16
TRANSFER,1124,Valérie Dijoux,1542,418,Valérie Dijoux,1542,2666,2022-09-17
CASH_OUT,300,Valérie Dijoux,418,118,Agence_mtn_Cotonou,300000,299700,2022-09-19
CASH_IN,9124,Agence_mtn_Ouidah,300000,290876,Valérie Dijoux,118,9242,2022-09-22
CASH_IN,146014,Agence_mtn_Abomey,300000,153986,Antoine Leleu,-1625,144389,2022-09-02
TRANSFER,116224,Antoine Leleu,144389,28165,Antoine Leleu,144389,260613,2022-09-03
CASH_OUT,26441,Antoine Leleu,28165,1724,Agence_mtn_Ouidah,300000,273559,2022-09-06
CASH_OUT,868,Antoine Leleu,1724,856,Agence_mtn_Ouidah,300000,299132,2022-09-14
CASH_IN,15891,Agence_mtn_Abomey,300000,284109,Antoine Leleu,856,16747,2022-09-14
CASH_OUT,11239,Antoine Leleu,16747,5508,Agence_mtn_Ouidah,300000,288761,2022-09-18
CASH_OUT,5465,Antoine Leleu,5508,43,Agence_mtn_Cotonou,300000,294535,2022-09-26
CASH_IN,274307,Agence_mtn_Ouidah,300000,25693,Adèle Labbé,-2061818,-1787511,2022-09-07
CASH_IN,145110,Agence_mtn_Cotonou,300000,154890,Adèle Labbé,-1787511,-1642401,2022-09-16
CASH_IN,241754,Agence_mtn_Abomey,300000,58246,Adèle Labbé,-1642401,-1400647,2022-09-17
CASH_IN,263555,Agence_mtn_Cotonou,300000,36445,Adèle Labbé,-1400647,-1137092,2022-09-21
CASH_IN,203691,Agence_mtn_Cotonou,300000,96309,Adèle Labbé,-1137092,-933401,2022-09-22
CASH_IN,94002,Agence_mtn_Ouidah,300000,205998,Adèle Labbé,-933401,-839399,2022-09-24
CASH_IN,183994,Agence_mtn_Ouidah,300000,116006,Nathalie Peron,-214483,-30489,2022-09-01
CASH_IN,122707,Agence_mtn_Cotonou,300000,177293,Nathalie Peron,-30489,92218,2022-09-04
TRANSFER,88137,Nathalie Peron,92218,4081,Nathalie Peron,92218,180355,2022-09-10
CASH_IN,152241,Agence_mtn_Cotonou,300000,147759,Nathalie Peron,4081,156322,2022-09-12
CASH_IN,152623,Agence_mtn_Cotonou,300000,147377,Nathalie Peron,156322,308945,2022-09-13
TRANSFER,177347,Nathalie Peron,308945,131598,Nathalie Peron,308945,131598,2022-09-15
CASH_OUT,57841,Nathalie Peron,131598,73757,Agence_mtn_Cotonou,300000,242159,2022-09-15
CASH_OUT,59922,Nathalie Peron,73757,13835,Agence_mtn_Ouidah,300000,240078,2022-09-17
CASH_OUT,7401,Nathalie Peron,13835,6434,Agence_mtn_Ouidah,300000,292599,2022-09-18
CASH_OUT,3302,Nathalie Peron,6434,3132,Agence_mtn_Cotonou,300000,296698,2022-09-19
CASH_IN,295220,Agence_mtn_Abomey,300000,4780,Nathalie Peron,3132,298352,2022-09-22
CASH_OUT,140813,Nathalie Peron,298352,157539,Agence_mtn_Abomey,300000,159187,2022-09-23
CASH_IN,132434,Agence_mtn_Cotonou,300000,167566,Nathalie Peron,157539,289973,2022-09-26
CASH_IN,21577,Agence_mtn_Abomey,300000,278423,Caroline-Lorraine Humbert,-497753,-476176,2022-09-01
CASH_IN,269592,Agence_mtn_Cotonou,300000,30408,Caroline-Lorraine Humbert,-476176,-206584,2022-09-01
CASH_IN,94905,Agence_mtn_Abomey,300000,205095,Caroline-Lorraine Humbert,-206584,-111679,2022-09-05
CASH_IN,274281,Agence_mtn_Ouidah,300000,25719,Caroline-Lorraine Humbert,-111679,162602,2022-09-08
TRANSFER,19828,Caroline-Lorraine Humbert,162602,142774,Caroline-Lorraine Humbert,162602,142774,2022-09-08
CASH_IN,52223,Agence_mtn_Abomey,300000,247777,Caroline-Lorraine Humbert,142774,194997,2022-09-10
CASH_OUT,136401,Caroline-Lorraine Humbert,194997,58596,Agence_mtn_Ouidah,300000,163599,2022-09-15
CASH_OUT,16560,Caroline-Lorraine Humbert,58596,42036,Agence_mtn_Abomey,300000,283440,2022-09-17
CASH_IN,285519,Agence_mtn_Abomey,300000,14481,Caroline-Lorraine Humbert,42036,327555,2022-09-17
TRANSFER,228302,Caroline-Lorraine Humbert,327555,99253,Caroline-Lorraine Humbert,327555,99253,2022-09-19
CASH_OUT,25049,Caroline-Lorraine Humbert,99253,74204,Agence_mtn_Ouidah,300000,274951,2022-09-22
CASH_OUT,55451,Caroline-Lorraine Humbert,74204,18753,Agence_mtn_Ouidah,300000,244549,2022-09-22
CASH_OUT,3885,Caroline-Lorraine Humbert,18753,14868,Agence_mtn_Ouidah,300000,296115,2022-09-24
CASH_IN,249215,Agence_mtn_Ouidah,300000,50785,Alfred du Lesage,-308839,-59624,2022-09-02
CASH_IN,68869,Agence_mtn_Cotonou,300000,231131,Alfred du Lesage,-59624,9245,2022-09-06
CASH_OUT,577,Alfred du Lesage,9245,8668,Agence_mtn_Ouidah,300000,299423,2022-09-08
CASH_OUT,8463,Alfred du Lesage,8668,205,Agence_mtn_Cotonou,300000,291537,2022-09-12
CASH_OUT,140,Alfred du Lesage,205,65,Agence_mtn_Cotonou,300000,299860,2022-09-15
CASH_IN,275567,Agence_mtn_Abomey,300000,24433,Alfred du Lesage,65,275632,2022-09-18
CASH_OUT,119348,Alfred du Lesage,275632,156284,Agence_mtn_Ouidah,300000,180652,2022-09-20
CASH_OUT,109922,Alfred du Lesage,156284,46362,Agence_mtn_Abomey,300000,190078,2022-09-20
CASH_OUT,20034,Alfred du Lesage,46362,26328,Agence_mtn_Cotonou,300000,279966,2022-09-20
CASH_IN,165117,Agence_mtn_Ouidah,300000,134883,Alfred du Lesage,26328,191445,2022-09-22
CASH_IN,176462,Agence_mtn_Abomey,300000,123538,Alfred du Lesage,191445,367907,2022-09-23
CASH_IN,6879,Agence_mtn_Ouidah,300000,293121,Eugène Poulain,-144166,-137287,2022-09-02
CASH_IN,281622,Agence_mtn_Abomey,300000,18378,Eugène Poulain,-137287,144335,2022-09-03
CASH_OUT,4785,Eugène Poulain,144335,139550,Agence_mtn_Abomey,300000,295215,2022-09-04
TRANSFER,1443,Eugène Poulain,139550,138107,Eugène Poulain,139550,138107,2022-09-06
CASH_IN,192243,Agence_mtn_Abomey,300000,107757,Eugène Poulain,138107,330350,2022-09-07
CASH_IN,136553,Agence_mtn_Abomey,300000,163447,Eugène Poulain,330350,466903,2022-09-09
TRANSFER,428056,Eugène Poulain,466903,38847,Eugène Poulain,466903,38847,2022-09-09
TRANSFER,463,Eugène Poulain,38847,38384,Eugène Poulain,38847,38384,2022-09-12
CASH_IN,85131,Agence_mtn_Abomey,300000,214869,Eugène Poulain,38384,123515,2022-09-14
TRANSFER,66229,Eugène Poulain,123515,57286,Eugène Poulain,123515,57286,2022-09-15
CASH_OUT,41116,Eugène Poulain,57286,16170,Agence_mtn_Abomey,300000,258884,2022-09-18
CASH_OUT,2710,Eugène Poulain,16170,13460,Agence_mtn_Ouidah,300000,297290,2022-09-19
CASH_OUT,2752,Eugène Poulain,13460,10708,Agence_mtn_Cotonou,300000,297248,2022-09-20
CASH_IN,2128,Agence_mtn_Ouidah,300000,297872,Eugène Poulain,10708,12836,2022-09-22
CASH_IN,198085,Agence_mtn_Cotonou,300000,101915,Eugène Poulain,12836,210921,2022-09-22
CASH_OUT,196311,Eugène Poulain,210921,14610,Agence_mtn_Abomey,300000,103689,2022-09-22
CASH_OUT,13030,Eugène Poulain,14610,1580,Agence_mtn_Ouidah,300000,286970,2022-09-25
CASH_IN,118704,Agence_mtn_Abomey,300000,181296,Eugène Poulain,1580,120284,2022-09-25
CASH_IN,255862,Agence_mtn_Ouidah,300000,44138,Margot Riou du Fernandes,-25982,229880,2022-09-01
CASH_OUT,53471,Margot Riou du Fernandes,229880,176409,Agence_mtn_Ouidah,300000,246529,2022-09-01
CASH_OUT,172762,Margot Riou du Fernandes,176409,3647,Agence_mtn_Cotonou,300000,127238,2022-09-02
TRANSFER,1556,Margot Riou du Fernandes,3647,2091,Margot Riou du Fernandes,3647,5203,2022-09-05
CASH_IN,41084,Agence_mtn_Ouidah,300000,258916,Margot Riou du Fernandes,2091,43175,2022-09-06
TRANSFER,26831,Margot Riou du Fernandes,43175,16344,Margot Riou du Fernandes,43175,16344,2022-09-06
CASH_IN,45765,Agence_mtn_Ouidah,300000,254235,Margot Riou du Fernandes,16344,62109,2022-09-09
CASH_OUT,35406,Margot Riou du Fernandes,62109,26703,Agence_mtn_Cotonou,300000,264594,2022-09-10
CASH_IN,249831,Agence_mtn_Ouidah,300000,50169,Margot Riou du Fernandes,26703,276534,2022-09-15
CASH_OUT,51775,Margot Riou du Fernandes,276534,224759,Agence_mtn_Abomey,300000,248225,2022-09-16
CASH_OUT,137154,Margot Riou du Fernandes,224759,87605,Agence_mtn_Abomey,300000,162846,2022-09-21
CASH_IN,124163,Agence_mtn_Cotonou,300000,175837,Renée David,-121350,2813,2022-09-01
TRANSFER,2400,Renée David,2813,413,Renée David,2813,413,2022-09-02
CASH_OUT,117,Renée David,413,296,Agence_mtn_Cotonou,300000,299883,2022-09-02
CASH_IN,150924,Agence_mtn_Ouidah,300000,149076,Renée David,296,151220,2022-09-02
CASH_OUT,121585,Renée David,151220,29635,Agence_mtn_Cotonou,300000,178415,2022-09-05
TRANSFER,2382,Renée David,29635,27253,Renée David,29635,27253,2022-09-05
CASH_IN,217573,Agence_mtn_Ouidah,300000,82427,Renée David,27253,244826,2022-09-06
CASH_OUT,79210,Renée David,244826,165616,Agence_mtn_Abomey,300000,220790,2022-09-07
CASH_IN,48412,Agence_mtn_Cotonou,300000,251588,Renée David,165616,214028,2022-09-07
TRANSFER,153615,Renée David,214028,60413,Renée David,214028,60413,2022-09-13
CASH_OUT,4384,Renée David,60413,56029,Agence_mtn_Ouidah,300000,295616,2022-09-17
CASH_OUT,53858,Renée David,56029,2171,Agence_mtn_Abomey,300000,246142,2022-09-17
CASH_OUT,1978,Renée David,2171,193,Agence_mtn_Cotonou,300000,298022,2022-09-17
CASH_OUT,157,Renée David,193,36,Agence_mtn_Cotonou,300000,299843,2022-09-18
CASH_IN,193674,Agence_mtn_Abomey,300000,106326,Renée David,36,193710,2022-09-21
CASH_IN,98302,Agence_mtn_Ouidah,300000,201698,Renée David,193710,292012,2022-09-25
CASH_OUT,178436,Renée David,292012,113576,Agence_mtn_Ouidah,300000,121564,2022-09-26
CASH_IN,17041,Agence_mtn_Abomey,300000,282959,Renée David,113576,130617,2022-09-26
CASH_IN,165306,Agence_mtn_Abomey,300000,134694,Gilbert-Charles Thibault,-264617,-99311,2022-09-01
CASH_IN,5880,Agence_mtn_Ouidah,300000,294120,Gilbert-Charles Thibault,-99311,-93431,2022-09-04
CASH_IN,199168,Agence_mtn_Abomey,300000,100832,Gilbert-Charles Thibault,-93431,105737,2022-09-04
TRANSFER,20825,Gilbert-Charles Thibault,105737,84912,Gilbert-Charles Thibault,105737,126562,2022-09-05
CASH_IN,68092,Agence_mtn_Ouidah,300000,231908,Gilbert-Charles Thibault,84912,153004,2022-09-09
TRANSFER,40400,Gilbert-Charles Thibault,153004,112604,Gilbert-Charles Thibault,153004,112604,2022-09-11
CASH_OUT,65639,Gilbert-Charles Thibault,112604,46965,Agence_mtn_Cotonou,300000,234361,2022-09-12
CASH_OUT,32291,Gilbert-Charles Thibault,46965,14674,Agence_mtn_Cotonou,300000,267709,2022-09-13
CASH_OUT,1004,Gilbert-Charles Thibault,14674,13670,Agence_mtn_Abomey,300000,298996,2022-09-14
TRANSFER,12885,Gilbert-Charles Thibault,13670,785,Gilbert-Charles Thibault,13670,785,2022-09-15
CASH_IN,289601,Agence_mtn_Ouidah,300000,10399,Gilbert-Charles Thibault,785,290386,2022-09-16
CASH_IN,189509,Agence_mtn_Abomey,300000,110491,Gilbert-Charles Thibault,290386,479895,2022-09-19
CASH_IN,296668,Agence_mtn_Cotonou,300000,3332,Gilbert-Charles Thibault,479895,776563,2022-09-21
CASH_OUT,32475,Gilbert-Charles Thibault,776563,744088,Agence_mtn_Cotonou,300000,267525,2022-09-22
CASH_OUT,673753,Gilbert-Charles Thibault,744088,70335,Agence_mtn_Ouidah,300000,-373753,2022-09-22
CASH_OUT,1054,Gilbert-Charles Thibault,70335,69281,Agence_mtn_Abomey,300000,298946,2022-09-23
CASH_IN,50043,Agence_mtn_Abomey,300000,249957,Gilbert-Charles Thibault,69281,119324,2022-09-24
CASH_IN,185260,Agence_mtn_Cotonou,300000,114740,Gilbert-Charles Thibault,119324,304584,2022-09-27
CASH_IN,283029,Agence_mtn_Abomey,300000,16971,Marcelle Paris,-113753,169276,2022-09-07
CASH_OUT,101961,Marcelle Paris,169276,67315,Agence_mtn_Abomey,300000,198039,2022-09-10
CASH_OUT,67216,Marcelle Paris,67315,99,Agence_mtn_Ouidah,300000,232784,2022-09-10
CASH_IN,71631,Agence_mtn_Abomey,300000,228369,Marcelle Paris,99,71730,2022-09-13
CASH_IN,269867,Agence_mtn_Ouidah,300000,30133,Marcelle Paris,71730,341597,2022-09-15
TRANSFER,262922,Marcelle Paris,341597,78675,Marcelle Paris,341597,78675,2022-09-16
CASH_OUT,15346,Marcelle Paris,78675,63329,Agence_mtn_Abomey,300000,284654,2022-09-20
CASH_IN,148921,Agence_mtn_Cotonou,300000,151079,Marcelle Paris,63329,212250,2022-09-21
CASH_OUT,148571,Marcelle Paris,212250,63679,Agence_mtn_Ouidah,300000,151429,2022-09-25
CASH_IN,183308,Agence_mtn_Ouidah,300000,116692,Valentine Richard-Bourdon,-89081,94227,2022-09-04
CASH_OUT,11045,Valentine Richard-Bourdon,94227,83182,Agence_mtn_Abomey,300000,288955,2022-09-06
CASH_OUT,79441,Valentine Richard-Bourdon,83182,3741,Agence_mtn_Cotonou,300000,220559,2022-09-06
CASH_OUT,171,Valentine Richard-Bourdon,3741,3570,Agence_mtn_Ouidah,300000,299829,2022-09-06
CASH_OUT,3108,Valentine Richard-Bourdon,3570,462,Agence_mtn_Ouidah,300000,296892,2022-09-07
CASH_OUT,241,Valentine Richard-Bourdon,462,221,Agence_mtn_Abomey,300000,299759,2022-09-20
CASH_IN,212750,Agence_mtn_Cotonou,300000,87250,Valentine Richard-Bourdon,221,212971,2022-09-24
CASH_IN,70299,Agence_mtn_Abomey,300000,229701,Valentine Richard-Bourdon,212971,283270,2022-09-26
CASH_IN,95807,Agence_mtn_Cotonou,300000,204193,Tristan Thomas,-508328,-412521,2022-09-01
CASH_IN,272800,Agence_mtn_Ouidah,300000,27200,Tristan Thomas,-412521,-139721,2022-09-07
CASH_IN,125709,Agence_mtn_Abomey,300000,174291,Tristan Thomas,-139721,-14012,2022-09-07
CASH_IN,23629,Agence_mtn_Ouidah,300000,276371,Tristan Thomas,-14012,9617,2022-09-13
CASH_IN,133508,Agence_mtn_Abomey,300000,166492,Tristan Thomas,9617,143125,2022-09-19
CASH_IN,136179,Agence_mtn_Abomey,300000,163821,Tristan Thomas,143125,279304,2022-09-25
CASH_IN,208263,Agence_mtn_Cotonou,300000,91737,Léon Martins-Briand,-12149,196114,2022-09-05
TRANSFER,29851,Léon Martins-Briand,196114,166263,Léon Martins-Briand,196114,166263,2022-09-05
CASH_IN,185649,Agence_mtn_Ouidah,300000,114351,Léon Martins-Briand,166263,351912,2022-09-09
TRANSFER,226965,Léon Martins-Briand,351912,124947,Léon Martins-Briand,351912,578877,2022-09-09
CASH_OUT,88587,Léon Martins-Briand,124947,36360,Agence_mtn_Ouidah,300000,211413,2022-09-12
TRANSFER,14155,Léon Martins-Briand,36360,22205,Léon Martins-Briand,36360,50515,2022-09-14
CASH_OUT,981,Léon Martins-Briand,22205,21224,Agence_mtn_Cotonou,300000,299019,2022-09-16
CASH_OUT,14748,Léon Martins-Briand,21224,6476,Agence_mtn_Abomey,300000,285252,2022-09-21
CASH_IN,294226,Agence_mtn_Abomey,300000,5774,Léon Martins-Briand,6476,300702,2022-09-22
CASH_IN,65929,Agence_mtn_Abomey,300000,234071,Léon Martins-Briand,300702,366631,2022-09-22
CASH_OUT,314137,Léon Martins-Briand,366631,52494,Agence_mtn_Abomey,300000,-14137,2022-09-24
CASH_OUT,6955,Léon Martins-Briand,52494,45539,Agence_mtn_Cotonou,300000,293045,2022-09-24
CASH_IN,46450,Agence_mtn_Abomey,300000,253550,Thibault Moreno,-143767,-97317,2022-09-01
CASH_IN,181496,Agence_mtn_Cotonou,300000,118504,Thibault Moreno,-97317,84179,2022-09-03
CASH_OUT,25404,Thibault Moreno,84179,58775,Agence_mtn_Ouidah,300000,274596,2022-09-05
TRANSFER,36874,Thibault Moreno,58775,21901,Thibault Moreno,58775,21901,2022-09-07
TRANSFER,14641,Thibault Moreno,21901,7260,Thibault Moreno,21901,7260,2022-09-10
CASH_OUT,602,Thibault Moreno,7260,6658,Agence_mtn_Cotonou,300000,299398,2022-09-11
CASH_OUT,6251,Thibault Moreno,6658,407,Agence_mtn_Ouidah,300000,293749,2022-09-12
CASH_IN,26569,Agence_mtn_Ouidah,300000,273431,Thibault Moreno,407,26976,2022-09-19
CASH_IN,176003,Agence_mtn_Cotonou,300000,123997,Thibault Moreno,26976,202979,2022-09-19
CASH_OUT,195803,Thibault Moreno,202979,7176,Agence_mtn_Cotonou,300000,104197,2022-09-21
CASH_IN,253247,Agence_mtn_Abomey,300000,46753,Thibault Moreno,7176,260423,2022-09-23
CASH_OUT,188623,Thibault Moreno,260423,71800,Agence_mtn_Abomey,300000,111377,2022-09-27
CASH_IN,142602,Agence_mtn_Ouidah,300000,157398,Roland Garcia,-348647,-206045,2022-09-03
CASH_IN,236675,Agence_mtn_Ouidah,300000,63325,Roland Garcia,-206045,30630,2022-09-03
CASH_OUT,4580,Roland Garcia,30630,26050,Agence_mtn_Ouidah,300000,295420,2022-09-05
CASH_IN,60911,Agence_mtn_Ouidah,300000,239089,Roland Garcia,26050,86961,2022-09-05
CASH_IN,37453,Agence_mtn_Abomey,300000,262547,Roland Garcia,86961,124414,2022-09-18
CASH_OUT,25328,Roland Garcia,124414,99086,Agence_mtn_Ouidah,300000,274672,2022-09-23
CASH_IN,162024,Agence_mtn_Cotonou,300000,137976,Roland Garcia,99086,261110,2022-09-27
CASH_IN,124480,Agence_mtn_Cotonou,300000,175520,Catherine Faivre,-14917,109563,2022-09-02
CASH_OUT,37111,Catherine Faivre,109563,72452,Agence_mtn_Ouidah,300000,262889,2022-09-02
TRANSFER,21102,Catherine Faivre,72452,51350,Catherine Faivre,72452,51350,2022-09-02
CASH_OUT,17319,Catherine Faivre,51350,34031,Agence_mtn_Cotonou,300000,282681,2022-09-11
CASH_IN,19392,Agence_mtn_Abomey,300000,280608,Catherine Faivre,34031,53423,2022-09-12
CASH_IN,283773,Agence_mtn_Abomey,300000,16227,Catherine Faivre,53423,337196,2022-09-13
CASH_IN,82637,Agence_mtn_Abomey,300000,217363,Catherine Faivre,337196,419833,2022-09-19
CASH_IN,18664,Agence_mtn_Ouidah,300000,281336,Catherine Faivre,419833,438497,2022-09-20
CASH_IN,113127,Agence_mtn_Ouidah,300000,186873,Catherine Faivre,438497,551624,2022-09-26
CASH_OUT,260242,Catherine Faivre,551624,291382,Agence_mtn_Ouidah,300000,39758,2022-09-27
CASH_IN,212007,Agence_mtn_Abomey,300000,87993,Bertrand Charles,-45946,166061,2022-09-01
TRANSFER,33679,Bertrand Charles,166061,132382,Bertrand Charles,166061,132382,2022-09-01
CASH_IN,37948,Agence_mtn_Cotonou,300000,262052,Bertrand Charles,132382,170330,2022-09-02
TRANSFER,144648,Bertrand Charles,170330,25682,Bertrand Charles,170330,314978,2022-09-04
CASH_OUT,14328,Bertrand Charles,25682,11354,Agence_mtn_Cotonou,300000,285672,2022-09-05
CASH_IN,184714,Agence_mtn_Cotonou,300000,115286,Bertrand Charles,11354,196068,2022-09-06
TRANSFER,92575,Bertrand Charles,196068,103493,Bertrand Charles,196068,288643,2022-09-07
CASH_OUT,78127,Bertrand Charles,103493,25366,Agence_mtn_Cotonou,300000,221873,2022-09-08
CASH_OUT,23006,Bertrand Charles,25366,2360,Agence_mtn_Cotonou,300000,276994,2022-09-13
CASH_IN,183454,Agence_mtn_Abomey,300000,116546,Bertrand Charles,2360,185814,2022-09-16
CASH_OUT,94693,Bertrand Charles,185814,91121,Agence_mtn_Cotonou,300000,205307,2022-09-16
CASH_OUT,26254,Bertrand Charles,91121,64867,Agence_mtn_Cotonou,300000,273746,2022-09-16
CASH_IN,211088,Agence_mtn_Cotonou,300000,88912,Bertrand Le Roux,-292244,-81156,2022-09-02
CASH_IN,285452,Agence_mtn_Ouidah,300000,14548,Bertrand Le Roux,-81156,204296,2022-09-03
CASH_OUT,161672,Bertrand Le Roux,204296,42624,Agence_mtn_Ouidah,300000,138328,2022-09-04
CASH_OUT,39430,Bertrand Le Roux,42624,3194,Agence_mtn_Cotonou,300000,260570,2022-09-07
CASH_IN,43220,Agence_mtn_Abomey,300000,256780,Bertrand Le Roux,3194,46414,2022-09-14
CASH_IN,121683,Agence_mtn_Abomey,300000,178317,Bertrand Le Roux,46414,168097,2022-09-17
CASH_OUT,45008,Bertrand Le Roux,168097,123089,Agence_mtn_Abomey,300000,254992,2022-09-19
CASH_IN,133944,Agence_mtn_Ouidah,300000,166056,Sophie Gonzalez,1270600,1404544,2022-10-13
CASH_IN,165846,Agence_mtn_Ouidah,300000,134154,Sophie Gonzalez,1404544,1570390,2022-10-18
TRANSFER,857081,Sophie Gonzalez,1570390,713309,Roland Garcia,1064500,207419,2022-10-19
CASH_IN,130526,Agence_mtn_Ouidah,300000,169474,Cécile Clerc,527200,657726,2022-10-23
TRANSFER,1184476,Simone Pineau,1276400,91924,Pierre Roger,1863400,3047876,2022-10-01
CASH_OUT,2142693,Pierre Roger,3047876,905183,Agence_mtn_Abomey,300000,-1842693,2022-10-04
CASH_IN,219396,Agence_mtn_Ouidah,300000,80604,Pierre Roger,905183,1124579,2022-10-19
TRANSFER,23679,Pierre Roger,1124579,1100900,Adrien Chartier,118300,94621,2022-10-20
CASH_OUT,185574,Pierre Roger,1100900,915326,Agence_mtn_Cotonou,300000,114426,2022-10-26
TRANSFER,445786,Frédéric Couturier,647100,201314,Jeanne Garnier,1144800,1590586,2022-10-07
CASH_OUT,1266652,Jeanne Garnier,1590586,323934,Agence_mtn_Cotonou,300000,-966652,2022-10-11
CASH_OUT,287214,Jeanne Garnier,323934,36720,Agence_mtn_Cotonou,300000,12786,2022-10-17
TRANSFER,352536,Rémy Le Michaud,921900,569364,Jeanne Garnier,36720,389256,2022-10-19
TRANSFER,38047,Alphonse Leclercq-Rousseau,102700,64653,Laure Philippe,1982400,1944353,2022-10-01
CASH_OUT,25414,Alphonse Leclercq-Rousseau,64653,39239,Agence_mtn_Cotonou,300000,274586,2022-10-03
CASH_IN,115629,Agence_mtn_Cotonou,300000,184371,Alphonse Leclercq-Rousseau,39239,154868,2022-10-08
CASH_OUT,625477,William Le Lucas,974400,348923,Agence_mtn_Cotonou,300000,-325477,2022-10-02
CASH_OUT,166825,William Le Lucas,348923,182098,Agence_mtn_Cotonou,300000,133175,2022-10-09
CASH_IN,95099,Agence_mtn_Abomey,300000,204901,William Le Lucas,182098,277197,2022-10-19
TRANSFER,132522,Richard Le Descamps,1695400,1562878,Inès Hamon,1896300,2028822,2022-10-13
CASH_OUT,1344114,Inès Hamon,2028822,684708,Agence_mtn_Ouidah,300000,-1044114,2022-10-20
CASH_OUT,654864,Inès Hamon,684708,29844,Agence_mtn_Cotonou,300000,-354864,2022-10-24
TRANSFER,17432,Xavier Leblanc-Ferreira,30800,13368,Émilie Moulin,1793300,1775868,2022-10-26
CASH_IN,85078,Agence_mtn_Cotonou,300000,214922,Alexandre Rémy,1949200,2034278,2022-10-01
CASH_IN,98939,Agence_mtn_Cotonou,300000,201061,Alexandre Rémy,2034278,2133217,2022-10-02
CASH_IN,100662,Agence_mtn_Cotonou,300000,199338,Alexandre Rémy,2133217,2233879,2022-10-13
CASH_OUT,22399,Alexandre Rémy,2233879,2211480,Agence_mtn_Abomey,300000,277601,2022-10-16
TRANSFER,1596,Inès de Letellier,4100,2504,Alexandre Rémy,2211480,2213076,2022-10-23
TRANSFER,123518,Gilbert Foucher,1828600,1705082,Émilie Moulin,1775868,1652350,2022-10-03
CASH_IN,17743,Agence_mtn_Ouidah,300000,282257,Gilbert Foucher,1705082,1722825,2022-10-06
CASH_IN,9852,Agence_mtn_Cotonou,300000,290148,Gilbert Foucher,1722825,1732677,2022-10-19
TRANSFER,829576,Gilbert Foucher,1732677,903101,Tristan Thomas,61400,-768176,2022-10-19
CASH_IN,200392,Agence_mtn_Abomey,300000,99608,Gilbert Foucher,903101,1103493,2022-10-25
CASH_OUT,180019,Thierry Delattre-Simon,429700,249681,Agence_mtn_Cotonou,300000,119981,2022-10-06
TRANSFER,194011,Gabriel-Tristan Marty,417100,223089,Thierry Delattre-Simon,249681,443692,2022-10-27
CASH_OUT,90501,Léon Martins-Briand,998800,908299,Agence_mtn_Cotonou,300000,209499,2022-10-24
CASH_IN,189875,Agence_mtn_Cotonou,300000,110125,Inès de Letellier,2504,192379,2022-10-06
TRANSFER,554659,David Guérin,761800,207141,Inès de Letellier,192379,747038,2022-10-08
CASH_IN,16665,Agence_mtn_Cotonou,300000,283335,Inès de Letellier,747038,763703,2022-10-23
CASH_OUT,984772,Marcelle Paris,1656800,672028,Agence_mtn_Ouidah,300000,-684772,2022-10-08
CASH_OUT,113064,Laure Philippe,1944353,1831289,Agence_mtn_Ouidah,300000,186936,2022-10-01
CASH_OUT,1011572,Laure Philippe,1831289,819717,Agence_mtn_Ouidah,300000,-711572,2022-10-20
TRANSFER,466358,Laure Philippe,819717,353359,William Lebrun,969500,503142,2022-10-20
CASH_OUT,131741,Laure Philippe,353359,221618,Agence_mtn_Cotonou,300000,168259,2022-10-27
CASH_OUT,97171,Laure Philippe,221618,124447,Agence_mtn_Abomey,300000,202829,2022-10-27
CASH_IN,229611,Agence_mtn_Abomey,300000,70389,Cécile Germain,462000,691611,2022-10-06
CASH_OUT,764477,Eugène Poulain,970200,205723,Agence_mtn_Abomey,300000,-464477,2022-10-08
TRANSFER,27281,Nathalie Pages,136900,109619,Eugène Poulain,205723,233004,2022-10-12
TRANSFER,404648,Valentine Richard-Bourdon,1501200,1096552,Eugène Poulain,233004,637652,2022-10-24
TRANSFER,362458,Benjamin Evrard-Marty,784400,421942,Gabriel Humbert,340500,702958,2022-10-10
CASH_IN,291937,Agence_mtn_Abomey,300000,8063,Gabriel Humbert,702958,994895,2022-10-11
TRANSFER,274971,William Lebrun,503142,228171,Gabriel Humbert,994895,1269866,2022-10-26
CASH_OUT,859877,Léon Lecoq,1524500,664623,Agence_mtn_Cotonou,300000,-559877,2022-10-19
CASH_IN,36421,Agence_mtn_Abomey,300000,263579,Léon Lecoq,664623,701044,2022-10-21
CASH_OUT,1472524,Bertrand Charles,1804500,331976,Agence_mtn_Abomey,300000,-1172524,2022-10-02
TRANSFER,276339,Bertrand Charles,331976,55637,Virginie Le Gall,43200,-233139,2022-10-06
TRANSFER,10696,Bertrand Charles,55637,44941,Benjamin Evrard-Marty,421942,411246,2022-10-08
TRANSFER,392638,Isabelle Rossi,718500,325862,Valentine Richard-Bourdon,1096552,703914,2022-10-26
CASH_IN,20635,Agence_mtn_Abomey,300000,279365,Étienne Roche,624000,644635,2022-10-07
CASH_OUT,223622,Étienne Roche,644635,421013,Agence_mtn_Ouidah,300000,76378,2022-10-08
CASH_OUT,83715,Étienne Roche,421013,337298,Agence_mtn_Cotonou,300000,216285,2022-10-26
CASH_OUT,227255,Étienne Roche,337298,110043,Agence_mtn_Abomey,300000,72745,2022-10-26
CASH_IN,267508,Agence_mtn_Abomey,300000,32492,Virginie Le Gall,-233139,34369,2022-10-05
CASH_OUT,29716,Virginie Le Gall,34369,4653,Agence_mtn_Ouidah,300000,270284,2022-10-06
CASH_IN,94507,Agence_mtn_Abomey,300000,205493,Virginie Le Gall,4653,99160,2022-10-18
CASH_IN,227431,Agence_mtn_Ouidah,300000,72569,Virginie Le Gall,99160,326591,2022-10-24
TRANSFER,30587,Frédéric Couturier,201314,170727,Xavier de Lebreton,850500,819913,2022-10-02
CASH_OUT,32194,Frédéric Couturier,170727,138533,Agence_mtn_Ouidah,300000,267806,2022-10-09
CASH_IN,51564,Agence_mtn_Ouidah,300000,248436,Frédéric Couturier,138533,190097,2022-10-10
CASH_OUT,12080,Frédéric Couturier,190097,178017,Agence_mtn_Ouidah,300000,287920,2022-10-14
CASH_OUT,128187,Frédéric Couturier,178017,49830,Agence_mtn_Cotonou,300000,171813,2022-10-17
CASH_OUT,319693,Zoé Renaud de Boutin,1426900,1107207,Agence_mtn_Cotonou,300000,-19693,2022-10-01
CASH_OUT,802835,Zoé Renaud de Boutin,1107207,304372,Agence_mtn_Ouidah,300000,-502835,2022-10-11
TRANSFER,882599,Céline Gomez,1401000,518401,Zoé Renaud de Boutin,304372,1186971,2022-10-15
CASH_OUT,48457,Astrid Gay de la Brunet,190300,141843,Agence_mtn_Cotonou,300000,251543,2022-10-07
TRANSFER,271453,David du Blondel,905600,634147,Astrid Gay de la Brunet,141843,413296,2022-10-09
CASH_OUT,38305,Astrid Gay de la Brunet,413296,374991,Agence_mtn_Ouidah,300000,261695,2022-10-09
TRANSFER,1485301,Éléonore-Hélène Dubois,1822000,336699,Astrid Gay de la Brunet,374991,1860292,2022-10-14
TRANSFER,327243,Franck-Charles Texier,1514600,1187357,Astrid Gay de la Brunet,1860292,2187535,2022-10-24
CASH_OUT,307038,Nathalie Peron,571600,264562,Agence_mtn_Cotonou,300000,-7038,2022-10-02
TRANSFER,213868,Nathalie Peron,264562,50694,Victoire-Nicole Lopez,534200,320332,2022-10-03
CASH_IN,49182,Agence_mtn_Cotonou,300000,250818,Nathalie Peron,50694,99876,2022-10-03
TRANSFER,78448,Nathalie Peron,99876,21428,Antoine Leleu,776100,697652,2022-10-03
CASH_OUT,1613,Nathalie Peron,21428,19815,Agence_mtn_Abomey,300000,298387,2022-10-04
CASH_IN,176623,Agence_mtn_Cotonou,300000,123377,Nathalie Peron,19815,196438,2022-10-05
CASH_OUT,53855,Nathalie Peron,196438,142583,Agence_mtn_Ouidah,300000,246145,2022-10-07
CASH_OUT,44376,Nathalie Peron,142583,98207,Agence_mtn_Abomey,300000,255624,2022-10-08
CASH_IN,15862,Agence_mtn_Ouidah,300000,284138,Nathalie Peron,98207,114069,2022-10-08
CASH_OUT,9404,Nathalie Peron,114069,104665,Agence_mtn_Cotonou,300000,290596,2022-10-08
CASH_IN,214348,Agence_mtn_Ouidah,300000,85652,Nathalie Peron,104665,319013,2022-10-11
CASH_IN,211150,Agence_mtn_Abomey,300000,88850,Nathalie Peron,319013,530163,2022-10-11
TRANSFER,283076,Nathalie Peron,530163,247087,Marcelle Charrier,1555100,1272024,2022-10-12
CASH_IN,83105,Agence_mtn_Cotonou,300000,216895,Nathalie Peron,247087,330192,2022-10-14
CASH_OUT,100616,Nathalie Peron,330192,229576,Agence_mtn_Ouidah,300000,199384,2022-10-14
CASH_IN,30917,Agence_mtn_Abomey,300000,269083,Nathalie Peron,229576,260493,2022-10-17
CASH_IN,174441,Agence_mtn_Abomey,300000,125559,Nathalie Peron,260493,434934,2022-10-19
TRANSFER,883998,Marie Picard,1078000,194002,Nathalie Peron,434934,1318932,2022-10-21
CASH_OUT,643856,Nathalie Peron,1318932,675076,Agence_mtn_Ouidah,300000,-343856,2022-10-24
CASH_OUT,495736,Nathalie Peron,675076,179340,Agence_mtn_Cotonou,300000,-195736,2022-10-25
CASH_OUT,165825,Nathalie Peron,179340,13515,Agence_mtn_Cotonou,300000,134175,2022-10-26
CASH_OUT,307801,Caroline-Lorraine Humbert,1842900,1535099,Agence_mtn_Ouidah,300000,-7801,2022-10-01
CASH_OUT,987402,Caroline-Lorraine Humbert,1535099,547697,Agence_mtn_Ouidah,300000,-687402,2022-10-03
TRANSFER,412316,Gilbert-Charles Thibault,814300,401984,Caroline-Lorraine Humbert,547697,960013,2022-10-03
CASH_OUT,748778,Caroline-Lorraine Humbert,960013,211235,Agence_mtn_Abomey,300000,-448778,2022-10-04
CASH_IN,171677,Agence_mtn_Ouidah,300000,128323,Caroline-Lorraine Humbert,211235,382912,2022-10-04
CASH_OUT,325615,Caroline-Lorraine Humbert,382912,57297,Agence_mtn_Cotonou,300000,-25615,2022-10-05
CASH_IN,235386,Agence_mtn_Ouidah,300000,64614,Caroline-Lorraine Humbert,57297,292683,2022-10-05
CASH_IN,209328,Agence_mtn_Ouidah,300000,90672,Caroline-Lorraine Humbert,292683,502011,2022-10-06
TRANSFER,466566,Xavier de Lebreton,819913,353347,Caroline-Lorraine Humbert,502011,968577,2022-10-07
CASH_OUT,356361,Caroline-Lorraine Humbert,968577,612216,Agence_mtn_Abomey,300000,-56361,2022-10-08
CASH_IN,129993,Agence_mtn_Ouidah,300000,170007,Caroline-Lorraine Humbert,612216,742209,2022-10-08
TRANSFER,602075,Pierre Reynaud,610900,8825,Caroline-Lorraine Humbert,742209,1344284,2022-10-11
CASH_OUT,697539,Caroline-Lorraine Humbert,1344284,646745,Agence_mtn_Cotonou,300000,-397539,2022-10-12
CASH_IN,213493,Agence_mtn_Cotonou,300000,86507,Caroline-Lorraine Humbert,646745,860238,2022-10-13
CASH_IN,75383,Agence_mtn_Abomey,300000,224617,Caroline-Lorraine Humbert,860238,935621,2022-10-13
TRANSFER,215155,Laurent-Bertrand Lefort,591700,376545,Caroline-Lorraine Humbert,935621,1150776,2022-10-16
CASH_OUT,761381,Caroline-Lorraine Humbert,1150776,389395,Agence_mtn_Abomey,300000,-461381,2022-10-17
CASH_IN,142563,Agence_mtn_Cotonou,300000,157437,Caroline-Lorraine Humbert,389395,531958,2022-10-17
CASH_IN,28838,Agence_mtn_Abomey,300000,271162,Caroline-Lorraine Humbert,531958,560796,2022-10-19
CASH_OUT,343217,Caroline-Lorraine Humbert,560796,217579,Agence_mtn_Abomey,300000,-43217,2022-10-19
CASH_OUT,62640,Caroline-Lorraine Humbert,217579,154939,Agence_mtn_Cotonou,300000,237360,2022-10-20
CASH_IN,220369,Agence_mtn_Cotonou,300000,79631,Caroline-Lorraine Humbert,154939,375308,2022-10-21
CASH_IN,249818,Agence_mtn_Abomey,300000,50182,Caroline-Lorraine Humbert,375308,625126,2022-10-22
CASH_IN,96270,Agence_mtn_Abomey,300000,203730,Caroline-Lorraine Humbert,625126,721396,2022-10-22
CASH_IN,19645,Agence_mtn_Cotonou,300000,280355,Caroline-Lorraine Humbert,721396,741041,2022-10-24
TRANSFER,141084,Caroline-Lorraine Humbert,741041,599957,Alexandrie Delmas,1677900,1536816,2022-10-26
CASH_OUT,217468,Caroline-Lorraine Humbert,599957,382489,Agence_mtn_Cotonou,300000,82532,2022-10-27
TRANSFER,223507,Marine Chauvet-Potier,1071400,847893,Caroline-Lorraine Humbert,382489,605996,2022-10-27
CASH_OUT,672451,Aurore Guyon,1066300,393849,Agence_mtn_Abomey,300000,-372451,2022-10-02
TRANSFER,306110,Aurore Guyon,393849,87739,Nath Bruneau,1029600,723490,2022-10-04
TRANSFER,1087405,Sébastien Lemaître,1860000,772595,Aurore Guyon,87739,1175144,2022-10-04
TRANSFER,181588,David Guérin,207141,25553,Aurore Guyon,1175144,1356732,2022-10-04
TRANSFER,388218,Geneviève De Oliveira-Michel,1348200,959982,Aurore Guyon,1356732,1744950,2022-10-05
CASH_IN,220615,Agence_mtn_Abomey,300000,79385,Aurore Guyon,1744950,1965565,2022-10-05
CASH_OUT,553446,Aurore Guyon,1965565,1412119,Agence_mtn_Cotonou,300000,-253446,2022-10-05
TRANSFER,130361,Aurore Guyon,1412119,1281758,Marine Chauvet-Potier,847893,717532,2022-10-05
CASH_OUT,738773,Aurore Guyon,1281758,542985,Agence_mtn_Cotonou,300000,-438773,2022-10-06
CASH_IN,170417,Agence_mtn_Cotonou,300000,129583,Aurore Guyon,542985,713402,2022-10-08
CASH_IN,115096,Agence_mtn_Cotonou,300000,184904,Aurore Guyon,713402,828498,2022-10-09
CASH_IN,236890,Agence_mtn_Abomey,300000,63110,Aurore Guyon,828498,1065388,2022-10-14
TRANSFER,1365713,Cécile Delattre-Arnaud,1671000,305287,Aurore Guyon,1065388,2431101,2022-10-15
CASH_IN,132643,Agence_mtn_Cotonou,300000,167357,Aurore Guyon,2431101,2563744,2022-10-16
CASH_OUT,1879895,Aurore Guyon,2563744,683849,Agence_mtn_Ouidah,300000,-1579895,2022-10-17
CASH_OUT,169887,Aurore Guyon,683849,513962,Agence_mtn_Ouidah,300000,130113,2022-10-17
CASH_IN,74388,Agence_mtn_Ouidah,300000,225612,Aurore Guyon,513962,588350,2022-10-18
CASH_OUT,250662,Aurore Guyon,588350,337688,Agence_mtn_Cotonou,300000,49338,2022-10-19
CASH_IN,103976,Agence_mtn_Ouidah,300000,196024,Aurore Guyon,337688,441664,2022-10-19
TRANSFER,463269,Marine Chauvet-Potier,717532,254263,Aurore Guyon,441664,904933,2022-10-19
TRANSFER,523834,Théodore De Oliveira-Nicolas,1407200,883366,Aurore Guyon,904933,1428767,2022-10-20
TRANSFER,28425,Marie Picard,194002,165577,Aurore Guyon,1428767,1457192,2022-10-22
CASH_IN,33400,Agence_mtn_Cotonou,300000,266600,Aurore Guyon,1457192,1490592,2022-10-22
CASH_IN,175670,Agence_mtn_Ouidah,300000,124330,Aurore Guyon,1490592,1666262,2022-10-23
TRANSFER,1247348,Aurore Guyon,1666262,418914,David du Blondel,634147,-613201,2022-10-24
CASH_IN,19724,Agence_mtn_Abomey,300000,280276,Aurore Guyon,418914,438638,2022-10-25
CASH_OUT,401761,Aurore Guyon,438638,36877,Agence_mtn_Cotonou,300000,-101761,2022-10-26
TRANSFER,35431,Aurore Guyon,36877,1446,David Guérin,25553,-9878,2022-10-26
CASH_IN,142151,Agence_mtn_Ouidah,300000,157849,Aurore Guyon,1446,143597,2022-10-27
TRANSFER,109664,Geneviève Grondin,487600,377936,Jean Benard,1399100,1289436,2022-10-01
CASH_OUT,65691,Geneviève Grondin,377936,312245,Agence_mtn_Cotonou,300000,234309,2022-10-04
CASH_OUT,198216,Geneviève Grondin,312245,114029,Agence_mtn_Cotonou,300000,101784,2022-10-05
CASH_OUT,8292,Geneviève Grondin,114029,105737,Agence_mtn_Cotonou,300000,291708,2022-10-05
TRANSFER,99012,Geneviève Grondin,105737,6725,Bertrand Le Roux,688100,589088,2022-10-06
CASH_IN,207586,Agence_mtn_Abomey,300000,92414,Geneviève Grondin,6725,214311,2022-10-09
CASH_OUT,78859,Geneviève Grondin,214311,135452,Agence_mtn_Cotonou,300000,221141,2022-10-10
CASH_IN,146814,Agence_mtn_Cotonou,300000,153186,Geneviève Grondin,135452,282266,2022-10-12
CASH_IN,205045,Agence_mtn_Cotonou,300000,94955,Geneviève Grondin,282266,487311,2022-10-13
CASH_IN,54226,Agence_mtn_Cotonou,300000,245774,Geneviève Grondin,487311,541537,2022-10-13
CASH_IN,266094,Agence_mtn_Ouidah,300000,33906,Geneviève Grondin,541537,807631,2022-10-14
CASH_OUT,806770,Geneviève Grondin,807631,861,Agence_mtn_Cotonou,300000,-506770,2022-10-19
CASH_OUT,514,Geneviève Grondin,861,347,Agence_mtn_Abomey,300000,299486,2022-10-20
CASH_OUT,206,Geneviève Grondin,347,141,Agence_mtn_Abomey,300000,299794,2022-10-21
CASH_OUT,118,Geneviève Grondin,141,23,Agence_mtn_Ouidah,300000,299882,2022-10-22
CASH_IN,23979,Agence_mtn_Abomey,300000,276021,Geneviève Grondin,23,24002,2022-10-22
TRANSFER,365,Pierre Reynaud,8825,8460,Geneviève Grondin,24002,24367,2022-10-24
CASH_IN,109243,Agence_mtn_Cotonou,300000,190757,Geneviève Grondin,24367,133610,2022-10-24
CASH_IN,64942,Agence_mtn_Abomey,300000,235058,Geneviève Grondin,133610,198552,2022-10-25
CASH_IN,31763,Agence_mtn_Ouidah,300000,268237,Geneviève Grondin,198552,230315,2022-10-26
CASH_OUT,53656,Geneviève Grondin,230315,176659,Agence_mtn_Cotonou,300000,246344,2022-10-27
CASH_OUT,14312,Geneviève Grondin,176659,162347,Agence_mtn_Ouidah,300000,285688,2022-10-27
CASH_IN,167083,Agence_mtn_Cotonou,300000,132917,Thérèse-Margaux Bruneau,1525300,1692383,2022-10-01
CASH_IN,183405,Agence_mtn_Abomey,300000,116595,Thérèse-Margaux Bruneau,1692383,1875788,2022-10-02
CASH_OUT,781971,Thérèse-Margaux Bruneau,1875788,1093817,Agence_mtn_Abomey,300000,-481971,2022-10-05
CASH_IN,23862,Agence_mtn_Abomey,300000,276138,Thérèse-Margaux Bruneau,1093817,1117679,2022-10-05
TRANSFER,7663,Vincent Mathieu,11200,3537,Thérèse-Margaux Bruneau,1117679,1125342,2022-10-08
CASH_IN,161270,Agence_mtn_Cotonou,300000,138730,Thérèse-Margaux Bruneau,1125342,1286612,2022-10-09
CASH_OUT,525775,Thérèse-Margaux Bruneau,1286612,760837,Agence_mtn_Ouidah,300000,-225775,2022-10-09
CASH_OUT,20560,Thérèse-Margaux Bruneau,760837,740277,Agence_mtn_Cotonou,300000,279440,2022-10-13
CASH_OUT,587194,Thérèse-Margaux Bruneau,740277,153083,Agence_mtn_Abomey,300000,-287194,2022-10-14
CASH_IN,136049,Agence_mtn_Cotonou,300000,163951,Thérèse-Margaux Bruneau,153083,289132,2022-10-18
CASH_OUT,135215,Thérèse-Margaux Bruneau,289132,153917,Agence_mtn_Ouidah,300000,164785,2022-10-19
CASH_IN,96616,Agence_mtn_Cotonou,300000,203384,Thérèse-Margaux Bruneau,153917,250533,2022-10-20
CASH_IN,5385,Agence_mtn_Cotonou,300000,294615,Thérèse-Margaux Bruneau,250533,255918,2022-10-21
TRANSFER,252074,Thérèse-Margaux Bruneau,255918,3844,Honoré du Laurent,265000,12926,2022-10-21
TRANSFER,1972,Thérèse-Margaux Bruneau,3844,1872,Adèle Labbé,379700,377728,2022-10-21
CASH_OUT,1434,Thérèse-Margaux Bruneau,1872,438,Agence_mtn_Abomey,300000,298566,2022-10-22
CASH_OUT,221,Thérèse-Margaux Bruneau,438,217,Agence_mtn_Cotonou,300000,299779,2022-10-22
TRANSFER,927,Vincent Mathieu,3537,2610,Thérèse-Margaux Bruneau,217,1144,2022-10-23
CASH_OUT,1097,Thérèse-Margaux Bruneau,1144,47,Agence_mtn_Abomey,300000,298903,2022-10-24
CASH_IN,209414,Agence_mtn_Cotonou,300000,90586,Thérèse-Margaux Bruneau,47,209461,2022-10-25
CASH_OUT,83658,Thérèse-Margaux Bruneau,209461,125803,Agence_mtn_Ouidah,300000,216342,2022-10-25
CASH_IN,255241,Agence_mtn_Abomey,300000,44759,Thérèse-Margaux Bruneau,125803,381044,2022-10-27
CASH_IN,200988,Agence_mtn_Cotonou,300000,99012,Thérèse-Margaux Bruneau,381044,582032,2022-10-27
TRANSFER,191363,Thibault Moreno,1582000,1390637,Thérèse-Margaux Bruneau,582032,773395,2022-10-27
CASH_OUT,697992,Raymond Marchal de Nguyen,1392100,694108,Agence_mtn_Ouidah,300000,-397992,2022-10-01
CASH_OUT,586695,Raymond Marchal de Nguyen,694108,107413,Agence_mtn_Ouidah,300000,-286695,2022-10-01
CASH_OUT,93683,Raymond Marchal de Nguyen,107413,13730,Agence_mtn_Abomey,300000,206317,2022-10-02
TRANSFER,10952,Raymond Marchal de Nguyen,13730,2778,William Lebrun,228171,217219,2022-10-02
TRANSFER,540623,Alexandrie Delmas,1536816,996193,Raymond Marchal de Nguyen,2778,543401,2022-10-03
CASH_IN,276000,Agence_mtn_Cotonou,300000,24000,Raymond Marchal de Nguyen,543401,819401,2022-10-05
TRANSFER,447983,Raymond Marchal de Nguyen,819401,371418,Alix Maillet,401500,-46483,2022-10-05
CASH_IN,53406,Agence_mtn_Abomey,300000,246594,Raymond Marchal de Nguyen,371418,424824,2022-10-08
CASH_IN,165762,Agence_mtn_Ouidah,300000,134238,Raymond Marchal de Nguyen,424824,590586,2022-10-09
TRANSFER,284274,Raymond Marchal de Nguyen,590586,306312,Céline Gomez,518401,234127,2022-10-10
CASH_IN,114470,Agence_mtn_Abomey,300000,185530,Raymond Marchal de Nguyen,306312,420782,2022-10-10
TRANSFER,210066,Raymond Marchal de Nguyen,420782,210716,Nath Bruneau,723490,513424,2022-10-10
CASH_OUT,163481,Raymond Marchal de Nguyen,210716,47235,Agence_mtn_Ouidah,300000,136519,2022-10-10
CASH_OUT,15131,Raymond Marchal de Nguyen,47235,32104,Agence_mtn_Ouidah,300000,284869,2022-10-10
CASH_OUT,31829,Raymond Marchal de Nguyen,32104,275,Agence_mtn_Cotonou,300000,268171,2022-10-11
CASH_OUT,129,Raymond Marchal de Nguyen,275,146,Agence_mtn_Abomey,300000,299871,2022-10-11
CASH_OUT,131,Raymond Marchal de Nguyen,146,15,Agence_mtn_Abomey,300000,299869,2022-10-12
CASH_IN,59035,Agence_mtn_Cotonou,300000,240965,Raymond Marchal de Nguyen,15,59050,2022-10-16
TRANSFER,17268,Raymond Marchal de Nguyen,59050,41782,Valentine Richard-Bourdon,703914,686646,2022-10-16
TRANSFER,781283,Richard Le Descamps,1562878,781595,Raymond Marchal de Nguyen,41782,823065,2022-10-17
CASH_OUT,250057,Raymond Marchal de Nguyen,823065,573008,Agence_mtn_Abomey,300000,49943,2022-10-17
TRANSFER,251004,Raymond Marchal de Nguyen,573008,322004,Sébastien Lemaître,772595,521591,2022-10-17
CASH_OUT,95762,Raymond Marchal de Nguyen,322004,226242,Agence_mtn_Abomey,300000,204238,2022-10-18
TRANSFER,164359,Rémy de la Roux,524400,360041,Raymond Marchal de Nguyen,226242,390601,2022-10-18
TRANSFER,364773,Raymond Marchal de Nguyen,390601,25828,Sébastien Vallée,1741500,1376727,2022-10-20
CASH_IN,262617,Agence_mtn_Ouidah,300000,37383,Raymond Marchal de Nguyen,25828,288445,2022-10-20
TRANSFER,792615,Pénélope Dupuis,1540000,747385,Raymond Marchal de Nguyen,288445,1081060,2022-10-21
TRANSFER,232002,Raymond Marchal de Nguyen,1081060,849058,William Lebrun,217219,-14783,2022-10-23
TRANSFER,201286,Rémy de la Roux,360041,158755,Raymond Marchal de Nguyen,849058,1050344,2022-10-24
CASH_OUT,520196,Raymond Marchal de Nguyen,1050344,530148,Agence_mtn_Cotonou,300000,-220196,2022-10-25
TRANSFER,701045,Émilie Moulin,1652350,951305,Gilbert-Charles Thibault,401984,1103029,2022-10-01
CASH_IN,186628,Agence_mtn_Abomey,300000,113372,Gilbert-Charles Thibault,1103029,1289657,2022-10-02
CASH_IN,86481,Agence_mtn_Abomey,300000,213519,Gilbert-Charles Thibault,1289657,1376138,2022-10-02
TRANSFER,93958,Gilbert-Charles Thibault,1376138,1282180,Benjamin Evrard-Marty,411246,317288,2022-10-02
TRANSFER,1224782,Gilbert-Charles Thibault,1282180,57398,Geneviève De Oliveira-Michel,959982,-264800,2022-10-03
TRANSFER,389302,Bertrand Le Roux,589088,199786,Gilbert-Charles Thibault,57398,446700,2022-10-03
CASH_IN,192372,Agence_mtn_Abomey,300000,107628,Gilbert-Charles Thibault,446700,639072,2022-10-04
CASH_OUT,261307,Gilbert-Charles Thibault,639072,377765,Agence_mtn_Abomey,300000,38693,2022-10-06
CASH_IN,23514,Agence_mtn_Ouidah,300000,276486,Gilbert-Charles Thibault,377765,401279,2022-10-06
CASH_OUT,332600,Gilbert-Charles Thibault,401279,68679,Agence_mtn_Abomey,300000,-32600,2022-10-07
TRANSFER,4155,Gilbert-Charles Thibault,68679,64524,Benjamin Evrard-Marty,317288,313133,2022-10-07
CASH_OUT,4401,Gilbert-Charles Thibault,64524,60123,Agence_mtn_Abomey,300000,295599,2022-10-08
CASH_IN,291441,Agence_mtn_Cotonou,300000,8559,Gilbert-Charles Thibault,60123,351564,2022-10-10
TRANSFER,251319,Gilbert-Charles Thibault,351564,100245,Pénélope Dupuis,747385,496066,2022-10-10
TRANSFER,55795,Valentine Martinez,1897500,1841705,Gilbert-Charles Thibault,100245,156040,2022-10-11
TRANSFER,190078,Benjamin Evrard-Marty,313133,123055,Gilbert-Charles Thibault,156040,346118,2022-10-14
CASH_OUT,20154,Gilbert-Charles Thibault,346118,325964,Agence_mtn_Cotonou,300000,279846,2022-10-15
TRANSFER,302602,Gilbert-Charles Thibault,325964,23362,Marie Picard,165577,-137025,2022-10-18
CASH_OUT,7989,Gilbert-Charles Thibault,23362,15373,Agence_mtn_Cotonou,300000,292011,2022-10-21
CASH_OUT,7321,Gilbert-Charles Thibault,15373,8052,Agence_mtn_Abomey,300000,292679,2022-10-22
TRANSFER,274138,Édouard Nguyen,757700,483562,Gilbert-Charles Thibault,8052,282190,2022-10-24
CASH_IN,111870,Agence_mtn_Abomey,300000,188130,Gilbert-Charles Thibault,282190,394060,2022-10-24
TRANSFER,67982,Gilbert-Charles Thibault,394060,326078,Nathalie Pages,109619,41637,2022-10-26
CASH_OUT,191496,Gilbert-Charles Thibault,326078,134582,Agence_mtn_Cotonou,300000,108504,2022-10-27
TRANSFER,227184,Joséphine Gros,329400,102216,Catherine Faivre,101600,328784,2022-10-03
CASH_IN,36830,Agence_mtn_Ouidah,300000,263170,Catherine Faivre,328784,365614,2022-10-03
CASH_OUT,345591,Catherine Faivre,365614,20023,Agence_mtn_Ouidah,300000,-45591,2022-10-04
TRANSFER,1841,Honoré du Laurent,12926,11085,Catherine Faivre,20023,21864,2022-10-06
TRANSFER,397277,Pénélope Dupuis,496066,98789,Catherine Faivre,21864,419141,2022-10-07
CASH_OUT,46200,Catherine Faivre,419141,372941,Agence_mtn_Cotonou,300000,253800,2022-10-07
CASH_OUT,218976,Catherine Faivre,372941,153965,Agence_mtn_Ouidah,300000,81024,2022-10-09
CASH_IN,25971,Agence_mtn_Abomey,300000,274029,Catherine Faivre,153965,179936,2022-10-09
CASH_IN,162381,Agence_mtn_Cotonou,300000,137619,Catherine Faivre,179936,342317,2022-10-10
CASH_OUT,181458,Catherine Faivre,342317,160859,Agence_mtn_Cotonou,300000,118542,2022-10-10
CASH_OUT,73316,Catherine Faivre,160859,87543,Agence_mtn_Cotonou,300000,226684,2022-10-11
CASH_OUT,54094,Catherine Faivre,87543,33449,Agence_mtn_Ouidah,300000,245906,2022-10-11
CASH_IN,42497,Agence_mtn_Cotonou,300000,257503,Catherine Faivre,33449,75946,2022-10-12
CASH_OUT,35421,Catherine Faivre,75946,40525,Agence_mtn_Cotonou,300000,264579,2022-10-13
CASH_OUT,21719,Catherine Faivre,40525,18806,Agence_mtn_Abomey,300000,278281,2022-10-13
TRANSFER,3690,Catherine Faivre,18806,15116,Alexandrie Delmas,996193,992503,2022-10-13
CASH_OUT,12086,Catherine Faivre,15116,3030,Agence_mtn_Ouidah,300000,287914,2022-10-14
CASH_OUT,1990,Catherine Faivre,3030,1040,Agence_mtn_Cotonou,300000,298010,2022-10-16
CASH_OUT,241,Catherine Faivre,1040,799,Agence_mtn_Abomey,300000,299759,2022-10-22
CASH_IN,274074,Agence_mtn_Abomey,300000,25926,Catherine Faivre,799,274873,2022-10-23
TRANSFER,91235,Catherine Faivre,274873,183638,Xavier de Lebreton,353347,262112,2022-10-23
TRANSFER,512238,Valentine Richard-Bourdon,686646,174408,Catherine Faivre,183638,695876,2022-10-23
TRANSFER,741946,Vincent Fournier,818300,76354,Catherine Faivre,695876,1437822,2022-10-26
CASH_OUT,410651,Michelle Lebon,718800,308149,Agence_mtn_Ouidah,300000,-110651,2022-10-01
CASH_OUT,114770,Michelle Lebon,308149,193379,Agence_mtn_Cotonou,300000,185230,2022-10-02
CASH_IN,67003,Agence_mtn_Ouidah,300000,232997,Michelle Lebon,193379,260382,2022-10-02
TRANSFER,237889,Michelle Lebon,260382,22493,Rémy Le Michaud,569364,331475,2022-10-05
TRANSFER,76720,Gabriel-Tristan Marty,223089,146369,Michelle Lebon,22493,99213,2022-10-06
CASH_IN,236208,Agence_mtn_Ouidah,300000,63792,Michelle Lebon,99213,335421,2022-10-08
CASH_OUT,293431,Michelle Lebon,335421,41990,Agence_mtn_Abomey,300000,6569,2022-10-09
CASH_OUT,2290,Michelle Lebon,41990,39700,Agence_mtn_Ouidah,300000,297710,2022-10-09
TRANSFER,716315,Émilie Moulin,951305,234990,Michelle Lebon,39700,756015,2022-10-10
CASH_IN,145543,Agence_mtn_Abomey,300000,154457,Michelle Lebon,756015,901558,2022-10-11
TRANSFER,667252,Michelle Lebon,901558,234306,Thibault Moreno,1390637,723385,2022-10-11
CASH_OUT,223076,Michelle Lebon,234306,11230,Agence_mtn_Abomey,300000,76924,2022-10-12
CASH_OUT,8856,Michelle Lebon,11230,2374,Agence_mtn_Ouidah,300000,291144,2022-10-13
TRANSFER,1159,Michelle Lebon,2374,1215,Bertrand Le Roux,199786,198627,2022-10-14
TRANSFER,191443,Éléonore-Hélène Dubois,336699,145256,Michelle Lebon,1215,192658,2022-10-16
TRANSFER,59863,Michelle Lebon,192658,132795,Margot Riou du Fernandes,1524100,1464237,2022-10-16
TRANSFER,26016,Michelle Lebon,132795,106779,Jean Benard,1289436,1263420,2022-10-16
CASH_OUT,35453,Michelle Lebon,106779,71326,Agence_mtn_Abomey,300000,264547,2022-10-18
TRANSFER,402533,Marcelle Charrier,1272024,869491,Michelle Lebon,71326,473859,2022-10-20
CASH_IN,189475,Agence_mtn_Ouidah,300000,110525,Michelle Lebon,473859,663334,2022-10-23
CASH_IN,263536,Agence_mtn_Ouidah,300000,36464,Michelle Lebon,663334,926870,2022-10-26
CASH_OUT,4832,Pierre Reynaud,8460,3628,Agence_mtn_Cotonou,300000,295168,2022-10-01
CASH_OUT,3538,Pierre Reynaud,3628,90,Agence_mtn_Cotonou,300000,296462,2022-10-04
CASH_IN,178401,Agence_mtn_Cotonou,300000,121599,Pierre Reynaud,90,178491,2022-10-04
CASH_OUT,107959,Pierre Reynaud,178491,70532,Agence_mtn_Abomey,300000,192041,2022-10-05
CASH_IN,167911,Agence_mtn_Ouidah,300000,132089,Pierre Reynaud,70532,238443,2022-10-10
CASH_OUT,48846,Pierre Reynaud,238443,189597,Agence_mtn_Abomey,300000,251154,2022-10-10
CASH_OUT,25272,Pierre Reynaud,189597,164325,Agence_mtn_Abomey,300000,274728,2022-10-10
CASH_IN,76203,Agence_mtn_Ouidah,300000,223797,Pierre Reynaud,164325,240528,2022-10-10
TRANSFER,25727,Édouard Nguyen,483562,457835,Pierre Reynaud,240528,266255,2022-10-12
CASH_IN,63310,Agence_mtn_Ouidah,300000,236690,Pierre Reynaud,266255,329565,2022-10-13
CASH_OUT,176200,Pierre Reynaud,329565,153365,Agence_mtn_Abomey,300000,123800,2022-10-17
CASH_OUT,106893,Pierre Reynaud,153365,46472,Agence_mtn_Abomey,300000,193107,2022-10-17
CASH_IN,84584,Agence_mtn_Cotonou,300000,215416,Pierre Reynaud,46472,131056,2022-10-18
CASH_IN,17965,Agence_mtn_Ouidah,300000,282035,Pierre Reynaud,131056,149021,2022-10-19
CASH_OUT,74837,Pierre Reynaud,149021,74184,Agence_mtn_Abomey,300000,225163,2022-10-20
CASH_IN,19473,Agence_mtn_Abomey,300000,280527,Pierre Reynaud,74184,93657,2022-10-21
CASH_OUT,69493,Pierre Reynaud,93657,24164,Agence_mtn_Cotonou,300000,230507,2022-10-21
CASH_IN,259920,Agence_mtn_Abomey,300000,40080,Pierre Reynaud,24164,284084,2022-10-23
CASH_IN,239164,Agence_mtn_Ouidah,300000,60836,Pierre Reynaud,284084,523248,2022-10-23
CASH_OUT,196955,Pierre Reynaud,523248,326293,Agence_mtn_Ouidah,300000,103045,2022-10-24
CASH_OUT,45681,Pierre Reynaud,326293,280612,Agence_mtn_Ouidah,300000,254319,2022-10-25
TRANSFER,942951,François Michel-Legros,950500,7549,Pierre Reynaud,280612,1223563,2022-10-26
CASH_OUT,383534,Pierre Reynaud,1223563,840029,Agence_mtn_Cotonou,300000,-83534,2022-10-27
TRANSFER,798838,Sophie Lévêque,1619100,820262,Pierre Reynaud,840029,1638867,2022-10-27
TRANSFER,411849,Raymond Rossi,1912900,1501051,Sébastien Lemaître,521591,933440,2022-10-02
TRANSFER,97656,Laurent-Bertrand Lefort,376545,278889,Sébastien Lemaître,933440,1031096,2022-10-03
TRANSFER,385681,Sébastien Lemaître,1031096,645415,Sébastien Vallée,1376727,991046,2022-10-04
CASH_IN,36487,Agence_mtn_Abomey,300000,263513,Sébastien Lemaître,645415,681902,2022-10-04
CASH_OUT,625763,Sébastien Lemaître,681902,56139,Agence_mtn_Cotonou,300000,-325763,2022-10-07
TRANSFER,147867,Pénélope Ollivier,213900,66033,Sébastien Lemaître,56139,204006,2022-10-09
CASH_OUT,184126,Sébastien Lemaître,204006,19880,Agence_mtn_Abomey,300000,115874,2022-10-11
CASH_IN,226627,Agence_mtn_Cotonou,300000,73373,Sébastien Lemaître,19880,246507,2022-10-12
CASH_IN,107279,Agence_mtn_Abomey,300000,192721,Sébastien Lemaître,246507,353786,2022-10-12
CASH_IN,183481,Agence_mtn_Abomey,300000,116519,Sébastien Lemaître,353786,537267,2022-10-15
CASH_IN,175574,Agence_mtn_Cotonou,300000,124426,Sébastien Lemaître,537267,712841,2022-10-16
CASH_OUT,375190,Sébastien Lemaître,712841,337651,Agence_mtn_Cotonou,300000,-75190,2022-10-16
CASH_IN,241779,Agence_mtn_Abomey,300000,58221,Sébastien Lemaître,337651,579430,2022-10-17
TRANSFER,404014,Sébastien Lemaître,579430,175416,Antoinette Bertrand,733300,329286,2022-10-17
TRANSFER,94175,Sébastien Lemaître,175416,81241,Victoire-Nicole Lopez,320332,226157,2022-10-17
TRANSFER,10492,Sébastien Lemaître,81241,70749,Théodore De Oliveira-Nicolas,883366,872874,2022-10-18
CASH_OUT,62633,Sébastien Lemaître,70749,8116,Agence_mtn_Abomey,300000,237367,2022-10-19
CASH_IN,16627,Agence_mtn_Abomey,300000,283373,Sébastien Lemaître,8116,24743,2022-10-19
CASH_OUT,11905,Sébastien Lemaître,24743,12838,Agence_mtn_Abomey,300000,288095,2022-10-20
CASH_OUT,2585,Sébastien Lemaître,12838,10253,Agence_mtn_Abomey,300000,297415,2022-10-21
TRANSFER,116591,Céline Gomez,234127,117536,Sébastien Lemaître,10253,126844,2022-10-22
CASH_OUT,76269,Sébastien Lemaître,126844,50575,Agence_mtn_Ouidah,300000,223731,2022-10-22
CASH_OUT,15924,Sébastien Lemaître,50575,34651,Agence_mtn_Abomey,300000,284076,2022-10-23
CASH_OUT,27135,Sébastien Lemaître,34651,7516,Agence_mtn_Ouidah,300000,272865,2022-10-24
CASH_OUT,4193,Sébastien Lemaître,7516,3323,Agence_mtn_Abomey,300000,295807,2022-10-25
TRANSFER,198380,Sophie Lévêque,820262,621882,Sébastien Lemaître,3323,201703,2022-10-25
CASH_OUT,827668,Thibaut Coulon,1616400,788732,Agence_mtn_Abomey,300000,-527668,2022-10-01
CASH_IN,39390,Agence_mtn_Abomey,300000,260610,Thibaut Coulon,788732,828122,2022-10-01
CASH_OUT,72930,Thibaut Coulon,828122,755192,Agence_mtn_Cotonou,300000,227070,2022-10-02
CASH_IN,160196,Agence_mtn_Abomey,300000,139804,Thibaut Coulon,755192,915388,2022-10-06
CASH_IN,85684,Agence_mtn_Ouidah,300000,214316,Thibaut Coulon,915388,1001072,2022-10-07
TRANSFER,997630,Thibaut Coulon,1001072,3442,Pénélope Dupuis,98789,-898841,2022-10-07
TRANSFER,3245,Thibaut Coulon,3442,197,Philippine Courtois,297300,294055,2022-10-08
CASH_IN,136458,Agence_mtn_Abomey,300000,163542,Thibaut Coulon,197,136655,2022-10-11
TRANSFER,200694,Émilie Moulin,234990,34296,Thibaut Coulon,136655,337349,2022-10-13
TRANSFER,38989,Thibaut Coulon,337349,298360,Margot Riou du Fernandes,1464237,1425248,2022-10-15
CASH_IN,145841,Agence_mtn_Cotonou,300000,154159,Thibaut Coulon,298360,444201,2022-10-16
CASH_OUT,13094,Thibaut Coulon,444201,431107,Agence_mtn_Cotonou,300000,286906,2022-10-18
TRANSFER,165254,Thibaut Coulon,431107,265853,Laurent-Bertrand Lefort,278889,113635,2022-10-18
CASH_OUT,247937,Thibaut Coulon,265853,17916,Agence_mtn_Abomey,300000,52063,2022-10-20
TRANSFER,311,Vincent Mathieu,2610,2299,Thibaut Coulon,17916,18227,2022-10-21
TRANSFER,322135,Théodore De Oliveira-Nicolas,872874,550739,Thibaut Coulon,18227,340362,2022-10-22
CASH_IN,179793,Agence_mtn_Cotonou,300000,120207,Thibaut Coulon,340362,520155,2022-10-23
TRANSFER,117179,Thibaut Coulon,520155,402976,Martine Wagner de la Bègue,1020000,902821,2022-10-24
TRANSFER,360531,Thibaut Coulon,402976,42445,Antoinette Bertrand,329286,-31245,2022-10-24
TRANSFER,78419,Marcelle Charrier,869491,791072,Thibaut Coulon,42445,120864,2022-10-25
CASH_IN,197282,Agence_mtn_Abomey,300000,102718,Thibaut Coulon,120864,318146,2022-10-25
CASH_IN,66472,Agence_mtn_Ouidah,300000,233528,Thibaut Coulon,318146,384618,2022-10-25
TRANSFER,372390,Thibaut Coulon,384618,12228,Sophie Lévêque,621882,249492,2022-10-25
CASH_OUT,1711,Thibaut Coulon,12228,10517,Agence_mtn_Cotonou,300000,298289,2022-10-27
CASH_OUT,88933,Victoire-Nicole Lopez,226157,137224,Agence_mtn_Ouidah,300000,211067,2022-10-04
TRANSFER,1110991,Jean Benard,1263420,152429,Victoire-Nicole Lopez,137224,1248215,2022-10-04
CASH_OUT,813510,Victoire-Nicole Lopez,1248215,434705,Agence_mtn_Cotonou,300000,-513510,2022-10-05
CASH_OUT,152211,Victoire-Nicole Lopez,434705,282494,Agence_mtn_Ouidah,300000,147789,2022-10-06
TRANSFER,16349,Nathalie Pages,41637,25288,Victoire-Nicole Lopez,282494,298843,2022-10-07
CASH_IN,30968,Agence_mtn_Ouidah,300000,269032,Victoire-Nicole Lopez,298843,329811,2022-10-07
CASH_OUT,93118,Victoire-Nicole Lopez,329811,236693,Agence_mtn_Ouidah,300000,206882,2022-10-08
TRANSFER,155839,Victoire-Nicole Lopez,236693,80854,Franck-Charles Texier,1187357,1031518,2022-10-08
CASH_IN,193385,Agence_mtn_Abomey,300000,106615,Victoire-Nicole Lopez,80854,274239,2022-10-09
CASH_IN,43032,Agence_mtn_Ouidah,300000,256968,Victoire-Nicole Lopez,274239,317271,2022-10-10
TRANSFER,213685,Victoire-Nicole Lopez,317271,103586,Éléonore-Hélène Dubois,145256,-68429,2022-10-12
CASH_IN,172102,Agence_mtn_Ouidah,300000,127898,Victoire-Nicole Lopez,103586,275688,2022-10-14
CASH_IN,23733,Agence_mtn_Cotonou,300000,276267,Victoire-Nicole Lopez,275688,299421,2022-10-15
CASH_OUT,62345,Victoire-Nicole Lopez,299421,237076,Agence_mtn_Ouidah,300000,237655,2022-10-16
CASH_IN,135508,Agence_mtn_Ouidah,300000,164492,Victoire-Nicole Lopez,237076,372584,2022-10-16
TRANSFER,86442,Valentine Richard-Bourdon,174408,87966,Victoire-Nicole Lopez,372584,459026,2022-10-17
TRANSFER,1333231,Raymond Rossi,1501051,167820,Victoire-Nicole Lopez,459026,1792257,2022-10-19
CASH_IN,241743,Agence_mtn_Abomey,300000,58257,Victoire-Nicole Lopez,1792257,2034000,2022-10-21
CASH_IN,6839,Agence_mtn_Ouidah,300000,293161,Victoire-Nicole Lopez,2034000,2040839,2022-10-21
CASH_IN,160205,Agence_mtn_Abomey,300000,139795,Victoire-Nicole Lopez,2040839,2201044,2022-10-23
CASH_OUT,1209166,Victoire-Nicole Lopez,2201044,991878,Agence_mtn_Abomey,300000,-909166,2022-10-24
TRANSFER,46346,Jean Benard,152429,106083,Victoire-Nicole Lopez,991878,1038224,2022-10-25
CASH_OUT,264450,Victoire-Nicole Lopez,1038224,773774,Agence_mtn_Ouidah,300000,35550,2022-10-26
CASH_OUT,505987,Victoire-Nicole Lopez,773774,267787,Agence_mtn_Cotonou,300000,-205987,2022-10-27
CASH_IN,252787,Agence_mtn_Ouidah,300000,47213,François Michel-Legros,7549,260336,2022-10-02
TRANSFER,34611,Gabriel-Tristan Marty,146369,111758,François Michel-Legros,260336,294947,2022-10-03
CASH_OUT,166870,François Michel-Legros,294947,128077,Agence_mtn_Abomey,300000,133130,2022-10-03
TRANSFER,95400,Laurent-Bertrand Lefort,113635,18235,François Michel-Legros,128077,223477,2022-10-04
TRANSFER,41828,Philippine Courtois,294055,252227,François Michel-Legros,223477,265305,2022-10-05
CASH_OUT,88419,François Michel-Legros,265305,176886,Agence_mtn_Cotonou,300000,211581,2022-10-10
TRANSFER,17967,Xavier de Lebreton,262112,244145,François Michel-Legros,176886,194853,2022-10-10
CASH_IN,277961,Agence_mtn_Ouidah,300000,22039,François Michel-Legros,194853,472814,2022-10-10
CASH_OUT,215760,François Michel-Legros,472814,257054,Agence_mtn_Ouidah,300000,84240,2022-10-11
CASH_IN,1459,Agence_mtn_Abomey,300000,298541,François Michel-Legros,257054,258513,2022-10-11
CASH_OUT,34622,François Michel-Legros,258513,223891,Agence_mtn_Abomey,300000,265378,2022-10-12
TRANSFER,421214,Marcelle Charrier,791072,369858,François Michel-Legros,223891,645105,2022-10-15
CASH_OUT,523153,François Michel-Legros,645105,121952,Agence_mtn_Ouidah,300000,-223153,2022-10-20
CASH_OUT,108049,François Michel-Legros,121952,13903,Agence_mtn_Abomey,300000,191951,2022-10-22
CASH_IN,60182,Agence_mtn_Cotonou,300000,239818,François Michel-Legros,13903,74085,2022-10-23
TRANSFER,23905,Nathalie Pages,25288,1383,François Michel-Legros,74085,97990,2022-10-23
CASH_OUT,57380,François Michel-Legros,97990,40610,Agence_mtn_Ouidah,300000,242620,2022-10-23
CASH_OUT,26720,François Michel-Legros,40610,13890,Agence_mtn_Abomey,300000,273280,2022-10-23
CASH_IN,160808,Agence_mtn_Ouidah,300000,139192,François Michel-Legros,13890,174698,2022-10-25
CASH_IN,108535,Agence_mtn_Cotonou,300000,191465,François Michel-Legros,174698,283233,2022-10-26
CASH_IN,209505,Agence_mtn_Abomey,300000,90495,François Michel-Legros,283233,492738,2022-10-27
CASH_OUT,286323,Margot Riou du Fernandes,1425248,1138925,Agence_mtn_Abomey,300000,13677,2022-10-01
TRANSFER,851720,Margot Riou du Fernandes,1138925,287205,Sébastien Vallée,991046,139326,2022-10-03
CASH_IN,73059,Agence_mtn_Abomey,300000,226941,Margot Riou du Fernandes,287205,360264,2022-10-05
CASH_IN,180935,Agence_mtn_Abomey,300000,119065,Margot Riou du Fernandes,360264,541199,2022-10-05
CASH_OUT,128535,Margot Riou du Fernandes,541199,412664,Agence_mtn_Abomey,300000,171465,2022-10-05
CASH_OUT,192565,Margot Riou du Fernandes,412664,220099,Agence_mtn_Ouidah,300000,107435,2022-10-07
TRANSFER,130485,Margot Riou du Fernandes,220099,89614,Valentine Martinez,1841705,1711220,2022-10-07
CASH_IN,2780,Agence_mtn_Cotonou,300000,297220,Margot Riou du Fernandes,89614,92394,2022-10-08
TRANSFER,55630,Margot Riou du Fernandes,92394,36764,Rémy Le Michaud,331475,275845,2022-10-09
CASH_IN,104927,Agence_mtn_Ouidah,300000,195073,Margot Riou du Fernandes,36764,141691,2022-10-10
TRANSFER,199385,Alexandrie Delmas,992503,793118,Margot Riou du Fernandes,141691,341076,2022-10-11
CASH_IN,265525,Agence_mtn_Ouidah,300000,34475,Margot Riou du Fernandes,341076,606601,2022-10-11
CASH_OUT,142515,Margot Riou du Fernandes,606601,464086,Agence_mtn_Ouidah,300000,157485,2022-10-13
TRANSFER,106954,Margot Riou du Fernandes,464086,357132,Valentine Richard-Bourdon,87966,-18988,2022-10-13
CASH_IN,230197,Agence_mtn_Abomey,300000,69803,Margot Riou du Fernandes,357132,587329,2022-10-14
TRANSFER,59085,Margot Riou du Fernandes,587329,528244,Alexandrie Delmas,793118,734033,2022-10-15
CASH_OUT,77907,Margot Riou du Fernandes,528244,450337,Agence_mtn_Ouidah,300000,222093,2022-10-15
CASH_OUT,229395,Margot Riou du Fernandes,450337,220942,Agence_mtn_Abomey,300000,70605,2022-10-18
CASH_IN,57902,Agence_mtn_Cotonou,300000,242098,Margot Riou du Fernandes,220942,278844,2022-10-19
TRANSFER,324139,Alexandrie Delmas,734033,409894,Margot Riou du Fernandes,278844,602983,2022-10-21
TRANSFER,647905,Richard Le Descamps,781595,133690,Margot Riou du Fernandes,602983,1250888,2022-10-21
CASH_IN,42698,Agence_mtn_Abomey,300000,257302,Margot Riou du Fernandes,1250888,1293586,2022-10-22
TRANSFER,1167924,Claude Foucher,1261800,93876,Margot Riou du Fernandes,1293586,2461510,2022-10-22
TRANSFER,2042575,Margot Riou du Fernandes,2461510,418935,Joséphine Gros,102216,-1940359,2022-10-23
CASH_OUT,212258,Margot Riou du Fernandes,418935,206677,Agence_mtn_Ouidah,300000,87742,2022-10-25
CASH_OUT,110176,Margot Riou du Fernandes,206677,96501,Agence_mtn_Cotonou,300000,189824,2022-10-26
CASH_OUT,13856,Margot Riou du Fernandes,96501,82645,Agence_mtn_Cotonou,300000,286144,2022-10-27
CASH_IN,163417,Agence_mtn_Abomey,300000,136583,David du Blondel,-613201,-449784,2022-10-01
CASH_IN,91911,Agence_mtn_Cotonou,300000,208089,David du Blondel,-449784,-357873,2022-10-02
CASH_IN,148000,Agence_mtn_Ouidah,300000,152000,David du Blondel,-357873,-209873,2022-10-04
CASH_IN,93988,Agence_mtn_Abomey,300000,206012,David du Blondel,-209873,-115885,2022-10-05
CASH_IN,28013,Agence_mtn_Abomey,300000,271987,David du Blondel,-115885,-87872,2022-10-09
CASH_IN,79052,Agence_mtn_Abomey,300000,220948,David du Blondel,-87872,-8820,2022-10-11
CASH_IN,295551,Agence_mtn_Cotonou,300000,4449,David du Blondel,-8820,286731,2022-10-11
CASH_OUT,83120,David du Blondel,286731,203611,Agence_mtn_Abomey,300000,216880,2022-10-11
CASH_IN,79286,Agence_mtn_Ouidah,300000,220714,David du Blondel,203611,282897,2022-10-11
CASH_OUT,102701,David du Blondel,282897,180196,Agence_mtn_Cotonou,300000,197299,2022-10-11
CASH_OUT,14521,David du Blondel,180196,165675,Agence_mtn_Cotonou,300000,285479,2022-10-13
TRANSFER,58692,David du Blondel,165675,106983,Adèle Labbé,377728,319036,2022-10-16
TRANSFER,39079,David du Blondel,106983,67904,Sébastien Vallée,139326,100247,2022-10-16
TRANSFER,736,Nathalie Pages,1383,647,David du Blondel,67904,68640,2022-10-17
CASH_OUT,10041,David du Blondel,68640,58599,Agence_mtn_Ouidah,300000,289959,2022-10-18
CASH_IN,37982,Agence_mtn_Ouidah,300000,262018,David du Blondel,58599,96581,2022-10-19
CASH_OUT,25469,David du Blondel,96581,71112,Agence_mtn_Cotonou,300000,274531,2022-10-21
CASH_IN,205140,Agence_mtn_Ouidah,300000,94860,David du Blondel,71112,276252,2022-10-23
CASH_OUT,232394,David du Blondel,276252,43858,Agence_mtn_Cotonou,300000,67606,2022-10-23
CASH_IN,1355,Agence_mtn_Abomey,300000,298645,David du Blondel,43858,45213,2022-10-24
TRANSFER,37341,David du Blondel,45213,7872,Margot Renaud,313200,275859,2022-10-25
CASH_IN,283873,Agence_mtn_Abomey,300000,16127,Geneviève De Oliveira-Michel,-264800,19073,2022-10-01
CASH_IN,101665,Agence_mtn_Ouidah,300000,198335,Geneviève De Oliveira-Michel,19073,120738,2022-10-02
CASH_IN,117222,Agence_mtn_Abomey,300000,182778,Geneviève De Oliveira-Michel,120738,237960,2022-10-02
CASH_IN,198097,Agence_mtn_Ouidah,300000,101903,Geneviève De Oliveira-Michel,237960,436057,2022-10-04
CASH_IN,142076,Agence_mtn_Cotonou,300000,157924,Geneviève De Oliveira-Michel,436057,578133,2022-10-07
CASH_IN,163489,Agence_mtn_Cotonou,300000,136511,Geneviève De Oliveira-Michel,578133,741622,2022-10-09
TRANSFER,566219,Geneviève De Oliveira-Michel,741622,175403,Richard Le Descamps,133690,-432529,2022-10-09
TRANSFER,6335,Laurent-Bertrand Lefort,18235,11900,Geneviève De Oliveira-Michel,175403,181738,2022-10-09
TRANSFER,1937,Vincent Mathieu,2299,362,Geneviève De Oliveira-Michel,181738,183675,2022-10-11
CASH_IN,276972,Agence_mtn_Abomey,300000,23028,Geneviève De Oliveira-Michel,183675,460647,2022-10-11
CASH_IN,250465,Agence_mtn_Ouidah,300000,49535,Geneviève De Oliveira-Michel,460647,711112,2022-10-12
CASH_OUT,124570,Geneviève De Oliveira-Michel,711112,586542,Agence_mtn_Ouidah,300000,175430,2022-10-13
CASH_IN,66688,Agence_mtn_Cotonou,300000,233312,Geneviève De Oliveira-Michel,586542,653230,2022-10-13
CASH_IN,139511,Agence_mtn_Cotonou,300000,160489,Geneviève De Oliveira-Michel,653230,792741,2022-10-13
TRANSFER,824937,Valentine Martinez,1711220,886283,Geneviève De Oliveira-Michel,792741,1617678,2022-10-13
CASH_OUT,361157,Geneviève De Oliveira-Michel,1617678,1256521,Agence_mtn_Cotonou,300000,-61157,2022-10-14
CASH_IN,100508,Agence_mtn_Ouidah,300000,199492,Geneviève De Oliveira-Michel,1256521,1357029,2022-10-17
TRANSFER,574576,Geneviève De Oliveira-Michel,1357029,782453,Sophie Lévêque,249492,-325084,2022-10-17
TRANSFER,654315,Geneviève De Oliveira-Michel,782453,128138,Gabriel-Tristan Marty,111758,-542557,2022-10-17
CASH_OUT,22233,Geneviève De Oliveira-Michel,128138,105905,Agence_mtn_Ouidah,300000,277767,2022-10-17
CASH_IN,56541,Agence_mtn_Abomey,300000,243459,Geneviève De Oliveira-Michel,105905,162446,2022-10-21
TRANSFER,155972,Geneviève De Oliveira-Michel,162446,6474,Xavier de Lebreton,244145,88173,2022-10-21
TRANSFER,2178,Geneviève De Oliveira-Michel,6474,4296,Adèle Labbé,319036,316858,2022-10-21
TRANSFER,376743,Louis Pichon,1037000,660257,Geneviève De Oliveira-Michel,4296,381039,2022-10-21
CASH_IN,109856,Agence_mtn_Abomey,300000,190144,Geneviève De Oliveira-Michel,381039,490895,2022-10-23
CASH_OUT,345776,Geneviève De Oliveira-Michel,490895,145119,Agence_mtn_Cotonou,300000,-45776,2022-10-24
CASH_OUT,126127,Geneviève De Oliveira-Michel,145119,18992,Agence_mtn_Cotonou,300000,173873,2022-10-26
CASH_OUT,724,Geneviève De Oliveira-Michel,18992,18268,Agence_mtn_Ouidah,300000,299276,2022-10-26
CASH_OUT,11540,Geneviève De Oliveira-Michel,18268,6728,Agence_mtn_Cotonou,300000,288460,2022-10-27
TRANSFER,1824,Geneviève De Oliveira-Michel,6728,4904,Édouard Nguyen,457835,456011,2022-10-27
CASH_OUT,21295,Valentine Martinez,886283,864988,Agence_mtn_Cotonou,300000,278705,2022-10-01
CASH_IN,147618,Agence_mtn_Ouidah,300000,152382,Valentine Martinez,864988,1012606,2022-10-01
TRANSFER,960327,Valentine Martinez,1012606,52279,Marcelle Charrier,369858,-590469,2022-10-02
CASH_IN,246766,Agence_mtn_Abomey,300000,53234,Valentine Martinez,52279,299045,2022-10-07
TRANSFER,131079,Valentine Martinez,299045,167966,Valérie Dijoux,688100,557021,2022-10-08
CASH_OUT,35876,Valentine Martinez,167966,132090,Agence_mtn_Cotonou,300000,264124,2022-10-09
TRANSFER,73293,Valentine Martinez,132090,58797,Jean Benard,106083,32790,2022-10-10
TRANSFER,27568,Valentine Martinez,58797,31229,Emmanuelle Georges,1110000,1082432,2022-10-10
CASH_IN,152652,Agence_mtn_Abomey,300000,147348,Valentine Martinez,31229,183881,2022-10-11
CASH_OUT,51530,Valentine Martinez,183881,132351,Agence_mtn_Cotonou,300000,248470,2022-10-11
TRANSFER,59151,Claude Foucher,93876,34725,Valentine Martinez,132351,191502,2022-10-13
CASH_OUT,45336,Valentine Martinez,191502,146166,Agence_mtn_Ouidah,300000,254664,2022-10-14
CASH_IN,108528,Agence_mtn_Ouidah,300000,191472,Valentine Martinez,146166,254694,2022-10-14
CASH_IN,106420,Agence_mtn_Cotonou,300000,193580,Valentine Martinez,254694,361114,2022-10-15
CASH_OUT,194196,Valentine Martinez,361114,166918,Agence_mtn_Ouidah,300000,105804,2022-10-16
CASH_IN,119114,Agence_mtn_Abomey,300000,180886,Valentine Martinez,166918,286032,2022-10-16
TRANSFER,98848,Valentine Martinez,286032,187184,Bertrand Le Roux,198627,99779,2022-10-17
CASH_OUT,111981,Valentine Martinez,187184,75203,Agence_mtn_Cotonou,300000,188019,2022-10-18
TRANSFER,16037,Valentine Martinez,75203,59166,Théodore De Oliveira-Nicolas,550739,534702,2022-10-20
TRANSFER,1632,Valentine Martinez,59166,57534,Nathalie Pages,647,-985,2022-10-20
TRANSFER,289743,Édouard Nguyen,456011,166268,Valentine Martinez,57534,347277,2022-10-21
TRANSFER,251454,Valentine Martinez,347277,95823,Édouard Nguyen,166268,-85186,2022-10-22
CASH_OUT,18156,Valentine Martinez,95823,77667,Agence_mtn_Ouidah,300000,281844,2022-10-23
CASH_IN,257034,Agence_mtn_Abomey,300000,42966,Valentine Martinez,77667,334701,2022-10-25
CASH_IN,1931,Agence_mtn_Abomey,300000,298069,Valentine Martinez,334701,336632,2022-10-26
CASH_OUT,293597,Valentine Martinez,336632,43035,Agence_mtn_Cotonou,300000,6403,2022-10-26
TRANSFER,1983,Renée David,929000,927017,Cécile Delattre-Arnaud,305287,303304,2022-10-01
CASH_OUT,83765,Renée David,927017,843252,Agence_mtn_Cotonou,300000,216235,2022-10-04
CASH_OUT,315484,Renée David,843252,527768,Agence_mtn_Cotonou,300000,-15484,2022-10-05
CASH_OUT,508115,Renée David,527768,19653,Agence_mtn_Cotonou,300000,-208115,2022-10-05
CASH_OUT,8745,Renée David,19653,10908,Agence_mtn_Cotonou,300000,291255,2022-10-05
TRANSFER,4872,Renée David,10908,6036,Jean Benard,32790,27918,2022-10-05
CASH_IN,37443,Agence_mtn_Cotonou,300000,262557,Renée David,6036,43479,2022-10-06
TRANSFER,14217,Hortense Lemaire,53400,39183,Renée David,43479,57696,2022-10-06
CASH_IN,258923,Agence_mtn_Cotonou,300000,41077,Renée David,57696,316619,2022-10-06
CASH_OUT,54319,Renée David,316619,262300,Agence_mtn_Ouidah,300000,245681,2022-10-07
CASH_OUT,166401,Renée David,262300,95899,Agence_mtn_Ouidah,300000,133599,2022-10-08
CASH_IN,55862,Agence_mtn_Cotonou,300000,244138,Renée David,95899,151761,2022-10-10
TRANSFER,99114,Bertrand Le Roux,99779,665,Renée David,151761,250875,2022-10-11
TRANSFER,249433,Renée David,250875,1442,Simone Pineau,91924,-157509,2022-10-11
CASH_OUT,1278,Renée David,1442,164,Agence_mtn_Abomey,300000,298722,2022-10-13
CASH_OUT,122,Renée David,164,42,Agence_mtn_Abomey,300000,299878,2022-10-16
CASH_IN,21144,Agence_mtn_Abomey,300000,278856,Renée David,42,21186,2022-10-17
TRANSFER,1560,Renée David,21186,19626,Adrien Chartier,94621,93061,2022-10-18
TRANSFER,185402,Théodore De Oliveira-Nicolas,534702,349300,Renée David,19626,205028,2022-10-18
CASH_OUT,107265,Renée David,205028,97763,Agence_mtn_Abomey,300000,192735,2022-10-21
CASH_OUT,18013,Renée David,97763,79750,Agence_mtn_Cotonou,300000,281987,2022-10-21
CASH_IN,83094,Agence_mtn_Cotonou,300000,216906,Renée David,79750,162844,2022-10-22
TRANSFER,31785,Hortense Lemaire,39183,7398,Renée David,162844,194629,2022-10-22
CASH_IN,133477,Agence_mtn_Abomey,300000,166523,Renée David,194629,328106,2022-10-22
CASH_IN,5107,Agence_mtn_Cotonou,300000,294893,Renée David,328106,333213,2022-10-23
TRANSFER,148646,Cécile Delattre-Arnaud,303304,154658,Renée David,333213,481859,2022-10-24
TRANSFER,639,Bertrand Le Roux,665,26,Benjamin Evrard-Marty,123055,122416,2022-10-02
CASH_IN,197458,Agence_mtn_Abomey,300000,102542,Bertrand Le Roux,26,197484,2022-10-02
CASH_OUT,33873,Bertrand Le Roux,197484,163611,Agence_mtn_Cotonou,300000,266127,2022-10-03
TRANSFER,154244,Bertrand Le Roux,163611,9367,Bertrand Le Roux,163611,317855,2022-10-06
CASH_OUT,3817,Bertrand Le Roux,9367,5550,Agence_mtn_Abomey,300000,296183,2022-10-08
TRANSFER,128778,Marine Chauvet-Potier,254263,125485,Bertrand Le Roux,5550,134328,2022-10-08
CASH_IN,67717,Agence_mtn_Ouidah,300000,232283,Bertrand Le Roux,134328,202045,2022-10-08
CASH_OUT,39392,Bertrand Le Roux,202045,162653,Agence_mtn_Cotonou,300000,260608,2022-10-10
TRANSFER,18174,Antoine Leleu,697652,679478,Bertrand Le Roux,162653,180827,2022-10-11
TRANSFER,14649,Thibault Moreno,723385,708736,Bertrand Le Roux,180827,195476,2022-10-11
TRANSFER,33079,Émilie Moulin,34296,1217,Bertrand Le Roux,195476,228555,2022-10-12
CASH_IN,161887,Agence_mtn_Ouidah,300000,138113,Bertrand Le Roux,228555,390442,2022-10-12
CASH_IN,285957,Agence_mtn_Cotonou,300000,14043,Bertrand Le Roux,390442,676399,2022-10-12
CASH_IN,147452,Agence_mtn_Cotonou,300000,152548,Bertrand Le Roux,676399,823851,2022-10-13
CASH_OUT,170921,Bertrand Le Roux,823851,652930,Agence_mtn_Abomey,300000,129079,2022-10-14
CASH_OUT,273605,Bertrand Le Roux,652930,379325,Agence_mtn_Ouidah,300000,26395,2022-10-14
TRANSFER,292994,Bertrand Le Roux,379325,86331,Bertrand Le Roux,379325,672319,2022-10-14
CASH_IN,80187,Agence_mtn_Ouidah,300000,219813,Bertrand Le Roux,86331,166518,2022-10-14
CASH_IN,182283,Agence_mtn_Abomey,300000,117717,Bertrand Le Roux,166518,348801,2022-10-15
CASH_OUT,9224,Bertrand Le Roux,348801,339577,Agence_mtn_Abomey,300000,290776,2022-10-16
CASH_OUT,103197,Bertrand Le Roux,339577,236380,Agence_mtn_Cotonou,300000,196803,2022-10-17
CASH_OUT,130863,Bertrand Le Roux,236380,105517,Agence_mtn_Abomey,300000,169137,2022-10-19
TRANSFER,202438,Margot Renaud,275859,73421,Bertrand Le Roux,105517,307955,2022-10-19
CASH_OUT,243209,Bertrand Le Roux,307955,64746,Agence_mtn_Abomey,300000,56791,2022-10-21
CASH_IN,275253,Agence_mtn_Ouidah,300000,24747,Bertrand Le Roux,64746,339999,2022-10-23
CASH_OUT,142083,Bertrand Le Roux,339999,197916,Agence_mtn_Abomey,300000,157917,2022-10-24
CASH_IN,213126,Agence_mtn_Abomey,300000,86874,Bertrand Le Roux,197916,411042,2022-10-25
TRANSFER,301983,Bertrand Le Roux,411042,109059,Théodore De Oliveira-Nicolas,349300,47317,2022-10-25
CASH_OUT,18420,Bertrand Le Roux,109059,90639,Agence_mtn_Ouidah,300000,281580,2022-10-26
TRANSFER,52306,Bertrand Le Roux,90639,38333,Honoré du Laurent,11085,-41221,2022-10-27
CASH_IN,75477,Agence_mtn_Cotonou,300000,224523,Gabriel-Tristan Marty,-542557,-467080,2022-10-01
CASH_IN,201181,Agence_mtn_Cotonou,300000,98819,Gabriel-Tristan Marty,-467080,-265899,2022-10-03
CASH_IN,151203,Agence_mtn_Ouidah,300000,148797,Gabriel-Tristan Marty,-265899,-114696,2022-10-03
CASH_IN,248433,Agence_mtn_Cotonou,300000,51567,Gabriel-Tristan Marty,-114696,133737,2022-10-05
CASH_OUT,105359,Gabriel-Tristan Marty,133737,28378,Agence_mtn_Cotonou,300000,194641,2022-10-09
TRANSFER,68110,Margot Renaud,73421,5311,Gabriel-Tristan Marty,28378,96488,2022-10-10
TRANSFER,25815,Antoine Leleu,679478,653663,Gabriel-Tristan Marty,96488,122303,2022-10-11
TRANSFER,25265,Gabriel-Tristan Marty,122303,97038,Pénélope Ollivier,66033,40768,2022-10-13
TRANSFER,80241,Gabriel-Tristan Marty,97038,16797,Xavier de Lebreton,88173,7932,2022-10-14
CASH_IN,109251,Agence_mtn_Cotonou,300000,190749,Gabriel-Tristan Marty,16797,126048,2022-10-14
TRANSFER,316559,Louis Pichon,660257,343698,Gabriel-Tristan Marty,126048,442607,2022-10-14
CASH_OUT,245509,Gabriel-Tristan Marty,442607,197098,Agence_mtn_Abomey,300000,54491,2022-10-16
CASH_OUT,33686,Gabriel-Tristan Marty,197098,163412,Agence_mtn_Abomey,300000,266314,2022-10-20
CASH_OUT,52474,Gabriel-Tristan Marty,163412,110938,Agence_mtn_Ouidah,300000,247526,2022-10-21
CASH_IN,87782,Agence_mtn_Abomey,300000,212218,Gabriel-Tristan Marty,110938,198720,2022-10-23
CASH_OUT,47193,Gabriel-Tristan Marty,198720,151527,Agence_mtn_Cotonou,300000,252807,2022-10-23
TRANSFER,12997,Jean Benard,27918,14921,Gabriel-Tristan Marty,151527,164524,2022-10-24
CASH_IN,250063,Agence_mtn_Ouidah,300000,49937,Gabriel-Tristan Marty,164524,414587,2022-10-26
CASH_OUT,233011,Gabriel-Tristan Marty,414587,181576,Agence_mtn_Ouidah,300000,66989,2022-10-27
CASH_IN,136336,Agence_mtn_Abomey,300000,163664,Jean Benard,14921,151257,2022-10-02
TRANSFER,47007,Jean Benard,151257,104250,Emmanuelle Georges,1082432,1035425,2022-10-05
CASH_OUT,94036,Jean Benard,104250,10214,Agence_mtn_Ouidah,300000,205964,2022-10-05
CASH_OUT,119,Jean Benard,10214,10095,Agence_mtn_Abomey,300000,299881,2022-10-07
CASH_OUT,4507,Jean Benard,10095,5588,Agence_mtn_Cotonou,300000,295493,2022-10-08
TRANSFER,6826,Hortense Lemaire,7398,572,Jean Benard,5588,12414,2022-10-09
CASH_OUT,9182,Jean Benard,12414,3232,Agence_mtn_Abomey,300000,290818,2022-10-11
CASH_IN,54535,Agence_mtn_Ouidah,300000,245465,Jean Benard,3232,57767,2022-10-11
CASH_IN,274878,Agence_mtn_Abomey,300000,25122,Jean Benard,57767,332645,2022-10-11
CASH_IN,79543,Agence_mtn_Ouidah,300000,220457,Jean Benard,332645,412188,2022-10-15
TRANSFER,127275,Jean Benard,412188,284913,Franck-Charles Texier,1031518,904243,2022-10-17
CASH_OUT,210265,Jean Benard,284913,74648,Agence_mtn_Abomey,300000,89735,2022-10-21
CASH_IN,139288,Agence_mtn_Abomey,300000,160712,Jean Benard,74648,213936,2022-10-21
CASH_OUT,79741,Jean Benard,213936,134195,Agence_mtn_Abomey,300000,220259,2022-10-22
CASH_OUT,1894,Pénélope Ollivier,40768,38874,Agence_mtn_Abomey,300000,298106,2022-10-04
CASH_IN,286871,Agence_mtn_Abomey,300000,13129,Pénélope Ollivier,38874,325745,2022-10-05
CASH_OUT,238697,Pénélope Ollivier,325745,87048,Agence_mtn_Abomey,300000,61303,2022-10-07
CASH_IN,69802,Agence_mtn_Ouidah,300000,230198,Pénélope Ollivier,87048,156850,2022-10-09
TRANSFER,23301,Pénélope Ollivier,156850,133549,Adèle Labbé,316858,293557,2022-10-09
CASH_OUT,42098,Pénélope Ollivier,133549,91451,Agence_mtn_Ouidah,300000,257902,2022-10-10
TRANSFER,91055,Pénélope Ollivier,91451,396,Adrien Chartier,93061,2006,2022-10-13
TRANSFER,231,Pénélope Ollivier,396,165,Sébastien Vallée,100247,100016,2022-10-14
CASH_IN,17865,Agence_mtn_Abomey,300000,282135,Pénélope Ollivier,165,18030,2022-10-18
CASH_IN,41730,Agence_mtn_Ouidah,300000,258270,Pénélope Ollivier,18030,59760,2022-10-20
CASH_IN,65786,Agence_mtn_Abomey,300000,234214,Pénélope Ollivier,59760,125546,2022-10-23
CASH_OUT,112905,Pénélope Ollivier,125546,12641,Agence_mtn_Ouidah,300000,187095,2022-10-23
CASH_IN,4525,Agence_mtn_Cotonou,300000,295475,Pénélope Ollivier,12641,17166,2022-10-25
CASH_IN,205226,Agence_mtn_Abomey,300000,94774,Pénélope Ollivier,17166,222392,2022-10-25
CASH_IN,204055,Agence_mtn_Ouidah,300000,95945,Éléonore-Hélène Dubois,-68429,135626,2022-10-02
CASH_IN,164643,Agence_mtn_Abomey,300000,135357,Éléonore-Hélène Dubois,135626,300269,2022-10-02
CASH_OUT,73535,Éléonore-Hélène Dubois,300269,226734,Agence_mtn_Ouidah,300000,226465,2022-10-03
CASH_IN,218388,Agence_mtn_Abomey,300000,81612,Éléonore-Hélène Dubois,226734,445122,2022-10-03
CASH_OUT,402805,Éléonore-Hélène Dubois,445122,42317,Agence_mtn_Cotonou,300000,-102805,2022-10-07
CASH_IN,213362,Agence_mtn_Cotonou,300000,86638,Éléonore-Hélène Dubois,42317,255679,2022-10-08
TRANSFER,162814,Éléonore-Hélène Dubois,255679,92865,Claude Foucher,34725,-128089,2022-10-10
TRANSFER,7681,Xavier de Lebreton,7932,251,Éléonore-Hélène Dubois,92865,100546,2022-10-10
CASH_IN,95453,Agence_mtn_Abomey,300000,204547,Éléonore-Hélène Dubois,100546,195999,2022-10-11
CASH_OUT,102723,Éléonore-Hélène Dubois,195999,93276,Agence_mtn_Cotonou,300000,197277,2022-10-12
TRANSFER,71663,Marine Chauvet-Potier,125485,53822,Éléonore-Hélène Dubois,93276,164939,2022-10-13
CASH_IN,276510,Agence_mtn_Abomey,300000,23490,Éléonore-Hélène Dubois,164939,441449,2022-10-20
CASH_IN,286289,Agence_mtn_Abomey,300000,13711,Éléonore-Hélène Dubois,441449,727738,2022-10-22
CASH_IN,225640,Agence_mtn_Ouidah,300000,74360,Éléonore-Hélène Dubois,727738,953378,2022-10-23
TRANSFER,45958,Sébastien Vallée,100016,54058,Éléonore-Hélène Dubois,953378,999336,2022-10-26
CASH_OUT,931282,Éléonore-Hélène Dubois,999336,68054,Agence_mtn_Abomey,300000,-631282,2022-10-27
CASH_IN,220452,Agence_mtn_Cotonou,300000,79548,Éléonore-Hélène Dubois,68054,288506,2022-10-27
CASH_IN,164896,Agence_mtn_Abomey,300000,135104,Alix Maillet,-46483,118413,2022-10-01
TRANSFER,151,Alix Maillet,118413,118262,Alix Maillet,118413,118564,2022-10-01
CASH_OUT,8552,Alix Maillet,118262,109710,Agence_mtn_Ouidah,300000,291448,2022-10-04
CASH_IN,18877,Agence_mtn_Abomey,300000,281123,Alix Maillet,109710,128587,2022-10-06
CASH_IN,121907,Agence_mtn_Cotonou,300000,178093,Alix Maillet,128587,250494,2022-10-06
TRANSFER,469,Hortense Lemaire,572,103,Alix Maillet,250494,250963,2022-10-10
TRANSFER,168471,Alix Maillet,250963,82492,Rémy Le Michaud,275845,107374,2022-10-12
CASH_OUT,2024,Alix Maillet,82492,80468,Agence_mtn_Cotonou,300000,297976,2022-10-12
CASH_IN,37185,Agence_mtn_Cotonou,300000,262815,Alix Maillet,80468,117653,2022-10-14
TRANSFER,119105,Rémy de la Roux,158755,39650,Alix Maillet,117653,236758,2022-10-20
TRANSFER,58255,Alix Maillet,236758,178503,Théodore De Oliveira-Nicolas,47317,-10938,2022-10-25
TRANSFER,11105,Sébastien Vallée,54058,42953,Alix Maillet,178503,189608,2022-10-25
CASH_IN,112272,Agence_mtn_Abomey,300000,187728,Alix Maillet,189608,301880,2022-10-27
CASH_OUT,17312,Sébastien Vallée,42953,25641,Agence_mtn_Cotonou,300000,282688,2022-10-07
TRANSFER,100,Hortense Lemaire,103,3,Sébastien Vallée,25641,25741,2022-10-09
CASH_OUT,13653,Sébastien Vallée,25741,12088,Agence_mtn_Abomey,300000,286347,2022-10-09
CASH_IN,126485,Agence_mtn_Ouidah,300000,173515,Sébastien Vallée,12088,138573,2022-10-12
TRANSFER,331,Vincent Mathieu,362,31,Sébastien Vallée,138573,138904,2022-10-15
CASH_OUT,105539,Sébastien Vallée,138904,33365,Agence_mtn_Ouidah,300000,194461,2022-10-15
CASH_IN,80184,Agence_mtn_Ouidah,300000,219816,Sébastien Vallée,33365,113549,2022-10-23
CASH_OUT,109038,Sébastien Vallée,113549,4511,Agence_mtn_Abomey,300000,190962,2022-10-24
CASH_OUT,3205,Sébastien Vallée,4511,1306,Agence_mtn_Ouidah,300000,296795,2022-10-26
CASH_OUT,316,Sébastien Vallée,1306,990,Agence_mtn_Cotonou,300000,299684,2022-10-26
CASH_IN,198823,Agence_mtn_Cotonou,300000,101177,Sébastien Vallée,990,199813,2022-10-27
CASH_OUT,219211,Louis Pichon,343698,124487,Agence_mtn_Cotonou,300000,80789,2022-10-03
CASH_IN,208879,Agence_mtn_Ouidah,300000,91121,Louis Pichon,124487,333366,2022-10-04
CASH_OUT,262581,Louis Pichon,333366,70785,Agence_mtn_Abomey,300000,37419,2022-10-05
CASH_OUT,45125,Louis Pichon,70785,25660,Agence_mtn_Cotonou,300000,254875,2022-10-07
CASH_OUT,17582,Louis Pichon,25660,8078,Agence_mtn_Abomey,300000,282418,2022-10-07
TRANSFER,3053,Louis Pichon,8078,5025,Céline Gomez,117536,114483,2022-10-07
TRANSFER,128416,Alexandrie Delmas,409894,281478,Louis Pichon,5025,133441,2022-10-08
CASH_IN,253588,Agence_mtn_Abomey,300000,46412,Louis Pichon,133441,387029,2022-10-10
TRANSFER,123985,Louis Pichon,387029,263044,Nath Bruneau,513424,389439,2022-10-14
CASH_OUT,145442,Louis Pichon,263044,117602,Agence_mtn_Ouidah,300000,154558,2022-10-16
CASH_IN,167725,Agence_mtn_Ouidah,300000,132275,Louis Pichon,117602,285327,2022-10-20
CASH_OUT,148890,Louis Pichon,285327,136437,Agence_mtn_Ouidah,300000,151110,2022-10-21
CASH_IN,111782,Agence_mtn_Abomey,300000,188218,Louis Pichon,136437,248219,2022-10-23
CASH_IN,38446,Agence_mtn_Cotonou,300000,261554,Louis Pichon,248219,286665,2022-10-25
CASH_OUT,23789,Louis Pichon,286665,262876,Agence_mtn_Ouidah,300000,276211,2022-10-25
TRANSFER,19706,Louis Pichon,262876,243170,Philippine Courtois,252227,232521,2022-10-26
CASH_IN,232318,Agence_mtn_Ouidah,300000,67682,Louis Pichon,243170,475488,2022-10-27
CASH_IN,10071,Agence_mtn_Ouidah,300000,289929,Honoré du Laurent,-41221,-31150,2022-10-03
CASH_IN,271774,Agence_mtn_Ouidah,300000,28226,Honoré du Laurent,-31150,240624,2022-10-15
CASH_IN,142744,Agence_mtn_Cotonou,300000,157256,Honoré du Laurent,240624,383368,2022-10-16
CASH_IN,167944,Agence_mtn_Cotonou,300000,132056,Honoré du Laurent,383368,551312,2022-10-17
CASH_IN,10551,Agence_mtn_Ouidah,300000,289449,Honoré du Laurent,551312,561863,2022-10-23
TRANSFER,1972,Adrien Chartier,2006,34,Honoré du Laurent,561863,563835,2022-10-25
CASH_IN,79565,Agence_mtn_Cotonou,300000,220435,Vincent Mathieu,31,79596,2022-10-06
TRANSFER,26015,Vincent Mathieu,79596,53581,Rémy Le Michaud,107374,81359,2022-10-10
CASH_IN,224832,Agence_mtn_Abomey,300000,75168,Vincent Mathieu,53581,278413,2022-10-12
TRANSFER,385773,Valérie Dijoux,557021,171248,Vincent Mathieu,278413,664186,2022-10-13
CASH_IN,16020,Agence_mtn_Abomey,300000,283980,Vincent Mathieu,664186,680206,2022-10-16
TRANSFER,85808,Philippine Courtois,232521,146713,Vincent Mathieu,680206,766014,2022-10-21
CASH_IN,264719,Agence_mtn_Ouidah,300000,35281,Vincent Mathieu,766014,1030733,2022-10-22
TRANSFER,221660,Vincent Mathieu,1030733,809073,Nath Bruneau,389439,167779,2022-10-27
CASH_IN,177485,Agence_mtn_Ouidah,300000,122515,Céline Gomez,114483,291968,2022-10-01
TRANSFER,15924,Céline Gomez,291968,276044,Rémy de la Roux,39650,23726,2022-10-03
CASH_OUT,227933,Céline Gomez,276044,48111,Agence_mtn_Abomey,300000,72067,2022-10-11
CASH_IN,61543,Agence_mtn_Cotonou,300000,238457,Céline Gomez,48111,109654,2022-10-13
CASH_IN,227720,Agence_mtn_Cotonou,300000,72280,Céline Gomez,109654,337374,2022-10-13
TRANSFER,114227,Céline Gomez,337374,223147,Raymond Rossi,167820,53593,2022-10-16
CASH_IN,232406,Agence_mtn_Ouidah,300000,67594,Céline Gomez,223147,455553,2022-10-16
TRANSFER,447779,Céline Gomez,455553,7774,Philippine Courtois,146713,-301066,2022-10-16
CASH_IN,277280,Agence_mtn_Ouidah,300000,22720,Céline Gomez,7774,285054,2022-10-23
TRANSFER,46360,Céline Gomez,285054,238694,Antoine Leleu,653663,607303,2022-10-25
CASH_IN,276692,Agence_mtn_Cotonou,300000,23308,Céline Gomez,238694,515386,2022-10-25
CASH_OUT,77769,Céline Gomez,515386,437617,Agence_mtn_Ouidah,300000,222231,2022-10-27
CASH_IN,257049,Agence_mtn_Ouidah,300000,42951,Céline Gomez,437617,694666,2022-10-27
CASH_IN,91696,Agence_mtn_Cotonou,300000,208304,Claude Foucher,-128089,-36393,2022-10-01
CASH_IN,219256,Agence_mtn_Cotonou,300000,80744,Claude Foucher,-36393,182863,2022-10-01
CASH_OUT,82477,Claude Foucher,182863,100386,Agence_mtn_Cotonou,300000,217523,2022-10-04
TRANSFER,61646,Claude Foucher,100386,38740,Cécile Delattre-Arnaud,154658,93012,2022-10-05
CASH_OUT,9880,Claude Foucher,38740,28860,Agence_mtn_Ouidah,300000,290120,2022-10-07
TRANSFER,32052,Rémy Le Michaud,81359,49307,Claude Foucher,28860,60912,2022-10-09
CASH_IN,78516,Agence_mtn_Cotonou,300000,221484,Claude Foucher,60912,139428,2022-10-12
TRANSFER,82162,Claude Foucher,139428,57266,Valérie Dijoux,171248,89086,2022-10-13
CASH_IN,161979,Agence_mtn_Ouidah,300000,138021,Claude Foucher,57266,219245,2022-10-16
CASH_OUT,109061,Claude Foucher,219245,110184,Agence_mtn_Abomey,300000,190939,2022-10-17
TRANSFER,57532,Claude Foucher,110184,52652,Claude Foucher,110184,52652,2022-10-20
TRANSFER,6506,Claude Foucher,52652,46146,Nath Bruneau,167779,161273,2022-10-21
TRANSFER,922,Émilie Moulin,1217,295,Claude Foucher,46146,47068,2022-10-24
TRANSFER,13185,Claude Foucher,47068,33883,Xavier de Lebreton,251,-12934,2022-10-24
CASH_IN,177475,Agence_mtn_Abomey,300000,122525,Claude Foucher,33883,211358,2022-10-25
CASH_IN,259117,Agence_mtn_Abomey,300000,40883,Claude Foucher,211358,470475,2022-10-26
TRANSFER,90810,Cécile Delattre-Arnaud,93012,2202,Claude Foucher,470475,561285,2022-10-27
CASH_IN,33695,Agence_mtn_Cotonou,300000,266305,Rémy de la Roux,23726,57421,2022-10-01
CASH_IN,201835,Agence_mtn_Cotonou,300000,98165,Rémy de la Roux,57421,259256,2022-10-01
CASH_OUT,185699,Rémy de la Roux,259256,73557,Agence_mtn_Cotonou,300000,114301,2022-10-03
CASH_OUT,57962,Rémy de la Roux,73557,15595,Agence_mtn_Abomey,300000,242038,2022-10-10
CASH_IN,177685,Agence_mtn_Abomey,300000,122315,Rémy de la Roux,15595,193280,2022-10-10
CASH_IN,235301,Agence_mtn_Abomey,300000,64699,Rémy de la Roux,193280,428581,2022-10-16
TRANSFER,4277,Margot Renaud,5311,1034,Rémy de la Roux,428581,432858,2022-10-18
CASH_IN,192109,Agence_mtn_Ouidah,300000,107891,Raymond Rossi,53593,245702,2022-10-01
TRANSFER,20514,Marine Chauvet-Potier,53822,33308,Raymond Rossi,245702,266216,2022-10-04
CASH_OUT,197609,Raymond Rossi,266216,68607,Agence_mtn_Abomey,300000,102391,2022-10-05
TRANSFER,365037,Antoine Leleu,607303,242266,Raymond Rossi,68607,433644,2022-10-06
CASH_IN,255726,Agence_mtn_Abomey,300000,44274,Raymond Rossi,433644,689370,2022-10-06
CASH_IN,185334,Agence_mtn_Abomey,300000,114666,Raymond Rossi,689370,874704,2022-10-07
TRANSFER,517229,Franck-Charles Texier,904243,387014,Raymond Rossi,874704,1391933,2022-10-09
TRANSFER,17256,Benjamin Evrard-Marty,122416,105160,Raymond Rossi,1391933,1409189,2022-10-09
TRANSFER,516399,Raymond Rossi,1409189,892790,Valérie Dijoux,89086,-427313,2022-10-10
CASH_IN,233758,Agence_mtn_Cotonou,300000,66242,Raymond Rossi,892790,1126548,2022-10-13
CASH_OUT,863901,Raymond Rossi,1126548,262647,Agence_mtn_Cotonou,300000,-563901,2022-10-13
CASH_OUT,201207,Raymond Rossi,262647,61440,Agence_mtn_Cotonou,300000,98793,2022-10-17
TRANSFER,14858,Marine Chauvet-Potier,33308,18450,Raymond Rossi,61440,76298,2022-10-19
TRANSFER,63344,Raymond Rossi,76298,12954,Alexandrie Delmas,281478,218134,2022-10-19
TRANSFER,11960,Raymond Rossi,12954,994,Cécile Delattre-Arnaud,2202,-9758,2022-10-26
CASH_IN,86668,Agence_mtn_Ouidah,300000,213332,Raymond Rossi,994,87662,2022-10-27
CASH_OUT,425173,Thibault Moreno,708736,283563,Agence_mtn_Abomey,300000,-125173,2022-10-01
TRANSFER,124282,Thibault Moreno,283563,159281,Nath Bruneau,161273,36991,2022-10-02
TRANSFER,436877,Martine Wagner de la Bègue,902821,465944,Thibault Moreno,159281,596158,2022-10-03
TRANSFER,400374,Thibault Moreno,596158,195784,Rémy Le Michaud,49307,-351067,2022-10-04
CASH_OUT,157081,Thibault Moreno,195784,38703,Agence_mtn_Cotonou,300000,142919,2022-10-04
CASH_OUT,32628,Thibault Moreno,38703,6075,Agence_mtn_Ouidah,300000,267372,2022-10-06
CASH_OUT,174,Thibault Moreno,6075,5901,Agence_mtn_Ouidah,300000,299826,2022-10-07
TRANSFER,736,Thibault Moreno,5901,5165,Nath Bruneau,36991,36255,2022-10-08
CASH_OUT,937,Thibault Moreno,5165,4228,Agence_mtn_Abomey,300000,299063,2022-10-09
CASH_IN,146912,Agence_mtn_Ouidah,300000,153088,Thibault Moreno,4228,151140,2022-10-09
TRANSFER,45090,Thibault Moreno,151140,106050,Martine Wagner de la Bègue,465944,420854,2022-10-09
CASH_IN,9005,Agence_mtn_Ouidah,300000,290995,Thibault Moreno,106050,115055,2022-10-11
CASH_IN,194792,Agence_mtn_Abomey,300000,105208,Thibault Moreno,115055,309847,2022-10-12
TRANSFER,9749,Benjamin Evrard-Marty,105160,95411,Thibault Moreno,309847,319596,2022-10-15
CASH_IN,186649,Agence_mtn_Ouidah,300000,113351,Thibault Moreno,319596,506245,2022-10-15
CASH_IN,292463,Agence_mtn_Ouidah,300000,7537,Thibault Moreno,506245,798708,2022-10-16
CASH_OUT,387019,Thibault Moreno,798708,411689,Agence_mtn_Abomey,300000,-87019,2022-10-17
CASH_OUT,57019,Thibault Moreno,411689,354670,Agence_mtn_Cotonou,300000,242981,2022-10-17
CASH_IN,20192,Agence_mtn_Abomey,300000,279808,Thibault Moreno,354670,374862,2022-10-19
CASH_IN,166364,Agence_mtn_Cotonou,300000,133636,Thibault Moreno,374862,541226,2022-10-23
CASH_IN,181461,Agence_mtn_Cotonou,300000,118539,Valentine Richard-Bourdon,-18988,162473,2022-10-04
TRANSFER,291558,Adèle Labbé,293557,1999,Valentine Richard-Bourdon,162473,454031,2022-10-10
CASH_OUT,222610,Valentine Richard-Bourdon,454031,231421,Agence_mtn_Cotonou,300000,77390,2022-10-14
TRANSFER,231420,Valentine Richard-Bourdon,231421,1,Vincent Fournier,76354,-155066,2022-10-15
CASH_IN,223337,Agence_mtn_Cotonou,300000,76663,Valentine Richard-Bourdon,1,223338,2022-10-17
CASH_OUT,540,Valentine Richard-Bourdon,223338,222798,Agence_mtn_Abomey,300000,299460,2022-10-20
CASH_IN,56359,Agence_mtn_Ouidah,300000,243641,Valentine Richard-Bourdon,222798,279157,2022-10-26
CASH_IN,262766,Agence_mtn_Ouidah,300000,37234,Cécile Delattre-Arnaud,-9758,253008,2022-10-01
TRANSFER,15655,Cécile Delattre-Arnaud,253008,237353,Adèle Labbé,1999,-13656,2022-10-02
TRANSFER,131598,Cécile Delattre-Arnaud,237353,105755,Nath Bruneau,36255,-95343,2022-10-04
CASH_IN,36170,Agence_mtn_Ouidah,300000,263830,Cécile Delattre-Arnaud,105755,141925,2022-10-11
CASH_IN,97756,Agence_mtn_Cotonou,300000,202244,Cécile Delattre-Arnaud,141925,239681,2022-10-16
CASH_IN,248428,Agence_mtn_Cotonou,300000,51572,Cécile Delattre-Arnaud,239681,488109,2022-10-16
CASH_OUT,379044,Cécile Delattre-Arnaud,488109,109065,Agence_mtn_Ouidah,300000,-79044,2022-10-17
CASH_OUT,59553,Cécile Delattre-Arnaud,109065,49512,Agence_mtn_Cotonou,300000,240447,2022-10-27
CASH_IN,8347,Agence_mtn_Ouidah,300000,291653,Cécile Delattre-Arnaud,49512,57859,2022-10-27
CASH_OUT,197724,Emmanuelle Georges,1035425,837701,Agence_mtn_Ouidah,300000,102276,2022-10-01
CASH_IN,159241,Agence_mtn_Ouidah,300000,140759,Emmanuelle Georges,837701,996942,2022-10-01
CASH_IN,44208,Agence_mtn_Abomey,300000,255792,Emmanuelle Georges,996942,1041150,2022-10-02
CASH_OUT,878544,Emmanuelle Georges,1041150,162606,Agence_mtn_Abomey,300000,-578544,2022-10-05
TRANSFER,112149,Antoine Leleu,242266,130117,Emmanuelle Georges,162606,274755,2022-10-08
CASH_OUT,46998,Emmanuelle Georges,274755,227757,Agence_mtn_Cotonou,300000,253002,2022-10-09
CASH_OUT,99484,Emmanuelle Georges,227757,128273,Agence_mtn_Cotonou,300000,200516,2022-10-10
CASH_OUT,62415,Emmanuelle Georges,128273,65858,Agence_mtn_Cotonou,300000,237585,2022-10-11
CASH_IN,136155,Agence_mtn_Abomey,300000,163845,Emmanuelle Georges,65858,202013,2022-10-14
CASH_IN,275223,Agence_mtn_Ouidah,300000,24777,Emmanuelle Georges,202013,477236,2022-10-16
TRANSFER,77816,Franck-Charles Texier,387014,309198,Emmanuelle Georges,477236,555052,2022-10-16
CASH_IN,189737,Agence_mtn_Ouidah,300000,110263,Emmanuelle Georges,555052,744789,2022-10-18
TRANSFER,7016,Marine Chauvet-Potier,18450,11434,Emmanuelle Georges,744789,751805,2022-10-18
TRANSFER,280413,Emmanuelle Georges,751805,471392,Alexandrie Delmas,218134,-62279,2022-10-18
TRANSFER,182680,Martine Wagner de la Bègue,420854,238174,Emmanuelle Georges,471392,654072,2022-10-18
CASH_IN,141407,Agence_mtn_Ouidah,300000,158593,Emmanuelle Georges,654072,795479,2022-10-18
CASH_IN,99032,Agence_mtn_Ouidah,300000,200968,Emmanuelle Georges,795479,894511,2022-10-20
TRANSFER,519,Margot Renaud,1034,515,Emmanuelle Georges,894511,895030,2022-10-21
CASH_OUT,840896,Emmanuelle Georges,895030,54134,Agence_mtn_Abomey,300000,-540896,2022-10-24
CASH_IN,200006,Agence_mtn_Cotonou,300000,99994,Franck-Charles Texier,309198,509204,2022-10-06
CASH_IN,166241,Agence_mtn_Cotonou,300000,133759,Franck-Charles Texier,509204,675445,2022-10-07
CASH_IN,106836,Agence_mtn_Ouidah,300000,193164,Franck-Charles Texier,675445,782281,2022-10-07
TRANSFER,109545,Franck-Charles Texier,782281,672736,Antoine Leleu,130117,20572,2022-10-09
CASH_OUT,130935,Franck-Charles Texier,672736,541801,Agence_mtn_Ouidah,300000,169065,2022-10-12
CASH_IN,258635,Agence_mtn_Cotonou,300000,41365,Franck-Charles Texier,541801,800436,2022-10-12
CASH_OUT,651888,Franck-Charles Texier,800436,148548,Agence_mtn_Ouidah,300000,-351888,2022-10-15
CASH_IN,132477,Agence_mtn_Cotonou,300000,167523,Franck-Charles Texier,148548,281025,2022-10-18
CASH_IN,218155,Agence_mtn_Abomey,300000,81845,Franck-Charles Texier,281025,499180,2022-10-26
CASH_OUT,64771,Franck-Charles Texier,499180,434409,Agence_mtn_Cotonou,300000,235229,2022-10-26
CASH_IN,51924,Agence_mtn_Abomey,300000,248076,Simone Pineau,-157509,-105585,2022-10-01
CASH_IN,260753,Agence_mtn_Ouidah,300000,39247,Simone Pineau,-105585,155168,2022-10-02
TRANSFER,1128,Simone Pineau,155168,154040,Benjamin Evrard-Marty,95411,94283,2022-10-02
CASH_OUT,51037,Simone Pineau,154040,103003,Agence_mtn_Ouidah,300000,248963,2022-10-04
TRANSFER,18952,Antoine Leleu,20572,1620,Simone Pineau,103003,121955,2022-10-07
CASH_IN,61777,Agence_mtn_Ouidah,300000,238223,Simone Pineau,121955,183732,2022-10-10
CASH_IN,209633,Agence_mtn_Abomey,300000,90367,Simone Pineau,183732,393365,2022-10-14
CASH_OUT,287528,Simone Pineau,393365,105837,Agence_mtn_Ouidah,300000,12472,2022-10-17
CASH_IN,298027,Agence_mtn_Ouidah,300000,1973,Simone Pineau,105837,403864,2022-10-19
TRANSFER,398034,Simone Pineau,403864,5830,Simone Pineau,403864,5830,2022-10-20
TRANSFER,1431,Antoine Leleu,1620,189,Simone Pineau,5830,7261,2022-10-23
CASH_OUT,1466,Simone Pineau,7261,5795,Agence_mtn_Ouidah,300000,298534,2022-10-25
CASH_OUT,3713,Simone Pineau,5795,2082,Agence_mtn_Ouidah,300000,296287,2022-10-27
CASH_IN,257138,Agence_mtn_Abomey,300000,42862,David Guérin,-9878,247260,2022-10-01
CASH_OUT,237806,David Guérin,247260,9454,Agence_mtn_Cotonou,300000,62194,2022-10-03
TRANSFER,7888,David Guérin,9454,1566,Alphonse Le Olivier,966900,959012,2022-10-04
CASH_OUT,1016,David Guérin,1566,550,Agence_mtn_Ouidah,300000,298984,2022-10-04
CASH_OUT,253,David Guérin,550,297,Agence_mtn_Ouidah,300000,299747,2022-10-05
CASH_IN,64296,Agence_mtn_Ouidah,300000,235704,David Guérin,297,64593,2022-10-08
TRANSFER,21698,David Guérin,64593,42895,David Guérin,64593,42895,2022-10-09
CASH_IN,209741,Agence_mtn_Abomey,300000,90259,David Guérin,42895,252636,2022-10-12
TRANSFER,1601,Martine Wagner de la Bègue,238174,236573,David Guérin,252636,254237,2022-10-14
CASH_IN,260695,Agence_mtn_Abomey,300000,39305,David Guérin,254237,514932,2022-10-17
TRANSFER,125343,David Guérin,514932,389589,Marine Chauvet-Potier,11434,-113909,2022-10-18
TRANSFER,154687,David Guérin,389589,234902,David Guérin,389589,234902,2022-10-19
CASH_OUT,216158,David Guérin,234902,18744,Agence_mtn_Cotonou,300000,83842,2022-10-21
CASH_IN,256109,Agence_mtn_Ouidah,300000,43891,David Guérin,18744,274853,2022-10-22
CASH_IN,15796,Agence_mtn_Cotonou,300000,284204,David Guérin,274853,290649,2022-10-23
TRANSFER,138740,David Guérin,290649,151909,Alphonse Le Olivier,959012,820272,2022-10-24
CASH_IN,293193,Agence_mtn_Ouidah,300000,6807,David Guérin,151909,445102,2022-10-24
CASH_IN,56249,Agence_mtn_Cotonou,300000,243751,Théodore De Oliveira-Nicolas,-10938,45311,2022-10-03
CASH_IN,297162,Agence_mtn_Ouidah,300000,2838,Théodore De Oliveira-Nicolas,45311,342473,2022-10-04
CASH_IN,185986,Agence_mtn_Cotonou,300000,114014,Théodore De Oliveira-Nicolas,342473,528459,2022-10-12
TRANSFER,4024,Laurent-Bertrand Lefort,11900,7876,Théodore De Oliveira-Nicolas,528459,532483,2022-10-14
CASH_OUT,44343,Théodore De Oliveira-Nicolas,532483,488140,Agence_mtn_Ouidah,300000,255657,2022-10-15
CASH_IN,239676,Agence_mtn_Abomey,300000,60324,Théodore De Oliveira-Nicolas,488140,727816,2022-10-15
CASH_IN,27245,Agence_mtn_Ouidah,300000,272755,Théodore De Oliveira-Nicolas,727816,755061,2022-10-17
TRANSFER,56486,Benjamin Evrard-Marty,94283,37797,Théodore De Oliveira-Nicolas,755061,811547,2022-10-19
CASH_OUT,411233,Théodore De Oliveira-Nicolas,811547,400314,Agence_mtn_Abomey,300000,-111233,2022-10-19
CASH_OUT,81596,Théodore De Oliveira-Nicolas,400314,318718,Agence_mtn_Ouidah,300000,218404,2022-10-23
CASH_IN,48182,Agence_mtn_Cotonou,300000,251818,Théodore De Oliveira-Nicolas,318718,366900,2022-10-23
TRANSFER,183754,Théodore De Oliveira-Nicolas,366900,183146,Benjamin Evrard-Marty,37797,-145957,2022-10-24
CASH_IN,134343,Agence_mtn_Abomey,300000,165657,Théodore De Oliveira-Nicolas,183146,317489,2022-10-26
CASH_OUT,230635,Théodore De Oliveira-Nicolas,317489,86854,Agence_mtn_Abomey,300000,69365,2022-10-27
CASH_IN,142934,Agence_mtn_Ouidah,300000,157066,Vincent Fournier,-155066,-12132,2022-10-04
CASH_IN,122256,Agence_mtn_Cotonou,300000,177744,Vincent Fournier,-12132,110124,2022-10-04
CASH_IN,239298,Agence_mtn_Ouidah,300000,60702,Vincent Fournier,110124,349422,2022-10-07
CASH_OUT,216284,Vincent Fournier,349422,133138,Agence_mtn_Ouidah,300000,83716,2022-10-09
TRANSFER,27663,Vincent Fournier,133138,105475,Martine Wagner de la Bègue,236573,208910,2022-10-17
CASH_OUT,18754,Vincent Fournier,105475,86721,Agence_mtn_Cotonou,300000,281246,2022-10-24
CASH_IN,151506,Agence_mtn_Cotonou,300000,148494,Vincent Fournier,86721,238227,2022-10-26
CASH_IN,92137,Agence_mtn_Ouidah,300000,207863,Joséphine Gros,-1940359,-1848222,2022-10-02
CASH_IN,65003,Agence_mtn_Ouidah,300000,234997,Joséphine Gros,-1848222,-1783219,2022-10-02
CASH_IN,68336,Agence_mtn_Ouidah,300000,231664,Joséphine Gros,-1783219,-1714883,2022-10-08
CASH_IN,221732,Agence_mtn_Cotonou,300000,78268,Joséphine Gros,-1714883,-1493151,2022-10-10
CASH_IN,260614,Agence_mtn_Ouidah,300000,39386,Joséphine Gros,-1493151,-1232537,2022-10-11
CASH_IN,212512,Agence_mtn_Abomey,300000,87488,Joséphine Gros,-1232537,-1020025,2022-10-14
CASH_IN,123137,Agence_mtn_Ouidah,300000,176863,Joséphine Gros,-1020025,-896888,2022-10-15
CASH_IN,83139,Agence_mtn_Ouidah,300000,216861,Joséphine Gros,-896888,-813749,2022-10-18
CASH_IN,71679,Agence_mtn_Ouidah,300000,228321,Joséphine Gros,-813749,-742070,2022-10-18
CASH_IN,58414,Agence_mtn_Abomey,300000,241586,Joséphine Gros,-742070,-683656,2022-10-21
CASH_IN,264163,Agence_mtn_Cotonou,300000,35837,Joséphine Gros,-683656,-419493,2022-10-22
CASH_IN,124707,Agence_mtn_Abomey,300000,175293,Joséphine Gros,-419493,-294786,2022-10-24
CASH_IN,4518,Agence_mtn_Abomey,300000,295482,Joséphine Gros,-294786,-290268,2022-10-27
CASH_OUT,297,Margot Renaud,515,218,Agence_mtn_Cotonou,300000,299703,2022-10-01
TRANSFER,198,Margot Renaud,218,20,Martine Wagner de la Bègue,208910,208712,2022-10-02
CASH_IN,70922,Agence_mtn_Ouidah,300000,229078,Margot Renaud,20,70942,2022-10-03
CASH_IN,273758,Agence_mtn_Abomey,300000,26242,Margot Renaud,70942,344700,2022-10-07
TRANSFER,325446,Margot Renaud,344700,19254,Margot Renaud,344700,19254,2022-10-07
CASH_OUT,11784,Margot Renaud,19254,7470,Agence_mtn_Ouidah,300000,288216,2022-10-08
CASH_OUT,2621,Margot Renaud,7470,4849,Agence_mtn_Ouidah,300000,297379,2022-10-08
TRANSFER,244,Margot Renaud,4849,4605,Laurent-Bertrand Lefort,7876,7632,2022-10-10
CASH_OUT,385,Margot Renaud,4605,4220,Agence_mtn_Cotonou,300000,299615,2022-10-10
CASH_IN,130909,Agence_mtn_Abomey,300000,169091,Margot Renaud,4220,135129,2022-10-13
CASH_OUT,61855,Margot Renaud,135129,73274,Agence_mtn_Ouidah,300000,238145,2022-10-15
CASH_IN,58891,Agence_mtn_Abomey,300000,241109,Margot Renaud,73274,132165,2022-10-22
CASH_IN,285920,Agence_mtn_Abomey,300000,14080,Margot Renaud,132165,418085,2022-10-23
TRANSFER,178308,Margot Renaud,418085,239777,Martine Wagner de la Bègue,208712,30404,2022-10-23
CASH_OUT,228080,Margot Renaud,239777,11697,Agence_mtn_Cotonou,300000,71920,2022-10-23
TRANSFER,14781,Martine Wagner de la Bègue,30404,15623,Margot Renaud,11697,26478,2022-10-24
CASH_IN,291766,Agence_mtn_Abomey,300000,8234,Margot Renaud,26478,318244,2022-10-25
CASH_IN,175512,Agence_mtn_Abomey,300000,124488,Nathalie Pages,-985,174527,2022-10-01
CASH_OUT,54162,Nathalie Pages,174527,120365,Agence_mtn_Abomey,300000,245838,2022-10-01
CASH_OUT,113531,Nathalie Pages,120365,6834,Agence_mtn_Abomey,300000,186469,2022-10-02
CASH_IN,245228,Agence_mtn_Cotonou,300000,54772,Nathalie Pages,6834,252062,2022-10-02
CASH_OUT,203526,Nathalie Pages,252062,48536,Agence_mtn_Abomey,300000,96474,2022-10-03
CASH_IN,63725,Agence_mtn_Cotonou,300000,236275,Nathalie Pages,48536,112261,2022-10-06
CASH_OUT,102460,Nathalie Pages,112261,9801,Agence_mtn_Abomey,300000,197540,2022-10-08
CASH_IN,123304,Agence_mtn_Ouidah,300000,176696,Nathalie Pages,9801,133105,2022-10-09
CASH_IN,74830,Agence_mtn_Ouidah,300000,225170,Nathalie Pages,133105,207935,2022-10-13
CASH_OUT,24481,Nathalie Pages,207935,183454,Agence_mtn_Ouidah,300000,275519,2022-10-13
CASH_OUT,50668,Nathalie Pages,183454,132786,Agence_mtn_Abomey,300000,249332,2022-10-15
TRANSFER,599,Laurent-Bertrand Lefort,7632,7033,Nathalie Pages,132786,133385,2022-10-18
TRANSFER,5738,Laurent-Bertrand Lefort,7033,1295,Nathalie Pages,133385,139123,2022-10-20
TRANSFER,702,Laurent-Bertrand Lefort,1295,593,Nathalie Pages,139123,139825,2022-10-22
TRANSFER,643017,Alphonse Le Olivier,820272,177255,Nathalie Pages,139825,782842,2022-10-24
CASH_OUT,391526,Nathalie Pages,782842,391316,Agence_mtn_Cotonou,300000,-91526,2022-10-25
CASH_IN,241399,Agence_mtn_Cotonou,300000,58601,Adèle Labbé,-13656,227743,2022-10-02
TRANSFER,179,Laurent-Bertrand Lefort,593,414,Adèle Labbé,227743,227922,2022-10-04
TRANSFER,137279,Adèle Labbé,227922,90643,Martine Wagner de la Bègue,15623,-121656,2022-10-08
TRANSFER,39766,Alphonse Le Olivier,177255,137489,Adèle Labbé,90643,130409,2022-10-08
CASH_OUT,58058,Adèle Labbé,130409,72351,Agence_mtn_Cotonou,300000,241942,2022-10-10
TRANSFER,49686,Adèle Labbé,72351,22665,Adèle Labbé,72351,22665,2022-10-11
TRANSFER,11666,Adèle Labbé,22665,10999,Laurent-Bertrand Lefort,414,-11252,2022-10-15
CASH_IN,95641,Agence_mtn_Ouidah,300000,204359,Adèle Labbé,10999,106640,2022-10-16
CASH_IN,113432,Agence_mtn_Cotonou,300000,186568,Adèle Labbé,106640,220072,2022-10-17
CASH_IN,9780,Agence_mtn_Cotonou,300000,290220,Adèle Labbé,220072,229852,2022-10-17
CASH_OUT,24956,Adèle Labbé,229852,204896,Agence_mtn_Ouidah,300000,275044,2022-10-21
CASH_OUT,39726,Adèle Labbé,204896,165170,Agence_mtn_Abomey,300000,260274,2022-10-21
CASH_OUT,154163,Adèle Labbé,165170,11007,Agence_mtn_Ouidah,300000,145837,2022-10-21
CASH_OUT,7956,Adèle Labbé,11007,3051,Agence_mtn_Abomey,300000,292044,2022-10-23
CASH_IN,142015,Agence_mtn_Cotonou,300000,157985,Adèle Labbé,3051,145066,2022-10-24
CASH_OUT,57991,Adèle Labbé,145066,87075,Agence_mtn_Abomey,300000,242009,2022-10-24
CASH_OUT,81219,Adèle Labbé,87075,5856,Agence_mtn_Abomey,300000,218781,2022-10-24
CASH_IN,221047,Agence_mtn_Cotonou,300000,78953,Adèle Labbé,5856,226903,2022-10-26
CASH_IN,36438,Agence_mtn_Ouidah,300000,263562,Adèle Labbé,226903,263341,2022-10-27
CASH_IN,109346,Agence_mtn_Cotonou,300000,190654,Philippine Courtois,-301066,-191720,2022-10-01
CASH_IN,211135,Agence_mtn_Abomey,300000,88865,Philippine Courtois,-191720,19415,2022-10-04
CASH_IN,244715,Agence_mtn_Ouidah,300000,55285,Philippine Courtois,19415,264130,2022-10-04
CASH_IN,259445,Agence_mtn_Cotonou,300000,40555,Philippine Courtois,264130,523575,2022-10-06
CASH_OUT,232625,Philippine Courtois,523575,290950,Agence_mtn_Abomey,300000,67375,2022-10-07
CASH_IN,1908,Agence_mtn_Ouidah,300000,298092,Philippine Courtois,290950,292858,2022-10-10
TRANSFER,19130,Alphonse Le Olivier,137489,118359,Philippine Courtois,292858,311988,2022-10-10
CASH_OUT,288508,Philippine Courtois,311988,23480,Agence_mtn_Ouidah,300000,11492,2022-10-10
CASH_OUT,6775,Philippine Courtois,23480,16705,Agence_mtn_Cotonou,300000,293225,2022-10-11
TRANSFER,14754,Philippine Courtois,16705,1951,Alphonse Le Olivier,118359,103605,2022-10-11
CASH_OUT,1894,Philippine Courtois,1951,57,Agence_mtn_Ouidah,300000,298106,2022-10-11
CASH_IN,32267,Agence_mtn_Ouidah,300000,267733,Philippine Courtois,57,32324,2022-10-13
TRANSFER,27936,Philippine Courtois,32324,4388,Alphonse Le Olivier,103605,75669,2022-10-14
TRANSFER,1155,Philippine Courtois,4388,3233,Philippine Courtois,4388,3233,2022-10-15
CASH_OUT,1629,Philippine Courtois,3233,1604,Agence_mtn_Abomey,300000,298371,2022-10-18
CASH_OUT,1021,Philippine Courtois,1604,583,Agence_mtn_Abomey,300000,298979,2022-10-18
CASH_IN,269492,Agence_mtn_Ouidah,300000,30508,Philippine Courtois,583,270075,2022-10-20
CASH_IN,280798,Agence_mtn_Ouidah,300000,19202,Philippine Courtois,270075,550873,2022-10-21
TRANSFER,41908,Alphonse Le Olivier,75669,33761,Philippine Courtois,550873,592781,2022-10-23
CASH_OUT,58576,Philippine Courtois,592781,534205,Agence_mtn_Cotonou,300000,241424,2022-10-23
CASH_IN,251174,Agence_mtn_Cotonou,300000,48826,Sophie Lévêque,-325084,-73910,2022-10-02
CASH_IN,247626,Agence_mtn_Ouidah,300000,52374,Sophie Lévêque,-73910,173716,2022-10-08
TRANSFER,114462,Sophie Lévêque,173716,59254,Alphonse Le Olivier,33761,-80701,2022-10-11
CASH_OUT,45023,Sophie Lévêque,59254,14231,Agence_mtn_Cotonou,300000,254977,2022-10-13
CASH_OUT,8386,Sophie Lévêque,14231,5845,Agence_mtn_Abomey,300000,291614,2022-10-22
CASH_IN,83623,Agence_mtn_Cotonou,300000,216377,Sophie Lévêque,5845,89468,2022-10-27
CASH_IN,140127,Agence_mtn_Abomey,300000,159873,Valérie Dijoux,-427313,-287186,2022-10-09
CASH_IN,135039,Agence_mtn_Cotonou,300000,164961,Valérie Dijoux,-287186,-152147,2022-10-14
CASH_IN,216821,Agence_mtn_Abomey,300000,83179,Valérie Dijoux,-152147,64674,2022-10-14
CASH_OUT,6356,Valérie Dijoux,64674,58318,Agence_mtn_Cotonou,300000,293644,2022-10-17
CASH_OUT,25750,Valérie Dijoux,58318,32568,Agence_mtn_Abomey,300000,274250,2022-10-21
CASH_IN,147235,Agence_mtn_Ouidah,300000,152765,Valérie Dijoux,32568,179803,2022-10-22
CASH_IN,198967,Agence_mtn_Ouidah,300000,101033,Pénélope Dupuis,-898841,-699874,2022-10-02
CASH_IN,119951,Agence_mtn_Ouidah,300000,180049,Pénélope Dupuis,-699874,-579923,2022-10-04
CASH_IN,150965,Agence_mtn_Ouidah,300000,149035,Pénélope Dupuis,-579923,-428958,2022-10-06
CASH_IN,41141,Agence_mtn_Abomey,300000,258859,Pénélope Dupuis,-428958,-387817,2022-10-07
CASH_IN,149276,Agence_mtn_Ouidah,300000,150724,Pénélope Dupuis,-387817,-238541,2022-10-14
CASH_IN,77582,Agence_mtn_Cotonou,300000,222418,Pénélope Dupuis,-238541,-160959,2022-10-16
CASH_IN,181651,Agence_mtn_Cotonou,300000,118349,Pénélope Dupuis,-160959,20692,2022-10-18
CASH_IN,61989,Agence_mtn_Cotonou,300000,238011,Pénélope Dupuis,20692,82681,2022-10-21
CASH_IN,52166,Agence_mtn_Abomey,300000,247834,Pénélope Dupuis,82681,134847,2022-10-23
CASH_OUT,49454,Pénélope Dupuis,134847,85393,Agence_mtn_Abomey,300000,250546,2022-10-24
CASH_IN,103490,Agence_mtn_Cotonou,300000,196510,Tristan Thomas,-768176,-664686,2022-10-04
CASH_IN,240900,Agence_mtn_Cotonou,300000,59100,Tristan Thomas,-664686,-423786,2022-10-09
CASH_IN,40754,Agence_mtn_Cotonou,300000,259246,Tristan Thomas,-423786,-383032,2022-10-17
CASH_IN,147962,Agence_mtn_Ouidah,300000,152038,Tristan Thomas,-383032,-235070,2022-10-19
CASH_IN,293027,Agence_mtn_Ouidah,300000,6973,Tristan Thomas,-235070,57957,2022-10-25
CASH_IN,211553,Agence_mtn_Ouidah,300000,88447,Marie Picard,-137025,74528,2022-10-15
TRANSFER,52413,Marie Picard,74528,22115,Marie Picard,74528,126941,2022-10-16
CASH_OUT,6288,Marie Picard,22115,15827,Agence_mtn_Cotonou,300000,293712,2022-10-21
TRANSFER,6607,Marie Picard,15827,9220,Marie Picard,15827,9220,2022-10-22
CASH_OUT,4308,Marie Picard,9220,4912,Agence_mtn_Cotonou,300000,295692,2022-10-23
CASH_IN,62996,Agence_mtn_Ouidah,300000,237004,Marie Picard,4912,67908,2022-10-26
CASH_IN,113565,Agence_mtn_Cotonou,300000,186435,Marie Picard,67908,181473,2022-10-27
CASH_OUT,32599,Marie Picard,181473,148874,Agence_mtn_Ouidah,300000,267401,2022-10-27
CASH_IN,252650,Agence_mtn_Abomey,300000,47350,Benjamin Evrard-Marty,-145957,106693,2022-10-01
TRANSFER,33406,Benjamin Evrard-Marty,106693,73287,Benjamin Evrard-Marty,106693,73287,2022-10-01
CASH_IN,79250,Agence_mtn_Abomey,300000,220750,Benjamin Evrard-Marty,73287,152537,2022-10-06
CASH_IN,99243,Agence_mtn_Abomey,300000,200757,Benjamin Evrard-Marty,152537,251780,2022-10-06
CASH_IN,114239,Agence_mtn_Abomey,300000,185761,Benjamin Evrard-Marty,251780,366019,2022-10-07
CASH_IN,30354,Agence_mtn_Cotonou,300000,269646,Benjamin Evrard-Marty,366019,396373,2022-10-20
CASH_IN,198993,Agence_mtn_Ouidah,300000,101007,Xavier de Lebreton,-12934,186059,2022-10-03
CASH_OUT,124967,Xavier de Lebreton,186059,61092,Agence_mtn_Ouidah,300000,175033,2022-10-03
CASH_IN,90293,Agence_mtn_Abomey,300000,209707,Xavier de Lebreton,61092,151385,2022-10-05
TRANSFER,47781,Xavier de Lebreton,151385,103604,Xavier de Lebreton,151385,103604,2022-10-05
TRANSFER,53856,Xavier de Lebreton,103604,49748,Xavier de Lebreton,103604,49748,2022-10-05
TRANSFER,18556,Xavier de Lebreton,49748,31192,Xavier de Lebreton,49748,31192,2022-10-06
CASH_IN,187553,Agence_mtn_Abomey,300000,112447,Xavier de Lebreton,31192,218745,2022-10-06
CASH_OUT,129099,Xavier de Lebreton,218745,89646,Agence_mtn_Cotonou,300000,170901,2022-10-12
CASH_IN,254378,Agence_mtn_Cotonou,300000,45622,Xavier de Lebreton,89646,344024,2022-10-14
CASH_OUT,92464,Xavier de Lebreton,344024,251560,Agence_mtn_Ouidah,300000,207536,2022-10-15
CASH_IN,8877,Agence_mtn_Cotonou,300000,291123,Xavier de Lebreton,251560,260437,2022-10-19
CASH_IN,29402,Agence_mtn_Abomey,300000,270598,Xavier de Lebreton,260437,289839,2022-10-22
CASH_OUT,64837,Xavier de Lebreton,289839,225002,Agence_mtn_Ouidah,300000,235163,2022-10-22
CASH_OUT,4839,Xavier de Lebreton,225002,220163,Agence_mtn_Abomey,300000,295161,2022-10-23
CASH_IN,209750,Agence_mtn_Cotonou,300000,90250,Xavier de Lebreton,220163,429913,2022-10-23
CASH_IN,10158,Agence_mtn_Ouidah,300000,289842,Xavier de Lebreton,429913,440071,2022-10-25
CASH_IN,213169,Agence_mtn_Ouidah,300000,86831,Xavier de Lebreton,440071,653240,2022-10-25
CASH_OUT,16962,Xavier de Lebreton,653240,636278,Agence_mtn_Cotonou,300000,283038,2022-10-27
CASH_IN,216211,Agence_mtn_Cotonou,300000,83789,Antoinette Bertrand,-31245,184966,2022-10-01
CASH_IN,281795,Agence_mtn_Cotonou,300000,18205,Antoinette Bertrand,184966,466761,2022-10-01
TRANSFER,455192,Antoinette Bertrand,466761,11569,Antoinette Bertrand,466761,11569,2022-10-03
TRANSFER,1747,Antoinette Bertrand,11569,9822,Antoinette Bertrand,11569,9822,2022-10-05
CASH_IN,139914,Agence_mtn_Cotonou,300000,160086,Antoinette Bertrand,9822,149736,2022-10-06
TRANSFER,97254,Antoinette Bertrand,149736,52482,Antoinette Bertrand,149736,52482,2022-10-08
CASH_OUT,40519,Antoinette Bertrand,52482,11963,Agence_mtn_Cotonou,300000,259481,2022-10-12
TRANSFER,3883,Antoinette Bertrand,11963,8080,Antoinette Bertrand,11963,8080,2022-10-13
TRANSFER,6785,Antoinette Bertrand,8080,1295,Antoinette Bertrand,8080,1295,2022-10-14
CASH_OUT,440,Antoinette Bertrand,1295,855,Agence_mtn_Abomey,300000,299560,2022-10-15
TRANSFER,664,Antoinette Bertrand,855,191,Antoinette Bertrand,855,1519,2022-10-17
CASH_IN,69842,Agence_mtn_Abomey,300000,230158,Antoinette Bertrand,191,70033,2022-10-20
CASH_OUT,58924,Antoinette Bertrand,70033,11109,Agence_mtn_Cotonou,300000,241076,2022-10-20
CASH_OUT,2322,Antoinette Bertrand,11109,8787,Agence_mtn_Ouidah,300000,297678,2022-10-21
CASH_IN,118193,Agence_mtn_Abomey,300000,181807,Antoinette Bertrand,8787,126980,2022-10-21
CASH_OUT,106760,Antoinette Bertrand,126980,20220,Agence_mtn_Abomey,300000,193240,2022-10-22
CASH_IN,10266,Agence_mtn_Abomey,300000,289734,Antoinette Bertrand,20220,30486,2022-10-25
CASH_IN,72944,Agence_mtn_Ouidah,300000,227056,Édouard Nguyen,-85186,-12242,2022-10-04
CASH_IN,190621,Agence_mtn_Ouidah,300000,109379,Édouard Nguyen,-12242,178379,2022-10-07
CASH_OUT,27218,Édouard Nguyen,178379,151161,Agence_mtn_Abomey,300000,272782,2022-10-08
CASH_IN,219266,Agence_mtn_Abomey,300000,80734,Édouard Nguyen,151161,370427,2022-10-09
CASH_OUT,27719,Édouard Nguyen,370427,342708,Agence_mtn_Ouidah,300000,272281,2022-10-09
TRANSFER,57049,Édouard Nguyen,342708,285659,Édouard Nguyen,342708,399757,2022-10-13
CASH_OUT,164919,Édouard Nguyen,285659,120740,Agence_mtn_Ouidah,300000,135081,2022-10-14
TRANSFER,98142,Édouard Nguyen,120740,22598,Édouard Nguyen,120740,22598,2022-10-19
TRANSFER,5832,Édouard Nguyen,22598,16766,Édouard Nguyen,22598,28430,2022-10-20
CASH_IN,105159,Agence_mtn_Abomey,300000,194841,Édouard Nguyen,16766,121925,2022-10-21
CASH_OUT,101196,Édouard Nguyen,121925,20729,Agence_mtn_Ouidah,300000,198804,2022-10-24
CASH_OUT,7218,Édouard Nguyen,20729,13511,Agence_mtn_Abomey,300000,292782,2022-10-25
CASH_IN,283786,Agence_mtn_Ouidah,300000,16214,Marine Chauvet-Potier,-113909,169877,2022-10-05
CASH_OUT,81858,Marine Chauvet-Potier,169877,88019,Agence_mtn_Ouidah,300000,218142,2022-10-07
CASH_IN,26748,Agence_mtn_Ouidah,300000,273252,Marine Chauvet-Potier,88019,114767,2022-10-08
CASH_OUT,49305,Marine Chauvet-Potier,114767,65462,Agence_mtn_Ouidah,300000,250695,2022-10-09
CASH_IN,91536,Agence_mtn_Cotonou,300000,208464,Marine Chauvet-Potier,65462,156998,2022-10-09
CASH_IN,192082,Agence_mtn_Ouidah,300000,107918,Marine Chauvet-Potier,156998,349080,2022-10-12
CASH_OUT,295259,Marine Chauvet-Potier,349080,53821,Agence_mtn_Ouidah,300000,4741,2022-10-24
CASH_OUT,3340,Marine Chauvet-Potier,53821,50481,Agence_mtn_Abomey,300000,296660,2022-10-25
CASH_OUT,38542,Marine Chauvet-Potier,50481,11939,Agence_mtn_Ouidah,300000,261458,2022-10-26
CASH_IN,169474,Agence_mtn_Ouidah,300000,130526,William Lebrun,-14783,154691,2022-10-06
CASH_OUT,46560,William Lebrun,154691,108131,Agence_mtn_Cotonou,300000,253440,2022-10-11
CASH_IN,116362,Agence_mtn_Abomey,300000,183638,William Lebrun,108131,224493,2022-10-11
CASH_OUT,79571,William Lebrun,224493,144922,Agence_mtn_Cotonou,300000,220429,2022-10-12
TRANSFER,62365,William Lebrun,144922,82557,William Lebrun,144922,207287,2022-10-14
CASH_OUT,10911,William Lebrun,82557,71646,Agence_mtn_Ouidah,300000,289089,2022-10-18
TRANSFER,43861,William Lebrun,71646,27785,William Lebrun,71646,115507,2022-10-18
CASH_IN,160828,Agence_mtn_Ouidah,300000,139172,William Lebrun,27785,188613,2022-10-20
CASH_OUT,175769,William Lebrun,188613,12844,Agence_mtn_Ouidah,300000,124231,2022-10-21
CASH_OUT,3971,William Lebrun,12844,8873,Agence_mtn_Ouidah,300000,296029,2022-10-23
CASH_IN,33102,Agence_mtn_Ouidah,300000,266898,William Lebrun,8873,41975,2022-10-24
CASH_IN,226690,Agence_mtn_Abomey,300000,73310,Hortense Lemaire,3,226693,2022-10-05
CASH_IN,250033,Agence_mtn_Abomey,300000,49967,Hortense Lemaire,226693,476726,2022-10-11
CASH_IN,94367,Agence_mtn_Ouidah,300000,205633,Hortense Lemaire,476726,571093,2022-10-11
CASH_IN,256268,Agence_mtn_Ouidah,300000,43732,Hortense Lemaire,571093,827361,2022-10-14
CASH_IN,48753,Agence_mtn_Cotonou,300000,251247,Hortense Lemaire,827361,876114,2022-10-15
CASH_OUT,314127,Hortense Lemaire,876114,561987,Agence_mtn_Ouidah,300000,-14127,2022-10-21
CASH_IN,180049,Agence_mtn_Cotonou,300000,119951,Alphonse Le Olivier,-80701,99348,2022-10-05
CASH_OUT,83331,Alphonse Le Olivier,99348,16017,Agence_mtn_Cotonou,300000,216669,2022-10-06
TRANSFER,10356,Alphonse Le Olivier,16017,5661,Alphonse Le Olivier,16017,26373,2022-10-08
CASH_IN,209340,Agence_mtn_Abomey,300000,90660,Alphonse Le Olivier,5661,215001,2022-10-12
TRANSFER,191802,Alphonse Le Olivier,215001,23199,Alphonse Le Olivier,215001,23199,2022-10-13
CASH_IN,140075,Agence_mtn_Abomey,300000,159925,Alphonse Le Olivier,23199,163274,2022-10-13
CASH_IN,265595,Agence_mtn_Ouidah,300000,34405,Alphonse Le Olivier,163274,428869,2022-10-13
CASH_OUT,30022,Alphonse Le Olivier,428869,398847,Agence_mtn_Abomey,300000,269978,2022-10-16
CASH_OUT,90161,Alphonse Le Olivier,398847,308686,Agence_mtn_Ouidah,300000,209839,2022-10-18
CASH_IN,146192,Agence_mtn_Cotonou,300000,153808,Alphonse Le Olivier,308686,454878,2022-10-21
CASH_OUT,235690,Alphonse Le Olivier,454878,219188,Agence_mtn_Abomey,300000,64310,2022-10-26
CASH_IN,47547,Agence_mtn_Abomey,300000,252453,Adrien Chartier,34,47581,2022-10-01
TRANSFER,608,Adrien Chartier,47581,46973,Adrien Chartier,47581,46973,2022-10-01
CASH_IN,221237,Agence_mtn_Abomey,300000,78763,Adrien Chartier,46973,268210,2022-10-03
CASH_IN,190608,Agence_mtn_Ouidah,300000,109392,Adrien Chartier,268210,458818,2022-10-04
TRANSFER,440379,Adrien Chartier,458818,18439,Adrien Chartier,458818,18439,2022-10-10
CASH_OUT,13774,Adrien Chartier,18439,4665,Agence_mtn_Abomey,300000,286226,2022-10-10
CASH_IN,100260,Agence_mtn_Cotonou,300000,199740,Adrien Chartier,4665,104925,2022-10-11
CASH_IN,196674,Agence_mtn_Abomey,300000,103326,Adrien Chartier,104925,301599,2022-10-11
CASH_OUT,215451,Adrien Chartier,301599,86148,Agence_mtn_Ouidah,300000,84549,2022-10-13
CASH_OUT,27602,Adrien Chartier,86148,58546,Agence_mtn_Cotonou,300000,272398,2022-10-15
CASH_OUT,10487,Adrien Chartier,58546,48059,Agence_mtn_Ouidah,300000,289513,2022-10-16
CASH_OUT,40984,Adrien Chartier,48059,7075,Agence_mtn_Ouidah,300000,259016,2022-10-18
CASH_OUT,3871,Adrien Chartier,7075,3204,Agence_mtn_Abomey,300000,296129,2022-10-20
CASH_OUT,2499,Adrien Chartier,3204,705,Agence_mtn_Cotonou,300000,297501,2022-10-22
CASH_IN,115274,Agence_mtn_Ouidah,300000,184726,Adrien Chartier,705,115979,2022-10-22
CASH_OUT,46675,Adrien Chartier,115979,69304,Agence_mtn_Abomey,300000,253325,2022-10-23
CASH_IN,233297,Agence_mtn_Ouidah,300000,66703,Laurent-Bertrand Lefort,-11252,222045,2022-10-01
CASH_OUT,65437,Laurent-Bertrand Lefort,222045,156608,Agence_mtn_Abomey,300000,234563,2022-10-03
CASH_OUT,20972,Laurent-Bertrand Lefort,156608,135636,Agence_mtn_Ouidah,300000,279028,2022-10-04
TRANSFER,64734,Laurent-Bertrand Lefort,135636,70902,Laurent-Bertrand Lefort,135636,200370,2022-10-05
TRANSFER,56770,Laurent-Bertrand Lefort,70902,14132,Laurent-Bertrand Lefort,70902,14132,2022-10-06
CASH_OUT,7583,Laurent-Bertrand Lefort,14132,6549,Agence_mtn_Ouidah,300000,292417,2022-10-09
CASH_OUT,3669,Laurent-Bertrand Lefort,6549,2880,Agence_mtn_Abomey,300000,296331,2022-10-11
CASH_OUT,2324,Laurent-Bertrand Lefort,2880,556,Agence_mtn_Ouidah,300000,297676,2022-10-13
CASH_OUT,548,Laurent-Bertrand Lefort,556,8,Agence_mtn_Ouidah,300000,299452,2022-10-14
CASH_IN,209441,Agence_mtn_Abomey,300000,90559,Laurent-Bertrand Lefort,8,209449,2022-10-15
CASH_OUT,56457,Laurent-Bertrand Lefort,209449,152992,Agence_mtn_Cotonou,300000,243543,2022-10-17
CASH_IN,269804,Agence_mtn_Cotonou,300000,30196,Laurent-Bertrand Lefort,152992,422796,2022-10-18
CASH_IN,206657,Agence_mtn_Cotonou,300000,93343,Nath Bruneau,-95343,111314,2022-10-07
CASH_IN,30170,Agence_mtn_Ouidah,300000,269830,Nath Bruneau,111314,141484,2022-10-08
CASH_OUT,58592,Nath Bruneau,141484,82892,Agence_mtn_Cotonou,300000,241408,2022-10-12
CASH_OUT,80100,Nath Bruneau,82892,2792,Agence_mtn_Ouidah,300000,219900,2022-10-13
CASH_OUT,775,Nath Bruneau,2792,2017,Agence_mtn_Abomey,300000,299225,2022-10-16
CASH_IN,86381,Agence_mtn_Abomey,300000,213619,Nath Bruneau,2017,88398,2022-10-17
CASH_IN,36669,Agence_mtn_Cotonou,300000,263331,Martine Wagner de la Bègue,-121656,-84987,2022-10-03
CASH_IN,1638,Agence_mtn_Ouidah,300000,298362,Martine Wagner de la Bègue,-84987,-83349,2022-10-06
CASH_IN,65376,Agence_mtn_Abomey,300000,234624,Martine Wagner de la Bègue,-83349,-17973,2022-10-09
CASH_IN,124435,Agence_mtn_Abomey,300000,175565,Martine Wagner de la Bègue,-17973,106462,2022-10-13
CASH_IN,172391,Agence_mtn_Cotonou,300000,127609,Martine Wagner de la Bègue,106462,278853,2022-10-15
CASH_OUT,176839,Martine Wagner de la Bègue,278853,102014,Agence_mtn_Ouidah,300000,123161,2022-10-16
CASH_IN,179422,Agence_mtn_Cotonou,300000,120578,Martine Wagner de la Bègue,102014,281436,2022-10-17
CASH_OUT,56374,Martine Wagner de la Bègue,281436,225062,Agence_mtn_Cotonou,300000,243626,2022-10-20
CASH_IN,139279,Agence_mtn_Abomey,300000,160721,Martine Wagner de la Bègue,225062,364341,2022-10-21
CASH_OUT,95196,Martine Wagner de la Bègue,364341,269145,Agence_mtn_Abomey,300000,204804,2022-10-22
CASH_IN,11081,Agence_mtn_Ouidah,300000,288919,Martine Wagner de la Bègue,269145,280226,2022-10-24
CASH_OUT,38052,Martine Wagner de la Bègue,280226,242174,Agence_mtn_Abomey,300000,261948,2022-10-25
CASH_IN,86985,Agence_mtn_Ouidah,300000,213015,Marcelle Charrier,-590469,-503484,2022-10-01
CASH_IN,138855,Agence_mtn_Ouidah,300000,161145,Marcelle Charrier,-503484,-364629,2022-10-02
CASH_IN,157819,Agence_mtn_Cotonou,300000,142181,Marcelle Charrier,-364629,-206810,2022-10-03
CASH_IN,263107,Agence_mtn_Cotonou,300000,36893,Marcelle Charrier,-206810,56297,2022-10-10
CASH_OUT,31106,Marcelle Charrier,56297,25191,Agence_mtn_Ouidah,300000,268894,2022-10-15
CASH_OUT,10672,Marcelle Charrier,25191,14519,Agence_mtn_Ouidah,300000,289328,2022-10-17
CASH_OUT,4679,Marcelle Charrier,14519,9840,Agence_mtn_Ouidah,300000,295321,2022-10-21
CASH_OUT,4820,Marcelle Charrier,9840,5020,Agence_mtn_Abomey,300000,295180,2022-10-27
CASH_IN,246829,Agence_mtn_Abomey,300000,53171,Richard Le Descamps,-432529,-185700,2022-10-01
CASH_IN,202806,Agence_mtn_Ouidah,300000,97194,Richard Le Descamps,-185700,17106,2022-10-02
CASH_IN,54864,Agence_mtn_Abomey,300000,245136,Richard Le Descamps,17106,71970,2022-10-04
TRANSFER,16925,Richard Le Descamps,71970,55045,Richard Le Descamps,71970,55045,2022-10-04
CASH_IN,228645,Agence_mtn_Abomey,300000,71355,Richard Le Descamps,55045,283690,2022-10-05
CASH_OUT,47461,Richard Le Descamps,283690,236229,Agence_mtn_Cotonou,300000,252539,2022-10-07
CASH_OUT,112910,Richard Le Descamps,236229,123319,Agence_mtn_Ouidah,300000,187090,2022-10-07
CASH_IN,203664,Agence_mtn_Ouidah,300000,96336,Richard Le Descamps,123319,326983,2022-10-08
CASH_OUT,5503,Richard Le Descamps,326983,321480,Agence_mtn_Cotonou,300000,294497,2022-10-10
TRANSFER,28588,Richard Le Descamps,321480,292892,Richard Le Descamps,321480,350068,2022-10-12
CASH_OUT,290233,Richard Le Descamps,292892,2659,Agence_mtn_Abomey,300000,9767,2022-10-14
CASH_OUT,2530,Richard Le Descamps,2659,129,Agence_mtn_Ouidah,300000,297470,2022-10-17
CASH_OUT,115,Richard Le Descamps,129,14,Agence_mtn_Abomey,300000,299885,2022-10-21
CASH_IN,14784,Agence_mtn_Abomey,300000,285216,Richard Le Descamps,14,14798,2022-10-22
CASH_OUT,1342,Richard Le Descamps,14798,13456,Agence_mtn_Ouidah,300000,298658,2022-10-26
CASH_IN,289555,Agence_mtn_Abomey,300000,10445,Alexandrie Delmas,-62279,227276,2022-10-04
CASH_OUT,208885,Alexandrie Delmas,227276,18391,Agence_mtn_Cotonou,300000,91115,2022-10-05
CASH_IN,192701,Agence_mtn_Abomey,300000,107299,Alexandrie Delmas,18391,211092,2022-10-05
CASH_IN,270489,Agence_mtn_Abomey,300000,29511,Alexandrie Delmas,211092,481581,2022-10-06
CASH_OUT,32855,Alexandrie Delmas,481581,448726,Agence_mtn_Abomey,300000,267145,2022-10-06
TRANSFER,107925,Alexandrie Delmas,448726,340801,Alexandrie Delmas,448726,556651,2022-10-06
CASH_IN,91451,Agence_mtn_Cotonou,300000,208549,Alexandrie Delmas,340801,432252,2022-10-07
CASH_OUT,334505,Alexandrie Delmas,432252,97747,Agence_mtn_Cotonou,300000,-34505,2022-10-08
CASH_OUT,45451,Alexandrie Delmas,97747,52296,Agence_mtn_Cotonou,300000,254549,2022-10-13
CASH_OUT,45143,Alexandrie Delmas,52296,7153,Agence_mtn_Abomey,300000,254857,2022-10-17
CASH_OUT,5142,Alexandrie Delmas,7153,2011,Agence_mtn_Ouidah,300000,294858,2022-10-22
CASH_OUT,1117,Alexandrie Delmas,2011,894,Agence_mtn_Ouidah,300000,298883,2022-10-24
CASH_IN,29914,Agence_mtn_Cotonou,300000,270086,Alexandrie Delmas,894,30808,2022-10-24
CASH_IN,177211,Agence_mtn_Abomey,300000,122789,Alexandrie Delmas,30808,208019,2022-10-25
CASH_IN,263269,Agence_mtn_Cotonou,300000,36731,Alexandrie Delmas,208019,471288,2022-10-25
CASH_IN,33244,Agence_mtn_Cotonou,300000,266756,Alexandrie Delmas,471288,504532,2022-10-25
TRANSFER,832104,Cécile Germain,1061500,229396,Raymond Marchal de Nguyen,19500,-812604,2022-11-23
CASH_IN,231582,Agence_mtn_Abomey,300000,68418,Marcelle Charrier,1591000,1822582,2022-11-05
CASH_OUT,928079,Marcelle Charrier,1822582,894503,Agence_mtn_Ouidah,300000,-628079,2022-11-16
CASH_IN,132510,Agence_mtn_Abomey,300000,167490,Marcelle Charrier,894503,1027013,2022-11-19
CASH_IN,284314,Agence_mtn_Abomey,300000,15686,Marcelle Charrier,1027013,1311327,2022-11-19
TRANSFER,1044548,Alexandrie Delmas,1928100,883552,Marine Chauvet-Potier,65100,-979448,2022-11-09
CASH_IN,131788,Agence_mtn_Ouidah,300000,168212,Tristan Thomas,578900,710688,2022-11-05
TRANSFER,66377,Tristan Thomas,710688,644311,Raymond Rossi,1240500,1174123,2022-11-11
CASH_OUT,594251,Tristan Thomas,644311,50060,Agence_mtn_Cotonou,300000,-294251,2022-11-11
CASH_IN,14531,Agence_mtn_Cotonou,300000,285469,Tristan Thomas,50060,64591,2022-11-27
TRANSFER,41230,William Le Lucas,418100,376870,Laure Philippe,1487800,1529030,2022-11-03
CASH_OUT,541346,Laure Philippe,1529030,987684,Agence_mtn_Ouidah,300000,-241346,2022-11-16
CASH_IN,236918,Agence_mtn_Cotonou,300000,63082,Laure Philippe,987684,1224602,2022-11-24
TRANSFER,145413,Alfred du Lesage,551900,406487,Margot Riou du Fernandes,1983000,1837587,2022-11-23
TRANSFER,1322040,Thérèse-Margaux Bruneau,1531800,209760,Alix Maillet,1246200,-75840,2022-11-07
CASH_OUT,78604,Thérèse-Margaux Bruneau,209760,131156,Agence_mtn_Cotonou,300000,221396,2022-11-07
TRANSFER,1263176,Émilie Moulin,1351000,87824,Thérèse-Margaux Bruneau,131156,1394332,2022-11-10
TRANSFER,878535,Gilbert-Charles Thibault,964700,86165,Alphonse Leclercq-Rousseau,1873000,2751535,2022-11-02
CASH_IN,170947,Agence_mtn_Cotonou,300000,129053,Alphonse Leclercq-Rousseau,2751535,2922482,2022-11-07
CASH_IN,177567,Agence_mtn_Cotonou,300000,122433,Raymond Marchal de Nguyen,-812604,-635037,2022-11-06
CASH_IN,262904,Agence_mtn_Ouidah,300000,37096,Raymond Marchal de Nguyen,-635037,-372133,2022-11-07
CASH_IN,220488,Agence_mtn_Ouidah,300000,79512,Raymond Marchal de Nguyen,-372133,-151645,2022-11-10
CASH_IN,201549,Agence_mtn_Abomey,300000,98451,Raymond Marchal de Nguyen,-151645,49904,2022-11-11
TRANSFER,12420,Raymond Marchal de Nguyen,49904,37484,Rémy de la Roux,104200,91780,2022-11-22
CASH_OUT,397235,Thibaut Coulon,724600,327365,Agence_mtn_Cotonou,300000,-97235,2022-11-10
TRANSFER,33413,Thibaut Coulon,327365,293952,Victoire-Nicole Lopez,936100,902687,2022-11-22
TRANSFER,187677,Thibaut Coulon,293952,106275,Joséphine Gros,445500,257823,2022-11-23
TRANSFER,293089,Virginie Le Gall,743300,450211,Thibaut Coulon,106275,399364,2022-11-24
TRANSFER,847626,Martine Wagner de la Bègue,1855400,1007774,Thibault Moreno,1704300,2551926,2022-11-26
TRANSFER,948803,Sébastien Vallée,1796200,847397,Zoé Renaud de Boutin,1892000,2840803,2022-11-06
TRANSFER,2693059,Zoé Renaud de Boutin,2840803,147744,Alphonse Le Olivier,1186500,-1506559,2022-11-06
CASH_IN,108827,Agence_mtn_Cotonou,300000,191173,Zoé Renaud de Boutin,147744,256571,2022-11-10
CASH_IN,175512,Agence_mtn_Cotonou,300000,124488,Zoé Renaud de Boutin,256571,432083,2022-11-18
CASH_IN,184865,Agence_mtn_Abomey,300000,115135,Zoé Renaud de Boutin,432083,616948,2022-11-23
CASH_IN,206750,Agence_mtn_Abomey,300000,93250,Céline Gomez,830100,1036850,2022-11-11
TRANSFER,341942,Alexandre Rémy,479400,137458,Rémy de la Roux,91780,433722,2022-11-01
CASH_OUT,301072,Rémy de la Roux,433722,132650,Agence_mtn_Cotonou,300000,-1072,2022-11-12
CASH_OUT,24477,Rémy de la Roux,132650,108173,Agence_mtn_Cotonou,300000,275523,2022-11-24
CASH_OUT,668777,Isabelle Rossi,821200,152423,Agence_mtn_Ouidah,300000,-368777,2022-11-03
CASH_IN,158941,Agence_mtn_Ouidah,300000,141059,Isabelle Rossi,152423,311364,2022-11-06
TRANSFER,181437,Isabelle Rossi,311364,129927,Gilbert Foucher,349600,168163,2022-11-07
CASH_IN,212094,Agence_mtn_Ouidah,300000,87906,Isabelle Rossi,129927,342021,2022-11-24
CASH_IN,225580,Agence_mtn_Cotonou,300000,74420,Jean Benard,1713000,1938580,2022-11-04
CASH_OUT,402412,Jean Benard,1938580,1536168,Agence_mtn_Abomey,300000,-102412,2022-11-10
CASH_OUT,539850,Jean Benard,1536168,996318,Agence_mtn_Abomey,300000,-239850,2022-11-11
CASH_OUT,236543,Sébastien Lemaître,1615600,1379057,Agence_mtn_Abomey,300000,63457,2022-11-14
CASH_IN,58954,Agence_mtn_Cotonou,300000,241046,Sophie Lévêque,341600,400554,2022-11-03
CASH_IN,249457,Agence_mtn_Ouidah,300000,50543,Sophie Lévêque,400554,650011,2022-11-08
TRANSFER,186945,Sophie Lévêque,650011,463066,Marcelle Paris,1512600,1325655,2022-11-26
CASH_OUT,56258,Éléonore-Hélène Dubois,80200,23942,Agence_mtn_Ouidah,300000,243742,2022-11-04
TRANSFER,15698,Éléonore-Hélène Dubois,23942,8244,Margot Riou du Fernandes,1837587,1821889,2022-11-05
TRANSFER,129653,David du Blondel,1497300,1367647,Éléonore-Hélène Dubois,8244,137897,2022-11-20
TRANSFER,414583,Victoire-Nicole Lopez,902687,488104,Bertrand Le Roux,674900,260317,2022-11-08
TRANSFER,301356,Victoire-Nicole Lopez,488104,186748,Marie Picard,1021700,720344,2022-11-17
CASH_OUT,162512,Victoire-Nicole Lopez,186748,24236,Agence_mtn_Ouidah,300000,137488,2022-11-27
TRANSFER,266873,Nathalie Peron,1442000,1175127,Victoire-Nicole Lopez,24236,291109,2022-11-27
TRANSFER,469303,Antoine Leleu,1972700,1503397,Étienne Roche,1244300,1713603,2022-11-06
CASH_OUT,967777,Étienne Roche,1713603,745826,Agence_mtn_Cotonou,300000,-667777,2022-11-06
TRANSFER,285915,Emmanuelle Georges,666100,380185,Étienne Roche,745826,1031741,2022-11-13
CASH_OUT,574300,Étienne Roche,1031741,457441,Agence_mtn_Ouidah,300000,-274300,2022-11-14
TRANSFER,441196,Étienne Roche,457441,16245,Simone Pineau,1943700,1502504,2022-11-19
CASH_IN,119161,Agence_mtn_Abomey,300000,180839,Édouard Nguyen,1723000,1842161,2022-11-01
CASH_IN,194024,Agence_mtn_Abomey,300000,105976,Édouard Nguyen,1842161,2036185,2022-11-13
TRANSFER,1725311,Édouard Nguyen,2036185,310874,Sophie Gonzalez,767000,-958311,2022-11-14
CASH_IN,58002,Agence_mtn_Cotonou,300000,241998,Édouard Nguyen,310874,368876,2022-11-21
CASH_IN,168288,Agence_mtn_Abomey,300000,131712,Édouard Nguyen,368876,537164,2022-11-26
CASH_IN,274339,Agence_mtn_Abomey,300000,25661,Bertrand Le Roux,260317,534656,2022-11-13
CASH_OUT,359321,Bertrand Le Roux,534656,175335,Agence_mtn_Cotonou,300000,-59321,2022-11-16
CASH_OUT,51522,Bertrand Le Roux,175335,123813,Agence_mtn_Cotonou,300000,248478,2022-11-17
TRANSFER,67824,Rémy Le Michaud,766500,698676,Bertrand Le Roux,123813,191637,2022-11-19
CASH_IN,114842,Agence_mtn_Abomey,300000,185158,Claude Foucher,970600,1085442,2022-11-04
CASH_IN,278511,Agence_mtn_Abomey,300000,21489,Claude Foucher,1085442,1363953,2022-11-10
TRANSFER,555460,Claude Foucher,1363953,808493,Laurent-Bertrand Lefort,962200,406740,2022-11-14
CASH_IN,33228,Agence_mtn_Cotonou,300000,266772,Hortense Lemaire,248300,281528,2022-11-01
CASH_OUT,30605,Hortense Lemaire,281528,250923,Agence_mtn_Abomey,300000,269395,2022-11-02
TRANSFER,88067,Honoré du Laurent,244000,155933,Hortense Lemaire,250923,338990,2022-11-02
TRANSFER,141796,Jeanne Garnier,1955900,1814104,Hortense Lemaire,338990,480786,2022-11-07
CASH_IN,123149,Agence_mtn_Cotonou,300000,176851,Hortense Lemaire,480786,603935,2022-11-07
TRANSFER,652246,Vincent Fournier,683600,31354,Hortense Lemaire,603935,1256181,2022-11-08
TRANSFER,814195,Hortense Lemaire,1256181,441986,Adrien Chartier,939000,124805,2022-11-08
CASH_OUT,349841,Hortense Lemaire,441986,92145,Agence_mtn_Cotonou,300000,-49841,2022-11-08
TRANSFER,58073,Hortense Lemaire,92145,34072,William Le Lucas,376870,318797,2022-11-09
CASH_OUT,17919,Hortense Lemaire,34072,16153,Agence_mtn_Abomey,300000,282081,2022-11-11
CASH_IN,148512,Agence_mtn_Cotonou,300000,151488,Hortense Lemaire,16153,164665,2022-11-13
CASH_OUT,126092,Hortense Lemaire,164665,38573,Agence_mtn_Abomey,300000,173908,2022-11-13
TRANSFER,28394,Hortense Lemaire,38573,10179,Martine Wagner de la Bègue,1007774,979380,2022-11-14
TRANSFER,666080,Antoine Leleu,1503397,837317,Hortense Lemaire,10179,676259,2022-11-17
CASH_IN,273100,Agence_mtn_Abomey,300000,26900,Hortense Lemaire,676259,949359,2022-11-18
CASH_IN,186589,Agence_mtn_Abomey,300000,113411,Hortense Lemaire,949359,1135948,2022-11-18
TRANSFER,384756,Richard Le Descamps,789000,404244,Hortense Lemaire,1135948,1520704,2022-11-19
CASH_IN,26448,Agence_mtn_Abomey,300000,273552,Hortense Lemaire,1520704,1547152,2022-11-20
CASH_OUT,429967,Hortense Lemaire,1547152,1117185,Agence_mtn_Abomey,300000,-129967,2022-11-21
CASH_IN,202785,Agence_mtn_Ouidah,300000,97215,Hortense Lemaire,1117185,1319970,2022-11-23
TRANSFER,183553,Léon Lecoq,600400,416847,Hortense Lemaire,1319970,1503523,2022-11-26
TRANSFER,226244,Laurent-Bertrand Lefort,406740,180496,Hortense Lemaire,1503523,1729767,2022-11-26
CASH_IN,260014,Agence_mtn_Abomey,300000,39986,Michelle Lebon,1938000,2198014,2022-11-01
CASH_IN,220814,Agence_mtn_Abomey,300000,79186,Michelle Lebon,2198014,2418828,2022-11-02
TRANSFER,566932,Michelle Lebon,2418828,1851896,Pénélope Dupuis,327900,-239032,2022-11-02
CASH_OUT,630588,Michelle Lebon,1851896,1221308,Agence_mtn_Abomey,300000,-330588,2022-11-03
CASH_OUT,962279,Michelle Lebon,1221308,259029,Agence_mtn_Cotonou,300000,-662279,2022-11-03
CASH_OUT,122990,Michelle Lebon,259029,136039,Agence_mtn_Abomey,300000,177010,2022-11-04
TRANSFER,451608,Valérie Dijoux,499900,48292,Michelle Lebon,136039,587647,2022-11-04
CASH_OUT,521343,Michelle Lebon,587647,66304,Agence_mtn_Ouidah,300000,-221343,2022-11-05
TRANSFER,164098,Geneviève Grondin,858000,693902,Michelle Lebon,66304,230402,2022-11-06
CASH_OUT,208563,Michelle Lebon,230402,21839,Agence_mtn_Abomey,300000,91437,2022-11-07
CASH_OUT,7725,Michelle Lebon,21839,14114,Agence_mtn_Cotonou,300000,292275,2022-11-08
CASH_IN,24180,Agence_mtn_Abomey,300000,275820,Michelle Lebon,14114,38294,2022-11-09
TRANSFER,256206,Pierre Reynaud,799300,543094,Michelle Lebon,38294,294500,2022-11-10
CASH_IN,41431,Agence_mtn_Ouidah,300000,258569,Michelle Lebon,294500,335931,2022-11-10
TRANSFER,31784,Astrid Gay de la Brunet,557400,525616,Michelle Lebon,335931,367715,2022-11-14
CASH_OUT,47483,Michelle Lebon,367715,320232,Agence_mtn_Abomey,300000,252517,2022-11-15
CASH_OUT,36961,Michelle Lebon,320232,283271,Agence_mtn_Ouidah,300000,263039,2022-11-17
TRANSFER,239091,Corinne-Louise Valentin,1580700,1341609,Michelle Lebon,283271,522362,2022-11-18
TRANSFER,741396,Simone Pineau,1502504,761108,Michelle Lebon,522362,1263758,2022-11-18
CASH_IN,60937,Agence_mtn_Abomey,300000,239063,Michelle Lebon,1263758,1324695,2022-11-19
CASH_IN,263874,Agence_mtn_Cotonou,300000,36126,Michelle Lebon,1324695,1588569,2022-11-19
CASH_OUT,48179,Michelle Lebon,1588569,1540390,Agence_mtn_Ouidah,300000,251821,2022-11-19
TRANSFER,824952,Michelle Lebon,1540390,715438,Valentine Richard-Bourdon,1071400,246448,2022-11-19
CASH_OUT,524636,Michelle Lebon,715438,190802,Agence_mtn_Cotonou,300000,-224636,2022-11-21
CASH_OUT,163170,Michelle Lebon,190802,27632,Agence_mtn_Ouidah,300000,136830,2022-11-21
CASH_IN,59462,Agence_mtn_Abomey,300000,240538,Michelle Lebon,27632,87094,2022-11-22
CASH_OUT,31934,Michelle Lebon,87094,55160,Agence_mtn_Cotonou,300000,268066,2022-11-23
CASH_OUT,8784,Michelle Lebon,55160,46376,Agence_mtn_Ouidah,300000,291216,2022-11-24
CASH_OUT,15268,Michelle Lebon,46376,31108,Agence_mtn_Abomey,300000,284732,2022-11-25
TRANSFER,10380,Michelle Lebon,31108,20728,Marcelle Paris,1325655,1315275,2022-11-26
TRANSFER,996361,David du Blondel,1367647,371286,François Michel-Legros,1407800,411439,2022-11-01
CASH_IN,77020,Agence_mtn_Ouidah,300000,222980,David du Blondel,371286,448306,2022-11-01
CASH_OUT,120369,David du Blondel,448306,327937,Agence_mtn_Ouidah,300000,179631,2022-11-02
CASH_OUT,187228,David du Blondel,327937,140709,Agence_mtn_Ouidah,300000,112772,2022-11-04
CASH_IN,106599,Agence_mtn_Cotonou,300000,193401,David du Blondel,140709,247308,2022-11-05
TRANSFER,572556,Antoine Leleu,837317,264761,David du Blondel,247308,819864,2022-11-07
CASH_IN,89233,Agence_mtn_Abomey,300000,210767,David du Blondel,819864,909097,2022-11-08
CASH_OUT,808029,David du Blondel,909097,101068,Agence_mtn_Abomey,300000,-508029,2022-11-08
TRANSFER,193989,David Guérin,238300,44311,David du Blondel,101068,295057,2022-11-10
CASH_OUT,246462,David du Blondel,295057,48595,Agence_mtn_Cotonou,300000,53538,2022-11-10
CASH_OUT,34219,David du Blondel,48595,14376,Agence_mtn_Abomey,300000,265781,2022-11-10
CASH_OUT,9100,David du Blondel,14376,5276,Agence_mtn_Cotonou,300000,290900,2022-11-11
CASH_IN,38332,Agence_mtn_Abomey,300000,261668,David du Blondel,5276,43608,2022-11-14
TRANSFER,22129,Nathalie Pages,112500,90371,David du Blondel,43608,65737,2022-11-17
TRANSFER,6966,David du Blondel,65737,58771,Frédéric Couturier,492600,485634,2022-11-18
CASH_IN,252299,Agence_mtn_Abomey,300000,47701,David du Blondel,58771,311070,2022-11-19
TRANSFER,221816,William Le Lucas,318797,96981,David du Blondel,311070,532886,2022-11-19
CASH_OUT,516358,David du Blondel,532886,16528,Agence_mtn_Cotonou,300000,-216358,2022-11-20
CASH_IN,113731,Agence_mtn_Abomey,300000,186269,David du Blondel,16528,130259,2022-11-21
CASH_OUT,65446,David du Blondel,130259,64813,Agence_mtn_Cotonou,300000,234554,2022-11-23
TRANSFER,55292,David du Blondel,64813,9521,Xavier de Lebreton,765800,710508,2022-11-23
CASH_OUT,9383,David du Blondel,9521,138,Agence_mtn_Cotonou,300000,290617,2022-11-26
CASH_OUT,121,David du Blondel,138,17,Agence_mtn_Ouidah,300000,299879,2022-11-26
CASH_IN,152963,Agence_mtn_Abomey,300000,147037,David du Blondel,17,152980,2022-11-26
CASH_OUT,106440,David du Blondel,152980,46540,Agence_mtn_Cotonou,300000,193560,2022-11-26
CASH_OUT,24273,Martine Wagner de la Bègue,979380,955107,Agence_mtn_Cotonou,300000,275727,2022-11-02
CASH_OUT,110333,Martine Wagner de la Bègue,955107,844774,Agence_mtn_Cotonou,300000,189667,2022-11-02
CASH_OUT,307982,Martine Wagner de la Bègue,844774,536792,Agence_mtn_Cotonou,300000,-7982,2022-11-02
TRANSFER,905905,Franck-Charles Texier,1834700,928795,Martine Wagner de la Bègue,536792,1442697,2022-11-03
CASH_IN,227335,Agence_mtn_Abomey,300000,72665,Martine Wagner de la Bègue,1442697,1670032,2022-11-06
CASH_OUT,715653,Martine Wagner de la Bègue,1670032,954379,Agence_mtn_Ouidah,300000,-415653,2022-11-08
CASH_IN,17649,Agence_mtn_Cotonou,300000,282351,Martine Wagner de la Bègue,954379,972028,2022-11-09
CASH_IN,179701,Agence_mtn_Abomey,300000,120299,Martine Wagner de la Bègue,972028,1151729,2022-11-09
TRANSFER,31611,Martine Wagner de la Bègue,1151729,1120118,Catherine Faivre,1905600,1873989,2022-11-10
CASH_IN,179190,Agence_mtn_Abomey,300000,120810,Martine Wagner de la Bègue,1120118,1299308,2022-11-12
TRANSFER,22645,Laurent-Bertrand Lefort,180496,157851,Martine Wagner de la Bègue,1299308,1321953,2022-11-13
CASH_IN,281387,Agence_mtn_Abomey,300000,18613,Martine Wagner de la Bègue,1321953,1603340,2022-11-13
CASH_IN,173167,Agence_mtn_Ouidah,300000,126833,Martine Wagner de la Bègue,1603340,1776507,2022-11-14
CASH_IN,210462,Agence_mtn_Abomey,300000,89538,Martine Wagner de la Bègue,1776507,1986969,2022-11-14
CASH_OUT,1980014,Martine Wagner de la Bègue,1986969,6955,Agence_mtn_Cotonou,300000,-1680014,2022-11-16
CASH_OUT,5756,Martine Wagner de la Bègue,6955,1199,Agence_mtn_Abomey,300000,294244,2022-11-17
TRANSFER,736,Martine Wagner de la Bègue,1199,463,Marcelle Paris,1315275,1314539,2022-11-17
CASH_IN,214233,Agence_mtn_Abomey,300000,85767,Martine Wagner de la Bègue,463,214696,2022-11-19
CASH_OUT,131211,Martine Wagner de la Bègue,214696,83485,Agence_mtn_Abomey,300000,168789,2022-11-19
TRANSFER,589850,Marie Picard,720344,130494,Martine Wagner de la Bègue,83485,673335,2022-11-20
TRANSFER,556029,Martine Wagner de la Bègue,673335,117306,Martine Wagner de la Bègue,673335,1229364,2022-11-21
CASH_OUT,101371,Martine Wagner de la Bègue,117306,15935,Agence_mtn_Abomey,300000,198629,2022-11-21
CASH_IN,189656,Agence_mtn_Abomey,300000,110344,Martine Wagner de la Bègue,15935,205591,2022-11-21
CASH_OUT,158512,Martine Wagner de la Bègue,205591,47079,Agence_mtn_Cotonou,300000,141488,2022-11-23
CASH_IN,86741,Agence_mtn_Ouidah,300000,213259,Martine Wagner de la Bègue,47079,133820,2022-11-23
TRANSFER,72028,Roland Garcia,354100,282072,Martine Wagner de la Bègue,133820,205848,2022-11-24
CASH_IN,180741,Agence_mtn_Ouidah,300000,119259,Martine Wagner de la Bègue,205848,386589,2022-11-26
CASH_IN,261377,Agence_mtn_Cotonou,300000,38623,Inès Hamon,1432600,1693977,2022-11-01
CASH_IN,134172,Agence_mtn_Abomey,300000,165828,Inès Hamon,1693977,1828149,2022-11-02
CASH_IN,258165,Agence_mtn_Abomey,300000,41835,Inès Hamon,1828149,2086314,2022-11-03
TRANSFER,121227,Inès Hamon,2086314,1965087,François Michel-Legros,411439,290212,2022-11-06
CASH_IN,142703,Agence_mtn_Ouidah,300000,157297,Inès Hamon,1965087,2107790,2022-11-08
CASH_IN,55155,Agence_mtn_Ouidah,300000,244845,Inès Hamon,2107790,2162945,2022-11-08
CASH_IN,274990,Agence_mtn_Ouidah,300000,25010,Inès Hamon,2162945,2437935,2022-11-08
CASH_IN,151598,Agence_mtn_Cotonou,300000,148402,Inès Hamon,2437935,2589533,2022-11-12
CASH_OUT,2338256,Inès Hamon,2589533,251277,Agence_mtn_Abomey,300000,-2038256,2022-11-14
TRANSFER,42406,Inès Hamon,251277,208871,Margot Riou du Fernandes,1821889,1779483,2022-11-15
CASH_IN,84944,Agence_mtn_Cotonou,300000,215056,Inès Hamon,208871,293815,2022-11-15
CASH_OUT,188890,Inès Hamon,293815,104925,Agence_mtn_Cotonou,300000,111110,2022-11-17
CASH_IN,128486,Agence_mtn_Cotonou,300000,171514,Inès Hamon,104925,233411,2022-11-17
CASH_OUT,45894,Inès Hamon,233411,187517,Agence_mtn_Cotonou,300000,254106,2022-11-19
CASH_OUT,26730,Inès Hamon,187517,160787,Agence_mtn_Ouidah,300000,273270,2022-11-20
TRANSFER,126172,Antoine Leleu,264761,138589,Inès Hamon,160787,286959,2022-11-21
TRANSFER,54187,Inès Hamon,286959,232772,Emmanuelle Georges,380185,325998,2022-11-21
CASH_IN,143280,Agence_mtn_Ouidah,300000,156720,Inès Hamon,232772,376052,2022-11-25
TRANSFER,6540,David Guérin,44311,37771,Inès Hamon,376052,382592,2022-11-25
CASH_IN,107327,Agence_mtn_Ouidah,300000,192673,Inès Hamon,382592,489919,2022-11-26
TRANSFER,455842,Corinne-Louise Valentin,1341609,885767,Inès Hamon,489919,945761,2022-11-26
TRANSFER,11849,Vincent Fournier,31354,19505,Inès Hamon,945761,957610,2022-11-26
CASH_IN,145790,Agence_mtn_Cotonou,300000,154210,Inès Hamon,957610,1103400,2022-11-27
CASH_IN,103564,Agence_mtn_Ouidah,300000,196436,Louis Pichon,1221800,1325364,2022-11-04
CASH_OUT,738391,Louis Pichon,1325364,586973,Agence_mtn_Abomey,300000,-438391,2022-11-04
TRANSFER,74402,Adrien Chartier,124805,50403,Louis Pichon,586973,661375,2022-11-05
CASH_IN,37962,Agence_mtn_Cotonou,300000,262038,Louis Pichon,661375,699337,2022-11-05
TRANSFER,240867,Louis Pichon,699337,458470,Catherine Faivre,1873989,1633122,2022-11-06
CASH_OUT,315727,Louis Pichon,458470,142743,Agence_mtn_Cotonou,300000,-15727,2022-11-06
TRANSFER,99077,Louis Pichon,142743,43666,Théodore De Oliveira-Nicolas,1539700,1440623,2022-11-08
TRANSFER,34822,Louis Pichon,43666,8844,Xavier de Lebreton,710508,675686,2022-11-10
TRANSFER,6302,Louis Pichon,8844,2542,William Le Lucas,96981,90679,2022-11-11
CASH_OUT,2267,Louis Pichon,2542,275,Agence_mtn_Ouidah,300000,297733,2022-11-12
TRANSFER,142,Louis Pichon,275,133,Emmanuelle Georges,325998,325856,2022-11-13
TRANSFER,89902,William Le Lucas,90679,777,Louis Pichon,133,90035,2022-11-13
TRANSFER,61151,Louis Pichon,90035,28884,Gabriel-Tristan Marty,75000,13849,2022-11-13
CASH_OUT,17215,Louis Pichon,28884,11669,Agence_mtn_Abomey,300000,282785,2022-11-13
TRANSFER,321354,Rémy Le Michaud,698676,377322,Louis Pichon,11669,333023,2022-11-14
CASH_IN,27853,Agence_mtn_Cotonou,300000,272147,Louis Pichon,333023,360876,2022-11-15
CASH_IN,245820,Agence_mtn_Abomey,300000,54180,Louis Pichon,360876,606696,2022-11-16
CASH_OUT,148190,Louis Pichon,606696,458506,Agence_mtn_Ouidah,300000,151810,2022-11-18
TRANSFER,441040,Louis Pichon,458506,17466,Gabriel-Tristan Marty,13849,-427191,2022-11-18
CASH_IN,234923,Agence_mtn_Abomey,300000,65077,Louis Pichon,17466,252389,2022-11-18
CASH_IN,288276,Agence_mtn_Cotonou,300000,11724,Louis Pichon,252389,540665,2022-11-19
TRANSFER,267118,Louis Pichon,540665,273547,Xavier Leblanc-Ferreira,1204100,936982,2022-11-20
CASH_IN,127503,Agence_mtn_Ouidah,300000,172497,Louis Pichon,273547,401050,2022-11-20
CASH_OUT,200801,Louis Pichon,401050,200249,Agence_mtn_Ouidah,300000,99199,2022-11-20
CASH_IN,232347,Agence_mtn_Cotonou,300000,67653,Louis Pichon,200249,432596,2022-11-21
CASH_OUT,410433,Louis Pichon,432596,22163,Agence_mtn_Ouidah,300000,-110433,2022-11-21
CASH_OUT,17108,Louis Pichon,22163,5055,Agence_mtn_Abomey,300000,282892,2022-11-22
CASH_IN,146417,Agence_mtn_Cotonou,300000,153583,Louis Pichon,5055,151472,2022-11-22
TRANSFER,653985,Thierry Delattre-Simon,1806400,1152415,Louis Pichon,151472,805457,2022-11-25
CASH_IN,190296,Agence_mtn_Cotonou,300000,109704,Louis Pichon,805457,995753,2022-11-27
TRANSFER,39837,Gilbert-Charles Thibault,86165,46328,Jeanne Garnier,1814104,1853941,2022-11-01
TRANSFER,1872085,Benjamin Evrard-Marty,1928000,55915,Jeanne Garnier,1853941,3726026,2022-11-02
TRANSFER,458726,Jeanne Garnier,3726026,3267300,Léon Lecoq,416847,-41879,2022-11-03
CASH_IN,151705,Agence_mtn_Abomey,300000,148295,Jeanne Garnier,3267300,3419005,2022-11-03
CASH_OUT,670076,Jeanne Garnier,3419005,2748929,Agence_mtn_Ouidah,300000,-370076,2022-11-04
CASH_OUT,1627179,Jeanne Garnier,2748929,1121750,Agence_mtn_Ouidah,300000,-1327179,2022-11-04
CASH_IN,154568,Agence_mtn_Ouidah,300000,145432,Jeanne Garnier,1121750,1276318,2022-11-05
TRANSFER,44332,Gilbert-Charles Thibault,46328,1996,Jeanne Garnier,1276318,1320650,2022-11-05
TRANSFER,30008,Jeanne Garnier,1320650,1290642,Jeanne Garnier,1320650,1350658,2022-11-05
CASH_IN,7421,Agence_mtn_Ouidah,300000,292579,Jeanne Garnier,1290642,1298063,2022-11-06
CASH_IN,78824,Agence_mtn_Cotonou,300000,221176,Jeanne Garnier,1298063,1376887,2022-11-07
CASH_IN,22065,Agence_mtn_Abomey,300000,277935,Jeanne Garnier,1376887,1398952,2022-11-07
CASH_IN,16209,Agence_mtn_Ouidah,300000,283791,Jeanne Garnier,1398952,1415161,2022-11-09
TRANSFER,807320,Jeanne Garnier,1415161,607841,Thierry Delattre-Simon,1152415,345095,2022-11-11
CASH_IN,83946,Agence_mtn_Cotonou,300000,216054,Jeanne Garnier,607841,691787,2022-11-13
TRANSFER,679677,Jeanne Garnier,691787,12110,Raymond Rossi,1174123,494446,2022-11-13
CASH_OUT,7456,Jeanne Garnier,12110,4654,Agence_mtn_Ouidah,300000,292544,2022-11-15
CASH_OUT,2372,Jeanne Garnier,4654,2282,Agence_mtn_Abomey,300000,297628,2022-11-15
CASH_IN,143666,Agence_mtn_Abomey,300000,156334,Jeanne Garnier,2282,145948,2022-11-19
CASH_OUT,21081,Jeanne Garnier,145948,124867,Agence_mtn_Abomey,300000,278919,2022-11-20
TRANSFER,48627,Léon Martins-Briand,1062800,1014173,Jeanne Garnier,124867,173494,2022-11-21
TRANSFER,126684,Louise Girard,1524900,1398216,Jeanne Garnier,173494,300178,2022-11-22
CASH_IN,214889,Agence_mtn_Ouidah,300000,85111,Jeanne Garnier,300178,515067,2022-11-22
CASH_OUT,371509,Jeanne Garnier,515067,143558,Agence_mtn_Abomey,300000,-71509,2022-11-23
TRANSFER,134876,Jeanne Garnier,143558,8682,Marie Picard,130494,-4382,2022-11-23
CASH_OUT,3687,Jeanne Garnier,8682,4995,Agence_mtn_Cotonou,300000,296313,2022-11-24
CASH_OUT,3926,Jeanne Garnier,4995,1069,Agence_mtn_Cotonou,300000,296074,2022-11-25
CASH_OUT,637,Jeanne Garnier,1069,432,Agence_mtn_Cotonou,300000,299363,2022-11-27
CASH_OUT,329,Jeanne Garnier,432,103,Agence_mtn_Cotonou,300000,299671,2022-11-27
CASH_OUT,100,Jeanne Garnier,103,3,Agence_mtn_Abomey,300000,299900,2022-11-27
CASH_IN,199781,Agence_mtn_Ouidah,300000,100219,Pénélope Dupuis,-239032,-39251,2022-11-01
CASH_IN,68278,Agence_mtn_Ouidah,300000,231722,Pénélope Dupuis,-39251,29027,2022-11-02
CASH_OUT,21321,Pénélope Dupuis,29027,7706,Agence_mtn_Cotonou,300000,278679,2022-11-03
CASH_IN,206072,Agence_mtn_Abomey,300000,93928,Pénélope Dupuis,7706,213778,2022-11-04
CASH_OUT,205766,Pénélope Dupuis,213778,8012,Agence_mtn_Ouidah,300000,94234,2022-11-06
CASH_IN,204540,Agence_mtn_Cotonou,300000,95460,Pénélope Dupuis,8012,212552,2022-11-06
TRANSFER,56023,Pénélope Dupuis,212552,156529,Pierre Roger,1871600,1815577,2022-11-07
TRANSFER,1519,Nathalie Pages,90371,88852,Pénélope Dupuis,156529,158048,2022-11-09
TRANSFER,51687,Pénélope Dupuis,158048,106361,Geneviève De Oliveira-Michel,532200,480513,2022-11-09
CASH_OUT,74842,Pénélope Dupuis,106361,31519,Agence_mtn_Cotonou,300000,225158,2022-11-09
CASH_OUT,31483,Pénélope Dupuis,31519,36,Agence_mtn_Cotonou,300000,268517,2022-11-10
CASH_IN,21776,Agence_mtn_Cotonou,300000,278224,Pénélope Dupuis,36,21812,2022-11-11
TRANSFER,21600,Pénélope Dupuis,21812,212,Pierre Reynaud,543094,521494,2022-11-11
CASH_IN,19078,Agence_mtn_Abomey,300000,280922,Pénélope Dupuis,212,19290,2022-11-11
CASH_IN,211487,Agence_mtn_Abomey,300000,88513,Pénélope Dupuis,19290,230777,2022-11-11
TRANSFER,256240,Gabriel Humbert,1298300,1042060,Pénélope Dupuis,230777,487017,2022-11-11
TRANSFER,405576,Pénélope Dupuis,487017,81441,Théodore De Oliveira-Nicolas,1440623,1035047,2022-11-12
TRANSFER,93093,Margot Riou du Fernandes,1779483,1686390,Pénélope Dupuis,81441,174534,2022-11-13
CASH_IN,64915,Agence_mtn_Ouidah,300000,235085,Pénélope Dupuis,174534,239449,2022-11-15
CASH_OUT,34637,Pénélope Dupuis,239449,204812,Agence_mtn_Ouidah,300000,265363,2022-11-15
TRANSFER,176970,Pénélope Dupuis,204812,27842,Richard Le Descamps,404244,227274,2022-11-15
TRANSFER,352909,Renée David,1355900,1002991,Pénélope Dupuis,27842,380751,2022-11-16
CASH_IN,3240,Agence_mtn_Cotonou,300000,296760,Pénélope Dupuis,380751,383991,2022-11-16
CASH_IN,149083,Agence_mtn_Abomey,300000,150917,Pénélope Dupuis,383991,533074,2022-11-17
CASH_IN,226115,Agence_mtn_Abomey,300000,73885,Pénélope Dupuis,533074,759189,2022-11-18
CASH_IN,8337,Agence_mtn_Abomey,300000,291663,Pénélope Dupuis,759189,767526,2022-11-20
TRANSFER,9213,Alexandre Rémy,137458,128245,Pénélope Dupuis,767526,776739,2022-11-22
CASH_IN,108021,Agence_mtn_Cotonou,300000,191979,Pénélope Dupuis,776739,884760,2022-11-23
CASH_IN,206553,Agence_mtn_Abomey,300000,93447,Pénélope Dupuis,884760,1091313,2022-11-24
CASH_IN,88969,Agence_mtn_Cotonou,300000,211031,Pénélope Dupuis,1091313,1180282,2022-11-26
TRANSFER,100601,Franck-Charles Texier,928795,828194,Catherine Faivre,1633122,1733723,2022-11-01
TRANSFER,334494,Virginie Le Gall,450211,115717,Catherine Faivre,1733723,2068217,2022-11-03
TRANSFER,421984,Catherine Faivre,2068217,1646233,Sébastien Vallée,847397,425413,2022-11-04
CASH_IN,281141,Agence_mtn_Cotonou,300000,18859,Catherine Faivre,1646233,1927374,2022-11-05
CASH_IN,242598,Agence_mtn_Abomey,300000,57402,Catherine Faivre,1927374,2169972,2022-11-06
TRANSFER,553401,Gabriel Humbert,1042060,488659,Catherine Faivre,2169972,2723373,2022-11-09
CASH_OUT,812218,Catherine Faivre,2723373,1911155,Agence_mtn_Ouidah,300000,-512218,2022-11-09
CASH_OUT,947111,Catherine Faivre,1911155,964044,Agence_mtn_Ouidah,300000,-647111,2022-11-10
CASH_OUT,269794,Catherine Faivre,964044,694250,Agence_mtn_Abomey,300000,30206,2022-11-11
CASH_OUT,258072,Catherine Faivre,694250,436178,Agence_mtn_Ouidah,300000,41928,2022-11-12
CASH_IN,243515,Agence_mtn_Ouidah,300000,56485,Catherine Faivre,436178,679693,2022-11-13
CASH_IN,156194,Agence_mtn_Abomey,300000,143806,Catherine Faivre,679693,835887,2022-11-13
CASH_OUT,806697,Catherine Faivre,835887,29190,Agence_mtn_Ouidah,300000,-506697,2022-11-13
CASH_IN,159283,Agence_mtn_Ouidah,300000,140717,Catherine Faivre,29190,188473,2022-11-15
CASH_OUT,43522,Catherine Faivre,188473,144951,Agence_mtn_Ouidah,300000,256478,2022-11-15
TRANSFER,116411,Catherine Faivre,144951,28540,Valentine Martinez,1432900,1316489,2022-11-17
CASH_OUT,16243,Catherine Faivre,28540,12297,Agence_mtn_Ouidah,300000,283757,2022-11-17
CASH_IN,65650,Agence_mtn_Cotonou,300000,234350,Catherine Faivre,12297,77947,2022-11-21
CASH_IN,16545,Agence_mtn_Abomey,300000,283455,Catherine Faivre,77947,94492,2022-11-22
CASH_IN,146433,Agence_mtn_Cotonou,300000,153567,Catherine Faivre,94492,240925,2022-11-23
TRANSFER,7511,Catherine Faivre,240925,233414,Adrien Chartier,50403,42892,2022-11-23
CASH_OUT,178383,Catherine Faivre,233414,55031,Agence_mtn_Cotonou,300000,121617,2022-11-23
TRANSFER,162634,Léon Martins-Briand,1014173,851539,Catherine Faivre,55031,217665,2022-11-24
CASH_OUT,225765,Roland Garcia,282072,56307,Agence_mtn_Cotonou,300000,74235,2022-11-03
CASH_IN,172352,Agence_mtn_Cotonou,300000,127648,Roland Garcia,56307,228659,2022-11-04
CASH_OUT,25369,Roland Garcia,228659,203290,Agence_mtn_Cotonou,300000,274631,2022-11-04
CASH_OUT,134036,Roland Garcia,203290,69254,Agence_mtn_Ouidah,300000,165964,2022-11-04
CASH_IN,202990,Agence_mtn_Cotonou,300000,97010,Roland Garcia,69254,272244,2022-11-06
CASH_OUT,198187,Roland Garcia,272244,74057,Agence_mtn_Abomey,300000,101813,2022-11-06
CASH_OUT,22459,Roland Garcia,74057,51598,Agence_mtn_Ouidah,300000,277541,2022-11-06
CASH_IN,211400,Agence_mtn_Ouidah,300000,88600,Roland Garcia,51598,262998,2022-11-07
CASH_IN,136359,Agence_mtn_Abomey,300000,163641,Roland Garcia,262998,399357,2022-11-07
CASH_IN,77149,Agence_mtn_Ouidah,300000,222851,Roland Garcia,399357,476506,2022-11-08
CASH_IN,146305,Agence_mtn_Abomey,300000,153695,Roland Garcia,476506,622811,2022-11-09
CASH_OUT,613104,Roland Garcia,622811,9707,Agence_mtn_Abomey,300000,-313104,2022-11-10
TRANSFER,629451,Corinne-Louise Valentin,885767,256316,Roland Garcia,9707,639158,2022-11-11
CASH_OUT,569595,Roland Garcia,639158,69563,Agence_mtn_Abomey,300000,-269595,2022-11-11
CASH_OUT,50286,Roland Garcia,69563,19277,Agence_mtn_Ouidah,300000,249714,2022-11-12
TRANSFER,8120,Roland Garcia,19277,11157,Xavier Leblanc-Ferreira,936982,928862,2022-11-13
CASH_IN,187499,Agence_mtn_Ouidah,300000,112501,Roland Garcia,11157,198656,2022-11-14
TRANSFER,97742,Roland Garcia,198656,100914,Corinne-Louise Valentin,256316,158574,2022-11-15
TRANSFER,10016,Roland Garcia,100914,90898,Emmanuelle Georges,325856,315840,2022-11-20
TRANSFER,1514,Nathalie Peron,1175127,1173613,Roland Garcia,90898,92412,2022-11-20
TRANSFER,17847,Valérie Dijoux,48292,30445,Roland Garcia,92412,110259,2022-11-21
TRANSFER,66839,Roland Garcia,110259,43420,Théodore De Oliveira-Nicolas,1035047,968208,2022-11-21
CASH_OUT,16226,Roland Garcia,43420,27194,Agence_mtn_Abomey,300000,283774,2022-11-22
TRANSFER,544600,Simone Pineau,761108,216508,Roland Garcia,27194,571794,2022-11-23
CASH_IN,262284,Agence_mtn_Ouidah,300000,37716,Roland Garcia,571794,834078,2022-11-24
CASH_OUT,659631,Roland Garcia,834078,174447,Agence_mtn_Cotonou,300000,-359631,2022-11-25
CASH_OUT,124711,Roland Garcia,174447,49736,Agence_mtn_Abomey,300000,175289,2022-11-26
CASH_OUT,25194,Roland Garcia,49736,24542,Agence_mtn_Abomey,300000,274806,2022-11-27
TRANSFER,291,Roland Garcia,24542,24251,Emmanuelle Georges,315840,315549,2022-11-27
CASH_IN,98620,Agence_mtn_Ouidah,300000,201380,Roland Garcia,24251,122871,2022-11-27
CASH_IN,154667,Agence_mtn_Abomey,300000,145333,Vincent Fournier,19505,174172,2022-11-01
CASH_IN,133668,Agence_mtn_Cotonou,300000,166332,Vincent Fournier,174172,307840,2022-11-02
TRANSFER,208354,Vincent Fournier,307840,99486,Adrien Chartier,42892,-165462,2022-11-03
TRANSFER,95283,Vincent Fournier,99486,4203,Astrid Gay de la Brunet,525616,430333,2022-11-03
CASH_IN,40372,Agence_mtn_Cotonou,300000,259628,Vincent Fournier,4203,44575,2022-11-06
CASH_OUT,244,Vincent Fournier,44575,44331,Agence_mtn_Ouidah,300000,299756,2022-11-06
TRANSFER,80075,Pénélope Ollivier,795400,715325,Vincent Fournier,44331,124406,2022-11-07
TRANSFER,88718,Vincent Fournier,124406,35688,Xavier Leblanc-Ferreira,928862,840144,2022-11-07
CASH_OUT,6007,Vincent Fournier,35688,29681,Agence_mtn_Cotonou,300000,293993,2022-11-07
TRANSFER,25407,Vincent Fournier,29681,4274,Antoinette Bertrand,1513000,1487593,2022-11-07
TRANSFER,881,Vincent Fournier,4274,3393,Renée David,1002991,1002110,2022-11-09
CASH_IN,107631,Agence_mtn_Ouidah,300000,192369,Vincent Fournier,3393,111024,2022-11-09
CASH_OUT,35840,Vincent Fournier,111024,75184,Agence_mtn_Ouidah,300000,264160,2022-11-11
CASH_IN,210819,Agence_mtn_Abomey,300000,89181,Vincent Fournier,75184,286003,2022-11-11
TRANSFER,275597,Vincent Fournier,286003,10406,Valérie Dijoux,30445,-245152,2022-11-14
CASH_IN,52919,Agence_mtn_Abomey,300000,247081,Vincent Fournier,10406,63325,2022-11-14
TRANSFER,43536,Pénélope Ollivier,715325,671789,Vincent Fournier,63325,106861,2022-11-18
CASH_OUT,35041,Vincent Fournier,106861,71820,Agence_mtn_Cotonou,300000,264959,2022-11-20
CASH_OUT,36129,Vincent Fournier,71820,35691,Agence_mtn_Abomey,300000,263871,2022-11-20
CASH_OUT,18707,Vincent Fournier,35691,16984,Agence_mtn_Abomey,300000,281293,2022-11-21
TRANSFER,10090,Vincent Fournier,16984,6894,Raymond Rossi,494446,484356,2022-11-21
CASH_IN,96999,Agence_mtn_Cotonou,300000,203001,Vincent Fournier,6894,103893,2022-11-21
TRANSFER,1852,Gilbert-Charles Thibault,1996,144,Vincent Fournier,103893,105745,2022-11-22
CASH_IN,21349,Agence_mtn_Ouidah,300000,278651,Vincent Fournier,105745,127094,2022-11-23
TRANSFER,41547,Pierre Reynaud,521494,479947,Vincent Fournier,127094,168641,2022-11-24
CASH_OUT,115230,Vincent Fournier,168641,53411,Agence_mtn_Cotonou,300000,184770,2022-11-24
CASH_OUT,3906,Vincent Fournier,53411,49505,Agence_mtn_Abomey,300000,296094,2022-11-25
TRANSFER,106400,Joséphine Gros,257823,151423,Vincent Fournier,49505,155905,2022-11-25
CASH_OUT,118017,Vincent Fournier,155905,37888,Agence_mtn_Cotonou,300000,181983,2022-11-27
TRANSFER,128465,Adèle Labbé,1226900,1098435,Vincent Fournier,37888,166353,2022-11-27
CASH_OUT,1178104,Aurore Guyon,1764700,586596,Agence_mtn_Cotonou,300000,-878104,2022-11-01
CASH_OUT,24563,Aurore Guyon,586596,562033,Agence_mtn_Abomey,300000,275437,2022-11-01
TRANSFER,370730,Aurore Guyon,562033,191303,Gilbert Foucher,168163,-202567,2022-11-02
TRANSFER,58394,Antoine Leleu,138589,80195,Aurore Guyon,191303,249697,2022-11-04
CASH_IN,200573,Agence_mtn_Abomey,300000,99427,Aurore Guyon,249697,450270,2022-11-04
CASH_OUT,326906,Aurore Guyon,450270,123364,Agence_mtn_Cotonou,300000,-26906,2022-11-04
CASH_OUT,2061,Aurore Guyon,123364,121303,Agence_mtn_Abomey,300000,297939,2022-11-05
TRANSFER,199367,Franck-Charles Texier,828194,628827,Aurore Guyon,121303,320670,2022-11-08
CASH_IN,105315,Agence_mtn_Cotonou,300000,194685,Aurore Guyon,320670,425985,2022-11-09
CASH_IN,109444,Agence_mtn_Cotonou,300000,190556,Aurore Guyon,425985,535429,2022-11-10
TRANSFER,87404,Aurore Guyon,535429,448025,Valentine Richard-Bourdon,246448,159044,2022-11-10
CASH_OUT,350943,Aurore Guyon,448025,97082,Agence_mtn_Cotonou,300000,-50943,2022-11-16
CASH_OUT,66381,Aurore Guyon,97082,30701,Agence_mtn_Abomey,300000,233619,2022-11-17
TRANSFER,723,Aurore Guyon,30701,29978,Adèle Labbé,1098435,1097712,2022-11-17
CASH_OUT,8996,Aurore Guyon,29978,20982,Agence_mtn_Cotonou,300000,291004,2022-11-17
CASH_OUT,14387,Aurore Guyon,20982,6595,Agence_mtn_Cotonou,300000,285613,2022-11-18
CASH_OUT,193,Aurore Guyon,6595,6402,Agence_mtn_Ouidah,300000,299807,2022-11-19
CASH_IN,192395,Agence_mtn_Abomey,300000,107605,Aurore Guyon,6402,198797,2022-11-24
TRANSFER,131367,Aurore Guyon,198797,67430,Philippine Courtois,478500,347133,2022-11-25
CASH_OUT,64721,Aurore Guyon,67430,2709,Agence_mtn_Cotonou,300000,235279,2022-11-25
CASH_OUT,110,Aurore Guyon,2709,2599,Agence_mtn_Cotonou,300000,299890,2022-11-25
CASH_IN,111484,Agence_mtn_Abomey,300000,188516,Aurore Guyon,2599,114083,2022-11-25
TRANSFER,18617,Aurore Guyon,114083,95466,Aurore Guyon,114083,132700,2022-11-26
TRANSFER,78487,Aurore Guyon,95466,16979,Adèle Labbé,1097712,1019225,2022-11-26
CASH_IN,267314,Agence_mtn_Ouidah,300000,32686,François Michel-Legros,290212,557526,2022-11-01
TRANSFER,400803,François Michel-Legros,557526,156723,Franck-Charles Texier,628827,228024,2022-11-01
CASH_OUT,148328,François Michel-Legros,156723,8395,Agence_mtn_Cotonou,300000,151672,2022-11-03
CASH_IN,254037,Agence_mtn_Cotonou,300000,45963,François Michel-Legros,8395,262432,2022-11-03
CASH_OUT,15175,François Michel-Legros,262432,247257,Agence_mtn_Ouidah,300000,284825,2022-11-06
CASH_IN,219486,Agence_mtn_Cotonou,300000,80514,François Michel-Legros,247257,466743,2022-11-08
TRANSFER,141661,François Michel-Legros,466743,325082,Antoine Leleu,80195,-61466,2022-11-09
TRANSFER,93858,François Michel-Legros,325082,231224,Raymond Rossi,484356,390498,2022-11-10
TRANSFER,212957,François Michel-Legros,231224,18267,Louise Girard,1398216,1185259,2022-11-11
CASH_OUT,9005,François Michel-Legros,18267,9262,Agence_mtn_Cotonou,300000,290995,2022-11-12
CASH_IN,251437,Agence_mtn_Cotonou,300000,48563,François Michel-Legros,9262,260699,2022-11-13
CASH_IN,171314,Agence_mtn_Cotonou,300000,128686,François Michel-Legros,260699,432013,2022-11-13
CASH_OUT,219492,François Michel-Legros,432013,212521,Agence_mtn_Abomey,300000,80508,2022-11-13
CASH_IN,6609,Agence_mtn_Ouidah,300000,293391,François Michel-Legros,212521,219130,2022-11-13
CASH_OUT,71770,François Michel-Legros,219130,147360,Agence_mtn_Abomey,300000,228230,2022-11-16
TRANSFER,11824,François Michel-Legros,147360,135536,François Michel-Legros,147360,135536,2022-11-17
TRANSFER,48991,François Michel-Legros,135536,86545,Renée David,1002110,953119,2022-11-19
CASH_OUT,78260,François Michel-Legros,86545,8285,Agence_mtn_Abomey,300000,221740,2022-11-20
TRANSFER,6812,François Michel-Legros,8285,1473,Gabriel Humbert,488659,481847,2022-11-21
CASH_IN,85503,Agence_mtn_Abomey,300000,214497,François Michel-Legros,1473,86976,2022-11-22
TRANSFER,51009,François Michel-Legros,86976,35967,Sébastien Vallée,425413,374404,2022-11-22
CASH_OUT,33798,François Michel-Legros,35967,2169,Agence_mtn_Abomey,300000,266202,2022-11-23
CASH_IN,42285,Agence_mtn_Abomey,300000,257715,François Michel-Legros,2169,44454,2022-11-24
CASH_OUT,37353,François Michel-Legros,44454,7101,Agence_mtn_Abomey,300000,262647,2022-11-24
CASH_OUT,6545,François Michel-Legros,7101,556,Agence_mtn_Abomey,300000,293455,2022-11-25
CASH_OUT,458,François Michel-Legros,556,98,Agence_mtn_Abomey,300000,299542,2022-11-26
CASH_IN,225389,Agence_mtn_Cotonou,300000,74611,François Michel-Legros,98,225487,2022-11-26
TRANSFER,33557,François Michel-Legros,225487,191930,Corinne-Louise Valentin,158574,125017,2022-11-27
CASH_IN,169797,Agence_mtn_Cotonou,300000,130203,Raymond Rossi,390498,560295,2022-11-01
CASH_IN,255268,Agence_mtn_Cotonou,300000,44732,Raymond Rossi,560295,815563,2022-11-01
CASH_OUT,597702,Raymond Rossi,815563,217861,Agence_mtn_Cotonou,300000,-297702,2022-11-02
CASH_OUT,55390,Raymond Rossi,217861,162471,Agence_mtn_Ouidah,300000,244610,2022-11-02
CASH_IN,33369,Agence_mtn_Ouidah,300000,266631,Raymond Rossi,162471,195840,2022-11-03
CASH_OUT,121966,Raymond Rossi,195840,73874,Agence_mtn_Abomey,300000,178034,2022-11-04
CASH_OUT,53298,Raymond Rossi,73874,20576,Agence_mtn_Ouidah,300000,246702,2022-11-04
CASH_OUT,9427,Raymond Rossi,20576,11149,Agence_mtn_Cotonou,300000,290573,2022-11-05
CASH_IN,269402,Agence_mtn_Cotonou,300000,30598,Raymond Rossi,11149,280551,2022-11-05
CASH_IN,22383,Agence_mtn_Ouidah,300000,277617,Raymond Rossi,280551,302934,2022-11-08
CASH_OUT,84236,Raymond Rossi,302934,218698,Agence_mtn_Cotonou,300000,215764,2022-11-09
TRANSFER,133015,Raymond Rossi,218698,85683,Emmanuelle Georges,315549,182534,2022-11-11
CASH_OUT,70452,Raymond Rossi,85683,15231,Agence_mtn_Abomey,300000,229548,2022-11-12
TRANSFER,104,Gilbert-Charles Thibault,144,40,Raymond Rossi,15231,15335,2022-11-12
TRANSFER,59660,Alexandre Rémy,128245,68585,Raymond Rossi,15335,74995,2022-11-12
TRANSFER,152010,Cécile Clerc,483600,331590,Raymond Rossi,74995,227005,2022-11-15
CASH_OUT,92689,Raymond Rossi,227005,134316,Agence_mtn_Cotonou,300000,207311,2022-11-16
TRANSFER,24315,Benjamin Evrard-Marty,55915,31600,Raymond Rossi,134316,158631,2022-11-16
CASH_IN,185061,Agence_mtn_Ouidah,300000,114939,Raymond Rossi,158631,343692,2022-11-17
CASH_IN,74337,Agence_mtn_Ouidah,300000,225663,Raymond Rossi,343692,418029,2022-11-17
TRANSFER,226258,Raymond Rossi,418029,191771,Frédéric Couturier,485634,259376,2022-11-18
CASH_OUT,131585,Raymond Rossi,191771,60186,Agence_mtn_Cotonou,300000,168415,2022-11-20
TRANSFER,22356,Raymond Rossi,60186,37830,Emmanuelle Georges,182534,160178,2022-11-20
CASH_IN,189032,Agence_mtn_Ouidah,300000,110968,Raymond Rossi,37830,226862,2022-11-22
CASH_OUT,180499,Raymond Rossi,226862,46363,Agence_mtn_Cotonou,300000,119501,2022-11-23
CASH_IN,170442,Agence_mtn_Ouidah,300000,129558,Raymond Rossi,46363,216805,2022-11-26
CASH_OUT,133477,Raymond Rossi,216805,83328,Agence_mtn_Cotonou,300000,166523,2022-11-27
CASH_IN,59408,Agence_mtn_Abomey,300000,240592,Raymond Rossi,83328,142736,2022-11-27
CASH_OUT,17635,Raymond Rossi,142736,125101,Agence_mtn_Abomey,300000,282365,2022-11-27
CASH_OUT,16651,Benjamin Evrard-Marty,31600,14949,Agence_mtn_Cotonou,300000,283349,2022-11-03
TRANSFER,600,Benjamin Evrard-Marty,14949,14349,Virginie Le Gall,115717,115117,2022-11-03
CASH_OUT,5019,Benjamin Evrard-Marty,14349,9330,Agence_mtn_Cotonou,300000,294981,2022-11-04
TRANSFER,7676,Benjamin Evrard-Marty,9330,1654,Valentine Richard-Bourdon,159044,151368,2022-11-06
TRANSFER,95719,Inès de Letellier,1338300,1242581,Benjamin Evrard-Marty,1654,97373,2022-11-08
CASH_OUT,2734,Benjamin Evrard-Marty,97373,94639,Agence_mtn_Abomey,300000,297266,2022-11-09
CASH_OUT,28620,Benjamin Evrard-Marty,94639,66019,Agence_mtn_Ouidah,300000,271380,2022-11-09
TRANSFER,142063,Joséphine Gros,151423,9360,Benjamin Evrard-Marty,66019,208082,2022-11-10
CASH_OUT,132532,Benjamin Evrard-Marty,208082,75550,Agence_mtn_Cotonou,300000,167468,2022-11-11
CASH_IN,289106,Agence_mtn_Abomey,300000,10894,Benjamin Evrard-Marty,75550,364656,2022-11-11
CASH_OUT,224014,Benjamin Evrard-Marty,364656,140642,Agence_mtn_Ouidah,300000,75986,2022-11-12
CASH_OUT,127804,Benjamin Evrard-Marty,140642,12838,Agence_mtn_Ouidah,300000,172196,2022-11-13
TRANSFER,868,Benjamin Evrard-Marty,12838,11970,Nathalie Pages,88852,87984,2022-11-13
CASH_OUT,4399,Benjamin Evrard-Marty,11970,7571,Agence_mtn_Cotonou,300000,295601,2022-11-13
TRANSFER,11211,Virginie Le Gall,115117,103906,Benjamin Evrard-Marty,7571,18782,2022-11-13
TRANSFER,1528897,Pierre Roger,1815577,286680,Benjamin Evrard-Marty,18782,1547679,2022-11-13
CASH_IN,78134,Agence_mtn_Cotonou,300000,221866,Benjamin Evrard-Marty,1547679,1625813,2022-11-16
CASH_IN,250860,Agence_mtn_Cotonou,300000,49140,Benjamin Evrard-Marty,1625813,1876673,2022-11-17
CASH_OUT,22405,Benjamin Evrard-Marty,1876673,1854268,Agence_mtn_Cotonou,300000,277595,2022-11-19
CASH_OUT,346422,Benjamin Evrard-Marty,1854268,1507846,Agence_mtn_Ouidah,300000,-46422,2022-11-20
CASH_OUT,1362878,Benjamin Evrard-Marty,1507846,144968,Agence_mtn_Cotonou,300000,-1062878,2022-11-20
CASH_OUT,2343,Benjamin Evrard-Marty,144968,142625,Agence_mtn_Abomey,300000,297657,2022-11-21
CASH_IN,13238,Agence_mtn_Ouidah,300000,286762,Benjamin Evrard-Marty,142625,155863,2022-11-22
CASH_OUT,29484,Benjamin Evrard-Marty,155863,126379,Agence_mtn_Cotonou,300000,270516,2022-11-25
TRANSFER,331185,Geneviève De Oliveira-Michel,480513,149328,Benjamin Evrard-Marty,126379,457564,2022-11-26
CASH_IN,263721,Agence_mtn_Abomey,300000,36279,Benjamin Evrard-Marty,457564,721285,2022-11-26
CASH_IN,280769,Agence_mtn_Ouidah,300000,19231,Benjamin Evrard-Marty,721285,1002054,2022-11-26
CASH_OUT,338293,Vincent Mathieu,804700,466407,Agence_mtn_Abomey,300000,-38293,2022-11-02
CASH_OUT,417380,Vincent Mathieu,466407,49027,Agence_mtn_Cotonou,300000,-117380,2022-11-03
CASH_OUT,21062,Vincent Mathieu,49027,27965,Agence_mtn_Abomey,300000,278938,2022-11-03
CASH_OUT,5007,Vincent Mathieu,27965,22958,Agence_mtn_Cotonou,300000,294993,2022-11-03
CASH_IN,259589,Agence_mtn_Abomey,300000,40411,Vincent Mathieu,22958,282547,2022-11-03
TRANSFER,263323,Vincent Mathieu,282547,19224,Pénélope Ollivier,671789,408466,2022-11-04
CASH_OUT,5485,Vincent Mathieu,19224,13739,Agence_mtn_Abomey,300000,294515,2022-11-05
CASH_IN,150100,Agence_mtn_Cotonou,300000,149900,Vincent Mathieu,13739,163839,2022-11-05
TRANSFER,132201,Vincent Mathieu,163839,31638,Antoinette Bertrand,1487593,1355392,2022-11-07
CASH_OUT,25937,Vincent Mathieu,31638,5701,Agence_mtn_Abomey,300000,274063,2022-11-08
CASH_OUT,4675,Vincent Mathieu,5701,1026,Agence_mtn_Abomey,300000,295325,2022-11-08
CASH_OUT,356,Vincent Mathieu,1026,670,Agence_mtn_Ouidah,300000,299644,2022-11-08
TRANSFER,511,Vincent Mathieu,670,159,Joséphine Gros,9360,8849,2022-11-08
CASH_OUT,116,Vincent Mathieu,159,43,Agence_mtn_Cotonou,300000,299884,2022-11-09
CASH_IN,11154,Agence_mtn_Abomey,300000,288846,Vincent Mathieu,43,11197,2022-11-09
CASH_OUT,8839,Vincent Mathieu,11197,2358,Agence_mtn_Abomey,300000,291161,2022-11-12
CASH_IN,140132,Agence_mtn_Cotonou,300000,159868,Vincent Mathieu,2358,142490,2022-11-14
CASH_IN,290691,Agence_mtn_Cotonou,300000,9309,Vincent Mathieu,142490,433181,2022-11-14
CASH_IN,171778,Agence_mtn_Cotonou,300000,128222,Vincent Mathieu,433181,604959,2022-11-17
TRANSFER,320048,Thierry Delattre-Simon,345095,25047,Vincent Mathieu,604959,925007,2022-11-18
CASH_IN,147781,Agence_mtn_Cotonou,300000,152219,Vincent Mathieu,925007,1072788,2022-11-21
CASH_IN,229230,Agence_mtn_Cotonou,300000,70770,Vincent Mathieu,1072788,1302018,2022-11-21
TRANSFER,96449,Pierre Reynaud,479947,383498,Vincent Mathieu,1302018,1398467,2022-11-22
CASH_IN,103423,Agence_mtn_Abomey,300000,196577,Vincent Mathieu,1398467,1501890,2022-11-23
TRANSFER,146901,Théodore De Oliveira-Nicolas,968208,821307,Vincent Mathieu,1501890,1648791,2022-11-24
CASH_OUT,918256,Vincent Mathieu,1648791,730535,Agence_mtn_Abomey,300000,-618256,2022-11-25
CASH_IN,35992,Agence_mtn_Abomey,300000,264008,Vincent Mathieu,730535,766527,2022-11-26
CASH_IN,109412,Agence_mtn_Cotonou,300000,190588,Léon Lecoq,-41879,67533,2022-11-03
TRANSFER,31877,Léon Lecoq,67533,35656,Frédéric Couturier,259376,227499,2022-11-06
CASH_OUT,11765,Léon Lecoq,35656,23891,Agence_mtn_Cotonou,300000,288235,2022-11-09
CASH_OUT,21875,Léon Lecoq,23891,2016,Agence_mtn_Cotonou,300000,278125,2022-11-11
CASH_OUT,852,Léon Lecoq,2016,1164,Agence_mtn_Abomey,300000,299148,2022-11-11
CASH_IN,14091,Agence_mtn_Abomey,300000,285909,Léon Lecoq,1164,15255,2022-11-11
TRANSFER,8296,Léon Lecoq,15255,6959,Honoré du Laurent,155933,147637,2022-11-13
TRANSFER,2658,Léon Lecoq,6959,4301,Théodore De Oliveira-Nicolas,821307,818649,2022-11-13
CASH_IN,118544,Agence_mtn_Abomey,300000,181456,Léon Lecoq,4301,122845,2022-11-13
CASH_IN,74446,Agence_mtn_Ouidah,300000,225554,Léon Lecoq,122845,197291,2022-11-15
CASH_OUT,11773,Léon Lecoq,197291,185518,Agence_mtn_Abomey,300000,288227,2022-11-16
CASH_IN,90730,Agence_mtn_Cotonou,300000,209270,Léon Lecoq,185518,276248,2022-11-18
CASH_IN,51422,Agence_mtn_Ouidah,300000,248578,Léon Lecoq,276248,327670,2022-11-22
TRANSFER,315929,Léon Lecoq,327670,11741,Astrid Gay de la Brunet,430333,114404,2022-11-22
TRANSFER,600353,Valentine Martinez,1316489,716136,Léon Lecoq,11741,612094,2022-11-22
TRANSFER,1087986,Nathalie Peron,1173613,85627,Léon Lecoq,612094,1700080,2022-11-23
TRANSFER,691023,Léon Lecoq,1700080,1009057,Inès de Letellier,1242581,551558,2022-11-23
CASH_OUT,742870,Léon Lecoq,1009057,266187,Agence_mtn_Abomey,300000,-442870,2022-11-23
CASH_IN,60584,Agence_mtn_Abomey,300000,239416,Léon Lecoq,266187,326771,2022-11-25
TRANSFER,139934,Valentine Richard-Bourdon,151368,11434,Léon Lecoq,326771,466705,2022-11-26
CASH_OUT,197388,Léon Lecoq,466705,269317,Agence_mtn_Ouidah,300000,102612,2022-11-27
CASH_IN,291281,Agence_mtn_Abomey,300000,8719,Gilbert Foucher,-202567,88714,2022-11-02
CASH_IN,294657,Agence_mtn_Ouidah,300000,5343,Gilbert Foucher,88714,383371,2022-11-03
TRANSFER,939232,Adèle Labbé,1019225,79993,Gilbert Foucher,383371,1322603,2022-11-06
CASH_OUT,660268,Gilbert Foucher,1322603,662335,Agence_mtn_Ouidah,300000,-360268,2022-11-07
CASH_OUT,481720,Gilbert Foucher,662335,180615,Agence_mtn_Abomey,300000,-181720,2022-11-08
CASH_IN,156647,Agence_mtn_Abomey,300000,143353,Gilbert Foucher,180615,337262,2022-11-08
CASH_IN,289023,Agence_mtn_Ouidah,300000,10977,Gilbert Foucher,337262,626285,2022-11-09
CASH_OUT,343435,Gilbert Foucher,626285,282850,Agence_mtn_Abomey,300000,-43435,2022-11-10
TRANSFER,92304,Gilbert Foucher,282850,190546,Richard Le Descamps,227274,134970,2022-11-12
CASH_IN,133284,Agence_mtn_Abomey,300000,166716,Gilbert Foucher,190546,323830,2022-11-15
TRANSFER,184796,Gilbert Foucher,323830,139034,Cécile Clerc,331590,146794,2022-11-16
TRANSFER,28519,Gilbert Foucher,139034,110515,Valentine Martinez,716136,687617,2022-11-17
TRANSFER,567015,Xavier de Lebreton,675686,108671,Gilbert Foucher,110515,677530,2022-11-17
TRANSFER,167575,Gilbert Foucher,677530,509955,Richard Le Descamps,134970,-32605,2022-11-18
TRANSFER,287568,Pierre Reynaud,383498,95930,Gilbert Foucher,509955,797523,2022-11-18
CASH_IN,174651,Agence_mtn_Cotonou,300000,125349,Gilbert Foucher,797523,972174,2022-11-18
TRANSFER,134327,Gilbert Foucher,972174,837847,David Guérin,37771,-96556,2022-11-20
TRANSFER,47027,Frédéric Couturier,227499,180472,Gilbert Foucher,837847,884874,2022-11-21
TRANSFER,192479,Gilbert Foucher,884874,692395,Valentine Richard-Bourdon,11434,-181045,2022-11-21
CASH_IN,191207,Agence_mtn_Cotonou,300000,108793,Gilbert Foucher,692395,883602,2022-11-21
CASH_OUT,326220,Gilbert Foucher,883602,557382,Agence_mtn_Ouidah,300000,-26220,2022-11-25
TRANSFER,521220,Gilbert Foucher,557382,36162,Franck-Charles Texier,228024,-293196,2022-11-25
TRANSFER,4419,Gilbert Foucher,36162,31743,Marcelle Paris,1314539,1310120,2022-11-25
CASH_IN,205077,Agence_mtn_Cotonou,300000,94923,Gilbert Foucher,31743,236820,2022-11-26
TRANSFER,19186,Thierry Delattre-Simon,25047,5861,Gilbert Foucher,236820,256006,2022-11-26
CASH_OUT,43040,Gilbert Foucher,256006,212966,Agence_mtn_Cotonou,300000,256960,2022-11-27
CASH_IN,269072,Agence_mtn_Ouidah,300000,30928,Gilbert Foucher,212966,482038,2022-11-27
CASH_IN,241356,Agence_mtn_Abomey,300000,58644,Renée David,953119,1194475,2022-11-01
CASH_IN,3939,Agence_mtn_Abomey,300000,296061,Renée David,1194475,1198414,2022-11-02
CASH_OUT,1123952,Renée David,1198414,74462,Agence_mtn_Ouidah,300000,-823952,2022-11-06
TRANSFER,991588,Marcelle Paris,1310120,318532,Renée David,74462,1066050,2022-11-08
TRANSFER,310026,Renée David,1066050,756024,Pénélope Ollivier,408466,98440,2022-11-09
CASH_OUT,599973,Renée David,756024,156051,Agence_mtn_Cotonou,300000,-299973,2022-11-09
CASH_IN,175036,Agence_mtn_Ouidah,300000,124964,Renée David,156051,331087,2022-11-11
CASH_OUT,321488,Renée David,331087,9599,Agence_mtn_Abomey,300000,-21488,2022-11-11
CASH_IN,157606,Agence_mtn_Cotonou,300000,142394,Renée David,9599,167205,2022-11-13
CASH_IN,144323,Agence_mtn_Cotonou,300000,155677,Renée David,167205,311528,2022-11-18
TRANSFER,279149,Renée David,311528,32379,Thierry Delattre-Simon,5861,-273288,2022-11-20
CASH_IN,145999,Agence_mtn_Ouidah,300000,154001,Renée David,32379,178378,2022-11-20
CASH_IN,162291,Agence_mtn_Cotonou,300000,137709,Renée David,178378,340669,2022-11-21
TRANSFER,224547,Renée David,340669,116122,Joséphine Gros,8849,-215698,2022-11-21
CASH_OUT,110333,Renée David,116122,5789,Agence_mtn_Cotonou,300000,189667,2022-11-21
CASH_IN,249339,Agence_mtn_Abomey,300000,50661,Renée David,5789,255128,2022-11-23
TRANSFER,42077,Émilie Moulin,87824,45747,Renée David,255128,297205,2022-11-23
CASH_IN,149291,Agence_mtn_Cotonou,300000,150709,Renée David,297205,446496,2022-11-24
CASH_OUT,306594,Renée David,446496,139902,Agence_mtn_Cotonou,300000,-6594,2022-11-24
CASH_IN,238568,Agence_mtn_Ouidah,300000,61432,Renée David,139902,378470,2022-11-25
TRANSFER,224373,Gabriel Humbert,481847,257474,Renée David,378470,602843,2022-11-26
TRANSFER,61770,Alexandre Rémy,68585,6815,Renée David,602843,664613,2022-11-27
CASH_IN,148076,Agence_mtn_Abomey,300000,151924,Renée David,664613,812689,2022-11-27
TRANSFER,16167,Corinne-Louise Valentin,125017,108850,Renée David,812689,828856,2022-11-27
CASH_OUT,7330,Renée David,828856,821526,Agence_mtn_Abomey,300000,292670,2022-11-27
CASH_IN,266846,Agence_mtn_Abomey,300000,33154,Philippine Courtois,347133,613979,2022-11-01
CASH_IN,82571,Agence_mtn_Ouidah,300000,217429,Philippine Courtois,613979,696550,2022-11-02
CASH_IN,26464,Agence_mtn_Abomey,300000,273536,Philippine Courtois,696550,723014,2022-11-03
CASH_IN,285074,Agence_mtn_Cotonou,300000,14926,Philippine Courtois,723014,1008088,2022-11-04
TRANSFER,116316,Laurent-Bertrand Lefort,157851,41535,Philippine Courtois,1008088,1124404,2022-11-04
TRANSFER,26921,Adèle Labbé,79993,53072,Philippine Courtois,1124404,1151325,2022-11-05
CASH_IN,159526,Agence_mtn_Abomey,300000,140474,Philippine Courtois,1151325,1310851,2022-11-06
CASH_IN,55730,Agence_mtn_Cotonou,300000,244270,Philippine Courtois,1310851,1366581,2022-11-07
CASH_OUT,122589,Philippine Courtois,1366581,1243992,Agence_mtn_Abomey,300000,177411,2022-11-08
CASH_IN,133034,Agence_mtn_Cotonou,300000,166966,Philippine Courtois,1243992,1377026,2022-11-09
CASH_IN,79019,Agence_mtn_Abomey,300000,220981,Philippine Courtois,1377026,1456045,2022-11-10
CASH_IN,178454,Agence_mtn_Cotonou,300000,121546,Philippine Courtois,1456045,1634499,2022-11-10
CASH_OUT,56840,Philippine Courtois,1634499,1577659,Agence_mtn_Cotonou,300000,243160,2022-11-11
TRANSFER,364453,Philippine Courtois,1577659,1213206,Philippine Courtois,1577659,1942112,2022-11-12
CASH_IN,53200,Agence_mtn_Abomey,300000,246800,Philippine Courtois,1213206,1266406,2022-11-13
TRANSFER,718208,Philippine Courtois,1266406,548198,Geneviève De Oliveira-Michel,149328,-568880,2022-11-14
TRANSFER,288565,Rémy Le Michaud,377322,88757,Philippine Courtois,548198,836763,2022-11-14
TRANSFER,33023,Honoré du Laurent,147637,114614,Philippine Courtois,836763,869786,2022-11-16
TRANSFER,102056,Corinne-Louise Valentin,108850,6794,Philippine Courtois,869786,971842,2022-11-16
CASH_OUT,780509,Philippine Courtois,971842,191333,Agence_mtn_Cotonou,300000,-480509,2022-11-18
CASH_IN,131988,Agence_mtn_Cotonou,300000,168012,Philippine Courtois,191333,323321,2022-11-20
CASH_IN,60637,Agence_mtn_Abomey,300000,239363,Philippine Courtois,323321,383958,2022-11-20
CASH_OUT,222459,Philippine Courtois,383958,161499,Agence_mtn_Abomey,300000,77541,2022-11-23
CASH_OUT,87337,Philippine Courtois,161499,74162,Agence_mtn_Cotonou,300000,212663,2022-11-24
CASH_OUT,44632,Philippine Courtois,74162,29530,Agence_mtn_Abomey,300000,255368,2022-11-26
CASH_OUT,491588,Léon Martins-Briand,851539,359951,Agence_mtn_Abomey,300000,-191588,2022-11-09
CASH_IN,175579,Agence_mtn_Abomey,300000,124421,Léon Martins-Briand,359951,535530,2022-11-12
CASH_IN,143246,Agence_mtn_Cotonou,300000,156754,Léon Martins-Briand,535530,678776,2022-11-16
TRANSFER,82925,Virginie Le Gall,103906,20981,Léon Martins-Briand,678776,761701,2022-11-18
CASH_OUT,56466,Léon Martins-Briand,761701,705235,Agence_mtn_Ouidah,300000,243534,2022-11-19
TRANSFER,33579,Pénélope Ollivier,98440,64861,Léon Martins-Briand,705235,738814,2022-11-21
CASH_IN,69089,Agence_mtn_Abomey,300000,230911,Joséphine Gros,-215698,-146609,2022-11-09
CASH_IN,95502,Agence_mtn_Abomey,300000,204498,Joséphine Gros,-146609,-51107,2022-11-12
CASH_IN,222670,Agence_mtn_Abomey,300000,77330,Joséphine Gros,-51107,171563,2022-11-21
CASH_OUT,73030,Joséphine Gros,171563,98533,Agence_mtn_Cotonou,300000,226970,2022-11-21
CASH_IN,239682,Agence_mtn_Abomey,300000,60318,Joséphine Gros,98533,338215,2022-11-22
TRANSFER,55078,Pierre Reynaud,95930,40852,Joséphine Gros,338215,393293,2022-11-26
CASH_IN,21269,Agence_mtn_Abomey,300000,278731,Richard Le Descamps,-32605,-11336,2022-11-04
CASH_IN,271002,Agence_mtn_Abomey,300000,28998,Richard Le Descamps,-11336,259666,2022-11-04
TRANSFER,19117,Richard Le Descamps,259666,240549,William Le Lucas,777,-18340,2022-11-04
TRANSFER,116536,Richard Le Descamps,240549,124013,Richard Le Descamps,240549,357085,2022-11-05
TRANSFER,567178,William Lebrun,1997400,1430222,Richard Le Descamps,124013,691191,2022-11-06
TRANSFER,620692,Richard Le Descamps,691191,70499,Laurent-Bertrand Lefort,41535,-579157,2022-11-06
TRANSFER,211299,William Lebrun,1430222,1218923,Richard Le Descamps,70499,281798,2022-11-06
CASH_OUT,57157,Richard Le Descamps,281798,224641,Agence_mtn_Ouidah,300000,242843,2022-11-09
TRANSFER,138579,Cécile Clerc,146794,8215,Richard Le Descamps,224641,363220,2022-11-10
CASH_OUT,50927,Richard Le Descamps,363220,312293,Agence_mtn_Cotonou,300000,249073,2022-11-10
TRANSFER,64919,Richard Le Descamps,312293,247374,Honoré du Laurent,114614,49695,2022-11-15
TRANSFER,6530,Cécile Clerc,8215,1685,Richard Le Descamps,247374,253904,2022-11-17
CASH_OUT,170604,Richard Le Descamps,253904,83300,Agence_mtn_Ouidah,300000,129396,2022-11-17
TRANSFER,1326058,Antoinette Bertrand,1355392,29334,Richard Le Descamps,83300,1409358,2022-11-18
TRANSFER,1090260,William Lebrun,1218923,128663,Richard Le Descamps,1409358,2499618,2022-11-20
CASH_IN,46141,Agence_mtn_Abomey,300000,253859,Richard Le Descamps,2499618,2545759,2022-11-23
TRANSFER,69355,Gabriel Humbert,257474,188119,Marcelle Paris,318532,249177,2022-11-03
CASH_IN,54801,Agence_mtn_Ouidah,300000,245199,Gabriel Humbert,188119,242920,2022-11-09
CASH_OUT,37439,Gabriel Humbert,242920,205481,Agence_mtn_Ouidah,300000,262561,2022-11-14
CASH_OUT,69302,Gabriel Humbert,205481,136179,Agence_mtn_Cotonou,300000,230698,2022-11-17
CASH_OUT,82264,Gabriel Humbert,136179,53915,Agence_mtn_Ouidah,300000,217736,2022-11-18
CASH_OUT,12397,Gabriel Humbert,53915,41518,Agence_mtn_Ouidah,300000,287603,2022-11-19
TRANSFER,26665,Gabriel Humbert,41518,14853,Virginie Le Gall,20981,-5684,2022-11-22
TRANSFER,4785,Alexandre Rémy,6815,2030,Gabriel Humbert,14853,19638,2022-11-24
CASH_OUT,746,Corinne-Louise Valentin,6794,6048,Agence_mtn_Cotonou,300000,299254,2022-11-01
CASH_IN,258131,Agence_mtn_Ouidah,300000,41869,Corinne-Louise Valentin,6048,264179,2022-11-02
TRANSFER,25155,Corinne-Louise Valentin,264179,239024,Louise Girard,1185259,1160104,2022-11-03
CASH_IN,168697,Agence_mtn_Abomey,300000,131303,Corinne-Louise Valentin,239024,407721,2022-11-04
CASH_IN,33861,Agence_mtn_Abomey,300000,266139,Corinne-Louise Valentin,407721,441582,2022-11-06
CASH_IN,132789,Agence_mtn_Ouidah,300000,167211,Corinne-Louise Valentin,441582,574371,2022-11-08
TRANSFER,186936,Corinne-Louise Valentin,574371,387435,Frédéric Couturier,180472,-6464,2022-11-08
CASH_IN,179911,Agence_mtn_Cotonou,300000,120089,Corinne-Louise Valentin,387435,567346,2022-11-11
CASH_OUT,561122,Corinne-Louise Valentin,567346,6224,Agence_mtn_Abomey,300000,-261122,2022-11-12
CASH_OUT,3959,Corinne-Louise Valentin,6224,2265,Agence_mtn_Abomey,300000,296041,2022-11-12
CASH_IN,18349,Agence_mtn_Cotonou,300000,281651,Corinne-Louise Valentin,2265,20614,2022-11-13
TRANSFER,11789,Corinne-Louise Valentin,20614,8825,Inès de Letellier,551558,539769,2022-11-14
CASH_OUT,3237,Corinne-Louise Valentin,8825,5588,Agence_mtn_Abomey,300000,296763,2022-11-16
CASH_IN,257559,Agence_mtn_Abomey,300000,42441,Corinne-Louise Valentin,5588,263147,2022-11-18
CASH_OUT,123471,Corinne-Louise Valentin,263147,139676,Agence_mtn_Ouidah,300000,176529,2022-11-23
CASH_OUT,84886,Corinne-Louise Valentin,139676,54790,Agence_mtn_Cotonou,300000,215114,2022-11-24
CASH_IN,77329,Agence_mtn_Abomey,300000,222671,Corinne-Louise Valentin,54790,132119,2022-11-24
TRANSFER,125529,Corinne-Louise Valentin,132119,6590,Honoré du Laurent,49695,-75834,2022-11-25
CASH_OUT,83274,Emmanuelle Georges,160178,76904,Agence_mtn_Cotonou,300000,216726,2022-11-01
TRANSFER,241111,Valentine Martinez,687617,446506,Emmanuelle Georges,76904,318015,2022-11-05
CASH_OUT,127926,Emmanuelle Georges,318015,190089,Agence_mtn_Cotonou,300000,172074,2022-11-13
CASH_OUT,29771,Emmanuelle Georges,190089,160318,Agence_mtn_Cotonou,300000,270229,2022-11-15
CASH_OUT,139313,Emmanuelle Georges,160318,21005,Agence_mtn_Abomey,300000,160687,2022-11-15
CASH_OUT,7446,Emmanuelle Georges,21005,13559,Agence_mtn_Cotonou,300000,292554,2022-11-16
CASH_OUT,4123,Emmanuelle Georges,13559,9436,Agence_mtn_Cotonou,300000,295877,2022-11-17
TRANSFER,6517,Emmanuelle Georges,9436,2919,Nathalie Pages,87984,81467,2022-11-22
TRANSFER,2759,Emmanuelle Georges,2919,160,Émilie Moulin,45747,42988,2022-11-23
CASH_OUT,103,Emmanuelle Georges,160,57,Agence_mtn_Cotonou,300000,299897,2022-11-24
CASH_IN,99791,Agence_mtn_Ouidah,300000,200209,Gabriel-Tristan Marty,-427191,-327400,2022-11-02
CASH_IN,125500,Agence_mtn_Abomey,300000,174500,Gabriel-Tristan Marty,-327400,-201900,2022-11-04
CASH_IN,86621,Agence_mtn_Cotonou,300000,213379,Gabriel-Tristan Marty,-201900,-115279,2022-11-07
CASH_IN,167335,Agence_mtn_Abomey,300000,132665,Gabriel-Tristan Marty,-115279,52056,2022-11-08
TRANSFER,637080,Geneviève Grondin,693902,56822,Gabriel-Tristan Marty,52056,689136,2022-11-09
TRANSFER,318136,Gabriel-Tristan Marty,689136,371000,Gabriel-Tristan Marty,689136,371000,2022-11-09
TRANSFER,4930,Antoinette Bertrand,29334,24404,Gabriel-Tristan Marty,371000,375930,2022-11-13
TRANSFER,65146,Gabriel-Tristan Marty,375930,310784,Louise Girard,1160104,1094958,2022-11-15
TRANSFER,208753,Gabriel-Tristan Marty,310784,102031,Pierre Roger,286680,77927,2022-11-17
CASH_IN,235721,Agence_mtn_Cotonou,300000,64279,Gabriel-Tristan Marty,102031,337752,2022-11-23
CASH_OUT,89381,Gabriel-Tristan Marty,337752,248371,Agence_mtn_Abomey,300000,210619,2022-11-24
TRANSFER,242835,Gabriel-Tristan Marty,248371,5536,Alexandre Rémy,2030,-240805,2022-11-24
CASH_OUT,5005,Gabriel-Tristan Marty,5536,531,Agence_mtn_Cotonou,300000,294995,2022-11-25
CASH_IN,74026,Agence_mtn_Abomey,300000,225974,Gabriel-Tristan Marty,531,74557,2022-11-26
TRANSFER,25795,Émilie Moulin,42988,17193,Inès de Letellier,539769,565564,2022-11-01
CASH_IN,243618,Agence_mtn_Abomey,300000,56382,Inès de Letellier,565564,809182,2022-11-02
CASH_OUT,59545,Inès de Letellier,809182,749637,Agence_mtn_Ouidah,300000,240455,2022-11-03
TRANSFER,258008,Inès de Letellier,749637,491629,Marcelle Paris,249177,-8831,2022-11-05
CASH_OUT,18828,Inès de Letellier,491629,472801,Agence_mtn_Cotonou,300000,281172,2022-11-05
CASH_OUT,94150,Inès de Letellier,472801,378651,Agence_mtn_Cotonou,300000,205850,2022-11-06
CASH_IN,138604,Agence_mtn_Ouidah,300000,161396,Inès de Letellier,378651,517255,2022-11-06
CASH_OUT,408901,Inès de Letellier,517255,108354,Agence_mtn_Cotonou,300000,-108901,2022-11-06
TRANSFER,728563,Margot Riou du Fernandes,1686390,957827,Inès de Letellier,108354,836917,2022-11-07
CASH_IN,31476,Agence_mtn_Cotonou,300000,268524,Inès de Letellier,836917,868393,2022-11-07
CASH_IN,166914,Agence_mtn_Abomey,300000,133086,Inès de Letellier,868393,1035307,2022-11-08
CASH_IN,224501,Agence_mtn_Ouidah,300000,75499,Inès de Letellier,1035307,1259808,2022-11-10
CASH_IN,192628,Agence_mtn_Cotonou,300000,107372,Inès de Letellier,1259808,1452436,2022-11-10
TRANSFER,1397548,Inès de Letellier,1452436,54888,Xavier de Lebreton,108671,-1288877,2022-11-10
TRANSFER,46073,Inès de Letellier,54888,8815,Inès de Letellier,54888,8815,2022-11-11
CASH_OUT,1290,Inès de Letellier,8815,7525,Agence_mtn_Cotonou,300000,298710,2022-11-16
CASH_OUT,6288,Inès de Letellier,7525,1237,Agence_mtn_Abomey,300000,293712,2022-11-16
CASH_OUT,779,Inès de Letellier,1237,458,Agence_mtn_Abomey,300000,299221,2022-11-17
TRANSFER,9096,Astrid Gay de la Brunet,114404,105308,Inès de Letellier,458,9554,2022-11-18
CASH_IN,152153,Agence_mtn_Cotonou,300000,147847,Virginie Le Gall,-5684,146469,2022-11-01
TRANSFER,55279,Simone Pineau,216508,161229,Virginie Le Gall,146469,201748,2022-11-03
TRANSFER,41510,Pierre Roger,77927,36417,Virginie Le Gall,201748,243258,2022-11-05
TRANSFER,215589,Louise Girard,1094958,879369,Virginie Le Gall,243258,458847,2022-11-07
TRANSFER,93863,Astrid Gay de la Brunet,105308,11445,Virginie Le Gall,458847,552710,2022-11-07
TRANSFER,319086,Virginie Le Gall,552710,233624,Virginie Le Gall,552710,233624,2022-11-07
CASH_OUT,72198,Virginie Le Gall,233624,161426,Agence_mtn_Cotonou,300000,227802,2022-11-10
TRANSFER,64378,Virginie Le Gall,161426,97048,Théodore De Oliveira-Nicolas,818649,754271,2022-11-12
TRANSFER,371600,Sébastien Vallée,374404,2804,Virginie Le Gall,97048,468648,2022-11-12
CASH_IN,189192,Agence_mtn_Cotonou,300000,110808,Virginie Le Gall,468648,657840,2022-11-14
CASH_OUT,289144,Virginie Le Gall,657840,368696,Agence_mtn_Cotonou,300000,10856,2022-11-15
TRANSFER,7875,Émilie Moulin,17193,9318,Virginie Le Gall,368696,376571,2022-11-16
CASH_OUT,145715,Virginie Le Gall,376571,230856,Agence_mtn_Ouidah,300000,154285,2022-11-16
CASH_IN,165641,Agence_mtn_Cotonou,300000,134359,Virginie Le Gall,230856,396497,2022-11-16
CASH_OUT,325671,Virginie Le Gall,396497,70826,Agence_mtn_Ouidah,300000,-25671,2022-11-17
CASH_IN,270419,Agence_mtn_Cotonou,300000,29581,Virginie Le Gall,70826,341245,2022-11-19
CASH_IN,117477,Agence_mtn_Cotonou,300000,182523,Virginie Le Gall,341245,458722,2022-11-21
CASH_OUT,277768,Virginie Le Gall,458722,180954,Agence_mtn_Cotonou,300000,22232,2022-11-24
CASH_OUT,134933,Virginie Le Gall,180954,46021,Agence_mtn_Cotonou,300000,165067,2022-11-26
CASH_IN,210717,Agence_mtn_Cotonou,300000,89283,Virginie Le Gall,46021,256738,2022-11-27
TRANSFER,297931,Louise Girard,879369,581438,William Lebrun,128663,426594,2022-11-04
CASH_IN,192144,Agence_mtn_Abomey,300000,107856,William Lebrun,426594,618738,2022-11-06
CASH_IN,92321,Agence_mtn_Ouidah,300000,207679,William Lebrun,618738,711059,2022-11-06
CASH_IN,144190,Agence_mtn_Abomey,300000,155810,William Lebrun,711059,855249,2022-11-17
CASH_OUT,527369,William Lebrun,855249,327880,Agence_mtn_Abomey,300000,-227369,2022-11-25
TRANSFER,28540,Geneviève Grondin,56822,28282,William Lebrun,327880,356420,2022-11-26
CASH_IN,285924,Agence_mtn_Cotonou,300000,14076,Alphonse Le Olivier,-1506559,-1220635,2022-11-02
CASH_IN,122046,Agence_mtn_Abomey,300000,177954,Alphonse Le Olivier,-1220635,-1098589,2022-11-04
CASH_IN,31989,Agence_mtn_Ouidah,300000,268011,Alphonse Le Olivier,-1098589,-1066600,2022-11-07
CASH_IN,196731,Agence_mtn_Cotonou,300000,103269,Alphonse Le Olivier,-1066600,-869869,2022-11-07
CASH_IN,207567,Agence_mtn_Ouidah,300000,92433,Alphonse Le Olivier,-869869,-662302,2022-11-08
CASH_IN,116738,Agence_mtn_Cotonou,300000,183262,Alphonse Le Olivier,-662302,-545564,2022-11-09
CASH_IN,249013,Agence_mtn_Cotonou,300000,50987,Alphonse Le Olivier,-545564,-296551,2022-11-10
CASH_IN,23976,Agence_mtn_Ouidah,300000,276024,Alphonse Le Olivier,-296551,-272575,2022-11-12
CASH_IN,285607,Agence_mtn_Cotonou,300000,14393,Alphonse Le Olivier,-272575,13032,2022-11-15
CASH_IN,49823,Agence_mtn_Ouidah,300000,250177,Alphonse Le Olivier,13032,62855,2022-11-15
CASH_IN,106068,Agence_mtn_Ouidah,300000,193932,Alphonse Le Olivier,62855,168923,2022-11-16
CASH_OUT,16830,Alphonse Le Olivier,168923,152093,Agence_mtn_Abomey,300000,283170,2022-11-18
CASH_OUT,35796,Alphonse Le Olivier,152093,116297,Agence_mtn_Cotonou,300000,264204,2022-11-24
CASH_OUT,5561,Alphonse Le Olivier,116297,110736,Agence_mtn_Abomey,300000,294439,2022-11-26
CASH_IN,204767,Agence_mtn_Cotonou,300000,95233,Valentine Richard-Bourdon,-181045,23722,2022-11-04
TRANSFER,6408,Antoinette Bertrand,24404,17996,Valentine Richard-Bourdon,23722,30130,2022-11-04
CASH_IN,61890,Agence_mtn_Cotonou,300000,238110,Valentine Richard-Bourdon,30130,92020,2022-11-06
CASH_OUT,38843,Valentine Richard-Bourdon,92020,53177,Agence_mtn_Ouidah,300000,261157,2022-11-06
CASH_IN,32124,Agence_mtn_Cotonou,300000,267876,Valentine Richard-Bourdon,53177,85301,2022-11-08
CASH_IN,18602,Agence_mtn_Ouidah,300000,281398,Valentine Richard-Bourdon,85301,103903,2022-11-11
CASH_OUT,20317,Valentine Richard-Bourdon,103903,83586,Agence_mtn_Ouidah,300000,279683,2022-11-12
TRANSFER,29780,Valentine Richard-Bourdon,83586,53806,Astrid Gay de la Brunet,11445,-18335,2022-11-15
CASH_OUT,29906,Valentine Richard-Bourdon,53806,23900,Agence_mtn_Ouidah,300000,270094,2022-11-17
CASH_OUT,21669,Valentine Richard-Bourdon,23900,2231,Agence_mtn_Abomey,300000,278331,2022-11-18
TRANSFER,823,Valentine Richard-Bourdon,2231,1408,Simone Pineau,161229,160406,2022-11-21
TRANSFER,9782,Geneviève Grondin,28282,18500,Valentine Richard-Bourdon,1408,11190,2022-11-22
CASH_OUT,6680,Valentine Richard-Bourdon,11190,4510,Agence_mtn_Abomey,300000,293320,2022-11-25
CASH_OUT,4420,Valentine Richard-Bourdon,4510,90,Agence_mtn_Ouidah,300000,295580,2022-11-25
CASH_IN,191001,Agence_mtn_Cotonou,300000,108999,Antoine Leleu,-61466,129535,2022-11-01
CASH_OUT,36955,Antoine Leleu,129535,92580,Agence_mtn_Abomey,300000,263045,2022-11-01
CASH_IN,63626,Agence_mtn_Cotonou,300000,236374,Antoine Leleu,92580,156206,2022-11-04
CASH_IN,283627,Agence_mtn_Abomey,300000,16373,Antoine Leleu,156206,439833,2022-11-06
CASH_OUT,176850,Antoine Leleu,439833,262983,Agence_mtn_Cotonou,300000,123150,2022-11-11
CASH_IN,271227,Agence_mtn_Cotonou,300000,28773,Antoine Leleu,262983,534210,2022-11-12
CASH_OUT,264329,Antoine Leleu,534210,269881,Agence_mtn_Cotonou,300000,35671,2022-11-13
CASH_OUT,214,Antoine Leleu,269881,269667,Agence_mtn_Cotonou,300000,299786,2022-11-15
CASH_IN,114123,Agence_mtn_Cotonou,300000,185877,Antoine Leleu,269667,383790,2022-11-18
TRANSFER,217898,Antoine Leleu,383790,165892,Théodore De Oliveira-Nicolas,754271,536373,2022-11-22
CASH_IN,206625,Agence_mtn_Ouidah,300000,93375,Honoré du Laurent,-75834,130791,2022-11-05
CASH_OUT,47672,Honoré du Laurent,130791,83119,Agence_mtn_Cotonou,300000,252328,2022-11-06
TRANSFER,81191,Honoré du Laurent,83119,1928,Émilie Moulin,9318,-71873,2022-11-13
CASH_IN,68735,Agence_mtn_Ouidah,300000,231265,Honoré du Laurent,1928,70663,2022-11-14
CASH_IN,184411,Agence_mtn_Ouidah,300000,115589,Honoré du Laurent,70663,255074,2022-11-17
TRANSFER,12553,Louise Girard,581438,568885,Honoré du Laurent,255074,267627,2022-11-24
TRANSFER,35197,Honoré du Laurent,267627,232430,Geneviève Grondin,18500,-16697,2022-11-24
TRANSFER,73202,Nathalie Pages,81467,8265,Simone Pineau,160406,87204,2022-11-01
CASH_IN,218368,Agence_mtn_Cotonou,300000,81632,Nathalie Pages,8265,226633,2022-11-08
CASH_IN,148159,Agence_mtn_Abomey,300000,151841,Nathalie Pages,226633,374792,2022-11-09
TRANSFER,260741,Nathalie Pages,374792,114051,Rémy Le Michaud,88757,-171984,2022-11-12
CASH_OUT,95379,Nathalie Pages,114051,18672,Agence_mtn_Abomey,300000,204621,2022-11-16
CASH_OUT,16028,Nathalie Pages,18672,2644,Agence_mtn_Cotonou,300000,283972,2022-11-27
CASH_IN,114818,Agence_mtn_Cotonou,300000,185182,Alix Maillet,-75840,38978,2022-11-01
CASH_IN,298876,Agence_mtn_Cotonou,300000,1124,Alix Maillet,38978,337854,2022-11-04
TRANSFER,333900,Alix Maillet,337854,3954,Margot Riou du Fernandes,957827,623927,2022-11-08
CASH_IN,201984,Agence_mtn_Cotonou,300000,98016,Alix Maillet,3954,205938,2022-11-08
TRANSFER,24574,Alix Maillet,205938,181364,Valentine Martinez,446506,421932,2022-11-10
CASH_OUT,137407,Alix Maillet,181364,43957,Agence_mtn_Abomey,300000,162593,2022-11-13
CASH_IN,96539,Agence_mtn_Cotonou,300000,203461,Alix Maillet,43957,140496,2022-11-14
TRANSFER,67704,Nathalie Peron,85627,17923,Alix Maillet,140496,208200,2022-11-20
CASH_OUT,161242,Alix Maillet,208200,46958,Agence_mtn_Cotonou,300000,138758,2022-11-20
CASH_IN,36378,Agence_mtn_Abomey,300000,263622,Alix Maillet,46958,83336,2022-11-25
CASH_IN,131694,Agence_mtn_Abomey,300000,168306,Sophie Gonzalez,-958311,-826617,2022-11-01
CASH_IN,86356,Agence_mtn_Ouidah,300000,213644,Sophie Gonzalez,-826617,-740261,2022-11-04
CASH_IN,275077,Agence_mtn_Ouidah,300000,24923,Sophie Gonzalez,-740261,-465184,2022-11-09
CASH_IN,71752,Agence_mtn_Ouidah,300000,228248,Sophie Gonzalez,-465184,-393432,2022-11-10
CASH_IN,140578,Agence_mtn_Abomey,300000,159422,Sophie Gonzalez,-393432,-252854,2022-11-10
CASH_IN,225403,Agence_mtn_Ouidah,300000,74597,Sophie Gonzalez,-252854,-27451,2022-11-23
CASH_IN,218117,Agence_mtn_Ouidah,300000,81883,Sophie Gonzalez,-27451,190666,2022-11-25
CASH_OUT,51323,Sophie Gonzalez,190666,139343,Agence_mtn_Cotonou,300000,248677,2022-11-26
TRANSFER,5168,Nathalie Peron,17923,12755,Pierre Roger,36417,31249,2022-11-01
CASH_IN,188745,Agence_mtn_Abomey,300000,111255,Nathalie Peron,12755,201500,2022-11-04
CASH_OUT,81141,Nathalie Peron,201500,120359,Agence_mtn_Ouidah,300000,218859,2022-11-05
TRANSFER,74062,Nathalie Peron,120359,46297,Xavier Leblanc-Ferreira,840144,766082,2022-11-05
TRANSFER,1620,Sébastien Vallée,2804,1184,Nathalie Peron,46297,47917,2022-11-12
CASH_IN,117886,Agence_mtn_Cotonou,300000,182114,Nathalie Peron,47917,165803,2022-11-23
CASH_OUT,130389,Nathalie Peron,165803,35414,Agence_mtn_Abomey,300000,169611,2022-11-27
CASH_IN,164807,Agence_mtn_Ouidah,300000,135193,Pénélope Ollivier,64861,229668,2022-11-03
TRANSFER,123438,Pénélope Ollivier,229668,106230,Cécile Clerc,1685,-121753,2022-11-03
CASH_IN,23413,Agence_mtn_Cotonou,300000,276587,Pénélope Ollivier,106230,129643,2022-11-03
CASH_OUT,120720,Pénélope Ollivier,129643,8923,Agence_mtn_Abomey,300000,179280,2022-11-04
CASH_IN,100170,Agence_mtn_Ouidah,300000,199830,Pénélope Ollivier,8923,109093,2022-11-06
CASH_OUT,52416,Pénélope Ollivier,109093,56677,Agence_mtn_Cotonou,300000,247584,2022-11-14
CASH_IN,7553,Agence_mtn_Ouidah,300000,292447,Pénélope Ollivier,56677,64230,2022-11-14
TRANSFER,1688,Antoinette Bertrand,17996,16308,Pénélope Ollivier,64230,65918,2022-11-22
TRANSFER,8691,Pénélope Ollivier,65918,57227,Valentine Martinez,421932,413241,2022-11-23
CASH_OUT,12343,Pénélope Ollivier,57227,44884,Agence_mtn_Abomey,300000,287657,2022-11-24
CASH_IN,233668,Agence_mtn_Abomey,300000,66332,Pénélope Ollivier,44884,278552,2022-11-25
CASH_IN,212169,Agence_mtn_Cotonou,300000,87831,Adrien Chartier,-165462,46707,2022-11-03
TRANSFER,281298,Valentine Martinez,413241,131943,Adrien Chartier,46707,328005,2022-11-05
CASH_OUT,232891,Adrien Chartier,328005,95114,Agence_mtn_Cotonou,300000,67109,2022-11-07
CASH_OUT,40556,Adrien Chartier,95114,54558,Agence_mtn_Abomey,300000,259444,2022-11-08
CASH_OUT,3012,Adrien Chartier,54558,51546,Agence_mtn_Cotonou,300000,296988,2022-11-10
CASH_OUT,38009,Adrien Chartier,51546,13537,Agence_mtn_Abomey,300000,261991,2022-11-10
CASH_IN,124056,Agence_mtn_Ouidah,300000,175944,Adrien Chartier,13537,137593,2022-11-11
CASH_OUT,33257,Adrien Chartier,137593,104336,Agence_mtn_Ouidah,300000,266743,2022-11-11
CASH_OUT,28614,Adrien Chartier,104336,75722,Agence_mtn_Abomey,300000,271386,2022-11-11
CASH_IN,97924,Agence_mtn_Ouidah,300000,202076,Adrien Chartier,75722,173646,2022-11-18
CASH_OUT,159681,Adrien Chartier,173646,13965,Agence_mtn_Cotonou,300000,140319,2022-11-18
CASH_IN,55620,Agence_mtn_Abomey,300000,244380,Adrien Chartier,13965,69585,2022-11-21
CASH_OUT,68767,Adrien Chartier,69585,818,Agence_mtn_Abomey,300000,231233,2022-11-22
TRANSFER,525,Adrien Chartier,818,293,Adrien Chartier,818,1343,2022-11-22
TRANSFER,236,Adrien Chartier,293,57,Valentine Martinez,131943,131707,2022-11-22
CASH_IN,17834,Agence_mtn_Abomey,300000,282166,Adrien Chartier,57,17891,2022-11-23
CASH_IN,90911,Agence_mtn_Abomey,300000,209089,Adrien Chartier,17891,108802,2022-11-23
CASH_OUT,95507,Adrien Chartier,108802,13295,Agence_mtn_Cotonou,300000,204493,2022-11-25
CASH_IN,268615,Agence_mtn_Ouidah,300000,31385,Adrien Chartier,13295,281910,2022-11-26
CASH_IN,32714,Agence_mtn_Cotonou,300000,267286,Adrien Chartier,281910,314624,2022-11-26
CASH_IN,131832,Agence_mtn_Ouidah,300000,168168,William Le Lucas,-18340,113492,2022-11-02
CASH_OUT,86460,William Le Lucas,113492,27032,Agence_mtn_Cotonou,300000,213540,2022-11-03
TRANSFER,8858,Antoinette Bertrand,16308,7450,William Le Lucas,27032,35890,2022-11-06
CASH_OUT,32815,William Le Lucas,35890,3075,Agence_mtn_Cotonou,300000,267185,2022-11-10
CASH_OUT,2013,William Le Lucas,3075,1062,Agence_mtn_Ouidah,300000,297987,2022-11-11
CASH_IN,157299,Agence_mtn_Abomey,300000,142701,William Le Lucas,1062,158361,2022-11-12
TRANSFER,7767,Simone Pineau,87204,79437,William Le Lucas,158361,166128,2022-11-12
CASH_OUT,76147,William Le Lucas,166128,89981,Agence_mtn_Cotonou,300000,223853,2022-11-15
CASH_IN,40944,Agence_mtn_Ouidah,300000,259056,William Le Lucas,89981,130925,2022-11-17
CASH_IN,253715,Agence_mtn_Ouidah,300000,46285,William Le Lucas,130925,384640,2022-11-17
CASH_OUT,15956,William Le Lucas,384640,368684,Agence_mtn_Cotonou,300000,284044,2022-11-19
CASH_OUT,106975,William Le Lucas,368684,261709,Agence_mtn_Abomey,300000,193025,2022-11-20
CASH_IN,34212,Agence_mtn_Abomey,300000,265788,William Le Lucas,261709,295921,2022-11-21
CASH_OUT,17292,William Le Lucas,295921,278629,Agence_mtn_Cotonou,300000,282708,2022-11-24
CASH_IN,255413,Agence_mtn_Cotonou,300000,44587,William Le Lucas,278629,534042,2022-11-25
CASH_IN,26724,Agence_mtn_Ouidah,300000,273276,William Le Lucas,534042,560766,2022-11-25
CASH_OUT,477519,William Le Lucas,560766,83247,Agence_mtn_Cotonou,300000,-177519,2022-11-27
CASH_IN,40183,Agence_mtn_Abomey,300000,259817,Geneviève De Oliveira-Michel,-568880,-528697,2022-11-01
CASH_IN,285190,Agence_mtn_Ouidah,300000,14810,Geneviève De Oliveira-Michel,-528697,-243507,2022-11-12
CASH_IN,214117,Agence_mtn_Abomey,300000,85883,Geneviève De Oliveira-Michel,-243507,-29390,2022-11-13
CASH_IN,231923,Agence_mtn_Cotonou,300000,68077,Geneviève De Oliveira-Michel,-29390,202533,2022-11-15
TRANSFER,85668,Valentine Martinez,131707,46039,Geneviève De Oliveira-Michel,202533,288201,2022-11-17
CASH_IN,241787,Agence_mtn_Ouidah,300000,58213,Geneviève De Oliveira-Michel,288201,529988,2022-11-20
TRANSFER,18069,Simone Pineau,79437,61368,Geneviève De Oliveira-Michel,529988,548057,2022-11-21
TRANSFER,365402,Geneviève De Oliveira-Michel,548057,182655,Théodore De Oliveira-Nicolas,536373,170971,2022-11-24
TRANSFER,37444,Valentine Martinez,46039,8595,Geneviève De Oliveira-Michel,182655,220099,2022-11-25
TRANSFER,1970,Antoinette Bertrand,7450,5480,Geneviève De Oliveira-Michel,220099,222069,2022-11-27
CASH_IN,69565,Agence_mtn_Ouidah,300000,230435,Margot Riou du Fernandes,623927,693492,2022-11-05
CASH_IN,29980,Agence_mtn_Abomey,300000,270020,Margot Riou du Fernandes,693492,723472,2022-11-07
CASH_OUT,3837,Margot Riou du Fernandes,723472,719635,Agence_mtn_Cotonou,300000,296163,2022-11-07
CASH_IN,32657,Agence_mtn_Ouidah,300000,267343,Margot Riou du Fernandes,719635,752292,2022-11-08
CASH_IN,120043,Agence_mtn_Ouidah,300000,179957,Margot Riou du Fernandes,752292,872335,2022-11-10
CASH_OUT,94828,Margot Riou du Fernandes,872335,777507,Agence_mtn_Cotonou,300000,205172,2022-11-10
CASH_OUT,402210,Margot Riou du Fernandes,777507,375297,Agence_mtn_Cotonou,300000,-102210,2022-11-11
TRANSFER,25049,Pierre Roger,31249,6200,Margot Riou du Fernandes,375297,400346,2022-11-15
CASH_IN,189921,Agence_mtn_Abomey,300000,110079,Margot Riou du Fernandes,400346,590267,2022-11-18
CASH_OUT,41245,Margot Riou du Fernandes,590267,549022,Agence_mtn_Abomey,300000,258755,2022-11-19
CASH_OUT,518794,Margot Riou du Fernandes,549022,30228,Agence_mtn_Ouidah,300000,-218794,2022-11-23
CASH_OUT,18509,Margot Riou du Fernandes,30228,11719,Agence_mtn_Cotonou,300000,281491,2022-11-26
CASH_IN,286480,Agence_mtn_Cotonou,300000,13520,Astrid Gay de la Brunet,-18335,268145,2022-11-01
TRANSFER,65110,Astrid Gay de la Brunet,268145,203035,Xavier Leblanc-Ferreira,766082,700972,2022-11-03
CASH_IN,194274,Agence_mtn_Ouidah,300000,105726,Astrid Gay de la Brunet,203035,397309,2022-11-03
CASH_OUT,379124,Astrid Gay de la Brunet,397309,18185,Agence_mtn_Abomey,300000,-79124,2022-11-03
CASH_OUT,662,Astrid Gay de la Brunet,18185,17523,Agence_mtn_Ouidah,300000,299338,2022-11-05
CASH_OUT,6894,Astrid Gay de la Brunet,17523,10629,Agence_mtn_Abomey,300000,293106,2022-11-05
CASH_OUT,5367,Astrid Gay de la Brunet,10629,5262,Agence_mtn_Abomey,300000,294633,2022-11-06
CASH_IN,119275,Agence_mtn_Ouidah,300000,180725,Astrid Gay de la Brunet,5262,124537,2022-11-16
CASH_IN,242023,Agence_mtn_Cotonou,300000,57977,Astrid Gay de la Brunet,124537,366560,2022-11-18
TRANSFER,232246,Astrid Gay de la Brunet,366560,134314,Xavier Leblanc-Ferreira,700972,468726,2022-11-18
CASH_OUT,110996,Astrid Gay de la Brunet,134314,23318,Agence_mtn_Abomey,300000,189004,2022-11-19
CASH_OUT,14550,Astrid Gay de la Brunet,23318,8768,Agence_mtn_Abomey,300000,285450,2022-11-20
CASH_IN,123755,Agence_mtn_Ouidah,300000,176245,Astrid Gay de la Brunet,8768,132523,2022-11-22
CASH_IN,169752,Agence_mtn_Ouidah,300000,130248,Geneviève Grondin,-16697,153055,2022-11-01
TRANSFER,11494,Simone Pineau,61368,49874,Geneviève Grondin,153055,164549,2022-11-03
CASH_IN,115421,Agence_mtn_Abomey,300000,184579,Geneviève Grondin,164549,279970,2022-11-04
CASH_OUT,87048,Geneviève Grondin,279970,192922,Agence_mtn_Ouidah,300000,212952,2022-11-12
CASH_OUT,130435,Geneviève Grondin,192922,62487,Agence_mtn_Ouidah,300000,169565,2022-11-13
TRANSFER,1289,Théodore De Oliveira-Nicolas,170971,169682,Geneviève Grondin,62487,63776,2022-11-16
TRANSFER,6420,Valentine Martinez,8595,2175,Geneviève Grondin,63776,70196,2022-11-16
CASH_OUT,39255,Geneviève Grondin,70196,30941,Agence_mtn_Ouidah,300000,260745,2022-11-18
CASH_OUT,6580,Geneviève Grondin,30941,24361,Agence_mtn_Abomey,300000,293420,2022-11-27
CASH_IN,271767,Agence_mtn_Cotonou,300000,28233,Marcelle Paris,-8831,262936,2022-11-04
TRANSFER,130426,Marcelle Paris,262936,132510,Théodore De Oliveira-Nicolas,169682,39256,2022-11-08
TRANSFER,2391,Antoinette Bertrand,5480,3089,Marcelle Paris,132510,134901,2022-11-11
TRANSFER,11800,Simone Pineau,49874,38074,Marcelle Paris,134901,146701,2022-11-11
TRANSFER,125446,Marcelle Paris,146701,21255,Théodore De Oliveira-Nicolas,39256,-86190,2022-11-12
TRANSFER,16930,Adèle Labbé,53072,36142,Marcelle Paris,21255,38185,2022-11-14
CASH_OUT,1600,Marcelle Paris,38185,36585,Agence_mtn_Cotonou,300000,298400,2022-11-15
TRANSFER,164258,Xavier Leblanc-Ferreira,468726,304468,Marcelle Paris,36585,200843,2022-11-16
TRANSFER,106122,Marcelle Paris,200843,94721,Adèle Labbé,36142,-69980,2022-11-19
CASH_IN,40927,Agence_mtn_Abomey,300000,259073,Marcelle Paris,94721,135648,2022-11-19
CASH_IN,284445,Agence_mtn_Ouidah,300000,15555,Marcelle Paris,135648,420093,2022-11-25
CASH_OUT,260882,Marcelle Paris,420093,159211,Agence_mtn_Abomey,300000,39118,2022-11-27
CASH_OUT,27720,Xavier Leblanc-Ferreira,304468,276748,Agence_mtn_Ouidah,300000,272280,2022-11-02
CASH_OUT,176273,Xavier Leblanc-Ferreira,276748,100475,Agence_mtn_Ouidah,300000,123727,2022-11-04
CASH_OUT,59697,Xavier Leblanc-Ferreira,100475,40778,Agence_mtn_Abomey,300000,240303,2022-11-11
CASH_OUT,40620,Xavier Leblanc-Ferreira,40778,158,Agence_mtn_Cotonou,300000,259380,2022-11-11
CASH_OUT,154,Xavier Leblanc-Ferreira,158,4,Agence_mtn_Abomey,300000,299846,2022-11-14
CASH_IN,230825,Agence_mtn_Abomey,300000,69175,Xavier Leblanc-Ferreira,4,230829,2022-11-15
CASH_OUT,25983,Xavier Leblanc-Ferreira,230829,204846,Agence_mtn_Abomey,300000,274017,2022-11-17
CASH_OUT,104549,Xavier Leblanc-Ferreira,204846,100297,Agence_mtn_Abomey,300000,195451,2022-11-22
CASH_OUT,98424,Xavier Leblanc-Ferreira,100297,1873,Agence_mtn_Ouidah,300000,201576,2022-11-23
CASH_OUT,167,Sébastien Vallée,1184,1017,Agence_mtn_Cotonou,300000,299833,2022-11-01
TRANSFER,645,Sébastien Vallée,1017,372,Sébastien Vallée,1017,1662,2022-11-02
CASH_IN,5139,Agence_mtn_Ouidah,300000,294861,Sébastien Vallée,372,5511,2022-11-07
TRANSFER,1306,Valentine Martinez,2175,869,Sébastien Vallée,5511,6817,2022-11-09
CASH_IN,188487,Agence_mtn_Ouidah,300000,111513,Sébastien Vallée,6817,195304,2022-11-11
CASH_OUT,119494,Sébastien Vallée,195304,75810,Agence_mtn_Abomey,300000,180506,2022-11-16
CASH_IN,195565,Agence_mtn_Cotonou,300000,104435,Sébastien Vallée,75810,271375,2022-11-18
CASH_OUT,244306,Sébastien Vallée,271375,27069,Agence_mtn_Cotonou,300000,55694,2022-11-19
TRANSFER,12993,Sébastien Vallée,27069,14076,Valentine Martinez,869,-12124,2022-11-19
TRANSFER,12664,Sébastien Vallée,14076,1412,Pierre Roger,6200,-6464,2022-11-23
TRANSFER,527,Sébastien Vallée,1412,885,Simone Pineau,38074,37547,2022-11-25
CASH_IN,36098,Agence_mtn_Cotonou,300000,263902,Sébastien Vallée,885,36983,2022-11-26
CASH_IN,266410,Agence_mtn_Cotonou,300000,33590,Gilbert-Charles Thibault,40,266450,2022-11-02
CASH_IN,222617,Agence_mtn_Cotonou,300000,77383,Gilbert-Charles Thibault,266450,489067,2022-11-03
CASH_OUT,475540,Gilbert-Charles Thibault,489067,13527,Agence_mtn_Ouidah,300000,-175540,2022-11-06
CASH_OUT,8330,Gilbert-Charles Thibault,13527,5197,Agence_mtn_Abomey,300000,291670,2022-11-08
CASH_IN,263203,Agence_mtn_Cotonou,300000,36797,Gilbert-Charles Thibault,5197,268400,2022-11-09
CASH_IN,96420,Agence_mtn_Abomey,300000,203580,Gilbert-Charles Thibault,268400,364820,2022-11-12
CASH_OUT,180375,Gilbert-Charles Thibault,364820,184445,Agence_mtn_Abomey,300000,119625,2022-11-15
CASH_OUT,143395,Gilbert-Charles Thibault,184445,41050,Agence_mtn_Ouidah,300000,156605,2022-11-21
CASH_IN,121485,Agence_mtn_Ouidah,300000,178515,Gilbert-Charles Thibault,41050,162535,2022-11-24
CASH_IN,166097,Agence_mtn_Ouidah,300000,133903,Émilie Moulin,-71873,94224,2022-11-02
CASH_OUT,10282,Émilie Moulin,94224,83942,Agence_mtn_Ouidah,300000,289718,2022-11-04
CASH_IN,142760,Agence_mtn_Abomey,300000,157240,Émilie Moulin,83942,226702,2022-11-05
CASH_IN,220110,Agence_mtn_Cotonou,300000,79890,Émilie Moulin,226702,446812,2022-11-07
CASH_OUT,372052,Émilie Moulin,446812,74760,Agence_mtn_Abomey,300000,-72052,2022-11-10
TRANSFER,38603,Émilie Moulin,74760,36157,Émilie Moulin,74760,36157,2022-11-11
CASH_OUT,26629,Émilie Moulin,36157,9528,Agence_mtn_Abomey,300000,273371,2022-11-12
TRANSFER,1047,Émilie Moulin,9528,8481,Antoinette Bertrand,3089,2042,2022-11-13
CASH_OUT,5022,Émilie Moulin,8481,3459,Agence_mtn_Cotonou,300000,294978,2022-11-17
CASH_IN,45856,Agence_mtn_Abomey,300000,254144,Émilie Moulin,3459,49315,2022-11-18
CASH_IN,135527,Agence_mtn_Abomey,300000,164473,Émilie Moulin,49315,184842,2022-11-22
TRANSFER,698,Antoinette Bertrand,2042,1344,Émilie Moulin,184842,185540,2022-11-24
CASH_IN,215555,Agence_mtn_Ouidah,300000,84445,Frédéric Couturier,-6464,209091,2022-11-09
TRANSFER,62260,Frédéric Couturier,209091,146831,Antoinette Bertrand,1344,-60916,2022-11-09
CASH_OUT,59506,Frédéric Couturier,146831,87325,Agence_mtn_Abomey,300000,240494,2022-11-11
TRANSFER,39243,Frédéric Couturier,87325,48082,Frédéric Couturier,87325,126568,2022-11-12
CASH_OUT,17626,Frédéric Couturier,48082,30456,Agence_mtn_Cotonou,300000,282374,2022-11-13
TRANSFER,36035,Simone Pineau,37547,1512,Frédéric Couturier,30456,66491,2022-11-14
CASH_IN,167310,Agence_mtn_Cotonou,300000,132690,Frédéric Couturier,66491,233801,2022-11-14
CASH_OUT,108768,Frédéric Couturier,233801,125033,Agence_mtn_Abomey,300000,191232,2022-11-17
CASH_IN,70073,Agence_mtn_Cotonou,300000,229927,Frédéric Couturier,125033,195106,2022-11-18
CASH_OUT,101165,Frédéric Couturier,195106,93941,Agence_mtn_Ouidah,300000,198835,2022-11-26
CASH_IN,97059,Agence_mtn_Ouidah,300000,202941,Xavier de Lebreton,-1288877,-1191818,2022-11-03
CASH_IN,122341,Agence_mtn_Ouidah,300000,177659,Xavier de Lebreton,-1191818,-1069477,2022-11-04
CASH_IN,23804,Agence_mtn_Ouidah,300000,276196,Xavier de Lebreton,-1069477,-1045673,2022-11-05
CASH_IN,142258,Agence_mtn_Abomey,300000,157742,Xavier de Lebreton,-1045673,-903415,2022-11-07
CASH_IN,162020,Agence_mtn_Ouidah,300000,137980,Xavier de Lebreton,-903415,-741395,2022-11-07
CASH_IN,120977,Agence_mtn_Abomey,300000,179023,Xavier de Lebreton,-741395,-620418,2022-11-08
CASH_IN,244717,Agence_mtn_Cotonou,300000,55283,Xavier de Lebreton,-620418,-375701,2022-11-12
CASH_IN,2758,Agence_mtn_Ouidah,300000,297242,Xavier de Lebreton,-375701,-372943,2022-11-12
CASH_IN,293624,Agence_mtn_Abomey,300000,6376,Xavier de Lebreton,-372943,-79319,2022-11-14
CASH_IN,178182,Agence_mtn_Cotonou,300000,121818,Xavier de Lebreton,-79319,98863,2022-11-16
CASH_OUT,55641,Xavier de Lebreton,98863,43222,Agence_mtn_Abomey,300000,244359,2022-11-21
CASH_OUT,30398,Xavier de Lebreton,43222,12824,Agence_mtn_Cotonou,300000,269602,2022-11-26
CASH_IN,211846,Agence_mtn_Ouidah,300000,88154,Valentine Martinez,-12124,199722,2022-11-04
TRANSFER,109326,Valentine Martinez,199722,90396,Valentine Martinez,199722,309048,2022-11-04
TRANSFER,53535,Valentine Martinez,90396,36861,Valentine Martinez,90396,143931,2022-11-04
CASH_IN,41942,Agence_mtn_Abomey,300000,258058,Valentine Martinez,36861,78803,2022-11-06
CASH_IN,36551,Agence_mtn_Abomey,300000,263449,Valentine Martinez,78803,115354,2022-11-07
CASH_OUT,82307,Valentine Martinez,115354,33047,Agence_mtn_Abomey,300000,217693,2022-11-08
CASH_IN,154055,Agence_mtn_Cotonou,300000,145945,Valentine Martinez,33047,187102,2022-11-08
CASH_OUT,5528,Valentine Martinez,187102,181574,Agence_mtn_Ouidah,300000,294472,2022-11-08
CASH_OUT,174084,Valentine Martinez,181574,7490,Agence_mtn_Ouidah,300000,125916,2022-11-18
CASH_IN,147706,Agence_mtn_Ouidah,300000,152294,Valentine Martinez,7490,155196,2022-11-20
CASH_IN,110220,Agence_mtn_Cotonou,300000,189780,Valentine Martinez,155196,265416,2022-11-20
CASH_OUT,156556,Valentine Martinez,265416,108860,Agence_mtn_Abomey,300000,143444,2022-11-24
CASH_IN,212248,Agence_mtn_Abomey,300000,87752,Marie Picard,-4382,207866,2022-11-06
TRANSFER,40541,Marie Picard,207866,167325,Marie Picard,207866,248407,2022-11-08
CASH_IN,128986,Agence_mtn_Abomey,300000,171014,Marie Picard,167325,296311,2022-11-10
TRANSFER,93904,Marie Picard,296311,202407,Marie Picard,296311,202407,2022-11-11
TRANSFER,86122,Marie Picard,202407,116285,Marie Picard,202407,288529,2022-11-11
TRANSFER,110925,Marie Picard,116285,5360,Marie Picard,116285,227210,2022-11-12
CASH_OUT,2588,Marie Picard,5360,2772,Agence_mtn_Ouidah,300000,297412,2022-11-14
TRANSFER,616,Marie Picard,2772,2156,Marie Picard,2772,2156,2022-11-14
CASH_IN,270593,Agence_mtn_Cotonou,300000,29407,Marie Picard,2156,272749,2022-11-14
CASH_OUT,139789,Marie Picard,272749,132960,Agence_mtn_Ouidah,300000,160211,2022-11-15
CASH_OUT,18848,Marie Picard,132960,114112,Agence_mtn_Abomey,300000,281152,2022-11-16
CASH_OUT,72625,Marie Picard,114112,41487,Agence_mtn_Abomey,300000,227375,2022-11-19
CASH_OUT,30760,Marie Picard,41487,10727,Agence_mtn_Ouidah,300000,269240,2022-11-22
CASH_IN,287186,Agence_mtn_Cotonou,300000,12814,Marie Picard,10727,297913,2022-11-24
CASH_IN,217230,Agence_mtn_Abomey,300000,82770,David Guérin,-96556,120674,2022-11-01
CASH_OUT,63260,David Guérin,120674,57414,Agence_mtn_Abomey,300000,236740,2022-11-02
CASH_IN,53655,Agence_mtn_Ouidah,300000,246345,David Guérin,57414,111069,2022-11-05
TRANSFER,54073,David Guérin,111069,56996,David Guérin,111069,165142,2022-11-16
CASH_OUT,24429,David Guérin,56996,32567,Agence_mtn_Abomey,300000,275571,2022-11-21
CASH_OUT,4375,David Guérin,32567,28192,Agence_mtn_Ouidah,300000,295625,2022-11-23
CASH_IN,111702,Agence_mtn_Abomey,300000,188298,Rémy Le Michaud,-171984,-60282,2022-11-01
CASH_IN,26854,Agence_mtn_Ouidah,300000,273146,Rémy Le Michaud,-60282,-33428,2022-11-01
CASH_IN,68089,Agence_mtn_Abomey,300000,231911,Rémy Le Michaud,-33428,34661,2022-11-06
CASH_IN,69366,Agence_mtn_Abomey,300000,230634,Rémy Le Michaud,34661,104027,2022-11-11
TRANSFER,75949,Rémy Le Michaud,104027,28078,Rémy Le Michaud,104027,179976,2022-11-13
CASH_IN,231079,Agence_mtn_Ouidah,300000,68921,Rémy Le Michaud,28078,259157,2022-11-17
CASH_IN,106910,Agence_mtn_Cotonou,300000,193090,Cécile Clerc,-121753,-14843,2022-11-02
CASH_IN,37215,Agence_mtn_Abomey,300000,262785,Cécile Clerc,-14843,22372,2022-11-03
CASH_IN,282804,Agence_mtn_Ouidah,300000,17196,Cécile Clerc,22372,305176,2022-11-03
CASH_OUT,9915,Cécile Clerc,305176,295261,Agence_mtn_Ouidah,300000,290085,2022-11-06
CASH_OUT,32968,Cécile Clerc,295261,262293,Agence_mtn_Abomey,300000,267032,2022-11-10
TRANSFER,173967,Cécile Clerc,262293,88326,Cécile Clerc,262293,436260,2022-11-17
CASH_OUT,77697,Cécile Clerc,88326,10629,Agence_mtn_Ouidah,300000,222303,2022-11-18
CASH_OUT,4877,Cécile Clerc,10629,5752,Agence_mtn_Cotonou,300000,295123,2022-11-19
CASH_OUT,231,Cécile Clerc,5752,5521,Agence_mtn_Ouidah,300000,299769,2022-11-23
CASH_OUT,453,Cécile Clerc,5521,5068,Agence_mtn_Ouidah,300000,299547,2022-11-23
CASH_OUT,674,Cécile Clerc,5068,4394,Agence_mtn_Cotonou,300000,299326,2022-11-24
CASH_OUT,3901,Cécile Clerc,4394,493,Agence_mtn_Ouidah,300000,296099,2022-11-24
CASH_IN,63836,Agence_mtn_Ouidah,300000,236164,Théodore De Oliveira-Nicolas,-86190,-22354,2022-11-02
CASH_IN,146887,Agence_mtn_Ouidah,300000,153113,Théodore De Oliveira-Nicolas,-22354,124533,2022-11-04
CASH_IN,284233,Agence_mtn_Abomey,300000,15767,Théodore De Oliveira-Nicolas,124533,408766,2022-11-07
CASH_OUT,369334,Théodore De Oliveira-Nicolas,408766,39432,Agence_mtn_Cotonou,300000,-69334,2022-11-08
CASH_IN,283924,Agence_mtn_Abomey,300000,16076,Théodore De Oliveira-Nicolas,39432,323356,2022-11-09
CASH_OUT,118862,Théodore De Oliveira-Nicolas,323356,204494,Agence_mtn_Cotonou,300000,181138,2022-11-10
CASH_IN,288866,Agence_mtn_Abomey,300000,11134,Théodore De Oliveira-Nicolas,204494,493360,2022-11-11
CASH_IN,130414,Agence_mtn_Cotonou,300000,169586,Théodore De Oliveira-Nicolas,493360,623774,2022-11-13
CASH_OUT,81234,Théodore De Oliveira-Nicolas,623774,542540,Agence_mtn_Cotonou,300000,218766,2022-11-13
CASH_OUT,401810,Théodore De Oliveira-Nicolas,542540,140730,Agence_mtn_Abomey,300000,-101810,2022-11-19
CASH_IN,110549,Agence_mtn_Abomey,300000,189451,Théodore De Oliveira-Nicolas,140730,251279,2022-11-19
CASH_OUT,227810,Théodore De Oliveira-Nicolas,251279,23469,Agence_mtn_Ouidah,300000,72190,2022-11-20
CASH_OUT,7481,Théodore De Oliveira-Nicolas,23469,15988,Agence_mtn_Ouidah,300000,292519,2022-11-21
CASH_OUT,10086,Théodore De Oliveira-Nicolas,15988,5902,Agence_mtn_Abomey,300000,289914,2022-11-22
CASH_OUT,4801,Théodore De Oliveira-Nicolas,5902,1101,Agence_mtn_Cotonou,300000,295199,2022-11-26
CASH_IN,7588,Agence_mtn_Abomey,300000,292412,Adèle Labbé,-69980,-62392,2022-11-01
CASH_IN,145636,Agence_mtn_Ouidah,300000,154364,Adèle Labbé,-62392,83244,2022-11-02
CASH_IN,207421,Agence_mtn_Cotonou,300000,92579,Adèle Labbé,83244,290665,2022-11-04
CASH_OUT,154634,Adèle Labbé,290665,136031,Agence_mtn_Cotonou,300000,145366,2022-11-04
CASH_OUT,108853,Adèle Labbé,136031,27178,Agence_mtn_Ouidah,300000,191147,2022-11-07
CASH_OUT,10399,Adèle Labbé,27178,16779,Agence_mtn_Cotonou,300000,289601,2022-11-08
CASH_IN,259340,Agence_mtn_Abomey,300000,40660,Adèle Labbé,16779,276119,2022-11-10
CASH_OUT,6248,Adèle Labbé,276119,269871,Agence_mtn_Abomey,300000,293752,2022-11-11
CASH_IN,144201,Agence_mtn_Ouidah,300000,155799,Adèle Labbé,269871,414072,2022-11-12
CASH_IN,35638,Agence_mtn_Cotonou,300000,264362,Adèle Labbé,414072,449710,2022-11-12
CASH_IN,114050,Agence_mtn_Ouidah,300000,185950,Adèle Labbé,449710,563760,2022-11-13
CASH_IN,14572,Agence_mtn_Abomey,300000,285428,Adèle Labbé,563760,578332,2022-11-16
CASH_IN,30234,Agence_mtn_Abomey,300000,269766,Adèle Labbé,578332,608566,2022-11-18
CASH_IN,53320,Agence_mtn_Abomey,300000,246680,Thierry Delattre-Simon,-273288,-219968,2022-11-04
CASH_IN,139760,Agence_mtn_Ouidah,300000,160240,Thierry Delattre-Simon,-219968,-80208,2022-11-09
CASH_IN,216391,Agence_mtn_Abomey,300000,83609,Thierry Delattre-Simon,-80208,136183,2022-11-12
CASH_OUT,132877,Thierry Delattre-Simon,136183,3306,Agence_mtn_Ouidah,300000,167123,2022-11-13
CASH_IN,39991,Agence_mtn_Abomey,300000,260009,Thierry Delattre-Simon,3306,43297,2022-11-21
CASH_OUT,24184,Thierry Delattre-Simon,43297,19113,Agence_mtn_Abomey,300000,275816,2022-11-25
CASH_OUT,18729,Thierry Delattre-Simon,19113,384,Agence_mtn_Cotonou,300000,281271,2022-11-27
CASH_IN,126863,Agence_mtn_Cotonou,300000,173137,Laurent-Bertrand Lefort,-579157,-452294,2022-11-01
CASH_IN,100902,Agence_mtn_Abomey,300000,199098,Laurent-Bertrand Lefort,-452294,-351392,2022-11-03
CASH_IN,57460,Agence_mtn_Ouidah,300000,242540,Laurent-Bertrand Lefort,-351392,-293932,2022-11-04
CASH_IN,28599,Agence_mtn_Abomey,300000,271401,Laurent-Bertrand Lefort,-293932,-265333,2022-11-05
CASH_IN,164139,Agence_mtn_Abomey,300000,135861,Laurent-Bertrand Lefort,-265333,-101194,2022-11-07
CASH_IN,125311,Agence_mtn_Ouidah,300000,174689,Laurent-Bertrand Lefort,-101194,24117,2022-11-08
TRANSFER,17474,Laurent-Bertrand Lefort,24117,6643,Laurent-Bertrand Lefort,24117,6643,2022-11-09
CASH_IN,63094,Agence_mtn_Abomey,300000,236906,Laurent-Bertrand Lefort,6643,69737,2022-11-10
CASH_IN,68052,Agence_mtn_Ouidah,300000,231948,Laurent-Bertrand Lefort,69737,137789,2022-11-11
TRANSFER,75247,Laurent-Bertrand Lefort,137789,62542,Laurent-Bertrand Lefort,137789,213036,2022-11-14
CASH_OUT,50327,Laurent-Bertrand Lefort,62542,12215,Agence_mtn_Abomey,300000,249673,2022-11-16
CASH_OUT,7595,Laurent-Bertrand Lefort,12215,4620,Agence_mtn_Ouidah,300000,292405,2022-11-22
CASH_IN,42378,Agence_mtn_Cotonou,300000,257622,Franck-Charles Texier,-293196,-250818,2022-11-04
CASH_IN,260267,Agence_mtn_Cotonou,300000,39733,Franck-Charles Texier,-250818,9449,2022-11-05
CASH_OUT,717,Franck-Charles Texier,9449,8732,Agence_mtn_Cotonou,300000,299283,2022-11-07
TRANSFER,2779,Franck-Charles Texier,8732,5953,Franck-Charles Texier,8732,5953,2022-11-11
CASH_OUT,4414,Franck-Charles Texier,5953,1539,Agence_mtn_Abomey,300000,295586,2022-11-13
CASH_OUT,1016,Franck-Charles Texier,1539,523,Agence_mtn_Abomey,300000,298984,2022-11-16
CASH_OUT,266,Franck-Charles Texier,523,257,Agence_mtn_Cotonou,300000,299734,2022-11-21
CASH_IN,279002,Agence_mtn_Ouidah,300000,20998,Franck-Charles Texier,257,279259,2022-11-24
CASH_OUT,120159,Franck-Charles Texier,279259,159100,Agence_mtn_Cotonou,300000,179841,2022-11-26
CASH_OUT,61459,Franck-Charles Texier,159100,97641,Agence_mtn_Ouidah,300000,238541,2022-11-27
CASH_IN,79641,Agence_mtn_Ouidah,300000,220359,Pierre Roger,-6464,73177,2022-11-01
TRANSFER,45740,Pierre Roger,73177,27437,Pierre Roger,73177,118917,2022-11-04
CASH_IN,184541,Agence_mtn_Cotonou,300000,115459,Pierre Roger,27437,211978,2022-11-05
CASH_IN,48359,Agence_mtn_Ouidah,300000,251641,Pierre Roger,211978,260337,2022-11-08
CASH_OUT,221581,Pierre Roger,260337,38756,Agence_mtn_Ouidah,300000,78419,2022-11-12
CASH_OUT,6413,Pierre Roger,38756,32343,Agence_mtn_Abomey,300000,293587,2022-11-13
CASH_OUT,6410,Pierre Roger,32343,25933,Agence_mtn_Abomey,300000,293590,2022-11-13
CASH_OUT,13711,Pierre Roger,25933,12222,Agence_mtn_Ouidah,300000,286289,2022-11-13
CASH_IN,256280,Agence_mtn_Ouidah,300000,43720,Pierre Roger,12222,268502,2022-11-21
CASH_OUT,97865,Pierre Roger,268502,170637,Agence_mtn_Ouidah,300000,202135,2022-11-21
CASH_OUT,61186,Pierre Roger,170637,109451,Agence_mtn_Ouidah,300000,238814,2022-11-21
CASH_IN,216666,Agence_mtn_Cotonou,300000,83334,Antoinette Bertrand,-60916,155750,2022-11-01
TRANSFER,34483,Antoinette Bertrand,155750,121267,Antoinette Bertrand,155750,121267,2022-11-07
CASH_IN,271701,Agence_mtn_Abomey,300000,28299,Antoinette Bertrand,121267,392968,2022-11-10
CASH_IN,23169,Agence_mtn_Cotonou,300000,276831,Antoinette Bertrand,392968,416137,2022-11-10
CASH_OUT,252392,Antoinette Bertrand,416137,163745,Agence_mtn_Cotonou,300000,47608,2022-11-10
CASH_OUT,13230,Antoinette Bertrand,163745,150515,Agence_mtn_Cotonou,300000,286770,2022-11-17
CASH_IN,124862,Agence_mtn_Ouidah,300000,175138,Antoinette Bertrand,150515,275377,2022-11-17
CASH_IN,67653,Agence_mtn_Ouidah,300000,232347,Antoinette Bertrand,275377,343030,2022-11-23
CASH_OUT,290567,Antoinette Bertrand,343030,52463,Agence_mtn_Cotonou,300000,9433,2022-11-24
CASH_OUT,51622,Antoinette Bertrand,52463,841,Agence_mtn_Cotonou,300000,248378,2022-11-26
CASH_IN,126371,Agence_mtn_Abomey,300000,173629,Antoinette Bertrand,841,127212,2022-11-27
CASH_OUT,78004,Antoinette Bertrand,127212,49208,Agence_mtn_Cotonou,300000,221996,2022-11-27
CASH_IN,299513,Agence_mtn_Cotonou,300000,487,Marine Chauvet-Potier,-979448,-679935,2022-11-02
CASH_IN,158296,Agence_mtn_Abomey,300000,141704,Marine Chauvet-Potier,-679935,-521639,2022-11-02
CASH_IN,39678,Agence_mtn_Ouidah,300000,260322,Marine Chauvet-Potier,-521639,-481961,2022-11-04
CASH_IN,75168,Agence_mtn_Ouidah,300000,224832,Marine Chauvet-Potier,-481961,-406793,2022-11-04
CASH_IN,189419,Agence_mtn_Abomey,300000,110581,Marine Chauvet-Potier,-406793,-217374,2022-11-07
CASH_IN,166962,Agence_mtn_Ouidah,300000,133038,Marine Chauvet-Potier,-217374,-50412,2022-11-07
CASH_IN,121225,Agence_mtn_Ouidah,300000,178775,Marine Chauvet-Potier,-50412,70813,2022-11-08
CASH_IN,196252,Agence_mtn_Abomey,300000,103748,Marine Chauvet-Potier,70813,267065,2022-11-10
CASH_IN,57645,Agence_mtn_Abomey,300000,242355,Marine Chauvet-Potier,267065,324710,2022-11-10
TRANSFER,280336,Marine Chauvet-Potier,324710,44374,Marine Chauvet-Potier,324710,605046,2022-11-14
TRANSFER,41329,Marine Chauvet-Potier,44374,3045,Marine Chauvet-Potier,44374,85703,2022-11-15
TRANSFER,2270,Marine Chauvet-Potier,3045,775,Marine Chauvet-Potier,3045,5315,2022-11-15
CASH_IN,242713,Agence_mtn_Cotonou,300000,57287,Marine Chauvet-Potier,775,243488,2022-11-19
CASH_OUT,176992,Marine Chauvet-Potier,243488,66496,Agence_mtn_Cotonou,300000,123008,2022-11-20
CASH_IN,171709,Agence_mtn_Abomey,300000,128291,Marine Chauvet-Potier,66496,238205,2022-11-21
CASH_IN,176912,Agence_mtn_Abomey,300000,123088,Marine Chauvet-Potier,238205,415117,2022-11-24
CASH_IN,47495,Agence_mtn_Ouidah,300000,252505,Valérie Dijoux,-245152,-197657,2022-11-01
CASH_IN,184514,Agence_mtn_Abomey,300000,115486,Valérie Dijoux,-197657,-13143,2022-11-02
CASH_IN,99428,Agence_mtn_Abomey,300000,200572,Valérie Dijoux,-13143,86285,2022-11-02
TRANSFER,66790,Valérie Dijoux,86285,19495,Valérie Dijoux,86285,153075,2022-11-02
CASH_IN,281322,Agence_mtn_Abomey,300000,18678,Valérie Dijoux,19495,300817,2022-11-03
CASH_OUT,6999,Valérie Dijoux,300817,293818,Agence_mtn_Abomey,300000,293001,2022-11-05
CASH_OUT,264029,Valérie Dijoux,293818,29789,Agence_mtn_Cotonou,300000,35971,2022-11-09
TRANSFER,5530,Valérie Dijoux,29789,24259,Valérie Dijoux,29789,35319,2022-11-10
CASH_IN,160150,Agence_mtn_Abomey,300000,139850,Valérie Dijoux,24259,184409,2022-11-11
CASH_OUT,97268,Valérie Dijoux,184409,87141,Agence_mtn_Cotonou,300000,202732,2022-11-14
CASH_IN,39166,Agence_mtn_Cotonou,300000,260834,Valérie Dijoux,87141,126307,2022-11-18
CASH_IN,299394,Agence_mtn_Abomey,300000,606,Valérie Dijoux,126307,425701,2022-11-19
CASH_IN,33444,Agence_mtn_Cotonou,300000,266556,Valérie Dijoux,425701,459145,2022-11-23
CASH_OUT,162315,Valérie Dijoux,459145,296830,Agence_mtn_Cotonou,300000,137685,2022-11-24
CASH_IN,253402,Agence_mtn_Abomey,300000,46598,Margot Renaud,510800,764202,2022-12-07
CASH_IN,60057,Agence_mtn_Abomey,300000,239943,Margot Renaud,764202,824259,2022-12-18
CASH_IN,192484,Agence_mtn_Abomey,300000,107516,Margot Renaud,824259,1016743,2022-12-21
TRANSFER,74086,Thierry Delattre-Simon,435200,361114,Pénélope Ollivier,508000,433914,2022-12-15
CASH_OUT,132186,Thierry Delattre-Simon,361114,228928,Agence_mtn_Abomey,300000,167814,2022-12-18
CASH_OUT,44937,Thierry Delattre-Simon,228928,183991,Agence_mtn_Ouidah,300000,255063,2022-12-26
CASH_IN,64651,Agence_mtn_Ouidah,300000,235349,Renée David,359100,423751,2022-12-11
CASH_IN,100163,Agence_mtn_Ouidah,300000,199837,Renée David,423751,523914,2022-12-19
CASH_IN,159753,Agence_mtn_Cotonou,300000,140247,Renée David,523914,683667,2022-12-24
CASH_OUT,238665,Renée David,683667,445002,Agence_mtn_Cotonou,300000,61335,2022-12-25
CASH_IN,291856,Agence_mtn_Abomey,300000,8144,Victoire-Nicole Lopez,1394400,1686256,2022-12-02
CASH_IN,207310,Agence_mtn_Cotonou,300000,92690,Victoire-Nicole Lopez,1686256,1893566,2022-12-10
TRANSFER,141092,Victoire-Nicole Lopez,1893566,1752474,Jeanne Garnier,250800,109708,2022-12-11
CASH_IN,241020,Agence_mtn_Ouidah,300000,58980,Victoire-Nicole Lopez,1752474,1993494,2022-12-13
CASH_IN,233284,Agence_mtn_Abomey,300000,66716,Victoire-Nicole Lopez,1993494,2226778,2022-12-13
CASH_IN,64224,Agence_mtn_Ouidah,300000,235776,Émilie Moulin,500400,564624,2022-12-08
CASH_IN,223184,Agence_mtn_Ouidah,300000,76816,Émilie Moulin,564624,787808,2022-12-16
CASH_OUT,257137,Adèle Labbé,1189400,932263,Agence_mtn_Abomey,300000,42863,2022-12-12
TRANSFER,320254,Simone Pineau,1677100,1356846,Cécile Germain,217400,537654,2022-12-02
CASH_OUT,360390,Cécile Germain,537654,177264,Agence_mtn_Abomey,300000,-60390,2022-12-10
CASH_OUT,131106,Cécile Germain,177264,46158,Agence_mtn_Abomey,300000,168894,2022-12-12
TRANSFER,22918,Cécile Germain,46158,23240,Cécile Clerc,1707500,1684582,2022-12-14
CASH_IN,39972,Agence_mtn_Ouidah,300000,260028,Thérèse-Margaux Bruneau,1191800,1231772,2022-12-11
CASH_OUT,1154781,Thérèse-Margaux Bruneau,1231772,76991,Agence_mtn_Cotonou,300000,-854781,2022-12-12
TRANSFER,16271,Thérèse-Margaux Bruneau,76991,60720,Alphonse Le Olivier,1399500,1383229,2022-12-20
CASH_OUT,1550314,Thibault Moreno,1972500,422186,Agence_mtn_Cotonou,300000,-1250314,2022-12-03
CASH_OUT,147508,Thibault Moreno,422186,274678,Agence_mtn_Abomey,300000,152492,2022-12-10
TRANSFER,487531,Aurore Guyon,621400,133869,Thibault Moreno,274678,762209,2022-12-12
CASH_OUT,508786,Thibault Moreno,762209,253423,Agence_mtn_Abomey,300000,-208786,2022-12-19
CASH_OUT,94449,Thibault Moreno,253423,158974,Agence_mtn_Cotonou,300000,205551,2022-12-20
CASH_OUT,66837,Tristan Thomas,96900,30063,Agence_mtn_Abomey,300000,233163,2022-12-09
CASH_IN,224083,Agence_mtn_Ouidah,300000,75917,Tristan Thomas,30063,254146,2022-12-23
CASH_IN,275881,Agence_mtn_Cotonou,300000,24119,Honoré du Laurent,174900,450781,2022-12-12
CASH_OUT,287843,Honoré du Laurent,450781,162938,Agence_mtn_Ouidah,300000,12157,2022-12-21
CASH_IN,283272,Agence_mtn_Cotonou,300000,16728,Honoré du Laurent,162938,446210,2022-12-21
CASH_IN,91499,Agence_mtn_Cotonou,300000,208501,Sophie Gonzalez,139500,230999,2022-12-01
TRANSFER,216625,Sophie Gonzalez,230999,14374,Inès de Letellier,1352100,1135475,2022-12-16
TRANSFER,2097,Sophie Gonzalez,14374,12277,William Lebrun,1230400,1228303,2022-12-21
TRANSFER,6703,Sophie Gonzalez,12277,5574,Alix Maillet,1939300,1932597,2022-12-21
TRANSFER,3584,Sophie Gonzalez,5574,1990,Claude Foucher,1100800,1097216,2022-12-27
CASH_OUT,79870,David Guérin,570400,490530,Agence_mtn_Ouidah,300000,220130,2022-12-17
CASH_OUT,270485,David Guérin,490530,220045,Agence_mtn_Abomey,300000,29515,2022-12-22
TRANSFER,26698,David Guérin,220045,193347,Joséphine Gros,231200,204502,2022-12-22
TRANSFER,49189,David du Blondel,458900,409711,David Guérin,193347,242536,2022-12-27
TRANSFER,110008,Claude Foucher,1097216,987208,Antoine Leleu,1984000,2094008,2022-12-05
CASH_OUT,2075627,Antoine Leleu,2094008,18381,Agence_mtn_Abomey,300000,-1775627,2022-12-06
CASH_OUT,14653,Antoine Leleu,18381,3728,Agence_mtn_Cotonou,300000,285347,2022-12-13
TRANSFER,359,Antoine Leleu,3728,3369,Virginie Le Gall,1277200,1276841,2022-12-17
TRANSFER,923078,Antoinette Bertrand,1130700,207622,Antoine Leleu,3369,926447,2022-12-26
TRANSFER,394575,Gabriel Humbert,438700,44125,Nath Bruneau,1892600,1498025,2022-12-09
TRANSFER,458308,Jean Benard,528100,69792,Léon Lecoq,449300,-9008,2022-12-13
CASH_IN,227098,Agence_mtn_Cotonou,300000,72902,Jean Benard,69792,296890,2022-12-14
CASH_IN,272828,Agence_mtn_Cotonou,300000,27172,Jean Benard,296890,569718,2022-12-18
CASH_IN,224138,Agence_mtn_Cotonou,300000,75862,Jean Benard,569718,793856,2022-12-24
TRANSFER,107020,Raymond Rossi,176400,69380,Jean Benard,793856,900876,2022-12-25
CASH_IN,209700,Agence_mtn_Abomey,300000,90300,Geneviève Grondin,396600,606300,2022-12-01
CASH_IN,84059,Agence_mtn_Abomey,300000,215941,Geneviève Grondin,606300,690359,2022-12-16
CASH_OUT,668150,Geneviève Grondin,690359,22209,Agence_mtn_Ouidah,300000,-368150,2022-12-27
TRANSFER,1272962,Rémy Le Michaud,1401800,128838,Antoinette Bertrand,207622,-1065340,2022-12-02
CASH_OUT,23594,Rémy Le Michaud,128838,105244,Agence_mtn_Abomey,300000,276406,2022-12-17
CASH_IN,113942,Agence_mtn_Abomey,300000,186058,Rémy Le Michaud,105244,219186,2022-12-21
CASH_OUT,9277,Eugène Poulain,16400,7123,Agence_mtn_Abomey,300000,290723,2022-12-06
CASH_OUT,5819,Eugène Poulain,7123,1304,Agence_mtn_Abomey,300000,294181,2022-12-26
TRANSFER,547503,Valentine Martinez,1628800,1081297,Louis Pichon,1498800,951297,2022-12-04
CASH_IN,6270,Agence_mtn_Cotonou,300000,293730,Valentine Martinez,1081297,1087567,2022-12-07
TRANSFER,68818,Bertrand Le Roux,1081800,1012982,Valentine Martinez,1087567,1156385,2022-12-16
TRANSFER,524100,Alfred du Lesage,604000,79900,Valentine Martinez,1156385,1680485,2022-12-19
CASH_OUT,1474115,Valentine Martinez,1680485,206370,Agence_mtn_Abomey,300000,-1174115,2022-12-20
CASH_OUT,113003,Bertrand Le Roux,1012982,899979,Agence_mtn_Cotonou,300000,186997,2022-12-03
CASH_IN,43809,Agence_mtn_Abomey,300000,256191,Bertrand Le Roux,899979,943788,2022-12-24
CASH_OUT,723629,Bertrand Le Roux,943788,220159,Agence_mtn_Abomey,300000,-423629,2022-12-25
CASH_OUT,62174,Étienne Roche,234100,171926,Agence_mtn_Ouidah,300000,237826,2022-12-02
TRANSFER,937202,Nathalie Peron,1163900,226698,Étienne Roche,171926,1109128,2022-12-06
TRANSFER,1073349,Étienne Roche,1109128,35779,Rémy de la Roux,253900,-819449,2022-12-07
CASH_OUT,15152,Étienne Roche,35779,20627,Agence_mtn_Abomey,300000,284848,2022-12-19
CASH_IN,1488,Agence_mtn_Abomey,300000,298512,Étienne Roche,20627,22115,2022-12-27
CASH_IN,116389,Agence_mtn_Abomey,300000,183611,Hortense Lemaire,1082400,1198789,2022-12-27
TRANSFER,405491,Margot Riou du Fernandes,1967900,1562409,Martine Wagner de la Bègue,495000,89509,2022-12-02
TRANSFER,439068,Margot Riou du Fernandes,1562409,1123341,Raymond Marchal de Nguyen,1677900,1238832,2022-12-02
CASH_IN,100230,Agence_mtn_Abomey,300000,199770,Margot Riou du Fernandes,1123341,1223571,2022-12-06
CASH_IN,260247,Agence_mtn_Cotonou,300000,39753,Margot Riou du Fernandes,1223571,1483818,2022-12-07
CASH_OUT,856142,Margot Riou du Fernandes,1483818,627676,Agence_mtn_Cotonou,300000,-556142,2022-12-09
CASH_IN,151440,Agence_mtn_Ouidah,300000,148560,Margot Riou du Fernandes,627676,779116,2022-12-10
CASH_OUT,556060,Margot Riou du Fernandes,779116,223056,Agence_mtn_Abomey,300000,-256060,2022-12-11
TRANSFER,79935,Margot Riou du Fernandes,223056,143121,Gilbert-Charles Thibault,992400,912465,2022-12-13
CASH_OUT,81861,Margot Riou du Fernandes,143121,61260,Agence_mtn_Ouidah,300000,218139,2022-12-14
TRANSFER,581454,Louis Pichon,951297,369843,Margot Riou du Fernandes,61260,642714,2022-12-14
CASH_OUT,416341,Margot Riou du Fernandes,642714,226373,Agence_mtn_Abomey,300000,-116341,2022-12-16
TRANSFER,31639,Margot Riou du Fernandes,226373,194734,Michelle Lebon,1647600,1615961,2022-12-16
CASH_OUT,119234,Margot Riou du Fernandes,194734,75500,Agence_mtn_Abomey,300000,180766,2022-12-17
CASH_IN,49639,Agence_mtn_Cotonou,300000,250361,Margot Riou du Fernandes,75500,125139,2022-12-18
CASH_IN,30807,Agence_mtn_Abomey,300000,269193,Margot Riou du Fernandes,125139,155946,2022-12-18
CASH_IN,84594,Agence_mtn_Cotonou,300000,215406,Margot Riou du Fernandes,155946,240540,2022-12-20
CASH_IN,249152,Agence_mtn_Cotonou,300000,50848,Margot Riou du Fernandes,240540,489692,2022-12-20
TRANSFER,1304050,Astrid Gay de la Brunet,1837400,533350,Margot Riou du Fernandes,489692,1793742,2022-12-21
TRANSFER,13917,Alexandrie Delmas,193100,179183,Margot Riou du Fernandes,1793742,1807659,2022-12-22
TRANSFER,44126,Margot Riou du Fernandes,1807659,1763533,Louise Girard,511900,467774,2022-12-22
CASH_IN,158619,Agence_mtn_Ouidah,300000,141381,Margot Riou du Fernandes,1763533,1922152,2022-12-24
CASH_OUT,11722,Margot Riou du Fernandes,1922152,1910430,Agence_mtn_Abomey,300000,288278,2022-12-27
TRANSFER,51109,Valentine Richard-Bourdon,176800,125691,Margot Riou du Fernandes,1910430,1961539,2022-12-27
CASH_OUT,184605,Claude Foucher,987208,802603,Agence_mtn_Ouidah,300000,115395,2022-12-04
TRANSFER,55547,Louis Pichon,369843,314296,Claude Foucher,802603,858150,2022-12-05
TRANSFER,298188,Claude Foucher,858150,559962,Joséphine Gros,204502,-93686,2022-12-05
TRANSFER,141490,Nath Bruneau,1498025,1356535,Claude Foucher,559962,701452,2022-12-07
CASH_IN,87246,Agence_mtn_Ouidah,300000,212754,Claude Foucher,701452,788698,2022-12-07
CASH_IN,117506,Agence_mtn_Abomey,300000,182494,Claude Foucher,788698,906204,2022-12-07
CASH_IN,103653,Agence_mtn_Ouidah,300000,196347,Claude Foucher,906204,1009857,2022-12-07
CASH_OUT,775936,Claude Foucher,1009857,233921,Agence_mtn_Cotonou,300000,-475936,2022-12-08
CASH_OUT,205368,Claude Foucher,233921,28553,Agence_mtn_Ouidah,300000,94632,2022-12-09
CASH_OUT,19386,Claude Foucher,28553,9167,Agence_mtn_Cotonou,300000,280614,2022-12-11
TRANSFER,5293,Claude Foucher,9167,3874,Zoé Renaud de Boutin,1631000,1625707,2022-12-15
TRANSFER,3371,Claude Foucher,3874,503,Pierre Roger,358000,354629,2022-12-17
CASH_OUT,498,Claude Foucher,503,5,Agence_mtn_Abomey,300000,299502,2022-12-17
CASH_IN,217260,Agence_mtn_Cotonou,300000,82740,Claude Foucher,5,217265,2022-12-17
CASH_IN,200610,Agence_mtn_Ouidah,300000,99390,Claude Foucher,217265,417875,2022-12-17
CASH_IN,163128,Agence_mtn_Ouidah,300000,136872,Claude Foucher,417875,581003,2022-12-20
CASH_OUT,180100,Claude Foucher,581003,400903,Agence_mtn_Abomey,300000,119900,2022-12-20
TRANSFER,298830,Claude Foucher,400903,102073,Frédéric Couturier,1639700,1340870,2022-12-20
CASH_IN,138146,Agence_mtn_Cotonou,300000,161854,Claude Foucher,102073,240219,2022-12-20
CASH_OUT,140355,Claude Foucher,240219,99864,Agence_mtn_Cotonou,300000,159645,2022-12-20
TRANSFER,137593,Richard Le Descamps,1888400,1750807,Claude Foucher,99864,237457,2022-12-23
TRANSFER,134695,Nathalie Peron,226698,92003,Claude Foucher,237457,372152,2022-12-23
TRANSFER,334924,Inès Hamon,581500,246576,Claude Foucher,372152,707076,2022-12-24
TRANSFER,76149,Aurore Guyon,133869,57720,Nathalie Pages,679600,603451,2022-12-01
TRANSFER,1506176,Richard Le Descamps,1750807,244631,Aurore Guyon,57720,1563896,2022-12-02
CASH_OUT,353841,Aurore Guyon,1563896,1210055,Agence_mtn_Abomey,300000,-53841,2022-12-03
TRANSFER,461924,Aurore Guyon,1210055,748131,Gilbert-Charles Thibault,912465,450541,2022-12-03
TRANSFER,8010,Bertrand Charles,41500,33490,Aurore Guyon,748131,756141,2022-12-03
CASH_IN,201663,Agence_mtn_Ouidah,300000,98337,Aurore Guyon,756141,957804,2022-12-04
CASH_IN,11047,Agence_mtn_Abomey,300000,288953,Aurore Guyon,957804,968851,2022-12-04
CASH_IN,26689,Agence_mtn_Cotonou,300000,273311,Aurore Guyon,968851,995540,2022-12-06
TRANSFER,663791,Aurore Guyon,995540,331749,Pénélope Dupuis,1436100,772309,2022-12-07
CASH_IN,32368,Agence_mtn_Abomey,300000,267632,Aurore Guyon,331749,364117,2022-12-09
CASH_IN,168934,Agence_mtn_Ouidah,300000,131066,Aurore Guyon,364117,533051,2022-12-09
CASH_OUT,134591,Aurore Guyon,533051,398460,Agence_mtn_Ouidah,300000,165409,2022-12-10
TRANSFER,14358,Valérie Dijoux,71500,57142,Aurore Guyon,398460,412818,2022-12-11
CASH_IN,238739,Agence_mtn_Ouidah,300000,61261,Aurore Guyon,412818,651557,2022-12-11
TRANSFER,17241,Roland Garcia,20500,3259,Aurore Guyon,651557,668798,2022-12-12
CASH_IN,175035,Agence_mtn_Abomey,300000,124965,Aurore Guyon,668798,843833,2022-12-13
CASH_OUT,512651,Aurore Guyon,843833,331182,Agence_mtn_Cotonou,300000,-212651,2022-12-13
CASH_IN,93443,Agence_mtn_Abomey,300000,206557,Aurore Guyon,331182,424625,2022-12-15
CASH_OUT,28669,Aurore Guyon,424625,395956,Agence_mtn_Ouidah,300000,271331,2022-12-18
CASH_IN,132099,Agence_mtn_Cotonou,300000,167901,Aurore Guyon,395956,528055,2022-12-20
CASH_IN,138060,Agence_mtn_Abomey,300000,161940,Aurore Guyon,528055,666115,2022-12-22
CASH_IN,207521,Agence_mtn_Abomey,300000,92479,Aurore Guyon,666115,873636,2022-12-26
CASH_IN,291663,Agence_mtn_Ouidah,300000,8337,Aurore Guyon,873636,1165299,2022-12-26
TRANSFER,1014685,Aurore Guyon,1165299,150614,Inès de Letellier,1135475,120790,2022-12-26
CASH_IN,286,Agence_mtn_Abomey,300000,299714,Aurore Guyon,150614,150900,2022-12-27
CASH_IN,172687,Agence_mtn_Abomey,300000,127313,Aurore Guyon,150900,323587,2022-12-27
CASH_IN,249148,Agence_mtn_Cotonou,300000,50852,Louise Girard,467774,716922,2022-12-01
CASH_OUT,173217,Louise Girard,716922,543705,Agence_mtn_Ouidah,300000,126783,2022-12-01
CASH_IN,231673,Agence_mtn_Cotonou,300000,68327,Louise Girard,543705,775378,2022-12-02
CASH_OUT,282497,Louise Girard,775378,492881,Agence_mtn_Cotonou,300000,17503,2022-12-04
CASH_IN,4434,Agence_mtn_Ouidah,300000,295566,Louise Girard,492881,497315,2022-12-05
TRANSFER,39360,Louise Girard,497315,457955,Nath Bruneau,1356535,1317175,2022-12-05
CASH_OUT,150422,Louise Girard,457955,307533,Agence_mtn_Abomey,300000,149578,2022-12-06
CASH_OUT,44144,Louise Girard,307533,263389,Agence_mtn_Cotonou,300000,255856,2022-12-08
TRANSFER,698929,Alexandre Rémy,1400700,701771,Louise Girard,263389,962318,2022-12-08
CASH_IN,191362,Agence_mtn_Abomey,300000,108638,Louise Girard,962318,1153680,2022-12-09
CASH_IN,120480,Agence_mtn_Abomey,300000,179520,Louise Girard,1153680,1274160,2022-12-11
CASH_IN,204072,Agence_mtn_Abomey,300000,95928,Louise Girard,1274160,1478232,2022-12-12
CASH_IN,75220,Agence_mtn_Abomey,300000,224780,Louise Girard,1478232,1553452,2022-12-12
CASH_IN,68545,Agence_mtn_Abomey,300000,231455,Louise Girard,1553452,1621997,2022-12-13
CASH_OUT,877381,Louise Girard,1621997,744616,Agence_mtn_Abomey,300000,-577381,2022-12-13
CASH_IN,61876,Agence_mtn_Abomey,300000,238124,Louise Girard,744616,806492,2022-12-15
CASH_OUT,56540,Louise Girard,806492,749952,Agence_mtn_Ouidah,300000,243460,2022-12-17
CASH_IN,215534,Agence_mtn_Ouidah,300000,84466,Louise Girard,749952,965486,2022-12-18
CASH_OUT,758816,Louise Girard,965486,206670,Agence_mtn_Abomey,300000,-458816,2022-12-19
CASH_IN,143785,Agence_mtn_Cotonou,300000,156215,Louise Girard,206670,350455,2022-12-19
CASH_OUT,32554,Louise Girard,350455,317901,Agence_mtn_Abomey,300000,267446,2022-12-20
TRANSFER,299920,Gabriel-Tristan Marty,396600,96680,Louise Girard,317901,617821,2022-12-20
CASH_OUT,89827,Louise Girard,617821,527994,Agence_mtn_Cotonou,300000,210173,2022-12-21
TRANSFER,156830,Louise Girard,527994,371164,Marine Chauvet-Potier,1824800,1667970,2022-12-21
CASH_OUT,323161,Louise Girard,371164,48003,Agence_mtn_Ouidah,300000,-23161,2022-12-23
CASH_OUT,28826,Louise Girard,48003,19177,Agence_mtn_Abomey,300000,271174,2022-12-24
CASH_OUT,15552,Louise Girard,19177,3625,Agence_mtn_Cotonou,300000,284448,2022-12-25
CASH_IN,251691,Agence_mtn_Cotonou,300000,48309,Louise Girard,3625,255316,2022-12-26
TRANSFER,26561,Jeanne Garnier,109708,83147,William Le Lucas,1160100,1133539,2022-12-02
TRANSFER,44160,Jeanne Garnier,83147,38987,Simone Pineau,1356846,1312686,2022-12-05
CASH_IN,150388,Agence_mtn_Cotonou,300000,149612,Jeanne Garnier,38987,189375,2022-12-07
CASH_OUT,140269,Jeanne Garnier,189375,49106,Agence_mtn_Abomey,300000,159731,2022-12-07
CASH_IN,165617,Agence_mtn_Cotonou,300000,134383,Jeanne Garnier,49106,214723,2022-12-09
CASH_OUT,136172,Jeanne Garnier,214723,78551,Agence_mtn_Cotonou,300000,163828,2022-12-10
CASH_OUT,33691,Jeanne Garnier,78551,44860,Agence_mtn_Abomey,300000,266309,2022-12-12
CASH_OUT,41610,Jeanne Garnier,44860,3250,Agence_mtn_Ouidah,300000,258390,2022-12-13
TRANSFER,1200,Jeanne Garnier,3250,2050,Inès de Letellier,120790,119590,2022-12-14
CASH_IN,103359,Agence_mtn_Abomey,300000,196641,Jeanne Garnier,2050,105409,2022-12-14
CASH_OUT,102163,Jeanne Garnier,105409,3246,Agence_mtn_Abomey,300000,197837,2022-12-15
CASH_OUT,1660,Jeanne Garnier,3246,1586,Agence_mtn_Abomey,300000,298340,2022-12-15
TRANSFER,62790,Raymond Rossi,69380,6590,Jeanne Garnier,1586,64376,2022-12-16
TRANSFER,716207,Éléonore-Hélène Dubois,1332600,616393,Jeanne Garnier,64376,780583,2022-12-17
TRANSFER,694394,Jeanne Garnier,780583,86189,Valentine Richard-Bourdon,125691,-568703,2022-12-19
CASH_OUT,63527,Jeanne Garnier,86189,22662,Agence_mtn_Cotonou,300000,236473,2022-12-20
CASH_IN,270178,Agence_mtn_Cotonou,300000,29822,Jeanne Garnier,22662,292840,2022-12-22
TRANSFER,204844,Jeanne Garnier,292840,87996,Gilbert Foucher,253000,48156,2022-12-22
CASH_OUT,60028,Jeanne Garnier,87996,27968,Agence_mtn_Ouidah,300000,239972,2022-12-22
CASH_OUT,8297,Jeanne Garnier,27968,19671,Agence_mtn_Abomey,300000,291703,2022-12-24
TRANSFER,509193,Alexandre Rémy,701771,192578,Jeanne Garnier,19671,528864,2022-12-24
CASH_IN,7126,Agence_mtn_Cotonou,300000,292874,Jeanne Garnier,528864,535990,2022-12-24
CASH_OUT,357335,Jeanne Garnier,535990,178655,Agence_mtn_Ouidah,300000,-57335,2022-12-25
TRANSFER,64606,Inès de Letellier,119590,54984,Jeanne Garnier,178655,243261,2022-12-26
CASH_IN,266189,Agence_mtn_Cotonou,300000,33811,Jeanne Garnier,243261,509450,2022-12-27
CASH_OUT,981036,William Le Lucas,1133539,152503,Agence_mtn_Abomey,300000,-681036,2022-12-03
TRANSFER,677085,François Michel-Legros,1765300,1088215,William Le Lucas,152503,829588,2022-12-03
TRANSFER,7794,Bertrand Charles,33490,25696,William Le Lucas,829588,837382,2022-12-03
CASH_OUT,668206,William Le Lucas,837382,169176,Agence_mtn_Abomey,300000,-368206,2022-12-03
CASH_OUT,100874,William Le Lucas,169176,68302,Agence_mtn_Abomey,300000,199126,2022-12-04
TRANSFER,60391,William Le Lucas,68302,7911,William Le Lucas,68302,128693,2022-12-05
TRANSFER,29893,Sophie Lévêque,365600,335707,William Le Lucas,7911,37804,2022-12-08
TRANSFER,18362,William Le Lucas,37804,19442,Caroline-Lorraine Humbert,1951500,1933138,2022-12-10
CASH_IN,4154,Agence_mtn_Cotonou,300000,295846,William Le Lucas,19442,23596,2022-12-10
TRANSFER,786437,Xavier Leblanc-Ferreira,1212100,425663,William Le Lucas,23596,810033,2022-12-10
CASH_OUT,240089,William Le Lucas,810033,569944,Agence_mtn_Cotonou,300000,59911,2022-12-11
TRANSFER,490883,William Le Lucas,569944,79061,Édouard Nguyen,58800,-432083,2022-12-14
TRANSFER,975791,Pierre Reynaud,1181200,205409,William Le Lucas,79061,1054852,2022-12-14
CASH_OUT,442292,William Le Lucas,1054852,612560,Agence_mtn_Abomey,300000,-142292,2022-12-16
TRANSFER,1170004,Thibaut Coulon,1548800,378796,William Le Lucas,612560,1782564,2022-12-17
CASH_OUT,1431652,William Le Lucas,1782564,350912,Agence_mtn_Cotonou,300000,-1131652,2022-12-17
TRANSFER,226117,William Le Lucas,350912,124795,Louis Pichon,314296,88179,2022-12-18
CASH_OUT,122816,William Le Lucas,124795,1979,Agence_mtn_Ouidah,300000,177184,2022-12-18
CASH_OUT,161,William Le Lucas,1979,1818,Agence_mtn_Ouidah,300000,299839,2022-12-20
TRANSFER,819392,Geneviève De Oliveira-Michel,1022400,203008,William Le Lucas,1818,821210,2022-12-20
CASH_OUT,785282,William Le Lucas,821210,35928,Agence_mtn_Cotonou,300000,-485282,2022-12-21
CASH_OUT,30475,William Le Lucas,35928,5453,Agence_mtn_Ouidah,300000,269525,2022-12-22
TRANSFER,73741,Alexandrie Delmas,179183,105442,William Le Lucas,5453,79194,2022-12-22
TRANSFER,73269,William Le Lucas,79194,5925,Nathalie Peron,92003,18734,2022-12-23
CASH_IN,199092,Agence_mtn_Ouidah,300000,100908,William Le Lucas,5925,205017,2022-12-23
TRANSFER,141761,William Le Lucas,205017,63256,Marie Picard,1536900,1395139,2022-12-23
CASH_OUT,59126,William Le Lucas,63256,4130,Agence_mtn_Abomey,300000,240874,2022-12-25
TRANSFER,1216,William Le Lucas,4130,2914,Gilbert Foucher,48156,46940,2022-12-25
TRANSFER,127,William Le Lucas,2914,2787,Gabriel-Tristan Marty,96680,96553,2022-12-27
CASH_IN,193604,Agence_mtn_Cotonou,300000,106396,Thibaut Coulon,378796,572400,2022-12-02
CASH_OUT,446412,Thibaut Coulon,572400,125988,Agence_mtn_Ouidah,300000,-146412,2022-12-03
CASH_IN,209469,Agence_mtn_Cotonou,300000,90531,Thibaut Coulon,125988,335457,2022-12-03
CASH_IN,221286,Agence_mtn_Abomey,300000,78714,Thibaut Coulon,335457,556743,2022-12-05
CASH_OUT,530280,Thibaut Coulon,556743,26463,Agence_mtn_Ouidah,300000,-230280,2022-12-05
TRANSFER,18105,Thibaut Coulon,26463,8358,William Lebrun,1228303,1210198,2022-12-05
CASH_OUT,5030,Thibaut Coulon,8358,3328,Agence_mtn_Cotonou,300000,294970,2022-12-05
TRANSFER,2935,Thibaut Coulon,3328,393,Richard Le Descamps,244631,241696,2022-12-06
TRANSFER,637295,Raymond Marchal de Nguyen,1238832,601537,Thibaut Coulon,393,637688,2022-12-07
TRANSFER,366161,Thibaut Coulon,637688,271527,Alexandre Rémy,192578,-173583,2022-12-08
TRANSFER,68990,Cécile Delattre-Arnaud,206800,137810,Thibaut Coulon,271527,340517,2022-12-10
CASH_IN,187429,Agence_mtn_Cotonou,300000,112571,Thibaut Coulon,340517,527946,2022-12-13
CASH_OUT,164075,Thibaut Coulon,527946,363871,Agence_mtn_Ouidah,300000,135925,2022-12-14
TRANSFER,236233,Thibaut Coulon,363871,127638,Bertrand Charles,25696,-210537,2022-12-17
CASH_IN,216615,Agence_mtn_Ouidah,300000,83385,Thibaut Coulon,127638,344253,2022-12-19
CASH_IN,189044,Agence_mtn_Ouidah,300000,110956,Thibaut Coulon,344253,533297,2022-12-19
CASH_IN,209073,Agence_mtn_Ouidah,300000,90927,Thibaut Coulon,533297,742370,2022-12-20
TRANSFER,430995,Thibaut Coulon,742370,311375,Pierre Roger,354629,-76366,2022-12-21
CASH_IN,252134,Agence_mtn_Abomey,300000,47866,Thibaut Coulon,311375,563509,2022-12-21
CASH_IN,72217,Agence_mtn_Ouidah,300000,227783,Thibaut Coulon,563509,635726,2022-12-22
TRANSFER,802780,Alix Maillet,1932597,1129817,Thibaut Coulon,635726,1438506,2022-12-22
CASH_OUT,382994,Thibaut Coulon,1438506,1055512,Agence_mtn_Cotonou,300000,-82994,2022-12-23
TRANSFER,204816,Léon Martins-Briand,275600,70784,Thibaut Coulon,1055512,1260328,2022-12-26
TRANSFER,124206,Gilbert-Charles Thibault,450541,326335,Nath Bruneau,1317175,1441381,2022-12-02
CASH_OUT,975364,Nath Bruneau,1441381,466017,Agence_mtn_Cotonou,300000,-675364,2022-12-03
CASH_OUT,113387,Nath Bruneau,466017,352630,Agence_mtn_Cotonou,300000,186613,2022-12-04
TRANSFER,145324,Nath Bruneau,352630,207306,Valérie Dijoux,57142,-88182,2022-12-04
CASH_OUT,79405,Nath Bruneau,207306,127901,Agence_mtn_Abomey,300000,220595,2022-12-05
TRANSFER,31312,Nath Bruneau,127901,96589,Léon Martins-Briand,70784,39472,2022-12-06
TRANSFER,96397,Nath Bruneau,96589,192,Théodore De Oliveira-Nicolas,871800,775403,2022-12-06
TRANSFER,189,Nath Bruneau,192,3,Raymond Rossi,6590,6401,2022-12-06
CASH_IN,15919,Agence_mtn_Cotonou,300000,284081,Nath Bruneau,3,15922,2022-12-09
CASH_OUT,9817,Nath Bruneau,15922,6105,Agence_mtn_Abomey,300000,290183,2022-12-10
CASH_IN,217406,Agence_mtn_Cotonou,300000,82594,Nath Bruneau,6105,223511,2022-12-11
CASH_IN,58971,Agence_mtn_Ouidah,300000,241029,Nath Bruneau,223511,282482,2022-12-12
TRANSFER,47825,Nath Bruneau,282482,234657,Gilbert Foucher,46940,-885,2022-12-12
CASH_IN,236631,Agence_mtn_Cotonou,300000,63369,Nath Bruneau,234657,471288,2022-12-13
CASH_OUT,315736,Nath Bruneau,471288,155552,Agence_mtn_Abomey,300000,-15736,2022-12-14
CASH_IN,20708,Agence_mtn_Ouidah,300000,279292,Nath Bruneau,155552,176260,2022-12-14
CASH_IN,84315,Agence_mtn_Abomey,300000,215685,Nath Bruneau,176260,260575,2022-12-15
TRANSFER,70128,Nath Bruneau,260575,190447,Sophie Lévêque,335707,265579,2022-12-16
CASH_IN,225997,Agence_mtn_Cotonou,300000,74003,Nath Bruneau,190447,416444,2022-12-17
CASH_OUT,84719,Nath Bruneau,416444,331725,Agence_mtn_Cotonou,300000,215281,2022-12-18
TRANSFER,582901,Marine Chauvet-Potier,1667970,1085069,Nath Bruneau,331725,914626,2022-12-18
TRANSFER,5528,Raymond Rossi,6401,873,Nath Bruneau,914626,920154,2022-12-18
CASH_IN,39153,Agence_mtn_Abomey,300000,260847,Nath Bruneau,920154,959307,2022-12-18
CASH_IN,238047,Agence_mtn_Ouidah,300000,61953,Nath Bruneau,959307,1197354,2022-12-20
CASH_IN,41774,Agence_mtn_Cotonou,300000,258226,Nath Bruneau,1197354,1239128,2022-12-20
CASH_IN,226772,Agence_mtn_Ouidah,300000,73228,Nath Bruneau,1239128,1465900,2022-12-23
TRANSFER,19007,Martine Wagner de la Bègue,89509,70502,Nath Bruneau,1465900,1484907,2022-12-24
TRANSFER,367515,Nath Bruneau,1484907,1117392,Marie Picard,1395139,1027624,2022-12-25
CASH_IN,298917,Agence_mtn_Ouidah,300000,1083,Nath Bruneau,1117392,1416309,2022-12-27
CASH_OUT,545277,Cécile Clerc,1684582,1139305,Agence_mtn_Cotonou,300000,-245277,2022-12-02
CASH_OUT,404734,Cécile Clerc,1139305,734571,Agence_mtn_Ouidah,300000,-104734,2022-12-03
CASH_OUT,334972,Cécile Clerc,734571,399599,Agence_mtn_Ouidah,300000,-34972,2022-12-03
CASH_IN,119198,Agence_mtn_Abomey,300000,180802,Cécile Clerc,399599,518797,2022-12-05
CASH_IN,217285,Agence_mtn_Ouidah,300000,82715,Cécile Clerc,518797,736082,2022-12-06
TRANSFER,293743,Cécile Clerc,736082,442339,Céline Gomez,714700,420957,2022-12-08
CASH_IN,158321,Agence_mtn_Abomey,300000,141679,Cécile Clerc,442339,600660,2022-12-09
TRANSFER,271684,Cécile Clerc,600660,328976,Inès de Letellier,54984,-216700,2022-12-10
CASH_OUT,62383,Cécile Clerc,328976,266593,Agence_mtn_Cotonou,300000,237617,2022-12-10
CASH_OUT,249155,Cécile Clerc,266593,17438,Agence_mtn_Abomey,300000,50845,2022-12-10
CASH_OUT,6631,Cécile Clerc,17438,10807,Agence_mtn_Cotonou,300000,293369,2022-12-12
TRANSFER,9911,Cécile Clerc,10807,896,Louis Pichon,88179,78268,2022-12-12
CASH_OUT,399,Cécile Clerc,896,497,Agence_mtn_Cotonou,300000,299601,2022-12-12
TRANSFER,271,Cécile Clerc,497,226,Michelle Lebon,1615961,1615690,2022-12-12
CASH_OUT,173,Cécile Clerc,226,53,Agence_mtn_Ouidah,300000,299827,2022-12-12
CASH_IN,273134,Agence_mtn_Abomey,300000,26866,Cécile Clerc,53,273187,2022-12-16
CASH_OUT,1295,Cécile Clerc,273187,271892,Agence_mtn_Cotonou,300000,298705,2022-12-16
TRANSFER,61382,Cécile Clerc,271892,210510,Nathalie Pages,603451,542069,2022-12-19
TRANSFER,97559,Cécile Clerc,210510,112951,Corinne-Louise Valentin,581800,484241,2022-12-22
CASH_OUT,82343,Cécile Clerc,112951,30608,Agence_mtn_Ouidah,300000,217657,2022-12-25
TRANSFER,146272,Pénélope Ollivier,433914,287642,Cécile Clerc,30608,176880,2022-12-25
TRANSFER,188357,Xavier Leblanc-Ferreira,425663,237306,Léon Martins-Briand,39472,-148885,2022-12-01
TRANSFER,15430,Xavier Leblanc-Ferreira,237306,221876,Alphonse Le Olivier,1383229,1367799,2022-12-02
CASH_OUT,200694,Xavier Leblanc-Ferreira,221876,21182,Agence_mtn_Abomey,300000,99306,2022-12-03
TRANSFER,533,Xavier Leblanc-Ferreira,21182,20649,Frédéric Couturier,1340870,1340337,2022-12-03
CASH_OUT,10957,Xavier Leblanc-Ferreira,20649,9692,Agence_mtn_Ouidah,300000,289043,2022-12-04
CASH_OUT,1316,Xavier Leblanc-Ferreira,9692,8376,Agence_mtn_Abomey,300000,298684,2022-12-04
TRANSFER,1912,Xavier Leblanc-Ferreira,8376,6464,François Michel-Legros,1088215,1086303,2022-12-05
CASH_OUT,3962,Xavier Leblanc-Ferreira,6464,2502,Agence_mtn_Cotonou,300000,296038,2022-12-05
TRANSFER,600994,Pénélope Dupuis,772309,171315,Xavier Leblanc-Ferreira,2502,603496,2022-12-05
CASH_OUT,246841,Xavier Leblanc-Ferreira,603496,356655,Agence_mtn_Cotonou,300000,53159,2022-12-06
CASH_IN,242562,Agence_mtn_Cotonou,300000,57438,Xavier Leblanc-Ferreira,356655,599217,2022-12-06
TRANSFER,17606,Xavier de Lebreton,46500,28894,Xavier Leblanc-Ferreira,599217,616823,2022-12-07
CASH_IN,244206,Agence_mtn_Ouidah,300000,55794,Xavier Leblanc-Ferreira,616823,861029,2022-12-08
CASH_IN,132619,Agence_mtn_Ouidah,300000,167381,Xavier Leblanc-Ferreira,861029,993648,2022-12-08
CASH_OUT,219844,Xavier Leblanc-Ferreira,993648,773804,Agence_mtn_Abomey,300000,80156,2022-12-09
CASH_IN,278748,Agence_mtn_Ouidah,300000,21252,Xavier Leblanc-Ferreira,773804,1052552,2022-12-09
CASH_IN,67902,Agence_mtn_Cotonou,300000,232098,Xavier Leblanc-Ferreira,1052552,1120454,2022-12-12
TRANSFER,192238,Xavier Leblanc-Ferreira,1120454,928216,Cécile Delattre-Arnaud,137810,-54428,2022-12-12
CASH_OUT,591380,Xavier Leblanc-Ferreira,928216,336836,Agence_mtn_Cotonou,300000,-291380,2022-12-14
TRANSFER,282590,Laurent-Bertrand Lefort,1515900,1233310,Xavier Leblanc-Ferreira,336836,619426,2022-12-14
CASH_OUT,136987,Xavier Leblanc-Ferreira,619426,482439,Agence_mtn_Abomey,300000,163013,2022-12-15
CASH_OUT,410501,Xavier Leblanc-Ferreira,482439,71938,Agence_mtn_Cotonou,300000,-110501,2022-12-17
CASH_IN,24405,Agence_mtn_Ouidah,300000,275595,Xavier Leblanc-Ferreira,71938,96343,2022-12-18
CASH_IN,235007,Agence_mtn_Abomey,300000,64993,Xavier Leblanc-Ferreira,96343,331350,2022-12-22
TRANSFER,159110,David du Blondel,409711,250601,Xavier Leblanc-Ferreira,331350,490460,2022-12-23
CASH_IN,226111,Agence_mtn_Ouidah,300000,73889,Xavier Leblanc-Ferreira,490460,716571,2022-12-25
TRANSFER,55296,Inès Hamon,246576,191280,Inès Hamon,246576,301872,2022-12-01
CASH_IN,228590,Agence_mtn_Ouidah,300000,71410,Inès Hamon,191280,419870,2022-12-01
CASH_IN,151469,Agence_mtn_Cotonou,300000,148531,Inès Hamon,419870,571339,2022-12-02
CASH_IN,199610,Agence_mtn_Abomey,300000,100390,Inès Hamon,571339,770949,2022-12-07
CASH_OUT,402498,Inès Hamon,770949,368451,Agence_mtn_Ouidah,300000,-102498,2022-12-08
CASH_OUT,37860,Inès Hamon,368451,330591,Agence_mtn_Cotonou,300000,262140,2022-12-09
TRANSFER,9185,Inès Hamon,330591,321406,Alphonse Leclercq-Rousseau,1086300,1077115,2022-12-09
CASH_IN,163759,Agence_mtn_Ouidah,300000,136241,Inès Hamon,321406,485165,2022-12-09
CASH_OUT,189978,Inès Hamon,485165,295187,Agence_mtn_Abomey,300000,110022,2022-12-10
CASH_IN,190236,Agence_mtn_Abomey,300000,109764,Inès Hamon,295187,485423,2022-12-10
TRANSFER,433277,Inès Hamon,485423,52146,Sophie Lévêque,265579,-167698,2022-12-10
TRANSFER,119515,Pénélope Dupuis,171315,51800,Inès Hamon,52146,171661,2022-12-11
TRANSFER,145658,Inès Hamon,171661,26003,Inès Hamon,171661,26003,2022-12-12
CASH_IN,200297,Agence_mtn_Abomey,300000,99703,Inès Hamon,26003,226300,2022-12-13
TRANSFER,1102750,Vincent Fournier,1296400,193650,Inès Hamon,226300,1329050,2022-12-13
CASH_OUT,1101759,Inès Hamon,1329050,227291,Agence_mtn_Cotonou,300000,-801759,2022-12-15
TRANSFER,710446,Frédéric Couturier,1340337,629891,Inès Hamon,227291,937737,2022-12-15
CASH_IN,146973,Agence_mtn_Abomey,300000,153027,Inès Hamon,937737,1084710,2022-12-16
CASH_IN,162300,Agence_mtn_Ouidah,300000,137700,Inès Hamon,1084710,1247010,2022-12-17
CASH_IN,261674,Agence_mtn_Cotonou,300000,38326,Inès Hamon,1247010,1508684,2022-12-19
CASH_IN,253721,Agence_mtn_Ouidah,300000,46279,Inès Hamon,1508684,1762405,2022-12-21
TRANSFER,1343165,Inès Hamon,1762405,419240,Alexandrie Delmas,105442,-1237723,2022-12-22
TRANSFER,207726,Inès Hamon,419240,211514,Louis Pichon,78268,-129458,2022-12-22
CASH_OUT,48017,Inès Hamon,211514,163497,Agence_mtn_Ouidah,300000,251983,2022-12-23
CASH_OUT,98551,Inès Hamon,163497,64946,Agence_mtn_Cotonou,300000,201449,2022-12-23
TRANSFER,324,Roland Garcia,3259,2935,Inès Hamon,64946,65270,2022-12-24
TRANSFER,134125,Gilbert-Charles Thibault,326335,192210,Inès Hamon,65270,199395,2022-12-26
CASH_IN,127104,Agence_mtn_Abomey,300000,172896,Alexandre Rémy,-173583,-46479,2022-12-01
CASH_IN,250951,Agence_mtn_Ouidah,300000,49049,Alexandre Rémy,-46479,204472,2022-12-02
CASH_OUT,155280,Alexandre Rémy,204472,49192,Agence_mtn_Cotonou,300000,144720,2022-12-03
CASH_IN,210306,Agence_mtn_Abomey,300000,89694,Alexandre Rémy,49192,259498,2022-12-03
CASH_OUT,215479,Alexandre Rémy,259498,44019,Agence_mtn_Cotonou,300000,84521,2022-12-03
CASH_OUT,24141,Alexandre Rémy,44019,19878,Agence_mtn_Cotonou,300000,275859,2022-12-04
CASH_OUT,4065,Alexandre Rémy,19878,15813,Agence_mtn_Ouidah,300000,295935,2022-12-04
CASH_OUT,9898,Alexandre Rémy,15813,5915,Agence_mtn_Abomey,300000,290102,2022-12-04
CASH_IN,95735,Agence_mtn_Ouidah,300000,204265,Alexandre Rémy,5915,101650,2022-12-05
TRANSFER,824659,Marie Picard,1027624,202965,Alexandre Rémy,101650,926309,2022-12-07
CASH_IN,155471,Agence_mtn_Abomey,300000,144529,Alexandre Rémy,926309,1081780,2022-12-09
TRANSFER,483403,Alphonse Le Olivier,1367799,884396,Alexandre Rémy,1081780,1565183,2022-12-10
TRANSFER,723346,Alexandre Rémy,1565183,841837,Richard Le Descamps,241696,-481650,2022-12-11
CASH_IN,57745,Agence_mtn_Cotonou,300000,242255,Alexandre Rémy,841837,899582,2022-12-12
CASH_OUT,107136,Alexandre Rémy,899582,792446,Agence_mtn_Cotonou,300000,192864,2022-12-13
TRANSFER,460165,Alexandre Rémy,792446,332281,Frédéric Couturier,629891,169726,2022-12-13
CASH_IN,168297,Agence_mtn_Abomey,300000,131703,Alexandre Rémy,332281,500578,2022-12-14
CASH_OUT,74071,Alexandre Rémy,500578,426507,Agence_mtn_Cotonou,300000,225929,2022-12-14
CASH_OUT,210834,Alexandre Rémy,426507,215673,Agence_mtn_Ouidah,300000,89166,2022-12-16
CASH_IN,163866,Agence_mtn_Cotonou,300000,136134,Alexandre Rémy,215673,379539,2022-12-18
CASH_IN,110339,Agence_mtn_Ouidah,300000,189661,Alexandre Rémy,379539,489878,2022-12-18
CASH_IN,148815,Agence_mtn_Ouidah,300000,151185,Alexandre Rémy,489878,638693,2022-12-19
TRANSFER,38238,Alexandre Rémy,638693,600455,Catherine Faivre,1916600,1878362,2022-12-20
CASH_OUT,410744,Alexandre Rémy,600455,189711,Agence_mtn_Abomey,300000,-110744,2022-12-21
TRANSFER,45855,Benjamin Evrard-Marty,1712300,1666445,Alexandre Rémy,189711,235566,2022-12-21
CASH_OUT,4354,Alexandre Rémy,235566,231212,Agence_mtn_Abomey,300000,295646,2022-12-22
CASH_IN,17580,Agence_mtn_Ouidah,300000,282420,Alexandre Rémy,231212,248792,2022-12-22
TRANSFER,258249,Alphonse Leclercq-Rousseau,1077115,818866,Alexandre Rémy,248792,507041,2022-12-27
TRANSFER,116493,Raymond Marchal de Nguyen,601537,485044,Alexandre Rémy,507041,623534,2022-12-27
CASH_IN,184538,Agence_mtn_Ouidah,300000,115462,Valérie Dijoux,-88182,96356,2022-12-03
TRANSFER,30955,Valérie Dijoux,96356,65401,David du Blondel,250601,219646,2022-12-03
CASH_OUT,61613,Valérie Dijoux,65401,3788,Agence_mtn_Abomey,300000,238387,2022-12-04
CASH_OUT,986,Valérie Dijoux,3788,2802,Agence_mtn_Cotonou,300000,299014,2022-12-04
CASH_IN,253080,Agence_mtn_Cotonou,300000,46920,Valérie Dijoux,2802,255882,2022-12-06
TRANSFER,106975,Valérie Dijoux,255882,148907,Emmanuelle Georges,660200,553225,2022-12-07
CASH_IN,238318,Agence_mtn_Ouidah,300000,61682,Valérie Dijoux,148907,387225,2022-12-07
TRANSFER,26062,Sébastien Lemaître,43300,17238,Valérie Dijoux,387225,413287,2022-12-09
CASH_IN,14722,Agence_mtn_Cotonou,300000,285278,Valérie Dijoux,413287,428009,2022-12-09
CASH_OUT,51119,Valérie Dijoux,428009,376890,Agence_mtn_Abomey,300000,248881,2022-12-13
TRANSFER,239903,Pénélope Ollivier,287642,47739,Valérie Dijoux,376890,616793,2022-12-14
CASH_OUT,217481,Valérie Dijoux,616793,399312,Agence_mtn_Abomey,300000,82519,2022-12-14
CASH_IN,249098,Agence_mtn_Ouidah,300000,50902,Valérie Dijoux,399312,648410,2022-12-15
CASH_OUT,442871,Valérie Dijoux,648410,205539,Agence_mtn_Abomey,300000,-142871,2022-12-16
CASH_IN,268896,Agence_mtn_Cotonou,300000,31104,Valérie Dijoux,205539,474435,2022-12-17
TRANSFER,230640,Valérie Dijoux,474435,243795,William Lebrun,1210198,979558,2022-12-17
CASH_OUT,82107,Valérie Dijoux,243795,161688,Agence_mtn_Cotonou,300000,217893,2022-12-18
CASH_IN,175837,Agence_mtn_Ouidah,300000,124163,Valérie Dijoux,161688,337525,2022-12-19
CASH_OUT,134453,Valérie Dijoux,337525,203072,Agence_mtn_Abomey,300000,165547,2022-12-19
TRANSFER,57045,Valérie Dijoux,203072,146027,Raymond Rossi,873,-56172,2022-12-20
TRANSFER,23605,Valérie Dijoux,146027,122422,William Lebrun,979558,955953,2022-12-21
CASH_IN,193245,Agence_mtn_Cotonou,300000,106755,Valérie Dijoux,122422,315667,2022-12-22
CASH_IN,6334,Agence_mtn_Ouidah,300000,293666,Valérie Dijoux,315667,322001,2022-12-22
CASH_IN,71957,Agence_mtn_Cotonou,300000,228043,Valérie Dijoux,322001,393958,2022-12-23
CASH_OUT,186296,Valérie Dijoux,393958,207662,Agence_mtn_Ouidah,300000,113704,2022-12-24
CASH_OUT,99838,Valérie Dijoux,207662,107824,Agence_mtn_Ouidah,300000,200162,2022-12-24
CASH_OUT,15737,Valérie Dijoux,107824,92087,Agence_mtn_Abomey,300000,284263,2022-12-25
CASH_IN,234372,Agence_mtn_Cotonou,300000,65628,Valérie Dijoux,92087,326459,2022-12-27
CASH_IN,22123,Agence_mtn_Abomey,300000,277877,Léon Lecoq,-9008,13115,2022-12-01
CASH_OUT,1708,Léon Lecoq,13115,11407,Agence_mtn_Abomey,300000,298292,2022-12-02
CASH_IN,207656,Agence_mtn_Ouidah,300000,92344,Léon Lecoq,11407,219063,2022-12-02
CASH_OUT,39254,Léon Lecoq,219063,179809,Agence_mtn_Abomey,300000,260746,2022-12-02
CASH_OUT,7873,Léon Lecoq,179809,171936,Agence_mtn_Cotonou,300000,292127,2022-12-03
CASH_OUT,62015,Léon Lecoq,171936,109921,Agence_mtn_Abomey,300000,237985,2022-12-04
TRANSFER,36513,Léon Lecoq,109921,73408,Vincent Fournier,193650,157137,2022-12-05
TRANSFER,410636,William Lebrun,955953,545317,Léon Lecoq,73408,484044,2022-12-08
CASH_IN,112165,Agence_mtn_Ouidah,300000,187835,Léon Lecoq,484044,596209,2022-12-09
CASH_OUT,544917,Léon Lecoq,596209,51292,Agence_mtn_Ouidah,300000,-244917,2022-12-10
CASH_IN,21099,Agence_mtn_Ouidah,300000,278901,Léon Lecoq,51292,72391,2022-12-10
TRANSFER,257770,Laure Philippe,732500,474730,Léon Lecoq,72391,330161,2022-12-11
CASH_OUT,200094,Léon Lecoq,330161,130067,Agence_mtn_Ouidah,300000,99906,2022-12-11
CASH_OUT,44863,Léon Lecoq,130067,85204,Agence_mtn_Cotonou,300000,255137,2022-12-12
CASH_OUT,78582,Léon Lecoq,85204,6622,Agence_mtn_Cotonou,300000,221418,2022-12-13
CASH_OUT,3133,Léon Lecoq,6622,3489,Agence_mtn_Ouidah,300000,296867,2022-12-14
TRANSFER,849258,François Michel-Legros,1086303,237045,Léon Lecoq,3489,852747,2022-12-16
CASH_IN,256250,Agence_mtn_Ouidah,300000,43750,Léon Lecoq,852747,1108997,2022-12-19
CASH_OUT,1098385,Léon Lecoq,1108997,10612,Agence_mtn_Abomey,300000,-798385,2022-12-22
CASH_OUT,10408,Léon Lecoq,10612,204,Agence_mtn_Ouidah,300000,289592,2022-12-23
CASH_OUT,165,Léon Lecoq,204,39,Agence_mtn_Abomey,300000,299835,2022-12-25
CASH_IN,39236,Agence_mtn_Abomey,300000,260764,Léon Lecoq,39,39275,2022-12-25
TRANSFER,35454,Gabriel-Tristan Marty,96553,61099,Léon Lecoq,39275,74729,2022-12-26
CASH_OUT,8296,Léon Lecoq,74729,66433,Agence_mtn_Ouidah,300000,291704,2022-12-27
CASH_IN,186286,Agence_mtn_Ouidah,300000,113714,Léon Martins-Briand,-148885,37401,2022-12-01
TRANSFER,54219,Gabriel-Tristan Marty,61099,6880,Léon Martins-Briand,37401,91620,2022-12-02
CASH_OUT,1973,Léon Martins-Briand,91620,89647,Agence_mtn_Ouidah,300000,298027,2022-12-03
CASH_IN,200055,Agence_mtn_Abomey,300000,99945,Léon Martins-Briand,89647,289702,2022-12-04
CASH_IN,33914,Agence_mtn_Cotonou,300000,266086,Léon Martins-Briand,289702,323616,2022-12-04
CASH_IN,5332,Agence_mtn_Abomey,300000,294668,Léon Martins-Briand,323616,328948,2022-12-05
CASH_OUT,264985,Léon Martins-Briand,328948,63963,Agence_mtn_Cotonou,300000,35015,2022-12-05
CASH_IN,124185,Agence_mtn_Abomey,300000,175815,Léon Martins-Briand,63963,188148,2022-12-06
TRANSFER,96950,Léon Martins-Briand,188148,91198,William Lebrun,545317,448367,2022-12-06
CASH_IN,267294,Agence_mtn_Cotonou,300000,32706,Léon Martins-Briand,91198,358492,2022-12-06
CASH_IN,136968,Agence_mtn_Abomey,300000,163032,Léon Martins-Briand,358492,495460,2022-12-06
CASH_IN,30536,Agence_mtn_Abomey,300000,269464,Léon Martins-Briand,495460,525996,2022-12-08
CASH_IN,165553,Agence_mtn_Ouidah,300000,134447,Léon Martins-Briand,525996,691549,2022-12-08
TRANSFER,67944,Céline Gomez,420957,353013,Léon Martins-Briand,691549,759493,2022-12-08
TRANSFER,494165,Marine Chauvet-Potier,1085069,590904,Léon Martins-Briand,759493,1253658,2022-12-09
CASH_OUT,999170,Léon Martins-Briand,1253658,254488,Agence_mtn_Abomey,300000,-699170,2022-12-11
CASH_OUT,135196,Léon Martins-Briand,254488,119292,Agence_mtn_Cotonou,300000,164804,2022-12-11
CASH_OUT,30727,Léon Martins-Briand,119292,88565,Agence_mtn_Ouidah,300000,269273,2022-12-11
CASH_OUT,48896,Léon Martins-Briand,88565,39669,Agence_mtn_Abomey,300000,251104,2022-12-11
TRANSFER,183908,Geneviève De Oliveira-Michel,203008,19100,Léon Martins-Briand,39669,223577,2022-12-14
TRANSFER,92854,Léon Martins-Briand,223577,130723,Simone Pineau,1312686,1219832,2022-12-15
CASH_OUT,5807,Léon Martins-Briand,130723,124916,Agence_mtn_Abomey,300000,294193,2022-12-20
CASH_IN,268204,Agence_mtn_Ouidah,300000,31796,Léon Martins-Briand,124916,393120,2022-12-20
TRANSFER,147981,Léon Martins-Briand,393120,245139,Marine Chauvet-Potier,590904,442923,2022-12-20
CASH_OUT,158368,Léon Martins-Briand,245139,86771,Agence_mtn_Ouidah,300000,141632,2022-12-20
CASH_OUT,37716,Léon Martins-Briand,86771,49055,Agence_mtn_Cotonou,300000,262284,2022-12-22
CASH_OUT,19309,Léon Martins-Briand,49055,29746,Agence_mtn_Cotonou,300000,280691,2022-12-24
CASH_OUT,16921,Léon Martins-Briand,29746,12825,Agence_mtn_Ouidah,300000,283079,2022-12-24
CASH_OUT,8519,Léon Martins-Briand,12825,4306,Agence_mtn_Ouidah,300000,291481,2022-12-25
CASH_IN,43990,Agence_mtn_Cotonou,300000,256010,Sébastien Lemaître,17238,61228,2022-12-01
CASH_OUT,10537,Sébastien Lemaître,61228,50691,Agence_mtn_Ouidah,300000,289463,2022-12-01
CASH_IN,85146,Agence_mtn_Abomey,300000,214854,Sébastien Lemaître,50691,135837,2022-12-02
CASH_OUT,98613,Sébastien Lemaître,135837,37224,Agence_mtn_Abomey,300000,201387,2022-12-03
TRANSFER,315052,Astrid Gay de la Brunet,533350,218298,Sébastien Lemaître,37224,352276,2022-12-04
TRANSFER,293394,Sébastien Lemaître,352276,58882,Raymond Marchal de Nguyen,485044,191650,2022-12-05
TRANSFER,52566,Sébastien Lemaître,58882,6316,Zoé Renaud de Boutin,1625707,1573141,2022-12-07
CASH_IN,293536,Agence_mtn_Cotonou,300000,6464,Sébastien Lemaître,6316,299852,2022-12-08
TRANSFER,248739,Sébastien Lemaître,299852,51113,Michelle Lebon,1615690,1366951,2022-12-09
CASH_OUT,17040,Sébastien Lemaître,51113,34073,Agence_mtn_Ouidah,300000,282960,2022-12-09
CASH_IN,148983,Agence_mtn_Cotonou,300000,151017,Sébastien Lemaître,34073,183056,2022-12-11
TRANSFER,4388,Geneviève De Oliveira-Michel,19100,14712,Sébastien Lemaître,183056,187444,2022-12-11
CASH_OUT,64164,Sébastien Lemaître,187444,123280,Agence_mtn_Cotonou,300000,235836,2022-12-14
CASH_OUT,88961,Sébastien Lemaître,123280,34319,Agence_mtn_Cotonou,300000,211039,2022-12-16
CASH_IN,263036,Agence_mtn_Abomey,300000,36964,Sébastien Lemaître,34319,297355,2022-12-16
CASH_IN,188318,Agence_mtn_Ouidah,300000,111682,Sébastien Lemaître,297355,485673,2022-12-18
CASH_OUT,349968,Sébastien Lemaître,485673,135705,Agence_mtn_Ouidah,300000,-49968,2022-12-19
TRANSFER,690191,Alphonse Le Olivier,884396,194205,Sébastien Lemaître,135705,825896,2022-12-19
TRANSFER,832200,Laurent-Bertrand Lefort,1233310,401110,Sébastien Lemaître,825896,1658096,2022-12-19
CASH_OUT,1149550,Sébastien Lemaître,1658096,508546,Agence_mtn_Ouidah,300000,-849550,2022-12-21
CASH_IN,90913,Agence_mtn_Ouidah,300000,209087,Sébastien Lemaître,508546,599459,2022-12-22
CASH_OUT,523448,Sébastien Lemaître,599459,76011,Agence_mtn_Cotonou,300000,-223448,2022-12-22
CASH_OUT,32534,Sébastien Lemaître,76011,43477,Agence_mtn_Abomey,300000,267466,2022-12-22
TRANSFER,424,Sébastien Lemaître,43477,43053,Corinne-Louise Valentin,484241,483817,2022-12-23
CASH_IN,210221,Agence_mtn_Abomey,300000,89779,Sébastien Lemaître,43053,253274,2022-12-24
CASH_IN,106026,Agence_mtn_Abomey,300000,193974,Sébastien Lemaître,253274,359300,2022-12-26
CASH_IN,284276,Agence_mtn_Ouidah,300000,15724,Pierre Roger,-76366,207910,2022-12-01
CASH_OUT,58225,Pierre Roger,207910,149685,Agence_mtn_Abomey,300000,241775,2022-12-02
TRANSFER,27341,Pierre Roger,149685,122344,Pierre Roger,149685,122344,2022-12-04
CASH_IN,117517,Agence_mtn_Cotonou,300000,182483,Pierre Roger,122344,239861,2022-12-06
CASH_IN,78689,Agence_mtn_Cotonou,300000,221311,Pierre Roger,239861,318550,2022-12-06
CASH_OUT,241942,Pierre Roger,318550,76608,Agence_mtn_Abomey,300000,58058,2022-12-08
CASH_OUT,51633,Pierre Roger,76608,24975,Agence_mtn_Cotonou,300000,248367,2022-12-09
TRANSFER,28069,Laurent-Bertrand Lefort,401110,373041,Pierre Roger,24975,53044,2022-12-10
CASH_IN,196076,Agence_mtn_Ouidah,300000,103924,Pierre Roger,53044,249120,2022-12-10
TRANSFER,171016,Pierre Roger,249120,78104,Gilbert-Charles Thibault,192210,21194,2022-12-11
TRANSFER,1188434,Michelle Lebon,1366951,178517,Pierre Roger,78104,1266538,2022-12-12
CASH_IN,265513,Agence_mtn_Cotonou,300000,34487,Pierre Roger,1266538,1532051,2022-12-13
CASH_OUT,1405079,Pierre Roger,1532051,126972,Agence_mtn_Ouidah,300000,-1105079,2022-12-14
CASH_OUT,103453,Pierre Roger,126972,23519,Agence_mtn_Abomey,300000,196547,2022-12-15
CASH_OUT,12292,Pierre Roger,23519,11227,Agence_mtn_Cotonou,300000,287708,2022-12-16
CASH_OUT,3220,Pierre Roger,11227,8007,Agence_mtn_Cotonou,300000,296780,2022-12-17
CASH_OUT,6107,Pierre Roger,8007,1900,Agence_mtn_Cotonou,300000,293893,2022-12-21
CASH_OUT,910,Pierre Roger,1900,990,Agence_mtn_Ouidah,300000,299090,2022-12-22
CASH_OUT,758,Pierre Roger,990,232,Agence_mtn_Ouidah,300000,299242,2022-12-22
CASH_OUT,202,Pierre Roger,232,30,Agence_mtn_Cotonou,300000,299798,2022-12-24
CASH_IN,162103,Agence_mtn_Abomey,300000,137897,Pierre Roger,30,162133,2022-12-25
CASH_OUT,194708,Astrid Gay de la Brunet,218298,23590,Agence_mtn_Ouidah,300000,105292,2022-12-01
CASH_OUT,18460,Astrid Gay de la Brunet,23590,5130,Agence_mtn_Abomey,300000,281540,2022-12-02
CASH_IN,64512,Agence_mtn_Ouidah,300000,235488,Astrid Gay de la Brunet,5130,69642,2022-12-03
TRANSFER,1362698,Caroline-Lorraine Humbert,1933138,570440,Astrid Gay de la Brunet,69642,1432340,2022-12-05
CASH_OUT,72332,Astrid Gay de la Brunet,1432340,1360008,Agence_mtn_Ouidah,300000,227668,2022-12-10
CASH_IN,62141,Agence_mtn_Abomey,300000,237859,Astrid Gay de la Brunet,1360008,1422149,2022-12-11
CASH_IN,235487,Agence_mtn_Ouidah,300000,64513,Astrid Gay de la Brunet,1422149,1657636,2022-12-12
TRANSFER,214451,Astrid Gay de la Brunet,1657636,1443185,Laure Philippe,474730,260279,2022-12-12
CASH_IN,230927,Agence_mtn_Abomey,300000,69073,Astrid Gay de la Brunet,1443185,1674112,2022-12-12
CASH_OUT,1581957,Astrid Gay de la Brunet,1674112,92155,Agence_mtn_Cotonou,300000,-1281957,2022-12-12
CASH_IN,274793,Agence_mtn_Abomey,300000,25207,Astrid Gay de la Brunet,92155,366948,2022-12-13
CASH_IN,157330,Agence_mtn_Cotonou,300000,142670,Astrid Gay de la Brunet,366948,524278,2022-12-13
CASH_IN,258760,Agence_mtn_Abomey,300000,41240,Astrid Gay de la Brunet,524278,783038,2022-12-13
CASH_IN,174175,Agence_mtn_Cotonou,300000,125825,Astrid Gay de la Brunet,783038,957213,2022-12-14
CASH_OUT,949700,Astrid Gay de la Brunet,957213,7513,Agence_mtn_Cotonou,300000,-649700,2022-12-16
CASH_OUT,3991,Astrid Gay de la Brunet,7513,3522,Agence_mtn_Abomey,300000,296009,2022-12-16
CASH_OUT,2434,Astrid Gay de la Brunet,3522,1088,Agence_mtn_Ouidah,300000,297566,2022-12-17
CASH_IN,239912,Agence_mtn_Cotonou,300000,60088,Astrid Gay de la Brunet,1088,241000,2022-12-19
TRANSFER,1502,Gabriel-Tristan Marty,6880,5378,Astrid Gay de la Brunet,241000,242502,2022-12-19
TRANSFER,154911,Astrid Gay de la Brunet,242502,87591,Roland Garcia,2935,-151976,2022-12-19
CASH_IN,70861,Agence_mtn_Ouidah,300000,229139,Astrid Gay de la Brunet,87591,158452,2022-12-20
CASH_OUT,51559,Astrid Gay de la Brunet,158452,106893,Agence_mtn_Abomey,300000,248441,2022-12-20
TRANSFER,9945,François Michel-Legros,237045,227100,Astrid Gay de la Brunet,106893,116838,2022-12-21
TRANSFER,28479,Astrid Gay de la Brunet,116838,88359,David du Blondel,219646,191167,2022-12-22
CASH_IN,228026,Agence_mtn_Abomey,300000,71974,Astrid Gay de la Brunet,88359,316385,2022-12-22
TRANSFER,167037,François Michel-Legros,227100,60063,Astrid Gay de la Brunet,316385,483422,2022-12-23
CASH_IN,3263,Agence_mtn_Cotonou,300000,296737,Astrid Gay de la Brunet,483422,486685,2022-12-25
TRANSFER,302959,William Lebrun,448367,145408,Astrid Gay de la Brunet,486685,789644,2022-12-26
CASH_OUT,608366,Astrid Gay de la Brunet,789644,181278,Agence_mtn_Cotonou,300000,-308366,2022-12-26
CASH_IN,25909,Agence_mtn_Ouidah,300000,274091,Astrid Gay de la Brunet,181278,207187,2022-12-27
CASH_IN,28520,Agence_mtn_Ouidah,300000,271480,Michelle Lebon,178517,207037,2022-12-01
CASH_OUT,201510,Michelle Lebon,207037,5527,Agence_mtn_Abomey,300000,98490,2022-12-03
CASH_IN,109452,Agence_mtn_Ouidah,300000,190548,Michelle Lebon,5527,114979,2022-12-03
TRANSFER,3225,William Lebrun,145408,142183,Michelle Lebon,114979,118204,2022-12-04
TRANSFER,11316,Geneviève De Oliveira-Michel,14712,3396,Michelle Lebon,118204,129520,2022-12-06
TRANSFER,58150,Alfred du Lesage,79900,21750,Michelle Lebon,129520,187670,2022-12-09
CASH_IN,200374,Agence_mtn_Abomey,300000,99626,Michelle Lebon,187670,388044,2022-12-11
TRANSFER,48346,Michelle Lebon,388044,339698,Alix Maillet,1129817,1081471,2022-12-11
CASH_IN,89300,Agence_mtn_Ouidah,300000,210700,Michelle Lebon,339698,428998,2022-12-14
TRANSFER,19214,Michelle Lebon,428998,409784,Alfred du Lesage,21750,2536,2022-12-14
TRANSFER,28694,Michelle Lebon,409784,381090,Pénélope Ollivier,47739,19045,2022-12-15
CASH_IN,278096,Agence_mtn_Abomey,300000,21904,Michelle Lebon,381090,659186,2022-12-15
CASH_OUT,193625,Michelle Lebon,659186,465561,Agence_mtn_Abomey,300000,106375,2022-12-16
CASH_OUT,193061,Michelle Lebon,465561,272500,Agence_mtn_Abomey,300000,106939,2022-12-17
CASH_OUT,121960,Michelle Lebon,272500,150540,Agence_mtn_Abomey,300000,178040,2022-12-17
CASH_IN,205575,Agence_mtn_Abomey,300000,94425,Michelle Lebon,150540,356115,2022-12-18
CASH_IN,29379,Agence_mtn_Cotonou,300000,270621,Michelle Lebon,356115,385494,2022-12-18
CASH_IN,55208,Agence_mtn_Ouidah,300000,244792,Michelle Lebon,385494,440702,2022-12-19
CASH_IN,105922,Agence_mtn_Abomey,300000,194078,Michelle Lebon,440702,546624,2022-12-21
TRANSFER,373015,Michelle Lebon,546624,173609,Laure Philippe,260279,-112736,2022-12-25
CASH_IN,47300,Agence_mtn_Ouidah,300000,252700,Michelle Lebon,173609,220909,2022-12-26
TRANSFER,183542,Marie Picard,202965,19423,Michelle Lebon,220909,404451,2022-12-27
TRANSFER,2035,Michelle Lebon,404451,402416,Marine Chauvet-Potier,442923,440888,2022-12-27
CASH_OUT,6124,François Michel-Legros,60063,53939,Agence_mtn_Cotonou,300000,293876,2022-12-01
CASH_OUT,48301,François Michel-Legros,53939,5638,Agence_mtn_Ouidah,300000,251699,2022-12-01
TRANSFER,236927,Catherine Faivre,1878362,1641435,François Michel-Legros,5638,242565,2022-12-02
TRANSFER,20623,Gilbert-Charles Thibault,21194,571,François Michel-Legros,242565,263188,2022-12-04
CASH_IN,58988,Agence_mtn_Abomey,300000,241012,François Michel-Legros,263188,322176,2022-12-04
TRANSFER,275628,François Michel-Legros,322176,46548,Céline Gomez,353013,77385,2022-12-05
TRANSFER,389731,Corinne-Louise Valentin,483817,94086,François Michel-Legros,46548,436279,2022-12-08
CASH_OUT,21424,François Michel-Legros,436279,414855,Agence_mtn_Ouidah,300000,278576,2022-12-09
CASH_IN,80706,Agence_mtn_Abomey,300000,219294,François Michel-Legros,414855,495561,2022-12-09
CASH_OUT,469547,François Michel-Legros,495561,26014,Agence_mtn_Abomey,300000,-169547,2022-12-10
TRANSFER,17677,François Michel-Legros,26014,8337,Caroline-Lorraine Humbert,570440,552763,2022-12-12
CASH_OUT,4378,François Michel-Legros,8337,3959,Agence_mtn_Ouidah,300000,295622,2022-12-16
CASH_OUT,1113,François Michel-Legros,3959,2846,Agence_mtn_Ouidah,300000,298887,2022-12-16
TRANSFER,1477617,Zoé Renaud de Boutin,1573141,95524,François Michel-Legros,2846,1480463,2022-12-17
TRANSFER,1392007,François Michel-Legros,1480463,88456,Théodore De Oliveira-Nicolas,775403,-616604,2022-12-19
CASH_OUT,73282,François Michel-Legros,88456,15174,Agence_mtn_Cotonou,300000,226718,2022-12-20
CASH_OUT,3096,François Michel-Legros,15174,12078,Agence_mtn_Abomey,300000,296904,2022-12-21
CASH_IN,237199,Agence_mtn_Abomey,300000,62801,François Michel-Legros,12078,249277,2022-12-21
CASH_OUT,224876,François Michel-Legros,249277,24401,Agence_mtn_Cotonou,300000,75124,2022-12-21
TRANSFER,212186,Laurent-Bertrand Lefort,373041,160855,François Michel-Legros,24401,236587,2022-12-23
TRANSFER,145367,David du Blondel,191167,45800,François Michel-Legros,236587,381954,2022-12-24
TRANSFER,1328,Gabriel-Tristan Marty,5378,4050,François Michel-Legros,381954,383282,2022-12-27
TRANSFER,43927,Alphonse Le Olivier,194205,150278,Sébastien Vallée,948300,992227,2022-12-07
CASH_IN,213349,Agence_mtn_Abomey,300000,86651,Sébastien Vallée,992227,1205576,2022-12-09
TRANSFER,603501,Alphonse Leclercq-Rousseau,818866,215365,Sébastien Vallée,1205576,1809077,2022-12-10
CASH_OUT,489355,Sébastien Vallée,1809077,1319722,Agence_mtn_Abomey,300000,-189355,2022-12-15
TRANSFER,711847,Sébastien Vallée,1319722,607875,Corinne-Louise Valentin,94086,-617761,2022-12-16
CASH_IN,272828,Agence_mtn_Abomey,300000,27172,Sébastien Vallée,607875,880703,2022-12-24
CASH_IN,294130,Agence_mtn_Cotonou,300000,5870,Vincent Fournier,157137,451267,2022-12-01
CASH_OUT,164338,Vincent Fournier,451267,286929,Agence_mtn_Abomey,300000,135662,2022-12-02
TRANSFER,219749,Vincent Fournier,286929,67180,David du Blondel,45800,-173949,2022-12-05
TRANSFER,448101,Virginie Le Gall,1276841,828740,Vincent Fournier,67180,515281,2022-12-06
TRANSFER,16492,Raymond Marchal de Nguyen,191650,175158,Vincent Fournier,515281,531773,2022-12-10
CASH_IN,66639,Agence_mtn_Abomey,300000,233361,Vincent Fournier,531773,598412,2022-12-10
CASH_OUT,134345,Vincent Fournier,598412,464067,Agence_mtn_Ouidah,300000,165655,2022-12-12
CASH_OUT,301234,Vincent Fournier,464067,162833,Agence_mtn_Ouidah,300000,-1234,2022-12-14
CASH_OUT,158413,Vincent Fournier,162833,4420,Agence_mtn_Cotonou,300000,141587,2022-12-15
TRANSFER,2905,Vincent Fournier,4420,1515,Simone Pineau,1219832,1216927,2022-12-15
TRANSFER,493,Vincent Fournier,1515,1022,Alix Maillet,1081471,1080978,2022-12-18
TRANSFER,210,Vincent Fournier,1022,812,Alphonse Leclercq-Rousseau,215365,215155,2022-12-18
CASH_OUT,265,Vincent Fournier,812,547,Agence_mtn_Ouidah,300000,299735,2022-12-18
CASH_IN,299538,Agence_mtn_Abomey,300000,462,Vincent Fournier,547,300085,2022-12-21
CASH_IN,47048,Agence_mtn_Ouidah,300000,252952,Vincent Fournier,300085,347133,2022-12-21
CASH_IN,73193,Agence_mtn_Abomey,300000,226807,Vincent Fournier,347133,420326,2022-12-23
TRANSFER,5711,Vincent Fournier,420326,414615,Alphonse Le Olivier,150278,144567,2022-12-23
CASH_IN,276294,Agence_mtn_Cotonou,300000,23706,Vincent Fournier,414615,690909,2022-12-25
TRANSFER,93423,Caroline-Lorraine Humbert,552763,459340,Vincent Fournier,690909,784332,2022-12-27
CASH_IN,163894,Agence_mtn_Ouidah,300000,136106,Vincent Fournier,784332,948226,2022-12-27
CASH_OUT,1530744,Benjamin Evrard-Marty,1666445,135701,Agence_mtn_Abomey,300000,-1230744,2022-12-02
TRANSFER,14113,Benjamin Evrard-Marty,135701,121588,Simone Pineau,1216927,1202814,2022-12-02
CASH_IN,243904,Agence_mtn_Cotonou,300000,56096,Benjamin Evrard-Marty,121588,365492,2022-12-03
TRANSFER,73346,Benjamin Evrard-Marty,365492,292146,Benjamin Evrard-Marty,365492,292146,2022-12-04
TRANSFER,104521,Benjamin Evrard-Marty,292146,187625,Benjamin Evrard-Marty,292146,187625,2022-12-05
CASH_OUT,151332,Benjamin Evrard-Marty,187625,36293,Agence_mtn_Cotonou,300000,148668,2022-12-09
TRANSFER,13155,Xavier de Lebreton,28894,15739,Benjamin Evrard-Marty,36293,49448,2022-12-10
TRANSFER,39071,Benjamin Evrard-Marty,49448,10377,Marie Picard,19423,-19648,2022-12-14
CASH_OUT,7369,Benjamin Evrard-Marty,10377,3008,Agence_mtn_Cotonou,300000,292631,2022-12-16
CASH_IN,209000,Agence_mtn_Ouidah,300000,91000,Benjamin Evrard-Marty,3008,212008,2022-12-18
CASH_OUT,101543,Benjamin Evrard-Marty,212008,110465,Agence_mtn_Cotonou,300000,198457,2022-12-19
CASH_OUT,34560,Benjamin Evrard-Marty,110465,75905,Agence_mtn_Cotonou,300000,265440,2022-12-22
CASH_IN,7797,Agence_mtn_Ouidah,300000,292203,Benjamin Evrard-Marty,75905,83702,2022-12-22
CASH_IN,228987,Agence_mtn_Ouidah,300000,71013,Benjamin Evrard-Marty,83702,312689,2022-12-24
CASH_OUT,6972,Benjamin Evrard-Marty,312689,305717,Agence_mtn_Ouidah,300000,293028,2022-12-26
CASH_IN,164699,Agence_mtn_Ouidah,300000,135301,Benjamin Evrard-Marty,305717,470416,2022-12-26
CASH_OUT,278692,Benjamin Evrard-Marty,470416,191724,Agence_mtn_Abomey,300000,21308,2022-12-26
CASH_OUT,43612,Benjamin Evrard-Marty,191724,148112,Agence_mtn_Cotonou,300000,256388,2022-12-27
CASH_OUT,304760,Caroline-Lorraine Humbert,459340,154580,Agence_mtn_Abomey,300000,-4760,2022-12-02
CASH_OUT,88370,Caroline-Lorraine Humbert,154580,66210,Agence_mtn_Ouidah,300000,211630,2022-12-06
CASH_OUT,63672,Caroline-Lorraine Humbert,66210,2538,Agence_mtn_Cotonou,300000,236328,2022-12-06
CASH_IN,235320,Agence_mtn_Ouidah,300000,64680,Caroline-Lorraine Humbert,2538,237858,2022-12-08
CASH_OUT,155095,Caroline-Lorraine Humbert,237858,82763,Agence_mtn_Ouidah,300000,144905,2022-12-10
CASH_OUT,34924,Caroline-Lorraine Humbert,82763,47839,Agence_mtn_Ouidah,300000,265076,2022-12-11
TRANSFER,3004,Caroline-Lorraine Humbert,47839,44835,Caroline-Lorraine Humbert,47839,50843,2022-12-11
CASH_IN,260384,Agence_mtn_Abomey,300000,39616,Caroline-Lorraine Humbert,44835,305219,2022-12-12
TRANSFER,297092,Caroline-Lorraine Humbert,305219,8127,Pierre Reynaud,205409,-91683,2022-12-15
TRANSFER,276588,Emmanuelle Georges,553225,276637,Caroline-Lorraine Humbert,8127,284715,2022-12-15
CASH_OUT,50116,Caroline-Lorraine Humbert,284715,234599,Agence_mtn_Cotonou,300000,249884,2022-12-16
CASH_IN,270918,Agence_mtn_Abomey,300000,29082,Caroline-Lorraine Humbert,234599,505517,2022-12-18
CASH_OUT,303378,Caroline-Lorraine Humbert,505517,202139,Agence_mtn_Abomey,300000,-3378,2022-12-19
CASH_IN,281074,Agence_mtn_Cotonou,300000,18926,Caroline-Lorraine Humbert,202139,483213,2022-12-19
CASH_IN,259468,Agence_mtn_Ouidah,300000,40532,Caroline-Lorraine Humbert,483213,742681,2022-12-23
CASH_IN,268340,Agence_mtn_Ouidah,300000,31660,Caroline-Lorraine Humbert,742681,1011021,2022-12-24
CASH_OUT,51777,Caroline-Lorraine Humbert,1011021,959244,Agence_mtn_Cotonou,300000,248223,2022-12-27
TRANSFER,581450,Caroline-Lorraine Humbert,959244,377794,Nathalie Peron,18734,-562716,2022-12-27
CASH_OUT,538182,Alix Maillet,1080978,542796,Agence_mtn_Ouidah,300000,-238182,2022-12-02
TRANSFER,109709,Alix Maillet,542796,433087,Pénélope Dupuis,51800,-57909,2022-12-08
CASH_IN,182844,Agence_mtn_Abomey,300000,117156,Alix Maillet,433087,615931,2022-12-14
CASH_IN,97975,Agence_mtn_Abomey,300000,202025,Alix Maillet,615931,713906,2022-12-17
CASH_OUT,182411,Alix Maillet,713906,531495,Agence_mtn_Abomey,300000,117589,2022-12-18
TRANSFER,196849,Nathalie Pages,542069,345220,Alix Maillet,531495,728344,2022-12-20
CASH_OUT,15302,Alix Maillet,728344,713042,Agence_mtn_Abomey,300000,284698,2022-12-26
TRANSFER,2968,Geneviève De Oliveira-Michel,3396,428,Alix Maillet,713042,716010,2022-12-27
CASH_IN,216587,Agence_mtn_Cotonou,300000,83413,Alphonse Le Olivier,144567,361154,2022-12-01
CASH_OUT,141535,Alphonse Le Olivier,361154,219619,Agence_mtn_Abomey,300000,158465,2022-12-01
CASH_IN,101077,Agence_mtn_Ouidah,300000,198923,Alphonse Le Olivier,219619,320696,2022-12-02
CASH_IN,38302,Agence_mtn_Abomey,300000,261698,Alphonse Le Olivier,320696,358998,2022-12-09
CASH_OUT,179339,Alphonse Le Olivier,358998,179659,Agence_mtn_Abomey,300000,120661,2022-12-09
CASH_IN,237381,Agence_mtn_Cotonou,300000,62619,Alphonse Le Olivier,179659,417040,2022-12-10
TRANSFER,96161,Alphonse Le Olivier,417040,320879,Laurent-Bertrand Lefort,160855,64694,2022-12-10
CASH_IN,49880,Agence_mtn_Cotonou,300000,250120,Alphonse Le Olivier,320879,370759,2022-12-12
TRANSFER,370390,Alphonse Le Olivier,370759,369,Virginie Le Gall,828740,458350,2022-12-15
TRANSFER,204,Alphonse Le Olivier,369,165,Céline Gomez,77385,77181,2022-12-16
TRANSFER,556898,Simone Pineau,1202814,645916,Alphonse Le Olivier,165,557063,2022-12-20
CASH_IN,64544,Agence_mtn_Ouidah,300000,235456,Alphonse Le Olivier,557063,621607,2022-12-20
CASH_OUT,277442,Alphonse Le Olivier,621607,344165,Agence_mtn_Ouidah,300000,22558,2022-12-22
CASH_IN,210897,Agence_mtn_Abomey,300000,89103,Alphonse Le Olivier,344165,555062,2022-12-22
CASH_OUT,116700,Alphonse Le Olivier,555062,438362,Agence_mtn_Cotonou,300000,183300,2022-12-24
TRANSFER,154621,Raymond Marchal de Nguyen,175158,20537,Alphonse Le Olivier,438362,592983,2022-12-26
CASH_IN,176041,Agence_mtn_Ouidah,300000,123959,Alphonse Le Olivier,592983,769024,2022-12-26
CASH_IN,237094,Agence_mtn_Cotonou,300000,62906,Roland Garcia,-151976,85118,2022-12-02
CASH_OUT,83093,Roland Garcia,85118,2025,Agence_mtn_Ouidah,300000,216907,2022-12-04
CASH_IN,254430,Agence_mtn_Ouidah,300000,45570,Roland Garcia,2025,256455,2022-12-09
CASH_OUT,206469,Roland Garcia,256455,49986,Agence_mtn_Cotonou,300000,93531,2022-12-10
CASH_IN,156747,Agence_mtn_Abomey,300000,143253,Roland Garcia,49986,206733,2022-12-11
CASH_IN,130086,Agence_mtn_Abomey,300000,169914,Roland Garcia,206733,336819,2022-12-12
TRANSFER,209734,Roland Garcia,336819,127085,Roland Garcia,336819,127085,2022-12-14
TRANSFER,68729,Zoé Renaud de Boutin,95524,26795,Roland Garcia,127085,195814,2022-12-14
CASH_OUT,195550,Roland Garcia,195814,264,Agence_mtn_Cotonou,300000,104450,2022-12-15
CASH_OUT,255,Roland Garcia,264,9,Agence_mtn_Cotonou,300000,299745,2022-12-18
CASH_IN,238216,Agence_mtn_Ouidah,300000,61784,Pénélope Dupuis,-57909,180307,2022-12-01
CASH_OUT,70741,Pénélope Dupuis,180307,109566,Agence_mtn_Ouidah,300000,229259,2022-12-09
CASH_OUT,4582,Pénélope Dupuis,109566,104984,Agence_mtn_Abomey,300000,295418,2022-12-10
CASH_OUT,72103,Pénélope Dupuis,104984,32881,Agence_mtn_Cotonou,300000,227897,2022-12-12
CASH_OUT,10379,Pénélope Dupuis,32881,22502,Agence_mtn_Abomey,300000,289621,2022-12-17
TRANSFER,60881,Laurent-Bertrand Lefort,64694,3813,Pénélope Dupuis,22502,83383,2022-12-18
CASH_IN,21290,Agence_mtn_Cotonou,300000,278710,Pénélope Dupuis,83383,104673,2022-12-25
CASH_IN,286083,Agence_mtn_Cotonou,300000,13917,Pénélope Dupuis,104673,390756,2022-12-27
CASH_IN,123202,Agence_mtn_Cotonou,300000,176798,Joséphine Gros,-93686,29516,2022-12-07
CASH_OUT,12973,Joséphine Gros,29516,16543,Agence_mtn_Ouidah,300000,287027,2022-12-09
CASH_OUT,9047,Joséphine Gros,16543,7496,Agence_mtn_Abomey,300000,290953,2022-12-10
CASH_OUT,2973,Joséphine Gros,7496,4523,Agence_mtn_Cotonou,300000,297027,2022-12-10
TRANSFER,157950,Alphonse Leclercq-Rousseau,215155,57205,Joséphine Gros,4523,162473,2022-12-11
CASH_IN,161834,Agence_mtn_Cotonou,300000,138166,Joséphine Gros,162473,324307,2022-12-20
CASH_OUT,96594,Joséphine Gros,324307,227713,Agence_mtn_Cotonou,300000,203406,2022-12-22
CASH_IN,212270,Agence_mtn_Cotonou,300000,87730,Joséphine Gros,227713,439983,2022-12-23
CASH_IN,275040,Agence_mtn_Abomey,300000,24960,Alexandrie Delmas,-1237723,-962683,2022-12-01
CASH_IN,86544,Agence_mtn_Cotonou,300000,213456,Alexandrie Delmas,-962683,-876139,2022-12-01
CASH_IN,95936,Agence_mtn_Abomey,300000,204064,Alexandrie Delmas,-876139,-780203,2022-12-03
CASH_IN,263836,Agence_mtn_Ouidah,300000,36164,Alexandrie Delmas,-780203,-516367,2022-12-04
CASH_IN,90154,Agence_mtn_Cotonou,300000,209846,Alexandrie Delmas,-516367,-426213,2022-12-04
CASH_IN,169591,Agence_mtn_Abomey,300000,130409,Alexandrie Delmas,-426213,-256622,2022-12-05
CASH_IN,136057,Agence_mtn_Ouidah,300000,163943,Alexandrie Delmas,-256622,-120565,2022-12-05
CASH_IN,132652,Agence_mtn_Ouidah,300000,167348,Alexandrie Delmas,-120565,12087,2022-12-05
TRANSFER,3093,Laurent-Bertrand Lefort,3813,720,Alexandrie Delmas,12087,15180,2022-12-06
CASH_OUT,10864,Alexandrie Delmas,15180,4316,Agence_mtn_Cotonou,300000,289136,2022-12-09
CASH_OUT,676,Alexandrie Delmas,4316,3640,Agence_mtn_Cotonou,300000,299324,2022-12-11
TRANSFER,1744,Alexandrie Delmas,3640,1896,William Lebrun,142183,140439,2022-12-17
CASH_OUT,1479,Alexandrie Delmas,1896,417,Agence_mtn_Cotonou,300000,298521,2022-12-17
TRANSFER,191,Alexandrie Delmas,417,226,Martine Wagner de la Bègue,70502,70311,2022-12-20
CASH_OUT,169,Alexandrie Delmas,226,57,Agence_mtn_Ouidah,300000,299831,2022-12-21
CASH_IN,93281,Agence_mtn_Cotonou,300000,206719,Alexandrie Delmas,57,93338,2022-12-26
CASH_IN,246637,Agence_mtn_Cotonou,300000,53363,Alexandrie Delmas,93338,339975,2022-12-27
CASH_IN,147753,Agence_mtn_Cotonou,300000,152247,Cécile Delattre-Arnaud,-54428,93325,2022-12-02
CASH_IN,69601,Agence_mtn_Abomey,300000,230399,Cécile Delattre-Arnaud,93325,162926,2022-12-03
CASH_OUT,43283,Cécile Delattre-Arnaud,162926,119643,Agence_mtn_Ouidah,300000,256717,2022-12-03
TRANSFER,91865,Cécile Delattre-Arnaud,119643,27778,Laurent-Bertrand Lefort,720,-91145,2022-12-05
TRANSFER,11341,Cécile Delattre-Arnaud,27778,16437,Geneviève De Oliveira-Michel,428,-10913,2022-12-05
CASH_IN,87998,Agence_mtn_Abomey,300000,212002,Cécile Delattre-Arnaud,16437,104435,2022-12-09
CASH_IN,246400,Agence_mtn_Ouidah,300000,53600,Cécile Delattre-Arnaud,104435,350835,2022-12-12
TRANSFER,13853,Raymond Marchal de Nguyen,20537,6684,Cécile Delattre-Arnaud,350835,364688,2022-12-15
TRANSFER,337593,Cécile Delattre-Arnaud,364688,27095,Cécile Delattre-Arnaud,364688,27095,2022-12-20
CASH_OUT,1489,Cécile Delattre-Arnaud,27095,25606,Agence_mtn_Cotonou,300000,298511,2022-12-23
TRANSFER,53070,Martine Wagner de la Bègue,70311,17241,Cécile Delattre-Arnaud,25606,78676,2022-12-25
TRANSFER,56344,William Lebrun,140439,84095,Gabriel-Tristan Marty,4050,60394,2022-12-01
TRANSFER,11763,Martine Wagner de la Bègue,17241,5478,Gabriel-Tristan Marty,60394,72157,2022-12-02
CASH_IN,45749,Agence_mtn_Abomey,300000,254251,Gabriel-Tristan Marty,72157,117906,2022-12-07
TRANSFER,91880,Gabriel-Tristan Marty,117906,26026,Virginie Le Gall,458350,366470,2022-12-08
CASH_IN,105839,Agence_mtn_Abomey,300000,194161,Gabriel-Tristan Marty,26026,131865,2022-12-09
TRANSFER,273950,Virginie Le Gall,366470,92520,Gabriel-Tristan Marty,131865,405815,2022-12-10
TRANSFER,326555,Gabriel-Tristan Marty,405815,79260,Virginie Le Gall,92520,-234035,2022-12-11
CASH_IN,289443,Agence_mtn_Cotonou,300000,10557,Gabriel-Tristan Marty,79260,368703,2022-12-14
CASH_IN,152183,Agence_mtn_Cotonou,300000,147817,Gabriel-Tristan Marty,368703,520886,2022-12-16
CASH_OUT,99953,Gabriel-Tristan Marty,520886,420933,Agence_mtn_Cotonou,300000,200047,2022-12-17
TRANSFER,3887,Alphonse Leclercq-Rousseau,57205,53318,Gabriel-Tristan Marty,420933,424820,2022-12-19
CASH_IN,253503,Agence_mtn_Abomey,300000,46497,Gabriel-Tristan Marty,424820,678323,2022-12-20
TRANSFER,47525,Éléonore-Hélène Dubois,616393,568868,Pénélope Ollivier,19045,-28480,2022-12-01
CASH_IN,263038,Agence_mtn_Cotonou,300000,36962,Éléonore-Hélène Dubois,568868,831906,2022-12-01
CASH_OUT,728667,Éléonore-Hélène Dubois,831906,103239,Agence_mtn_Ouidah,300000,-428667,2022-12-08
CASH_IN,147837,Agence_mtn_Cotonou,300000,152163,Éléonore-Hélène Dubois,103239,251076,2022-12-09
TRANSFER,6888,Frédéric Couturier,169726,162838,Éléonore-Hélène Dubois,251076,257964,2022-12-14
CASH_IN,222619,Agence_mtn_Abomey,300000,77381,Éléonore-Hélène Dubois,257964,480583,2022-12-21
CASH_IN,177541,Agence_mtn_Ouidah,300000,122459,Marie Picard,-19648,157893,2022-12-01
TRANSFER,119750,Marie Picard,157893,38143,Nathalie Pages,345220,225470,2022-12-04
CASH_OUT,21131,Marie Picard,38143,17012,Agence_mtn_Cotonou,300000,278869,2022-12-05
TRANSFER,336721,Marine Chauvet-Potier,440888,104167,Marie Picard,17012,353733,2022-12-06
CASH_IN,164516,Agence_mtn_Cotonou,300000,135484,Marie Picard,353733,518249,2022-12-07
TRANSFER,188685,Marie Picard,518249,329564,Emmanuelle Georges,276637,87952,2022-12-07
TRANSFER,292492,Marie Picard,329564,37072,Marine Chauvet-Potier,104167,-188325,2022-12-09
CASH_OUT,22240,Marie Picard,37072,14832,Agence_mtn_Cotonou,300000,277760,2022-12-10
CASH_OUT,14314,Marie Picard,14832,518,Agence_mtn_Ouidah,300000,285686,2022-12-14
TRANSFER,3588,Martine Wagner de la Bègue,5478,1890,Marie Picard,518,4106,2022-12-14
CASH_IN,298660,Agence_mtn_Ouidah,300000,1340,Marie Picard,4106,302766,2022-12-14
CASH_OUT,183786,Marie Picard,302766,118980,Agence_mtn_Abomey,300000,116214,2022-12-16
CASH_OUT,46968,Marie Picard,118980,72012,Agence_mtn_Abomey,300000,253032,2022-12-18
TRANSFER,27833,Marie Picard,72012,44179,Emmanuelle Georges,87952,60119,2022-12-18
CASH_OUT,19831,Marie Picard,44179,24348,Agence_mtn_Cotonou,300000,280169,2022-12-18
CASH_OUT,2907,Marie Picard,24348,21441,Agence_mtn_Ouidah,300000,297093,2022-12-19
CASH_OUT,8061,Marie Picard,21441,13380,Agence_mtn_Abomey,300000,291939,2022-12-23
CASH_OUT,3356,Marie Picard,13380,10024,Agence_mtn_Cotonou,300000,296644,2022-12-26
CASH_IN,64437,Agence_mtn_Abomey,300000,235563,Corinne-Louise Valentin,-617761,-553324,2022-12-05
CASH_IN,115849,Agence_mtn_Abomey,300000,184151,Corinne-Louise Valentin,-553324,-437475,2022-12-06
CASH_IN,188076,Agence_mtn_Cotonou,300000,111924,Corinne-Louise Valentin,-437475,-249399,2022-12-17
CASH_IN,233143,Agence_mtn_Ouidah,300000,66857,Corinne-Louise Valentin,-249399,-16256,2022-12-18
CASH_IN,51977,Agence_mtn_Cotonou,300000,248023,Corinne-Louise Valentin,-16256,35721,2022-12-20
CASH_IN,117936,Agence_mtn_Ouidah,300000,182064,Corinne-Louise Valentin,35721,153657,2022-12-21
CASH_IN,249769,Agence_mtn_Cotonou,300000,50231,Sophie Lévêque,-167698,82071,2022-12-01
TRANSFER,3795,Raymond Marchal de Nguyen,6684,2889,Sophie Lévêque,82071,85866,2022-12-02
TRANSFER,2871,Raymond Marchal de Nguyen,2889,18,Sophie Lévêque,85866,88737,2022-12-04
CASH_IN,45992,Agence_mtn_Abomey,300000,254008,Sophie Lévêque,88737,134729,2022-12-05
CASH_OUT,25820,Sophie Lévêque,134729,108909,Agence_mtn_Ouidah,300000,274180,2022-12-08
TRANSFER,38082,Sophie Lévêque,108909,70827,Emmanuelle Georges,60119,22037,2022-12-11
CASH_IN,120265,Agence_mtn_Ouidah,300000,179735,Sophie Lévêque,70827,191092,2022-12-13
CASH_OUT,111080,Sophie Lévêque,191092,80012,Agence_mtn_Cotonou,300000,188920,2022-12-14
TRANSFER,65300,Sophie Lévêque,80012,14712,Martine Wagner de la Bègue,1890,-63410,2022-12-26
CASH_IN,32238,Agence_mtn_Cotonou,300000,267762,Louis Pichon,-129458,-97220,2022-12-04
CASH_IN,207917,Agence_mtn_Ouidah,300000,92083,Louis Pichon,-97220,110697,2022-12-06
CASH_OUT,11627,Louis Pichon,110697,99070,Agence_mtn_Abomey,300000,288373,2022-12-09
TRANSFER,40377,Frédéric Couturier,162838,122461,Louis Pichon,99070,139447,2022-12-10
CASH_IN,185155,Agence_mtn_Abomey,300000,114845,Louis Pichon,139447,324602,2022-12-13
TRANSFER,34395,Louis Pichon,324602,290207,Xavier de Lebreton,15739,-18656,2022-12-14
TRANSFER,223162,Louis Pichon,290207,67045,Alphonse Leclercq-Rousseau,53318,-169844,2022-12-15
TRANSFER,66404,Louis Pichon,67045,641,Emmanuelle Georges,22037,-44367,2022-12-15
CASH_IN,110168,Agence_mtn_Abomey,300000,189832,Louis Pichon,641,110809,2022-12-16
CASH_IN,111308,Agence_mtn_Cotonou,300000,188692,Louis Pichon,110809,222117,2022-12-19
TRANSFER,568707,Simone Pineau,645916,77209,Louis Pichon,222117,790824,2022-12-25
CASH_OUT,619093,Louis Pichon,790824,171731,Agence_mtn_Abomey,300000,-319093,2022-12-26
TRANSFER,6668,Zoé Renaud de Boutin,26795,20127,Louis Pichon,171731,178399,2022-12-26
CASH_IN,40736,Agence_mtn_Cotonou,300000,259264,Louis Pichon,178399,219135,2022-12-26
CASH_IN,161823,Agence_mtn_Abomey,300000,138177,Valentine Richard-Bourdon,-568703,-406880,2022-12-01
CASH_IN,254300,Agence_mtn_Ouidah,300000,45700,Valentine Richard-Bourdon,-406880,-152580,2022-12-02
CASH_IN,70115,Agence_mtn_Cotonou,300000,229885,Valentine Richard-Bourdon,-152580,-82465,2022-12-03
CASH_IN,149854,Agence_mtn_Abomey,300000,150146,Valentine Richard-Bourdon,-82465,67389,2022-12-15
TRANSFER,35818,Frédéric Couturier,122461,86643,Valentine Richard-Bourdon,67389,103207,2022-12-18
TRANSFER,6703,Valentine Richard-Bourdon,103207,96504,Zoé Renaud de Boutin,20127,13424,2022-12-24
CASH_IN,55616,Agence_mtn_Cotonou,300000,244384,Xavier de Lebreton,-18656,36960,2022-12-01
CASH_IN,263380,Agence_mtn_Ouidah,300000,36620,Xavier de Lebreton,36960,300340,2022-12-06
CASH_OUT,231340,Xavier de Lebreton,300340,69000,Agence_mtn_Ouidah,300000,68660,2022-12-15
TRANSFER,48322,Xavier de Lebreton,69000,20678,Xavier de Lebreton,69000,117322,2022-12-17
CASH_IN,274959,Agence_mtn_Abomey,300000,25041,Xavier de Lebreton,20678,295637,2022-12-18
CASH_IN,38302,Agence_mtn_Cotonou,300000,261698,Xavier de Lebreton,295637,333939,2022-12-19
TRANSFER,55572,Nathalie Pages,225470,169898,Xavier de Lebreton,333939,389511,2022-12-20
CASH_OUT,61046,Xavier de Lebreton,389511,328465,Agence_mtn_Abomey,300000,238954,2022-12-27
CASH_IN,250088,Agence_mtn_Abomey,300000,49912,Théodore De Oliveira-Nicolas,-616604,-366516,2022-12-04
CASH_IN,179035,Agence_mtn_Cotonou,300000,120965,Théodore De Oliveira-Nicolas,-366516,-187481,2022-12-04
CASH_IN,109065,Agence_mtn_Abomey,300000,190935,Théodore De Oliveira-Nicolas,-187481,-78416,2022-12-07
CASH_IN,200126,Agence_mtn_Ouidah,300000,99874,Théodore De Oliveira-Nicolas,-78416,121710,2022-12-11
CASH_IN,201814,Agence_mtn_Cotonou,300000,98186,Théodore De Oliveira-Nicolas,121710,323524,2022-12-12
CASH_IN,268896,Agence_mtn_Ouidah,300000,31104,Théodore De Oliveira-Nicolas,323524,592420,2022-12-13
CASH_IN,3121,Agence_mtn_Abomey,300000,296879,Théodore De Oliveira-Nicolas,592420,595541,2022-12-14
CASH_OUT,592131,Théodore De Oliveira-Nicolas,595541,3410,Agence_mtn_Abomey,300000,-292131,2022-12-16
CASH_IN,289292,Agence_mtn_Ouidah,300000,10708,Théodore De Oliveira-Nicolas,3410,292702,2022-12-18
CASH_IN,96728,Agence_mtn_Cotonou,300000,203272,Théodore De Oliveira-Nicolas,292702,389430,2022-12-19
CASH_IN,242091,Agence_mtn_Ouidah,300000,57909,Théodore De Oliveira-Nicolas,389430,631521,2022-12-23
CASH_OUT,437484,Théodore De Oliveira-Nicolas,631521,194037,Agence_mtn_Ouidah,300000,-137484,2022-12-24
CASH_IN,282231,Agence_mtn_Ouidah,300000,17769,Théodore De Oliveira-Nicolas,194037,476268,2022-12-25
TRANSFER,235367,Théodore De Oliveira-Nicolas,476268,240901,Frédéric Couturier,86643,-148724,2022-12-26
CASH_IN,71379,Agence_mtn_Cotonou,300000,228621,Théodore De Oliveira-Nicolas,240901,312280,2022-12-26
TRANSFER,10238,Théodore De Oliveira-Nicolas,312280,302042,Céline Gomez,77181,66943,2022-12-26
CASH_OUT,211970,Théodore De Oliveira-Nicolas,302042,90072,Agence_mtn_Ouidah,300000,88030,2022-12-26
CASH_IN,156223,Agence_mtn_Abomey,300000,143777,Théodore De Oliveira-Nicolas,90072,246295,2022-12-26
TRANSFER,52659,William Lebrun,84095,31436,Alfred du Lesage,2536,55195,2022-12-01
CASH_IN,145118,Agence_mtn_Cotonou,300000,154882,Alfred du Lesage,55195,200313,2022-12-02
CASH_IN,237440,Agence_mtn_Ouidah,300000,62560,Alfred du Lesage,200313,437753,2022-12-04
TRANSFER,331793,Alfred du Lesage,437753,105960,Alfred du Lesage,437753,769546,2022-12-04
CASH_OUT,100563,Alfred du Lesage,105960,5397,Agence_mtn_Ouidah,300000,199437,2022-12-05
CASH_OUT,4428,Alfred du Lesage,5397,969,Agence_mtn_Cotonou,300000,295572,2022-12-08
CASH_IN,80534,Agence_mtn_Ouidah,300000,219466,Alfred du Lesage,969,81503,2022-12-10
CASH_OUT,28745,Alfred du Lesage,81503,52758,Agence_mtn_Cotonou,300000,271255,2022-12-11
CASH_IN,144179,Agence_mtn_Abomey,300000,155821,Alfred du Lesage,52758,196937,2022-12-12
TRANSFER,22905,Alfred du Lesage,196937,174032,William Lebrun,31436,8531,2022-12-16
TRANSFER,7622,Alfred du Lesage,174032,166410,Zoé Renaud de Boutin,13424,5802,2022-12-18
TRANSFER,14631,Alfred du Lesage,166410,151779,Céline Gomez,66943,52312,2022-12-19
CASH_IN,175664,Agence_mtn_Abomey,300000,124336,Alfred du Lesage,151779,327443,2022-12-19
CASH_IN,250646,Agence_mtn_Abomey,300000,49354,Alfred du Lesage,327443,578089,2022-12-19
CASH_IN,179428,Agence_mtn_Cotonou,300000,120572,Alfred du Lesage,578089,757517,2022-12-22
CASH_OUT,34918,Alfred du Lesage,757517,722599,Agence_mtn_Abomey,300000,265082,2022-12-24
CASH_IN,108410,Agence_mtn_Abomey,300000,191590,Raymond Marchal de Nguyen,18,108428,2022-12-02
CASH_OUT,62442,Raymond Marchal de Nguyen,108428,45986,Agence_mtn_Cotonou,300000,237558,2022-12-02
TRANSFER,49656,Céline Gomez,52312,2656,Raymond Marchal de Nguyen,45986,95642,2022-12-05
TRANSFER,42558,Raymond Marchal de Nguyen,95642,53084,Catherine Faivre,1641435,1598877,2022-12-07
CASH_OUT,32903,Raymond Marchal de Nguyen,53084,20181,Agence_mtn_Cotonou,300000,267097,2022-12-09
CASH_IN,121602,Agence_mtn_Cotonou,300000,178398,Raymond Marchal de Nguyen,20181,141783,2022-12-09
CASH_IN,111675,Agence_mtn_Ouidah,300000,188325,Raymond Marchal de Nguyen,141783,253458,2022-12-12
TRANSFER,7001,William Lebrun,8531,1530,Raymond Marchal de Nguyen,253458,260459,2022-12-12
CASH_OUT,221626,Raymond Marchal de Nguyen,260459,38833,Agence_mtn_Cotonou,300000,78374,2022-12-13
TRANSFER,348,Céline Gomez,2656,2308,Raymond Marchal de Nguyen,38833,39181,2022-12-13
CASH_IN,83045,Agence_mtn_Ouidah,300000,216955,Raymond Marchal de Nguyen,39181,122226,2022-12-13
CASH_IN,84031,Agence_mtn_Cotonou,300000,215969,Raymond Marchal de Nguyen,122226,206257,2022-12-14
CASH_IN,79575,Agence_mtn_Cotonou,300000,220425,Raymond Marchal de Nguyen,206257,285832,2022-12-14
CASH_OUT,39845,Raymond Marchal de Nguyen,285832,245987,Agence_mtn_Ouidah,300000,260155,2022-12-16
CASH_IN,57444,Agence_mtn_Ouidah,300000,242556,Raymond Marchal de Nguyen,245987,303431,2022-12-22
CASH_OUT,171701,Raymond Marchal de Nguyen,303431,131730,Agence_mtn_Cotonou,300000,128299,2022-12-23
CASH_IN,170681,Agence_mtn_Cotonou,300000,129319,Raymond Marchal de Nguyen,131730,302411,2022-12-23
CASH_OUT,129797,Raymond Marchal de Nguyen,302411,172614,Agence_mtn_Abomey,300000,170203,2022-12-25
CASH_IN,272707,Agence_mtn_Cotonou,300000,27293,Raymond Marchal de Nguyen,172614,445321,2022-12-26
CASH_IN,52253,Agence_mtn_Abomey,300000,247747,Geneviève De Oliveira-Michel,-10913,41340,2022-12-04
CASH_OUT,34525,Geneviève De Oliveira-Michel,41340,6815,Agence_mtn_Cotonou,300000,265475,2022-12-04
TRANSFER,93821,Catherine Faivre,1598877,1505056,Geneviève De Oliveira-Michel,6815,100636,2022-12-09
CASH_IN,37504,Agence_mtn_Ouidah,300000,262496,Geneviève De Oliveira-Michel,100636,138140,2022-12-09
CASH_OUT,72038,Geneviève De Oliveira-Michel,138140,66102,Agence_mtn_Cotonou,300000,227962,2022-12-11
CASH_OUT,13793,Geneviève De Oliveira-Michel,66102,52309,Agence_mtn_Abomey,300000,286207,2022-12-19
TRANSFER,16471,Geneviève De Oliveira-Michel,52309,35838,Catherine Faivre,1505056,1488585,2022-12-23
CASH_OUT,22979,Geneviève De Oliveira-Michel,35838,12859,Agence_mtn_Abomey,300000,277021,2022-12-23
CASH_IN,53808,Agence_mtn_Abomey,300000,246192,Geneviève De Oliveira-Michel,12859,66667,2022-12-25
CASH_OUT,63477,Geneviève De Oliveira-Michel,66667,3190,Agence_mtn_Abomey,300000,236523,2022-12-26
CASH_IN,114987,Agence_mtn_Ouidah,300000,185013,Emmanuelle Georges,-44367,70620,2022-12-04
CASH_IN,222884,Agence_mtn_Abomey,300000,77116,Emmanuelle Georges,70620,293504,2022-12-05
CASH_IN,145891,Agence_mtn_Ouidah,300000,154109,Emmanuelle Georges,293504,439395,2022-12-06
CASH_IN,145849,Agence_mtn_Ouidah,300000,154151,Emmanuelle Georges,439395,585244,2022-12-07
TRANSFER,386825,Emmanuelle Georges,585244,198419,William Lebrun,1530,-385295,2022-12-07
TRANSFER,18980,Emmanuelle Georges,198419,179439,Zoé Renaud de Boutin,5802,-13178,2022-12-08
TRANSFER,602844,Catherine Faivre,1488585,885741,Emmanuelle Georges,179439,782283,2022-12-11
TRANSFER,701208,Emmanuelle Georges,782283,81075,Emmanuelle Georges,782283,1483491,2022-12-12
TRANSFER,6477,Emmanuelle Georges,81075,74598,Simone Pineau,77209,70732,2022-12-14
TRANSFER,7611,Emmanuelle Georges,74598,66987,Nathalie Pages,169898,162287,2022-12-20
TRANSFER,140408,Nathalie Pages,162287,21879,Emmanuelle Georges,66987,207395,2022-12-21
CASH_OUT,178604,Emmanuelle Georges,207395,28791,Agence_mtn_Abomey,300000,121396,2022-12-23
CASH_IN,143933,Agence_mtn_Abomey,300000,156067,Emmanuelle Georges,28791,172724,2022-12-25
TRANSFER,504638,Catherine Faivre,885741,381103,Emmanuelle Georges,172724,677362,2022-12-25
CASH_IN,84959,Agence_mtn_Abomey,300000,215041,Emmanuelle Georges,677362,762321,2022-12-25
CASH_IN,123714,Agence_mtn_Cotonou,300000,176286,Martine Wagner de la Bègue,-63410,60304,2022-12-07
TRANSFER,33749,Martine Wagner de la Bègue,60304,26555,Martine Wagner de la Bègue,60304,26555,2022-12-07
TRANSFER,81254,Catherine Faivre,381103,299849,Martine Wagner de la Bègue,26555,107809,2022-12-08
CASH_OUT,6915,Martine Wagner de la Bègue,107809,100894,Agence_mtn_Abomey,300000,293085,2022-12-08
CASH_IN,205269,Agence_mtn_Ouidah,300000,94731,Martine Wagner de la Bègue,100894,306163,2022-12-11
TRANSFER,42462,Catherine Faivre,299849,257387,Martine Wagner de la Bègue,306163,348625,2022-12-13
CASH_IN,36815,Agence_mtn_Cotonou,300000,263185,Martine Wagner de la Bègue,348625,385440,2022-12-13
CASH_IN,226141,Agence_mtn_Cotonou,300000,73859,Martine Wagner de la Bègue,385440,611581,2022-12-13
CASH_IN,118819,Agence_mtn_Ouidah,300000,181181,Martine Wagner de la Bègue,611581,730400,2022-12-15
CASH_OUT,444173,Martine Wagner de la Bègue,730400,286227,Agence_mtn_Cotonou,300000,-144173,2022-12-16
CASH_IN,161637,Agence_mtn_Ouidah,300000,138363,Martine Wagner de la Bègue,286227,447864,2022-12-16
TRANSFER,257104,Catherine Faivre,257387,283,Martine Wagner de la Bègue,447864,704968,2022-12-17
CASH_IN,41073,Agence_mtn_Cotonou,300000,258927,Martine Wagner de la Bègue,704968,746041,2022-12-22
TRANSFER,195,Nathalie Pages,21879,21684,Martine Wagner de la Bègue,746041,746236,2022-12-26
TRANSFER,156,Catherine Faivre,283,127,Martine Wagner de la Bègue,746236,746392,2022-12-27
CASH_IN,72338,Agence_mtn_Ouidah,300000,227662,Bertrand Charles,-210537,-138199,2022-12-01
CASH_IN,30683,Agence_mtn_Ouidah,300000,269317,Bertrand Charles,-138199,-107516,2022-12-05
CASH_IN,830,Agence_mtn_Abomey,300000,299170,Bertrand Charles,-107516,-106686,2022-12-07
CASH_IN,14727,Agence_mtn_Ouidah,300000,285273,Bertrand Charles,-106686,-91959,2022-12-08
CASH_IN,226051,Agence_mtn_Ouidah,300000,73949,Bertrand Charles,-91959,134092,2022-12-08
CASH_IN,295831,Agence_mtn_Ouidah,300000,4169,Bertrand Charles,134092,429923,2022-12-11
CASH_IN,250615,Agence_mtn_Abomey,300000,49385,Bertrand Charles,429923,680538,2022-12-12
CASH_IN,21573,Agence_mtn_Ouidah,300000,278427,Bertrand Charles,680538,702111,2022-12-16
CASH_IN,136044,Agence_mtn_Cotonou,300000,163956,Bertrand Charles,702111,838155,2022-12-22
CASH_IN,231699,Agence_mtn_Cotonou,300000,68301,Bertrand Charles,838155,1069854,2022-12-24
CASH_IN,273179,Agence_mtn_Cotonou,300000,26821,Laure Philippe,-112736,160443,2022-12-01
CASH_IN,163592,Agence_mtn_Cotonou,300000,136408,Laure Philippe,160443,324035,2022-12-02
TRANSFER,7021,Nathalie Pages,21684,14663,Laure Philippe,324035,331056,2022-12-02
TRANSFER,324912,Laure Philippe,331056,6144,Laure Philippe,331056,655968,2022-12-03
CASH_OUT,4324,Laure Philippe,6144,1820,Agence_mtn_Cotonou,300000,295676,2022-12-05
CASH_OUT,915,Laure Philippe,1820,905,Agence_mtn_Abomey,300000,299085,2022-12-06
CASH_IN,207244,Agence_mtn_Ouidah,300000,92756,Laure Philippe,905,208149,2022-12-06
CASH_OUT,108096,Laure Philippe,208149,100053,Agence_mtn_Cotonou,300000,191904,2022-12-08
CASH_IN,90987,Agence_mtn_Abomey,300000,209013,Laure Philippe,100053,191040,2022-12-08
CASH_OUT,182387,Laure Philippe,191040,8653,Agence_mtn_Abomey,300000,117613,2022-12-09
CASH_OUT,656,Laure Philippe,8653,7997,Agence_mtn_Cotonou,300000,299344,2022-12-11
TRANSFER,4744,Laure Philippe,7997,3253,Simone Pineau,70732,65988,2022-12-13
CASH_OUT,2090,Laure Philippe,3253,1163,Agence_mtn_Cotonou,300000,297910,2022-12-17
CASH_IN,11916,Agence_mtn_Abomey,300000,288084,Laure Philippe,1163,13079,2022-12-18
TRANSFER,9611,Nathalie Pages,14663,5052,Laure Philippe,13079,22690,2022-12-19
TRANSFER,2125,Nathalie Pages,5052,2927,Laure Philippe,22690,24815,2022-12-20
CASH_IN,102983,Agence_mtn_Cotonou,300000,197017,Laure Philippe,24815,127798,2022-12-24
CASH_IN,253884,Agence_mtn_Ouidah,300000,46116,Laure Philippe,127798,381682,2022-12-25
CASH_IN,212489,Agence_mtn_Abomey,300000,87511,Laure Philippe,381682,594171,2022-12-26
CASH_OUT,550686,Laure Philippe,594171,43485,Agence_mtn_Cotonou,300000,-250686,2022-12-27
CASH_IN,195647,Agence_mtn_Cotonou,300000,104353,Virginie Le Gall,-234035,-38388,2022-12-02
CASH_IN,249793,Agence_mtn_Cotonou,300000,50207,Virginie Le Gall,-38388,211405,2022-12-03
CASH_IN,239450,Agence_mtn_Cotonou,300000,60550,Virginie Le Gall,211405,450855,2022-12-04
TRANSFER,11218,Simone Pineau,65988,54770,Virginie Le Gall,450855,462073,2022-12-05
CASH_IN,277979,Agence_mtn_Cotonou,300000,22021,Virginie Le Gall,462073,740052,2022-12-07
TRANSFER,18830,Simone Pineau,54770,35940,Virginie Le Gall,740052,758882,2022-12-07
CASH_IN,36373,Agence_mtn_Abomey,300000,263627,Virginie Le Gall,758882,795255,2022-12-08
CASH_OUT,449271,Virginie Le Gall,795255,345984,Agence_mtn_Abomey,300000,-149271,2022-12-10
CASH_IN,135719,Agence_mtn_Ouidah,300000,164281,Virginie Le Gall,345984,481703,2022-12-16
CASH_OUT,451417,Virginie Le Gall,481703,30286,Agence_mtn_Cotonou,300000,-151417,2022-12-16
TRANSFER,17040,Virginie Le Gall,30286,13246,Virginie Le Gall,30286,13246,2022-12-16
CASH_IN,292772,Agence_mtn_Abomey,300000,7228,Virginie Le Gall,13246,306018,2022-12-16
TRANSFER,24609,Simone Pineau,35940,11331,Virginie Le Gall,306018,330627,2022-12-17
CASH_IN,294842,Agence_mtn_Abomey,300000,5158,Virginie Le Gall,330627,625469,2022-12-18
CASH_OUT,264393,Virginie Le Gall,625469,361076,Agence_mtn_Abomey,300000,35607,2022-12-19
CASH_IN,8257,Agence_mtn_Ouidah,300000,291743,Virginie Le Gall,361076,369333,2022-12-21
TRANSFER,193463,Virginie Le Gall,369333,175870,Simone Pineau,11331,-182132,2022-12-24
CASH_OUT,145915,Virginie Le Gall,175870,29955,Agence_mtn_Abomey,300000,154085,2022-12-26
CASH_IN,294282,Agence_mtn_Abomey,300000,5718,Pierre Reynaud,-91683,202599,2022-12-03
TRANSFER,115,Catherine Faivre,127,12,Pierre Reynaud,202599,202714,2022-12-03
TRANSFER,19948,Pierre Reynaud,202714,182766,Pierre Reynaud,202714,222662,2022-12-05
CASH_IN,9251,Agence_mtn_Abomey,300000,290749,Pierre Reynaud,182766,192017,2022-12-08
TRANSFER,98919,Pierre Reynaud,192017,93098,Pierre Reynaud,192017,93098,2022-12-10
CASH_OUT,10381,Pierre Reynaud,93098,82717,Agence_mtn_Cotonou,300000,289619,2022-12-10
TRANSFER,42626,Pierre Reynaud,82717,40091,Pierre Reynaud,82717,40091,2022-12-12
TRANSFER,33354,Pierre Reynaud,40091,6737,Pierre Reynaud,40091,6737,2022-12-17
CASH_IN,253991,Agence_mtn_Ouidah,300000,46009,Pierre Reynaud,6737,260728,2022-12-19
CASH_OUT,119562,Pierre Reynaud,260728,141166,Agence_mtn_Cotonou,300000,180438,2022-12-19
CASH_IN,258380,Agence_mtn_Abomey,300000,41620,Pierre Reynaud,141166,399546,2022-12-20
CASH_IN,234883,Agence_mtn_Ouidah,300000,65117,Frédéric Couturier,-148724,86159,2022-12-02
CASH_OUT,28442,Frédéric Couturier,86159,57717,Agence_mtn_Cotonou,300000,271558,2022-12-02
TRANSFER,22601,Frédéric Couturier,57717,35116,Frédéric Couturier,57717,80318,2022-12-06
CASH_IN,81087,Agence_mtn_Cotonou,300000,218913,Frédéric Couturier,35116,116203,2022-12-08
CASH_OUT,13515,Frédéric Couturier,116203,102688,Agence_mtn_Abomey,300000,286485,2022-12-09
CASH_IN,173541,Agence_mtn_Abomey,300000,126459,Frédéric Couturier,102688,276229,2022-12-19
CASH_IN,297374,Agence_mtn_Ouidah,300000,2626,Frédéric Couturier,276229,573603,2022-12-19
CASH_IN,86806,Agence_mtn_Abomey,300000,213194,Frédéric Couturier,573603,660409,2022-12-20
CASH_IN,223946,Agence_mtn_Abomey,300000,76054,Frédéric Couturier,660409,884355,2022-12-26
CASH_OUT,404326,Frédéric Couturier,884355,480029,Agence_mtn_Cotonou,300000,-104326,2022-12-26
CASH_IN,3354,Agence_mtn_Cotonou,300000,296646,Richard Le Descamps,-481650,-478296,2022-12-02
CASH_IN,92128,Agence_mtn_Ouidah,300000,207872,Richard Le Descamps,-478296,-386168,2022-12-02
CASH_IN,226496,Agence_mtn_Abomey,300000,73504,Richard Le Descamps,-386168,-159672,2022-12-02
CASH_IN,152312,Agence_mtn_Ouidah,300000,147688,Richard Le Descamps,-159672,-7360,2022-12-03
CASH_IN,247988,Agence_mtn_Abomey,300000,52012,Richard Le Descamps,-7360,240628,2022-12-03
CASH_IN,151914,Agence_mtn_Cotonou,300000,148086,Richard Le Descamps,240628,392542,2022-12-06
CASH_OUT,174977,Richard Le Descamps,392542,217565,Agence_mtn_Cotonou,300000,125023,2022-12-06
TRANSFER,62689,Richard Le Descamps,217565,154876,Richard Le Descamps,217565,154876,2022-12-06
CASH_IN,55117,Agence_mtn_Abomey,300000,244883,Richard Le Descamps,154876,209993,2022-12-08
CASH_IN,233325,Agence_mtn_Cotonou,300000,66675,Richard Le Descamps,209993,443318,2022-12-10
CASH_IN,34151,Agence_mtn_Cotonou,300000,265849,Richard Le Descamps,443318,477469,2022-12-12
CASH_IN,243782,Agence_mtn_Ouidah,300000,56218,Richard Le Descamps,477469,721251,2022-12-13
CASH_IN,149315,Agence_mtn_Ouidah,300000,150685,Richard Le Descamps,721251,870566,2022-12-16
CASH_IN,145387,Agence_mtn_Ouidah,300000,154613,Richard Le Descamps,870566,1015953,2022-12-19
CASH_IN,123247,Agence_mtn_Abomey,300000,176753,Richard Le Descamps,1015953,1139200,2022-12-20
CASH_IN,37116,Agence_mtn_Abomey,300000,262884,Richard Le Descamps,1139200,1176316,2022-12-24
CASH_IN,45312,Agence_mtn_Cotonou,300000,254688,Richard Le Descamps,1176316,1221628,2022-12-26
CASH_IN,206401,Agence_mtn_Cotonou,300000,93599,Raymond Rossi,-56172,150229,2022-12-03
TRANSFER,60377,Raymond Rossi,150229,89852,Raymond Rossi,150229,89852,2022-12-06
CASH_IN,297436,Agence_mtn_Abomey,300000,2564,Raymond Rossi,89852,387288,2022-12-07
CASH_IN,173917,Agence_mtn_Abomey,300000,126083,Raymond Rossi,387288,561205,2022-12-08
CASH_IN,182291,Agence_mtn_Ouidah,300000,117709,Raymond Rossi,561205,743496,2022-12-14
TRANSFER,696799,Raymond Rossi,743496,46697,Raymond Rossi,743496,46697,2022-12-16
TRANSFER,34731,Raymond Rossi,46697,11966,Raymond Rossi,46697,81428,2022-12-16
CASH_OUT,5416,Raymond Rossi,11966,6550,Agence_mtn_Abomey,300000,294584,2022-12-17
CASH_OUT,4437,Raymond Rossi,6550,2113,Agence_mtn_Abomey,300000,295563,2022-12-17
CASH_OUT,1363,Raymond Rossi,2113,750,Agence_mtn_Abomey,300000,298637,2022-12-20
CASH_IN,193105,Agence_mtn_Abomey,300000,106895,Raymond Rossi,750,193855,2022-12-23
CASH_OUT,99709,Raymond Rossi,193855,94146,Agence_mtn_Cotonou,300000,200291,2022-12-27
CASH_IN,14451,Agence_mtn_Abomey,300000,285549,Zoé Renaud de Boutin,-13178,1273,2022-12-04
CASH_OUT,329,Zoé Renaud de Boutin,1273,944,Agence_mtn_Cotonou,300000,299671,2022-12-04
CASH_OUT,174,Zoé Renaud de Boutin,944,770,Agence_mtn_Cotonou,300000,299826,2022-12-05
CASH_OUT,348,Zoé Renaud de Boutin,770,422,Agence_mtn_Abomey,300000,299652,2022-12-09
CASH_OUT,320,Zoé Renaud de Boutin,422,102,Agence_mtn_Ouidah,300000,299680,2022-12-15
TRANSFER,101,Zoé Renaud de Boutin,102,1,Zoé Renaud de Boutin,102,203,2022-12-18
CASH_IN,47036,Agence_mtn_Ouidah,300000,252964,Zoé Renaud de Boutin,1,47037,2022-12-20
CASH_IN,265151,Agence_mtn_Cotonou,300000,34849,Zoé Renaud de Boutin,47037,312188,2022-12-21
CASH_OUT,22305,Zoé Renaud de Boutin,312188,289883,Agence_mtn_Abomey,300000,277695,2022-12-22
CASH_IN,16344,Agence_mtn_Ouidah,300000,283656,Zoé Renaud de Boutin,289883,306227,2022-12-23
CASH_OUT,47164,Zoé Renaud de Boutin,306227,259063,Agence_mtn_Abomey,300000,252836,2022-12-24
CASH_OUT,229734,Zoé Renaud de Boutin,259063,29329,Agence_mtn_Cotonou,300000,70266,2022-12-25
CASH_IN,9808,Agence_mtn_Cotonou,300000,290192,Zoé Renaud de Boutin,29329,39137,2022-12-25
CASH_IN,25011,Agence_mtn_Abomey,300000,274989,Catherine Faivre,12,25023,2022-12-04
CASH_IN,134068,Agence_mtn_Cotonou,300000,165932,Catherine Faivre,25023,159091,2022-12-04
CASH_IN,230052,Agence_mtn_Cotonou,300000,69948,Catherine Faivre,159091,389143,2022-12-08
CASH_IN,282753,Agence_mtn_Cotonou,300000,17247,Catherine Faivre,389143,671896,2022-12-12
CASH_OUT,136674,Catherine Faivre,671896,535222,Agence_mtn_Cotonou,300000,163326,2022-12-14
CASH_OUT,153777,Catherine Faivre,535222,381445,Agence_mtn_Ouidah,300000,146223,2022-12-14
TRANSFER,371173,Catherine Faivre,381445,10272,Catherine Faivre,381445,752618,2022-12-15
CASH_IN,26577,Agence_mtn_Cotonou,300000,273423,Catherine Faivre,10272,36849,2022-12-17
CASH_IN,180068,Agence_mtn_Abomey,300000,119932,Catherine Faivre,36849,216917,2022-12-17
CASH_OUT,36257,Catherine Faivre,216917,180660,Agence_mtn_Abomey,300000,263743,2022-12-19
CASH_OUT,144778,Catherine Faivre,180660,35882,Agence_mtn_Ouidah,300000,155222,2022-12-22
CASH_OUT,31101,Catherine Faivre,35882,4781,Agence_mtn_Ouidah,300000,268899,2022-12-24
CASH_IN,97178,Agence_mtn_Cotonou,300000,202822,Catherine Faivre,4781,101959,2022-12-25
CASH_IN,257758,Agence_mtn_Abomey,300000,42242,Catherine Faivre,101959,359717,2022-12-25
CASH_IN,257039,Agence_mtn_Cotonou,300000,42961,Catherine Faivre,359717,616756,2022-12-26
CASH_OUT,122231,Catherine Faivre,616756,494525,Agence_mtn_Abomey,300000,177769,2022-12-27
CASH_IN,173099,Agence_mtn_Ouidah,300000,126901,William Lebrun,-385295,-212196,2022-12-01
CASH_IN,213157,Agence_mtn_Ouidah,300000,86843,William Lebrun,-212196,961,2022-12-03
CASH_OUT,711,William Lebrun,961,250,Agence_mtn_Abomey,300000,299289,2022-12-06
CASH_IN,103885,Agence_mtn_Ouidah,300000,196115,William Lebrun,250,104135,2022-12-06
CASH_IN,285407,Agence_mtn_Abomey,300000,14593,William Lebrun,104135,389542,2022-12-10
CASH_OUT,304619,William Lebrun,389542,84923,Agence_mtn_Abomey,300000,-4619,2022-12-12
CASH_OUT,43365,William Lebrun,84923,41558,Agence_mtn_Ouidah,300000,256635,2022-12-15
CASH_IN,262560,Agence_mtn_Ouidah,300000,37440,William Lebrun,41558,304118,2022-12-15
CASH_OUT,128553,William Lebrun,304118,175565,Agence_mtn_Abomey,300000,171447,2022-12-17
CASH_OUT,36790,William Lebrun,175565,138775,Agence_mtn_Ouidah,300000,263210,2022-12-20
CASH_IN,181080,Agence_mtn_Ouidah,300000,118920,William Lebrun,138775,319855,2022-12-20
CASH_IN,198873,Agence_mtn_Cotonou,300000,101127,William Lebrun,319855,518728,2022-12-26
CASH_OUT,296522,William Lebrun,518728,222206,Agence_mtn_Cotonou,300000,3478,2022-12-27
CASH_IN,155971,Agence_mtn_Cotonou,300000,144029,William Lebrun,222206,378177,2022-12-27
CASH_IN,205596,Agence_mtn_Ouidah,300000,94404,Gilbert Foucher,-885,204711,2022-12-07
TRANSFER,179989,Gilbert Foucher,204711,24722,Gilbert Foucher,204711,384700,2022-12-14
CASH_OUT,3771,Gilbert Foucher,24722,20951,Agence_mtn_Cotonou,300000,296229,2022-12-15
CASH_OUT,17507,Gilbert Foucher,20951,3444,Agence_mtn_Abomey,300000,282493,2022-12-18
CASH_IN,289260,Agence_mtn_Abomey,300000,10740,Gilbert Foucher,3444,292704,2022-12-23
CASH_IN,88970,Agence_mtn_Abomey,300000,211030,Alphonse Leclercq-Rousseau,-169844,-80874,2022-12-01
CASH_IN,133397,Agence_mtn_Cotonou,300000,166603,Alphonse Leclercq-Rousseau,-80874,52523,2022-12-02
CASH_IN,183870,Agence_mtn_Ouidah,300000,116130,Alphonse Leclercq-Rousseau,52523,236393,2022-12-06
CASH_IN,105233,Agence_mtn_Ouidah,300000,194767,Alphonse Leclercq-Rousseau,236393,341626,2022-12-07
CASH_OUT,276163,Alphonse Leclercq-Rousseau,341626,65463,Agence_mtn_Ouidah,300000,23837,2022-12-08
CASH_OUT,8124,Alphonse Leclercq-Rousseau,65463,57339,Agence_mtn_Ouidah,300000,291876,2022-12-09
CASH_IN,136636,Agence_mtn_Abomey,300000,163364,Alphonse Leclercq-Rousseau,57339,193975,2022-12-10
TRANSFER,73935,Alphonse Leclercq-Rousseau,193975,120040,Alphonse Leclercq-Rousseau,193975,120040,2022-12-10
CASH_IN,78795,Agence_mtn_Ouidah,300000,221205,Alphonse Leclercq-Rousseau,120040,198835,2022-12-13
CASH_IN,262140,Agence_mtn_Cotonou,300000,37860,Alphonse Leclercq-Rousseau,198835,460975,2022-12-20
CASH_IN,45996,Agence_mtn_Ouidah,300000,254004,Alphonse Leclercq-Rousseau,460975,506971,2022-12-26
CASH_IN,36174,Agence_mtn_Cotonou,300000,263826,Nathalie Peron,-562716,-526542,2022-12-07
CASH_IN,286390,Agence_mtn_Ouidah,300000,13610,Nathalie Peron,-526542,-240152,2022-12-08
CASH_IN,270526,Agence_mtn_Cotonou,300000,29474,Nathalie Peron,-240152,30374,2022-12-10
CASH_OUT,24170,Nathalie Peron,30374,6204,Agence_mtn_Abomey,300000,275830,2022-12-11
CASH_IN,280285,Agence_mtn_Ouidah,300000,19715,Nathalie Peron,6204,286489,2022-12-13
CASH_OUT,149394,Nathalie Peron,286489,137095,Agence_mtn_Cotonou,300000,150606,2022-12-13
CASH_IN,81477,Agence_mtn_Abomey,300000,218523,Nathalie Peron,137095,218572,2022-12-16
CASH_IN,35938,Agence_mtn_Abomey,300000,264062,Nathalie Peron,218572,254510,2022-12-18
TRANSFER,209585,Nathalie Peron,254510,44925,Nathalie Peron,254510,464095,2022-12-19
CASH_IN,187567,Agence_mtn_Cotonou,300000,112433,Nathalie Peron,44925,232492,2022-12-20
CASH_IN,107835,Agence_mtn_Abomey,300000,192165,Nathalie Peron,232492,340327,2022-12-20
CASH_IN,55519,Agence_mtn_Cotonou,300000,244481,Nathalie Peron,340327,395846,2022-12-22
CASH_IN,134841,Agence_mtn_Ouidah,300000,165159,Nathalie Peron,395846,530687,2022-12-24
CASH_IN,133860,Agence_mtn_Ouidah,300000,166140,Inès de Letellier,-216700,-82840,2022-12-03
CASH_IN,145128,Agence_mtn_Ouidah,300000,154872,Inès de Letellier,-82840,62288,2022-12-04
CASH_IN,183613,Agence_mtn_Cotonou,300000,116387,Inès de Letellier,62288,245901,2022-12-05
CASH_OUT,126442,Inès de Letellier,245901,119459,Agence_mtn_Abomey,300000,173558,2022-12-05
TRANSFER,26884,Inès de Letellier,119459,92575,Inès de Letellier,119459,146343,2022-12-05
CASH_IN,201902,Agence_mtn_Cotonou,300000,98098,Inès de Letellier,92575,294477,2022-12-06
TRANSFER,137970,Inès de Letellier,294477,156507,Inès de Letellier,294477,432447,2022-12-09
TRANSFER,74364,Inès de Letellier,156507,82143,Inès de Letellier,156507,230871,2022-12-09
CASH_IN,94110,Agence_mtn_Abomey,300000,205890,Inès de Letellier,82143,176253,2022-12-09
CASH_OUT,12251,Inès de Letellier,176253,164002,Agence_mtn_Cotonou,300000,287749,2022-12-13
CASH_OUT,157188,Inès de Letellier,164002,6814,Agence_mtn_Cotonou,300000,142812,2022-12-13
TRANSFER,6356,Inès de Letellier,6814,458,Inès de Letellier,6814,13170,2022-12-15
CASH_OUT,234,Inès de Letellier,458,224,Agence_mtn_Cotonou,300000,299766,2022-12-16
CASH_OUT,205,Inès de Letellier,224,19,Agence_mtn_Abomey,300000,299795,2022-12-20
CASH_IN,61517,Agence_mtn_Abomey,300000,238483,Inès de Letellier,19,61536,2022-12-21
CASH_OUT,45663,Inès de Letellier,61536,15873,Agence_mtn_Cotonou,300000,254337,2022-12-22
CASH_OUT,5581,Inès de Letellier,15873,10292,Agence_mtn_Cotonou,300000,294419,2022-12-25
CASH_IN,220917,Agence_mtn_Abomey,300000,79083,Inès de Letellier,10292,231209,2022-12-26
CASH_IN,88819,Agence_mtn_Abomey,300000,211181,Rémy de la Roux,-819449,-730630,2022-12-03
CASH_IN,73711,Agence_mtn_Cotonou,300000,226289,Rémy de la Roux,-730630,-656919,2022-12-05
CASH_IN,57391,Agence_mtn_Ouidah,300000,242609,Rémy de la Roux,-656919,-599528,2022-12-10
CASH_IN,217752,Agence_mtn_Abomey,300000,82248,Rémy de la Roux,-599528,-381776,2022-12-11
CASH_IN,295367,Agence_mtn_Cotonou,300000,4633,Rémy de la Roux,-381776,-86409,2022-12-13
CASH_IN,115538,Agence_mtn_Ouidah,300000,184462,Rémy de la Roux,-86409,29129,2022-12-13
CASH_OUT,18505,Rémy de la Roux,29129,10624,Agence_mtn_Abomey,300000,281495,2022-12-14
CASH_OUT,7167,Rémy de la Roux,10624,3457,Agence_mtn_Ouidah,300000,292833,2022-12-15
CASH_OUT,2100,Rémy de la Roux,3457,1357,Agence_mtn_Cotonou,300000,297900,2022-12-19
CASH_OUT,835,Rémy de la Roux,1357,522,Agence_mtn_Cotonou,300000,299165,2022-12-20
TRANSFER,469,Rémy de la Roux,522,53,Rémy de la Roux,522,53,2022-12-26
CASH_IN,122619,Agence_mtn_Ouidah,300000,177381,Rémy de la Roux,53,122672,2022-12-27
CASH_IN,15594,Agence_mtn_Ouidah,300000,284406,David du Blondel,-173949,-158355,2022-12-01
CASH_IN,261435,Agence_mtn_Ouidah,300000,38565,David du Blondel,-158355,103080,2022-12-02
CASH_IN,9670,Agence_mtn_Abomey,300000,290330,David du Blondel,103080,112750,2022-12-07
CASH_IN,229083,Agence_mtn_Ouidah,300000,70917,David du Blondel,112750,341833,2022-12-09
CASH_OUT,91589,David du Blondel,341833,250244,Agence_mtn_Abomey,300000,208411,2022-12-09
TRANSFER,90084,David du Blondel,250244,160160,David du Blondel,250244,160160,2022-12-11
CASH_OUT,93782,David du Blondel,160160,66378,Agence_mtn_Abomey,300000,206218,2022-12-13
CASH_IN,63847,Agence_mtn_Abomey,300000,236153,David du Blondel,66378,130225,2022-12-17
TRANSFER,34504,David du Blondel,130225,95721,David du Blondel,130225,164729,2022-12-17
CASH_IN,132031,Agence_mtn_Cotonou,300000,167969,David du Blondel,95721,227752,2022-12-18
CASH_IN,28125,Agence_mtn_Cotonou,300000,271875,David du Blondel,227752,255877,2022-12-18
CASH_IN,256552,Agence_mtn_Ouidah,300000,43448,David du Blondel,255877,512429,2022-12-19
CASH_IN,188345,Agence_mtn_Ouidah,300000,111655,David du Blondel,512429,700774,2022-12-20
CASH_IN,177218,Agence_mtn_Cotonou,300000,122782,David du Blondel,700774,877992,2022-12-21
CASH_OUT,824506,David du Blondel,877992,53486,Agence_mtn_Cotonou,300000,-524506,2022-12-25
CASH_IN,39005,Agence_mtn_Cotonou,300000,260995,Antoinette Bertrand,-1065340,-1026335,2022-12-01
CASH_IN,107326,Agence_mtn_Cotonou,300000,192674,Antoinette Bertrand,-1026335,-919009,2022-12-01
CASH_IN,19495,Agence_mtn_Abomey,300000,280505,Antoinette Bertrand,-919009,-899514,2022-12-02
CASH_IN,23414,Agence_mtn_Abomey,300000,276586,Antoinette Bertrand,-899514,-876100,2022-12-03
CASH_IN,68016,Agence_mtn_Ouidah,300000,231984,Antoinette Bertrand,-876100,-808084,2022-12-04
CASH_IN,208435,Agence_mtn_Ouidah,300000,91565,Antoinette Bertrand,-808084,-599649,2022-12-06
CASH_IN,188493,Agence_mtn_Cotonou,300000,111507,Antoinette Bertrand,-599649,-411156,2022-12-08
CASH_IN,178867,Agence_mtn_Abomey,300000,121133,Antoinette Bertrand,-411156,-232289,2022-12-09
CASH_IN,109252,Agence_mtn_Cotonou,300000,190748,Antoinette Bertrand,-232289,-123037,2022-12-09
CASH_IN,289841,Agence_mtn_Abomey,300000,10159,Antoinette Bertrand,-123037,166804,2022-12-12
CASH_IN,139260,Agence_mtn_Abomey,300000,160740,Antoinette Bertrand,166804,306064,2022-12-12
CASH_OUT,253161,Antoinette Bertrand,306064,52903,Agence_mtn_Ouidah,300000,46839,2022-12-14
CASH_IN,115656,Agence_mtn_Abomey,300000,184344,Antoinette Bertrand,52903,168559,2022-12-14
TRANSFER,93201,Antoinette Bertrand,168559,75358,Antoinette Bertrand,168559,261760,2022-12-15
CASH_IN,45067,Agence_mtn_Ouidah,300000,254933,Antoinette Bertrand,75358,120425,2022-12-19
CASH_IN,177818,Agence_mtn_Abomey,300000,122182,Antoinette Bertrand,120425,298243,2022-12-22
CASH_OUT,51692,Antoinette Bertrand,298243,246551,Agence_mtn_Ouidah,300000,248308,2022-12-23
CASH_OUT,180066,Antoinette Bertrand,246551,66485,Agence_mtn_Abomey,300000,119934,2022-12-24
CASH_OUT,36602,Antoinette Bertrand,66485,29883,Agence_mtn_Ouidah,300000,263398,2022-12-24
CASH_IN,78625,Agence_mtn_Ouidah,300000,221375,Antoinette Bertrand,29883,108508,2022-12-26
CASH_IN,28401,Agence_mtn_Abomey,300000,271599,Édouard Nguyen,-432083,-403682,2022-12-01
CASH_IN,191612,Agence_mtn_Abomey,300000,108388,Édouard Nguyen,-403682,-212070,2022-12-01
CASH_IN,205185,Agence_mtn_Abomey,300000,94815,Édouard Nguyen,-212070,-6885,2022-12-03
CASH_IN,2376,Agence_mtn_Ouidah,300000,297624,Édouard Nguyen,-6885,-4509,2022-12-03
CASH_IN,292833,Agence_mtn_Abomey,300000,7167,Édouard Nguyen,-4509,288324,2022-12-06
CASH_IN,264935,Agence_mtn_Cotonou,300000,35065,Édouard Nguyen,288324,553259,2022-12-07
CASH_OUT,495779,Édouard Nguyen,553259,57480,Agence_mtn_Ouidah,300000,-195779,2022-12-08
CASH_IN,55135,Agence_mtn_Abomey,300000,244865,Édouard Nguyen,57480,112615,2022-12-09
TRANSFER,53793,Édouard Nguyen,112615,58822,Édouard Nguyen,112615,58822,2022-12-10
CASH_OUT,318,Édouard Nguyen,58822,58504,Agence_mtn_Abomey,300000,299682,2022-12-12
CASH_IN,170868,Agence_mtn_Abomey,300000,129132,Édouard Nguyen,58504,229372,2022-12-13
CASH_IN,142530,Agence_mtn_Abomey,300000,157470,Édouard Nguyen,229372,371902,2022-12-16
CASH_OUT,5144,Édouard Nguyen,371902,366758,Agence_mtn_Cotonou,300000,294856,2022-12-17
CASH_IN,35862,Agence_mtn_Ouidah,300000,264138,Édouard Nguyen,366758,402620,2022-12-17
CASH_IN,229601,Agence_mtn_Ouidah,300000,70399,Laurent-Bertrand Lefort,-91145,138456,2022-12-01
CASH_OUT,104379,Laurent-Bertrand Lefort,138456,34077,Agence_mtn_Ouidah,300000,195621,2022-12-10
CASH_IN,53776,Agence_mtn_Abomey,300000,246224,Laurent-Bertrand Lefort,34077,87853,2022-12-22
CASH_OUT,7238,Laurent-Bertrand Lefort,87853,80615,Agence_mtn_Ouidah,300000,292762,2022-12-26
CASH_IN,191798,Agence_mtn_Abomey,300000,108202,Pénélope Ollivier,-28480,163318,2022-12-01
TRANSFER,2616,Pénélope Ollivier,163318,160702,Pénélope Ollivier,163318,165934,2022-12-02
CASH_IN,282201,Agence_mtn_Cotonou,300000,17799,Pénélope Ollivier,160702,442903,2022-12-05
CASH_IN,286672,Agence_mtn_Cotonou,300000,13328,Pénélope Ollivier,442903,729575,2022-12-06
TRANSFER,377731,Pénélope Ollivier,729575,351844,Pénélope Ollivier,729575,351844,2022-12-07
TRANSFER,197314,Pénélope Ollivier,351844,154530,Pénélope Ollivier,351844,154530,2022-12-07
TRANSFER,117889,Pénélope Ollivier,154530,36641,Pénélope Ollivier,154530,272419,2022-12-09
CASH_OUT,3351,Pénélope Ollivier,36641,33290,Agence_mtn_Ouidah,300000,296649,2022-12-11
CASH_OUT,1856,Pénélope Ollivier,33290,31434,Agence_mtn_Ouidah,300000,298144,2022-12-22
CASH_OUT,17122,Pénélope Ollivier,31434,14312,Agence_mtn_Abomey,300000,282878,2022-12-23
CASH_OUT,2598,Pénélope Ollivier,14312,11714,Agence_mtn_Ouidah,300000,297402,2022-12-23
CASH_OUT,4241,Pénélope Ollivier,11714,7473,Agence_mtn_Ouidah,300000,295759,2022-12-26
CASH_IN,120122,Agence_mtn_Ouidah,300000,179878,Simone Pineau,-182132,-62010,2022-12-01
CASH_IN,47169,Agence_mtn_Cotonou,300000,252831,Simone Pineau,-62010,-14841,2022-12-06
CASH_IN,245738,Agence_mtn_Cotonou,300000,54262,Simone Pineau,-14841,230897,2022-12-08
CASH_IN,208579,Agence_mtn_Abomey,300000,91421,Simone Pineau,230897,439476,2022-12-09
CASH_OUT,240291,Simone Pineau,439476,199185,Agence_mtn_Ouidah,300000,59709,2022-12-11
CASH_IN,274200,Agence_mtn_Abomey,300000,25800,Simone Pineau,199185,473385,2022-12-11
CASH_IN,269660,Agence_mtn_Abomey,300000,30340,Simone Pineau,473385,743045,2022-12-13
CASH_OUT,112037,Simone Pineau,743045,631008,Agence_mtn_Abomey,300000,187963,2022-12-17
CASH_IN,153456,Agence_mtn_Ouidah,300000,146544,Simone Pineau,631008,784464,2022-12-18
CASH_IN,265539,Agence_mtn_Ouidah,300000,34461,Simone Pineau,784464,1050003,2022-12-24
CASH_OUT,1011059,Simone Pineau,1050003,38944,Agence_mtn_Cotonou,300000,-711059,2022-12-25
CASH_OUT,18606,Simone Pineau,38944,20338,Agence_mtn_Ouidah,300000,281394,2022-12-27
